#srcQName	srcQStart	srcQEnd	srcQSize	srcTName	srcTStart	srcTEnd	srcStrand	srcAligned	mappingQName	mappingQStart	mappingQEnd	mappingTName	mappingTStart	mappingTEnd	mappingStrand	mappingId	mappedQName	mappedQStart	mappedQEnd	mappedTName	mappedTStart	mappedTEnd	mappedStrand	mappedAligned	qStartTrunc	qEndTrunc	mappedPslLine
P00519-1#0	0	3390	3390	P00519-1	0	3390	+	3390	P00519-1	78	138	ENST00000393293.4	475	532	+	64	P00519-1#0	78	138	ENST00000393293.4	475	532	+	57	78	3252	0
P00519-1#0	0	3390	3390	P00519-1	0	3390	+	3390	P00519-1	78	3390	ENST00000372348.9	1412	4724	++	48	P00519-1#0	78	3390	ENST00000372348.9	1412	4724	+	3312	78	0	1
P00519-1#0	0	3390	3390	P00519-1	0	3390	+	3390	P00519-1	0	3390	ENST00000318560.6	193	3583	++	24	P00519-1#0	0	3390	ENST00000318560.6	193	3583	+	3390	0	0	2
P00519-1#1	0	183	183	P00519-1	180	363	+	183	P00519-1	78	3390	ENST00000372348.9	1412	4724	++	48	P00519-1#1	0	183	ENST00000372348.9	1514	1697	+	183	0	0	3
P00519-1#1	0	183	183	P00519-1	180	363	+	183	P00519-1	0	3390	ENST00000318560.6	193	3583	++	24	P00519-1#1	0	183	ENST00000318560.6	373	556	+	183	0	0	4
P00519-1#2	0	273	273	P00519-1	378	651	+	273	P00519-1	78	3390	ENST00000372348.9	1412	4724	++	48	P00519-1#2	0	273	ENST00000372348.9	1712	1985	+	273	0	0	5
P00519-1#2	0	273	273	P00519-1	378	651	+	273	P00519-1	0	3390	ENST00000318560.6	193	3583	++	24	P00519-1#2	0	273	ENST00000318560.6	571	844	+	273	0	0	6
P00519-1#3	0	756	756	P00519-1	723	1479	+	756	P00519-1	78	3390	ENST00000372348.9	1412	4724	++	48	P00519-1#3	0	756	ENST00000372348.9	2057	2813	+	756	0	0	7
P00519-1#3	0	756	756	P00519-1	723	1479	+	756	P00519-1	0	3390	ENST00000318560.6	193	3583	++	24	P00519-1#3	0	756	ENST00000318560.6	916	1672	+	756	0	0	8
P00519-1#4	0	180	180	P00519-1	0	180	+	180	P00519-1	78	138	ENST00000393293.4	475	532	+	64	P00519-1#4	78	138	ENST00000393293.4	475	532	+	57	78	42	9
P00519-1#4	0	180	180	P00519-1	0	180	+	180	P00519-1	78	3390	ENST00000372348.9	1412	4724	++	48	P00519-1#4	78	180	ENST00000372348.9	1412	1514	+	102	78	0	10
P00519-1#4	0	180	180	P00519-1	0	180	+	180	P00519-1	0	3390	ENST00000318560.6	193	3583	++	24	P00519-1#4	0	180	ENST00000318560.6	193	373	+	180	0	0	11
P00519-1#5	0	1437	1437	P00519-1	1551	2988	+	1437	P00519-1	78	3390	ENST00000372348.9	1412	4724	++	48	P00519-1#5	0	1437	ENST00000372348.9	2885	4322	+	1437	0	0	12
P00519-1#5	0	1437	1437	P00519-1	1551	2988	+	1437	P00519-1	0	3390	ENST00000318560.6	193	3583	++	24	P00519-1#5	0	1437	ENST00000318560.6	1744	3181	+	1437	0	0	13
P00519-1#6	0	300	300	P00519-1	2604	2904	+	300	P00519-1	78	3390	ENST00000372348.9	1412	4724	++	48	P00519-1#6	0	300	ENST00000372348.9	3938	4238	+	300	0	0	14
P00519-1#6	0	300	300	P00519-1	2604	2904	+	300	P00519-1	0	3390	ENST00000318560.6	193	3583	++	24	P00519-1#6	0	300	ENST00000318560.6	2797	3097	+	300	0	0	15
P00519-1#7	0	534	534	P00519-1	2856	3390	+	534	P00519-1	78	3390	ENST00000372348.9	1412	4724	++	48	P00519-1#7	0	534	ENST00000372348.9	4190	4724	+	534	0	0	16
P00519-1#7	0	534	534	P00519-1	2856	3390	+	534	P00519-1	0	3390	ENST00000318560.6	193	3583	++	24	P00519-1#7	0	534	ENST00000318560.6	3049	3583	+	534	0	0	17
P00519-1#8	0	75	75	P00519-1	1140	1215	+	75	P00519-1	78	3390	ENST00000372348.9	1412	4724	++	48	P00519-1#8	0	75	ENST00000372348.9	2474	2549	+	75	0	0	18
P00519-1#8	0	75	75	P00519-1	1140	1215	+	75	P00519-1	0	3390	ENST00000318560.6	193	3583	++	24	P00519-1#8	0	75	ENST00000318560.6	1333	1408	+	75	0	0	19
P00519-1#9	0	15	15	P00519-1	1812	1827	+	15	P00519-1	78	3390	ENST00000372348.9	1412	4724	++	48	P00519-1#9	0	15	ENST00000372348.9	3146	3161	+	15	0	0	20
P00519-1#9	0	15	15	P00519-1	1812	1827	+	15	P00519-1	0	3390	ENST00000318560.6	193	3583	++	24	P00519-1#9	0	15	ENST00000318560.6	2005	2020	+	15	0	0	21
P00519-1#10	0	21	21	P00519-1	2124	2145	+	21	P00519-1	78	3390	ENST00000372348.9	1412	4724	++	48	P00519-1#10	0	21	ENST00000372348.9	3458	3479	+	21	0	0	22
P00519-1#10	0	21	21	P00519-1	2124	2145	+	21	P00519-1	0	3390	ENST00000318560.6	193	3583	++	24	P00519-1#10	0	21	ENST00000318560.6	2317	2338	+	21	0	0	23
P00519-1#11	0	24	24	P00519-1	2283	2307	+	24	P00519-1	78	3390	ENST00000372348.9	1412	4724	++	48	P00519-1#11	0	24	ENST00000372348.9	3617	3641	+	24	0	0	24
P00519-1#11	0	24	24	P00519-1	2283	2307	+	24	P00519-1	0	3390	ENST00000318560.6	193	3583	++	24	P00519-1#11	0	24	ENST00000318560.6	2476	2500	+	24	0	0	25
P00519-1#12	0	33	33	P00519-1	3267	3300	+	33	P00519-1	78	3390	ENST00000372348.9	1412	4724	++	48	P00519-1#12	0	33	ENST00000372348.9	4601	4634	+	33	0	0	26
P00519-1#12	0	33	33	P00519-1	3267	3300	+	33	P00519-1	0	3390	ENST00000318560.6	193	3583	++	24	P00519-1#12	0	33	ENST00000318560.6	3460	3493	+	33	0	0	27
P00519-1#13	0	51	51	P00519-1	1596	1647	+	51	P00519-1	78	3390	ENST00000372348.9	1412	4724	++	48	P00519-1#13	0	51	ENST00000372348.9	2930	2981	+	51	0	0	28
P00519-1#13	0	51	51	P00519-1	1596	1647	+	51	P00519-1	0	3390	ENST00000318560.6	193	3583	++	24	P00519-1#13	0	51	ENST00000318560.6	1789	1840	+	51	0	0	29
P00519-1#14	0	69	69	P00519-1	1734	1803	+	69	P00519-1	78	3390	ENST00000372348.9	1412	4724	++	48	P00519-1#14	0	69	ENST00000372348.9	3068	3137	+	69	0	0	30
P00519-1#14	0	69	69	P00519-1	1734	1803	+	69	P00519-1	0	3390	ENST00000318560.6	193	3583	++	24	P00519-1#14	0	69	ENST00000318560.6	1927	1996	+	69	0	0	31
P00519-1#15	0	51	51	P00519-1	1863	1914	+	51	P00519-1	78	3390	ENST00000372348.9	1412	4724	++	48	P00519-1#15	0	51	ENST00000372348.9	3197	3248	+	51	0	0	32
P00519-1#15	0	51	51	P00519-1	1863	1914	+	51	P00519-1	0	3390	ENST00000318560.6	193	3583	++	24	P00519-1#15	0	51	ENST00000318560.6	2056	2107	+	51	0	0	33
P00519-1#16	0	57	57	P00519-1	2052	2109	+	57	P00519-1	78	3390	ENST00000372348.9	1412	4724	++	48	P00519-1#16	0	57	ENST00000372348.9	3386	3443	+	57	0	0	34
P00519-1#16	0	57	57	P00519-1	2052	2109	+	57	P00519-1	0	3390	ENST00000318560.6	193	3583	++	24	P00519-1#16	0	57	ENST00000318560.6	2245	2302	+	57	0	0	35
P00519-1#17	0	57	57	P00519-1	2202	2259	+	57	P00519-1	78	3390	ENST00000372348.9	1412	4724	++	48	P00519-1#17	0	57	ENST00000372348.9	3536	3593	+	57	0	0	36
P00519-1#17	0	57	57	P00519-1	2202	2259	+	57	P00519-1	0	3390	ENST00000318560.6	193	3583	++	24	P00519-1#17	0	57	ENST00000318560.6	2395	2452	+	57	0	0	37
P00519-1#18	0	45	45	P00519-1	2271	2316	+	45	P00519-1	78	3390	ENST00000372348.9	1412	4724	++	48	P00519-1#18	0	45	ENST00000372348.9	3605	3650	+	45	0	0	38
P00519-1#18	0	45	45	P00519-1	2271	2316	+	45	P00519-1	0	3390	ENST00000318560.6	193	3583	++	24	P00519-1#18	0	45	ENST00000318560.6	2464	2509	+	45	0	0	39
P00519-1#19	0	75	75	P00519-1	2607	2682	+	75	P00519-1	78	3390	ENST00000372348.9	1412	4724	++	48	P00519-1#19	0	75	ENST00000372348.9	3941	4016	+	75	0	0	40
P00519-1#19	0	75	75	P00519-1	2607	2682	+	75	P00519-1	0	3390	ENST00000318560.6	193	3583	++	24	P00519-1#19	0	75	ENST00000318560.6	2800	2875	+	75	0	0	41
P00519-1#20	0	3	3	P00519-1	1086	1089	+	3	P00519-1	78	3390	ENST00000372348.9	1412	4724	++	48	P00519-1#20	0	3	ENST00000372348.9	2420	2423	+	3	0	0	42
P00519-1#20	0	3	3	P00519-1	1086	1089	+	3	P00519-1	0	3390	ENST00000318560.6	193	3583	++	24	P00519-1#20	0	3	ENST00000318560.6	1279	1282	+	3	0	0	43
P00519-1#21	0	27	27	P00519-1	741	768	+	27	P00519-1	78	3390	ENST00000372348.9	1412	4724	++	48	P00519-1#21	0	27	ENST00000372348.9	2075	2102	+	27	0	0	44
P00519-1#21	0	27	27	P00519-1	741	768	+	27	P00519-1	0	3390	ENST00000318560.6	193	3583	++	24	P00519-1#21	0	27	ENST00000318560.6	934	961	+	27	0	0	45
P00519-1#22	0	3	3	P00519-1	810	813	+	3	P00519-1	78	3390	ENST00000372348.9	1412	4724	++	48	P00519-1#22	0	3	ENST00000372348.9	2144	2147	+	3	0	0	46
P00519-1#22	0	3	3	P00519-1	810	813	+	3	P00519-1	0	3390	ENST00000318560.6	193	3583	++	24	P00519-1#22	0	3	ENST00000318560.6	1003	1006	+	3	0	0	47
P00519-1#23	0	21	21	P00519-1	945	966	+	21	P00519-1	78	3390	ENST00000372348.9	1412	4724	++	48	P00519-1#23	0	21	ENST00000372348.9	2279	2300	+	21	0	0	48
P00519-1#23	0	21	21	P00519-1	945	966	+	21	P00519-1	0	3390	ENST00000318560.6	193	3583	++	24	P00519-1#23	0	21	ENST00000318560.6	1138	1159	+	21	0	0	49
P00519-1#24	0	6	6	P00519-1	75	81	+	6	P00519-1	78	138	ENST00000393293.4	475	532	+	64	P00519-1#24	3	4	ENST00000393293.4	475	476	+	1	3	2	50
P00519-1#24	0	6	6	P00519-1	75	81	+	6	P00519-1	78	3390	ENST00000372348.9	1412	4724	++	48	P00519-1#24	3	6	ENST00000372348.9	1412	1415	+	3	3	0	51
P00519-1#24	0	6	6	P00519-1	75	81	+	6	P00519-1	0	3390	ENST00000318560.6	193	3583	++	24	P00519-1#24	0	6	ENST00000318560.6	268	274	+	6	0	0	52
P00519-1#25	0	3	3	P00519-1	147	150	+	3	P00519-1	78	3390	ENST00000372348.9	1412	4724	++	48	P00519-1#25	0	3	ENST00000372348.9	1481	1484	+	3	0	0	53
P00519-1#25	0	3	3	P00519-1	147	150	+	3	P00519-1	0	3390	ENST00000318560.6	193	3583	++	24	P00519-1#25	0	3	ENST00000318560.6	340	343	+	3	0	0	54
P00519-1#26	0	3	3	P00519-1	207	210	+	3	P00519-1	78	3390	ENST00000372348.9	1412	4724	++	48	P00519-1#26	0	3	ENST00000372348.9	1541	1544	+	3	0	0	55
P00519-1#26	0	3	3	P00519-1	207	210	+	3	P00519-1	0	3390	ENST00000318560.6	193	3583	++	24	P00519-1#26	0	3	ENST00000318560.6	400	403	+	3	0	0	56
P00519-1#27	0	3	3	P00519-1	342	345	+	3	P00519-1	78	3390	ENST00000372348.9	1412	4724	++	48	P00519-1#27	0	3	ENST00000372348.9	1676	1679	+	3	0	0	57
P00519-1#27	0	3	3	P00519-1	342	345	+	3	P00519-1	0	3390	ENST00000318560.6	193	3583	++	24	P00519-1#27	0	3	ENST00000318560.6	535	538	+	3	0	0	58
P00519-1#28	0	3	3	P00519-1	381	384	+	3	P00519-1	78	3390	ENST00000372348.9	1412	4724	++	48	P00519-1#28	0	3	ENST00000372348.9	1715	1718	+	3	0	0	59
P00519-1#28	0	3	3	P00519-1	381	384	+	3	P00519-1	0	3390	ENST00000318560.6	193	3583	++	24	P00519-1#28	0	3	ENST00000318560.6	574	577	+	3	0	0	60
P00519-1#29	0	3	3	P00519-1	414	417	+	3	P00519-1	78	3390	ENST00000372348.9	1412	4724	++	48	P00519-1#29	0	3	ENST00000372348.9	1748	1751	+	3	0	0	61
P00519-1#29	0	3	3	P00519-1	414	417	+	3	P00519-1	0	3390	ENST00000318560.6	193	3583	++	24	P00519-1#29	0	3	ENST00000318560.6	607	610	+	3	0	0	62
P00519-1#30	0	3	3	P00519-1	513	516	+	3	P00519-1	78	3390	ENST00000372348.9	1412	4724	++	48	P00519-1#30	0	3	ENST00000372348.9	1847	1850	+	3	0	0	63
P00519-1#30	0	3	3	P00519-1	513	516	+	3	P00519-1	0	3390	ENST00000318560.6	193	3583	++	24	P00519-1#30	0	3	ENST00000318560.6	706	709	+	3	0	0	64
P00519-1#31	0	3	3	P00519-1	552	555	+	3	P00519-1	78	3390	ENST00000372348.9	1412	4724	++	48	P00519-1#31	0	3	ENST00000372348.9	1886	1889	+	3	0	0	65
P00519-1#31	0	3	3	P00519-1	552	555	+	3	P00519-1	0	3390	ENST00000318560.6	193	3583	++	24	P00519-1#31	0	3	ENST00000318560.6	745	748	+	3	0	0	66
P00519-1#32	0	3	3	P00519-1	642	645	+	3	P00519-1	78	3390	ENST00000372348.9	1412	4724	++	48	P00519-1#32	0	3	ENST00000372348.9	1976	1979	+	3	0	0	67
P00519-1#32	0	3	3	P00519-1	642	645	+	3	P00519-1	0	3390	ENST00000318560.6	193	3583	++	24	P00519-1#32	0	3	ENST00000318560.6	835	838	+	3	0	0	68
P00519-1#33	0	3	3	P00519-1	675	678	+	3	P00519-1	78	3390	ENST00000372348.9	1412	4724	++	48	P00519-1#33	0	3	ENST00000372348.9	2009	2012	+	3	0	0	69
P00519-1#33	0	3	3	P00519-1	675	678	+	3	P00519-1	0	3390	ENST00000318560.6	193	3583	++	24	P00519-1#33	0	3	ENST00000318560.6	868	871	+	3	0	0	70
P00519-1#34	0	3	3	P00519-1	684	687	+	3	P00519-1	78	3390	ENST00000372348.9	1412	4724	++	48	P00519-1#34	0	3	ENST00000372348.9	2018	2021	+	3	0	0	71
P00519-1#34	0	3	3	P00519-1	684	687	+	3	P00519-1	0	3390	ENST00000318560.6	193	3583	++	24	P00519-1#34	0	3	ENST00000318560.6	877	880	+	3	0	0	72
P00519-1#35	0	3	3	P00519-1	756	759	+	3	P00519-1	78	3390	ENST00000372348.9	1412	4724	++	48	P00519-1#35	0	3	ENST00000372348.9	2090	2093	+	3	0	0	73
P00519-1#35	0	3	3	P00519-1	756	759	+	3	P00519-1	0	3390	ENST00000318560.6	193	3583	++	24	P00519-1#35	0	3	ENST00000318560.6	949	952	+	3	0	0	74
P00519-1#36	0	3	3	P00519-1	768	771	+	3	P00519-1	78	3390	ENST00000372348.9	1412	4724	++	48	P00519-1#36	0	3	ENST00000372348.9	2102	2105	+	3	0	0	75
P00519-1#36	0	3	3	P00519-1	768	771	+	3	P00519-1	0	3390	ENST00000318560.6	193	3583	++	24	P00519-1#36	0	3	ENST00000318560.6	961	964	+	3	0	0	76
P00519-1#37	0	3	3	P00519-1	1176	1179	+	3	P00519-1	78	3390	ENST00000372348.9	1412	4724	++	48	P00519-1#37	0	3	ENST00000372348.9	2510	2513	+	3	0	0	77
P00519-1#37	0	3	3	P00519-1	1176	1179	+	3	P00519-1	0	3390	ENST00000318560.6	193	3583	++	24	P00519-1#37	0	3	ENST00000318560.6	1369	1372	+	3	0	0	78
P00519-1#38	0	3	3	P00519-1	1236	1239	+	3	P00519-1	78	3390	ENST00000372348.9	1412	4724	++	48	P00519-1#38	0	3	ENST00000372348.9	2570	2573	+	3	0	0	79
P00519-1#38	0	3	3	P00519-1	1236	1239	+	3	P00519-1	0	3390	ENST00000318560.6	193	3583	++	24	P00519-1#38	0	3	ENST00000318560.6	1429	1432	+	3	0	0	80
P00519-1#39	0	3	3	P00519-1	1335	1338	+	3	P00519-1	78	3390	ENST00000372348.9	1412	4724	++	48	P00519-1#39	0	3	ENST00000372348.9	2669	2672	+	3	0	0	81
P00519-1#39	0	3	3	P00519-1	1335	1338	+	3	P00519-1	0	3390	ENST00000318560.6	193	3583	++	24	P00519-1#39	0	3	ENST00000318560.6	1528	1531	+	3	0	0	82
P00519-1#40	0	3	3	P00519-1	1674	1677	+	3	P00519-1	78	3390	ENST00000372348.9	1412	4724	++	48	P00519-1#40	0	3	ENST00000372348.9	3008	3011	+	3	0	0	83
P00519-1#40	0	3	3	P00519-1	1674	1677	+	3	P00519-1	0	3390	ENST00000318560.6	193	3583	++	24	P00519-1#40	0	3	ENST00000318560.6	1867	1870	+	3	0	0	84
P00519-1#41	0	3	3	P00519-1	1704	1707	+	3	P00519-1	78	3390	ENST00000372348.9	1412	4724	++	48	P00519-1#41	0	3	ENST00000372348.9	3038	3041	+	3	0	0	85
P00519-1#41	0	3	3	P00519-1	1704	1707	+	3	P00519-1	0	3390	ENST00000318560.6	193	3583	++	24	P00519-1#41	0	3	ENST00000318560.6	1897	1900	+	3	0	0	86
P00519-1#42	0	3	3	P00519-1	1851	1854	+	3	P00519-1	78	3390	ENST00000372348.9	1412	4724	++	48	P00519-1#42	0	3	ENST00000372348.9	3185	3188	+	3	0	0	87
P00519-1#42	0	3	3	P00519-1	1851	1854	+	3	P00519-1	0	3390	ENST00000318560.6	193	3583	++	24	P00519-1#42	0	3	ENST00000318560.6	2044	2047	+	3	0	0	88
P00519-1#43	0	3	3	P00519-1	1854	1857	+	3	P00519-1	78	3390	ENST00000372348.9	1412	4724	++	48	P00519-1#43	0	3	ENST00000372348.9	3188	3191	+	3	0	0	89
P00519-1#43	0	3	3	P00519-1	1854	1857	+	3	P00519-1	0	3390	ENST00000318560.6	193	3583	++	24	P00519-1#43	0	3	ENST00000318560.6	2047	2050	+	3	0	0	90
P00519-1#44	0	3	3	P00519-1	1857	1860	+	3	P00519-1	78	3390	ENST00000372348.9	1412	4724	++	48	P00519-1#44	0	3	ENST00000372348.9	3191	3194	+	3	0	0	91
P00519-1#44	0	3	3	P00519-1	1857	1860	+	3	P00519-1	0	3390	ENST00000318560.6	193	3583	++	24	P00519-1#44	0	3	ENST00000318560.6	2050	2053	+	3	0	0	92
P00519-1#45	0	3	3	P00519-1	1974	1977	+	3	P00519-1	78	3390	ENST00000372348.9	1412	4724	++	48	P00519-1#45	0	3	ENST00000372348.9	3308	3311	+	3	0	0	93
P00519-1#45	0	3	3	P00519-1	1974	1977	+	3	P00519-1	0	3390	ENST00000318560.6	193	3583	++	24	P00519-1#45	0	3	ENST00000318560.6	2167	2170	+	3	0	0	94
P00519-1#46	0	3	3	P00519-1	2046	2049	+	3	P00519-1	78	3390	ENST00000372348.9	1412	4724	++	48	P00519-1#46	0	3	ENST00000372348.9	3380	3383	+	3	0	0	95
P00519-1#46	0	3	3	P00519-1	2046	2049	+	3	P00519-1	0	3390	ENST00000318560.6	193	3583	++	24	P00519-1#46	0	3	ENST00000318560.6	2239	2242	+	3	0	0	96
P00519-1#47	0	3	3	P00519-1	2130	2133	+	3	P00519-1	78	3390	ENST00000372348.9	1412	4724	++	48	P00519-1#47	0	3	ENST00000372348.9	3464	3467	+	3	0	0	97
P00519-1#47	0	3	3	P00519-1	2130	2133	+	3	P00519-1	0	3390	ENST00000318560.6	193	3583	++	24	P00519-1#47	0	3	ENST00000318560.6	2323	2326	+	3	0	0	98
P00519-1#48	0	3	3	P00519-1	2151	2154	+	3	P00519-1	78	3390	ENST00000372348.9	1412	4724	++	48	P00519-1#48	0	3	ENST00000372348.9	3485	3488	+	3	0	0	99
P00519-1#48	0	3	3	P00519-1	2151	2154	+	3	P00519-1	0	3390	ENST00000318560.6	193	3583	++	24	P00519-1#48	0	3	ENST00000318560.6	2344	2347	+	3	0	0	100
P00519-1#49	0	3	3	P00519-1	2202	2205	+	3	P00519-1	78	3390	ENST00000372348.9	1412	4724	++	48	P00519-1#49	0	3	ENST00000372348.9	3536	3539	+	3	0	0	101
P00519-1#49	0	3	3	P00519-1	2202	2205	+	3	P00519-1	0	3390	ENST00000318560.6	193	3583	++	24	P00519-1#49	0	3	ENST00000318560.6	2395	2398	+	3	0	0	102
P00519-1#50	0	3	3	P00519-1	2250	2253	+	3	P00519-1	78	3390	ENST00000372348.9	1412	4724	++	48	P00519-1#50	0	3	ENST00000372348.9	3584	3587	+	3	0	0	103
P00519-1#50	0	3	3	P00519-1	2250	2253	+	3	P00519-1	0	3390	ENST00000318560.6	193	3583	++	24	P00519-1#50	0	3	ENST00000318560.6	2443	2446	+	3	0	0	104
P00519-1#51	0	3	3	P00519-1	2340	2343	+	3	P00519-1	78	3390	ENST00000372348.9	1412	4724	++	48	P00519-1#51	0	3	ENST00000372348.9	3674	3677	+	3	0	0	105
P00519-1#51	0	3	3	P00519-1	2340	2343	+	3	P00519-1	0	3390	ENST00000318560.6	193	3583	++	24	P00519-1#51	0	3	ENST00000318560.6	2533	2536	+	3	0	0	106
P00519-1#52	0	3	3	P00519-1	2439	2442	+	3	P00519-1	78	3390	ENST00000372348.9	1412	4724	++	48	P00519-1#52	0	3	ENST00000372348.9	3773	3776	+	3	0	0	107
P00519-1#52	0	3	3	P00519-1	2439	2442	+	3	P00519-1	0	3390	ENST00000318560.6	193	3583	++	24	P00519-1#52	0	3	ENST00000318560.6	2632	2635	+	3	0	0	108
P00519-1#53	0	3	3	P00519-1	2466	2469	+	3	P00519-1	78	3390	ENST00000372348.9	1412	4724	++	48	P00519-1#53	0	3	ENST00000372348.9	3800	3803	+	3	0	0	109
P00519-1#53	0	3	3	P00519-1	2466	2469	+	3	P00519-1	0	3390	ENST00000318560.6	193	3583	++	24	P00519-1#53	0	3	ENST00000318560.6	2659	2662	+	3	0	0	110
P00519-1#54	0	3	3	P00519-1	2529	2532	+	3	P00519-1	78	3390	ENST00000372348.9	1412	4724	++	48	P00519-1#54	0	3	ENST00000372348.9	3863	3866	+	3	0	0	111
P00519-1#54	0	3	3	P00519-1	2529	2532	+	3	P00519-1	0	3390	ENST00000318560.6	193	3583	++	24	P00519-1#54	0	3	ENST00000318560.6	2722	2725	+	3	0	0	112
P00519-1#55	0	3	3	P00519-1	2553	2556	+	3	P00519-1	78	3390	ENST00000372348.9	1412	4724	++	48	P00519-1#55	0	3	ENST00000372348.9	3887	3890	+	3	0	0	113
P00519-1#55	0	3	3	P00519-1	2553	2556	+	3	P00519-1	0	3390	ENST00000318560.6	193	3583	++	24	P00519-1#55	0	3	ENST00000318560.6	2746	2749	+	3	0	0	114
P00519-1#56	0	3	3	P00519-1	2562	2565	+	3	P00519-1	78	3390	ENST00000372348.9	1412	4724	++	48	P00519-1#56	0	3	ENST00000372348.9	3896	3899	+	3	0	0	115
P00519-1#56	0	3	3	P00519-1	2562	2565	+	3	P00519-1	0	3390	ENST00000318560.6	193	3583	++	24	P00519-1#56	0	3	ENST00000318560.6	2755	2758	+	3	0	0	116
P00519-1#57	0	3	3	P00519-1	2748	2751	+	3	P00519-1	78	3390	ENST00000372348.9	1412	4724	++	48	P00519-1#57	0	3	ENST00000372348.9	4082	4085	+	3	0	0	117
P00519-1#57	0	3	3	P00519-1	2748	2751	+	3	P00519-1	0	3390	ENST00000318560.6	193	3583	++	24	P00519-1#57	0	3	ENST00000318560.6	2941	2944	+	3	0	0	118
P00519-1#58	0	3	3	P00519-1	2928	2931	+	3	P00519-1	78	3390	ENST00000372348.9	1412	4724	++	48	P00519-1#58	0	3	ENST00000372348.9	4262	4265	+	3	0	0	119
P00519-1#58	0	3	3	P00519-1	2928	2931	+	3	P00519-1	0	3390	ENST00000318560.6	193	3583	++	24	P00519-1#58	0	3	ENST00000318560.6	3121	3124	+	3	0	0	120
P00519-1#59	0	78	78	P00519-1	0	78	+	78	P00519-1	0	3390	ENST00000318560.6	193	3583	++	24	P00519-1#59	0	78	ENST00000318560.6	193	271	+	78	0	0	121
P00519-1#60	0	3	3	P00519-1	138	141	+	3	P00519-1	78	3390	ENST00000372348.9	1412	4724	++	48	P00519-1#60	0	3	ENST00000372348.9	1472	1475	+	3	0	0	122
P00519-1#60	0	3	3	P00519-1	138	141	+	3	P00519-1	0	3390	ENST00000318560.6	193	3583	++	24	P00519-1#60	0	3	ENST00000318560.6	331	334	+	3	0	0	123
P00519-1#61	0	3	3	P00519-1	417	420	+	3	P00519-1	78	3390	ENST00000372348.9	1412	4724	++	48	P00519-1#61	0	3	ENST00000372348.9	1751	1754	+	3	0	0	124
P00519-1#61	0	3	3	P00519-1	417	420	+	3	P00519-1	0	3390	ENST00000318560.6	193	3583	++	24	P00519-1#61	0	3	ENST00000318560.6	610	613	+	3	0	0	125
P00519-1#62	0	3	3	P00519-1	495	498	+	3	P00519-1	78	3390	ENST00000372348.9	1412	4724	++	48	P00519-1#62	0	3	ENST00000372348.9	1829	1832	+	3	0	0	126
P00519-1#62	0	3	3	P00519-1	495	498	+	3	P00519-1	0	3390	ENST00000318560.6	193	3583	++	24	P00519-1#62	0	3	ENST00000318560.6	688	691	+	3	0	0	127
P00519-1#63	0	3	3	P00519-1	675	678	+	3	P00519-1	78	3390	ENST00000372348.9	1412	4724	++	48	P00519-1#63	0	3	ENST00000372348.9	2009	2012	+	3	0	0	128
P00519-1#63	0	3	3	P00519-1	675	678	+	3	P00519-1	0	3390	ENST00000318560.6	193	3583	++	24	P00519-1#63	0	3	ENST00000318560.6	868	871	+	3	0	0	129
P00519-1#64	0	3	3	P00519-1	738	741	+	3	P00519-1	78	3390	ENST00000372348.9	1412	4724	++	48	P00519-1#64	0	3	ENST00000372348.9	2072	2075	+	3	0	0	130
P00519-1#64	0	3	3	P00519-1	738	741	+	3	P00519-1	0	3390	ENST00000318560.6	193	3583	++	24	P00519-1#64	0	3	ENST00000318560.6	931	934	+	3	0	0	131
P00519-1#65	0	3	3	P00519-1	1008	1011	+	3	P00519-1	78	3390	ENST00000372348.9	1412	4724	++	48	P00519-1#65	0	3	ENST00000372348.9	2342	2345	+	3	0	0	132
P00519-1#65	0	3	3	P00519-1	1008	1011	+	3	P00519-1	0	3390	ENST00000318560.6	193	3583	++	24	P00519-1#65	0	3	ENST00000318560.6	1201	1204	+	3	0	0	133
P00519-1#66	0	3	3	P00519-1	2115	2118	+	3	P00519-1	78	3390	ENST00000372348.9	1412	4724	++	48	P00519-1#66	0	3	ENST00000372348.9	3449	3452	+	3	0	0	134
P00519-1#66	0	3	3	P00519-1	2115	2118	+	3	P00519-1	0	3390	ENST00000318560.6	193	3583	++	24	P00519-1#66	0	3	ENST00000318560.6	2308	2311	+	3	0	0	135
P00519-1#67	0	3	3	P00519-1	2427	2430	+	3	P00519-1	78	3390	ENST00000372348.9	1412	4724	++	48	P00519-1#67	0	3	ENST00000372348.9	3761	3764	+	3	0	0	136
P00519-1#67	0	3	3	P00519-1	2427	2430	+	3	P00519-1	0	3390	ENST00000318560.6	193	3583	++	24	P00519-1#67	0	3	ENST00000318560.6	2620	2623	+	3	0	0	137
P00519-1#68	0	3	3	P00519-1	2553	2556	+	3	P00519-1	78	3390	ENST00000372348.9	1412	4724	++	48	P00519-1#68	0	3	ENST00000372348.9	3887	3890	+	3	0	0	138
P00519-1#68	0	3	3	P00519-1	2553	2556	+	3	P00519-1	0	3390	ENST00000318560.6	193	3583	++	24	P00519-1#68	0	3	ENST00000318560.6	2746	2749	+	3	0	0	139
P00519-1#69	0	3	3	P00519-1	2697	2700	+	3	P00519-1	78	3390	ENST00000372348.9	1412	4724	++	48	P00519-1#69	0	3	ENST00000372348.9	4031	4034	+	3	0	0	140
P00519-1#69	0	3	3	P00519-1	2697	2700	+	3	P00519-1	0	3390	ENST00000318560.6	193	3583	++	24	P00519-1#69	0	3	ENST00000318560.6	2890	2893	+	3	0	0	141
P00519-1#70	0	3	3	P00519-1	2901	2904	+	3	P00519-1	78	3390	ENST00000372348.9	1412	4724	++	48	P00519-1#70	0	3	ENST00000372348.9	4235	4238	+	3	0	0	142
P00519-1#70	0	3	3	P00519-1	2901	2904	+	3	P00519-1	0	3390	ENST00000318560.6	193	3583	++	24	P00519-1#70	0	3	ENST00000318560.6	3094	3097	+	3	0	0	143
P00519-1#71	0	3	3	P00519-1	2913	2916	+	3	P00519-1	78	3390	ENST00000372348.9	1412	4724	++	48	P00519-1#71	0	3	ENST00000372348.9	4247	4250	+	3	0	0	144
P00519-1#71	0	3	3	P00519-1	2913	2916	+	3	P00519-1	0	3390	ENST00000318560.6	193	3583	++	24	P00519-1#71	0	3	ENST00000318560.6	3106	3109	+	3	0	0	145
P00519-1#72	0	3	3	P00519-1	2202	2205	+	3	P00519-1	78	3390	ENST00000372348.9	1412	4724	++	48	P00519-1#72	0	3	ENST00000372348.9	3536	3539	+	3	0	0	146
P00519-1#72	0	3	3	P00519-1	2202	2205	+	3	P00519-1	0	3390	ENST00000318560.6	193	3583	++	24	P00519-1#72	0	3	ENST00000318560.6	2395	2398	+	3	0	0	147
P00519-1#73	0	3	3	P00519-1	474	477	+	3	P00519-1	78	3390	ENST00000372348.9	1412	4724	++	48	P00519-1#73	0	3	ENST00000372348.9	1808	1811	+	3	0	0	148
P00519-1#73	0	3	3	P00519-1	474	477	+	3	P00519-1	0	3390	ENST00000318560.6	193	3583	++	24	P00519-1#73	0	3	ENST00000318560.6	667	670	+	3	0	0	149
P00519-1#74	0	6	6	P00519-1	1269	1275	+	6	P00519-1	78	3390	ENST00000372348.9	1412	4724	++	48	P00519-1#74	0	6	ENST00000372348.9	2603	2609	+	6	0	0	150
P00519-1#74	0	6	6	P00519-1	1269	1275	+	6	P00519-1	0	3390	ENST00000318560.6	193	3583	++	24	P00519-1#74	0	6	ENST00000318560.6	1462	1468	+	6	0	0	151
P00519-1#75	0	3	3	P00519-1	1332	1335	+	3	P00519-1	78	3390	ENST00000372348.9	1412	4724	++	48	P00519-1#75	0	3	ENST00000372348.9	2666	2669	+	3	0	0	152
P00519-1#75	0	3	3	P00519-1	1332	1335	+	3	P00519-1	0	3390	ENST00000318560.6	193	3583	++	24	P00519-1#75	0	3	ENST00000318560.6	1525	1528	+	3	0	0	153
P00519-1#76	0	3	3	P00519-1	1374	1377	+	3	P00519-1	78	3390	ENST00000372348.9	1412	4724	++	48	P00519-1#76	0	3	ENST00000372348.9	2708	2711	+	3	0	0	154
P00519-1#76	0	3	3	P00519-1	1374	1377	+	3	P00519-1	0	3390	ENST00000318560.6	193	3583	++	24	P00519-1#76	0	3	ENST00000318560.6	1567	1570	+	3	0	0	155
P00519-1#77	0	3	3	P00519-1	1557	1560	+	3	P00519-1	78	3390	ENST00000372348.9	1412	4724	++	48	P00519-1#77	0	3	ENST00000372348.9	2891	2894	+	3	0	0	156
P00519-1#77	0	3	3	P00519-1	1557	1560	+	3	P00519-1	0	3390	ENST00000318560.6	193	3583	++	24	P00519-1#77	0	3	ENST00000318560.6	1750	1753	+	3	0	0	157
P00519-1#78	0	3	3	P00519-1	2154	2157	+	3	P00519-1	78	3390	ENST00000372348.9	1412	4724	++	48	P00519-1#78	0	3	ENST00000372348.9	3488	3491	+	3	0	0	158
P00519-1#78	0	3	3	P00519-1	2154	2157	+	3	P00519-1	0	3390	ENST00000318560.6	193	3583	++	24	P00519-1#78	0	3	ENST00000318560.6	2347	2350	+	3	0	0	159
P00519-1#79	0	3	3	P00519-1	2508	2511	+	3	P00519-1	78	3390	ENST00000372348.9	1412	4724	++	48	P00519-1#79	0	3	ENST00000372348.9	3842	3845	+	3	0	0	160
P00519-1#79	0	3	3	P00519-1	2508	2511	+	3	P00519-1	0	3390	ENST00000318560.6	193	3583	++	24	P00519-1#79	0	3	ENST00000318560.6	2701	2704	+	3	0	0	161
P00519-1#80	0	3	3	P00519-1	2508	2511	+	3	P00519-1	78	3390	ENST00000372348.9	1412	4724	++	48	P00519-1#80	0	3	ENST00000372348.9	3842	3845	+	3	0	0	162
P00519-1#80	0	3	3	P00519-1	2508	2511	+	3	P00519-1	0	3390	ENST00000318560.6	193	3583	++	24	P00519-1#80	0	3	ENST00000318560.6	2701	2704	+	3	0	0	163
P00519-1#81	0	3	3	P00519-1	2586	2589	+	3	P00519-1	78	3390	ENST00000372348.9	1412	4724	++	48	P00519-1#81	0	3	ENST00000372348.9	3920	3923	+	3	0	0	164
P00519-1#81	0	3	3	P00519-1	2586	2589	+	3	P00519-1	0	3390	ENST00000318560.6	193	3583	++	24	P00519-1#81	0	3	ENST00000318560.6	2779	2782	+	3	0	0	165
P00519-1#82	0	3	3	P00519-1	2679	2682	+	3	P00519-1	78	3390	ENST00000372348.9	1412	4724	++	48	P00519-1#82	0	3	ENST00000372348.9	4013	4016	+	3	0	0	166
P00519-1#82	0	3	3	P00519-1	2679	2682	+	3	P00519-1	0	3390	ENST00000318560.6	193	3583	++	24	P00519-1#82	0	3	ENST00000318560.6	2872	2875	+	3	0	0	167
P00519-1#83	0	9	9	P00519-1	2748	2757	+	9	P00519-1	78	3390	ENST00000372348.9	1412	4724	++	48	P00519-1#83	0	9	ENST00000372348.9	4082	4091	+	9	0	0	168
P00519-1#83	0	9	9	P00519-1	2748	2757	+	9	P00519-1	0	3390	ENST00000318560.6	193	3583	++	24	P00519-1#83	0	9	ENST00000318560.6	2941	2950	+	9	0	0	169
P00519-1#84	0	3	3	P00519-1	2853	2856	+	3	P00519-1	78	3390	ENST00000372348.9	1412	4724	++	48	P00519-1#84	0	3	ENST00000372348.9	4187	4190	+	3	0	0	170
P00519-1#84	0	3	3	P00519-1	2853	2856	+	3	P00519-1	0	3390	ENST00000318560.6	193	3583	++	24	P00519-1#84	0	3	ENST00000318560.6	3046	3049	+	3	0	0	171
P00519-1#85	0	6	6	P00519-1	2898	2904	+	6	P00519-1	78	3390	ENST00000372348.9	1412	4724	++	48	P00519-1#85	0	6	ENST00000372348.9	4232	4238	+	6	0	0	172
P00519-1#85	0	6	6	P00519-1	2898	2904	+	6	P00519-1	0	3390	ENST00000318560.6	193	3583	++	24	P00519-1#85	0	6	ENST00000318560.6	3091	3097	+	6	0	0	173
P00519-1#86	0	3	3	P00519-1	2943	2946	+	3	P00519-1	78	3390	ENST00000372348.9	1412	4724	++	48	P00519-1#86	0	3	ENST00000372348.9	4277	4280	+	3	0	0	174
P00519-1#86	0	3	3	P00519-1	2943	2946	+	3	P00519-1	0	3390	ENST00000318560.6	193	3583	++	24	P00519-1#86	0	3	ENST00000318560.6	3136	3139	+	3	0	0	175
P00519-1#87	0	3	3	P00519-1	3063	3066	+	3	P00519-1	78	3390	ENST00000372348.9	1412	4724	++	48	P00519-1#87	0	3	ENST00000372348.9	4397	4400	+	3	0	0	176
P00519-1#87	0	3	3	P00519-1	3063	3066	+	3	P00519-1	0	3390	ENST00000318560.6	193	3583	++	24	P00519-1#87	0	3	ENST00000318560.6	3256	3259	+	3	0	0	177
P00519-1#88	0	3	3	P00519-1	3132	3135	+	3	P00519-1	78	3390	ENST00000372348.9	1412	4724	++	48	P00519-1#88	0	3	ENST00000372348.9	4466	4469	+	3	0	0	178
P00519-1#88	0	3	3	P00519-1	3132	3135	+	3	P00519-1	0	3390	ENST00000318560.6	193	3583	++	24	P00519-1#88	0	3	ENST00000318560.6	3325	3328	+	3	0	0	179
P00519-1#89	0	3	3	P00519-1	3306	3309	+	3	P00519-1	78	3390	ENST00000372348.9	1412	4724	++	48	P00519-1#89	0	3	ENST00000372348.9	4640	4643	+	3	0	0	180
P00519-1#89	0	3	3	P00519-1	3306	3309	+	3	P00519-1	0	3390	ENST00000318560.6	193	3583	++	24	P00519-1#89	0	3	ENST00000318560.6	3499	3502	+	3	0	0	181
P00519-1#90	0	21	21	P00519-1	75	96	+	21	P00519-1	78	138	ENST00000393293.4	475	532	+	64	P00519-1#90	3	21	ENST00000393293.4	475	490	+	15	3	0	182
P00519-1#90	0	21	21	P00519-1	75	96	+	21	P00519-1	78	3390	ENST00000372348.9	1412	4724	++	48	P00519-1#90	3	21	ENST00000372348.9	1412	1430	+	18	3	0	183
P00519-1#90	0	21	21	P00519-1	75	96	+	21	P00519-1	0	3390	ENST00000318560.6	193	3583	++	24	P00519-1#90	0	21	ENST00000318560.6	268	289	+	21	0	0	184
P00519-1#91	0	18	18	P00519-1	114	132	+	18	P00519-1	78	138	ENST00000393293.4	475	532	+	64	P00519-1#91	0	18	ENST00000393293.4	508	526	+	18	0	0	185
P00519-1#91	0	18	18	P00519-1	114	132	+	18	P00519-1	78	3390	ENST00000372348.9	1412	4724	++	48	P00519-1#91	0	18	ENST00000372348.9	1448	1466	+	18	0	0	186
P00519-1#91	0	18	18	P00519-1	114	132	+	18	P00519-1	0	3390	ENST00000318560.6	193	3583	++	24	P00519-1#91	0	18	ENST00000318560.6	307	325	+	18	0	0	187
P00519-1#92	0	9	9	P00519-1	132	141	+	9	P00519-1	78	138	ENST00000393293.4	475	532	+	64	P00519-1#92	0	6	ENST00000393293.4	526	532	+	6	0	3	188
P00519-1#92	0	9	9	P00519-1	132	141	+	9	P00519-1	78	3390	ENST00000372348.9	1412	4724	++	48	P00519-1#92	0	9	ENST00000372348.9	1466	1475	+	9	0	0	189
P00519-1#92	0	9	9	P00519-1	132	141	+	9	P00519-1	0	3390	ENST00000318560.6	193	3583	++	24	P00519-1#92	0	9	ENST00000318560.6	325	334	+	9	0	0	190
P00519-1#93	0	15	15	P00519-1	144	159	+	15	P00519-1	78	3390	ENST00000372348.9	1412	4724	++	48	P00519-1#93	0	15	ENST00000372348.9	1478	1493	+	15	0	0	191
P00519-1#93	0	15	15	P00519-1	144	159	+	15	P00519-1	0	3390	ENST00000318560.6	193	3583	++	24	P00519-1#93	0	15	ENST00000318560.6	337	352	+	15	0	0	192
P00519-1#94	0	9	9	P00519-1	171	180	+	9	P00519-1	78	3390	ENST00000372348.9	1412	4724	++	48	P00519-1#94	0	9	ENST00000372348.9	1505	1514	+	9	0	0	193
P00519-1#94	0	9	9	P00519-1	171	180	+	9	P00519-1	0	3390	ENST00000318560.6	193	3583	++	24	P00519-1#94	0	9	ENST00000318560.6	364	373	+	9	0	0	194
P00519-1#95	0	18	18	P00519-1	192	210	+	18	P00519-1	78	3390	ENST00000372348.9	1412	4724	++	48	P00519-1#95	0	18	ENST00000372348.9	1526	1544	+	18	0	0	195
P00519-1#95	0	18	18	P00519-1	192	210	+	18	P00519-1	0	3390	ENST00000318560.6	193	3583	++	24	P00519-1#95	0	18	ENST00000318560.6	385	403	+	18	0	0	196
P00519-1#96	0	12	12	P00519-1	225	237	+	12	P00519-1	78	3390	ENST00000372348.9	1412	4724	++	48	P00519-1#96	0	12	ENST00000372348.9	1559	1571	+	12	0	0	197
P00519-1#96	0	12	12	P00519-1	225	237	+	12	P00519-1	0	3390	ENST00000318560.6	193	3583	++	24	P00519-1#96	0	12	ENST00000318560.6	418	430	+	12	0	0	198
P00519-1#97	0	21	21	P00519-1	258	279	+	21	P00519-1	78	3390	ENST00000372348.9	1412	4724	++	48	P00519-1#97	0	21	ENST00000372348.9	1592	1613	+	21	0	0	199
P00519-1#97	0	21	21	P00519-1	258	279	+	21	P00519-1	0	3390	ENST00000318560.6	193	3583	++	24	P00519-1#97	0	21	ENST00000318560.6	451	472	+	21	0	0	200
P00519-1#98	0	24	24	P00519-1	288	312	+	24	P00519-1	78	3390	ENST00000372348.9	1412	4724	++	48	P00519-1#98	0	24	ENST00000372348.9	1622	1646	+	24	0	0	201
P00519-1#98	0	24	24	P00519-1	288	312	+	24	P00519-1	0	3390	ENST00000318560.6	193	3583	++	24	P00519-1#98	0	24	ENST00000318560.6	481	505	+	24	0	0	202
P00519-1#99	0	18	18	P00519-1	318	336	+	18	P00519-1	78	3390	ENST00000372348.9	1412	4724	++	48	P00519-1#99	0	18	ENST00000372348.9	1652	1670	+	18	0	0	203
P00519-1#99	0	18	18	P00519-1	318	336	+	18	P00519-1	0	3390	ENST00000318560.6	193	3583	++	24	P00519-1#99	0	18	ENST00000318560.6	511	529	+	18	0	0	204
P00519-1#100	0	9	9	P00519-1	336	345	+	9	P00519-1	78	3390	ENST00000372348.9	1412	4724	++	48	P00519-1#100	0	9	ENST00000372348.9	1670	1679	+	9	0	0	205
P00519-1#100	0	9	9	P00519-1	336	345	+	9	P00519-1	0	3390	ENST00000318560.6	193	3583	++	24	P00519-1#100	0	9	ENST00000318560.6	529	538	+	9	0	0	206
P00519-1#101	0	9	9	P00519-1	345	354	+	9	P00519-1	78	3390	ENST00000372348.9	1412	4724	++	48	P00519-1#101	0	9	ENST00000372348.9	1679	1688	+	9	0	0	207
P00519-1#101	0	9	9	P00519-1	345	354	+	9	P00519-1	0	3390	ENST00000318560.6	193	3583	++	24	P00519-1#101	0	9	ENST00000318560.6	538	547	+	9	0	0	208
P00519-1#102	0	9	9	P00519-1	363	372	+	9	P00519-1	78	3390	ENST00000372348.9	1412	4724	++	48	P00519-1#102	0	9	ENST00000372348.9	1697	1706	+	9	0	0	209
P00519-1#102	0	9	9	P00519-1	363	372	+	9	P00519-1	0	3390	ENST00000318560.6	193	3583	++	24	P00519-1#102	0	9	ENST00000318560.6	556	565	+	9	0	0	210
P00519-1#103	0	12	12	P00519-1	381	393	+	12	P00519-1	78	3390	ENST00000372348.9	1412	4724	++	48	P00519-1#103	0	12	ENST00000372348.9	1715	1727	+	12	0	0	211
P00519-1#103	0	12	12	P00519-1	381	393	+	12	P00519-1	0	3390	ENST00000318560.6	193	3583	++	24	P00519-1#103	0	12	ENST00000318560.6	574	586	+	12	0	0	212
P00519-1#104	0	21	21	P00519-1	399	420	+	21	P00519-1	78	3390	ENST00000372348.9	1412	4724	++	48	P00519-1#104	0	21	ENST00000372348.9	1733	1754	+	21	0	0	213
P00519-1#104	0	21	21	P00519-1	399	420	+	21	P00519-1	0	3390	ENST00000318560.6	193	3583	++	24	P00519-1#104	0	21	ENST00000318560.6	592	613	+	21	0	0	214
P00519-1#105	0	9	9	P00519-1	420	429	+	9	P00519-1	78	3390	ENST00000372348.9	1412	4724	++	48	P00519-1#105	0	9	ENST00000372348.9	1754	1763	+	9	0	0	215
P00519-1#105	0	9	9	P00519-1	420	429	+	9	P00519-1	0	3390	ENST00000318560.6	193	3583	++	24	P00519-1#105	0	9	ENST00000318560.6	613	622	+	9	0	0	216
P00519-1#106	0	18	18	P00519-1	441	459	+	18	P00519-1	78	3390	ENST00000372348.9	1412	4724	++	48	P00519-1#106	0	18	ENST00000372348.9	1775	1793	+	18	0	0	217
P00519-1#106	0	18	18	P00519-1	441	459	+	18	P00519-1	0	3390	ENST00000318560.6	193	3583	++	24	P00519-1#106	0	18	ENST00000318560.6	634	652	+	18	0	0	218
P00519-1#107	0	9	9	P00519-1	462	471	+	9	P00519-1	78	3390	ENST00000372348.9	1412	4724	++	48	P00519-1#107	0	9	ENST00000372348.9	1796	1805	+	9	0	0	219
P00519-1#107	0	9	9	P00519-1	462	471	+	9	P00519-1	0	3390	ENST00000318560.6	193	3583	++	24	P00519-1#107	0	9	ENST00000318560.6	655	664	+	9	0	0	220
P00519-1#108	0	21	21	P00519-1	480	501	+	21	P00519-1	78	3390	ENST00000372348.9	1412	4724	++	48	P00519-1#108	0	21	ENST00000372348.9	1814	1835	+	21	0	0	221
P00519-1#108	0	21	21	P00519-1	480	501	+	21	P00519-1	0	3390	ENST00000318560.6	193	3583	++	24	P00519-1#108	0	21	ENST00000318560.6	673	694	+	21	0	0	222
P00519-1#109	0	18	18	P00519-1	507	525	+	18	P00519-1	78	3390	ENST00000372348.9	1412	4724	++	48	P00519-1#109	0	18	ENST00000372348.9	1841	1859	+	18	0	0	223
P00519-1#109	0	18	18	P00519-1	507	525	+	18	P00519-1	0	3390	ENST00000318560.6	193	3583	++	24	P00519-1#109	0	18	ENST00000318560.6	700	718	+	18	0	0	224
P00519-1#110	0	9	9	P00519-1	528	537	+	9	P00519-1	78	3390	ENST00000372348.9	1412	4724	++	48	P00519-1#110	0	9	ENST00000372348.9	1862	1871	+	9	0	0	225
P00519-1#110	0	9	9	P00519-1	528	537	+	9	P00519-1	0	3390	ENST00000318560.6	193	3583	++	24	P00519-1#110	0	9	ENST00000318560.6	721	730	+	9	0	0	226
P00519-1#111	0	9	9	P00519-1	537	546	+	9	P00519-1	78	3390	ENST00000372348.9	1412	4724	++	48	P00519-1#111	0	9	ENST00000372348.9	1871	1880	+	9	0	0	227
P00519-1#111	0	9	9	P00519-1	537	546	+	9	P00519-1	0	3390	ENST00000318560.6	193	3583	++	24	P00519-1#111	0	9	ENST00000318560.6	730	739	+	9	0	0	228
P00519-1#112	0	12	12	P00519-1	549	561	+	12	P00519-1	78	3390	ENST00000372348.9	1412	4724	++	48	P00519-1#112	0	12	ENST00000372348.9	1883	1895	+	12	0	0	229
P00519-1#112	0	12	12	P00519-1	549	561	+	12	P00519-1	0	3390	ENST00000318560.6	193	3583	++	24	P00519-1#112	0	12	ENST00000318560.6	742	754	+	12	0	0	230
P00519-1#113	0	15	15	P00519-1	567	582	+	15	P00519-1	78	3390	ENST00000372348.9	1412	4724	++	48	P00519-1#113	0	15	ENST00000372348.9	1901	1916	+	15	0	0	231
P00519-1#113	0	15	15	P00519-1	567	582	+	15	P00519-1	0	3390	ENST00000318560.6	193	3583	++	24	P00519-1#113	0	15	ENST00000318560.6	760	775	+	15	0	0	232
P00519-1#114	0	24	24	P00519-1	582	606	+	24	P00519-1	78	3390	ENST00000372348.9	1412	4724	++	48	P00519-1#114	0	24	ENST00000372348.9	1916	1940	+	24	0	0	233
P00519-1#114	0	24	24	P00519-1	582	606	+	24	P00519-1	0	3390	ENST00000318560.6	193	3583	++	24	P00519-1#114	0	24	ENST00000318560.6	775	799	+	24	0	0	234
P00519-1#115	0	9	9	P00519-1	624	633	+	9	P00519-1	78	3390	ENST00000372348.9	1412	4724	++	48	P00519-1#115	0	9	ENST00000372348.9	1958	1967	+	9	0	0	235
P00519-1#115	0	9	9	P00519-1	624	633	+	9	P00519-1	0	3390	ENST00000318560.6	193	3583	++	24	P00519-1#115	0	9	ENST00000318560.6	817	826	+	9	0	0	236
P00519-1#116	0	9	9	P00519-1	675	684	+	9	P00519-1	78	3390	ENST00000372348.9	1412	4724	++	48	P00519-1#116	0	9	ENST00000372348.9	2009	2018	+	9	0	0	237
P00519-1#116	0	9	9	P00519-1	675	684	+	9	P00519-1	0	3390	ENST00000318560.6	193	3583	++	24	P00519-1#116	0	9	ENST00000318560.6	868	877	+	9	0	0	238
P00519-1#117	0	9	9	P00519-1	684	693	+	9	P00519-1	78	3390	ENST00000372348.9	1412	4724	++	48	P00519-1#117	0	9	ENST00000372348.9	2018	2027	+	9	0	0	239
P00519-1#117	0	9	9	P00519-1	684	693	+	9	P00519-1	0	3390	ENST00000318560.6	193	3583	++	24	P00519-1#117	0	9	ENST00000318560.6	877	886	+	9	0	0	240
P00519-1#118	0	9	9	P00519-1	696	705	+	9	P00519-1	78	3390	ENST00000372348.9	1412	4724	++	48	P00519-1#118	0	9	ENST00000372348.9	2030	2039	+	9	0	0	241
P00519-1#118	0	9	9	P00519-1	696	705	+	9	P00519-1	0	3390	ENST00000318560.6	193	3583	++	24	P00519-1#118	0	9	ENST00000318560.6	889	898	+	9	0	0	242
P00519-1#119	0	9	9	P00519-1	714	723	+	9	P00519-1	78	3390	ENST00000372348.9	1412	4724	++	48	P00519-1#119	0	9	ENST00000372348.9	2048	2057	+	9	0	0	243
P00519-1#119	0	9	9	P00519-1	714	723	+	9	P00519-1	0	3390	ENST00000318560.6	193	3583	++	24	P00519-1#119	0	9	ENST00000318560.6	907	916	+	9	0	0	244
P00519-1#120	0	18	18	P00519-1	723	741	+	18	P00519-1	78	3390	ENST00000372348.9	1412	4724	++	48	P00519-1#120	0	18	ENST00000372348.9	2057	2075	+	18	0	0	245
P00519-1#120	0	18	18	P00519-1	723	741	+	18	P00519-1	0	3390	ENST00000318560.6	193	3583	++	24	P00519-1#120	0	18	ENST00000318560.6	916	934	+	18	0	0	246
P00519-1#121	0	12	12	P00519-1	741	753	+	12	P00519-1	78	3390	ENST00000372348.9	1412	4724	++	48	P00519-1#121	0	12	ENST00000372348.9	2075	2087	+	12	0	0	247
P00519-1#121	0	12	12	P00519-1	741	753	+	12	P00519-1	0	3390	ENST00000318560.6	193	3583	++	24	P00519-1#121	0	12	ENST00000318560.6	934	946	+	12	0	0	248
P00519-1#122	0	24	24	P00519-1	759	783	+	24	P00519-1	78	3390	ENST00000372348.9	1412	4724	++	48	P00519-1#122	0	24	ENST00000372348.9	2093	2117	+	24	0	0	249
P00519-1#122	0	24	24	P00519-1	759	783	+	24	P00519-1	0	3390	ENST00000318560.6	193	3583	++	24	P00519-1#122	0	24	ENST00000318560.6	952	976	+	24	0	0	250
P00519-1#123	0	9	9	P00519-1	783	792	+	9	P00519-1	78	3390	ENST00000372348.9	1412	4724	++	48	P00519-1#123	0	9	ENST00000372348.9	2117	2126	+	9	0	0	251
P00519-1#123	0	9	9	P00519-1	783	792	+	9	P00519-1	0	3390	ENST00000318560.6	193	3583	++	24	P00519-1#123	0	9	ENST00000318560.6	976	985	+	9	0	0	252
P00519-1#124	0	18	18	P00519-1	795	813	+	18	P00519-1	78	3390	ENST00000372348.9	1412	4724	++	48	P00519-1#124	0	18	ENST00000372348.9	2129	2147	+	18	0	0	253
P00519-1#124	0	18	18	P00519-1	795	813	+	18	P00519-1	0	3390	ENST00000318560.6	193	3583	++	24	P00519-1#124	0	18	ENST00000318560.6	988	1006	+	18	0	0	254
P00519-1#125	0	9	9	P00519-1	822	831	+	9	P00519-1	78	3390	ENST00000372348.9	1412	4724	++	48	P00519-1#125	0	9	ENST00000372348.9	2156	2165	+	9	0	0	255
P00519-1#125	0	9	9	P00519-1	822	831	+	9	P00519-1	0	3390	ENST00000318560.6	193	3583	++	24	P00519-1#125	0	9	ENST00000318560.6	1015	1024	+	9	0	0	256
P00519-1#126	0	33	33	P00519-1	837	870	+	33	P00519-1	78	3390	ENST00000372348.9	1412	4724	++	48	P00519-1#126	0	33	ENST00000372348.9	2171	2204	+	33	0	0	257
P00519-1#126	0	33	33	P00519-1	837	870	+	33	P00519-1	0	3390	ENST00000318560.6	193	3583	++	24	P00519-1#126	0	33	ENST00000318560.6	1030	1063	+	33	0	0	258
P00519-1#127	0	15	15	P00519-1	900	915	+	15	P00519-1	78	3390	ENST00000372348.9	1412	4724	++	48	P00519-1#127	0	15	ENST00000372348.9	2234	2249	+	15	0	0	259
P00519-1#127	0	15	15	P00519-1	900	915	+	15	P00519-1	0	3390	ENST00000318560.6	193	3583	++	24	P00519-1#127	0	15	ENST00000318560.6	1093	1108	+	15	0	0	260
P00519-1#128	0	12	12	P00519-1	918	930	+	12	P00519-1	78	3390	ENST00000372348.9	1412	4724	++	48	P00519-1#128	0	12	ENST00000372348.9	2252	2264	+	12	0	0	261
P00519-1#128	0	12	12	P00519-1	918	930	+	12	P00519-1	0	3390	ENST00000318560.6	193	3583	++	24	P00519-1#128	0	12	ENST00000318560.6	1111	1123	+	12	0	0	262
P00519-1#129	0	15	15	P00519-1	933	948	+	15	P00519-1	78	3390	ENST00000372348.9	1412	4724	++	48	P00519-1#129	0	15	ENST00000372348.9	2267	2282	+	15	0	0	263
P00519-1#129	0	15	15	P00519-1	933	948	+	15	P00519-1	0	3390	ENST00000318560.6	193	3583	++	24	P00519-1#129	0	15	ENST00000318560.6	1126	1141	+	15	0	0	264
P00519-1#130	0	12	12	P00519-1	954	966	+	12	P00519-1	78	3390	ENST00000372348.9	1412	4724	++	48	P00519-1#130	0	12	ENST00000372348.9	2288	2300	+	12	0	0	265
P00519-1#130	0	12	12	P00519-1	954	966	+	12	P00519-1	0	3390	ENST00000318560.6	193	3583	++	24	P00519-1#130	0	12	ENST00000318560.6	1147	1159	+	12	0	0	266
P00519-1#131	0	21	21	P00519-1	966	987	+	21	P00519-1	78	3390	ENST00000372348.9	1412	4724	++	48	P00519-1#131	0	21	ENST00000372348.9	2300	2321	+	21	0	0	267
P00519-1#131	0	21	21	P00519-1	966	987	+	21	P00519-1	0	3390	ENST00000318560.6	193	3583	++	24	P00519-1#131	0	21	ENST00000318560.6	1159	1180	+	21	0	0	268
P00519-1#132	0	9	9	P00519-1	993	1002	+	9	P00519-1	78	3390	ENST00000372348.9	1412	4724	++	48	P00519-1#132	0	9	ENST00000372348.9	2327	2336	+	9	0	0	269
P00519-1#132	0	9	9	P00519-1	993	1002	+	9	P00519-1	0	3390	ENST00000318560.6	193	3583	++	24	P00519-1#132	0	9	ENST00000318560.6	1186	1195	+	9	0	0	270
P00519-1#133	0	60	60	P00519-1	1008	1068	+	60	P00519-1	78	3390	ENST00000372348.9	1412	4724	++	48	P00519-1#133	0	60	ENST00000372348.9	2342	2402	+	60	0	0	271
P00519-1#133	0	60	60	P00519-1	1008	1068	+	60	P00519-1	0	3390	ENST00000318560.6	193	3583	++	24	P00519-1#133	0	60	ENST00000318560.6	1201	1261	+	60	0	0	272
P00519-1#134	0	9	9	P00519-1	1074	1083	+	9	P00519-1	78	3390	ENST00000372348.9	1412	4724	++	48	P00519-1#134	0	9	ENST00000372348.9	2408	2417	+	9	0	0	273
P00519-1#134	0	9	9	P00519-1	1074	1083	+	9	P00519-1	0	3390	ENST00000318560.6	193	3583	++	24	P00519-1#134	0	9	ENST00000318560.6	1267	1276	+	9	0	0	274
P00519-1#135	0	9	9	P00519-1	1095	1104	+	9	P00519-1	78	3390	ENST00000372348.9	1412	4724	++	48	P00519-1#135	0	9	ENST00000372348.9	2429	2438	+	9	0	0	275
P00519-1#135	0	9	9	P00519-1	1095	1104	+	9	P00519-1	0	3390	ENST00000318560.6	193	3583	++	24	P00519-1#135	0	9	ENST00000318560.6	1288	1297	+	9	0	0	276
P00519-1#136	0	9	9	P00519-1	1104	1113	+	9	P00519-1	78	3390	ENST00000372348.9	1412	4724	++	48	P00519-1#136	0	9	ENST00000372348.9	2438	2447	+	9	0	0	277
P00519-1#136	0	9	9	P00519-1	1104	1113	+	9	P00519-1	0	3390	ENST00000318560.6	193	3583	++	24	P00519-1#136	0	9	ENST00000318560.6	1297	1306	+	9	0	0	278
P00519-1#137	0	9	9	P00519-1	1116	1125	+	9	P00519-1	78	3390	ENST00000372348.9	1412	4724	++	48	P00519-1#137	0	9	ENST00000372348.9	2450	2459	+	9	0	0	279
P00519-1#137	0	9	9	P00519-1	1116	1125	+	9	P00519-1	0	3390	ENST00000318560.6	193	3583	++	24	P00519-1#137	0	9	ENST00000318560.6	1309	1318	+	9	0	0	280
P00519-1#138	0	9	9	P00519-1	1128	1137	+	9	P00519-1	78	3390	ENST00000372348.9	1412	4724	++	48	P00519-1#138	0	9	ENST00000372348.9	2462	2471	+	9	0	0	281
P00519-1#138	0	9	9	P00519-1	1128	1137	+	9	P00519-1	0	3390	ENST00000318560.6	193	3583	++	24	P00519-1#138	0	9	ENST00000318560.6	1321	1330	+	9	0	0	282
P00519-1#139	0	9	9	P00519-1	1140	1149	+	9	P00519-1	78	3390	ENST00000372348.9	1412	4724	++	48	P00519-1#139	0	9	ENST00000372348.9	2474	2483	+	9	0	0	283
P00519-1#139	0	9	9	P00519-1	1140	1149	+	9	P00519-1	0	3390	ENST00000318560.6	193	3583	++	24	P00519-1#139	0	9	ENST00000318560.6	1333	1342	+	9	0	0	284
P00519-1#140	0	12	12	P00519-1	1149	1161	+	12	P00519-1	78	3390	ENST00000372348.9	1412	4724	++	48	P00519-1#140	0	12	ENST00000372348.9	2483	2495	+	12	0	0	285
P00519-1#140	0	12	12	P00519-1	1149	1161	+	12	P00519-1	0	3390	ENST00000318560.6	193	3583	++	24	P00519-1#140	0	12	ENST00000318560.6	1342	1354	+	12	0	0	286
P00519-1#141	0	9	9	P00519-1	1167	1176	+	9	P00519-1	78	3390	ENST00000372348.9	1412	4724	++	48	P00519-1#141	0	9	ENST00000372348.9	2501	2510	+	9	0	0	287
P00519-1#141	0	9	9	P00519-1	1167	1176	+	9	P00519-1	0	3390	ENST00000318560.6	193	3583	++	24	P00519-1#141	0	9	ENST00000318560.6	1360	1369	+	9	0	0	288
P00519-1#142	0	12	12	P00519-1	1176	1188	+	12	P00519-1	78	3390	ENST00000372348.9	1412	4724	++	48	P00519-1#142	0	12	ENST00000372348.9	2510	2522	+	12	0	0	289
P00519-1#142	0	12	12	P00519-1	1176	1188	+	12	P00519-1	0	3390	ENST00000318560.6	193	3583	++	24	P00519-1#142	0	12	ENST00000318560.6	1369	1381	+	12	0	0	290
P00519-1#143	0	9	9	P00519-1	1194	1203	+	9	P00519-1	78	3390	ENST00000372348.9	1412	4724	++	48	P00519-1#143	0	9	ENST00000372348.9	2528	2537	+	9	0	0	291
P00519-1#143	0	9	9	P00519-1	1194	1203	+	9	P00519-1	0	3390	ENST00000318560.6	193	3583	++	24	P00519-1#143	0	9	ENST00000318560.6	1387	1396	+	9	0	0	292
P00519-1#144	0	9	9	P00519-1	1206	1215	+	9	P00519-1	78	3390	ENST00000372348.9	1412	4724	++	48	P00519-1#144	0	9	ENST00000372348.9	2540	2549	+	9	0	0	293
P00519-1#144	0	9	9	P00519-1	1206	1215	+	9	P00519-1	0	3390	ENST00000318560.6	193	3583	++	24	P00519-1#144	0	9	ENST00000318560.6	1399	1408	+	9	0	0	294
P00519-1#145	0	18	18	P00519-1	1221	1239	+	18	P00519-1	78	3390	ENST00000372348.9	1412	4724	++	48	P00519-1#145	0	18	ENST00000372348.9	2555	2573	+	18	0	0	295
P00519-1#145	0	18	18	P00519-1	1221	1239	+	18	P00519-1	0	3390	ENST00000318560.6	193	3583	++	24	P00519-1#145	0	18	ENST00000318560.6	1414	1432	+	18	0	0	296
P00519-1#146	0	48	48	P00519-1	1251	1299	+	48	P00519-1	78	3390	ENST00000372348.9	1412	4724	++	48	P00519-1#146	0	48	ENST00000372348.9	2585	2633	+	48	0	0	297
P00519-1#146	0	48	48	P00519-1	1251	1299	+	48	P00519-1	0	3390	ENST00000318560.6	193	3583	++	24	P00519-1#146	0	48	ENST00000318560.6	1444	1492	+	48	0	0	298
P00519-1#147	0	9	9	P00519-1	1332	1341	+	9	P00519-1	78	3390	ENST00000372348.9	1412	4724	++	48	P00519-1#147	0	9	ENST00000372348.9	2666	2675	+	9	0	0	299
P00519-1#147	0	9	9	P00519-1	1332	1341	+	9	P00519-1	0	3390	ENST00000318560.6	193	3583	++	24	P00519-1#147	0	9	ENST00000318560.6	1525	1534	+	9	0	0	300
P00519-1#148	0	18	18	P00519-1	1341	1359	+	18	P00519-1	78	3390	ENST00000372348.9	1412	4724	++	48	P00519-1#148	0	18	ENST00000372348.9	2675	2693	+	18	0	0	301
P00519-1#148	0	18	18	P00519-1	1341	1359	+	18	P00519-1	0	3390	ENST00000318560.6	193	3583	++	24	P00519-1#148	0	18	ENST00000318560.6	1534	1552	+	18	0	0	302
P00519-1#149	0	30	30	P00519-1	1395	1425	+	30	P00519-1	78	3390	ENST00000372348.9	1412	4724	++	48	P00519-1#149	0	30	ENST00000372348.9	2729	2759	+	30	0	0	303
P00519-1#149	0	30	30	P00519-1	1395	1425	+	30	P00519-1	0	3390	ENST00000318560.6	193	3583	++	24	P00519-1#149	0	30	ENST00000318560.6	1588	1618	+	30	0	0	304
P00519-1#150	0	9	9	P00519-1	1437	1446	+	9	P00519-1	78	3390	ENST00000372348.9	1412	4724	++	48	P00519-1#150	0	9	ENST00000372348.9	2771	2780	+	9	0	0	305
P00519-1#150	0	9	9	P00519-1	1437	1446	+	9	P00519-1	0	3390	ENST00000318560.6	193	3583	++	24	P00519-1#150	0	9	ENST00000318560.6	1630	1639	+	9	0	0	306
P00519-1#151	0	33	33	P00519-1	1455	1488	+	33	P00519-1	78	3390	ENST00000372348.9	1412	4724	++	48	P00519-1#151	0	33	ENST00000372348.9	2789	2822	+	33	0	0	307
P00519-1#151	0	33	33	P00519-1	1455	1488	+	33	P00519-1	0	3390	ENST00000318560.6	193	3583	++	24	P00519-1#151	0	33	ENST00000318560.6	1648	1681	+	33	0	0	308
P00519-1#152	0	9	9	P00519-1	1491	1500	+	9	P00519-1	78	3390	ENST00000372348.9	1412	4724	++	48	P00519-1#152	0	9	ENST00000372348.9	2825	2834	+	9	0	0	309
P00519-1#152	0	9	9	P00519-1	1491	1500	+	9	P00519-1	0	3390	ENST00000318560.6	193	3583	++	24	P00519-1#152	0	9	ENST00000318560.6	1684	1693	+	9	0	0	310
P00519-1#153	0	12	12	P00519-1	1506	1518	+	12	P00519-1	78	3390	ENST00000372348.9	1412	4724	++	48	P00519-1#153	0	12	ENST00000372348.9	2840	2852	+	12	0	0	311
P00519-1#153	0	12	12	P00519-1	1506	1518	+	12	P00519-1	0	3390	ENST00000318560.6	193	3583	++	24	P00519-1#153	0	12	ENST00000318560.6	1699	1711	+	12	0	0	312
P00519-1#154	0	9	9	P00519-1	1527	1536	+	9	P00519-1	78	3390	ENST00000372348.9	1412	4724	++	48	P00519-1#154	0	9	ENST00000372348.9	2861	2870	+	9	0	0	313
P00519-1#154	0	9	9	P00519-1	1527	1536	+	9	P00519-1	0	3390	ENST00000318560.6	193	3583	++	24	P00519-1#154	0	9	ENST00000318560.6	1720	1729	+	9	0	0	314
P00519-1#155	0	51	51	P00519-1	3084	3135	+	51	P00519-1	78	3390	ENST00000372348.9	1412	4724	++	48	P00519-1#155	0	51	ENST00000372348.9	4418	4469	+	51	0	0	315
P00519-1#155	0	51	51	P00519-1	3084	3135	+	51	P00519-1	0	3390	ENST00000318560.6	193	3583	++	24	P00519-1#155	0	51	ENST00000318560.6	3277	3328	+	51	0	0	316
P00519-1#156	0	9	9	P00519-1	3135	3144	+	9	P00519-1	78	3390	ENST00000372348.9	1412	4724	++	48	P00519-1#156	0	9	ENST00000372348.9	4469	4478	+	9	0	0	317
P00519-1#156	0	9	9	P00519-1	3135	3144	+	9	P00519-1	0	3390	ENST00000318560.6	193	3583	++	24	P00519-1#156	0	9	ENST00000318560.6	3328	3337	+	9	0	0	318
P00519-1#157	0	54	54	P00519-1	3156	3210	+	54	P00519-1	78	3390	ENST00000372348.9	1412	4724	++	48	P00519-1#157	0	54	ENST00000372348.9	4490	4544	+	54	0	0	319
P00519-1#157	0	54	54	P00519-1	3156	3210	+	54	P00519-1	0	3390	ENST00000318560.6	193	3583	++	24	P00519-1#157	0	54	ENST00000318560.6	3349	3403	+	54	0	0	320
P00519-1#158	0	9	9	P00519-1	3210	3219	+	9	P00519-1	78	3390	ENST00000372348.9	1412	4724	++	48	P00519-1#158	0	9	ENST00000372348.9	4544	4553	+	9	0	0	321
P00519-1#158	0	9	9	P00519-1	3210	3219	+	9	P00519-1	0	3390	ENST00000318560.6	193	3583	++	24	P00519-1#158	0	9	ENST00000318560.6	3403	3412	+	9	0	0	322
P00519-1#159	0	54	54	P00519-1	3237	3291	+	54	P00519-1	78	3390	ENST00000372348.9	1412	4724	++	48	P00519-1#159	0	54	ENST00000372348.9	4571	4625	+	54	0	0	323
P00519-1#159	0	54	54	P00519-1	3237	3291	+	54	P00519-1	0	3390	ENST00000318560.6	193	3583	++	24	P00519-1#159	0	54	ENST00000318560.6	3430	3484	+	54	0	0	324
P00519-1#160	0	12	12	P00519-1	3300	3312	+	12	P00519-1	78	3390	ENST00000372348.9	1412	4724	++	48	P00519-1#160	0	12	ENST00000372348.9	4634	4646	+	12	0	0	325
P00519-1#160	0	12	12	P00519-1	3300	3312	+	12	P00519-1	0	3390	ENST00000318560.6	193	3583	++	24	P00519-1#160	0	12	ENST00000318560.6	3493	3505	+	12	0	0	326
P00519-1#161	0	9	9	P00519-1	3315	3324	+	9	P00519-1	78	3390	ENST00000372348.9	1412	4724	++	48	P00519-1#161	0	9	ENST00000372348.9	4649	4658	+	9	0	0	327
P00519-1#161	0	9	9	P00519-1	3315	3324	+	9	P00519-1	0	3390	ENST00000318560.6	193	3583	++	24	P00519-1#161	0	9	ENST00000318560.6	3508	3517	+	9	0	0	328
P00519-1#162	0	42	42	P00519-1	3342	3384	+	42	P00519-1	78	3390	ENST00000372348.9	1412	4724	++	48	P00519-1#162	0	42	ENST00000372348.9	4676	4718	+	42	0	0	329
P00519-1#162	0	42	42	P00519-1	3342	3384	+	42	P00519-1	0	3390	ENST00000318560.6	193	3583	++	24	P00519-1#162	0	42	ENST00000318560.6	3535	3577	+	42	0	0	330
P00519-1#163	0	3	3	P00519-1	3	6	+	3	P00519-1	0	3390	ENST00000318560.6	193	3583	++	24	P00519-1#163	0	3	ENST00000318560.6	196	199	+	3	0	0	331
O95831-1#0	0	162	162	O95831-1	0	162	+	162	O95831-1	0	1839	ENST00000676436.1	34	1861	+	255	O95831-1#0	0	162	ENST00000676436.1	34	196	+	162	0	0	332
O95831-1#0	0	162	162	O95831-1	0	162	+	162	O95831-1	0	1839	ENST00000676328.1	56	1892	+	254	O95831-1#0	0	162	ENST00000676328.1	56	218	+	162	0	0	333
O95831-1#0	0	162	162	O95831-1	0	162	+	162	O95831-1	0	1839	ENST00000676229.1	223	2050	++	253	O95831-1#0	0	162	ENST00000676229.1	223	370	+	147	0	0	334
O95831-1#0	0	162	162	O95831-1	0	162	+	162	O95831-1	0	1839	ENST00000675857.1	82	1915	+	251	O95831-1#0	0	162	ENST00000675857.1	82	244	+	162	0	0	335
O95831-1#0	0	162	162	O95831-1	0	162	+	162	O95831-1	0	108	ENST00000675774.1	41	149	++	250	O95831-1#0	0	108	ENST00000675774.1	41	149	+	108	0	54	336
O95831-1#0	0	162	162	O95831-1	0	162	+	162	O95831-1	0	1839	ENST00000675427.1	89	1925	+	249	O95831-1#0	0	162	ENST00000675427.1	89	251	+	162	0	0	337
O95831-1#0	0	162	162	O95831-1	0	162	+	162	O95831-1	0	1762	ENST00000675240.1	169	1867	+	248	O95831-1#0	0	162	ENST00000675240.1	169	331	+	162	0	0	338
O95831-1#0	0	162	162	O95831-1	0	162	+	162	O95831-1	0	1839	ENST00000675092.1	90	1956	+	247	O95831-1#0	0	162	ENST00000675092.1	90	252	+	162	0	0	339
O95831-1#0	0	162	162	O95831-1	0	162	+	162	O95831-1	0	1839	ENST00000675050.1	71	1898	++	246	O95831-1#0	0	162	ENST00000675050.1	71	218	+	147	0	0	340
O95831-1#0	0	162	162	O95831-1	0	162	+	162	O95831-1	0	1454	ENST00000675037.1	56	1439	+	245	O95831-1#0	0	162	ENST00000675037.1	56	218	+	162	0	0	341
O95831-1#0	0	162	162	O95831-1	0	162	+	162	O95831-1	0	108	ENST00000674997.1	0	108	++	244	O95831-1#0	0	108	ENST00000674997.1	0	108	+	108	0	54	342
O95831-1#0	0	162	162	O95831-1	0	162	+	162	O95831-1	0	832	ENST00000674722.1	13	760	+	242	O95831-1#0	0	162	ENST00000674722.1	13	175	+	162	0	0	343
O95831-1#0	0	162	162	O95831-1	0	162	+	162	O95831-1	0	265	ENST00000674555.1	57	354	+	240	O95831-1#0	0	162	ENST00000674555.1	57	219	+	162	0	0	344
O95831-1#0	0	162	162	O95831-1	0	162	+	162	O95831-1	0	1762	ENST00000674546.1	185	1955	+	239	O95831-1#0	0	162	ENST00000674546.1	185	347	+	162	0	0	345
O95831-1#0	0	162	162	O95831-1	0	162	+	162	O95831-1	0	966	ENST00000535724.6	8	974	++	156	O95831-1#0	0	162	ENST00000535724.6	8	170	+	162	0	0	346
O95831-1#0	0	162	162	O95831-1	0	162	+	162	O95831-1	0	249	ENST00000529877.1	103	352	+	149	O95831-1#0	0	162	ENST00000529877.1	103	265	+	162	0	0	347
O95831-1#0	0	162	162	O95831-1	0	162	+	162	O95831-1	0	108	ENST00000527892.5	8	116	++	145	O95831-1#0	0	108	ENST00000527892.5	8	116	+	108	0	54	348
O95831-1#0	0	162	162	O95831-1	0	162	+	162	O95831-1	0	1336	ENST00000416073.7	37	1363	+	76	O95831-1#0	0	162	ENST00000416073.7	37	199	+	162	0	0	349
O95831-1#0	0	162	162	O95831-1	0	162	+	162	O95831-1	0	1839	ENST00000346424.6	24	1002	++	34	O95831-1#0	0	105	ENST00000346424.6	24	129	+	105	0	57	350
O95831-1#0	0	162	162	O95831-1	0	162	+	162	O95831-1	0	1839	ENST00000319908.8	174	2007	+	25	O95831-1#0	0	162	ENST00000319908.8	174	336	+	162	0	0	351
O95831-1#0	0	162	162	O95831-1	0	162	+	162	O95831-1	0	1839	ENST00000287295.8	185	2024	++	16	O95831-1#0	0	162	ENST00000287295.8	185	347	+	162	0	0	352
O95831-1#1	0	141	141	O95831-1	162	303	+	141	O95831-1	0	1839	ENST00000676436.1	34	1861	+	255	O95831-1#1	0	141	ENST00000676436.1	196	337	+	141	0	0	353
O95831-1#1	0	141	141	O95831-1	162	303	+	141	O95831-1	0	1839	ENST00000676328.1	56	1892	+	254	O95831-1#1	0	141	ENST00000676328.1	218	359	+	141	0	0	354
O95831-1#1	0	141	141	O95831-1	162	303	+	141	O95831-1	0	1839	ENST00000676229.1	223	2050	++	253	O95831-1#1	0	141	ENST00000676229.1	370	514	+	141	0	0	355
O95831-1#1	0	141	141	O95831-1	162	303	+	141	O95831-1	284	409	ENST00000676144.1	0	184	+	252	O95831-1#1	122	141	ENST00000676144.1	0	19	+	19	122	0	356
O95831-1#1	0	141	141	O95831-1	162	303	+	141	O95831-1	0	1839	ENST00000675857.1	82	1915	+	251	O95831-1#1	0	141	ENST00000675857.1	244	385	+	141	0	0	357
O95831-1#1	0	141	141	O95831-1	162	303	+	141	O95831-1	0	1839	ENST00000675427.1	89	1925	+	249	O95831-1#1	0	141	ENST00000675427.1	251	392	+	141	0	0	358
O95831-1#1	0	141	141	O95831-1	162	303	+	141	O95831-1	0	1762	ENST00000675240.1	169	1867	+	248	O95831-1#1	0	141	ENST00000675240.1	331	472	+	141	0	0	359
O95831-1#1	0	141	141	O95831-1	162	303	+	141	O95831-1	0	1839	ENST00000675092.1	90	1956	+	247	O95831-1#1	0	141	ENST00000675092.1	252	393	+	141	0	0	360
O95831-1#1	0	141	141	O95831-1	162	303	+	141	O95831-1	0	1839	ENST00000675050.1	71	1898	++	246	O95831-1#1	0	141	ENST00000675050.1	218	362	+	141	0	0	361
O95831-1#1	0	141	141	O95831-1	162	303	+	141	O95831-1	0	1454	ENST00000675037.1	56	1439	+	245	O95831-1#1	0	141	ENST00000675037.1	218	359	+	141	0	0	362
O95831-1#1	0	141	141	O95831-1	162	303	+	141	O95831-1	299	1183	ENST00000674957.1	0	880	+	243	O95831-1#1	137	141	ENST00000674957.1	0	4	+	4	137	0	363
O95831-1#1	0	141	141	O95831-1	162	303	+	141	O95831-1	0	832	ENST00000674722.1	13	760	+	242	O95831-1#1	0	141	ENST00000674722.1	175	316	+	141	0	0	364
O95831-1#1	0	141	141	O95831-1	162	303	+	141	O95831-1	0	265	ENST00000674555.1	57	354	+	240	O95831-1#1	0	103	ENST00000674555.1	219	354	+	103	0	38	365
O95831-1#1	0	141	141	O95831-1	162	303	+	141	O95831-1	0	1762	ENST00000674546.1	185	1955	+	239	O95831-1#1	0	141	ENST00000674546.1	347	488	+	141	0	0	366
O95831-1#1	0	141	141	O95831-1	162	303	+	141	O95831-1	0	966	ENST00000535724.6	8	974	++	156	O95831-1#1	0	141	ENST00000535724.6	170	311	+	141	0	0	367
O95831-1#1	0	141	141	O95831-1	162	303	+	141	O95831-1	0	249	ENST00000529877.1	103	352	+	149	O95831-1#1	0	87	ENST00000529877.1	265	352	+	87	0	54	368
O95831-1#1	0	141	141	O95831-1	162	303	+	141	O95831-1	0	1336	ENST00000416073.7	37	1363	+	76	O95831-1#1	0	141	ENST00000416073.7	199	340	+	141	0	0	369
O95831-1#1	0	141	141	O95831-1	162	303	+	141	O95831-1	0	1839	ENST00000319908.8	174	2007	+	25	O95831-1#1	0	141	ENST00000319908.8	336	477	+	141	0	0	370
O95831-1#1	0	141	141	O95831-1	162	303	+	141	O95831-1	0	1839	ENST00000287295.8	185	2024	++	16	O95831-1#1	0	141	ENST00000287295.8	347	488	+	141	0	0	371
O95831-1#2	0	1536	1536	O95831-1	303	1839	+	1536	O95831-1	0	1839	ENST00000676436.1	34	1861	+	255	O95831-1#2	0	1536	ENST00000676436.1	337	1861	+	1524	0	0	372
O95831-1#2	0	1536	1536	O95831-1	303	1839	+	1536	O95831-1	0	1839	ENST00000676328.1	56	1892	+	254	O95831-1#2	0	1536	ENST00000676328.1	359	1892	+	1533	0	0	373
O95831-1#2	0	1536	1536	O95831-1	303	1839	+	1536	O95831-1	0	1839	ENST00000676229.1	223	2050	++	253	O95831-1#2	0	1536	ENST00000676229.1	514	2050	+	1536	0	0	374
O95831-1#2	0	1536	1536	O95831-1	303	1839	+	1536	O95831-1	284	409	ENST00000676144.1	0	184	+	252	O95831-1#2	0	106	ENST00000676144.1	19	184	+	106	0	1430	375
O95831-1#2	0	1536	1536	O95831-1	303	1839	+	1536	O95831-1	0	1839	ENST00000675857.1	82	1915	+	251	O95831-1#2	0	1536	ENST00000675857.1	385	1915	+	1530	0	0	376
O95831-1#2	0	1536	1536	O95831-1	303	1839	+	1536	O95831-1	0	1839	ENST00000675427.1	89	1925	+	249	O95831-1#2	0	1536	ENST00000675427.1	392	1925	+	1533	0	0	377
O95831-1#2	0	1536	1536	O95831-1	303	1839	+	1536	O95831-1	0	1762	ENST00000675240.1	169	1867	+	248	O95831-1#2	0	1459	ENST00000675240.1	472	1867	+	1395	0	77	378
O95831-1#2	0	1536	1536	O95831-1	303	1839	+	1536	O95831-1	0	1839	ENST00000675092.1	90	1956	+	247	O95831-1#2	0	1536	ENST00000675092.1	393	1956	+	1536	0	0	379
O95831-1#2	0	1536	1536	O95831-1	303	1839	+	1536	O95831-1	0	1839	ENST00000675050.1	71	1898	++	246	O95831-1#2	0	1536	ENST00000675050.1	362	1898	+	1536	0	0	380
O95831-1#2	0	1536	1536	O95831-1	303	1839	+	1536	O95831-1	0	1454	ENST00000675037.1	56	1439	+	245	O95831-1#2	0	1151	ENST00000675037.1	359	1439	+	1080	0	385	381
O95831-1#2	0	1536	1536	O95831-1	303	1839	+	1536	O95831-1	299	1183	ENST00000674957.1	0	880	+	243	O95831-1#2	0	880	ENST00000674957.1	4	880	+	876	0	656	382
O95831-1#2	0	1536	1536	O95831-1	303	1839	+	1536	O95831-1	0	832	ENST00000674722.1	13	760	+	242	O95831-1#2	0	529	ENST00000674722.1	316	760	+	444	0	1007	383
O95831-1#2	0	1536	1536	O95831-1	303	1839	+	1536	O95831-1	1012	1839	ENST00000674601.1	0	686	+	241	O95831-1#2	709	1536	ENST00000674601.1	0	686	+	686	709	0	384
O95831-1#2	0	1536	1536	O95831-1	303	1839	+	1536	O95831-1	0	1762	ENST00000674546.1	185	1955	+	239	O95831-1#2	0	1459	ENST00000674546.1	488	1955	+	1459	0	77	385
O95831-1#2	0	1536	1536	O95831-1	303	1839	+	1536	O95831-1	0	966	ENST00000535724.6	8	974	++	156	O95831-1#2	0	663	ENST00000535724.6	311	974	+	663	0	873	386
O95831-1#2	0	1536	1536	O95831-1	303	1839	+	1536	O95831-1	1017	1839	ENST00000460436.6	905	1727	+	105	O95831-1#2	714	1536	ENST00000460436.6	905	1727	+	822	714	0	387
O95831-1#2	0	1536	1536	O95831-1	303	1839	+	1536	O95831-1	0	1336	ENST00000416073.7	37	1363	+	76	O95831-1#2	0	1033	ENST00000416073.7	340	1363	+	1023	0	503	388
O95831-1#2	0	1536	1536	O95831-1	303	1839	+	1536	O95831-1	0	1839	ENST00000346424.6	24	1002	++	34	O95831-1#2	663	1536	ENST00000346424.6	129	1002	+	873	663	0	389
O95831-1#2	0	1536	1536	O95831-1	303	1839	+	1536	O95831-1	0	1839	ENST00000319908.8	174	2007	+	25	O95831-1#2	0	1536	ENST00000319908.8	477	2007	+	1530	0	0	390
O95831-1#2	0	1536	1536	O95831-1	303	1839	+	1536	O95831-1	0	1839	ENST00000287295.8	185	2024	++	16	O95831-1#2	0	1536	ENST00000287295.8	488	2024	+	1536	0	0	391
O95831-1#3	0	84	84	O95831-1	297	381	+	84	O95831-1	0	1839	ENST00000676436.1	34	1861	+	255	O95831-1#3	0	84	ENST00000676436.1	331	409	+	78	0	0	392
O95831-1#3	0	84	84	O95831-1	297	381	+	84	O95831-1	0	1839	ENST00000676328.1	56	1892	+	254	O95831-1#3	0	84	ENST00000676328.1	353	437	+	84	0	0	393
O95831-1#3	0	84	84	O95831-1	297	381	+	84	O95831-1	0	1839	ENST00000676229.1	223	2050	++	253	O95831-1#3	0	84	ENST00000676229.1	508	592	+	84	0	0	394
O95831-1#3	0	84	84	O95831-1	297	381	+	84	O95831-1	284	409	ENST00000676144.1	0	184	+	252	O95831-1#3	0	84	ENST00000676144.1	13	156	+	84	0	0	395
O95831-1#3	0	84	84	O95831-1	297	381	+	84	O95831-1	0	1839	ENST00000675857.1	82	1915	+	251	O95831-1#3	0	84	ENST00000675857.1	379	457	+	78	0	0	396
O95831-1#3	0	84	84	O95831-1	297	381	+	84	O95831-1	0	1839	ENST00000675427.1	89	1925	+	249	O95831-1#3	0	84	ENST00000675427.1	386	470	+	84	0	0	397
O95831-1#3	0	84	84	O95831-1	297	381	+	84	O95831-1	0	1762	ENST00000675240.1	169	1867	+	248	O95831-1#3	0	84	ENST00000675240.1	466	550	+	84	0	0	398
O95831-1#3	0	84	84	O95831-1	297	381	+	84	O95831-1	0	1839	ENST00000675092.1	90	1956	+	247	O95831-1#3	0	84	ENST00000675092.1	387	471	+	84	0	0	399
O95831-1#3	0	84	84	O95831-1	297	381	+	84	O95831-1	0	1839	ENST00000675050.1	71	1898	++	246	O95831-1#3	0	84	ENST00000675050.1	356	440	+	84	0	0	400
O95831-1#3	0	84	84	O95831-1	297	381	+	84	O95831-1	0	1454	ENST00000675037.1	56	1439	+	245	O95831-1#3	0	84	ENST00000675037.1	353	437	+	84	0	0	401
O95831-1#3	0	84	84	O95831-1	297	381	+	84	O95831-1	299	1183	ENST00000674957.1	0	880	+	243	O95831-1#3	2	84	ENST00000674957.1	0	82	+	82	2	0	402
O95831-1#3	0	84	84	O95831-1	297	381	+	84	O95831-1	0	832	ENST00000674722.1	13	760	+	242	O95831-1#3	0	84	ENST00000674722.1	310	394	+	84	0	0	403
O95831-1#3	0	84	84	O95831-1	297	381	+	84	O95831-1	0	1762	ENST00000674546.1	185	1955	+	239	O95831-1#3	0	84	ENST00000674546.1	482	566	+	84	0	0	404
O95831-1#3	0	84	84	O95831-1	297	381	+	84	O95831-1	0	966	ENST00000535724.6	8	974	++	156	O95831-1#3	0	84	ENST00000535724.6	305	389	+	84	0	0	405
O95831-1#3	0	84	84	O95831-1	297	381	+	84	O95831-1	0	1336	ENST00000416073.7	37	1363	+	76	O95831-1#3	0	84	ENST00000416073.7	334	412	+	78	0	0	406
O95831-1#3	0	84	84	O95831-1	297	381	+	84	O95831-1	0	1839	ENST00000319908.8	174	2007	+	25	O95831-1#3	0	84	ENST00000319908.8	471	555	+	84	0	0	407
O95831-1#3	0	84	84	O95831-1	297	381	+	84	O95831-1	0	1839	ENST00000287295.8	185	2024	++	16	O95831-1#3	0	84	ENST00000287295.8	482	566	+	84	0	0	408
O95831-1#4	0	1050	1050	O95831-1	399	1449	+	1050	O95831-1	0	1839	ENST00000676436.1	34	1861	+	255	O95831-1#4	0	1050	ENST00000676436.1	427	1471	+	1044	0	0	409
O95831-1#4	0	1050	1050	O95831-1	399	1449	+	1050	O95831-1	0	1839	ENST00000676328.1	56	1892	+	254	O95831-1#4	0	1050	ENST00000676328.1	455	1502	+	1047	0	0	410
O95831-1#4	0	1050	1050	O95831-1	399	1449	+	1050	O95831-1	0	1839	ENST00000676229.1	223	2050	++	253	O95831-1#4	0	1050	ENST00000676229.1	610	1660	+	1050	0	0	411
O95831-1#4	0	1050	1050	O95831-1	399	1449	+	1050	O95831-1	284	409	ENST00000676144.1	0	184	+	252	O95831-1#4	0	10	ENST00000676144.1	174	184	+	10	0	1040	412
O95831-1#4	0	1050	1050	O95831-1	399	1449	+	1050	O95831-1	0	1839	ENST00000675857.1	82	1915	+	251	O95831-1#4	0	1050	ENST00000675857.1	475	1525	+	1050	0	0	413
O95831-1#4	0	1050	1050	O95831-1	399	1449	+	1050	O95831-1	0	1839	ENST00000675427.1	89	1925	+	249	O95831-1#4	0	1050	ENST00000675427.1	488	1535	+	1047	0	0	414
O95831-1#4	0	1050	1050	O95831-1	399	1449	+	1050	O95831-1	0	1762	ENST00000675240.1	169	1867	+	248	O95831-1#4	0	1050	ENST00000675240.1	568	1618	+	1050	0	0	415
O95831-1#4	0	1050	1050	O95831-1	399	1449	+	1050	O95831-1	0	1839	ENST00000675092.1	90	1956	+	247	O95831-1#4	0	1050	ENST00000675092.1	489	1539	+	1050	0	0	416
O95831-1#4	0	1050	1050	O95831-1	399	1449	+	1050	O95831-1	0	1839	ENST00000675050.1	71	1898	++	246	O95831-1#4	0	1050	ENST00000675050.1	458	1508	+	1050	0	0	417
O95831-1#4	0	1050	1050	O95831-1	399	1449	+	1050	O95831-1	0	1454	ENST00000675037.1	56	1439	+	245	O95831-1#4	0	1050	ENST00000675037.1	455	1434	+	979	0	0	418
O95831-1#4	0	1050	1050	O95831-1	399	1449	+	1050	O95831-1	299	1183	ENST00000674957.1	0	880	+	243	O95831-1#4	0	784	ENST00000674957.1	100	880	+	780	0	266	419
O95831-1#4	0	1050	1050	O95831-1	399	1449	+	1050	O95831-1	0	832	ENST00000674722.1	13	760	+	242	O95831-1#4	0	433	ENST00000674722.1	412	760	+	348	0	617	420
O95831-1#4	0	1050	1050	O95831-1	399	1449	+	1050	O95831-1	1012	1839	ENST00000674601.1	0	686	+	241	O95831-1#4	613	1050	ENST00000674601.1	0	296	+	296	613	0	421
O95831-1#4	0	1050	1050	O95831-1	399	1449	+	1050	O95831-1	0	1762	ENST00000674546.1	185	1955	+	239	O95831-1#4	0	1050	ENST00000674546.1	584	1634	+	1050	0	0	422
O95831-1#4	0	1050	1050	O95831-1	399	1449	+	1050	O95831-1	0	966	ENST00000535724.6	8	974	++	156	O95831-1#4	0	567	ENST00000535724.6	407	974	+	567	0	483	423
O95831-1#4	0	1050	1050	O95831-1	399	1449	+	1050	O95831-1	1017	1839	ENST00000460436.6	905	1727	+	105	O95831-1#4	618	1050	ENST00000460436.6	905	1337	+	432	618	0	424
O95831-1#4	0	1050	1050	O95831-1	399	1449	+	1050	O95831-1	0	1336	ENST00000416073.7	37	1363	+	76	O95831-1#4	0	937	ENST00000416073.7	430	1363	+	933	0	113	425
O95831-1#4	0	1050	1050	O95831-1	399	1449	+	1050	O95831-1	0	1839	ENST00000346424.6	24	1002	++	34	O95831-1#4	567	1050	ENST00000346424.6	129	612	+	483	567	0	426
O95831-1#4	0	1050	1050	O95831-1	399	1449	+	1050	O95831-1	0	1839	ENST00000319908.8	174	2007	+	25	O95831-1#4	0	1049	ENST00000319908.8	573	1619	+	1046	0	1	427
O95831-1#4	0	1050	1050	O95831-1	399	1449	+	1050	O95831-1	0	1839	ENST00000287295.8	185	2024	++	16	O95831-1#4	0	1050	ENST00000287295.8	584	1634	+	1050	0	0	428
O95831-1#5	0	126	126	O95831-1	1536	1662	+	126	O95831-1	0	1839	ENST00000676436.1	34	1861	+	255	O95831-1#5	0	126	ENST00000676436.1	1558	1684	+	126	0	0	429
O95831-1#5	0	126	126	O95831-1	1536	1662	+	126	O95831-1	0	1839	ENST00000676328.1	56	1892	+	254	O95831-1#5	0	126	ENST00000676328.1	1589	1715	+	126	0	0	430
O95831-1#5	0	126	126	O95831-1	1536	1662	+	126	O95831-1	0	1839	ENST00000676229.1	223	2050	++	253	O95831-1#5	0	126	ENST00000676229.1	1747	1873	+	126	0	0	431
O95831-1#5	0	126	126	O95831-1	1536	1662	+	126	O95831-1	0	1839	ENST00000675857.1	82	1915	+	251	O95831-1#5	0	126	ENST00000675857.1	1612	1738	+	126	0	0	432
O95831-1#5	0	126	126	O95831-1	1536	1662	+	126	O95831-1	0	1839	ENST00000675427.1	89	1925	+	249	O95831-1#5	0	126	ENST00000675427.1	1622	1748	+	126	0	0	433
O95831-1#5	0	126	126	O95831-1	1536	1662	+	126	O95831-1	0	1762	ENST00000675240.1	169	1867	+	248	O95831-1#5	0	126	ENST00000675240.1	1705	1767	+	62	0	0	434
O95831-1#5	0	126	126	O95831-1	1536	1662	+	126	O95831-1	0	1839	ENST00000675092.1	90	1956	+	247	O95831-1#5	0	126	ENST00000675092.1	1626	1779	+	126	0	0	435
O95831-1#5	0	126	126	O95831-1	1536	1662	+	126	O95831-1	0	1839	ENST00000675050.1	71	1898	++	246	O95831-1#5	0	126	ENST00000675050.1	1595	1721	+	126	0	0	436
O95831-1#5	0	126	126	O95831-1	1536	1662	+	126	O95831-1	1012	1839	ENST00000674601.1	0	686	+	241	O95831-1#5	0	126	ENST00000674601.1	383	509	+	126	0	0	437
O95831-1#5	0	126	126	O95831-1	1536	1662	+	126	O95831-1	0	1762	ENST00000674546.1	185	1955	+	239	O95831-1#5	0	126	ENST00000674546.1	1721	1855	+	126	0	0	438
O95831-1#5	0	126	126	O95831-1	1536	1662	+	126	O95831-1	1017	1839	ENST00000460436.6	905	1727	+	105	O95831-1#5	0	126	ENST00000460436.6	1424	1550	+	126	0	0	439
O95831-1#5	0	126	126	O95831-1	1536	1662	+	126	O95831-1	0	1839	ENST00000346424.6	24	1002	++	34	O95831-1#5	0	126	ENST00000346424.6	699	825	+	126	0	0	440
O95831-1#5	0	126	126	O95831-1	1536	1662	+	126	O95831-1	0	1839	ENST00000319908.8	174	2007	+	25	O95831-1#5	0	126	ENST00000319908.8	1704	1830	+	126	0	0	441
O95831-1#5	0	126	126	O95831-1	1536	1662	+	126	O95831-1	0	1839	ENST00000287295.8	185	2024	++	16	O95831-1#5	0	126	ENST00000287295.8	1721	1847	+	126	0	0	442
O95831-1#6	0	93	93	O95831-1	0	93	+	93	O95831-1	0	1839	ENST00000676436.1	34	1861	+	255	O95831-1#6	0	93	ENST00000676436.1	34	127	+	93	0	0	443
O95831-1#6	0	93	93	O95831-1	0	93	+	93	O95831-1	0	1839	ENST00000676328.1	56	1892	+	254	O95831-1#6	0	93	ENST00000676328.1	56	149	+	93	0	0	444
O95831-1#6	0	93	93	O95831-1	0	93	+	93	O95831-1	0	1839	ENST00000676229.1	223	2050	++	253	O95831-1#6	0	93	ENST00000676229.1	223	316	+	93	0	0	445
O95831-1#6	0	93	93	O95831-1	0	93	+	93	O95831-1	0	1839	ENST00000675857.1	82	1915	+	251	O95831-1#6	0	93	ENST00000675857.1	82	175	+	93	0	0	446
O95831-1#6	0	93	93	O95831-1	0	93	+	93	O95831-1	0	108	ENST00000675774.1	41	149	++	250	O95831-1#6	0	93	ENST00000675774.1	41	134	+	93	0	0	447
O95831-1#6	0	93	93	O95831-1	0	93	+	93	O95831-1	0	1839	ENST00000675427.1	89	1925	+	249	O95831-1#6	0	93	ENST00000675427.1	89	182	+	93	0	0	448
O95831-1#6	0	93	93	O95831-1	0	93	+	93	O95831-1	0	1762	ENST00000675240.1	169	1867	+	248	O95831-1#6	0	93	ENST00000675240.1	169	262	+	93	0	0	449
O95831-1#6	0	93	93	O95831-1	0	93	+	93	O95831-1	0	1839	ENST00000675092.1	90	1956	+	247	O95831-1#6	0	93	ENST00000675092.1	90	183	+	93	0	0	450
O95831-1#6	0	93	93	O95831-1	0	93	+	93	O95831-1	0	1839	ENST00000675050.1	71	1898	++	246	O95831-1#6	0	93	ENST00000675050.1	71	164	+	93	0	0	451
O95831-1#6	0	93	93	O95831-1	0	93	+	93	O95831-1	0	1454	ENST00000675037.1	56	1439	+	245	O95831-1#6	0	93	ENST00000675037.1	56	149	+	93	0	0	452
O95831-1#6	0	93	93	O95831-1	0	93	+	93	O95831-1	0	108	ENST00000674997.1	0	108	++	244	O95831-1#6	0	93	ENST00000674997.1	0	93	+	93	0	0	453
O95831-1#6	0	93	93	O95831-1	0	93	+	93	O95831-1	0	832	ENST00000674722.1	13	760	+	242	O95831-1#6	0	93	ENST00000674722.1	13	106	+	93	0	0	454
O95831-1#6	0	93	93	O95831-1	0	93	+	93	O95831-1	0	265	ENST00000674555.1	57	354	+	240	O95831-1#6	0	93	ENST00000674555.1	57	150	+	93	0	0	455
O95831-1#6	0	93	93	O95831-1	0	93	+	93	O95831-1	0	1762	ENST00000674546.1	185	1955	+	239	O95831-1#6	0	93	ENST00000674546.1	185	278	+	93	0	0	456
O95831-1#6	0	93	93	O95831-1	0	93	+	93	O95831-1	0	966	ENST00000535724.6	8	974	++	156	O95831-1#6	0	93	ENST00000535724.6	8	101	+	93	0	0	457
O95831-1#6	0	93	93	O95831-1	0	93	+	93	O95831-1	0	249	ENST00000529877.1	103	352	+	149	O95831-1#6	0	93	ENST00000529877.1	103	196	+	93	0	0	458
O95831-1#6	0	93	93	O95831-1	0	93	+	93	O95831-1	0	108	ENST00000527892.5	8	116	++	145	O95831-1#6	0	93	ENST00000527892.5	8	101	+	93	0	0	459
O95831-1#6	0	93	93	O95831-1	0	93	+	93	O95831-1	0	1336	ENST00000416073.7	37	1363	+	76	O95831-1#6	0	93	ENST00000416073.7	37	130	+	93	0	0	460
O95831-1#6	0	93	93	O95831-1	0	93	+	93	O95831-1	0	1839	ENST00000346424.6	24	1002	++	34	O95831-1#6	0	93	ENST00000346424.6	24	117	+	93	0	0	461
O95831-1#6	0	93	93	O95831-1	0	93	+	93	O95831-1	0	1839	ENST00000319908.8	174	2007	+	25	O95831-1#6	0	93	ENST00000319908.8	174	267	+	93	0	0	462
O95831-1#6	0	93	93	O95831-1	0	93	+	93	O95831-1	0	1839	ENST00000287295.8	185	2024	++	16	O95831-1#6	0	93	ENST00000287295.8	185	278	+	93	0	0	463
O95831-1#7	0	81	81	O95831-1	186	267	+	81	O95831-1	0	1839	ENST00000676436.1	34	1861	+	255	O95831-1#7	0	81	ENST00000676436.1	220	301	+	81	0	0	464
O95831-1#7	0	81	81	O95831-1	186	267	+	81	O95831-1	0	1839	ENST00000676328.1	56	1892	+	254	O95831-1#7	0	81	ENST00000676328.1	242	323	+	81	0	0	465
O95831-1#7	0	81	81	O95831-1	186	267	+	81	O95831-1	0	1839	ENST00000676229.1	223	2050	++	253	O95831-1#7	0	81	ENST00000676229.1	394	478	+	81	0	0	466
O95831-1#7	0	81	81	O95831-1	186	267	+	81	O95831-1	0	1839	ENST00000675857.1	82	1915	+	251	O95831-1#7	0	81	ENST00000675857.1	268	349	+	81	0	0	467
O95831-1#7	0	81	81	O95831-1	186	267	+	81	O95831-1	0	1839	ENST00000675427.1	89	1925	+	249	O95831-1#7	0	81	ENST00000675427.1	275	356	+	81	0	0	468
O95831-1#7	0	81	81	O95831-1	186	267	+	81	O95831-1	0	1762	ENST00000675240.1	169	1867	+	248	O95831-1#7	0	81	ENST00000675240.1	355	436	+	81	0	0	469
O95831-1#7	0	81	81	O95831-1	186	267	+	81	O95831-1	0	1839	ENST00000675092.1	90	1956	+	247	O95831-1#7	0	81	ENST00000675092.1	276	357	+	81	0	0	470
O95831-1#7	0	81	81	O95831-1	186	267	+	81	O95831-1	0	1839	ENST00000675050.1	71	1898	++	246	O95831-1#7	0	81	ENST00000675050.1	242	326	+	81	0	0	471
O95831-1#7	0	81	81	O95831-1	186	267	+	81	O95831-1	0	1454	ENST00000675037.1	56	1439	+	245	O95831-1#7	0	81	ENST00000675037.1	242	323	+	81	0	0	472
O95831-1#7	0	81	81	O95831-1	186	267	+	81	O95831-1	0	832	ENST00000674722.1	13	760	+	242	O95831-1#7	0	81	ENST00000674722.1	199	280	+	81	0	0	473
O95831-1#7	0	81	81	O95831-1	186	267	+	81	O95831-1	0	265	ENST00000674555.1	57	354	+	240	O95831-1#7	0	79	ENST00000674555.1	243	354	+	79	0	2	474
O95831-1#7	0	81	81	O95831-1	186	267	+	81	O95831-1	0	1762	ENST00000674546.1	185	1955	+	239	O95831-1#7	0	81	ENST00000674546.1	371	452	+	81	0	0	475
O95831-1#7	0	81	81	O95831-1	186	267	+	81	O95831-1	0	966	ENST00000535724.6	8	974	++	156	O95831-1#7	0	81	ENST00000535724.6	194	275	+	81	0	0	476
O95831-1#7	0	81	81	O95831-1	186	267	+	81	O95831-1	0	249	ENST00000529877.1	103	352	+	149	O95831-1#7	0	63	ENST00000529877.1	289	352	+	63	0	18	477
O95831-1#7	0	81	81	O95831-1	186	267	+	81	O95831-1	0	1336	ENST00000416073.7	37	1363	+	76	O95831-1#7	0	81	ENST00000416073.7	223	304	+	81	0	0	478
O95831-1#7	0	81	81	O95831-1	186	267	+	81	O95831-1	0	1839	ENST00000319908.8	174	2007	+	25	O95831-1#7	0	81	ENST00000319908.8	360	441	+	81	0	0	479
O95831-1#7	0	81	81	O95831-1	186	267	+	81	O95831-1	0	1839	ENST00000287295.8	185	2024	++	16	O95831-1#7	0	81	ENST00000287295.8	371	452	+	81	0	0	480
O95831-1#8	0	18	18	O95831-1	1335	1353	+	18	O95831-1	0	1839	ENST00000676436.1	34	1861	+	255	O95831-1#8	0	18	ENST00000676436.1	1357	1375	+	18	0	0	481
O95831-1#8	0	18	18	O95831-1	1335	1353	+	18	O95831-1	0	1839	ENST00000676328.1	56	1892	+	254	O95831-1#8	0	18	ENST00000676328.1	1388	1406	+	18	0	0	482
O95831-1#8	0	18	18	O95831-1	1335	1353	+	18	O95831-1	0	1839	ENST00000676229.1	223	2050	++	253	O95831-1#8	0	18	ENST00000676229.1	1546	1564	+	18	0	0	483
O95831-1#8	0	18	18	O95831-1	1335	1353	+	18	O95831-1	0	1839	ENST00000675857.1	82	1915	+	251	O95831-1#8	0	18	ENST00000675857.1	1411	1429	+	18	0	0	484
O95831-1#8	0	18	18	O95831-1	1335	1353	+	18	O95831-1	0	1839	ENST00000675427.1	89	1925	+	249	O95831-1#8	0	18	ENST00000675427.1	1421	1439	+	18	0	0	485
O95831-1#8	0	18	18	O95831-1	1335	1353	+	18	O95831-1	0	1762	ENST00000675240.1	169	1867	+	248	O95831-1#8	0	18	ENST00000675240.1	1504	1522	+	18	0	0	486
O95831-1#8	0	18	18	O95831-1	1335	1353	+	18	O95831-1	0	1839	ENST00000675092.1	90	1956	+	247	O95831-1#8	0	18	ENST00000675092.1	1425	1443	+	18	0	0	487
O95831-1#8	0	18	18	O95831-1	1335	1353	+	18	O95831-1	0	1839	ENST00000675050.1	71	1898	++	246	O95831-1#8	0	18	ENST00000675050.1	1394	1412	+	18	0	0	488
O95831-1#8	0	18	18	O95831-1	1335	1353	+	18	O95831-1	0	1454	ENST00000675037.1	56	1439	+	245	O95831-1#8	0	18	ENST00000675037.1	1391	1409	+	18	0	0	489
O95831-1#8	0	18	18	O95831-1	1335	1353	+	18	O95831-1	1012	1839	ENST00000674601.1	0	686	+	241	O95831-1#8	0	18	ENST00000674601.1	182	200	+	18	0	0	490
O95831-1#8	0	18	18	O95831-1	1335	1353	+	18	O95831-1	0	1762	ENST00000674546.1	185	1955	+	239	O95831-1#8	0	18	ENST00000674546.1	1520	1538	+	18	0	0	491
O95831-1#8	0	18	18	O95831-1	1335	1353	+	18	O95831-1	1017	1839	ENST00000460436.6	905	1727	+	105	O95831-1#8	0	18	ENST00000460436.6	1223	1241	+	18	0	0	492
O95831-1#8	0	18	18	O95831-1	1335	1353	+	18	O95831-1	0	1336	ENST00000416073.7	37	1363	+	76	O95831-1#8	0	1	ENST00000416073.7	1362	1363	+	1	0	17	493
O95831-1#8	0	18	18	O95831-1	1335	1353	+	18	O95831-1	0	1839	ENST00000346424.6	24	1002	++	34	O95831-1#8	0	18	ENST00000346424.6	498	516	+	18	0	0	494
O95831-1#8	0	18	18	O95831-1	1335	1353	+	18	O95831-1	0	1839	ENST00000319908.8	174	2007	+	25	O95831-1#8	0	18	ENST00000319908.8	1506	1524	+	18	0	0	495
O95831-1#8	0	18	18	O95831-1	1335	1353	+	18	O95831-1	0	1839	ENST00000287295.8	185	2024	++	16	O95831-1#8	0	18	ENST00000287295.8	1520	1538	+	18	0	0	496
O95831-1#9	0	99	99	O95831-1	1539	1638	+	99	O95831-1	0	1839	ENST00000676436.1	34	1861	+	255	O95831-1#9	0	99	ENST00000676436.1	1561	1660	+	99	0	0	497
O95831-1#9	0	99	99	O95831-1	1539	1638	+	99	O95831-1	0	1839	ENST00000676328.1	56	1892	+	254	O95831-1#9	0	99	ENST00000676328.1	1592	1691	+	99	0	0	498
O95831-1#9	0	99	99	O95831-1	1539	1638	+	99	O95831-1	0	1839	ENST00000676229.1	223	2050	++	253	O95831-1#9	0	99	ENST00000676229.1	1750	1849	+	99	0	0	499
O95831-1#9	0	99	99	O95831-1	1539	1638	+	99	O95831-1	0	1839	ENST00000675857.1	82	1915	+	251	O95831-1#9	0	99	ENST00000675857.1	1615	1714	+	99	0	0	500
O95831-1#9	0	99	99	O95831-1	1539	1638	+	99	O95831-1	0	1839	ENST00000675427.1	89	1925	+	249	O95831-1#9	0	99	ENST00000675427.1	1625	1724	+	99	0	0	501
O95831-1#9	0	99	99	O95831-1	1539	1638	+	99	O95831-1	0	1762	ENST00000675240.1	169	1867	+	248	O95831-1#9	0	99	ENST00000675240.1	1708	1743	+	35	0	0	502
O95831-1#9	0	99	99	O95831-1	1539	1638	+	99	O95831-1	0	1839	ENST00000675092.1	90	1956	+	247	O95831-1#9	0	99	ENST00000675092.1	1629	1755	+	99	0	0	503
O95831-1#9	0	99	99	O95831-1	1539	1638	+	99	O95831-1	0	1839	ENST00000675050.1	71	1898	++	246	O95831-1#9	0	99	ENST00000675050.1	1598	1697	+	99	0	0	504
O95831-1#9	0	99	99	O95831-1	1539	1638	+	99	O95831-1	1012	1839	ENST00000674601.1	0	686	+	241	O95831-1#9	0	99	ENST00000674601.1	386	485	+	99	0	0	505
O95831-1#9	0	99	99	O95831-1	1539	1638	+	99	O95831-1	0	1762	ENST00000674546.1	185	1955	+	239	O95831-1#9	0	99	ENST00000674546.1	1724	1831	+	99	0	0	506
O95831-1#9	0	99	99	O95831-1	1539	1638	+	99	O95831-1	1017	1839	ENST00000460436.6	905	1727	+	105	O95831-1#9	0	99	ENST00000460436.6	1427	1526	+	99	0	0	507
O95831-1#9	0	99	99	O95831-1	1539	1638	+	99	O95831-1	0	1839	ENST00000346424.6	24	1002	++	34	O95831-1#9	0	99	ENST00000346424.6	702	801	+	99	0	0	508
O95831-1#9	0	99	99	O95831-1	1539	1638	+	99	O95831-1	0	1839	ENST00000319908.8	174	2007	+	25	O95831-1#9	0	99	ENST00000319908.8	1707	1806	+	99	0	0	509
O95831-1#9	0	99	99	O95831-1	1539	1638	+	99	O95831-1	0	1839	ENST00000287295.8	185	2024	++	16	O95831-1#9	0	99	ENST00000287295.8	1724	1823	+	99	0	0	510
O95831-1#10	0	15	15	O95831-1	411	426	+	15	O95831-1	0	1839	ENST00000676436.1	34	1861	+	255	O95831-1#10	0	15	ENST00000676436.1	439	454	+	15	0	0	511
O95831-1#10	0	15	15	O95831-1	411	426	+	15	O95831-1	0	1839	ENST00000676328.1	56	1892	+	254	O95831-1#10	0	15	ENST00000676328.1	467	482	+	15	0	0	512
O95831-1#10	0	15	15	O95831-1	411	426	+	15	O95831-1	0	1839	ENST00000676229.1	223	2050	++	253	O95831-1#10	0	15	ENST00000676229.1	622	637	+	15	0	0	513
O95831-1#10	0	15	15	O95831-1	411	426	+	15	O95831-1	0	1839	ENST00000675857.1	82	1915	+	251	O95831-1#10	0	15	ENST00000675857.1	487	502	+	15	0	0	514
O95831-1#10	0	15	15	O95831-1	411	426	+	15	O95831-1	0	1839	ENST00000675427.1	89	1925	+	249	O95831-1#10	0	15	ENST00000675427.1	500	515	+	15	0	0	515
O95831-1#10	0	15	15	O95831-1	411	426	+	15	O95831-1	0	1762	ENST00000675240.1	169	1867	+	248	O95831-1#10	0	15	ENST00000675240.1	580	595	+	15	0	0	516
O95831-1#10	0	15	15	O95831-1	411	426	+	15	O95831-1	0	1839	ENST00000675092.1	90	1956	+	247	O95831-1#10	0	15	ENST00000675092.1	501	516	+	15	0	0	517
O95831-1#10	0	15	15	O95831-1	411	426	+	15	O95831-1	0	1839	ENST00000675050.1	71	1898	++	246	O95831-1#10	0	15	ENST00000675050.1	470	485	+	15	0	0	518
O95831-1#10	0	15	15	O95831-1	411	426	+	15	O95831-1	0	1454	ENST00000675037.1	56	1439	+	245	O95831-1#10	0	15	ENST00000675037.1	467	482	+	15	0	0	519
O95831-1#10	0	15	15	O95831-1	411	426	+	15	O95831-1	299	1183	ENST00000674957.1	0	880	+	243	O95831-1#10	0	15	ENST00000674957.1	112	127	+	15	0	0	520
O95831-1#10	0	15	15	O95831-1	411	426	+	15	O95831-1	0	832	ENST00000674722.1	13	760	+	242	O95831-1#10	0	15	ENST00000674722.1	424	439	+	15	0	0	521
O95831-1#10	0	15	15	O95831-1	411	426	+	15	O95831-1	0	1762	ENST00000674546.1	185	1955	+	239	O95831-1#10	0	15	ENST00000674546.1	596	611	+	15	0	0	522
O95831-1#10	0	15	15	O95831-1	411	426	+	15	O95831-1	0	966	ENST00000535724.6	8	974	++	156	O95831-1#10	0	15	ENST00000535724.6	419	434	+	15	0	0	523
O95831-1#10	0	15	15	O95831-1	411	426	+	15	O95831-1	0	1336	ENST00000416073.7	37	1363	+	76	O95831-1#10	0	15	ENST00000416073.7	442	457	+	15	0	0	524
O95831-1#10	0	15	15	O95831-1	411	426	+	15	O95831-1	0	1839	ENST00000319908.8	174	2007	+	25	O95831-1#10	0	15	ENST00000319908.8	585	600	+	15	0	0	525
O95831-1#10	0	15	15	O95831-1	411	426	+	15	O95831-1	0	1839	ENST00000287295.8	185	2024	++	16	O95831-1#10	0	15	ENST00000287295.8	596	611	+	15	0	0	526
O95831-1#11	0	6	6	O95831-1	489	495	+	6	O95831-1	0	1839	ENST00000676436.1	34	1861	+	255	O95831-1#11	0	6	ENST00000676436.1	517	523	+	6	0	0	527
O95831-1#11	0	6	6	O95831-1	489	495	+	6	O95831-1	0	1839	ENST00000676328.1	56	1892	+	254	O95831-1#11	0	6	ENST00000676328.1	545	551	+	6	0	0	528
O95831-1#11	0	6	6	O95831-1	489	495	+	6	O95831-1	0	1839	ENST00000676229.1	223	2050	++	253	O95831-1#11	0	6	ENST00000676229.1	700	706	+	6	0	0	529
O95831-1#11	0	6	6	O95831-1	489	495	+	6	O95831-1	0	1839	ENST00000675857.1	82	1915	+	251	O95831-1#11	0	6	ENST00000675857.1	565	571	+	6	0	0	530
O95831-1#11	0	6	6	O95831-1	489	495	+	6	O95831-1	0	1839	ENST00000675427.1	89	1925	+	249	O95831-1#11	0	6	ENST00000675427.1	578	584	+	6	0	0	531
O95831-1#11	0	6	6	O95831-1	489	495	+	6	O95831-1	0	1762	ENST00000675240.1	169	1867	+	248	O95831-1#11	0	6	ENST00000675240.1	658	664	+	6	0	0	532
O95831-1#11	0	6	6	O95831-1	489	495	+	6	O95831-1	0	1839	ENST00000675092.1	90	1956	+	247	O95831-1#11	0	6	ENST00000675092.1	579	585	+	6	0	0	533
O95831-1#11	0	6	6	O95831-1	489	495	+	6	O95831-1	0	1839	ENST00000675050.1	71	1898	++	246	O95831-1#11	0	6	ENST00000675050.1	548	554	+	6	0	0	534
O95831-1#11	0	6	6	O95831-1	489	495	+	6	O95831-1	0	1454	ENST00000675037.1	56	1439	+	245	O95831-1#11	0	6	ENST00000675037.1	545	551	+	6	0	0	535
O95831-1#11	0	6	6	O95831-1	489	495	+	6	O95831-1	299	1183	ENST00000674957.1	0	880	+	243	O95831-1#11	0	6	ENST00000674957.1	190	196	+	6	0	0	536
O95831-1#11	0	6	6	O95831-1	489	495	+	6	O95831-1	0	832	ENST00000674722.1	13	760	+	242	O95831-1#11	0	6	ENST00000674722.1	502	508	+	6	0	0	537
O95831-1#11	0	6	6	O95831-1	489	495	+	6	O95831-1	0	1762	ENST00000674546.1	185	1955	+	239	O95831-1#11	0	6	ENST00000674546.1	674	680	+	6	0	0	538
O95831-1#11	0	6	6	O95831-1	489	495	+	6	O95831-1	0	966	ENST00000535724.6	8	974	++	156	O95831-1#11	0	6	ENST00000535724.6	497	503	+	6	0	0	539
O95831-1#11	0	6	6	O95831-1	489	495	+	6	O95831-1	0	1336	ENST00000416073.7	37	1363	+	76	O95831-1#11	0	6	ENST00000416073.7	520	526	+	6	0	0	540
O95831-1#11	0	6	6	O95831-1	489	495	+	6	O95831-1	0	1839	ENST00000319908.8	174	2007	+	25	O95831-1#11	0	6	ENST00000319908.8	663	669	+	6	0	0	541
O95831-1#11	0	6	6	O95831-1	489	495	+	6	O95831-1	0	1839	ENST00000287295.8	185	2024	++	16	O95831-1#11	0	6	ENST00000287295.8	674	680	+	6	0	0	542
O95831-1#12	0	3	3	O95831-1	513	516	+	3	O95831-1	0	1839	ENST00000676436.1	34	1861	+	255	O95831-1#12	0	3	ENST00000676436.1	541	544	+	3	0	0	543
O95831-1#12	0	3	3	O95831-1	513	516	+	3	O95831-1	0	1839	ENST00000676328.1	56	1892	+	254	O95831-1#12	0	3	ENST00000676328.1	569	572	+	3	0	0	544
O95831-1#12	0	3	3	O95831-1	513	516	+	3	O95831-1	0	1839	ENST00000676229.1	223	2050	++	253	O95831-1#12	0	3	ENST00000676229.1	724	727	+	3	0	0	545
O95831-1#12	0	3	3	O95831-1	513	516	+	3	O95831-1	0	1839	ENST00000675857.1	82	1915	+	251	O95831-1#12	0	3	ENST00000675857.1	589	592	+	3	0	0	546
O95831-1#12	0	3	3	O95831-1	513	516	+	3	O95831-1	0	1839	ENST00000675427.1	89	1925	+	249	O95831-1#12	0	3	ENST00000675427.1	602	605	+	3	0	0	547
O95831-1#12	0	3	3	O95831-1	513	516	+	3	O95831-1	0	1762	ENST00000675240.1	169	1867	+	248	O95831-1#12	0	3	ENST00000675240.1	682	685	+	3	0	0	548
O95831-1#12	0	3	3	O95831-1	513	516	+	3	O95831-1	0	1839	ENST00000675092.1	90	1956	+	247	O95831-1#12	0	3	ENST00000675092.1	603	606	+	3	0	0	549
O95831-1#12	0	3	3	O95831-1	513	516	+	3	O95831-1	0	1839	ENST00000675050.1	71	1898	++	246	O95831-1#12	0	3	ENST00000675050.1	572	575	+	3	0	0	550
O95831-1#12	0	3	3	O95831-1	513	516	+	3	O95831-1	0	1454	ENST00000675037.1	56	1439	+	245	O95831-1#12	0	3	ENST00000675037.1	569	572	+	3	0	0	551
O95831-1#12	0	3	3	O95831-1	513	516	+	3	O95831-1	299	1183	ENST00000674957.1	0	880	+	243	O95831-1#12	0	3	ENST00000674957.1	214	217	+	3	0	0	552
O95831-1#12	0	3	3	O95831-1	513	516	+	3	O95831-1	0	832	ENST00000674722.1	13	760	+	242	O95831-1#12	0	3	ENST00000674722.1	526	529	+	3	0	0	553
O95831-1#12	0	3	3	O95831-1	513	516	+	3	O95831-1	0	1762	ENST00000674546.1	185	1955	+	239	O95831-1#12	0	3	ENST00000674546.1	698	701	+	3	0	0	554
O95831-1#12	0	3	3	O95831-1	513	516	+	3	O95831-1	0	966	ENST00000535724.6	8	974	++	156	O95831-1#12	0	3	ENST00000535724.6	521	524	+	3	0	0	555
O95831-1#12	0	3	3	O95831-1	513	516	+	3	O95831-1	0	1336	ENST00000416073.7	37	1363	+	76	O95831-1#12	0	3	ENST00000416073.7	544	547	+	3	0	0	556
O95831-1#12	0	3	3	O95831-1	513	516	+	3	O95831-1	0	1839	ENST00000319908.8	174	2007	+	25	O95831-1#12	0	3	ENST00000319908.8	687	690	+	3	0	0	557
O95831-1#12	0	3	3	O95831-1	513	516	+	3	O95831-1	0	1839	ENST00000287295.8	185	2024	++	16	O95831-1#12	0	3	ENST00000287295.8	698	701	+	3	0	0	558
O95831-1#13	0	3	3	O95831-1	528	531	+	3	O95831-1	0	1839	ENST00000676436.1	34	1861	+	255	O95831-1#13	0	3	ENST00000676436.1	556	559	+	3	0	0	559
O95831-1#13	0	3	3	O95831-1	528	531	+	3	O95831-1	0	1839	ENST00000676328.1	56	1892	+	254	O95831-1#13	0	3	ENST00000676328.1	584	587	+	3	0	0	560
O95831-1#13	0	3	3	O95831-1	528	531	+	3	O95831-1	0	1839	ENST00000676229.1	223	2050	++	253	O95831-1#13	0	3	ENST00000676229.1	739	742	+	3	0	0	561
O95831-1#13	0	3	3	O95831-1	528	531	+	3	O95831-1	0	1839	ENST00000675857.1	82	1915	+	251	O95831-1#13	0	3	ENST00000675857.1	604	607	+	3	0	0	562
O95831-1#13	0	3	3	O95831-1	528	531	+	3	O95831-1	0	1839	ENST00000675427.1	89	1925	+	249	O95831-1#13	0	3	ENST00000675427.1	617	620	+	3	0	0	563
O95831-1#13	0	3	3	O95831-1	528	531	+	3	O95831-1	0	1762	ENST00000675240.1	169	1867	+	248	O95831-1#13	0	3	ENST00000675240.1	697	700	+	3	0	0	564
O95831-1#13	0	3	3	O95831-1	528	531	+	3	O95831-1	0	1839	ENST00000675092.1	90	1956	+	247	O95831-1#13	0	3	ENST00000675092.1	618	621	+	3	0	0	565
O95831-1#13	0	3	3	O95831-1	528	531	+	3	O95831-1	0	1839	ENST00000675050.1	71	1898	++	246	O95831-1#13	0	3	ENST00000675050.1	587	590	+	3	0	0	566
O95831-1#13	0	3	3	O95831-1	528	531	+	3	O95831-1	0	1454	ENST00000675037.1	56	1439	+	245	O95831-1#13	0	3	ENST00000675037.1	584	587	+	3	0	0	567
O95831-1#13	0	3	3	O95831-1	528	531	+	3	O95831-1	299	1183	ENST00000674957.1	0	880	+	243	O95831-1#13	0	3	ENST00000674957.1	229	232	+	3	0	0	568
O95831-1#13	0	3	3	O95831-1	528	531	+	3	O95831-1	0	832	ENST00000674722.1	13	760	+	242	O95831-1#13	0	3	ENST00000674722.1	541	544	+	3	0	0	569
O95831-1#13	0	3	3	O95831-1	528	531	+	3	O95831-1	0	1762	ENST00000674546.1	185	1955	+	239	O95831-1#13	0	3	ENST00000674546.1	713	716	+	3	0	0	570
O95831-1#13	0	3	3	O95831-1	528	531	+	3	O95831-1	0	966	ENST00000535724.6	8	974	++	156	O95831-1#13	0	3	ENST00000535724.6	536	539	+	3	0	0	571
O95831-1#13	0	3	3	O95831-1	528	531	+	3	O95831-1	0	1336	ENST00000416073.7	37	1363	+	76	O95831-1#13	0	3	ENST00000416073.7	559	562	+	3	0	0	572
O95831-1#13	0	3	3	O95831-1	528	531	+	3	O95831-1	0	1839	ENST00000319908.8	174	2007	+	25	O95831-1#13	0	3	ENST00000319908.8	702	705	+	3	0	0	573
O95831-1#13	0	3	3	O95831-1	528	531	+	3	O95831-1	0	1839	ENST00000287295.8	185	2024	++	16	O95831-1#13	0	3	ENST00000287295.8	713	716	+	3	0	0	574
O95831-1#14	0	3	3	O95831-1	585	588	+	3	O95831-1	0	1839	ENST00000676436.1	34	1861	+	255	O95831-1#14	0	3	ENST00000676436.1	613	616	+	3	0	0	575
O95831-1#14	0	3	3	O95831-1	585	588	+	3	O95831-1	0	1839	ENST00000676328.1	56	1892	+	254	O95831-1#14	0	3	ENST00000676328.1	641	644	+	3	0	0	576
O95831-1#14	0	3	3	O95831-1	585	588	+	3	O95831-1	0	1839	ENST00000676229.1	223	2050	++	253	O95831-1#14	0	3	ENST00000676229.1	796	799	+	3	0	0	577
O95831-1#14	0	3	3	O95831-1	585	588	+	3	O95831-1	0	1839	ENST00000675857.1	82	1915	+	251	O95831-1#14	0	3	ENST00000675857.1	661	664	+	3	0	0	578
O95831-1#14	0	3	3	O95831-1	585	588	+	3	O95831-1	0	1839	ENST00000675427.1	89	1925	+	249	O95831-1#14	0	3	ENST00000675427.1	674	677	+	3	0	0	579
O95831-1#14	0	3	3	O95831-1	585	588	+	3	O95831-1	0	1762	ENST00000675240.1	169	1867	+	248	O95831-1#14	0	3	ENST00000675240.1	754	757	+	3	0	0	580
O95831-1#14	0	3	3	O95831-1	585	588	+	3	O95831-1	0	1839	ENST00000675092.1	90	1956	+	247	O95831-1#14	0	3	ENST00000675092.1	675	678	+	3	0	0	581
O95831-1#14	0	3	3	O95831-1	585	588	+	3	O95831-1	0	1839	ENST00000675050.1	71	1898	++	246	O95831-1#14	0	3	ENST00000675050.1	644	647	+	3	0	0	582
O95831-1#14	0	3	3	O95831-1	585	588	+	3	O95831-1	0	1454	ENST00000675037.1	56	1439	+	245	O95831-1#14	0	3	ENST00000675037.1	641	644	+	3	0	0	583
O95831-1#14	0	3	3	O95831-1	585	588	+	3	O95831-1	299	1183	ENST00000674957.1	0	880	+	243	O95831-1#14	0	3	ENST00000674957.1	286	289	+	3	0	0	584
O95831-1#14	0	3	3	O95831-1	585	588	+	3	O95831-1	0	832	ENST00000674722.1	13	760	+	242	O95831-1#14	0	3	ENST00000674722.1	598	601	+	3	0	0	585
O95831-1#14	0	3	3	O95831-1	585	588	+	3	O95831-1	0	1762	ENST00000674546.1	185	1955	+	239	O95831-1#14	0	3	ENST00000674546.1	770	773	+	3	0	0	586
O95831-1#14	0	3	3	O95831-1	585	588	+	3	O95831-1	0	966	ENST00000535724.6	8	974	++	156	O95831-1#14	0	3	ENST00000535724.6	593	596	+	3	0	0	587
O95831-1#14	0	3	3	O95831-1	585	588	+	3	O95831-1	0	1336	ENST00000416073.7	37	1363	+	76	O95831-1#14	0	3	ENST00000416073.7	616	619	+	3	0	0	588
O95831-1#14	0	3	3	O95831-1	585	588	+	3	O95831-1	0	1839	ENST00000319908.8	174	2007	+	25	O95831-1#14	0	3	ENST00000319908.8	759	762	+	3	0	0	589
O95831-1#14	0	3	3	O95831-1	585	588	+	3	O95831-1	0	1839	ENST00000287295.8	185	2024	++	16	O95831-1#14	0	3	ENST00000287295.8	770	773	+	3	0	0	590
O95831-1#15	0	3	3	O95831-1	696	699	+	3	O95831-1	0	1839	ENST00000676436.1	34	1861	+	255	O95831-1#15	0	3	ENST00000676436.1	724	727	+	3	0	0	591
O95831-1#15	0	3	3	O95831-1	696	699	+	3	O95831-1	0	1839	ENST00000676328.1	56	1892	+	254	O95831-1#15	0	3	ENST00000676328.1	752	755	+	3	0	0	592
O95831-1#15	0	3	3	O95831-1	696	699	+	3	O95831-1	0	1839	ENST00000676229.1	223	2050	++	253	O95831-1#15	0	3	ENST00000676229.1	907	910	+	3	0	0	593
O95831-1#15	0	3	3	O95831-1	696	699	+	3	O95831-1	0	1839	ENST00000675857.1	82	1915	+	251	O95831-1#15	0	3	ENST00000675857.1	772	775	+	3	0	0	594
O95831-1#15	0	3	3	O95831-1	696	699	+	3	O95831-1	0	1839	ENST00000675427.1	89	1925	+	249	O95831-1#15	0	3	ENST00000675427.1	785	788	+	3	0	0	595
O95831-1#15	0	3	3	O95831-1	696	699	+	3	O95831-1	0	1762	ENST00000675240.1	169	1867	+	248	O95831-1#15	0	3	ENST00000675240.1	865	868	+	3	0	0	596
O95831-1#15	0	3	3	O95831-1	696	699	+	3	O95831-1	0	1839	ENST00000675092.1	90	1956	+	247	O95831-1#15	0	3	ENST00000675092.1	786	789	+	3	0	0	597
O95831-1#15	0	3	3	O95831-1	696	699	+	3	O95831-1	0	1839	ENST00000675050.1	71	1898	++	246	O95831-1#15	0	3	ENST00000675050.1	755	758	+	3	0	0	598
O95831-1#15	0	3	3	O95831-1	696	699	+	3	O95831-1	0	1454	ENST00000675037.1	56	1439	+	245	O95831-1#15	0	3	ENST00000675037.1	752	755	+	3	0	0	599
O95831-1#15	0	3	3	O95831-1	696	699	+	3	O95831-1	299	1183	ENST00000674957.1	0	880	+	243	O95831-1#15	0	3	ENST00000674957.1	397	400	+	3	0	0	600
O95831-1#15	0	3	3	O95831-1	696	699	+	3	O95831-1	0	1762	ENST00000674546.1	185	1955	+	239	O95831-1#15	0	3	ENST00000674546.1	881	884	+	3	0	0	601
O95831-1#15	0	3	3	O95831-1	696	699	+	3	O95831-1	0	966	ENST00000535724.6	8	974	++	156	O95831-1#15	0	3	ENST00000535724.6	704	707	+	3	0	0	602
O95831-1#15	0	3	3	O95831-1	696	699	+	3	O95831-1	0	1336	ENST00000416073.7	37	1363	+	76	O95831-1#15	0	3	ENST00000416073.7	727	730	+	3	0	0	603
O95831-1#15	0	3	3	O95831-1	696	699	+	3	O95831-1	0	1839	ENST00000319908.8	174	2007	+	25	O95831-1#15	0	3	ENST00000319908.8	870	873	+	3	0	0	604
O95831-1#15	0	3	3	O95831-1	696	699	+	3	O95831-1	0	1839	ENST00000287295.8	185	2024	++	16	O95831-1#15	0	3	ENST00000287295.8	881	884	+	3	0	0	605
O95831-1#16	0	3	3	O95831-1	852	855	+	3	O95831-1	0	1839	ENST00000676436.1	34	1861	+	255	O95831-1#16	0	3	ENST00000676436.1	880	883	+	3	0	0	606
O95831-1#16	0	3	3	O95831-1	852	855	+	3	O95831-1	0	1839	ENST00000676328.1	56	1892	+	254	O95831-1#16	0	3	ENST00000676328.1	905	908	+	3	0	0	607
O95831-1#16	0	3	3	O95831-1	852	855	+	3	O95831-1	0	1839	ENST00000676229.1	223	2050	++	253	O95831-1#16	0	3	ENST00000676229.1	1063	1066	+	3	0	0	608
O95831-1#16	0	3	3	O95831-1	852	855	+	3	O95831-1	0	1839	ENST00000675857.1	82	1915	+	251	O95831-1#16	0	3	ENST00000675857.1	928	931	+	3	0	0	609
O95831-1#16	0	3	3	O95831-1	852	855	+	3	O95831-1	0	1839	ENST00000675427.1	89	1925	+	249	O95831-1#16	0	3	ENST00000675427.1	941	944	+	3	0	0	610
O95831-1#16	0	3	3	O95831-1	852	855	+	3	O95831-1	0	1762	ENST00000675240.1	169	1867	+	248	O95831-1#16	0	3	ENST00000675240.1	1021	1024	+	3	0	0	611
O95831-1#16	0	3	3	O95831-1	852	855	+	3	O95831-1	0	1839	ENST00000675092.1	90	1956	+	247	O95831-1#16	0	3	ENST00000675092.1	942	945	+	3	0	0	612
O95831-1#16	0	3	3	O95831-1	852	855	+	3	O95831-1	0	1839	ENST00000675050.1	71	1898	++	246	O95831-1#16	0	3	ENST00000675050.1	911	914	+	3	0	0	613
O95831-1#16	0	3	3	O95831-1	852	855	+	3	O95831-1	0	1454	ENST00000675037.1	56	1439	+	245	O95831-1#16	0	3	ENST00000675037.1	908	911	+	3	0	0	614
O95831-1#16	0	3	3	O95831-1	852	855	+	3	O95831-1	299	1183	ENST00000674957.1	0	880	+	243	O95831-1#16	0	3	ENST00000674957.1	553	556	+	3	0	0	615
O95831-1#16	0	3	3	O95831-1	852	855	+	3	O95831-1	0	1762	ENST00000674546.1	185	1955	+	239	O95831-1#16	0	3	ENST00000674546.1	1037	1040	+	3	0	0	616
O95831-1#16	0	3	3	O95831-1	852	855	+	3	O95831-1	0	966	ENST00000535724.6	8	974	++	156	O95831-1#16	0	3	ENST00000535724.6	860	863	+	3	0	0	617
O95831-1#16	0	3	3	O95831-1	852	855	+	3	O95831-1	0	1336	ENST00000416073.7	37	1363	+	76	O95831-1#16	0	3	ENST00000416073.7	883	886	+	3	0	0	618
O95831-1#16	0	3	3	O95831-1	852	855	+	3	O95831-1	0	1839	ENST00000319908.8	174	2007	+	25	O95831-1#16	0	3	ENST00000319908.8	1023	1026	+	3	0	0	619
O95831-1#16	0	3	3	O95831-1	852	855	+	3	O95831-1	0	1839	ENST00000287295.8	185	2024	++	16	O95831-1#16	0	3	ENST00000287295.8	1037	1040	+	3	0	0	620
O95831-1#17	0	12	12	O95831-1	921	933	+	12	O95831-1	0	1839	ENST00000676436.1	34	1861	+	255	O95831-1#17	0	12	ENST00000676436.1	949	961	+	12	0	0	621
O95831-1#17	0	12	12	O95831-1	921	933	+	12	O95831-1	0	1839	ENST00000676328.1	56	1892	+	254	O95831-1#17	0	12	ENST00000676328.1	974	986	+	12	0	0	622
O95831-1#17	0	12	12	O95831-1	921	933	+	12	O95831-1	0	1839	ENST00000676229.1	223	2050	++	253	O95831-1#17	0	12	ENST00000676229.1	1132	1144	+	12	0	0	623
O95831-1#17	0	12	12	O95831-1	921	933	+	12	O95831-1	0	1839	ENST00000675857.1	82	1915	+	251	O95831-1#17	0	12	ENST00000675857.1	997	1009	+	12	0	0	624
O95831-1#17	0	12	12	O95831-1	921	933	+	12	O95831-1	0	1839	ENST00000675427.1	89	1925	+	249	O95831-1#17	0	12	ENST00000675427.1	1010	1022	+	12	0	0	625
O95831-1#17	0	12	12	O95831-1	921	933	+	12	O95831-1	0	1762	ENST00000675240.1	169	1867	+	248	O95831-1#17	0	12	ENST00000675240.1	1090	1102	+	12	0	0	626
O95831-1#17	0	12	12	O95831-1	921	933	+	12	O95831-1	0	1839	ENST00000675092.1	90	1956	+	247	O95831-1#17	0	12	ENST00000675092.1	1011	1023	+	12	0	0	627
O95831-1#17	0	12	12	O95831-1	921	933	+	12	O95831-1	0	1839	ENST00000675050.1	71	1898	++	246	O95831-1#17	0	12	ENST00000675050.1	980	992	+	12	0	0	628
O95831-1#17	0	12	12	O95831-1	921	933	+	12	O95831-1	0	1454	ENST00000675037.1	56	1439	+	245	O95831-1#17	0	12	ENST00000675037.1	977	989	+	12	0	0	629
O95831-1#17	0	12	12	O95831-1	921	933	+	12	O95831-1	299	1183	ENST00000674957.1	0	880	+	243	O95831-1#17	0	12	ENST00000674957.1	622	634	+	12	0	0	630
O95831-1#17	0	12	12	O95831-1	921	933	+	12	O95831-1	0	1762	ENST00000674546.1	185	1955	+	239	O95831-1#17	0	12	ENST00000674546.1	1106	1118	+	12	0	0	631
O95831-1#17	0	12	12	O95831-1	921	933	+	12	O95831-1	0	966	ENST00000535724.6	8	974	++	156	O95831-1#17	0	12	ENST00000535724.6	929	941	+	12	0	0	632
O95831-1#17	0	12	12	O95831-1	921	933	+	12	O95831-1	0	1336	ENST00000416073.7	37	1363	+	76	O95831-1#17	0	12	ENST00000416073.7	952	964	+	12	0	0	633
O95831-1#17	0	12	12	O95831-1	921	933	+	12	O95831-1	0	1839	ENST00000319908.8	174	2007	+	25	O95831-1#17	0	12	ENST00000319908.8	1092	1104	+	12	0	0	634
O95831-1#17	0	12	12	O95831-1	921	933	+	12	O95831-1	0	1839	ENST00000287295.8	185	2024	++	16	O95831-1#17	0	12	ENST00000287295.8	1106	1118	+	12	0	0	635
O95831-1#18	0	3	3	O95831-1	1005	1008	+	3	O95831-1	0	1839	ENST00000676436.1	34	1861	+	255	O95831-1#18	0	3	ENST00000676436.1	1027	1030	+	3	0	0	636
O95831-1#18	0	3	3	O95831-1	1005	1008	+	3	O95831-1	0	1839	ENST00000676328.1	56	1892	+	254	O95831-1#18	0	3	ENST00000676328.1	1058	1061	+	3	0	0	637
O95831-1#18	0	3	3	O95831-1	1005	1008	+	3	O95831-1	0	1839	ENST00000676229.1	223	2050	++	253	O95831-1#18	0	3	ENST00000676229.1	1216	1219	+	3	0	0	638
O95831-1#18	0	3	3	O95831-1	1005	1008	+	3	O95831-1	0	1839	ENST00000675857.1	82	1915	+	251	O95831-1#18	0	3	ENST00000675857.1	1081	1084	+	3	0	0	639
O95831-1#18	0	3	3	O95831-1	1005	1008	+	3	O95831-1	0	1839	ENST00000675427.1	89	1925	+	249	O95831-1#18	0	3	ENST00000675427.1	1094	1097	+	3	0	0	640
O95831-1#18	0	3	3	O95831-1	1005	1008	+	3	O95831-1	0	1762	ENST00000675240.1	169	1867	+	248	O95831-1#18	0	3	ENST00000675240.1	1174	1177	+	3	0	0	641
O95831-1#18	0	3	3	O95831-1	1005	1008	+	3	O95831-1	0	1839	ENST00000675092.1	90	1956	+	247	O95831-1#18	0	3	ENST00000675092.1	1095	1098	+	3	0	0	642
O95831-1#18	0	3	3	O95831-1	1005	1008	+	3	O95831-1	0	1839	ENST00000675050.1	71	1898	++	246	O95831-1#18	0	3	ENST00000675050.1	1064	1067	+	3	0	0	643
O95831-1#18	0	3	3	O95831-1	1005	1008	+	3	O95831-1	0	1454	ENST00000675037.1	56	1439	+	245	O95831-1#18	0	3	ENST00000675037.1	1061	1064	+	3	0	0	644
O95831-1#18	0	3	3	O95831-1	1005	1008	+	3	O95831-1	299	1183	ENST00000674957.1	0	880	+	243	O95831-1#18	0	3	ENST00000674957.1	706	709	+	3	0	0	645
O95831-1#18	0	3	3	O95831-1	1005	1008	+	3	O95831-1	0	1762	ENST00000674546.1	185	1955	+	239	O95831-1#18	0	3	ENST00000674546.1	1190	1193	+	3	0	0	646
O95831-1#18	0	3	3	O95831-1	1005	1008	+	3	O95831-1	0	1336	ENST00000416073.7	37	1363	+	76	O95831-1#18	0	3	ENST00000416073.7	1036	1039	+	3	0	0	647
O95831-1#18	0	3	3	O95831-1	1005	1008	+	3	O95831-1	0	1839	ENST00000346424.6	24	1002	++	34	O95831-1#18	0	3	ENST00000346424.6	168	171	+	3	0	0	648
O95831-1#18	0	3	3	O95831-1	1005	1008	+	3	O95831-1	0	1839	ENST00000319908.8	174	2007	+	25	O95831-1#18	0	3	ENST00000319908.8	1176	1179	+	3	0	0	649
O95831-1#18	0	3	3	O95831-1	1005	1008	+	3	O95831-1	0	1839	ENST00000287295.8	185	2024	++	16	O95831-1#18	0	3	ENST00000287295.8	1190	1193	+	3	0	0	650
O95831-1#19	0	3	3	O95831-1	1023	1026	+	3	O95831-1	0	1839	ENST00000676436.1	34	1861	+	255	O95831-1#19	0	3	ENST00000676436.1	1045	1048	+	3	0	0	651
O95831-1#19	0	3	3	O95831-1	1023	1026	+	3	O95831-1	0	1839	ENST00000676328.1	56	1892	+	254	O95831-1#19	0	3	ENST00000676328.1	1076	1079	+	3	0	0	652
O95831-1#19	0	3	3	O95831-1	1023	1026	+	3	O95831-1	0	1839	ENST00000676229.1	223	2050	++	253	O95831-1#19	0	3	ENST00000676229.1	1234	1237	+	3	0	0	653
O95831-1#19	0	3	3	O95831-1	1023	1026	+	3	O95831-1	0	1839	ENST00000675857.1	82	1915	+	251	O95831-1#19	0	3	ENST00000675857.1	1099	1102	+	3	0	0	654
O95831-1#19	0	3	3	O95831-1	1023	1026	+	3	O95831-1	0	1839	ENST00000675427.1	89	1925	+	249	O95831-1#19	0	3	ENST00000675427.1	1112	1115	+	3	0	0	655
O95831-1#19	0	3	3	O95831-1	1023	1026	+	3	O95831-1	0	1762	ENST00000675240.1	169	1867	+	248	O95831-1#19	0	3	ENST00000675240.1	1192	1195	+	3	0	0	656
O95831-1#19	0	3	3	O95831-1	1023	1026	+	3	O95831-1	0	1839	ENST00000675092.1	90	1956	+	247	O95831-1#19	0	3	ENST00000675092.1	1113	1116	+	3	0	0	657
O95831-1#19	0	3	3	O95831-1	1023	1026	+	3	O95831-1	0	1839	ENST00000675050.1	71	1898	++	246	O95831-1#19	0	3	ENST00000675050.1	1082	1085	+	3	0	0	658
O95831-1#19	0	3	3	O95831-1	1023	1026	+	3	O95831-1	0	1454	ENST00000675037.1	56	1439	+	245	O95831-1#19	0	3	ENST00000675037.1	1079	1082	+	3	0	0	659
O95831-1#19	0	3	3	O95831-1	1023	1026	+	3	O95831-1	299	1183	ENST00000674957.1	0	880	+	243	O95831-1#19	0	3	ENST00000674957.1	724	727	+	3	0	0	660
O95831-1#19	0	3	3	O95831-1	1023	1026	+	3	O95831-1	1012	1839	ENST00000674601.1	0	686	+	241	O95831-1#19	0	3	ENST00000674601.1	11	14	+	3	0	0	661
O95831-1#19	0	3	3	O95831-1	1023	1026	+	3	O95831-1	0	1762	ENST00000674546.1	185	1955	+	239	O95831-1#19	0	3	ENST00000674546.1	1208	1211	+	3	0	0	662
O95831-1#19	0	3	3	O95831-1	1023	1026	+	3	O95831-1	1017	1839	ENST00000460436.6	905	1727	+	105	O95831-1#19	0	3	ENST00000460436.6	911	914	+	3	0	0	663
O95831-1#19	0	3	3	O95831-1	1023	1026	+	3	O95831-1	0	1336	ENST00000416073.7	37	1363	+	76	O95831-1#19	0	3	ENST00000416073.7	1054	1057	+	3	0	0	664
O95831-1#19	0	3	3	O95831-1	1023	1026	+	3	O95831-1	0	1839	ENST00000346424.6	24	1002	++	34	O95831-1#19	0	3	ENST00000346424.6	186	189	+	3	0	0	665
O95831-1#19	0	3	3	O95831-1	1023	1026	+	3	O95831-1	0	1839	ENST00000319908.8	174	2007	+	25	O95831-1#19	0	3	ENST00000319908.8	1194	1197	+	3	0	0	666
O95831-1#19	0	3	3	O95831-1	1023	1026	+	3	O95831-1	0	1839	ENST00000287295.8	185	2024	++	16	O95831-1#19	0	3	ENST00000287295.8	1208	1211	+	3	0	0	667
O95831-1#20	0	3	3	O95831-1	1194	1197	+	3	O95831-1	0	1839	ENST00000676436.1	34	1861	+	255	O95831-1#20	0	3	ENST00000676436.1	1216	1219	+	3	0	0	668
O95831-1#20	0	3	3	O95831-1	1194	1197	+	3	O95831-1	0	1839	ENST00000676328.1	56	1892	+	254	O95831-1#20	0	3	ENST00000676328.1	1247	1250	+	3	0	0	669
O95831-1#20	0	3	3	O95831-1	1194	1197	+	3	O95831-1	0	1839	ENST00000676229.1	223	2050	++	253	O95831-1#20	0	3	ENST00000676229.1	1405	1408	+	3	0	0	670
O95831-1#20	0	3	3	O95831-1	1194	1197	+	3	O95831-1	0	1839	ENST00000675857.1	82	1915	+	251	O95831-1#20	0	3	ENST00000675857.1	1270	1273	+	3	0	0	671
O95831-1#20	0	3	3	O95831-1	1194	1197	+	3	O95831-1	0	1839	ENST00000675427.1	89	1925	+	249	O95831-1#20	0	3	ENST00000675427.1	1283	1286	+	3	0	0	672
O95831-1#20	0	3	3	O95831-1	1194	1197	+	3	O95831-1	0	1762	ENST00000675240.1	169	1867	+	248	O95831-1#20	0	3	ENST00000675240.1	1363	1366	+	3	0	0	673
O95831-1#20	0	3	3	O95831-1	1194	1197	+	3	O95831-1	0	1839	ENST00000675092.1	90	1956	+	247	O95831-1#20	0	3	ENST00000675092.1	1284	1287	+	3	0	0	674
O95831-1#20	0	3	3	O95831-1	1194	1197	+	3	O95831-1	0	1839	ENST00000675050.1	71	1898	++	246	O95831-1#20	0	3	ENST00000675050.1	1253	1256	+	3	0	0	675
O95831-1#20	0	3	3	O95831-1	1194	1197	+	3	O95831-1	0	1454	ENST00000675037.1	56	1439	+	245	O95831-1#20	0	3	ENST00000675037.1	1250	1253	+	3	0	0	676
O95831-1#20	0	3	3	O95831-1	1194	1197	+	3	O95831-1	0	1762	ENST00000674546.1	185	1955	+	239	O95831-1#20	0	3	ENST00000674546.1	1379	1382	+	3	0	0	677
O95831-1#20	0	3	3	O95831-1	1194	1197	+	3	O95831-1	1017	1839	ENST00000460436.6	905	1727	+	105	O95831-1#20	0	3	ENST00000460436.6	1082	1085	+	3	0	0	678
O95831-1#20	0	3	3	O95831-1	1194	1197	+	3	O95831-1	0	1336	ENST00000416073.7	37	1363	+	76	O95831-1#20	0	3	ENST00000416073.7	1225	1228	+	3	0	0	679
O95831-1#20	0	3	3	O95831-1	1194	1197	+	3	O95831-1	0	1839	ENST00000346424.6	24	1002	++	34	O95831-1#20	0	3	ENST00000346424.6	357	360	+	3	0	0	680
O95831-1#20	0	3	3	O95831-1	1194	1197	+	3	O95831-1	0	1839	ENST00000319908.8	174	2007	+	25	O95831-1#20	0	3	ENST00000319908.8	1365	1368	+	3	0	0	681
O95831-1#20	0	3	3	O95831-1	1194	1197	+	3	O95831-1	0	1839	ENST00000287295.8	185	2024	++	16	O95831-1#20	0	3	ENST00000287295.8	1379	1382	+	3	0	0	682
O95831-1#21	0	3	3	O95831-1	1311	1314	+	3	O95831-1	0	1839	ENST00000676436.1	34	1861	+	255	O95831-1#21	0	3	ENST00000676436.1	1333	1336	+	3	0	0	683
O95831-1#21	0	3	3	O95831-1	1311	1314	+	3	O95831-1	0	1839	ENST00000676328.1	56	1892	+	254	O95831-1#21	0	3	ENST00000676328.1	1364	1367	+	3	0	0	684
O95831-1#21	0	3	3	O95831-1	1311	1314	+	3	O95831-1	0	1839	ENST00000676229.1	223	2050	++	253	O95831-1#21	0	3	ENST00000676229.1	1522	1525	+	3	0	0	685
O95831-1#21	0	3	3	O95831-1	1311	1314	+	3	O95831-1	0	1839	ENST00000675857.1	82	1915	+	251	O95831-1#21	0	3	ENST00000675857.1	1387	1390	+	3	0	0	686
O95831-1#21	0	3	3	O95831-1	1311	1314	+	3	O95831-1	0	1839	ENST00000675427.1	89	1925	+	249	O95831-1#21	0	3	ENST00000675427.1	1397	1400	+	3	0	0	687
O95831-1#21	0	3	3	O95831-1	1311	1314	+	3	O95831-1	0	1762	ENST00000675240.1	169	1867	+	248	O95831-1#21	0	3	ENST00000675240.1	1480	1483	+	3	0	0	688
O95831-1#21	0	3	3	O95831-1	1311	1314	+	3	O95831-1	0	1839	ENST00000675092.1	90	1956	+	247	O95831-1#21	0	3	ENST00000675092.1	1401	1404	+	3	0	0	689
O95831-1#21	0	3	3	O95831-1	1311	1314	+	3	O95831-1	0	1839	ENST00000675050.1	71	1898	++	246	O95831-1#21	0	3	ENST00000675050.1	1370	1373	+	3	0	0	690
O95831-1#21	0	3	3	O95831-1	1311	1314	+	3	O95831-1	0	1454	ENST00000675037.1	56	1439	+	245	O95831-1#21	0	3	ENST00000675037.1	1367	1370	+	3	0	0	691
O95831-1#21	0	3	3	O95831-1	1311	1314	+	3	O95831-1	1012	1839	ENST00000674601.1	0	686	+	241	O95831-1#21	0	3	ENST00000674601.1	158	161	+	3	0	0	692
O95831-1#21	0	3	3	O95831-1	1311	1314	+	3	O95831-1	0	1762	ENST00000674546.1	185	1955	+	239	O95831-1#21	0	3	ENST00000674546.1	1496	1499	+	3	0	0	693
O95831-1#21	0	3	3	O95831-1	1311	1314	+	3	O95831-1	1017	1839	ENST00000460436.6	905	1727	+	105	O95831-1#21	0	3	ENST00000460436.6	1199	1202	+	3	0	0	694
O95831-1#21	0	3	3	O95831-1	1311	1314	+	3	O95831-1	0	1336	ENST00000416073.7	37	1363	+	76	O95831-1#21	0	3	ENST00000416073.7	1338	1341	+	3	0	0	695
O95831-1#21	0	3	3	O95831-1	1311	1314	+	3	O95831-1	0	1839	ENST00000346424.6	24	1002	++	34	O95831-1#21	0	3	ENST00000346424.6	474	477	+	3	0	0	696
O95831-1#21	0	3	3	O95831-1	1311	1314	+	3	O95831-1	0	1839	ENST00000319908.8	174	2007	+	25	O95831-1#21	0	3	ENST00000319908.8	1482	1485	+	3	0	0	697
O95831-1#21	0	3	3	O95831-1	1311	1314	+	3	O95831-1	0	1839	ENST00000287295.8	185	2024	++	16	O95831-1#21	0	3	ENST00000287295.8	1496	1499	+	3	0	0	698
O95831-1#22	0	6	6	O95831-1	1356	1362	+	6	O95831-1	0	1839	ENST00000676436.1	34	1861	+	255	O95831-1#22	0	6	ENST00000676436.1	1378	1384	+	6	0	0	699
O95831-1#22	0	6	6	O95831-1	1356	1362	+	6	O95831-1	0	1839	ENST00000676328.1	56	1892	+	254	O95831-1#22	0	6	ENST00000676328.1	1409	1415	+	6	0	0	700
O95831-1#22	0	6	6	O95831-1	1356	1362	+	6	O95831-1	0	1839	ENST00000676229.1	223	2050	++	253	O95831-1#22	0	6	ENST00000676229.1	1567	1573	+	6	0	0	701
O95831-1#22	0	6	6	O95831-1	1356	1362	+	6	O95831-1	0	1839	ENST00000675857.1	82	1915	+	251	O95831-1#22	0	6	ENST00000675857.1	1432	1438	+	6	0	0	702
O95831-1#22	0	6	6	O95831-1	1356	1362	+	6	O95831-1	0	1839	ENST00000675427.1	89	1925	+	249	O95831-1#22	0	6	ENST00000675427.1	1442	1448	+	6	0	0	703
O95831-1#22	0	6	6	O95831-1	1356	1362	+	6	O95831-1	0	1762	ENST00000675240.1	169	1867	+	248	O95831-1#22	0	6	ENST00000675240.1	1525	1531	+	6	0	0	704
O95831-1#22	0	6	6	O95831-1	1356	1362	+	6	O95831-1	0	1839	ENST00000675092.1	90	1956	+	247	O95831-1#22	0	6	ENST00000675092.1	1446	1452	+	6	0	0	705
O95831-1#22	0	6	6	O95831-1	1356	1362	+	6	O95831-1	0	1839	ENST00000675050.1	71	1898	++	246	O95831-1#22	0	6	ENST00000675050.1	1415	1421	+	6	0	0	706
O95831-1#22	0	6	6	O95831-1	1356	1362	+	6	O95831-1	0	1454	ENST00000675037.1	56	1439	+	245	O95831-1#22	0	6	ENST00000675037.1	1412	1418	+	6	0	0	707
O95831-1#22	0	6	6	O95831-1	1356	1362	+	6	O95831-1	1012	1839	ENST00000674601.1	0	686	+	241	O95831-1#22	0	6	ENST00000674601.1	203	209	+	6	0	0	708
O95831-1#22	0	6	6	O95831-1	1356	1362	+	6	O95831-1	0	1762	ENST00000674546.1	185	1955	+	239	O95831-1#22	0	6	ENST00000674546.1	1541	1547	+	6	0	0	709
O95831-1#22	0	6	6	O95831-1	1356	1362	+	6	O95831-1	1017	1839	ENST00000460436.6	905	1727	+	105	O95831-1#22	0	6	ENST00000460436.6	1244	1250	+	6	0	0	710
O95831-1#22	0	6	6	O95831-1	1356	1362	+	6	O95831-1	0	1839	ENST00000346424.6	24	1002	++	34	O95831-1#22	0	6	ENST00000346424.6	519	525	+	6	0	0	711
O95831-1#22	0	6	6	O95831-1	1356	1362	+	6	O95831-1	0	1839	ENST00000319908.8	174	2007	+	25	O95831-1#22	0	6	ENST00000319908.8	1527	1533	+	6	0	0	712
O95831-1#22	0	6	6	O95831-1	1356	1362	+	6	O95831-1	0	1839	ENST00000287295.8	185	2024	++	16	O95831-1#22	0	6	ENST00000287295.8	1541	1547	+	6	0	0	713
O95831-1#23	0	6	6	O95831-1	1359	1365	+	6	O95831-1	0	1839	ENST00000676436.1	34	1861	+	255	O95831-1#23	0	6	ENST00000676436.1	1381	1387	+	6	0	0	714
O95831-1#23	0	6	6	O95831-1	1359	1365	+	6	O95831-1	0	1839	ENST00000676328.1	56	1892	+	254	O95831-1#23	0	6	ENST00000676328.1	1412	1418	+	6	0	0	715
O95831-1#23	0	6	6	O95831-1	1359	1365	+	6	O95831-1	0	1839	ENST00000676229.1	223	2050	++	253	O95831-1#23	0	6	ENST00000676229.1	1570	1576	+	6	0	0	716
O95831-1#23	0	6	6	O95831-1	1359	1365	+	6	O95831-1	0	1839	ENST00000675857.1	82	1915	+	251	O95831-1#23	0	6	ENST00000675857.1	1435	1441	+	6	0	0	717
O95831-1#23	0	6	6	O95831-1	1359	1365	+	6	O95831-1	0	1839	ENST00000675427.1	89	1925	+	249	O95831-1#23	0	6	ENST00000675427.1	1445	1451	+	6	0	0	718
O95831-1#23	0	6	6	O95831-1	1359	1365	+	6	O95831-1	0	1762	ENST00000675240.1	169	1867	+	248	O95831-1#23	0	6	ENST00000675240.1	1528	1534	+	6	0	0	719
O95831-1#23	0	6	6	O95831-1	1359	1365	+	6	O95831-1	0	1839	ENST00000675092.1	90	1956	+	247	O95831-1#23	0	6	ENST00000675092.1	1449	1455	+	6	0	0	720
O95831-1#23	0	6	6	O95831-1	1359	1365	+	6	O95831-1	0	1839	ENST00000675050.1	71	1898	++	246	O95831-1#23	0	6	ENST00000675050.1	1418	1424	+	6	0	0	721
O95831-1#23	0	6	6	O95831-1	1359	1365	+	6	O95831-1	0	1454	ENST00000675037.1	56	1439	+	245	O95831-1#23	0	6	ENST00000675037.1	1415	1421	+	6	0	0	722
O95831-1#23	0	6	6	O95831-1	1359	1365	+	6	O95831-1	1012	1839	ENST00000674601.1	0	686	+	241	O95831-1#23	0	6	ENST00000674601.1	206	212	+	6	0	0	723
O95831-1#23	0	6	6	O95831-1	1359	1365	+	6	O95831-1	0	1762	ENST00000674546.1	185	1955	+	239	O95831-1#23	0	6	ENST00000674546.1	1544	1550	+	6	0	0	724
O95831-1#23	0	6	6	O95831-1	1359	1365	+	6	O95831-1	1017	1839	ENST00000460436.6	905	1727	+	105	O95831-1#23	0	6	ENST00000460436.6	1247	1253	+	6	0	0	725
O95831-1#23	0	6	6	O95831-1	1359	1365	+	6	O95831-1	0	1839	ENST00000346424.6	24	1002	++	34	O95831-1#23	0	6	ENST00000346424.6	522	528	+	6	0	0	726
O95831-1#23	0	6	6	O95831-1	1359	1365	+	6	O95831-1	0	1839	ENST00000319908.8	174	2007	+	25	O95831-1#23	0	6	ENST00000319908.8	1530	1536	+	6	0	0	727
O95831-1#23	0	6	6	O95831-1	1359	1365	+	6	O95831-1	0	1839	ENST00000287295.8	185	2024	++	16	O95831-1#23	0	6	ENST00000287295.8	1544	1550	+	6	0	0	728
O95831-1#24	0	3	3	O95831-1	1446	1449	+	3	O95831-1	0	1839	ENST00000676436.1	34	1861	+	255	O95831-1#24	0	3	ENST00000676436.1	1468	1471	+	3	0	0	729
O95831-1#24	0	3	3	O95831-1	1446	1449	+	3	O95831-1	0	1839	ENST00000676328.1	56	1892	+	254	O95831-1#24	0	3	ENST00000676328.1	1499	1502	+	3	0	0	730
O95831-1#24	0	3	3	O95831-1	1446	1449	+	3	O95831-1	0	1839	ENST00000676229.1	223	2050	++	253	O95831-1#24	0	3	ENST00000676229.1	1657	1660	+	3	0	0	731
O95831-1#24	0	3	3	O95831-1	1446	1449	+	3	O95831-1	0	1839	ENST00000675857.1	82	1915	+	251	O95831-1#24	0	3	ENST00000675857.1	1522	1525	+	3	0	0	732
O95831-1#24	0	3	3	O95831-1	1446	1449	+	3	O95831-1	0	1839	ENST00000675427.1	89	1925	+	249	O95831-1#24	0	3	ENST00000675427.1	1532	1535	+	3	0	0	733
O95831-1#24	0	3	3	O95831-1	1446	1449	+	3	O95831-1	0	1762	ENST00000675240.1	169	1867	+	248	O95831-1#24	0	3	ENST00000675240.1	1615	1618	+	3	0	0	734
O95831-1#24	0	3	3	O95831-1	1446	1449	+	3	O95831-1	0	1839	ENST00000675092.1	90	1956	+	247	O95831-1#24	0	3	ENST00000675092.1	1536	1539	+	3	0	0	735
O95831-1#24	0	3	3	O95831-1	1446	1449	+	3	O95831-1	0	1839	ENST00000675050.1	71	1898	++	246	O95831-1#24	0	3	ENST00000675050.1	1505	1508	+	3	0	0	736
O95831-1#24	0	3	3	O95831-1	1446	1449	+	3	O95831-1	0	1454	ENST00000675037.1	56	1439	+	245	O95831-1#24	2	3	ENST00000675037.1	1433	1434	+	1	2	0	737
O95831-1#24	0	3	3	O95831-1	1446	1449	+	3	O95831-1	1012	1839	ENST00000674601.1	0	686	+	241	O95831-1#24	0	3	ENST00000674601.1	293	296	+	3	0	0	738
O95831-1#24	0	3	3	O95831-1	1446	1449	+	3	O95831-1	0	1762	ENST00000674546.1	185	1955	+	239	O95831-1#24	0	3	ENST00000674546.1	1631	1634	+	3	0	0	739
O95831-1#24	0	3	3	O95831-1	1446	1449	+	3	O95831-1	1017	1839	ENST00000460436.6	905	1727	+	105	O95831-1#24	0	3	ENST00000460436.6	1334	1337	+	3	0	0	740
O95831-1#24	0	3	3	O95831-1	1446	1449	+	3	O95831-1	0	1839	ENST00000346424.6	24	1002	++	34	O95831-1#24	0	3	ENST00000346424.6	609	612	+	3	0	0	741
O95831-1#24	0	3	3	O95831-1	1446	1449	+	3	O95831-1	0	1839	ENST00000319908.8	174	2007	+	25	O95831-1#24	0	2	ENST00000319908.8	1617	1619	+	2	0	1	742
O95831-1#24	0	3	3	O95831-1	1446	1449	+	3	O95831-1	0	1839	ENST00000287295.8	185	2024	++	16	O95831-1#24	0	3	ENST00000287295.8	1631	1634	+	3	0	0	743
O95831-1#25	0	3	3	O95831-1	1446	1449	+	3	O95831-1	0	1839	ENST00000676436.1	34	1861	+	255	O95831-1#25	0	3	ENST00000676436.1	1468	1471	+	3	0	0	744
O95831-1#25	0	3	3	O95831-1	1446	1449	+	3	O95831-1	0	1839	ENST00000676328.1	56	1892	+	254	O95831-1#25	0	3	ENST00000676328.1	1499	1502	+	3	0	0	745
O95831-1#25	0	3	3	O95831-1	1446	1449	+	3	O95831-1	0	1839	ENST00000676229.1	223	2050	++	253	O95831-1#25	0	3	ENST00000676229.1	1657	1660	+	3	0	0	746
O95831-1#25	0	3	3	O95831-1	1446	1449	+	3	O95831-1	0	1839	ENST00000675857.1	82	1915	+	251	O95831-1#25	0	3	ENST00000675857.1	1522	1525	+	3	0	0	747
O95831-1#25	0	3	3	O95831-1	1446	1449	+	3	O95831-1	0	1839	ENST00000675427.1	89	1925	+	249	O95831-1#25	0	3	ENST00000675427.1	1532	1535	+	3	0	0	748
O95831-1#25	0	3	3	O95831-1	1446	1449	+	3	O95831-1	0	1762	ENST00000675240.1	169	1867	+	248	O95831-1#25	0	3	ENST00000675240.1	1615	1618	+	3	0	0	749
O95831-1#25	0	3	3	O95831-1	1446	1449	+	3	O95831-1	0	1839	ENST00000675092.1	90	1956	+	247	O95831-1#25	0	3	ENST00000675092.1	1536	1539	+	3	0	0	750
O95831-1#25	0	3	3	O95831-1	1446	1449	+	3	O95831-1	0	1839	ENST00000675050.1	71	1898	++	246	O95831-1#25	0	3	ENST00000675050.1	1505	1508	+	3	0	0	751
O95831-1#25	0	3	3	O95831-1	1446	1449	+	3	O95831-1	0	1454	ENST00000675037.1	56	1439	+	245	O95831-1#25	2	3	ENST00000675037.1	1433	1434	+	1	2	0	752
O95831-1#25	0	3	3	O95831-1	1446	1449	+	3	O95831-1	1012	1839	ENST00000674601.1	0	686	+	241	O95831-1#25	0	3	ENST00000674601.1	293	296	+	3	0	0	753
O95831-1#25	0	3	3	O95831-1	1446	1449	+	3	O95831-1	0	1762	ENST00000674546.1	185	1955	+	239	O95831-1#25	0	3	ENST00000674546.1	1631	1634	+	3	0	0	754
O95831-1#25	0	3	3	O95831-1	1446	1449	+	3	O95831-1	1017	1839	ENST00000460436.6	905	1727	+	105	O95831-1#25	0	3	ENST00000460436.6	1334	1337	+	3	0	0	755
O95831-1#25	0	3	3	O95831-1	1446	1449	+	3	O95831-1	0	1839	ENST00000346424.6	24	1002	++	34	O95831-1#25	0	3	ENST00000346424.6	609	612	+	3	0	0	756
O95831-1#25	0	3	3	O95831-1	1446	1449	+	3	O95831-1	0	1839	ENST00000319908.8	174	2007	+	25	O95831-1#25	0	2	ENST00000319908.8	1617	1619	+	2	0	1	757
O95831-1#25	0	3	3	O95831-1	1446	1449	+	3	O95831-1	0	1839	ENST00000287295.8	185	2024	++	16	O95831-1#25	0	3	ENST00000287295.8	1631	1634	+	3	0	0	758
O95831-1#26	0	3	3	O95831-1	1476	1479	+	3	O95831-1	0	1839	ENST00000676436.1	34	1861	+	255	O95831-1#26	0	3	ENST00000676436.1	1498	1501	+	3	0	0	759
O95831-1#26	0	3	3	O95831-1	1476	1479	+	3	O95831-1	0	1839	ENST00000676328.1	56	1892	+	254	O95831-1#26	0	3	ENST00000676328.1	1529	1532	+	3	0	0	760
O95831-1#26	0	3	3	O95831-1	1476	1479	+	3	O95831-1	0	1839	ENST00000676229.1	223	2050	++	253	O95831-1#26	0	3	ENST00000676229.1	1687	1690	+	3	0	0	761
O95831-1#26	0	3	3	O95831-1	1476	1479	+	3	O95831-1	0	1839	ENST00000675857.1	82	1915	+	251	O95831-1#26	0	3	ENST00000675857.1	1552	1555	+	3	0	0	762
O95831-1#26	0	3	3	O95831-1	1476	1479	+	3	O95831-1	0	1839	ENST00000675427.1	89	1925	+	249	O95831-1#26	0	3	ENST00000675427.1	1562	1565	+	3	0	0	763
O95831-1#26	0	3	3	O95831-1	1476	1479	+	3	O95831-1	0	1762	ENST00000675240.1	169	1867	+	248	O95831-1#26	0	3	ENST00000675240.1	1645	1648	+	3	0	0	764
O95831-1#26	0	3	3	O95831-1	1476	1479	+	3	O95831-1	0	1839	ENST00000675092.1	90	1956	+	247	O95831-1#26	0	3	ENST00000675092.1	1566	1569	+	3	0	0	765
O95831-1#26	0	3	3	O95831-1	1476	1479	+	3	O95831-1	0	1839	ENST00000675050.1	71	1898	++	246	O95831-1#26	0	3	ENST00000675050.1	1535	1538	+	3	0	0	766
O95831-1#26	0	3	3	O95831-1	1476	1479	+	3	O95831-1	1012	1839	ENST00000674601.1	0	686	+	241	O95831-1#26	0	3	ENST00000674601.1	323	326	+	3	0	0	767
O95831-1#26	0	3	3	O95831-1	1476	1479	+	3	O95831-1	0	1762	ENST00000674546.1	185	1955	+	239	O95831-1#26	0	3	ENST00000674546.1	1661	1664	+	3	0	0	768
O95831-1#26	0	3	3	O95831-1	1476	1479	+	3	O95831-1	1017	1839	ENST00000460436.6	905	1727	+	105	O95831-1#26	0	3	ENST00000460436.6	1364	1367	+	3	0	0	769
O95831-1#26	0	3	3	O95831-1	1476	1479	+	3	O95831-1	0	1839	ENST00000346424.6	24	1002	++	34	O95831-1#26	0	3	ENST00000346424.6	639	642	+	3	0	0	770
O95831-1#26	0	3	3	O95831-1	1476	1479	+	3	O95831-1	0	1839	ENST00000319908.8	174	2007	+	25	O95831-1#26	0	3	ENST00000319908.8	1644	1647	+	3	0	0	771
O95831-1#26	0	3	3	O95831-1	1476	1479	+	3	O95831-1	0	1839	ENST00000287295.8	185	2024	++	16	O95831-1#26	0	3	ENST00000287295.8	1661	1664	+	3	0	0	772
O95831-1#27	0	3	3	O95831-1	1746	1749	+	3	O95831-1	0	1839	ENST00000676436.1	34	1861	+	255	O95831-1#27	0	3	ENST00000676436.1	1768	1771	+	3	0	0	773
O95831-1#27	0	3	3	O95831-1	1746	1749	+	3	O95831-1	0	1839	ENST00000676328.1	56	1892	+	254	O95831-1#27	0	3	ENST00000676328.1	1799	1802	+	3	0	0	774
O95831-1#27	0	3	3	O95831-1	1746	1749	+	3	O95831-1	0	1839	ENST00000676229.1	223	2050	++	253	O95831-1#27	0	3	ENST00000676229.1	1957	1960	+	3	0	0	775
O95831-1#27	0	3	3	O95831-1	1746	1749	+	3	O95831-1	0	1839	ENST00000675857.1	82	1915	+	251	O95831-1#27	0	3	ENST00000675857.1	1822	1825	+	3	0	0	776
O95831-1#27	0	3	3	O95831-1	1746	1749	+	3	O95831-1	0	1839	ENST00000675427.1	89	1925	+	249	O95831-1#27	0	3	ENST00000675427.1	1832	1835	+	3	0	0	777
O95831-1#27	0	3	3	O95831-1	1746	1749	+	3	O95831-1	0	1762	ENST00000675240.1	169	1867	+	248	O95831-1#27	0	3	ENST00000675240.1	1851	1854	+	3	0	0	778
O95831-1#27	0	3	3	O95831-1	1746	1749	+	3	O95831-1	0	1839	ENST00000675092.1	90	1956	+	247	O95831-1#27	0	3	ENST00000675092.1	1863	1866	+	3	0	0	779
O95831-1#27	0	3	3	O95831-1	1746	1749	+	3	O95831-1	0	1839	ENST00000675050.1	71	1898	++	246	O95831-1#27	0	3	ENST00000675050.1	1805	1808	+	3	0	0	780
O95831-1#27	0	3	3	O95831-1	1746	1749	+	3	O95831-1	1012	1839	ENST00000674601.1	0	686	+	241	O95831-1#27	0	3	ENST00000674601.1	593	596	+	3	0	0	781
O95831-1#27	0	3	3	O95831-1	1746	1749	+	3	O95831-1	0	1762	ENST00000674546.1	185	1955	+	239	O95831-1#27	0	3	ENST00000674546.1	1939	1942	+	3	0	0	782
O95831-1#27	0	3	3	O95831-1	1746	1749	+	3	O95831-1	1017	1839	ENST00000460436.6	905	1727	+	105	O95831-1#27	0	3	ENST00000460436.6	1634	1637	+	3	0	0	783
O95831-1#27	0	3	3	O95831-1	1746	1749	+	3	O95831-1	0	1839	ENST00000346424.6	24	1002	++	34	O95831-1#27	0	3	ENST00000346424.6	909	912	+	3	0	0	784
O95831-1#27	0	3	3	O95831-1	1746	1749	+	3	O95831-1	0	1839	ENST00000319908.8	174	2007	+	25	O95831-1#27	0	3	ENST00000319908.8	1914	1917	+	3	0	0	785
O95831-1#27	0	3	3	O95831-1	1746	1749	+	3	O95831-1	0	1839	ENST00000287295.8	185	2024	++	16	O95831-1#27	0	3	ENST00000287295.8	1931	1934	+	3	0	0	786
O95831-1#28	0	3	3	O95831-1	312	315	+	3	O95831-1	0	1839	ENST00000676436.1	34	1861	+	255	O95831-1#28	0	3	ENST00000676436.1	346	349	+	3	0	0	787
O95831-1#28	0	3	3	O95831-1	312	315	+	3	O95831-1	0	1839	ENST00000676328.1	56	1892	+	254	O95831-1#28	0	3	ENST00000676328.1	368	371	+	3	0	0	788
O95831-1#28	0	3	3	O95831-1	312	315	+	3	O95831-1	0	1839	ENST00000676229.1	223	2050	++	253	O95831-1#28	0	3	ENST00000676229.1	523	526	+	3	0	0	789
O95831-1#28	0	3	3	O95831-1	312	315	+	3	O95831-1	284	409	ENST00000676144.1	0	184	+	252	O95831-1#28	0	3	ENST00000676144.1	28	31	+	3	0	0	790
O95831-1#28	0	3	3	O95831-1	312	315	+	3	O95831-1	0	1839	ENST00000675857.1	82	1915	+	251	O95831-1#28	0	3	ENST00000675857.1	394	397	+	3	0	0	791
O95831-1#28	0	3	3	O95831-1	312	315	+	3	O95831-1	0	1839	ENST00000675427.1	89	1925	+	249	O95831-1#28	0	3	ENST00000675427.1	401	404	+	3	0	0	792
O95831-1#28	0	3	3	O95831-1	312	315	+	3	O95831-1	0	1762	ENST00000675240.1	169	1867	+	248	O95831-1#28	0	3	ENST00000675240.1	481	484	+	3	0	0	793
O95831-1#28	0	3	3	O95831-1	312	315	+	3	O95831-1	0	1839	ENST00000675092.1	90	1956	+	247	O95831-1#28	0	3	ENST00000675092.1	402	405	+	3	0	0	794
O95831-1#28	0	3	3	O95831-1	312	315	+	3	O95831-1	0	1839	ENST00000675050.1	71	1898	++	246	O95831-1#28	0	3	ENST00000675050.1	371	374	+	3	0	0	795
O95831-1#28	0	3	3	O95831-1	312	315	+	3	O95831-1	0	1454	ENST00000675037.1	56	1439	+	245	O95831-1#28	0	3	ENST00000675037.1	368	371	+	3	0	0	796
O95831-1#28	0	3	3	O95831-1	312	315	+	3	O95831-1	299	1183	ENST00000674957.1	0	880	+	243	O95831-1#28	0	3	ENST00000674957.1	13	16	+	3	0	0	797
O95831-1#28	0	3	3	O95831-1	312	315	+	3	O95831-1	0	832	ENST00000674722.1	13	760	+	242	O95831-1#28	0	3	ENST00000674722.1	325	328	+	3	0	0	798
O95831-1#28	0	3	3	O95831-1	312	315	+	3	O95831-1	0	1762	ENST00000674546.1	185	1955	+	239	O95831-1#28	0	3	ENST00000674546.1	497	500	+	3	0	0	799
O95831-1#28	0	3	3	O95831-1	312	315	+	3	O95831-1	0	966	ENST00000535724.6	8	974	++	156	O95831-1#28	0	3	ENST00000535724.6	320	323	+	3	0	0	800
O95831-1#28	0	3	3	O95831-1	312	315	+	3	O95831-1	0	1336	ENST00000416073.7	37	1363	+	76	O95831-1#28	0	3	ENST00000416073.7	349	352	+	3	0	0	801
O95831-1#28	0	3	3	O95831-1	312	315	+	3	O95831-1	0	1839	ENST00000319908.8	174	2007	+	25	O95831-1#28	0	3	ENST00000319908.8	486	489	+	3	0	0	802
O95831-1#28	0	3	3	O95831-1	312	315	+	3	O95831-1	0	1839	ENST00000287295.8	185	2024	++	16	O95831-1#28	0	3	ENST00000287295.8	497	500	+	3	0	0	803
O95831-1#29	0	3	3	O95831-1	324	327	+	3	O95831-1	0	1839	ENST00000676436.1	34	1861	+	255	O95831-1#29	0	3	ENST00000676436.1	358	361	+	3	0	0	804
O95831-1#29	0	3	3	O95831-1	324	327	+	3	O95831-1	0	1839	ENST00000676328.1	56	1892	+	254	O95831-1#29	0	3	ENST00000676328.1	380	383	+	3	0	0	805
O95831-1#29	0	3	3	O95831-1	324	327	+	3	O95831-1	0	1839	ENST00000676229.1	223	2050	++	253	O95831-1#29	0	3	ENST00000676229.1	535	538	+	3	0	0	806
O95831-1#29	0	3	3	O95831-1	324	327	+	3	O95831-1	284	409	ENST00000676144.1	0	184	+	252	O95831-1#29	0	3	ENST00000676144.1	40	43	+	3	0	0	807
O95831-1#29	0	3	3	O95831-1	324	327	+	3	O95831-1	0	1839	ENST00000675857.1	82	1915	+	251	O95831-1#29	0	3	ENST00000675857.1	406	409	+	3	0	0	808
O95831-1#29	0	3	3	O95831-1	324	327	+	3	O95831-1	0	1839	ENST00000675427.1	89	1925	+	249	O95831-1#29	0	3	ENST00000675427.1	413	416	+	3	0	0	809
O95831-1#29	0	3	3	O95831-1	324	327	+	3	O95831-1	0	1762	ENST00000675240.1	169	1867	+	248	O95831-1#29	0	3	ENST00000675240.1	493	496	+	3	0	0	810
O95831-1#29	0	3	3	O95831-1	324	327	+	3	O95831-1	0	1839	ENST00000675092.1	90	1956	+	247	O95831-1#29	0	3	ENST00000675092.1	414	417	+	3	0	0	811
O95831-1#29	0	3	3	O95831-1	324	327	+	3	O95831-1	0	1839	ENST00000675050.1	71	1898	++	246	O95831-1#29	0	3	ENST00000675050.1	383	386	+	3	0	0	812
O95831-1#29	0	3	3	O95831-1	324	327	+	3	O95831-1	0	1454	ENST00000675037.1	56	1439	+	245	O95831-1#29	0	3	ENST00000675037.1	380	383	+	3	0	0	813
O95831-1#29	0	3	3	O95831-1	324	327	+	3	O95831-1	299	1183	ENST00000674957.1	0	880	+	243	O95831-1#29	0	3	ENST00000674957.1	25	28	+	3	0	0	814
O95831-1#29	0	3	3	O95831-1	324	327	+	3	O95831-1	0	832	ENST00000674722.1	13	760	+	242	O95831-1#29	0	3	ENST00000674722.1	337	340	+	3	0	0	815
O95831-1#29	0	3	3	O95831-1	324	327	+	3	O95831-1	0	1762	ENST00000674546.1	185	1955	+	239	O95831-1#29	0	3	ENST00000674546.1	509	512	+	3	0	0	816
O95831-1#29	0	3	3	O95831-1	324	327	+	3	O95831-1	0	966	ENST00000535724.6	8	974	++	156	O95831-1#29	0	3	ENST00000535724.6	332	335	+	3	0	0	817
O95831-1#29	0	3	3	O95831-1	324	327	+	3	O95831-1	0	1336	ENST00000416073.7	37	1363	+	76	O95831-1#29	0	3	ENST00000416073.7	361	364	+	3	0	0	818
O95831-1#29	0	3	3	O95831-1	324	327	+	3	O95831-1	0	1839	ENST00000319908.8	174	2007	+	25	O95831-1#29	0	3	ENST00000319908.8	498	501	+	3	0	0	819
O95831-1#29	0	3	3	O95831-1	324	327	+	3	O95831-1	0	1839	ENST00000287295.8	185	2024	++	16	O95831-1#29	0	3	ENST00000287295.8	509	512	+	3	0	0	820
O95831-1#30	0	3	3	O95831-1	345	348	+	3	O95831-1	0	1839	ENST00000676436.1	34	1861	+	255	O95831-1#30	0	3	ENST00000676436.1	379	382	+	3	0	0	821
O95831-1#30	0	3	3	O95831-1	345	348	+	3	O95831-1	0	1839	ENST00000676328.1	56	1892	+	254	O95831-1#30	0	3	ENST00000676328.1	401	404	+	3	0	0	822
O95831-1#30	0	3	3	O95831-1	345	348	+	3	O95831-1	0	1839	ENST00000676229.1	223	2050	++	253	O95831-1#30	0	3	ENST00000676229.1	556	559	+	3	0	0	823
O95831-1#30	0	3	3	O95831-1	345	348	+	3	O95831-1	284	409	ENST00000676144.1	0	184	+	252	O95831-1#30	0	3	ENST00000676144.1	61	64	+	3	0	0	824
O95831-1#30	0	3	3	O95831-1	345	348	+	3	O95831-1	0	1839	ENST00000675857.1	82	1915	+	251	O95831-1#30	0	3	ENST00000675857.1	427	430	+	3	0	0	825
O95831-1#30	0	3	3	O95831-1	345	348	+	3	O95831-1	0	1839	ENST00000675427.1	89	1925	+	249	O95831-1#30	0	3	ENST00000675427.1	434	437	+	3	0	0	826
O95831-1#30	0	3	3	O95831-1	345	348	+	3	O95831-1	0	1762	ENST00000675240.1	169	1867	+	248	O95831-1#30	0	3	ENST00000675240.1	514	517	+	3	0	0	827
O95831-1#30	0	3	3	O95831-1	345	348	+	3	O95831-1	0	1839	ENST00000675092.1	90	1956	+	247	O95831-1#30	0	3	ENST00000675092.1	435	438	+	3	0	0	828
O95831-1#30	0	3	3	O95831-1	345	348	+	3	O95831-1	0	1839	ENST00000675050.1	71	1898	++	246	O95831-1#30	0	3	ENST00000675050.1	404	407	+	3	0	0	829
O95831-1#30	0	3	3	O95831-1	345	348	+	3	O95831-1	0	1454	ENST00000675037.1	56	1439	+	245	O95831-1#30	0	3	ENST00000675037.1	401	404	+	3	0	0	830
O95831-1#30	0	3	3	O95831-1	345	348	+	3	O95831-1	299	1183	ENST00000674957.1	0	880	+	243	O95831-1#30	0	3	ENST00000674957.1	46	49	+	3	0	0	831
O95831-1#30	0	3	3	O95831-1	345	348	+	3	O95831-1	0	832	ENST00000674722.1	13	760	+	242	O95831-1#30	0	3	ENST00000674722.1	358	361	+	3	0	0	832
O95831-1#30	0	3	3	O95831-1	345	348	+	3	O95831-1	0	1762	ENST00000674546.1	185	1955	+	239	O95831-1#30	0	3	ENST00000674546.1	530	533	+	3	0	0	833
O95831-1#30	0	3	3	O95831-1	345	348	+	3	O95831-1	0	966	ENST00000535724.6	8	974	++	156	O95831-1#30	0	3	ENST00000535724.6	353	356	+	3	0	0	834
O95831-1#30	0	3	3	O95831-1	345	348	+	3	O95831-1	0	1336	ENST00000416073.7	37	1363	+	76	O95831-1#30	0	3	ENST00000416073.7	382	385	+	3	0	0	835
O95831-1#30	0	3	3	O95831-1	345	348	+	3	O95831-1	0	1839	ENST00000319908.8	174	2007	+	25	O95831-1#30	0	3	ENST00000319908.8	519	522	+	3	0	0	836
O95831-1#30	0	3	3	O95831-1	345	348	+	3	O95831-1	0	1839	ENST00000287295.8	185	2024	++	16	O95831-1#30	0	3	ENST00000287295.8	530	533	+	3	0	0	837
O95831-1#31	0	3	3	O95831-1	351	354	+	3	O95831-1	0	1839	ENST00000676328.1	56	1892	+	254	O95831-1#31	0	3	ENST00000676328.1	407	410	+	3	0	0	838
O95831-1#31	0	3	3	O95831-1	351	354	+	3	O95831-1	0	1839	ENST00000676229.1	223	2050	++	253	O95831-1#31	0	3	ENST00000676229.1	562	565	+	3	0	0	839
O95831-1#31	0	3	3	O95831-1	351	354	+	3	O95831-1	284	409	ENST00000676144.1	0	184	+	252	O95831-1#31	0	3	ENST00000676144.1	126	129	+	3	0	0	840
O95831-1#31	0	3	3	O95831-1	351	354	+	3	O95831-1	0	1839	ENST00000675427.1	89	1925	+	249	O95831-1#31	0	3	ENST00000675427.1	440	443	+	3	0	0	841
O95831-1#31	0	3	3	O95831-1	351	354	+	3	O95831-1	0	1762	ENST00000675240.1	169	1867	+	248	O95831-1#31	0	3	ENST00000675240.1	520	523	+	3	0	0	842
O95831-1#31	0	3	3	O95831-1	351	354	+	3	O95831-1	0	1839	ENST00000675092.1	90	1956	+	247	O95831-1#31	0	3	ENST00000675092.1	441	444	+	3	0	0	843
O95831-1#31	0	3	3	O95831-1	351	354	+	3	O95831-1	0	1839	ENST00000675050.1	71	1898	++	246	O95831-1#31	0	3	ENST00000675050.1	410	413	+	3	0	0	844
O95831-1#31	0	3	3	O95831-1	351	354	+	3	O95831-1	0	1454	ENST00000675037.1	56	1439	+	245	O95831-1#31	0	3	ENST00000675037.1	407	410	+	3	0	0	845
O95831-1#31	0	3	3	O95831-1	351	354	+	3	O95831-1	299	1183	ENST00000674957.1	0	880	+	243	O95831-1#31	0	3	ENST00000674957.1	52	55	+	3	0	0	846
O95831-1#31	0	3	3	O95831-1	351	354	+	3	O95831-1	0	832	ENST00000674722.1	13	760	+	242	O95831-1#31	0	3	ENST00000674722.1	364	367	+	3	0	0	847
O95831-1#31	0	3	3	O95831-1	351	354	+	3	O95831-1	0	1762	ENST00000674546.1	185	1955	+	239	O95831-1#31	0	3	ENST00000674546.1	536	539	+	3	0	0	848
O95831-1#31	0	3	3	O95831-1	351	354	+	3	O95831-1	0	966	ENST00000535724.6	8	974	++	156	O95831-1#31	0	3	ENST00000535724.6	359	362	+	3	0	0	849
O95831-1#31	0	3	3	O95831-1	351	354	+	3	O95831-1	0	1839	ENST00000319908.8	174	2007	+	25	O95831-1#31	0	3	ENST00000319908.8	525	528	+	3	0	0	850
O95831-1#31	0	3	3	O95831-1	351	354	+	3	O95831-1	0	1839	ENST00000287295.8	185	2024	++	16	O95831-1#31	0	3	ENST00000287295.8	536	539	+	3	0	0	851
O95831-1#32	0	3	3	O95831-1	801	804	+	3	O95831-1	0	1839	ENST00000676436.1	34	1861	+	255	O95831-1#32	0	3	ENST00000676436.1	829	832	+	3	0	0	852
O95831-1#32	0	3	3	O95831-1	801	804	+	3	O95831-1	0	1839	ENST00000676328.1	56	1892	+	254	O95831-1#32	0	3	ENST00000676328.1	854	857	+	3	0	0	853
O95831-1#32	0	3	3	O95831-1	801	804	+	3	O95831-1	0	1839	ENST00000676229.1	223	2050	++	253	O95831-1#32	0	3	ENST00000676229.1	1012	1015	+	3	0	0	854
O95831-1#32	0	3	3	O95831-1	801	804	+	3	O95831-1	0	1839	ENST00000675857.1	82	1915	+	251	O95831-1#32	0	3	ENST00000675857.1	877	880	+	3	0	0	855
O95831-1#32	0	3	3	O95831-1	801	804	+	3	O95831-1	0	1839	ENST00000675427.1	89	1925	+	249	O95831-1#32	0	3	ENST00000675427.1	890	893	+	3	0	0	856
O95831-1#32	0	3	3	O95831-1	801	804	+	3	O95831-1	0	1762	ENST00000675240.1	169	1867	+	248	O95831-1#32	0	3	ENST00000675240.1	970	973	+	3	0	0	857
O95831-1#32	0	3	3	O95831-1	801	804	+	3	O95831-1	0	1839	ENST00000675092.1	90	1956	+	247	O95831-1#32	0	3	ENST00000675092.1	891	894	+	3	0	0	858
O95831-1#32	0	3	3	O95831-1	801	804	+	3	O95831-1	0	1839	ENST00000675050.1	71	1898	++	246	O95831-1#32	0	3	ENST00000675050.1	860	863	+	3	0	0	859
O95831-1#32	0	3	3	O95831-1	801	804	+	3	O95831-1	0	1454	ENST00000675037.1	56	1439	+	245	O95831-1#32	0	3	ENST00000675037.1	857	860	+	3	0	0	860
O95831-1#32	0	3	3	O95831-1	801	804	+	3	O95831-1	299	1183	ENST00000674957.1	0	880	+	243	O95831-1#32	0	3	ENST00000674957.1	502	505	+	3	0	0	861
O95831-1#32	0	3	3	O95831-1	801	804	+	3	O95831-1	0	832	ENST00000674722.1	13	760	+	242	O95831-1#32	0	3	ENST00000674722.1	729	732	+	3	0	0	862
O95831-1#32	0	3	3	O95831-1	801	804	+	3	O95831-1	0	1762	ENST00000674546.1	185	1955	+	239	O95831-1#32	0	3	ENST00000674546.1	986	989	+	3	0	0	863
O95831-1#32	0	3	3	O95831-1	801	804	+	3	O95831-1	0	966	ENST00000535724.6	8	974	++	156	O95831-1#32	0	3	ENST00000535724.6	809	812	+	3	0	0	864
O95831-1#32	0	3	3	O95831-1	801	804	+	3	O95831-1	0	1336	ENST00000416073.7	37	1363	+	76	O95831-1#32	0	3	ENST00000416073.7	832	835	+	3	0	0	865
O95831-1#32	0	3	3	O95831-1	801	804	+	3	O95831-1	0	1839	ENST00000319908.8	174	2007	+	25	O95831-1#32	0	3	ENST00000319908.8	972	975	+	3	0	0	866
O95831-1#32	0	3	3	O95831-1	801	804	+	3	O95831-1	0	1839	ENST00000287295.8	185	2024	++	16	O95831-1#32	0	3	ENST00000287295.8	986	989	+	3	0	0	867
O95831-1#33	0	3	3	O95831-1	873	876	+	3	O95831-1	0	1839	ENST00000676436.1	34	1861	+	255	O95831-1#33	0	3	ENST00000676436.1	901	904	+	3	0	0	868
O95831-1#33	0	3	3	O95831-1	873	876	+	3	O95831-1	0	1839	ENST00000676328.1	56	1892	+	254	O95831-1#33	0	3	ENST00000676328.1	926	929	+	3	0	0	869
O95831-1#33	0	3	3	O95831-1	873	876	+	3	O95831-1	0	1839	ENST00000676229.1	223	2050	++	253	O95831-1#33	0	3	ENST00000676229.1	1084	1087	+	3	0	0	870
O95831-1#33	0	3	3	O95831-1	873	876	+	3	O95831-1	0	1839	ENST00000675857.1	82	1915	+	251	O95831-1#33	0	3	ENST00000675857.1	949	952	+	3	0	0	871
O95831-1#33	0	3	3	O95831-1	873	876	+	3	O95831-1	0	1839	ENST00000675427.1	89	1925	+	249	O95831-1#33	0	3	ENST00000675427.1	962	965	+	3	0	0	872
O95831-1#33	0	3	3	O95831-1	873	876	+	3	O95831-1	0	1762	ENST00000675240.1	169	1867	+	248	O95831-1#33	0	3	ENST00000675240.1	1042	1045	+	3	0	0	873
O95831-1#33	0	3	3	O95831-1	873	876	+	3	O95831-1	0	1839	ENST00000675092.1	90	1956	+	247	O95831-1#33	0	3	ENST00000675092.1	963	966	+	3	0	0	874
O95831-1#33	0	3	3	O95831-1	873	876	+	3	O95831-1	0	1839	ENST00000675050.1	71	1898	++	246	O95831-1#33	0	3	ENST00000675050.1	932	935	+	3	0	0	875
O95831-1#33	0	3	3	O95831-1	873	876	+	3	O95831-1	0	1454	ENST00000675037.1	56	1439	+	245	O95831-1#33	0	3	ENST00000675037.1	929	932	+	3	0	0	876
O95831-1#33	0	3	3	O95831-1	873	876	+	3	O95831-1	299	1183	ENST00000674957.1	0	880	+	243	O95831-1#33	0	3	ENST00000674957.1	574	577	+	3	0	0	877
O95831-1#33	0	3	3	O95831-1	873	876	+	3	O95831-1	0	1762	ENST00000674546.1	185	1955	+	239	O95831-1#33	0	3	ENST00000674546.1	1058	1061	+	3	0	0	878
O95831-1#33	0	3	3	O95831-1	873	876	+	3	O95831-1	0	966	ENST00000535724.6	8	974	++	156	O95831-1#33	0	3	ENST00000535724.6	881	884	+	3	0	0	879
O95831-1#33	0	3	3	O95831-1	873	876	+	3	O95831-1	0	1336	ENST00000416073.7	37	1363	+	76	O95831-1#33	0	3	ENST00000416073.7	904	907	+	3	0	0	880
O95831-1#33	0	3	3	O95831-1	873	876	+	3	O95831-1	0	1839	ENST00000319908.8	174	2007	+	25	O95831-1#33	0	3	ENST00000319908.8	1044	1047	+	3	0	0	881
O95831-1#33	0	3	3	O95831-1	873	876	+	3	O95831-1	0	1839	ENST00000287295.8	185	2024	++	16	O95831-1#33	0	3	ENST00000287295.8	1058	1061	+	3	0	0	882
O95831-1#34	0	3	3	O95831-1	1110	1113	+	3	O95831-1	0	1839	ENST00000676436.1	34	1861	+	255	O95831-1#34	0	3	ENST00000676436.1	1132	1135	+	3	0	0	883
O95831-1#34	0	3	3	O95831-1	1110	1113	+	3	O95831-1	0	1839	ENST00000676328.1	56	1892	+	254	O95831-1#34	0	3	ENST00000676328.1	1163	1166	+	3	0	0	884
O95831-1#34	0	3	3	O95831-1	1110	1113	+	3	O95831-1	0	1839	ENST00000676229.1	223	2050	++	253	O95831-1#34	0	3	ENST00000676229.1	1321	1324	+	3	0	0	885
O95831-1#34	0	3	3	O95831-1	1110	1113	+	3	O95831-1	0	1839	ENST00000675857.1	82	1915	+	251	O95831-1#34	0	3	ENST00000675857.1	1186	1189	+	3	0	0	886
O95831-1#34	0	3	3	O95831-1	1110	1113	+	3	O95831-1	0	1839	ENST00000675427.1	89	1925	+	249	O95831-1#34	0	3	ENST00000675427.1	1199	1202	+	3	0	0	887
O95831-1#34	0	3	3	O95831-1	1110	1113	+	3	O95831-1	0	1762	ENST00000675240.1	169	1867	+	248	O95831-1#34	0	3	ENST00000675240.1	1279	1282	+	3	0	0	888
O95831-1#34	0	3	3	O95831-1	1110	1113	+	3	O95831-1	0	1839	ENST00000675092.1	90	1956	+	247	O95831-1#34	0	3	ENST00000675092.1	1200	1203	+	3	0	0	889
O95831-1#34	0	3	3	O95831-1	1110	1113	+	3	O95831-1	0	1839	ENST00000675050.1	71	1898	++	246	O95831-1#34	0	3	ENST00000675050.1	1169	1172	+	3	0	0	890
O95831-1#34	0	3	3	O95831-1	1110	1113	+	3	O95831-1	0	1454	ENST00000675037.1	56	1439	+	245	O95831-1#34	0	3	ENST00000675037.1	1166	1169	+	3	0	0	891
O95831-1#34	0	3	3	O95831-1	1110	1113	+	3	O95831-1	299	1183	ENST00000674957.1	0	880	+	243	O95831-1#34	0	3	ENST00000674957.1	811	814	+	3	0	0	892
O95831-1#34	0	3	3	O95831-1	1110	1113	+	3	O95831-1	1012	1839	ENST00000674601.1	0	686	+	241	O95831-1#34	0	3	ENST00000674601.1	98	101	+	3	0	0	893
O95831-1#34	0	3	3	O95831-1	1110	1113	+	3	O95831-1	0	1762	ENST00000674546.1	185	1955	+	239	O95831-1#34	0	3	ENST00000674546.1	1295	1298	+	3	0	0	894
O95831-1#34	0	3	3	O95831-1	1110	1113	+	3	O95831-1	1017	1839	ENST00000460436.6	905	1727	+	105	O95831-1#34	0	3	ENST00000460436.6	998	1001	+	3	0	0	895
O95831-1#34	0	3	3	O95831-1	1110	1113	+	3	O95831-1	0	1336	ENST00000416073.7	37	1363	+	76	O95831-1#34	0	3	ENST00000416073.7	1141	1144	+	3	0	0	896
O95831-1#34	0	3	3	O95831-1	1110	1113	+	3	O95831-1	0	1839	ENST00000346424.6	24	1002	++	34	O95831-1#34	0	3	ENST00000346424.6	273	276	+	3	0	0	897
O95831-1#34	0	3	3	O95831-1	1110	1113	+	3	O95831-1	0	1839	ENST00000319908.8	174	2007	+	25	O95831-1#34	0	3	ENST00000319908.8	1281	1284	+	3	0	0	898
O95831-1#34	0	3	3	O95831-1	1110	1113	+	3	O95831-1	0	1839	ENST00000287295.8	185	2024	++	16	O95831-1#34	0	3	ENST00000287295.8	1295	1298	+	3	0	0	899
O95831-1#35	0	3	3	O95831-1	1161	1164	+	3	O95831-1	0	1839	ENST00000676436.1	34	1861	+	255	O95831-1#35	0	3	ENST00000676436.1	1183	1186	+	3	0	0	900
O95831-1#35	0	3	3	O95831-1	1161	1164	+	3	O95831-1	0	1839	ENST00000676328.1	56	1892	+	254	O95831-1#35	0	3	ENST00000676328.1	1214	1217	+	3	0	0	901
O95831-1#35	0	3	3	O95831-1	1161	1164	+	3	O95831-1	0	1839	ENST00000676229.1	223	2050	++	253	O95831-1#35	0	3	ENST00000676229.1	1372	1375	+	3	0	0	902
O95831-1#35	0	3	3	O95831-1	1161	1164	+	3	O95831-1	0	1839	ENST00000675857.1	82	1915	+	251	O95831-1#35	0	3	ENST00000675857.1	1237	1240	+	3	0	0	903
O95831-1#35	0	3	3	O95831-1	1161	1164	+	3	O95831-1	0	1839	ENST00000675427.1	89	1925	+	249	O95831-1#35	0	3	ENST00000675427.1	1250	1253	+	3	0	0	904
O95831-1#35	0	3	3	O95831-1	1161	1164	+	3	O95831-1	0	1762	ENST00000675240.1	169	1867	+	248	O95831-1#35	0	3	ENST00000675240.1	1330	1333	+	3	0	0	905
O95831-1#35	0	3	3	O95831-1	1161	1164	+	3	O95831-1	0	1839	ENST00000675092.1	90	1956	+	247	O95831-1#35	0	3	ENST00000675092.1	1251	1254	+	3	0	0	906
O95831-1#35	0	3	3	O95831-1	1161	1164	+	3	O95831-1	0	1839	ENST00000675050.1	71	1898	++	246	O95831-1#35	0	3	ENST00000675050.1	1220	1223	+	3	0	0	907
O95831-1#35	0	3	3	O95831-1	1161	1164	+	3	O95831-1	0	1454	ENST00000675037.1	56	1439	+	245	O95831-1#35	0	3	ENST00000675037.1	1217	1220	+	3	0	0	908
O95831-1#35	0	3	3	O95831-1	1161	1164	+	3	O95831-1	299	1183	ENST00000674957.1	0	880	+	243	O95831-1#35	0	3	ENST00000674957.1	862	865	+	3	0	0	909
O95831-1#35	0	3	3	O95831-1	1161	1164	+	3	O95831-1	1012	1839	ENST00000674601.1	0	686	+	241	O95831-1#35	0	3	ENST00000674601.1	149	152	+	3	0	0	910
O95831-1#35	0	3	3	O95831-1	1161	1164	+	3	O95831-1	0	1762	ENST00000674546.1	185	1955	+	239	O95831-1#35	0	3	ENST00000674546.1	1346	1349	+	3	0	0	911
O95831-1#35	0	3	3	O95831-1	1161	1164	+	3	O95831-1	1017	1839	ENST00000460436.6	905	1727	+	105	O95831-1#35	0	3	ENST00000460436.6	1049	1052	+	3	0	0	912
O95831-1#35	0	3	3	O95831-1	1161	1164	+	3	O95831-1	0	1336	ENST00000416073.7	37	1363	+	76	O95831-1#35	0	3	ENST00000416073.7	1192	1195	+	3	0	0	913
O95831-1#35	0	3	3	O95831-1	1161	1164	+	3	O95831-1	0	1839	ENST00000346424.6	24	1002	++	34	O95831-1#35	0	3	ENST00000346424.6	324	327	+	3	0	0	914
O95831-1#35	0	3	3	O95831-1	1161	1164	+	3	O95831-1	0	1839	ENST00000319908.8	174	2007	+	25	O95831-1#35	0	3	ENST00000319908.8	1332	1335	+	3	0	0	915
O95831-1#35	0	3	3	O95831-1	1161	1164	+	3	O95831-1	0	1839	ENST00000287295.8	185	2024	++	16	O95831-1#35	0	3	ENST00000287295.8	1346	1349	+	3	0	0	916
O95831-1#36	0	3	3	O95831-1	1560	1563	+	3	O95831-1	0	1839	ENST00000676436.1	34	1861	+	255	O95831-1#36	0	3	ENST00000676436.1	1582	1585	+	3	0	0	917
O95831-1#36	0	3	3	O95831-1	1560	1563	+	3	O95831-1	0	1839	ENST00000676328.1	56	1892	+	254	O95831-1#36	0	3	ENST00000676328.1	1613	1616	+	3	0	0	918
O95831-1#36	0	3	3	O95831-1	1560	1563	+	3	O95831-1	0	1839	ENST00000676229.1	223	2050	++	253	O95831-1#36	0	3	ENST00000676229.1	1771	1774	+	3	0	0	919
O95831-1#36	0	3	3	O95831-1	1560	1563	+	3	O95831-1	0	1839	ENST00000675857.1	82	1915	+	251	O95831-1#36	0	3	ENST00000675857.1	1636	1639	+	3	0	0	920
O95831-1#36	0	3	3	O95831-1	1560	1563	+	3	O95831-1	0	1839	ENST00000675427.1	89	1925	+	249	O95831-1#36	0	3	ENST00000675427.1	1646	1649	+	3	0	0	921
O95831-1#36	0	3	3	O95831-1	1560	1563	+	3	O95831-1	0	1762	ENST00000675240.1	169	1867	+	248	O95831-1#36	0	3	ENST00000675240.1	1729	1732	+	3	0	0	922
O95831-1#36	0	3	3	O95831-1	1560	1563	+	3	O95831-1	0	1839	ENST00000675092.1	90	1956	+	247	O95831-1#36	0	3	ENST00000675092.1	1650	1653	+	3	0	0	923
O95831-1#36	0	3	3	O95831-1	1560	1563	+	3	O95831-1	0	1839	ENST00000675050.1	71	1898	++	246	O95831-1#36	0	3	ENST00000675050.1	1619	1622	+	3	0	0	924
O95831-1#36	0	3	3	O95831-1	1560	1563	+	3	O95831-1	1012	1839	ENST00000674601.1	0	686	+	241	O95831-1#36	0	3	ENST00000674601.1	407	410	+	3	0	0	925
O95831-1#36	0	3	3	O95831-1	1560	1563	+	3	O95831-1	0	1762	ENST00000674546.1	185	1955	+	239	O95831-1#36	0	3	ENST00000674546.1	1745	1748	+	3	0	0	926
O95831-1#36	0	3	3	O95831-1	1560	1563	+	3	O95831-1	1017	1839	ENST00000460436.6	905	1727	+	105	O95831-1#36	0	3	ENST00000460436.6	1448	1451	+	3	0	0	927
O95831-1#36	0	3	3	O95831-1	1560	1563	+	3	O95831-1	0	1839	ENST00000346424.6	24	1002	++	34	O95831-1#36	0	3	ENST00000346424.6	723	726	+	3	0	0	928
O95831-1#36	0	3	3	O95831-1	1560	1563	+	3	O95831-1	0	1839	ENST00000319908.8	174	2007	+	25	O95831-1#36	0	3	ENST00000319908.8	1728	1731	+	3	0	0	929
O95831-1#36	0	3	3	O95831-1	1560	1563	+	3	O95831-1	0	1839	ENST00000287295.8	185	2024	++	16	O95831-1#36	0	3	ENST00000287295.8	1745	1748	+	3	0	0	930
O95831-1#37	0	3	3	O95831-1	1569	1572	+	3	O95831-1	0	1839	ENST00000676436.1	34	1861	+	255	O95831-1#37	0	3	ENST00000676436.1	1591	1594	+	3	0	0	931
O95831-1#37	0	3	3	O95831-1	1569	1572	+	3	O95831-1	0	1839	ENST00000676328.1	56	1892	+	254	O95831-1#37	0	3	ENST00000676328.1	1622	1625	+	3	0	0	932
O95831-1#37	0	3	3	O95831-1	1569	1572	+	3	O95831-1	0	1839	ENST00000676229.1	223	2050	++	253	O95831-1#37	0	3	ENST00000676229.1	1780	1783	+	3	0	0	933
O95831-1#37	0	3	3	O95831-1	1569	1572	+	3	O95831-1	0	1839	ENST00000675857.1	82	1915	+	251	O95831-1#37	0	3	ENST00000675857.1	1645	1648	+	3	0	0	934
O95831-1#37	0	3	3	O95831-1	1569	1572	+	3	O95831-1	0	1839	ENST00000675427.1	89	1925	+	249	O95831-1#37	0	3	ENST00000675427.1	1655	1658	+	3	0	0	935
O95831-1#37	0	3	3	O95831-1	1569	1572	+	3	O95831-1	0	1762	ENST00000675240.1	169	1867	+	248	O95831-1#37	0	3	ENST00000675240.1	1738	1741	+	3	0	0	936
O95831-1#37	0	3	3	O95831-1	1569	1572	+	3	O95831-1	0	1839	ENST00000675092.1	90	1956	+	247	O95831-1#37	0	3	ENST00000675092.1	1659	1662	+	3	0	0	937
O95831-1#37	0	3	3	O95831-1	1569	1572	+	3	O95831-1	0	1839	ENST00000675050.1	71	1898	++	246	O95831-1#37	0	3	ENST00000675050.1	1628	1631	+	3	0	0	938
O95831-1#37	0	3	3	O95831-1	1569	1572	+	3	O95831-1	1012	1839	ENST00000674601.1	0	686	+	241	O95831-1#37	0	3	ENST00000674601.1	416	419	+	3	0	0	939
O95831-1#37	0	3	3	O95831-1	1569	1572	+	3	O95831-1	0	1762	ENST00000674546.1	185	1955	+	239	O95831-1#37	0	3	ENST00000674546.1	1754	1757	+	3	0	0	940
O95831-1#37	0	3	3	O95831-1	1569	1572	+	3	O95831-1	1017	1839	ENST00000460436.6	905	1727	+	105	O95831-1#37	0	3	ENST00000460436.6	1457	1460	+	3	0	0	941
O95831-1#37	0	3	3	O95831-1	1569	1572	+	3	O95831-1	0	1839	ENST00000346424.6	24	1002	++	34	O95831-1#37	0	3	ENST00000346424.6	732	735	+	3	0	0	942
O95831-1#37	0	3	3	O95831-1	1569	1572	+	3	O95831-1	0	1839	ENST00000319908.8	174	2007	+	25	O95831-1#37	0	3	ENST00000319908.8	1737	1740	+	3	0	0	943
O95831-1#37	0	3	3	O95831-1	1569	1572	+	3	O95831-1	0	1839	ENST00000287295.8	185	2024	++	16	O95831-1#37	0	3	ENST00000287295.8	1754	1757	+	3	0	0	944
O95831-1#38	0	3	3	O95831-1	1587	1590	+	3	O95831-1	0	1839	ENST00000676436.1	34	1861	+	255	O95831-1#38	0	3	ENST00000676436.1	1609	1612	+	3	0	0	945
O95831-1#38	0	3	3	O95831-1	1587	1590	+	3	O95831-1	0	1839	ENST00000676328.1	56	1892	+	254	O95831-1#38	0	3	ENST00000676328.1	1640	1643	+	3	0	0	946
O95831-1#38	0	3	3	O95831-1	1587	1590	+	3	O95831-1	0	1839	ENST00000676229.1	223	2050	++	253	O95831-1#38	0	3	ENST00000676229.1	1798	1801	+	3	0	0	947
O95831-1#38	0	3	3	O95831-1	1587	1590	+	3	O95831-1	0	1839	ENST00000675857.1	82	1915	+	251	O95831-1#38	0	3	ENST00000675857.1	1663	1666	+	3	0	0	948
O95831-1#38	0	3	3	O95831-1	1587	1590	+	3	O95831-1	0	1839	ENST00000675427.1	89	1925	+	249	O95831-1#38	0	3	ENST00000675427.1	1673	1676	+	3	0	0	949
O95831-1#38	0	3	3	O95831-1	1587	1590	+	3	O95831-1	0	1839	ENST00000675092.1	90	1956	+	247	O95831-1#38	0	3	ENST00000675092.1	1704	1707	+	3	0	0	950
O95831-1#38	0	3	3	O95831-1	1587	1590	+	3	O95831-1	0	1839	ENST00000675050.1	71	1898	++	246	O95831-1#38	0	3	ENST00000675050.1	1646	1649	+	3	0	0	951
O95831-1#38	0	3	3	O95831-1	1587	1590	+	3	O95831-1	1012	1839	ENST00000674601.1	0	686	+	241	O95831-1#38	0	3	ENST00000674601.1	434	437	+	3	0	0	952
O95831-1#38	0	3	3	O95831-1	1587	1590	+	3	O95831-1	0	1762	ENST00000674546.1	185	1955	+	239	O95831-1#38	0	3	ENST00000674546.1	1780	1783	+	3	0	0	953
O95831-1#38	0	3	3	O95831-1	1587	1590	+	3	O95831-1	1017	1839	ENST00000460436.6	905	1727	+	105	O95831-1#38	0	3	ENST00000460436.6	1475	1478	+	3	0	0	954
O95831-1#38	0	3	3	O95831-1	1587	1590	+	3	O95831-1	0	1839	ENST00000346424.6	24	1002	++	34	O95831-1#38	0	3	ENST00000346424.6	750	753	+	3	0	0	955
O95831-1#38	0	3	3	O95831-1	1587	1590	+	3	O95831-1	0	1839	ENST00000319908.8	174	2007	+	25	O95831-1#38	0	3	ENST00000319908.8	1755	1758	+	3	0	0	956
O95831-1#38	0	3	3	O95831-1	1587	1590	+	3	O95831-1	0	1839	ENST00000287295.8	185	2024	++	16	O95831-1#38	0	3	ENST00000287295.8	1772	1775	+	3	0	0	957
O95831-1#39	0	3	3	O95831-1	1776	1779	+	3	O95831-1	0	1839	ENST00000676436.1	34	1861	+	255	O95831-1#39	0	3	ENST00000676436.1	1798	1801	+	3	0	0	958
O95831-1#39	0	3	3	O95831-1	1776	1779	+	3	O95831-1	0	1839	ENST00000676328.1	56	1892	+	254	O95831-1#39	0	3	ENST00000676328.1	1829	1832	+	3	0	0	959
O95831-1#39	0	3	3	O95831-1	1776	1779	+	3	O95831-1	0	1839	ENST00000676229.1	223	2050	++	253	O95831-1#39	0	3	ENST00000676229.1	1987	1990	+	3	0	0	960
O95831-1#39	0	3	3	O95831-1	1776	1779	+	3	O95831-1	0	1839	ENST00000675857.1	82	1915	+	251	O95831-1#39	0	3	ENST00000675857.1	1852	1855	+	3	0	0	961
O95831-1#39	0	3	3	O95831-1	1776	1779	+	3	O95831-1	0	1839	ENST00000675427.1	89	1925	+	249	O95831-1#39	0	3	ENST00000675427.1	1862	1865	+	3	0	0	962
O95831-1#39	0	3	3	O95831-1	1776	1779	+	3	O95831-1	0	1839	ENST00000675092.1	90	1956	+	247	O95831-1#39	0	3	ENST00000675092.1	1893	1896	+	3	0	0	963
O95831-1#39	0	3	3	O95831-1	1776	1779	+	3	O95831-1	0	1839	ENST00000675050.1	71	1898	++	246	O95831-1#39	0	3	ENST00000675050.1	1835	1838	+	3	0	0	964
O95831-1#39	0	3	3	O95831-1	1776	1779	+	3	O95831-1	1012	1839	ENST00000674601.1	0	686	+	241	O95831-1#39	0	3	ENST00000674601.1	623	626	+	3	0	0	965
O95831-1#39	0	3	3	O95831-1	1776	1779	+	3	O95831-1	1017	1839	ENST00000460436.6	905	1727	+	105	O95831-1#39	0	3	ENST00000460436.6	1664	1667	+	3	0	0	966
O95831-1#39	0	3	3	O95831-1	1776	1779	+	3	O95831-1	0	1839	ENST00000346424.6	24	1002	++	34	O95831-1#39	0	3	ENST00000346424.6	939	942	+	3	0	0	967
O95831-1#39	0	3	3	O95831-1	1776	1779	+	3	O95831-1	0	1839	ENST00000319908.8	174	2007	+	25	O95831-1#39	0	3	ENST00000319908.8	1944	1947	+	3	0	0	968
O95831-1#39	0	3	3	O95831-1	1776	1779	+	3	O95831-1	0	1839	ENST00000287295.8	185	2024	++	16	O95831-1#39	0	3	ENST00000287295.8	1961	1964	+	3	0	0	969
O95831-1#40	0	3	3	O95831-1	762	765	+	3	O95831-1	0	1839	ENST00000676436.1	34	1861	+	255	O95831-1#40	0	3	ENST00000676436.1	790	793	+	3	0	0	970
O95831-1#40	0	3	3	O95831-1	762	765	+	3	O95831-1	0	1839	ENST00000676328.1	56	1892	+	254	O95831-1#40	0	3	ENST00000676328.1	818	821	+	3	0	0	971
O95831-1#40	0	3	3	O95831-1	762	765	+	3	O95831-1	0	1839	ENST00000676229.1	223	2050	++	253	O95831-1#40	0	3	ENST00000676229.1	973	976	+	3	0	0	972
O95831-1#40	0	3	3	O95831-1	762	765	+	3	O95831-1	0	1839	ENST00000675857.1	82	1915	+	251	O95831-1#40	0	3	ENST00000675857.1	838	841	+	3	0	0	973
O95831-1#40	0	3	3	O95831-1	762	765	+	3	O95831-1	0	1839	ENST00000675427.1	89	1925	+	249	O95831-1#40	0	3	ENST00000675427.1	851	854	+	3	0	0	974
O95831-1#40	0	3	3	O95831-1	762	765	+	3	O95831-1	0	1762	ENST00000675240.1	169	1867	+	248	O95831-1#40	0	3	ENST00000675240.1	931	934	+	3	0	0	975
O95831-1#40	0	3	3	O95831-1	762	765	+	3	O95831-1	0	1839	ENST00000675092.1	90	1956	+	247	O95831-1#40	0	3	ENST00000675092.1	852	855	+	3	0	0	976
O95831-1#40	0	3	3	O95831-1	762	765	+	3	O95831-1	0	1839	ENST00000675050.1	71	1898	++	246	O95831-1#40	0	3	ENST00000675050.1	821	824	+	3	0	0	977
O95831-1#40	0	3	3	O95831-1	762	765	+	3	O95831-1	0	1454	ENST00000675037.1	56	1439	+	245	O95831-1#40	0	3	ENST00000675037.1	818	821	+	3	0	0	978
O95831-1#40	0	3	3	O95831-1	762	765	+	3	O95831-1	299	1183	ENST00000674957.1	0	880	+	243	O95831-1#40	0	3	ENST00000674957.1	463	466	+	3	0	0	979
O95831-1#40	0	3	3	O95831-1	762	765	+	3	O95831-1	0	1762	ENST00000674546.1	185	1955	+	239	O95831-1#40	0	3	ENST00000674546.1	947	950	+	3	0	0	980
O95831-1#40	0	3	3	O95831-1	762	765	+	3	O95831-1	0	966	ENST00000535724.6	8	974	++	156	O95831-1#40	0	3	ENST00000535724.6	770	773	+	3	0	0	981
O95831-1#40	0	3	3	O95831-1	762	765	+	3	O95831-1	0	1336	ENST00000416073.7	37	1363	+	76	O95831-1#40	0	3	ENST00000416073.7	793	796	+	3	0	0	982
O95831-1#40	0	3	3	O95831-1	762	765	+	3	O95831-1	0	1839	ENST00000319908.8	174	2007	+	25	O95831-1#40	0	3	ENST00000319908.8	936	939	+	3	0	0	983
O95831-1#40	0	3	3	O95831-1	762	765	+	3	O95831-1	0	1839	ENST00000287295.8	185	2024	++	16	O95831-1#40	0	3	ENST00000287295.8	947	950	+	3	0	0	984
O95831-1#41	0	1056	1056	O95831-1	0	1056	+	1056	O95831-1	0	1839	ENST00000676436.1	34	1861	+	255	O95831-1#41	0	1056	ENST00000676436.1	34	1078	+	1044	0	0	985
O95831-1#41	0	1056	1056	O95831-1	0	1056	+	1056	O95831-1	0	1839	ENST00000676328.1	56	1892	+	254	O95831-1#41	0	1056	ENST00000676328.1	56	1109	+	1053	0	0	986
O95831-1#41	0	1056	1056	O95831-1	0	1056	+	1056	O95831-1	0	1839	ENST00000676229.1	223	2050	++	253	O95831-1#41	0	1056	ENST00000676229.1	223	1267	+	1041	0	0	987
O95831-1#41	0	1056	1056	O95831-1	0	1056	+	1056	O95831-1	284	409	ENST00000676144.1	0	184	+	252	O95831-1#41	284	409	ENST00000676144.1	0	184	+	125	284	647	988
O95831-1#41	0	1056	1056	O95831-1	0	1056	+	1056	O95831-1	0	1839	ENST00000675857.1	82	1915	+	251	O95831-1#41	0	1056	ENST00000675857.1	82	1132	+	1050	0	0	989
O95831-1#41	0	1056	1056	O95831-1	0	1056	+	1056	O95831-1	0	108	ENST00000675774.1	41	149	++	250	O95831-1#41	0	108	ENST00000675774.1	41	149	+	108	0	948	990
O95831-1#41	0	1056	1056	O95831-1	0	1056	+	1056	O95831-1	0	1839	ENST00000675427.1	89	1925	+	249	O95831-1#41	0	1056	ENST00000675427.1	89	1145	+	1056	0	0	991
O95831-1#41	0	1056	1056	O95831-1	0	1056	+	1056	O95831-1	0	1762	ENST00000675240.1	169	1867	+	248	O95831-1#41	0	1056	ENST00000675240.1	169	1225	+	1056	0	0	992
O95831-1#41	0	1056	1056	O95831-1	0	1056	+	1056	O95831-1	0	1839	ENST00000675092.1	90	1956	+	247	O95831-1#41	0	1056	ENST00000675092.1	90	1146	+	1056	0	0	993
O95831-1#41	0	1056	1056	O95831-1	0	1056	+	1056	O95831-1	0	1839	ENST00000675050.1	71	1898	++	246	O95831-1#41	0	1056	ENST00000675050.1	71	1115	+	1041	0	0	994
O95831-1#41	0	1056	1056	O95831-1	0	1056	+	1056	O95831-1	0	1454	ENST00000675037.1	56	1439	+	245	O95831-1#41	0	1056	ENST00000675037.1	56	1112	+	1056	0	0	995
O95831-1#41	0	1056	1056	O95831-1	0	1056	+	1056	O95831-1	0	108	ENST00000674997.1	0	108	++	244	O95831-1#41	0	108	ENST00000674997.1	0	108	+	108	0	948	996
O95831-1#41	0	1056	1056	O95831-1	0	1056	+	1056	O95831-1	299	1183	ENST00000674957.1	0	880	+	243	O95831-1#41	299	1056	ENST00000674957.1	0	757	+	757	299	0	997
O95831-1#41	0	1056	1056	O95831-1	0	1056	+	1056	O95831-1	0	832	ENST00000674722.1	13	760	+	242	O95831-1#41	0	832	ENST00000674722.1	13	760	+	747	0	224	998
O95831-1#41	0	1056	1056	O95831-1	0	1056	+	1056	O95831-1	1012	1839	ENST00000674601.1	0	686	+	241	O95831-1#41	1012	1056	ENST00000674601.1	0	44	+	44	1012	0	999
O95831-1#41	0	1056	1056	O95831-1	0	1056	+	1056	O95831-1	0	265	ENST00000674555.1	57	354	+	240	O95831-1#41	0	265	ENST00000674555.1	57	354	+	265	0	791	1000
O95831-1#41	0	1056	1056	O95831-1	0	1056	+	1056	O95831-1	0	1762	ENST00000674546.1	185	1955	+	239	O95831-1#41	0	1056	ENST00000674546.1	185	1241	+	1056	0	0	1001
O95831-1#41	0	1056	1056	O95831-1	0	1056	+	1056	O95831-1	0	966	ENST00000535724.6	8	974	++	156	O95831-1#41	0	966	ENST00000535724.6	8	974	+	966	0	90	1002
O95831-1#41	0	1056	1056	O95831-1	0	1056	+	1056	O95831-1	0	249	ENST00000529877.1	103	352	+	149	O95831-1#41	0	249	ENST00000529877.1	103	352	+	249	0	807	1003
O95831-1#41	0	1056	1056	O95831-1	0	1056	+	1056	O95831-1	0	108	ENST00000527892.5	8	116	++	145	O95831-1#41	0	108	ENST00000527892.5	8	116	+	108	0	948	1004
O95831-1#41	0	1056	1056	O95831-1	0	1056	+	1056	O95831-1	1017	1839	ENST00000460436.6	905	1727	+	105	O95831-1#41	1017	1056	ENST00000460436.6	905	944	+	39	1017	0	1005
O95831-1#41	0	1056	1056	O95831-1	0	1056	+	1056	O95831-1	0	1336	ENST00000416073.7	37	1363	+	76	O95831-1#41	0	1056	ENST00000416073.7	37	1087	+	1050	0	0	1006
O95831-1#41	0	1056	1056	O95831-1	0	1056	+	1056	O95831-1	0	1839	ENST00000346424.6	24	1002	++	34	O95831-1#41	0	1056	ENST00000346424.6	24	219	+	195	0	0	1007
O95831-1#41	0	1056	1056	O95831-1	0	1056	+	1056	O95831-1	0	1839	ENST00000319908.8	174	2007	+	25	O95831-1#41	0	1056	ENST00000319908.8	174	1227	+	1053	0	0	1008
O95831-1#41	0	1056	1056	O95831-1	0	1056	+	1056	O95831-1	0	1839	ENST00000287295.8	185	2024	++	16	O95831-1#41	0	1056	ENST00000287295.8	185	1241	+	1056	0	0	1009
O95831-1#42	0	861	861	O95831-1	105	966	+	861	O95831-1	0	1839	ENST00000676436.1	34	1861	+	255	O95831-1#42	0	861	ENST00000676436.1	139	994	+	855	0	0	1010
O95831-1#42	0	861	861	O95831-1	105	966	+	861	O95831-1	0	1839	ENST00000676328.1	56	1892	+	254	O95831-1#42	0	861	ENST00000676328.1	161	1019	+	858	0	0	1011
O95831-1#42	0	861	861	O95831-1	105	966	+	861	O95831-1	0	1839	ENST00000676229.1	223	2050	++	253	O95831-1#42	6	861	ENST00000676229.1	328	1177	+	846	6	0	1012
O95831-1#42	0	861	861	O95831-1	105	966	+	861	O95831-1	284	409	ENST00000676144.1	0	184	+	252	O95831-1#42	179	304	ENST00000676144.1	0	184	+	125	179	557	1013
O95831-1#42	0	861	861	O95831-1	105	966	+	861	O95831-1	0	1839	ENST00000675857.1	82	1915	+	251	O95831-1#42	0	861	ENST00000675857.1	187	1042	+	855	0	0	1014
O95831-1#42	0	861	861	O95831-1	105	966	+	861	O95831-1	0	108	ENST00000675774.1	41	149	++	250	O95831-1#42	0	3	ENST00000675774.1	146	149	+	3	0	858	1015
O95831-1#42	0	861	861	O95831-1	105	966	+	861	O95831-1	0	1839	ENST00000675427.1	89	1925	+	249	O95831-1#42	0	861	ENST00000675427.1	194	1055	+	861	0	0	1016
O95831-1#42	0	861	861	O95831-1	105	966	+	861	O95831-1	0	1762	ENST00000675240.1	169	1867	+	248	O95831-1#42	0	861	ENST00000675240.1	274	1135	+	861	0	0	1017
O95831-1#42	0	861	861	O95831-1	105	966	+	861	O95831-1	0	1839	ENST00000675092.1	90	1956	+	247	O95831-1#42	0	861	ENST00000675092.1	195	1056	+	861	0	0	1018
O95831-1#42	0	861	861	O95831-1	105	966	+	861	O95831-1	0	1839	ENST00000675050.1	71	1898	++	246	O95831-1#42	6	861	ENST00000675050.1	176	1025	+	846	6	0	1019
O95831-1#42	0	861	861	O95831-1	105	966	+	861	O95831-1	0	1454	ENST00000675037.1	56	1439	+	245	O95831-1#42	0	861	ENST00000675037.1	161	1022	+	861	0	0	1020
O95831-1#42	0	861	861	O95831-1	105	966	+	861	O95831-1	0	108	ENST00000674997.1	0	108	++	244	O95831-1#42	0	3	ENST00000674997.1	105	108	+	3	0	858	1021
O95831-1#42	0	861	861	O95831-1	105	966	+	861	O95831-1	299	1183	ENST00000674957.1	0	880	+	243	O95831-1#42	194	861	ENST00000674957.1	0	667	+	667	194	0	1022
O95831-1#42	0	861	861	O95831-1	105	966	+	861	O95831-1	0	832	ENST00000674722.1	13	760	+	242	O95831-1#42	0	727	ENST00000674722.1	118	760	+	642	0	134	1023
O95831-1#42	0	861	861	O95831-1	105	966	+	861	O95831-1	0	265	ENST00000674555.1	57	354	+	240	O95831-1#42	0	160	ENST00000674555.1	162	354	+	160	0	701	1024
O95831-1#42	0	861	861	O95831-1	105	966	+	861	O95831-1	0	1762	ENST00000674546.1	185	1955	+	239	O95831-1#42	0	861	ENST00000674546.1	290	1151	+	861	0	0	1025
O95831-1#42	0	861	861	O95831-1	105	966	+	861	O95831-1	0	966	ENST00000535724.6	8	974	++	156	O95831-1#42	0	861	ENST00000535724.6	113	974	+	861	0	0	1026
O95831-1#42	0	861	861	O95831-1	105	966	+	861	O95831-1	0	249	ENST00000529877.1	103	352	+	149	O95831-1#42	0	144	ENST00000529877.1	208	352	+	144	0	717	1027
O95831-1#42	0	861	861	O95831-1	105	966	+	861	O95831-1	0	108	ENST00000527892.5	8	116	++	145	O95831-1#42	0	3	ENST00000527892.5	113	116	+	3	0	858	1028
O95831-1#42	0	861	861	O95831-1	105	966	+	861	O95831-1	0	1336	ENST00000416073.7	37	1363	+	76	O95831-1#42	0	861	ENST00000416073.7	142	997	+	855	0	0	1029
O95831-1#42	0	861	861	O95831-1	105	966	+	861	O95831-1	0	1839	ENST00000319908.8	174	2007	+	25	O95831-1#42	0	861	ENST00000319908.8	279	1137	+	858	0	0	1030
O95831-1#42	0	861	861	O95831-1	105	966	+	861	O95831-1	0	1839	ENST00000287295.8	185	2024	++	16	O95831-1#42	0	861	ENST00000287295.8	290	1151	+	861	0	0	1031
O95831-1#43	0	141	141	O95831-1	105	246	+	141	O95831-1	0	1839	ENST00000676436.1	34	1861	+	255	O95831-1#43	0	141	ENST00000676436.1	139	280	+	141	0	0	1032
O95831-1#43	0	141	141	O95831-1	105	246	+	141	O95831-1	0	1839	ENST00000676328.1	56	1892	+	254	O95831-1#43	0	141	ENST00000676328.1	161	302	+	141	0	0	1033
O95831-1#43	0	141	141	O95831-1	105	246	+	141	O95831-1	0	1839	ENST00000676229.1	223	2050	++	253	O95831-1#43	6	141	ENST00000676229.1	328	454	+	126	6	0	1034
O95831-1#43	0	141	141	O95831-1	105	246	+	141	O95831-1	0	1839	ENST00000675857.1	82	1915	+	251	O95831-1#43	0	141	ENST00000675857.1	187	328	+	141	0	0	1035
O95831-1#43	0	141	141	O95831-1	105	246	+	141	O95831-1	0	108	ENST00000675774.1	41	149	++	250	O95831-1#43	0	3	ENST00000675774.1	146	149	+	3	0	138	1036
O95831-1#43	0	141	141	O95831-1	105	246	+	141	O95831-1	0	1839	ENST00000675427.1	89	1925	+	249	O95831-1#43	0	141	ENST00000675427.1	194	335	+	141	0	0	1037
O95831-1#43	0	141	141	O95831-1	105	246	+	141	O95831-1	0	1762	ENST00000675240.1	169	1867	+	248	O95831-1#43	0	141	ENST00000675240.1	274	415	+	141	0	0	1038
O95831-1#43	0	141	141	O95831-1	105	246	+	141	O95831-1	0	1839	ENST00000675092.1	90	1956	+	247	O95831-1#43	0	141	ENST00000675092.1	195	336	+	141	0	0	1039
O95831-1#43	0	141	141	O95831-1	105	246	+	141	O95831-1	0	1839	ENST00000675050.1	71	1898	++	246	O95831-1#43	6	141	ENST00000675050.1	176	302	+	126	6	0	1040
O95831-1#43	0	141	141	O95831-1	105	246	+	141	O95831-1	0	1454	ENST00000675037.1	56	1439	+	245	O95831-1#43	0	141	ENST00000675037.1	161	302	+	141	0	0	1041
O95831-1#43	0	141	141	O95831-1	105	246	+	141	O95831-1	0	108	ENST00000674997.1	0	108	++	244	O95831-1#43	0	3	ENST00000674997.1	105	108	+	3	0	138	1042
O95831-1#43	0	141	141	O95831-1	105	246	+	141	O95831-1	0	832	ENST00000674722.1	13	760	+	242	O95831-1#43	0	141	ENST00000674722.1	118	259	+	141	0	0	1043
O95831-1#43	0	141	141	O95831-1	105	246	+	141	O95831-1	0	265	ENST00000674555.1	57	354	+	240	O95831-1#43	0	141	ENST00000674555.1	162	303	+	141	0	0	1044
O95831-1#43	0	141	141	O95831-1	105	246	+	141	O95831-1	0	1762	ENST00000674546.1	185	1955	+	239	O95831-1#43	0	141	ENST00000674546.1	290	431	+	141	0	0	1045
O95831-1#43	0	141	141	O95831-1	105	246	+	141	O95831-1	0	966	ENST00000535724.6	8	974	++	156	O95831-1#43	0	141	ENST00000535724.6	113	254	+	141	0	0	1046
O95831-1#43	0	141	141	O95831-1	105	246	+	141	O95831-1	0	249	ENST00000529877.1	103	352	+	149	O95831-1#43	0	141	ENST00000529877.1	208	349	+	141	0	0	1047
O95831-1#43	0	141	141	O95831-1	105	246	+	141	O95831-1	0	108	ENST00000527892.5	8	116	++	145	O95831-1#43	0	3	ENST00000527892.5	113	116	+	3	0	138	1048
O95831-1#43	0	141	141	O95831-1	105	246	+	141	O95831-1	0	1336	ENST00000416073.7	37	1363	+	76	O95831-1#43	0	141	ENST00000416073.7	142	283	+	141	0	0	1049
O95831-1#43	0	141	141	O95831-1	105	246	+	141	O95831-1	0	1839	ENST00000319908.8	174	2007	+	25	O95831-1#43	0	141	ENST00000319908.8	279	420	+	141	0	0	1050
O95831-1#43	0	141	141	O95831-1	105	246	+	141	O95831-1	0	1839	ENST00000287295.8	185	2024	++	16	O95831-1#43	0	141	ENST00000287295.8	290	431	+	141	0	0	1051
O95831-1#44	0	21	21	O95831-1	108	129	+	21	O95831-1	0	1839	ENST00000676436.1	34	1861	+	255	O95831-1#44	0	21	ENST00000676436.1	142	163	+	21	0	0	1052
O95831-1#44	0	21	21	O95831-1	108	129	+	21	O95831-1	0	1839	ENST00000676328.1	56	1892	+	254	O95831-1#44	0	21	ENST00000676328.1	164	185	+	21	0	0	1053
O95831-1#44	0	21	21	O95831-1	108	129	+	21	O95831-1	0	1839	ENST00000676229.1	223	2050	++	253	O95831-1#44	3	21	ENST00000676229.1	328	346	+	18	3	0	1054
O95831-1#44	0	21	21	O95831-1	108	129	+	21	O95831-1	0	1839	ENST00000675857.1	82	1915	+	251	O95831-1#44	0	21	ENST00000675857.1	190	211	+	21	0	0	1055
O95831-1#44	0	21	21	O95831-1	108	129	+	21	O95831-1	0	1839	ENST00000675427.1	89	1925	+	249	O95831-1#44	0	21	ENST00000675427.1	197	218	+	21	0	0	1056
O95831-1#44	0	21	21	O95831-1	108	129	+	21	O95831-1	0	1762	ENST00000675240.1	169	1867	+	248	O95831-1#44	0	21	ENST00000675240.1	277	298	+	21	0	0	1057
O95831-1#44	0	21	21	O95831-1	108	129	+	21	O95831-1	0	1839	ENST00000675092.1	90	1956	+	247	O95831-1#44	0	21	ENST00000675092.1	198	219	+	21	0	0	1058
O95831-1#44	0	21	21	O95831-1	108	129	+	21	O95831-1	0	1839	ENST00000675050.1	71	1898	++	246	O95831-1#44	3	21	ENST00000675050.1	176	194	+	18	3	0	1059
O95831-1#44	0	21	21	O95831-1	108	129	+	21	O95831-1	0	1454	ENST00000675037.1	56	1439	+	245	O95831-1#44	0	21	ENST00000675037.1	164	185	+	21	0	0	1060
O95831-1#44	0	21	21	O95831-1	108	129	+	21	O95831-1	0	832	ENST00000674722.1	13	760	+	242	O95831-1#44	0	21	ENST00000674722.1	121	142	+	21	0	0	1061
O95831-1#44	0	21	21	O95831-1	108	129	+	21	O95831-1	0	265	ENST00000674555.1	57	354	+	240	O95831-1#44	0	21	ENST00000674555.1	165	186	+	21	0	0	1062
O95831-1#44	0	21	21	O95831-1	108	129	+	21	O95831-1	0	1762	ENST00000674546.1	185	1955	+	239	O95831-1#44	0	21	ENST00000674546.1	293	314	+	21	0	0	1063
O95831-1#44	0	21	21	O95831-1	108	129	+	21	O95831-1	0	966	ENST00000535724.6	8	974	++	156	O95831-1#44	0	21	ENST00000535724.6	116	137	+	21	0	0	1064
O95831-1#44	0	21	21	O95831-1	108	129	+	21	O95831-1	0	249	ENST00000529877.1	103	352	+	149	O95831-1#44	0	21	ENST00000529877.1	211	232	+	21	0	0	1065
O95831-1#44	0	21	21	O95831-1	108	129	+	21	O95831-1	0	1336	ENST00000416073.7	37	1363	+	76	O95831-1#44	0	21	ENST00000416073.7	145	166	+	21	0	0	1066
O95831-1#44	0	21	21	O95831-1	108	129	+	21	O95831-1	0	1839	ENST00000319908.8	174	2007	+	25	O95831-1#44	0	21	ENST00000319908.8	282	303	+	21	0	0	1067
O95831-1#44	0	21	21	O95831-1	108	129	+	21	O95831-1	0	1839	ENST00000287295.8	185	2024	++	16	O95831-1#44	0	21	ENST00000287295.8	293	314	+	21	0	0	1068
O95831-1#45	0	1710	1710	O95831-1	129	1839	+	1710	O95831-1	0	1839	ENST00000676436.1	34	1861	+	255	O95831-1#45	0	1710	ENST00000676436.1	163	1861	+	1698	0	0	1069
O95831-1#45	0	1710	1710	O95831-1	129	1839	+	1710	O95831-1	0	1839	ENST00000676328.1	56	1892	+	254	O95831-1#45	0	1710	ENST00000676328.1	185	1892	+	1707	0	0	1070
O95831-1#45	0	1710	1710	O95831-1	129	1839	+	1710	O95831-1	0	1839	ENST00000676229.1	223	2050	++	253	O95831-1#45	0	1710	ENST00000676229.1	346	2050	+	1701	0	0	1071
O95831-1#45	0	1710	1710	O95831-1	129	1839	+	1710	O95831-1	284	409	ENST00000676144.1	0	184	+	252	O95831-1#45	155	280	ENST00000676144.1	0	184	+	125	155	1430	1072
O95831-1#45	0	1710	1710	O95831-1	129	1839	+	1710	O95831-1	0	1839	ENST00000675857.1	82	1915	+	251	O95831-1#45	0	1710	ENST00000675857.1	211	1915	+	1704	0	0	1073
O95831-1#45	0	1710	1710	O95831-1	129	1839	+	1710	O95831-1	0	1839	ENST00000675427.1	89	1925	+	249	O95831-1#45	0	1710	ENST00000675427.1	218	1925	+	1707	0	0	1074
O95831-1#45	0	1710	1710	O95831-1	129	1839	+	1710	O95831-1	0	1762	ENST00000675240.1	169	1867	+	248	O95831-1#45	0	1633	ENST00000675240.1	298	1867	+	1569	0	77	1075
O95831-1#45	0	1710	1710	O95831-1	129	1839	+	1710	O95831-1	0	1839	ENST00000675092.1	90	1956	+	247	O95831-1#45	0	1710	ENST00000675092.1	219	1956	+	1710	0	0	1076
O95831-1#45	0	1710	1710	O95831-1	129	1839	+	1710	O95831-1	0	1839	ENST00000675050.1	71	1898	++	246	O95831-1#45	0	1710	ENST00000675050.1	194	1898	+	1701	0	0	1077
O95831-1#45	0	1710	1710	O95831-1	129	1839	+	1710	O95831-1	0	1454	ENST00000675037.1	56	1439	+	245	O95831-1#45	0	1325	ENST00000675037.1	185	1439	+	1254	0	385	1078
O95831-1#45	0	1710	1710	O95831-1	129	1839	+	1710	O95831-1	299	1183	ENST00000674957.1	0	880	+	243	O95831-1#45	170	1054	ENST00000674957.1	0	880	+	880	170	656	1079
O95831-1#45	0	1710	1710	O95831-1	129	1839	+	1710	O95831-1	0	832	ENST00000674722.1	13	760	+	242	O95831-1#45	0	703	ENST00000674722.1	142	760	+	618	0	1007	1080
O95831-1#45	0	1710	1710	O95831-1	129	1839	+	1710	O95831-1	1012	1839	ENST00000674601.1	0	686	+	241	O95831-1#45	883	1710	ENST00000674601.1	0	686	+	686	883	0	1081
O95831-1#45	0	1710	1710	O95831-1	129	1839	+	1710	O95831-1	0	265	ENST00000674555.1	57	354	+	240	O95831-1#45	0	136	ENST00000674555.1	186	354	+	136	0	1574	1082
O95831-1#45	0	1710	1710	O95831-1	129	1839	+	1710	O95831-1	0	1762	ENST00000674546.1	185	1955	+	239	O95831-1#45	0	1633	ENST00000674546.1	314	1955	+	1633	0	77	1083
O95831-1#45	0	1710	1710	O95831-1	129	1839	+	1710	O95831-1	0	966	ENST00000535724.6	8	974	++	156	O95831-1#45	0	837	ENST00000535724.6	137	974	+	837	0	873	1084
O95831-1#45	0	1710	1710	O95831-1	129	1839	+	1710	O95831-1	0	249	ENST00000529877.1	103	352	+	149	O95831-1#45	0	120	ENST00000529877.1	232	352	+	120	0	1590	1085
O95831-1#45	0	1710	1710	O95831-1	129	1839	+	1710	O95831-1	1017	1839	ENST00000460436.6	905	1727	+	105	O95831-1#45	888	1710	ENST00000460436.6	905	1727	+	822	888	0	1086
O95831-1#45	0	1710	1710	O95831-1	129	1839	+	1710	O95831-1	0	1336	ENST00000416073.7	37	1363	+	76	O95831-1#45	0	1207	ENST00000416073.7	166	1363	+	1197	0	503	1087
O95831-1#45	0	1710	1710	O95831-1	129	1839	+	1710	O95831-1	0	1839	ENST00000346424.6	24	1002	++	34	O95831-1#45	837	1710	ENST00000346424.6	129	1002	+	873	837	0	1088
O95831-1#45	0	1710	1710	O95831-1	129	1839	+	1710	O95831-1	0	1839	ENST00000319908.8	174	2007	+	25	O95831-1#45	0	1710	ENST00000319908.8	303	2007	+	1704	0	0	1089
O95831-1#45	0	1710	1710	O95831-1	129	1839	+	1710	O95831-1	0	1839	ENST00000287295.8	185	2024	++	16	O95831-1#45	0	1710	ENST00000287295.8	314	2024	+	1710	0	0	1090
O95831-1#46	0	6	6	O95831-1	966	972	+	6	O95831-1	0	1839	ENST00000676436.1	34	1861	+	255	O95831-1#46	0	1	ENST00000676436.1	994	995	+	1	0	5	1091
O95831-1#46	0	6	6	O95831-1	966	972	+	6	O95831-1	0	1839	ENST00000676328.1	56	1892	+	254	O95831-1#46	0	6	ENST00000676328.1	1019	1025	+	6	0	0	1092
O95831-1#46	0	6	6	O95831-1	966	972	+	6	O95831-1	0	1839	ENST00000676229.1	223	2050	++	253	O95831-1#46	0	6	ENST00000676229.1	1177	1183	+	6	0	0	1093
O95831-1#46	0	6	6	O95831-1	966	972	+	6	O95831-1	0	1839	ENST00000675857.1	82	1915	+	251	O95831-1#46	0	6	ENST00000675857.1	1042	1048	+	6	0	0	1094
O95831-1#46	0	6	6	O95831-1	966	972	+	6	O95831-1	0	1839	ENST00000675427.1	89	1925	+	249	O95831-1#46	0	6	ENST00000675427.1	1055	1061	+	6	0	0	1095
O95831-1#46	0	6	6	O95831-1	966	972	+	6	O95831-1	0	1762	ENST00000675240.1	169	1867	+	248	O95831-1#46	0	6	ENST00000675240.1	1135	1141	+	6	0	0	1096
O95831-1#46	0	6	6	O95831-1	966	972	+	6	O95831-1	0	1839	ENST00000675092.1	90	1956	+	247	O95831-1#46	0	6	ENST00000675092.1	1056	1062	+	6	0	0	1097
O95831-1#46	0	6	6	O95831-1	966	972	+	6	O95831-1	0	1839	ENST00000675050.1	71	1898	++	246	O95831-1#46	0	6	ENST00000675050.1	1025	1031	+	6	0	0	1098
O95831-1#46	0	6	6	O95831-1	966	972	+	6	O95831-1	0	1454	ENST00000675037.1	56	1439	+	245	O95831-1#46	0	6	ENST00000675037.1	1022	1028	+	6	0	0	1099
O95831-1#46	0	6	6	O95831-1	966	972	+	6	O95831-1	299	1183	ENST00000674957.1	0	880	+	243	O95831-1#46	0	6	ENST00000674957.1	667	673	+	6	0	0	1100
O95831-1#46	0	6	6	O95831-1	966	972	+	6	O95831-1	0	1762	ENST00000674546.1	185	1955	+	239	O95831-1#46	0	6	ENST00000674546.1	1151	1157	+	6	0	0	1101
O95831-1#46	0	6	6	O95831-1	966	972	+	6	O95831-1	0	1336	ENST00000416073.7	37	1363	+	76	O95831-1#46	0	6	ENST00000416073.7	997	1003	+	6	0	0	1102
O95831-1#46	0	6	6	O95831-1	966	972	+	6	O95831-1	0	1839	ENST00000346424.6	24	1002	++	34	O95831-1#46	0	6	ENST00000346424.6	129	135	+	6	0	0	1103
O95831-1#46	0	6	6	O95831-1	966	972	+	6	O95831-1	0	1839	ENST00000319908.8	174	2007	+	25	O95831-1#46	0	6	ENST00000319908.8	1137	1143	+	6	0	0	1104
O95831-1#46	0	6	6	O95831-1	966	972	+	6	O95831-1	0	1839	ENST00000287295.8	185	2024	++	16	O95831-1#46	0	6	ENST00000287295.8	1151	1157	+	6	0	0	1105
O95831-1#47	0	867	867	O95831-1	972	1839	+	867	O95831-1	0	1839	ENST00000676436.1	34	1861	+	255	O95831-1#47	1	867	ENST00000676436.1	995	1861	+	866	1	0	1106
O95831-1#47	0	867	867	O95831-1	972	1839	+	867	O95831-1	0	1839	ENST00000676328.1	56	1892	+	254	O95831-1#47	0	867	ENST00000676328.1	1025	1892	+	867	0	0	1107
O95831-1#47	0	867	867	O95831-1	972	1839	+	867	O95831-1	0	1839	ENST00000676229.1	223	2050	++	253	O95831-1#47	0	867	ENST00000676229.1	1183	2050	+	867	0	0	1108
O95831-1#47	0	867	867	O95831-1	972	1839	+	867	O95831-1	0	1839	ENST00000675857.1	82	1915	+	251	O95831-1#47	0	867	ENST00000675857.1	1048	1915	+	867	0	0	1109
O95831-1#47	0	867	867	O95831-1	972	1839	+	867	O95831-1	0	1839	ENST00000675427.1	89	1925	+	249	O95831-1#47	0	867	ENST00000675427.1	1061	1925	+	864	0	0	1110
O95831-1#47	0	867	867	O95831-1	972	1839	+	867	O95831-1	0	1762	ENST00000675240.1	169	1867	+	248	O95831-1#47	0	790	ENST00000675240.1	1141	1867	+	726	0	77	1111
O95831-1#47	0	867	867	O95831-1	972	1839	+	867	O95831-1	0	1839	ENST00000675092.1	90	1956	+	247	O95831-1#47	0	867	ENST00000675092.1	1062	1956	+	867	0	0	1112
O95831-1#47	0	867	867	O95831-1	972	1839	+	867	O95831-1	0	1839	ENST00000675050.1	71	1898	++	246	O95831-1#47	0	867	ENST00000675050.1	1031	1898	+	867	0	0	1113
O95831-1#47	0	867	867	O95831-1	972	1839	+	867	O95831-1	0	1454	ENST00000675037.1	56	1439	+	245	O95831-1#47	0	482	ENST00000675037.1	1028	1439	+	411	0	385	1114
O95831-1#47	0	867	867	O95831-1	972	1839	+	867	O95831-1	299	1183	ENST00000674957.1	0	880	+	243	O95831-1#47	0	211	ENST00000674957.1	673	880	+	207	0	656	1115
O95831-1#47	0	867	867	O95831-1	972	1839	+	867	O95831-1	1012	1839	ENST00000674601.1	0	686	+	241	O95831-1#47	40	867	ENST00000674601.1	0	686	+	686	40	0	1116
O95831-1#47	0	867	867	O95831-1	972	1839	+	867	O95831-1	0	1762	ENST00000674546.1	185	1955	+	239	O95831-1#47	0	790	ENST00000674546.1	1157	1955	+	790	0	77	1117
O95831-1#47	0	867	867	O95831-1	972	1839	+	867	O95831-1	1017	1839	ENST00000460436.6	905	1727	+	105	O95831-1#47	45	867	ENST00000460436.6	905	1727	+	822	45	0	1118
O95831-1#47	0	867	867	O95831-1	972	1839	+	867	O95831-1	0	1336	ENST00000416073.7	37	1363	+	76	O95831-1#47	0	364	ENST00000416073.7	1003	1363	+	360	0	503	1119
O95831-1#47	0	867	867	O95831-1	972	1839	+	867	O95831-1	0	1839	ENST00000346424.6	24	1002	++	34	O95831-1#47	0	867	ENST00000346424.6	135	1002	+	867	0	0	1120
O95831-1#47	0	867	867	O95831-1	972	1839	+	867	O95831-1	0	1839	ENST00000319908.8	174	2007	+	25	O95831-1#47	0	867	ENST00000319908.8	1143	2007	+	864	0	0	1121
O95831-1#47	0	867	867	O95831-1	972	1839	+	867	O95831-1	0	1839	ENST00000287295.8	185	2024	++	16	O95831-1#47	0	867	ENST00000287295.8	1157	2024	+	867	0	0	1122
O95831-1#48	0	3	3	O95831-1	600	603	+	3	O95831-1	0	1839	ENST00000676436.1	34	1861	+	255	O95831-1#48	0	3	ENST00000676436.1	628	631	+	3	0	0	1123
O95831-1#48	0	3	3	O95831-1	600	603	+	3	O95831-1	0	1839	ENST00000676328.1	56	1892	+	254	O95831-1#48	0	3	ENST00000676328.1	656	659	+	3	0	0	1124
O95831-1#48	0	3	3	O95831-1	600	603	+	3	O95831-1	0	1839	ENST00000676229.1	223	2050	++	253	O95831-1#48	0	3	ENST00000676229.1	811	814	+	3	0	0	1125
O95831-1#48	0	3	3	O95831-1	600	603	+	3	O95831-1	0	1839	ENST00000675857.1	82	1915	+	251	O95831-1#48	0	3	ENST00000675857.1	676	679	+	3	0	0	1126
O95831-1#48	0	3	3	O95831-1	600	603	+	3	O95831-1	0	1839	ENST00000675427.1	89	1925	+	249	O95831-1#48	0	3	ENST00000675427.1	689	692	+	3	0	0	1127
O95831-1#48	0	3	3	O95831-1	600	603	+	3	O95831-1	0	1762	ENST00000675240.1	169	1867	+	248	O95831-1#48	0	3	ENST00000675240.1	769	772	+	3	0	0	1128
O95831-1#48	0	3	3	O95831-1	600	603	+	3	O95831-1	0	1839	ENST00000675092.1	90	1956	+	247	O95831-1#48	0	3	ENST00000675092.1	690	693	+	3	0	0	1129
O95831-1#48	0	3	3	O95831-1	600	603	+	3	O95831-1	0	1839	ENST00000675050.1	71	1898	++	246	O95831-1#48	0	3	ENST00000675050.1	659	662	+	3	0	0	1130
O95831-1#48	0	3	3	O95831-1	600	603	+	3	O95831-1	0	1454	ENST00000675037.1	56	1439	+	245	O95831-1#48	0	3	ENST00000675037.1	656	659	+	3	0	0	1131
O95831-1#48	0	3	3	O95831-1	600	603	+	3	O95831-1	299	1183	ENST00000674957.1	0	880	+	243	O95831-1#48	0	3	ENST00000674957.1	301	304	+	3	0	0	1132
O95831-1#48	0	3	3	O95831-1	600	603	+	3	O95831-1	0	832	ENST00000674722.1	13	760	+	242	O95831-1#48	0	3	ENST00000674722.1	613	616	+	3	0	0	1133
O95831-1#48	0	3	3	O95831-1	600	603	+	3	O95831-1	0	1762	ENST00000674546.1	185	1955	+	239	O95831-1#48	0	3	ENST00000674546.1	785	788	+	3	0	0	1134
O95831-1#48	0	3	3	O95831-1	600	603	+	3	O95831-1	0	966	ENST00000535724.6	8	974	++	156	O95831-1#48	0	3	ENST00000535724.6	608	611	+	3	0	0	1135
O95831-1#48	0	3	3	O95831-1	600	603	+	3	O95831-1	0	1336	ENST00000416073.7	37	1363	+	76	O95831-1#48	0	3	ENST00000416073.7	631	634	+	3	0	0	1136
O95831-1#48	0	3	3	O95831-1	600	603	+	3	O95831-1	0	1839	ENST00000319908.8	174	2007	+	25	O95831-1#48	0	3	ENST00000319908.8	774	777	+	3	0	0	1137
O95831-1#48	0	3	3	O95831-1	600	603	+	3	O95831-1	0	1839	ENST00000287295.8	185	2024	++	16	O95831-1#48	0	3	ENST00000287295.8	785	788	+	3	0	0	1138
O95831-1#49	0	3	3	O95831-1	702	705	+	3	O95831-1	0	1839	ENST00000676436.1	34	1861	+	255	O95831-1#49	0	3	ENST00000676436.1	730	733	+	3	0	0	1139
O95831-1#49	0	3	3	O95831-1	702	705	+	3	O95831-1	0	1839	ENST00000676328.1	56	1892	+	254	O95831-1#49	0	3	ENST00000676328.1	758	761	+	3	0	0	1140
O95831-1#49	0	3	3	O95831-1	702	705	+	3	O95831-1	0	1839	ENST00000676229.1	223	2050	++	253	O95831-1#49	0	3	ENST00000676229.1	913	916	+	3	0	0	1141
O95831-1#49	0	3	3	O95831-1	702	705	+	3	O95831-1	0	1839	ENST00000675857.1	82	1915	+	251	O95831-1#49	0	3	ENST00000675857.1	778	781	+	3	0	0	1142
O95831-1#49	0	3	3	O95831-1	702	705	+	3	O95831-1	0	1839	ENST00000675427.1	89	1925	+	249	O95831-1#49	0	3	ENST00000675427.1	791	794	+	3	0	0	1143
O95831-1#49	0	3	3	O95831-1	702	705	+	3	O95831-1	0	1762	ENST00000675240.1	169	1867	+	248	O95831-1#49	0	3	ENST00000675240.1	871	874	+	3	0	0	1144
O95831-1#49	0	3	3	O95831-1	702	705	+	3	O95831-1	0	1839	ENST00000675092.1	90	1956	+	247	O95831-1#49	0	3	ENST00000675092.1	792	795	+	3	0	0	1145
O95831-1#49	0	3	3	O95831-1	702	705	+	3	O95831-1	0	1839	ENST00000675050.1	71	1898	++	246	O95831-1#49	0	3	ENST00000675050.1	761	764	+	3	0	0	1146
O95831-1#49	0	3	3	O95831-1	702	705	+	3	O95831-1	0	1454	ENST00000675037.1	56	1439	+	245	O95831-1#49	0	3	ENST00000675037.1	758	761	+	3	0	0	1147
O95831-1#49	0	3	3	O95831-1	702	705	+	3	O95831-1	299	1183	ENST00000674957.1	0	880	+	243	O95831-1#49	0	3	ENST00000674957.1	403	406	+	3	0	0	1148
O95831-1#49	0	3	3	O95831-1	702	705	+	3	O95831-1	0	1762	ENST00000674546.1	185	1955	+	239	O95831-1#49	0	3	ENST00000674546.1	887	890	+	3	0	0	1149
O95831-1#49	0	3	3	O95831-1	702	705	+	3	O95831-1	0	966	ENST00000535724.6	8	974	++	156	O95831-1#49	0	3	ENST00000535724.6	710	713	+	3	0	0	1150
O95831-1#49	0	3	3	O95831-1	702	705	+	3	O95831-1	0	1336	ENST00000416073.7	37	1363	+	76	O95831-1#49	0	3	ENST00000416073.7	733	736	+	3	0	0	1151
O95831-1#49	0	3	3	O95831-1	702	705	+	3	O95831-1	0	1839	ENST00000319908.8	174	2007	+	25	O95831-1#49	0	3	ENST00000319908.8	876	879	+	3	0	0	1152
O95831-1#49	0	3	3	O95831-1	702	705	+	3	O95831-1	0	1839	ENST00000287295.8	185	2024	++	16	O95831-1#49	0	3	ENST00000287295.8	887	890	+	3	0	0	1153
O95831-1#50	0	3	3	O95831-1	708	711	+	3	O95831-1	0	1839	ENST00000676436.1	34	1861	+	255	O95831-1#50	0	3	ENST00000676436.1	736	739	+	3	0	0	1154
O95831-1#50	0	3	3	O95831-1	708	711	+	3	O95831-1	0	1839	ENST00000676328.1	56	1892	+	254	O95831-1#50	0	3	ENST00000676328.1	764	767	+	3	0	0	1155
O95831-1#50	0	3	3	O95831-1	708	711	+	3	O95831-1	0	1839	ENST00000676229.1	223	2050	++	253	O95831-1#50	0	3	ENST00000676229.1	919	922	+	3	0	0	1156
O95831-1#50	0	3	3	O95831-1	708	711	+	3	O95831-1	0	1839	ENST00000675857.1	82	1915	+	251	O95831-1#50	0	3	ENST00000675857.1	784	787	+	3	0	0	1157
O95831-1#50	0	3	3	O95831-1	708	711	+	3	O95831-1	0	1839	ENST00000675427.1	89	1925	+	249	O95831-1#50	0	3	ENST00000675427.1	797	800	+	3	0	0	1158
O95831-1#50	0	3	3	O95831-1	708	711	+	3	O95831-1	0	1762	ENST00000675240.1	169	1867	+	248	O95831-1#50	0	3	ENST00000675240.1	877	880	+	3	0	0	1159
O95831-1#50	0	3	3	O95831-1	708	711	+	3	O95831-1	0	1839	ENST00000675092.1	90	1956	+	247	O95831-1#50	0	3	ENST00000675092.1	798	801	+	3	0	0	1160
O95831-1#50	0	3	3	O95831-1	708	711	+	3	O95831-1	0	1839	ENST00000675050.1	71	1898	++	246	O95831-1#50	0	3	ENST00000675050.1	767	770	+	3	0	0	1161
O95831-1#50	0	3	3	O95831-1	708	711	+	3	O95831-1	0	1454	ENST00000675037.1	56	1439	+	245	O95831-1#50	0	3	ENST00000675037.1	764	767	+	3	0	0	1162
O95831-1#50	0	3	3	O95831-1	708	711	+	3	O95831-1	299	1183	ENST00000674957.1	0	880	+	243	O95831-1#50	0	3	ENST00000674957.1	409	412	+	3	0	0	1163
O95831-1#50	0	3	3	O95831-1	708	711	+	3	O95831-1	0	1762	ENST00000674546.1	185	1955	+	239	O95831-1#50	0	3	ENST00000674546.1	893	896	+	3	0	0	1164
O95831-1#50	0	3	3	O95831-1	708	711	+	3	O95831-1	0	966	ENST00000535724.6	8	974	++	156	O95831-1#50	0	3	ENST00000535724.6	716	719	+	3	0	0	1165
O95831-1#50	0	3	3	O95831-1	708	711	+	3	O95831-1	0	1336	ENST00000416073.7	37	1363	+	76	O95831-1#50	0	3	ENST00000416073.7	739	742	+	3	0	0	1166
O95831-1#50	0	3	3	O95831-1	708	711	+	3	O95831-1	0	1839	ENST00000319908.8	174	2007	+	25	O95831-1#50	0	3	ENST00000319908.8	882	885	+	3	0	0	1167
O95831-1#50	0	3	3	O95831-1	708	711	+	3	O95831-1	0	1839	ENST00000287295.8	185	2024	++	16	O95831-1#50	0	3	ENST00000287295.8	893	896	+	3	0	0	1168
O95831-1#51	0	3	3	O95831-1	708	711	+	3	O95831-1	0	1839	ENST00000676436.1	34	1861	+	255	O95831-1#51	0	3	ENST00000676436.1	736	739	+	3	0	0	1169
O95831-1#51	0	3	3	O95831-1	708	711	+	3	O95831-1	0	1839	ENST00000676328.1	56	1892	+	254	O95831-1#51	0	3	ENST00000676328.1	764	767	+	3	0	0	1170
O95831-1#51	0	3	3	O95831-1	708	711	+	3	O95831-1	0	1839	ENST00000676229.1	223	2050	++	253	O95831-1#51	0	3	ENST00000676229.1	919	922	+	3	0	0	1171
O95831-1#51	0	3	3	O95831-1	708	711	+	3	O95831-1	0	1839	ENST00000675857.1	82	1915	+	251	O95831-1#51	0	3	ENST00000675857.1	784	787	+	3	0	0	1172
O95831-1#51	0	3	3	O95831-1	708	711	+	3	O95831-1	0	1839	ENST00000675427.1	89	1925	+	249	O95831-1#51	0	3	ENST00000675427.1	797	800	+	3	0	0	1173
O95831-1#51	0	3	3	O95831-1	708	711	+	3	O95831-1	0	1762	ENST00000675240.1	169	1867	+	248	O95831-1#51	0	3	ENST00000675240.1	877	880	+	3	0	0	1174
O95831-1#51	0	3	3	O95831-1	708	711	+	3	O95831-1	0	1839	ENST00000675092.1	90	1956	+	247	O95831-1#51	0	3	ENST00000675092.1	798	801	+	3	0	0	1175
O95831-1#51	0	3	3	O95831-1	708	711	+	3	O95831-1	0	1839	ENST00000675050.1	71	1898	++	246	O95831-1#51	0	3	ENST00000675050.1	767	770	+	3	0	0	1176
O95831-1#51	0	3	3	O95831-1	708	711	+	3	O95831-1	0	1454	ENST00000675037.1	56	1439	+	245	O95831-1#51	0	3	ENST00000675037.1	764	767	+	3	0	0	1177
O95831-1#51	0	3	3	O95831-1	708	711	+	3	O95831-1	299	1183	ENST00000674957.1	0	880	+	243	O95831-1#51	0	3	ENST00000674957.1	409	412	+	3	0	0	1178
O95831-1#51	0	3	3	O95831-1	708	711	+	3	O95831-1	0	1762	ENST00000674546.1	185	1955	+	239	O95831-1#51	0	3	ENST00000674546.1	893	896	+	3	0	0	1179
O95831-1#51	0	3	3	O95831-1	708	711	+	3	O95831-1	0	966	ENST00000535724.6	8	974	++	156	O95831-1#51	0	3	ENST00000535724.6	716	719	+	3	0	0	1180
O95831-1#51	0	3	3	O95831-1	708	711	+	3	O95831-1	0	1336	ENST00000416073.7	37	1363	+	76	O95831-1#51	0	3	ENST00000416073.7	739	742	+	3	0	0	1181
O95831-1#51	0	3	3	O95831-1	708	711	+	3	O95831-1	0	1839	ENST00000319908.8	174	2007	+	25	O95831-1#51	0	3	ENST00000319908.8	882	885	+	3	0	0	1182
O95831-1#51	0	3	3	O95831-1	708	711	+	3	O95831-1	0	1839	ENST00000287295.8	185	2024	++	16	O95831-1#51	0	3	ENST00000287295.8	893	896	+	3	0	0	1183
O95831-1#52	0	3	3	O95831-1	726	729	+	3	O95831-1	0	1839	ENST00000676436.1	34	1861	+	255	O95831-1#52	0	3	ENST00000676436.1	754	757	+	3	0	0	1184
O95831-1#52	0	3	3	O95831-1	726	729	+	3	O95831-1	0	1839	ENST00000676328.1	56	1892	+	254	O95831-1#52	0	3	ENST00000676328.1	782	785	+	3	0	0	1185
O95831-1#52	0	3	3	O95831-1	726	729	+	3	O95831-1	0	1839	ENST00000676229.1	223	2050	++	253	O95831-1#52	0	3	ENST00000676229.1	937	940	+	3	0	0	1186
O95831-1#52	0	3	3	O95831-1	726	729	+	3	O95831-1	0	1839	ENST00000675857.1	82	1915	+	251	O95831-1#52	0	3	ENST00000675857.1	802	805	+	3	0	0	1187
O95831-1#52	0	3	3	O95831-1	726	729	+	3	O95831-1	0	1839	ENST00000675427.1	89	1925	+	249	O95831-1#52	0	3	ENST00000675427.1	815	818	+	3	0	0	1188
O95831-1#52	0	3	3	O95831-1	726	729	+	3	O95831-1	0	1762	ENST00000675240.1	169	1867	+	248	O95831-1#52	0	3	ENST00000675240.1	895	898	+	3	0	0	1189
O95831-1#52	0	3	3	O95831-1	726	729	+	3	O95831-1	0	1839	ENST00000675092.1	90	1956	+	247	O95831-1#52	0	3	ENST00000675092.1	816	819	+	3	0	0	1190
O95831-1#52	0	3	3	O95831-1	726	729	+	3	O95831-1	0	1839	ENST00000675050.1	71	1898	++	246	O95831-1#52	0	3	ENST00000675050.1	785	788	+	3	0	0	1191
O95831-1#52	0	3	3	O95831-1	726	729	+	3	O95831-1	0	1454	ENST00000675037.1	56	1439	+	245	O95831-1#52	0	3	ENST00000675037.1	782	785	+	3	0	0	1192
O95831-1#52	0	3	3	O95831-1	726	729	+	3	O95831-1	299	1183	ENST00000674957.1	0	880	+	243	O95831-1#52	0	3	ENST00000674957.1	427	430	+	3	0	0	1193
O95831-1#52	0	3	3	O95831-1	726	729	+	3	O95831-1	0	1762	ENST00000674546.1	185	1955	+	239	O95831-1#52	0	3	ENST00000674546.1	911	914	+	3	0	0	1194
O95831-1#52	0	3	3	O95831-1	726	729	+	3	O95831-1	0	966	ENST00000535724.6	8	974	++	156	O95831-1#52	0	3	ENST00000535724.6	734	737	+	3	0	0	1195
O95831-1#52	0	3	3	O95831-1	726	729	+	3	O95831-1	0	1336	ENST00000416073.7	37	1363	+	76	O95831-1#52	0	3	ENST00000416073.7	757	760	+	3	0	0	1196
O95831-1#52	0	3	3	O95831-1	726	729	+	3	O95831-1	0	1839	ENST00000319908.8	174	2007	+	25	O95831-1#52	0	3	ENST00000319908.8	900	903	+	3	0	0	1197
O95831-1#52	0	3	3	O95831-1	726	729	+	3	O95831-1	0	1839	ENST00000287295.8	185	2024	++	16	O95831-1#52	0	3	ENST00000287295.8	911	914	+	3	0	0	1198
O95831-1#53	0	3	3	O95831-1	777	780	+	3	O95831-1	0	1839	ENST00000676436.1	34	1861	+	255	O95831-1#53	0	3	ENST00000676436.1	805	808	+	3	0	0	1199
O95831-1#53	0	3	3	O95831-1	777	780	+	3	O95831-1	0	1839	ENST00000676328.1	56	1892	+	254	O95831-1#53	0	3	ENST00000676328.1	833	836	+	3	0	0	1200
O95831-1#53	0	3	3	O95831-1	777	780	+	3	O95831-1	0	1839	ENST00000676229.1	223	2050	++	253	O95831-1#53	0	3	ENST00000676229.1	988	991	+	3	0	0	1201
O95831-1#53	0	3	3	O95831-1	777	780	+	3	O95831-1	0	1839	ENST00000675857.1	82	1915	+	251	O95831-1#53	0	3	ENST00000675857.1	853	856	+	3	0	0	1202
O95831-1#53	0	3	3	O95831-1	777	780	+	3	O95831-1	0	1839	ENST00000675427.1	89	1925	+	249	O95831-1#53	0	3	ENST00000675427.1	866	869	+	3	0	0	1203
O95831-1#53	0	3	3	O95831-1	777	780	+	3	O95831-1	0	1762	ENST00000675240.1	169	1867	+	248	O95831-1#53	0	3	ENST00000675240.1	946	949	+	3	0	0	1204
O95831-1#53	0	3	3	O95831-1	777	780	+	3	O95831-1	0	1839	ENST00000675092.1	90	1956	+	247	O95831-1#53	0	3	ENST00000675092.1	867	870	+	3	0	0	1205
O95831-1#53	0	3	3	O95831-1	777	780	+	3	O95831-1	0	1839	ENST00000675050.1	71	1898	++	246	O95831-1#53	0	3	ENST00000675050.1	836	839	+	3	0	0	1206
O95831-1#53	0	3	3	O95831-1	777	780	+	3	O95831-1	0	1454	ENST00000675037.1	56	1439	+	245	O95831-1#53	0	3	ENST00000675037.1	833	836	+	3	0	0	1207
O95831-1#53	0	3	3	O95831-1	777	780	+	3	O95831-1	299	1183	ENST00000674957.1	0	880	+	243	O95831-1#53	0	3	ENST00000674957.1	478	481	+	3	0	0	1208
O95831-1#53	0	3	3	O95831-1	777	780	+	3	O95831-1	0	1762	ENST00000674546.1	185	1955	+	239	O95831-1#53	0	3	ENST00000674546.1	962	965	+	3	0	0	1209
O95831-1#53	0	3	3	O95831-1	777	780	+	3	O95831-1	0	966	ENST00000535724.6	8	974	++	156	O95831-1#53	0	3	ENST00000535724.6	785	788	+	3	0	0	1210
O95831-1#53	0	3	3	O95831-1	777	780	+	3	O95831-1	0	1336	ENST00000416073.7	37	1363	+	76	O95831-1#53	0	3	ENST00000416073.7	808	811	+	3	0	0	1211
O95831-1#53	0	3	3	O95831-1	777	780	+	3	O95831-1	0	1839	ENST00000319908.8	174	2007	+	25	O95831-1#53	0	3	ENST00000319908.8	951	954	+	3	0	0	1212
O95831-1#53	0	3	3	O95831-1	777	780	+	3	O95831-1	0	1839	ENST00000287295.8	185	2024	++	16	O95831-1#53	0	3	ENST00000287295.8	962	965	+	3	0	0	1213
O95831-1#54	0	3	3	O95831-1	783	786	+	3	O95831-1	0	1839	ENST00000676436.1	34	1861	+	255	O95831-1#54	0	3	ENST00000676436.1	811	814	+	3	0	0	1214
O95831-1#54	0	3	3	O95831-1	783	786	+	3	O95831-1	0	1839	ENST00000676328.1	56	1892	+	254	O95831-1#54	1	3	ENST00000676328.1	837	839	+	2	1	0	1215
O95831-1#54	0	3	3	O95831-1	783	786	+	3	O95831-1	0	1839	ENST00000676229.1	223	2050	++	253	O95831-1#54	0	3	ENST00000676229.1	994	997	+	3	0	0	1216
O95831-1#54	0	3	3	O95831-1	783	786	+	3	O95831-1	0	1839	ENST00000675857.1	82	1915	+	251	O95831-1#54	0	3	ENST00000675857.1	859	862	+	3	0	0	1217
O95831-1#54	0	3	3	O95831-1	783	786	+	3	O95831-1	0	1839	ENST00000675427.1	89	1925	+	249	O95831-1#54	0	3	ENST00000675427.1	872	875	+	3	0	0	1218
O95831-1#54	0	3	3	O95831-1	783	786	+	3	O95831-1	0	1762	ENST00000675240.1	169	1867	+	248	O95831-1#54	0	3	ENST00000675240.1	952	955	+	3	0	0	1219
O95831-1#54	0	3	3	O95831-1	783	786	+	3	O95831-1	0	1839	ENST00000675092.1	90	1956	+	247	O95831-1#54	0	3	ENST00000675092.1	873	876	+	3	0	0	1220
O95831-1#54	0	3	3	O95831-1	783	786	+	3	O95831-1	0	1839	ENST00000675050.1	71	1898	++	246	O95831-1#54	0	3	ENST00000675050.1	842	845	+	3	0	0	1221
O95831-1#54	0	3	3	O95831-1	783	786	+	3	O95831-1	0	1454	ENST00000675037.1	56	1439	+	245	O95831-1#54	0	3	ENST00000675037.1	839	842	+	3	0	0	1222
O95831-1#54	0	3	3	O95831-1	783	786	+	3	O95831-1	299	1183	ENST00000674957.1	0	880	+	243	O95831-1#54	0	3	ENST00000674957.1	484	487	+	3	0	0	1223
O95831-1#54	0	3	3	O95831-1	783	786	+	3	O95831-1	0	832	ENST00000674722.1	13	760	+	242	O95831-1#54	0	3	ENST00000674722.1	711	714	+	3	0	0	1224
O95831-1#54	0	3	3	O95831-1	783	786	+	3	O95831-1	0	1762	ENST00000674546.1	185	1955	+	239	O95831-1#54	0	3	ENST00000674546.1	968	971	+	3	0	0	1225
O95831-1#54	0	3	3	O95831-1	783	786	+	3	O95831-1	0	966	ENST00000535724.6	8	974	++	156	O95831-1#54	0	3	ENST00000535724.6	791	794	+	3	0	0	1226
O95831-1#54	0	3	3	O95831-1	783	786	+	3	O95831-1	0	1336	ENST00000416073.7	37	1363	+	76	O95831-1#54	0	3	ENST00000416073.7	814	817	+	3	0	0	1227
O95831-1#54	0	3	3	O95831-1	783	786	+	3	O95831-1	0	1839	ENST00000319908.8	174	2007	+	25	O95831-1#54	1	3	ENST00000319908.8	955	957	+	2	1	0	1228
O95831-1#54	0	3	3	O95831-1	783	786	+	3	O95831-1	0	1839	ENST00000287295.8	185	2024	++	16	O95831-1#54	0	3	ENST00000287295.8	968	971	+	3	0	0	1229
O95831-1#55	0	3	3	O95831-1	921	924	+	3	O95831-1	0	1839	ENST00000676436.1	34	1861	+	255	O95831-1#55	0	3	ENST00000676436.1	949	952	+	3	0	0	1230
O95831-1#55	0	3	3	O95831-1	921	924	+	3	O95831-1	0	1839	ENST00000676328.1	56	1892	+	254	O95831-1#55	0	3	ENST00000676328.1	974	977	+	3	0	0	1231
O95831-1#55	0	3	3	O95831-1	921	924	+	3	O95831-1	0	1839	ENST00000676229.1	223	2050	++	253	O95831-1#55	0	3	ENST00000676229.1	1132	1135	+	3	0	0	1232
O95831-1#55	0	3	3	O95831-1	921	924	+	3	O95831-1	0	1839	ENST00000675857.1	82	1915	+	251	O95831-1#55	0	3	ENST00000675857.1	997	1000	+	3	0	0	1233
O95831-1#55	0	3	3	O95831-1	921	924	+	3	O95831-1	0	1839	ENST00000675427.1	89	1925	+	249	O95831-1#55	0	3	ENST00000675427.1	1010	1013	+	3	0	0	1234
O95831-1#55	0	3	3	O95831-1	921	924	+	3	O95831-1	0	1762	ENST00000675240.1	169	1867	+	248	O95831-1#55	0	3	ENST00000675240.1	1090	1093	+	3	0	0	1235
O95831-1#55	0	3	3	O95831-1	921	924	+	3	O95831-1	0	1839	ENST00000675092.1	90	1956	+	247	O95831-1#55	0	3	ENST00000675092.1	1011	1014	+	3	0	0	1236
O95831-1#55	0	3	3	O95831-1	921	924	+	3	O95831-1	0	1839	ENST00000675050.1	71	1898	++	246	O95831-1#55	0	3	ENST00000675050.1	980	983	+	3	0	0	1237
O95831-1#55	0	3	3	O95831-1	921	924	+	3	O95831-1	0	1454	ENST00000675037.1	56	1439	+	245	O95831-1#55	0	3	ENST00000675037.1	977	980	+	3	0	0	1238
O95831-1#55	0	3	3	O95831-1	921	924	+	3	O95831-1	299	1183	ENST00000674957.1	0	880	+	243	O95831-1#55	0	3	ENST00000674957.1	622	625	+	3	0	0	1239
O95831-1#55	0	3	3	O95831-1	921	924	+	3	O95831-1	0	1762	ENST00000674546.1	185	1955	+	239	O95831-1#55	0	3	ENST00000674546.1	1106	1109	+	3	0	0	1240
O95831-1#55	0	3	3	O95831-1	921	924	+	3	O95831-1	0	966	ENST00000535724.6	8	974	++	156	O95831-1#55	0	3	ENST00000535724.6	929	932	+	3	0	0	1241
O95831-1#55	0	3	3	O95831-1	921	924	+	3	O95831-1	0	1336	ENST00000416073.7	37	1363	+	76	O95831-1#55	0	3	ENST00000416073.7	952	955	+	3	0	0	1242
O95831-1#55	0	3	3	O95831-1	921	924	+	3	O95831-1	0	1839	ENST00000319908.8	174	2007	+	25	O95831-1#55	0	3	ENST00000319908.8	1092	1095	+	3	0	0	1243
O95831-1#55	0	3	3	O95831-1	921	924	+	3	O95831-1	0	1839	ENST00000287295.8	185	2024	++	16	O95831-1#55	0	3	ENST00000287295.8	1106	1109	+	3	0	0	1244
O95831-1#56	0	3	3	O95831-1	1011	1014	+	3	O95831-1	0	1839	ENST00000676436.1	34	1861	+	255	O95831-1#56	0	3	ENST00000676436.1	1033	1036	+	3	0	0	1245
O95831-1#56	0	3	3	O95831-1	1011	1014	+	3	O95831-1	0	1839	ENST00000676328.1	56	1892	+	254	O95831-1#56	0	3	ENST00000676328.1	1064	1067	+	3	0	0	1246
O95831-1#56	0	3	3	O95831-1	1011	1014	+	3	O95831-1	0	1839	ENST00000676229.1	223	2050	++	253	O95831-1#56	0	3	ENST00000676229.1	1222	1225	+	3	0	0	1247
O95831-1#56	0	3	3	O95831-1	1011	1014	+	3	O95831-1	0	1839	ENST00000675857.1	82	1915	+	251	O95831-1#56	0	3	ENST00000675857.1	1087	1090	+	3	0	0	1248
O95831-1#56	0	3	3	O95831-1	1011	1014	+	3	O95831-1	0	1839	ENST00000675427.1	89	1925	+	249	O95831-1#56	0	3	ENST00000675427.1	1100	1103	+	3	0	0	1249
O95831-1#56	0	3	3	O95831-1	1011	1014	+	3	O95831-1	0	1762	ENST00000675240.1	169	1867	+	248	O95831-1#56	0	3	ENST00000675240.1	1180	1183	+	3	0	0	1250
O95831-1#56	0	3	3	O95831-1	1011	1014	+	3	O95831-1	0	1839	ENST00000675092.1	90	1956	+	247	O95831-1#56	0	3	ENST00000675092.1	1101	1104	+	3	0	0	1251
O95831-1#56	0	3	3	O95831-1	1011	1014	+	3	O95831-1	0	1839	ENST00000675050.1	71	1898	++	246	O95831-1#56	0	3	ENST00000675050.1	1070	1073	+	3	0	0	1252
O95831-1#56	0	3	3	O95831-1	1011	1014	+	3	O95831-1	0	1454	ENST00000675037.1	56	1439	+	245	O95831-1#56	0	3	ENST00000675037.1	1067	1070	+	3	0	0	1253
O95831-1#56	0	3	3	O95831-1	1011	1014	+	3	O95831-1	299	1183	ENST00000674957.1	0	880	+	243	O95831-1#56	0	3	ENST00000674957.1	712	715	+	3	0	0	1254
O95831-1#56	0	3	3	O95831-1	1011	1014	+	3	O95831-1	1012	1839	ENST00000674601.1	0	686	+	241	O95831-1#56	1	3	ENST00000674601.1	0	2	+	2	1	0	1255
O95831-1#56	0	3	3	O95831-1	1011	1014	+	3	O95831-1	0	1762	ENST00000674546.1	185	1955	+	239	O95831-1#56	0	3	ENST00000674546.1	1196	1199	+	3	0	0	1256
O95831-1#56	0	3	3	O95831-1	1011	1014	+	3	O95831-1	0	1336	ENST00000416073.7	37	1363	+	76	O95831-1#56	0	3	ENST00000416073.7	1042	1045	+	3	0	0	1257
O95831-1#56	0	3	3	O95831-1	1011	1014	+	3	O95831-1	0	1839	ENST00000346424.6	24	1002	++	34	O95831-1#56	0	3	ENST00000346424.6	174	177	+	3	0	0	1258
O95831-1#56	0	3	3	O95831-1	1011	1014	+	3	O95831-1	0	1839	ENST00000319908.8	174	2007	+	25	O95831-1#56	0	3	ENST00000319908.8	1182	1185	+	3	0	0	1259
O95831-1#56	0	3	3	O95831-1	1011	1014	+	3	O95831-1	0	1839	ENST00000287295.8	185	2024	++	16	O95831-1#56	0	3	ENST00000287295.8	1196	1199	+	3	0	0	1260
O95831-1#57	0	3	3	O95831-1	1029	1032	+	3	O95831-1	0	1839	ENST00000676436.1	34	1861	+	255	O95831-1#57	0	3	ENST00000676436.1	1051	1054	+	3	0	0	1261
O95831-1#57	0	3	3	O95831-1	1029	1032	+	3	O95831-1	0	1839	ENST00000676328.1	56	1892	+	254	O95831-1#57	0	3	ENST00000676328.1	1082	1085	+	3	0	0	1262
O95831-1#57	0	3	3	O95831-1	1029	1032	+	3	O95831-1	0	1839	ENST00000676229.1	223	2050	++	253	O95831-1#57	0	3	ENST00000676229.1	1240	1243	+	3	0	0	1263
O95831-1#57	0	3	3	O95831-1	1029	1032	+	3	O95831-1	0	1839	ENST00000675857.1	82	1915	+	251	O95831-1#57	0	3	ENST00000675857.1	1105	1108	+	3	0	0	1264
O95831-1#57	0	3	3	O95831-1	1029	1032	+	3	O95831-1	0	1839	ENST00000675427.1	89	1925	+	249	O95831-1#57	0	3	ENST00000675427.1	1118	1121	+	3	0	0	1265
O95831-1#57	0	3	3	O95831-1	1029	1032	+	3	O95831-1	0	1762	ENST00000675240.1	169	1867	+	248	O95831-1#57	0	3	ENST00000675240.1	1198	1201	+	3	0	0	1266
O95831-1#57	0	3	3	O95831-1	1029	1032	+	3	O95831-1	0	1839	ENST00000675092.1	90	1956	+	247	O95831-1#57	0	3	ENST00000675092.1	1119	1122	+	3	0	0	1267
O95831-1#57	0	3	3	O95831-1	1029	1032	+	3	O95831-1	0	1839	ENST00000675050.1	71	1898	++	246	O95831-1#57	0	3	ENST00000675050.1	1088	1091	+	3	0	0	1268
O95831-1#57	0	3	3	O95831-1	1029	1032	+	3	O95831-1	0	1454	ENST00000675037.1	56	1439	+	245	O95831-1#57	0	3	ENST00000675037.1	1085	1088	+	3	0	0	1269
O95831-1#57	0	3	3	O95831-1	1029	1032	+	3	O95831-1	299	1183	ENST00000674957.1	0	880	+	243	O95831-1#57	0	3	ENST00000674957.1	730	733	+	3	0	0	1270
O95831-1#57	0	3	3	O95831-1	1029	1032	+	3	O95831-1	1012	1839	ENST00000674601.1	0	686	+	241	O95831-1#57	0	3	ENST00000674601.1	17	20	+	3	0	0	1271
O95831-1#57	0	3	3	O95831-1	1029	1032	+	3	O95831-1	0	1762	ENST00000674546.1	185	1955	+	239	O95831-1#57	0	3	ENST00000674546.1	1214	1217	+	3	0	0	1272
O95831-1#57	0	3	3	O95831-1	1029	1032	+	3	O95831-1	1017	1839	ENST00000460436.6	905	1727	+	105	O95831-1#57	0	3	ENST00000460436.6	917	920	+	3	0	0	1273
O95831-1#57	0	3	3	O95831-1	1029	1032	+	3	O95831-1	0	1336	ENST00000416073.7	37	1363	+	76	O95831-1#57	0	3	ENST00000416073.7	1060	1063	+	3	0	0	1274
O95831-1#57	0	3	3	O95831-1	1029	1032	+	3	O95831-1	0	1839	ENST00000346424.6	24	1002	++	34	O95831-1#57	0	3	ENST00000346424.6	192	195	+	3	0	0	1275
O95831-1#57	0	3	3	O95831-1	1029	1032	+	3	O95831-1	0	1839	ENST00000319908.8	174	2007	+	25	O95831-1#57	0	3	ENST00000319908.8	1200	1203	+	3	0	0	1276
O95831-1#57	0	3	3	O95831-1	1029	1032	+	3	O95831-1	0	1839	ENST00000287295.8	185	2024	++	16	O95831-1#57	0	3	ENST00000287295.8	1214	1217	+	3	0	0	1277
O95831-1#58	0	3	3	O95831-1	1077	1080	+	3	O95831-1	0	1839	ENST00000676436.1	34	1861	+	255	O95831-1#58	0	3	ENST00000676436.1	1099	1102	+	3	0	0	1278
O95831-1#58	0	3	3	O95831-1	1077	1080	+	3	O95831-1	0	1839	ENST00000676328.1	56	1892	+	254	O95831-1#58	0	3	ENST00000676328.1	1130	1133	+	3	0	0	1279
O95831-1#58	0	3	3	O95831-1	1077	1080	+	3	O95831-1	0	1839	ENST00000676229.1	223	2050	++	253	O95831-1#58	0	3	ENST00000676229.1	1288	1291	+	3	0	0	1280
O95831-1#58	0	3	3	O95831-1	1077	1080	+	3	O95831-1	0	1839	ENST00000675857.1	82	1915	+	251	O95831-1#58	0	3	ENST00000675857.1	1153	1156	+	3	0	0	1281
O95831-1#58	0	3	3	O95831-1	1077	1080	+	3	O95831-1	0	1839	ENST00000675427.1	89	1925	+	249	O95831-1#58	0	3	ENST00000675427.1	1166	1169	+	3	0	0	1282
O95831-1#58	0	3	3	O95831-1	1077	1080	+	3	O95831-1	0	1762	ENST00000675240.1	169	1867	+	248	O95831-1#58	0	3	ENST00000675240.1	1246	1249	+	3	0	0	1283
O95831-1#58	0	3	3	O95831-1	1077	1080	+	3	O95831-1	0	1839	ENST00000675092.1	90	1956	+	247	O95831-1#58	0	3	ENST00000675092.1	1167	1170	+	3	0	0	1284
O95831-1#58	0	3	3	O95831-1	1077	1080	+	3	O95831-1	0	1839	ENST00000675050.1	71	1898	++	246	O95831-1#58	0	3	ENST00000675050.1	1136	1139	+	3	0	0	1285
O95831-1#58	0	3	3	O95831-1	1077	1080	+	3	O95831-1	0	1454	ENST00000675037.1	56	1439	+	245	O95831-1#58	0	3	ENST00000675037.1	1133	1136	+	3	0	0	1286
O95831-1#58	0	3	3	O95831-1	1077	1080	+	3	O95831-1	299	1183	ENST00000674957.1	0	880	+	243	O95831-1#58	0	3	ENST00000674957.1	778	781	+	3	0	0	1287
O95831-1#58	0	3	3	O95831-1	1077	1080	+	3	O95831-1	1012	1839	ENST00000674601.1	0	686	+	241	O95831-1#58	0	3	ENST00000674601.1	65	68	+	3	0	0	1288
O95831-1#58	0	3	3	O95831-1	1077	1080	+	3	O95831-1	0	1762	ENST00000674546.1	185	1955	+	239	O95831-1#58	0	3	ENST00000674546.1	1262	1265	+	3	0	0	1289
O95831-1#58	0	3	3	O95831-1	1077	1080	+	3	O95831-1	1017	1839	ENST00000460436.6	905	1727	+	105	O95831-1#58	0	3	ENST00000460436.6	965	968	+	3	0	0	1290
O95831-1#58	0	3	3	O95831-1	1077	1080	+	3	O95831-1	0	1336	ENST00000416073.7	37	1363	+	76	O95831-1#58	0	3	ENST00000416073.7	1108	1111	+	3	0	0	1291
O95831-1#58	0	3	3	O95831-1	1077	1080	+	3	O95831-1	0	1839	ENST00000346424.6	24	1002	++	34	O95831-1#58	0	3	ENST00000346424.6	240	243	+	3	0	0	1292
O95831-1#58	0	3	3	O95831-1	1077	1080	+	3	O95831-1	0	1839	ENST00000319908.8	174	2007	+	25	O95831-1#58	0	3	ENST00000319908.8	1248	1251	+	3	0	0	1293
O95831-1#58	0	3	3	O95831-1	1077	1080	+	3	O95831-1	0	1839	ENST00000287295.8	185	2024	++	16	O95831-1#58	0	3	ENST00000287295.8	1262	1265	+	3	0	0	1294
O95831-1#59	0	3	3	O95831-1	1263	1266	+	3	O95831-1	0	1839	ENST00000676436.1	34	1861	+	255	O95831-1#59	0	3	ENST00000676436.1	1285	1288	+	3	0	0	1295
O95831-1#59	0	3	3	O95831-1	1263	1266	+	3	O95831-1	0	1839	ENST00000676328.1	56	1892	+	254	O95831-1#59	0	3	ENST00000676328.1	1316	1319	+	3	0	0	1296
O95831-1#59	0	3	3	O95831-1	1263	1266	+	3	O95831-1	0	1839	ENST00000676229.1	223	2050	++	253	O95831-1#59	0	3	ENST00000676229.1	1474	1477	+	3	0	0	1297
O95831-1#59	0	3	3	O95831-1	1263	1266	+	3	O95831-1	0	1839	ENST00000675857.1	82	1915	+	251	O95831-1#59	0	3	ENST00000675857.1	1339	1342	+	3	0	0	1298
O95831-1#59	0	3	3	O95831-1	1263	1266	+	3	O95831-1	0	1839	ENST00000675427.1	89	1925	+	249	O95831-1#59	0	3	ENST00000675427.1	1352	1355	+	3	0	0	1299
O95831-1#59	0	3	3	O95831-1	1263	1266	+	3	O95831-1	0	1762	ENST00000675240.1	169	1867	+	248	O95831-1#59	0	3	ENST00000675240.1	1432	1435	+	3	0	0	1300
O95831-1#59	0	3	3	O95831-1	1263	1266	+	3	O95831-1	0	1839	ENST00000675092.1	90	1956	+	247	O95831-1#59	0	3	ENST00000675092.1	1353	1356	+	3	0	0	1301
O95831-1#59	0	3	3	O95831-1	1263	1266	+	3	O95831-1	0	1839	ENST00000675050.1	71	1898	++	246	O95831-1#59	0	3	ENST00000675050.1	1322	1325	+	3	0	0	1302
O95831-1#59	0	3	3	O95831-1	1263	1266	+	3	O95831-1	0	1454	ENST00000675037.1	56	1439	+	245	O95831-1#59	0	3	ENST00000675037.1	1319	1322	+	3	0	0	1303
O95831-1#59	0	3	3	O95831-1	1263	1266	+	3	O95831-1	0	1762	ENST00000674546.1	185	1955	+	239	O95831-1#59	0	3	ENST00000674546.1	1448	1451	+	3	0	0	1304
O95831-1#59	0	3	3	O95831-1	1263	1266	+	3	O95831-1	1017	1839	ENST00000460436.6	905	1727	+	105	O95831-1#59	0	3	ENST00000460436.6	1151	1154	+	3	0	0	1305
O95831-1#59	0	3	3	O95831-1	1263	1266	+	3	O95831-1	0	1336	ENST00000416073.7	37	1363	+	76	O95831-1#59	0	3	ENST00000416073.7	1294	1297	+	3	0	0	1306
O95831-1#59	0	3	3	O95831-1	1263	1266	+	3	O95831-1	0	1839	ENST00000346424.6	24	1002	++	34	O95831-1#59	0	3	ENST00000346424.6	426	429	+	3	0	0	1307
O95831-1#59	0	3	3	O95831-1	1263	1266	+	3	O95831-1	0	1839	ENST00000319908.8	174	2007	+	25	O95831-1#59	0	3	ENST00000319908.8	1434	1437	+	3	0	0	1308
O95831-1#59	0	3	3	O95831-1	1263	1266	+	3	O95831-1	0	1839	ENST00000287295.8	185	2024	++	16	O95831-1#59	0	3	ENST00000287295.8	1448	1451	+	3	0	0	1309
O95831-1#60	0	3	3	O95831-1	1263	1266	+	3	O95831-1	0	1839	ENST00000676436.1	34	1861	+	255	O95831-1#60	0	3	ENST00000676436.1	1285	1288	+	3	0	0	1310
O95831-1#60	0	3	3	O95831-1	1263	1266	+	3	O95831-1	0	1839	ENST00000676328.1	56	1892	+	254	O95831-1#60	0	3	ENST00000676328.1	1316	1319	+	3	0	0	1311
O95831-1#60	0	3	3	O95831-1	1263	1266	+	3	O95831-1	0	1839	ENST00000676229.1	223	2050	++	253	O95831-1#60	0	3	ENST00000676229.1	1474	1477	+	3	0	0	1312
O95831-1#60	0	3	3	O95831-1	1263	1266	+	3	O95831-1	0	1839	ENST00000675857.1	82	1915	+	251	O95831-1#60	0	3	ENST00000675857.1	1339	1342	+	3	0	0	1313
O95831-1#60	0	3	3	O95831-1	1263	1266	+	3	O95831-1	0	1839	ENST00000675427.1	89	1925	+	249	O95831-1#60	0	3	ENST00000675427.1	1352	1355	+	3	0	0	1314
O95831-1#60	0	3	3	O95831-1	1263	1266	+	3	O95831-1	0	1762	ENST00000675240.1	169	1867	+	248	O95831-1#60	0	3	ENST00000675240.1	1432	1435	+	3	0	0	1315
O95831-1#60	0	3	3	O95831-1	1263	1266	+	3	O95831-1	0	1839	ENST00000675092.1	90	1956	+	247	O95831-1#60	0	3	ENST00000675092.1	1353	1356	+	3	0	0	1316
O95831-1#60	0	3	3	O95831-1	1263	1266	+	3	O95831-1	0	1839	ENST00000675050.1	71	1898	++	246	O95831-1#60	0	3	ENST00000675050.1	1322	1325	+	3	0	0	1317
O95831-1#60	0	3	3	O95831-1	1263	1266	+	3	O95831-1	0	1454	ENST00000675037.1	56	1439	+	245	O95831-1#60	0	3	ENST00000675037.1	1319	1322	+	3	0	0	1318
O95831-1#60	0	3	3	O95831-1	1263	1266	+	3	O95831-1	0	1762	ENST00000674546.1	185	1955	+	239	O95831-1#60	0	3	ENST00000674546.1	1448	1451	+	3	0	0	1319
O95831-1#60	0	3	3	O95831-1	1263	1266	+	3	O95831-1	1017	1839	ENST00000460436.6	905	1727	+	105	O95831-1#60	0	3	ENST00000460436.6	1151	1154	+	3	0	0	1320
O95831-1#60	0	3	3	O95831-1	1263	1266	+	3	O95831-1	0	1336	ENST00000416073.7	37	1363	+	76	O95831-1#60	0	3	ENST00000416073.7	1294	1297	+	3	0	0	1321
O95831-1#60	0	3	3	O95831-1	1263	1266	+	3	O95831-1	0	1839	ENST00000346424.6	24	1002	++	34	O95831-1#60	0	3	ENST00000346424.6	426	429	+	3	0	0	1322
O95831-1#60	0	3	3	O95831-1	1263	1266	+	3	O95831-1	0	1839	ENST00000319908.8	174	2007	+	25	O95831-1#60	0	3	ENST00000319908.8	1434	1437	+	3	0	0	1323
O95831-1#60	0	3	3	O95831-1	1263	1266	+	3	O95831-1	0	1839	ENST00000287295.8	185	2024	++	16	O95831-1#60	0	3	ENST00000287295.8	1448	1451	+	3	0	0	1324
O95831-1#61	0	3	3	O95831-1	1287	1290	+	3	O95831-1	0	1839	ENST00000676436.1	34	1861	+	255	O95831-1#61	0	3	ENST00000676436.1	1309	1312	+	3	0	0	1325
O95831-1#61	0	3	3	O95831-1	1287	1290	+	3	O95831-1	0	1839	ENST00000676328.1	56	1892	+	254	O95831-1#61	0	3	ENST00000676328.1	1340	1343	+	3	0	0	1326
O95831-1#61	0	3	3	O95831-1	1287	1290	+	3	O95831-1	0	1839	ENST00000676229.1	223	2050	++	253	O95831-1#61	0	3	ENST00000676229.1	1498	1501	+	3	0	0	1327
O95831-1#61	0	3	3	O95831-1	1287	1290	+	3	O95831-1	0	1839	ENST00000675857.1	82	1915	+	251	O95831-1#61	0	3	ENST00000675857.1	1363	1366	+	3	0	0	1328
O95831-1#61	0	3	3	O95831-1	1287	1290	+	3	O95831-1	0	1839	ENST00000675427.1	89	1925	+	249	O95831-1#61	0	3	ENST00000675427.1	1376	1379	+	3	0	0	1329
O95831-1#61	0	3	3	O95831-1	1287	1290	+	3	O95831-1	0	1762	ENST00000675240.1	169	1867	+	248	O95831-1#61	0	3	ENST00000675240.1	1456	1459	+	3	0	0	1330
O95831-1#61	0	3	3	O95831-1	1287	1290	+	3	O95831-1	0	1839	ENST00000675092.1	90	1956	+	247	O95831-1#61	0	3	ENST00000675092.1	1377	1380	+	3	0	0	1331
O95831-1#61	0	3	3	O95831-1	1287	1290	+	3	O95831-1	0	1839	ENST00000675050.1	71	1898	++	246	O95831-1#61	0	3	ENST00000675050.1	1346	1349	+	3	0	0	1332
O95831-1#61	0	3	3	O95831-1	1287	1290	+	3	O95831-1	0	1454	ENST00000675037.1	56	1439	+	245	O95831-1#61	0	3	ENST00000675037.1	1343	1346	+	3	0	0	1333
O95831-1#61	0	3	3	O95831-1	1287	1290	+	3	O95831-1	0	1762	ENST00000674546.1	185	1955	+	239	O95831-1#61	0	3	ENST00000674546.1	1472	1475	+	3	0	0	1334
O95831-1#61	0	3	3	O95831-1	1287	1290	+	3	O95831-1	1017	1839	ENST00000460436.6	905	1727	+	105	O95831-1#61	0	3	ENST00000460436.6	1175	1178	+	3	0	0	1335
O95831-1#61	0	3	3	O95831-1	1287	1290	+	3	O95831-1	0	1336	ENST00000416073.7	37	1363	+	76	O95831-1#61	0	3	ENST00000416073.7	1318	1321	+	3	0	0	1336
O95831-1#61	0	3	3	O95831-1	1287	1290	+	3	O95831-1	0	1839	ENST00000346424.6	24	1002	++	34	O95831-1#61	0	3	ENST00000346424.6	450	453	+	3	0	0	1337
O95831-1#61	0	3	3	O95831-1	1287	1290	+	3	O95831-1	0	1839	ENST00000319908.8	174	2007	+	25	O95831-1#61	0	3	ENST00000319908.8	1458	1461	+	3	0	0	1338
O95831-1#61	0	3	3	O95831-1	1287	1290	+	3	O95831-1	0	1839	ENST00000287295.8	185	2024	++	16	O95831-1#61	0	3	ENST00000287295.8	1472	1475	+	3	0	0	1339
O95831-1#62	0	3	3	O95831-1	1350	1353	+	3	O95831-1	0	1839	ENST00000676436.1	34	1861	+	255	O95831-1#62	0	3	ENST00000676436.1	1372	1375	+	3	0	0	1340
O95831-1#62	0	3	3	O95831-1	1350	1353	+	3	O95831-1	0	1839	ENST00000676328.1	56	1892	+	254	O95831-1#62	0	3	ENST00000676328.1	1403	1406	+	3	0	0	1341
O95831-1#62	0	3	3	O95831-1	1350	1353	+	3	O95831-1	0	1839	ENST00000676229.1	223	2050	++	253	O95831-1#62	0	3	ENST00000676229.1	1561	1564	+	3	0	0	1342
O95831-1#62	0	3	3	O95831-1	1350	1353	+	3	O95831-1	0	1839	ENST00000675857.1	82	1915	+	251	O95831-1#62	0	3	ENST00000675857.1	1426	1429	+	3	0	0	1343
O95831-1#62	0	3	3	O95831-1	1350	1353	+	3	O95831-1	0	1839	ENST00000675427.1	89	1925	+	249	O95831-1#62	0	3	ENST00000675427.1	1436	1439	+	3	0	0	1344
O95831-1#62	0	3	3	O95831-1	1350	1353	+	3	O95831-1	0	1762	ENST00000675240.1	169	1867	+	248	O95831-1#62	0	3	ENST00000675240.1	1519	1522	+	3	0	0	1345
O95831-1#62	0	3	3	O95831-1	1350	1353	+	3	O95831-1	0	1839	ENST00000675092.1	90	1956	+	247	O95831-1#62	0	3	ENST00000675092.1	1440	1443	+	3	0	0	1346
O95831-1#62	0	3	3	O95831-1	1350	1353	+	3	O95831-1	0	1839	ENST00000675050.1	71	1898	++	246	O95831-1#62	0	3	ENST00000675050.1	1409	1412	+	3	0	0	1347
O95831-1#62	0	3	3	O95831-1	1350	1353	+	3	O95831-1	0	1454	ENST00000675037.1	56	1439	+	245	O95831-1#62	0	3	ENST00000675037.1	1406	1409	+	3	0	0	1348
O95831-1#62	0	3	3	O95831-1	1350	1353	+	3	O95831-1	1012	1839	ENST00000674601.1	0	686	+	241	O95831-1#62	0	3	ENST00000674601.1	197	200	+	3	0	0	1349
O95831-1#62	0	3	3	O95831-1	1350	1353	+	3	O95831-1	0	1762	ENST00000674546.1	185	1955	+	239	O95831-1#62	0	3	ENST00000674546.1	1535	1538	+	3	0	0	1350
O95831-1#62	0	3	3	O95831-1	1350	1353	+	3	O95831-1	1017	1839	ENST00000460436.6	905	1727	+	105	O95831-1#62	0	3	ENST00000460436.6	1238	1241	+	3	0	0	1351
O95831-1#62	0	3	3	O95831-1	1350	1353	+	3	O95831-1	0	1839	ENST00000346424.6	24	1002	++	34	O95831-1#62	0	3	ENST00000346424.6	513	516	+	3	0	0	1352
O95831-1#62	0	3	3	O95831-1	1350	1353	+	3	O95831-1	0	1839	ENST00000319908.8	174	2007	+	25	O95831-1#62	0	3	ENST00000319908.8	1521	1524	+	3	0	0	1353
O95831-1#62	0	3	3	O95831-1	1350	1353	+	3	O95831-1	0	1839	ENST00000287295.8	185	2024	++	16	O95831-1#62	0	3	ENST00000287295.8	1535	1538	+	3	0	0	1354
O95831-1#63	0	3	3	O95831-1	1413	1416	+	3	O95831-1	0	1839	ENST00000676436.1	34	1861	+	255	O95831-1#63	0	3	ENST00000676436.1	1435	1438	+	3	0	0	1355
O95831-1#63	0	3	3	O95831-1	1413	1416	+	3	O95831-1	0	1839	ENST00000676328.1	56	1892	+	254	O95831-1#63	0	3	ENST00000676328.1	1466	1469	+	3	0	0	1356
O95831-1#63	0	3	3	O95831-1	1413	1416	+	3	O95831-1	0	1839	ENST00000676229.1	223	2050	++	253	O95831-1#63	0	3	ENST00000676229.1	1624	1627	+	3	0	0	1357
O95831-1#63	0	3	3	O95831-1	1413	1416	+	3	O95831-1	0	1839	ENST00000675857.1	82	1915	+	251	O95831-1#63	0	3	ENST00000675857.1	1489	1492	+	3	0	0	1358
O95831-1#63	0	3	3	O95831-1	1413	1416	+	3	O95831-1	0	1839	ENST00000675427.1	89	1925	+	249	O95831-1#63	0	3	ENST00000675427.1	1499	1502	+	3	0	0	1359
O95831-1#63	0	3	3	O95831-1	1413	1416	+	3	O95831-1	0	1762	ENST00000675240.1	169	1867	+	248	O95831-1#63	0	3	ENST00000675240.1	1582	1585	+	3	0	0	1360
O95831-1#63	0	3	3	O95831-1	1413	1416	+	3	O95831-1	0	1839	ENST00000675092.1	90	1956	+	247	O95831-1#63	0	3	ENST00000675092.1	1503	1506	+	3	0	0	1361
O95831-1#63	0	3	3	O95831-1	1413	1416	+	3	O95831-1	0	1839	ENST00000675050.1	71	1898	++	246	O95831-1#63	0	3	ENST00000675050.1	1472	1475	+	3	0	0	1362
O95831-1#63	0	3	3	O95831-1	1413	1416	+	3	O95831-1	1012	1839	ENST00000674601.1	0	686	+	241	O95831-1#63	0	3	ENST00000674601.1	260	263	+	3	0	0	1363
O95831-1#63	0	3	3	O95831-1	1413	1416	+	3	O95831-1	0	1762	ENST00000674546.1	185	1955	+	239	O95831-1#63	0	3	ENST00000674546.1	1598	1601	+	3	0	0	1364
O95831-1#63	0	3	3	O95831-1	1413	1416	+	3	O95831-1	1017	1839	ENST00000460436.6	905	1727	+	105	O95831-1#63	0	3	ENST00000460436.6	1301	1304	+	3	0	0	1365
O95831-1#63	0	3	3	O95831-1	1413	1416	+	3	O95831-1	0	1839	ENST00000346424.6	24	1002	++	34	O95831-1#63	0	3	ENST00000346424.6	576	579	+	3	0	0	1366
O95831-1#63	0	3	3	O95831-1	1413	1416	+	3	O95831-1	0	1839	ENST00000319908.8	174	2007	+	25	O95831-1#63	0	3	ENST00000319908.8	1584	1587	+	3	0	0	1367
O95831-1#63	0	3	3	O95831-1	1413	1416	+	3	O95831-1	0	1839	ENST00000287295.8	185	2024	++	16	O95831-1#63	0	3	ENST00000287295.8	1598	1601	+	3	0	0	1368
O95831-1#64	0	3	3	O95831-1	1422	1425	+	3	O95831-1	0	1839	ENST00000676436.1	34	1861	+	255	O95831-1#64	0	3	ENST00000676436.1	1444	1447	+	3	0	0	1369
O95831-1#64	0	3	3	O95831-1	1422	1425	+	3	O95831-1	0	1839	ENST00000676328.1	56	1892	+	254	O95831-1#64	0	3	ENST00000676328.1	1475	1478	+	3	0	0	1370
O95831-1#64	0	3	3	O95831-1	1422	1425	+	3	O95831-1	0	1839	ENST00000676229.1	223	2050	++	253	O95831-1#64	0	3	ENST00000676229.1	1633	1636	+	3	0	0	1371
O95831-1#64	0	3	3	O95831-1	1422	1425	+	3	O95831-1	0	1839	ENST00000675857.1	82	1915	+	251	O95831-1#64	0	3	ENST00000675857.1	1498	1501	+	3	0	0	1372
O95831-1#64	0	3	3	O95831-1	1422	1425	+	3	O95831-1	0	1839	ENST00000675427.1	89	1925	+	249	O95831-1#64	0	3	ENST00000675427.1	1508	1511	+	3	0	0	1373
O95831-1#64	0	3	3	O95831-1	1422	1425	+	3	O95831-1	0	1762	ENST00000675240.1	169	1867	+	248	O95831-1#64	0	3	ENST00000675240.1	1591	1594	+	3	0	0	1374
O95831-1#64	0	3	3	O95831-1	1422	1425	+	3	O95831-1	0	1839	ENST00000675092.1	90	1956	+	247	O95831-1#64	0	3	ENST00000675092.1	1512	1515	+	3	0	0	1375
O95831-1#64	0	3	3	O95831-1	1422	1425	+	3	O95831-1	0	1839	ENST00000675050.1	71	1898	++	246	O95831-1#64	0	3	ENST00000675050.1	1481	1484	+	3	0	0	1376
O95831-1#64	0	3	3	O95831-1	1422	1425	+	3	O95831-1	1012	1839	ENST00000674601.1	0	686	+	241	O95831-1#64	0	3	ENST00000674601.1	269	272	+	3	0	0	1377
O95831-1#64	0	3	3	O95831-1	1422	1425	+	3	O95831-1	0	1762	ENST00000674546.1	185	1955	+	239	O95831-1#64	0	3	ENST00000674546.1	1607	1610	+	3	0	0	1378
O95831-1#64	0	3	3	O95831-1	1422	1425	+	3	O95831-1	1017	1839	ENST00000460436.6	905	1727	+	105	O95831-1#64	0	3	ENST00000460436.6	1310	1313	+	3	0	0	1379
O95831-1#64	0	3	3	O95831-1	1422	1425	+	3	O95831-1	0	1839	ENST00000346424.6	24	1002	++	34	O95831-1#64	0	3	ENST00000346424.6	585	588	+	3	0	0	1380
O95831-1#64	0	3	3	O95831-1	1422	1425	+	3	O95831-1	0	1839	ENST00000319908.8	174	2007	+	25	O95831-1#64	0	3	ENST00000319908.8	1593	1596	+	3	0	0	1381
O95831-1#64	0	3	3	O95831-1	1422	1425	+	3	O95831-1	0	1839	ENST00000287295.8	185	2024	++	16	O95831-1#64	0	3	ENST00000287295.8	1607	1610	+	3	0	0	1382
O95831-1#65	0	3	3	O95831-1	1476	1479	+	3	O95831-1	0	1839	ENST00000676436.1	34	1861	+	255	O95831-1#65	0	3	ENST00000676436.1	1498	1501	+	3	0	0	1383
O95831-1#65	0	3	3	O95831-1	1476	1479	+	3	O95831-1	0	1839	ENST00000676328.1	56	1892	+	254	O95831-1#65	0	3	ENST00000676328.1	1529	1532	+	3	0	0	1384
O95831-1#65	0	3	3	O95831-1	1476	1479	+	3	O95831-1	0	1839	ENST00000676229.1	223	2050	++	253	O95831-1#65	0	3	ENST00000676229.1	1687	1690	+	3	0	0	1385
O95831-1#65	0	3	3	O95831-1	1476	1479	+	3	O95831-1	0	1839	ENST00000675857.1	82	1915	+	251	O95831-1#65	0	3	ENST00000675857.1	1552	1555	+	3	0	0	1386
O95831-1#65	0	3	3	O95831-1	1476	1479	+	3	O95831-1	0	1839	ENST00000675427.1	89	1925	+	249	O95831-1#65	0	3	ENST00000675427.1	1562	1565	+	3	0	0	1387
O95831-1#65	0	3	3	O95831-1	1476	1479	+	3	O95831-1	0	1762	ENST00000675240.1	169	1867	+	248	O95831-1#65	0	3	ENST00000675240.1	1645	1648	+	3	0	0	1388
O95831-1#65	0	3	3	O95831-1	1476	1479	+	3	O95831-1	0	1839	ENST00000675092.1	90	1956	+	247	O95831-1#65	0	3	ENST00000675092.1	1566	1569	+	3	0	0	1389
O95831-1#65	0	3	3	O95831-1	1476	1479	+	3	O95831-1	0	1839	ENST00000675050.1	71	1898	++	246	O95831-1#65	0	3	ENST00000675050.1	1535	1538	+	3	0	0	1390
O95831-1#65	0	3	3	O95831-1	1476	1479	+	3	O95831-1	1012	1839	ENST00000674601.1	0	686	+	241	O95831-1#65	0	3	ENST00000674601.1	323	326	+	3	0	0	1391
O95831-1#65	0	3	3	O95831-1	1476	1479	+	3	O95831-1	0	1762	ENST00000674546.1	185	1955	+	239	O95831-1#65	0	3	ENST00000674546.1	1661	1664	+	3	0	0	1392
O95831-1#65	0	3	3	O95831-1	1476	1479	+	3	O95831-1	1017	1839	ENST00000460436.6	905	1727	+	105	O95831-1#65	0	3	ENST00000460436.6	1364	1367	+	3	0	0	1393
O95831-1#65	0	3	3	O95831-1	1476	1479	+	3	O95831-1	0	1839	ENST00000346424.6	24	1002	++	34	O95831-1#65	0	3	ENST00000346424.6	639	642	+	3	0	0	1394
O95831-1#65	0	3	3	O95831-1	1476	1479	+	3	O95831-1	0	1839	ENST00000319908.8	174	2007	+	25	O95831-1#65	0	3	ENST00000319908.8	1644	1647	+	3	0	0	1395
O95831-1#65	0	3	3	O95831-1	1476	1479	+	3	O95831-1	0	1839	ENST00000287295.8	185	2024	++	16	O95831-1#65	0	3	ENST00000287295.8	1661	1664	+	3	0	0	1396
O95831-1#66	0	3	3	O95831-1	1491	1494	+	3	O95831-1	0	1839	ENST00000676436.1	34	1861	+	255	O95831-1#66	0	3	ENST00000676436.1	1513	1516	+	3	0	0	1397
O95831-1#66	0	3	3	O95831-1	1491	1494	+	3	O95831-1	0	1839	ENST00000676328.1	56	1892	+	254	O95831-1#66	0	3	ENST00000676328.1	1544	1547	+	3	0	0	1398
O95831-1#66	0	3	3	O95831-1	1491	1494	+	3	O95831-1	0	1839	ENST00000676229.1	223	2050	++	253	O95831-1#66	0	3	ENST00000676229.1	1702	1705	+	3	0	0	1399
O95831-1#66	0	3	3	O95831-1	1491	1494	+	3	O95831-1	0	1839	ENST00000675857.1	82	1915	+	251	O95831-1#66	0	3	ENST00000675857.1	1567	1570	+	3	0	0	1400
O95831-1#66	0	3	3	O95831-1	1491	1494	+	3	O95831-1	0	1839	ENST00000675427.1	89	1925	+	249	O95831-1#66	0	3	ENST00000675427.1	1577	1580	+	3	0	0	1401
O95831-1#66	0	3	3	O95831-1	1491	1494	+	3	O95831-1	0	1762	ENST00000675240.1	169	1867	+	248	O95831-1#66	0	3	ENST00000675240.1	1660	1663	+	3	0	0	1402
O95831-1#66	0	3	3	O95831-1	1491	1494	+	3	O95831-1	0	1839	ENST00000675092.1	90	1956	+	247	O95831-1#66	0	3	ENST00000675092.1	1581	1584	+	3	0	0	1403
O95831-1#66	0	3	3	O95831-1	1491	1494	+	3	O95831-1	0	1839	ENST00000675050.1	71	1898	++	246	O95831-1#66	0	3	ENST00000675050.1	1550	1553	+	3	0	0	1404
O95831-1#66	0	3	3	O95831-1	1491	1494	+	3	O95831-1	1012	1839	ENST00000674601.1	0	686	+	241	O95831-1#66	0	3	ENST00000674601.1	338	341	+	3	0	0	1405
O95831-1#66	0	3	3	O95831-1	1491	1494	+	3	O95831-1	0	1762	ENST00000674546.1	185	1955	+	239	O95831-1#66	0	3	ENST00000674546.1	1676	1679	+	3	0	0	1406
O95831-1#66	0	3	3	O95831-1	1491	1494	+	3	O95831-1	1017	1839	ENST00000460436.6	905	1727	+	105	O95831-1#66	0	3	ENST00000460436.6	1379	1382	+	3	0	0	1407
O95831-1#66	0	3	3	O95831-1	1491	1494	+	3	O95831-1	0	1839	ENST00000346424.6	24	1002	++	34	O95831-1#66	0	3	ENST00000346424.6	654	657	+	3	0	0	1408
O95831-1#66	0	3	3	O95831-1	1491	1494	+	3	O95831-1	0	1839	ENST00000319908.8	174	2007	+	25	O95831-1#66	0	3	ENST00000319908.8	1659	1662	+	3	0	0	1409
O95831-1#66	0	3	3	O95831-1	1491	1494	+	3	O95831-1	0	1839	ENST00000287295.8	185	2024	++	16	O95831-1#66	0	3	ENST00000287295.8	1676	1679	+	3	0	0	1410
O95831-1#67	0	3	3	O95831-1	1770	1773	+	3	O95831-1	0	1839	ENST00000676436.1	34	1861	+	255	O95831-1#67	0	3	ENST00000676436.1	1792	1795	+	3	0	0	1411
O95831-1#67	0	3	3	O95831-1	1770	1773	+	3	O95831-1	0	1839	ENST00000676328.1	56	1892	+	254	O95831-1#67	0	3	ENST00000676328.1	1823	1826	+	3	0	0	1412
O95831-1#67	0	3	3	O95831-1	1770	1773	+	3	O95831-1	0	1839	ENST00000676229.1	223	2050	++	253	O95831-1#67	0	3	ENST00000676229.1	1981	1984	+	3	0	0	1413
O95831-1#67	0	3	3	O95831-1	1770	1773	+	3	O95831-1	0	1839	ENST00000675857.1	82	1915	+	251	O95831-1#67	0	3	ENST00000675857.1	1846	1849	+	3	0	0	1414
O95831-1#67	0	3	3	O95831-1	1770	1773	+	3	O95831-1	0	1839	ENST00000675427.1	89	1925	+	249	O95831-1#67	0	3	ENST00000675427.1	1856	1859	+	3	0	0	1415
O95831-1#67	0	3	3	O95831-1	1770	1773	+	3	O95831-1	0	1839	ENST00000675092.1	90	1956	+	247	O95831-1#67	0	3	ENST00000675092.1	1887	1890	+	3	0	0	1416
O95831-1#67	0	3	3	O95831-1	1770	1773	+	3	O95831-1	0	1839	ENST00000675050.1	71	1898	++	246	O95831-1#67	0	3	ENST00000675050.1	1829	1832	+	3	0	0	1417
O95831-1#67	0	3	3	O95831-1	1770	1773	+	3	O95831-1	1012	1839	ENST00000674601.1	0	686	+	241	O95831-1#67	0	3	ENST00000674601.1	617	620	+	3	0	0	1418
O95831-1#67	0	3	3	O95831-1	1770	1773	+	3	O95831-1	1017	1839	ENST00000460436.6	905	1727	+	105	O95831-1#67	0	3	ENST00000460436.6	1658	1661	+	3	0	0	1419
O95831-1#67	0	3	3	O95831-1	1770	1773	+	3	O95831-1	0	1839	ENST00000346424.6	24	1002	++	34	O95831-1#67	0	3	ENST00000346424.6	933	936	+	3	0	0	1420
O95831-1#67	0	3	3	O95831-1	1770	1773	+	3	O95831-1	0	1839	ENST00000319908.8	174	2007	+	25	O95831-1#67	0	3	ENST00000319908.8	1938	1941	+	3	0	0	1421
O95831-1#67	0	3	3	O95831-1	1770	1773	+	3	O95831-1	0	1839	ENST00000287295.8	185	2024	++	16	O95831-1#67	0	3	ENST00000287295.8	1955	1958	+	3	0	0	1422
O95831-1#68	0	3	3	O95831-1	585	588	+	3	O95831-1	0	1839	ENST00000676436.1	34	1861	+	255	O95831-1#68	0	3	ENST00000676436.1	613	616	+	3	0	0	1423
O95831-1#68	0	3	3	O95831-1	585	588	+	3	O95831-1	0	1839	ENST00000676328.1	56	1892	+	254	O95831-1#68	0	3	ENST00000676328.1	641	644	+	3	0	0	1424
O95831-1#68	0	3	3	O95831-1	585	588	+	3	O95831-1	0	1839	ENST00000676229.1	223	2050	++	253	O95831-1#68	0	3	ENST00000676229.1	796	799	+	3	0	0	1425
O95831-1#68	0	3	3	O95831-1	585	588	+	3	O95831-1	0	1839	ENST00000675857.1	82	1915	+	251	O95831-1#68	0	3	ENST00000675857.1	661	664	+	3	0	0	1426
O95831-1#68	0	3	3	O95831-1	585	588	+	3	O95831-1	0	1839	ENST00000675427.1	89	1925	+	249	O95831-1#68	0	3	ENST00000675427.1	674	677	+	3	0	0	1427
O95831-1#68	0	3	3	O95831-1	585	588	+	3	O95831-1	0	1762	ENST00000675240.1	169	1867	+	248	O95831-1#68	0	3	ENST00000675240.1	754	757	+	3	0	0	1428
O95831-1#68	0	3	3	O95831-1	585	588	+	3	O95831-1	0	1839	ENST00000675092.1	90	1956	+	247	O95831-1#68	0	3	ENST00000675092.1	675	678	+	3	0	0	1429
O95831-1#68	0	3	3	O95831-1	585	588	+	3	O95831-1	0	1839	ENST00000675050.1	71	1898	++	246	O95831-1#68	0	3	ENST00000675050.1	644	647	+	3	0	0	1430
O95831-1#68	0	3	3	O95831-1	585	588	+	3	O95831-1	0	1454	ENST00000675037.1	56	1439	+	245	O95831-1#68	0	3	ENST00000675037.1	641	644	+	3	0	0	1431
O95831-1#68	0	3	3	O95831-1	585	588	+	3	O95831-1	299	1183	ENST00000674957.1	0	880	+	243	O95831-1#68	0	3	ENST00000674957.1	286	289	+	3	0	0	1432
O95831-1#68	0	3	3	O95831-1	585	588	+	3	O95831-1	0	832	ENST00000674722.1	13	760	+	242	O95831-1#68	0	3	ENST00000674722.1	598	601	+	3	0	0	1433
O95831-1#68	0	3	3	O95831-1	585	588	+	3	O95831-1	0	1762	ENST00000674546.1	185	1955	+	239	O95831-1#68	0	3	ENST00000674546.1	770	773	+	3	0	0	1434
O95831-1#68	0	3	3	O95831-1	585	588	+	3	O95831-1	0	966	ENST00000535724.6	8	974	++	156	O95831-1#68	0	3	ENST00000535724.6	593	596	+	3	0	0	1435
O95831-1#68	0	3	3	O95831-1	585	588	+	3	O95831-1	0	1336	ENST00000416073.7	37	1363	+	76	O95831-1#68	0	3	ENST00000416073.7	616	619	+	3	0	0	1436
O95831-1#68	0	3	3	O95831-1	585	588	+	3	O95831-1	0	1839	ENST00000319908.8	174	2007	+	25	O95831-1#68	0	3	ENST00000319908.8	759	762	+	3	0	0	1437
O95831-1#68	0	3	3	O95831-1	585	588	+	3	O95831-1	0	1839	ENST00000287295.8	185	2024	++	16	O95831-1#68	0	3	ENST00000287295.8	770	773	+	3	0	0	1438
O95831-1#69	0	54	54	O95831-1	1236	1290	+	54	O95831-1	0	1839	ENST00000676436.1	34	1861	+	255	O95831-1#69	0	54	ENST00000676436.1	1258	1312	+	54	0	0	1439
O95831-1#69	0	54	54	O95831-1	1236	1290	+	54	O95831-1	0	1839	ENST00000676328.1	56	1892	+	254	O95831-1#69	0	54	ENST00000676328.1	1289	1343	+	54	0	0	1440
O95831-1#69	0	54	54	O95831-1	1236	1290	+	54	O95831-1	0	1839	ENST00000676229.1	223	2050	++	253	O95831-1#69	0	54	ENST00000676229.1	1447	1501	+	54	0	0	1441
O95831-1#69	0	54	54	O95831-1	1236	1290	+	54	O95831-1	0	1839	ENST00000675857.1	82	1915	+	251	O95831-1#69	0	54	ENST00000675857.1	1312	1366	+	54	0	0	1442
O95831-1#69	0	54	54	O95831-1	1236	1290	+	54	O95831-1	0	1839	ENST00000675427.1	89	1925	+	249	O95831-1#69	0	54	ENST00000675427.1	1325	1379	+	54	0	0	1443
O95831-1#69	0	54	54	O95831-1	1236	1290	+	54	O95831-1	0	1762	ENST00000675240.1	169	1867	+	248	O95831-1#69	0	54	ENST00000675240.1	1405	1459	+	54	0	0	1444
O95831-1#69	0	54	54	O95831-1	1236	1290	+	54	O95831-1	0	1839	ENST00000675092.1	90	1956	+	247	O95831-1#69	0	54	ENST00000675092.1	1326	1380	+	54	0	0	1445
O95831-1#69	0	54	54	O95831-1	1236	1290	+	54	O95831-1	0	1839	ENST00000675050.1	71	1898	++	246	O95831-1#69	0	54	ENST00000675050.1	1295	1349	+	54	0	0	1446
O95831-1#69	0	54	54	O95831-1	1236	1290	+	54	O95831-1	0	1454	ENST00000675037.1	56	1439	+	245	O95831-1#69	0	54	ENST00000675037.1	1292	1346	+	54	0	0	1447
O95831-1#69	0	54	54	O95831-1	1236	1290	+	54	O95831-1	0	1762	ENST00000674546.1	185	1955	+	239	O95831-1#69	0	54	ENST00000674546.1	1421	1475	+	54	0	0	1448
O95831-1#69	0	54	54	O95831-1	1236	1290	+	54	O95831-1	1017	1839	ENST00000460436.6	905	1727	+	105	O95831-1#69	0	54	ENST00000460436.6	1124	1178	+	54	0	0	1449
O95831-1#69	0	54	54	O95831-1	1236	1290	+	54	O95831-1	0	1336	ENST00000416073.7	37	1363	+	76	O95831-1#69	0	54	ENST00000416073.7	1267	1321	+	54	0	0	1450
O95831-1#69	0	54	54	O95831-1	1236	1290	+	54	O95831-1	0	1839	ENST00000346424.6	24	1002	++	34	O95831-1#69	0	54	ENST00000346424.6	399	453	+	54	0	0	1451
O95831-1#69	0	54	54	O95831-1	1236	1290	+	54	O95831-1	0	1839	ENST00000319908.8	174	2007	+	25	O95831-1#69	0	54	ENST00000319908.8	1407	1461	+	54	0	0	1452
O95831-1#69	0	54	54	O95831-1	1236	1290	+	54	O95831-1	0	1839	ENST00000287295.8	185	2024	++	16	O95831-1#69	0	54	ENST00000287295.8	1421	1475	+	54	0	0	1453
O95831-1#70	0	9	9	O95831-1	1326	1335	+	9	O95831-1	0	1839	ENST00000676436.1	34	1861	+	255	O95831-1#70	0	9	ENST00000676436.1	1348	1357	+	9	0	0	1454
O95831-1#70	0	9	9	O95831-1	1326	1335	+	9	O95831-1	0	1839	ENST00000676328.1	56	1892	+	254	O95831-1#70	0	9	ENST00000676328.1	1379	1388	+	9	0	0	1455
O95831-1#70	0	9	9	O95831-1	1326	1335	+	9	O95831-1	0	1839	ENST00000676229.1	223	2050	++	253	O95831-1#70	0	9	ENST00000676229.1	1537	1546	+	9	0	0	1456
O95831-1#70	0	9	9	O95831-1	1326	1335	+	9	O95831-1	0	1839	ENST00000675857.1	82	1915	+	251	O95831-1#70	0	9	ENST00000675857.1	1402	1411	+	9	0	0	1457
O95831-1#70	0	9	9	O95831-1	1326	1335	+	9	O95831-1	0	1839	ENST00000675427.1	89	1925	+	249	O95831-1#70	0	9	ENST00000675427.1	1412	1421	+	9	0	0	1458
O95831-1#70	0	9	9	O95831-1	1326	1335	+	9	O95831-1	0	1762	ENST00000675240.1	169	1867	+	248	O95831-1#70	0	9	ENST00000675240.1	1495	1504	+	9	0	0	1459
O95831-1#70	0	9	9	O95831-1	1326	1335	+	9	O95831-1	0	1839	ENST00000675092.1	90	1956	+	247	O95831-1#70	0	9	ENST00000675092.1	1416	1425	+	9	0	0	1460
O95831-1#70	0	9	9	O95831-1	1326	1335	+	9	O95831-1	0	1839	ENST00000675050.1	71	1898	++	246	O95831-1#70	0	9	ENST00000675050.1	1385	1394	+	9	0	0	1461
O95831-1#70	0	9	9	O95831-1	1326	1335	+	9	O95831-1	0	1454	ENST00000675037.1	56	1439	+	245	O95831-1#70	0	9	ENST00000675037.1	1382	1391	+	9	0	0	1462
O95831-1#70	0	9	9	O95831-1	1326	1335	+	9	O95831-1	1012	1839	ENST00000674601.1	0	686	+	241	O95831-1#70	0	9	ENST00000674601.1	173	182	+	9	0	0	1463
O95831-1#70	0	9	9	O95831-1	1326	1335	+	9	O95831-1	0	1762	ENST00000674546.1	185	1955	+	239	O95831-1#70	0	9	ENST00000674546.1	1511	1520	+	9	0	0	1464
O95831-1#70	0	9	9	O95831-1	1326	1335	+	9	O95831-1	1017	1839	ENST00000460436.6	905	1727	+	105	O95831-1#70	0	9	ENST00000460436.6	1214	1223	+	9	0	0	1465
O95831-1#70	0	9	9	O95831-1	1326	1335	+	9	O95831-1	0	1336	ENST00000416073.7	37	1363	+	76	O95831-1#70	0	9	ENST00000416073.7	1353	1362	+	9	0	0	1466
O95831-1#70	0	9	9	O95831-1	1326	1335	+	9	O95831-1	0	1839	ENST00000346424.6	24	1002	++	34	O95831-1#70	0	9	ENST00000346424.6	489	498	+	9	0	0	1467
O95831-1#70	0	9	9	O95831-1	1326	1335	+	9	O95831-1	0	1839	ENST00000319908.8	174	2007	+	25	O95831-1#70	0	9	ENST00000319908.8	1497	1506	+	9	0	0	1468
O95831-1#70	0	9	9	O95831-1	1326	1335	+	9	O95831-1	0	1839	ENST00000287295.8	185	2024	++	16	O95831-1#70	0	9	ENST00000287295.8	1511	1520	+	9	0	0	1469
O95831-1#71	0	3	3	O95831-1	1359	1362	+	3	O95831-1	0	1839	ENST00000676436.1	34	1861	+	255	O95831-1#71	0	3	ENST00000676436.1	1381	1384	+	3	0	0	1470
O95831-1#71	0	3	3	O95831-1	1359	1362	+	3	O95831-1	0	1839	ENST00000676328.1	56	1892	+	254	O95831-1#71	0	3	ENST00000676328.1	1412	1415	+	3	0	0	1471
O95831-1#71	0	3	3	O95831-1	1359	1362	+	3	O95831-1	0	1839	ENST00000676229.1	223	2050	++	253	O95831-1#71	0	3	ENST00000676229.1	1570	1573	+	3	0	0	1472
O95831-1#71	0	3	3	O95831-1	1359	1362	+	3	O95831-1	0	1839	ENST00000675857.1	82	1915	+	251	O95831-1#71	0	3	ENST00000675857.1	1435	1438	+	3	0	0	1473
O95831-1#71	0	3	3	O95831-1	1359	1362	+	3	O95831-1	0	1839	ENST00000675427.1	89	1925	+	249	O95831-1#71	0	3	ENST00000675427.1	1445	1448	+	3	0	0	1474
O95831-1#71	0	3	3	O95831-1	1359	1362	+	3	O95831-1	0	1762	ENST00000675240.1	169	1867	+	248	O95831-1#71	0	3	ENST00000675240.1	1528	1531	+	3	0	0	1475
O95831-1#71	0	3	3	O95831-1	1359	1362	+	3	O95831-1	0	1839	ENST00000675092.1	90	1956	+	247	O95831-1#71	0	3	ENST00000675092.1	1449	1452	+	3	0	0	1476
O95831-1#71	0	3	3	O95831-1	1359	1362	+	3	O95831-1	0	1839	ENST00000675050.1	71	1898	++	246	O95831-1#71	0	3	ENST00000675050.1	1418	1421	+	3	0	0	1477
O95831-1#71	0	3	3	O95831-1	1359	1362	+	3	O95831-1	0	1454	ENST00000675037.1	56	1439	+	245	O95831-1#71	0	3	ENST00000675037.1	1415	1418	+	3	0	0	1478
O95831-1#71	0	3	3	O95831-1	1359	1362	+	3	O95831-1	1012	1839	ENST00000674601.1	0	686	+	241	O95831-1#71	0	3	ENST00000674601.1	206	209	+	3	0	0	1479
O95831-1#71	0	3	3	O95831-1	1359	1362	+	3	O95831-1	0	1762	ENST00000674546.1	185	1955	+	239	O95831-1#71	0	3	ENST00000674546.1	1544	1547	+	3	0	0	1480
O95831-1#71	0	3	3	O95831-1	1359	1362	+	3	O95831-1	1017	1839	ENST00000460436.6	905	1727	+	105	O95831-1#71	0	3	ENST00000460436.6	1247	1250	+	3	0	0	1481
O95831-1#71	0	3	3	O95831-1	1359	1362	+	3	O95831-1	0	1839	ENST00000346424.6	24	1002	++	34	O95831-1#71	0	3	ENST00000346424.6	522	525	+	3	0	0	1482
O95831-1#71	0	3	3	O95831-1	1359	1362	+	3	O95831-1	0	1839	ENST00000319908.8	174	2007	+	25	O95831-1#71	0	3	ENST00000319908.8	1530	1533	+	3	0	0	1483
O95831-1#71	0	3	3	O95831-1	1359	1362	+	3	O95831-1	0	1839	ENST00000287295.8	185	2024	++	16	O95831-1#71	0	3	ENST00000287295.8	1544	1547	+	3	0	0	1484
O95831-1#72	0	3	3	O95831-1	1428	1431	+	3	O95831-1	0	1839	ENST00000676436.1	34	1861	+	255	O95831-1#72	0	3	ENST00000676436.1	1450	1453	+	3	0	0	1485
O95831-1#72	0	3	3	O95831-1	1428	1431	+	3	O95831-1	0	1839	ENST00000676328.1	56	1892	+	254	O95831-1#72	0	3	ENST00000676328.1	1481	1484	+	3	0	0	1486
O95831-1#72	0	3	3	O95831-1	1428	1431	+	3	O95831-1	0	1839	ENST00000676229.1	223	2050	++	253	O95831-1#72	0	3	ENST00000676229.1	1639	1642	+	3	0	0	1487
O95831-1#72	0	3	3	O95831-1	1428	1431	+	3	O95831-1	0	1839	ENST00000675857.1	82	1915	+	251	O95831-1#72	0	3	ENST00000675857.1	1504	1507	+	3	0	0	1488
O95831-1#72	0	3	3	O95831-1	1428	1431	+	3	O95831-1	0	1839	ENST00000675427.1	89	1925	+	249	O95831-1#72	0	3	ENST00000675427.1	1514	1517	+	3	0	0	1489
O95831-1#72	0	3	3	O95831-1	1428	1431	+	3	O95831-1	0	1762	ENST00000675240.1	169	1867	+	248	O95831-1#72	0	3	ENST00000675240.1	1597	1600	+	3	0	0	1490
O95831-1#72	0	3	3	O95831-1	1428	1431	+	3	O95831-1	0	1839	ENST00000675092.1	90	1956	+	247	O95831-1#72	0	3	ENST00000675092.1	1518	1521	+	3	0	0	1491
O95831-1#72	0	3	3	O95831-1	1428	1431	+	3	O95831-1	0	1839	ENST00000675050.1	71	1898	++	246	O95831-1#72	0	3	ENST00000675050.1	1487	1490	+	3	0	0	1492
O95831-1#72	0	3	3	O95831-1	1428	1431	+	3	O95831-1	1012	1839	ENST00000674601.1	0	686	+	241	O95831-1#72	0	3	ENST00000674601.1	275	278	+	3	0	0	1493
O95831-1#72	0	3	3	O95831-1	1428	1431	+	3	O95831-1	0	1762	ENST00000674546.1	185	1955	+	239	O95831-1#72	0	3	ENST00000674546.1	1613	1616	+	3	0	0	1494
O95831-1#72	0	3	3	O95831-1	1428	1431	+	3	O95831-1	1017	1839	ENST00000460436.6	905	1727	+	105	O95831-1#72	0	3	ENST00000460436.6	1316	1319	+	3	0	0	1495
O95831-1#72	0	3	3	O95831-1	1428	1431	+	3	O95831-1	0	1839	ENST00000346424.6	24	1002	++	34	O95831-1#72	0	3	ENST00000346424.6	591	594	+	3	0	0	1496
O95831-1#72	0	3	3	O95831-1	1428	1431	+	3	O95831-1	0	1839	ENST00000319908.8	174	2007	+	25	O95831-1#72	0	3	ENST00000319908.8	1599	1602	+	3	0	0	1497
O95831-1#72	0	3	3	O95831-1	1428	1431	+	3	O95831-1	0	1839	ENST00000287295.8	185	2024	++	16	O95831-1#72	0	3	ENST00000287295.8	1613	1616	+	3	0	0	1498
O95831-1#73	0	3	3	O95831-1	1437	1440	+	3	O95831-1	0	1839	ENST00000676436.1	34	1861	+	255	O95831-1#73	0	3	ENST00000676436.1	1459	1462	+	3	0	0	1499
O95831-1#73	0	3	3	O95831-1	1437	1440	+	3	O95831-1	0	1839	ENST00000676328.1	56	1892	+	254	O95831-1#73	0	3	ENST00000676328.1	1490	1493	+	3	0	0	1500
O95831-1#73	0	3	3	O95831-1	1437	1440	+	3	O95831-1	0	1839	ENST00000676229.1	223	2050	++	253	O95831-1#73	0	3	ENST00000676229.1	1648	1651	+	3	0	0	1501
O95831-1#73	0	3	3	O95831-1	1437	1440	+	3	O95831-1	0	1839	ENST00000675857.1	82	1915	+	251	O95831-1#73	0	3	ENST00000675857.1	1513	1516	+	3	0	0	1502
O95831-1#73	0	3	3	O95831-1	1437	1440	+	3	O95831-1	0	1839	ENST00000675427.1	89	1925	+	249	O95831-1#73	0	3	ENST00000675427.1	1523	1526	+	3	0	0	1503
O95831-1#73	0	3	3	O95831-1	1437	1440	+	3	O95831-1	0	1762	ENST00000675240.1	169	1867	+	248	O95831-1#73	0	3	ENST00000675240.1	1606	1609	+	3	0	0	1504
O95831-1#73	0	3	3	O95831-1	1437	1440	+	3	O95831-1	0	1839	ENST00000675092.1	90	1956	+	247	O95831-1#73	0	3	ENST00000675092.1	1527	1530	+	3	0	0	1505
O95831-1#73	0	3	3	O95831-1	1437	1440	+	3	O95831-1	0	1839	ENST00000675050.1	71	1898	++	246	O95831-1#73	0	3	ENST00000675050.1	1496	1499	+	3	0	0	1506
O95831-1#73	0	3	3	O95831-1	1437	1440	+	3	O95831-1	1012	1839	ENST00000674601.1	0	686	+	241	O95831-1#73	0	3	ENST00000674601.1	284	287	+	3	0	0	1507
O95831-1#73	0	3	3	O95831-1	1437	1440	+	3	O95831-1	0	1762	ENST00000674546.1	185	1955	+	239	O95831-1#73	0	3	ENST00000674546.1	1622	1625	+	3	0	0	1508
O95831-1#73	0	3	3	O95831-1	1437	1440	+	3	O95831-1	1017	1839	ENST00000460436.6	905	1727	+	105	O95831-1#73	0	3	ENST00000460436.6	1325	1328	+	3	0	0	1509
O95831-1#73	0	3	3	O95831-1	1437	1440	+	3	O95831-1	0	1839	ENST00000346424.6	24	1002	++	34	O95831-1#73	0	3	ENST00000346424.6	600	603	+	3	0	0	1510
O95831-1#73	0	3	3	O95831-1	1437	1440	+	3	O95831-1	0	1839	ENST00000319908.8	174	2007	+	25	O95831-1#73	0	3	ENST00000319908.8	1608	1611	+	3	0	0	1511
O95831-1#73	0	3	3	O95831-1	1437	1440	+	3	O95831-1	0	1839	ENST00000287295.8	185	2024	++	16	O95831-1#73	0	3	ENST00000287295.8	1622	1625	+	3	0	0	1512
O95831-1#74	0	3	3	O95831-1	1452	1455	+	3	O95831-1	0	1839	ENST00000676436.1	34	1861	+	255	O95831-1#74	0	3	ENST00000676436.1	1474	1477	+	3	0	0	1513
O95831-1#74	0	3	3	O95831-1	1452	1455	+	3	O95831-1	0	1839	ENST00000676328.1	56	1892	+	254	O95831-1#74	0	3	ENST00000676328.1	1505	1508	+	3	0	0	1514
O95831-1#74	0	3	3	O95831-1	1452	1455	+	3	O95831-1	0	1839	ENST00000676229.1	223	2050	++	253	O95831-1#74	0	3	ENST00000676229.1	1663	1666	+	3	0	0	1515
O95831-1#74	0	3	3	O95831-1	1452	1455	+	3	O95831-1	0	1839	ENST00000675857.1	82	1915	+	251	O95831-1#74	0	3	ENST00000675857.1	1528	1531	+	3	0	0	1516
O95831-1#74	0	3	3	O95831-1	1452	1455	+	3	O95831-1	0	1839	ENST00000675427.1	89	1925	+	249	O95831-1#74	0	3	ENST00000675427.1	1538	1541	+	3	0	0	1517
O95831-1#74	0	3	3	O95831-1	1452	1455	+	3	O95831-1	0	1762	ENST00000675240.1	169	1867	+	248	O95831-1#74	0	3	ENST00000675240.1	1621	1624	+	3	0	0	1518
O95831-1#74	0	3	3	O95831-1	1452	1455	+	3	O95831-1	0	1839	ENST00000675092.1	90	1956	+	247	O95831-1#74	0	3	ENST00000675092.1	1542	1545	+	3	0	0	1519
O95831-1#74	0	3	3	O95831-1	1452	1455	+	3	O95831-1	0	1839	ENST00000675050.1	71	1898	++	246	O95831-1#74	0	3	ENST00000675050.1	1511	1514	+	3	0	0	1520
O95831-1#74	0	3	3	O95831-1	1452	1455	+	3	O95831-1	0	1454	ENST00000675037.1	56	1439	+	245	O95831-1#74	0	2	ENST00000675037.1	1437	1439	+	2	0	1	1521
O95831-1#74	0	3	3	O95831-1	1452	1455	+	3	O95831-1	1012	1839	ENST00000674601.1	0	686	+	241	O95831-1#74	0	3	ENST00000674601.1	299	302	+	3	0	0	1522
O95831-1#74	0	3	3	O95831-1	1452	1455	+	3	O95831-1	0	1762	ENST00000674546.1	185	1955	+	239	O95831-1#74	0	3	ENST00000674546.1	1637	1640	+	3	0	0	1523
O95831-1#74	0	3	3	O95831-1	1452	1455	+	3	O95831-1	1017	1839	ENST00000460436.6	905	1727	+	105	O95831-1#74	0	3	ENST00000460436.6	1340	1343	+	3	0	0	1524
O95831-1#74	0	3	3	O95831-1	1452	1455	+	3	O95831-1	0	1839	ENST00000346424.6	24	1002	++	34	O95831-1#74	0	3	ENST00000346424.6	615	618	+	3	0	0	1525
O95831-1#74	0	3	3	O95831-1	1452	1455	+	3	O95831-1	0	1839	ENST00000319908.8	174	2007	+	25	O95831-1#74	0	3	ENST00000319908.8	1620	1623	+	3	0	0	1526
O95831-1#74	0	3	3	O95831-1	1452	1455	+	3	O95831-1	0	1839	ENST00000287295.8	185	2024	++	16	O95831-1#74	0	3	ENST00000287295.8	1637	1640	+	3	0	0	1527
O95831-1#75	0	3	3	O95831-1	1584	1587	+	3	O95831-1	0	1839	ENST00000676436.1	34	1861	+	255	O95831-1#75	0	3	ENST00000676436.1	1606	1609	+	3	0	0	1528
O95831-1#75	0	3	3	O95831-1	1584	1587	+	3	O95831-1	0	1839	ENST00000676328.1	56	1892	+	254	O95831-1#75	0	3	ENST00000676328.1	1637	1640	+	3	0	0	1529
O95831-1#75	0	3	3	O95831-1	1584	1587	+	3	O95831-1	0	1839	ENST00000676229.1	223	2050	++	253	O95831-1#75	0	3	ENST00000676229.1	1795	1798	+	3	0	0	1530
O95831-1#75	0	3	3	O95831-1	1584	1587	+	3	O95831-1	0	1839	ENST00000675857.1	82	1915	+	251	O95831-1#75	0	3	ENST00000675857.1	1660	1663	+	3	0	0	1531
O95831-1#75	0	3	3	O95831-1	1584	1587	+	3	O95831-1	0	1839	ENST00000675427.1	89	1925	+	249	O95831-1#75	0	3	ENST00000675427.1	1670	1673	+	3	0	0	1532
O95831-1#75	0	3	3	O95831-1	1584	1587	+	3	O95831-1	0	1839	ENST00000675092.1	90	1956	+	247	O95831-1#75	0	3	ENST00000675092.1	1701	1704	+	3	0	0	1533
O95831-1#75	0	3	3	O95831-1	1584	1587	+	3	O95831-1	0	1839	ENST00000675050.1	71	1898	++	246	O95831-1#75	0	3	ENST00000675050.1	1643	1646	+	3	0	0	1534
O95831-1#75	0	3	3	O95831-1	1584	1587	+	3	O95831-1	1012	1839	ENST00000674601.1	0	686	+	241	O95831-1#75	0	3	ENST00000674601.1	431	434	+	3	0	0	1535
O95831-1#75	0	3	3	O95831-1	1584	1587	+	3	O95831-1	0	1762	ENST00000674546.1	185	1955	+	239	O95831-1#75	0	3	ENST00000674546.1	1777	1780	+	3	0	0	1536
O95831-1#75	0	3	3	O95831-1	1584	1587	+	3	O95831-1	1017	1839	ENST00000460436.6	905	1727	+	105	O95831-1#75	0	3	ENST00000460436.6	1472	1475	+	3	0	0	1537
O95831-1#75	0	3	3	O95831-1	1584	1587	+	3	O95831-1	0	1839	ENST00000346424.6	24	1002	++	34	O95831-1#75	0	3	ENST00000346424.6	747	750	+	3	0	0	1538
O95831-1#75	0	3	3	O95831-1	1584	1587	+	3	O95831-1	0	1839	ENST00000319908.8	174	2007	+	25	O95831-1#75	0	3	ENST00000319908.8	1752	1755	+	3	0	0	1539
O95831-1#75	0	3	3	O95831-1	1584	1587	+	3	O95831-1	0	1839	ENST00000287295.8	185	2024	++	16	O95831-1#75	0	3	ENST00000287295.8	1769	1772	+	3	0	0	1540
O95831-1#76	0	3	3	O95831-1	1590	1593	+	3	O95831-1	0	1839	ENST00000676436.1	34	1861	+	255	O95831-1#76	0	3	ENST00000676436.1	1612	1615	+	3	0	0	1541
O95831-1#76	0	3	3	O95831-1	1590	1593	+	3	O95831-1	0	1839	ENST00000676328.1	56	1892	+	254	O95831-1#76	0	3	ENST00000676328.1	1643	1646	+	3	0	0	1542
O95831-1#76	0	3	3	O95831-1	1590	1593	+	3	O95831-1	0	1839	ENST00000676229.1	223	2050	++	253	O95831-1#76	0	3	ENST00000676229.1	1801	1804	+	3	0	0	1543
O95831-1#76	0	3	3	O95831-1	1590	1593	+	3	O95831-1	0	1839	ENST00000675857.1	82	1915	+	251	O95831-1#76	0	3	ENST00000675857.1	1666	1669	+	3	0	0	1544
O95831-1#76	0	3	3	O95831-1	1590	1593	+	3	O95831-1	0	1839	ENST00000675427.1	89	1925	+	249	O95831-1#76	0	3	ENST00000675427.1	1676	1679	+	3	0	0	1545
O95831-1#76	0	3	3	O95831-1	1590	1593	+	3	O95831-1	0	1839	ENST00000675092.1	90	1956	+	247	O95831-1#76	0	3	ENST00000675092.1	1707	1710	+	3	0	0	1546
O95831-1#76	0	3	3	O95831-1	1590	1593	+	3	O95831-1	0	1839	ENST00000675050.1	71	1898	++	246	O95831-1#76	0	3	ENST00000675050.1	1649	1652	+	3	0	0	1547
O95831-1#76	0	3	3	O95831-1	1590	1593	+	3	O95831-1	1012	1839	ENST00000674601.1	0	686	+	241	O95831-1#76	0	3	ENST00000674601.1	437	440	+	3	0	0	1548
O95831-1#76	0	3	3	O95831-1	1590	1593	+	3	O95831-1	0	1762	ENST00000674546.1	185	1955	+	239	O95831-1#76	0	3	ENST00000674546.1	1783	1786	+	3	0	0	1549
O95831-1#76	0	3	3	O95831-1	1590	1593	+	3	O95831-1	1017	1839	ENST00000460436.6	905	1727	+	105	O95831-1#76	0	3	ENST00000460436.6	1478	1481	+	3	0	0	1550
O95831-1#76	0	3	3	O95831-1	1590	1593	+	3	O95831-1	0	1839	ENST00000346424.6	24	1002	++	34	O95831-1#76	0	3	ENST00000346424.6	753	756	+	3	0	0	1551
O95831-1#76	0	3	3	O95831-1	1590	1593	+	3	O95831-1	0	1839	ENST00000319908.8	174	2007	+	25	O95831-1#76	0	3	ENST00000319908.8	1758	1761	+	3	0	0	1552
O95831-1#76	0	3	3	O95831-1	1590	1593	+	3	O95831-1	0	1839	ENST00000287295.8	185	2024	++	16	O95831-1#76	0	3	ENST00000287295.8	1775	1778	+	3	0	0	1553
O95831-1#77	0	3	3	O95831-1	1596	1599	+	3	O95831-1	0	1839	ENST00000676436.1	34	1861	+	255	O95831-1#77	0	3	ENST00000676436.1	1618	1621	+	3	0	0	1554
O95831-1#77	0	3	3	O95831-1	1596	1599	+	3	O95831-1	0	1839	ENST00000676328.1	56	1892	+	254	O95831-1#77	0	3	ENST00000676328.1	1649	1652	+	3	0	0	1555
O95831-1#77	0	3	3	O95831-1	1596	1599	+	3	O95831-1	0	1839	ENST00000676229.1	223	2050	++	253	O95831-1#77	0	3	ENST00000676229.1	1807	1810	+	3	0	0	1556
O95831-1#77	0	3	3	O95831-1	1596	1599	+	3	O95831-1	0	1839	ENST00000675857.1	82	1915	+	251	O95831-1#77	0	3	ENST00000675857.1	1672	1675	+	3	0	0	1557
O95831-1#77	0	3	3	O95831-1	1596	1599	+	3	O95831-1	0	1839	ENST00000675427.1	89	1925	+	249	O95831-1#77	0	3	ENST00000675427.1	1682	1685	+	3	0	0	1558
O95831-1#77	0	3	3	O95831-1	1596	1599	+	3	O95831-1	0	1839	ENST00000675092.1	90	1956	+	247	O95831-1#77	0	3	ENST00000675092.1	1713	1716	+	3	0	0	1559
O95831-1#77	0	3	3	O95831-1	1596	1599	+	3	O95831-1	0	1839	ENST00000675050.1	71	1898	++	246	O95831-1#77	0	3	ENST00000675050.1	1655	1658	+	3	0	0	1560
O95831-1#77	0	3	3	O95831-1	1596	1599	+	3	O95831-1	1012	1839	ENST00000674601.1	0	686	+	241	O95831-1#77	0	3	ENST00000674601.1	443	446	+	3	0	0	1561
O95831-1#77	0	3	3	O95831-1	1596	1599	+	3	O95831-1	0	1762	ENST00000674546.1	185	1955	+	239	O95831-1#77	0	3	ENST00000674546.1	1789	1792	+	3	0	0	1562
O95831-1#77	0	3	3	O95831-1	1596	1599	+	3	O95831-1	1017	1839	ENST00000460436.6	905	1727	+	105	O95831-1#77	0	3	ENST00000460436.6	1484	1487	+	3	0	0	1563
O95831-1#77	0	3	3	O95831-1	1596	1599	+	3	O95831-1	0	1839	ENST00000346424.6	24	1002	++	34	O95831-1#77	0	3	ENST00000346424.6	759	762	+	3	0	0	1564
O95831-1#77	0	3	3	O95831-1	1596	1599	+	3	O95831-1	0	1839	ENST00000319908.8	174	2007	+	25	O95831-1#77	0	3	ENST00000319908.8	1764	1767	+	3	0	0	1565
O95831-1#77	0	3	3	O95831-1	1596	1599	+	3	O95831-1	0	1839	ENST00000287295.8	185	2024	++	16	O95831-1#77	0	3	ENST00000287295.8	1781	1784	+	3	0	0	1566
O95831-1#78	0	3	3	O95831-1	1602	1605	+	3	O95831-1	0	1839	ENST00000676436.1	34	1861	+	255	O95831-1#78	0	3	ENST00000676436.1	1624	1627	+	3	0	0	1567
O95831-1#78	0	3	3	O95831-1	1602	1605	+	3	O95831-1	0	1839	ENST00000676328.1	56	1892	+	254	O95831-1#78	0	3	ENST00000676328.1	1655	1658	+	3	0	0	1568
O95831-1#78	0	3	3	O95831-1	1602	1605	+	3	O95831-1	0	1839	ENST00000676229.1	223	2050	++	253	O95831-1#78	0	3	ENST00000676229.1	1813	1816	+	3	0	0	1569
O95831-1#78	0	3	3	O95831-1	1602	1605	+	3	O95831-1	0	1839	ENST00000675857.1	82	1915	+	251	O95831-1#78	0	3	ENST00000675857.1	1678	1681	+	3	0	0	1570
O95831-1#78	0	3	3	O95831-1	1602	1605	+	3	O95831-1	0	1839	ENST00000675427.1	89	1925	+	249	O95831-1#78	0	3	ENST00000675427.1	1688	1691	+	3	0	0	1571
O95831-1#78	0	3	3	O95831-1	1602	1605	+	3	O95831-1	0	1839	ENST00000675092.1	90	1956	+	247	O95831-1#78	0	3	ENST00000675092.1	1719	1722	+	3	0	0	1572
O95831-1#78	0	3	3	O95831-1	1602	1605	+	3	O95831-1	0	1839	ENST00000675050.1	71	1898	++	246	O95831-1#78	0	3	ENST00000675050.1	1661	1664	+	3	0	0	1573
O95831-1#78	0	3	3	O95831-1	1602	1605	+	3	O95831-1	1012	1839	ENST00000674601.1	0	686	+	241	O95831-1#78	0	3	ENST00000674601.1	449	452	+	3	0	0	1574
O95831-1#78	0	3	3	O95831-1	1602	1605	+	3	O95831-1	0	1762	ENST00000674546.1	185	1955	+	239	O95831-1#78	0	3	ENST00000674546.1	1795	1798	+	3	0	0	1575
O95831-1#78	0	3	3	O95831-1	1602	1605	+	3	O95831-1	1017	1839	ENST00000460436.6	905	1727	+	105	O95831-1#78	0	3	ENST00000460436.6	1490	1493	+	3	0	0	1576
O95831-1#78	0	3	3	O95831-1	1602	1605	+	3	O95831-1	0	1839	ENST00000346424.6	24	1002	++	34	O95831-1#78	0	3	ENST00000346424.6	765	768	+	3	0	0	1577
O95831-1#78	0	3	3	O95831-1	1602	1605	+	3	O95831-1	0	1839	ENST00000319908.8	174	2007	+	25	O95831-1#78	0	3	ENST00000319908.8	1770	1773	+	3	0	0	1578
O95831-1#78	0	3	3	O95831-1	1602	1605	+	3	O95831-1	0	1839	ENST00000287295.8	185	2024	++	16	O95831-1#78	0	3	ENST00000287295.8	1787	1790	+	3	0	0	1579
O95831-1#79	0	27	27	O95831-1	387	414	+	27	O95831-1	0	1839	ENST00000676436.1	34	1861	+	255	O95831-1#79	0	27	ENST00000676436.1	415	442	+	27	0	0	1580
O95831-1#79	0	27	27	O95831-1	387	414	+	27	O95831-1	0	1839	ENST00000676328.1	56	1892	+	254	O95831-1#79	0	27	ENST00000676328.1	443	470	+	27	0	0	1581
O95831-1#79	0	27	27	O95831-1	387	414	+	27	O95831-1	0	1839	ENST00000676229.1	223	2050	++	253	O95831-1#79	0	27	ENST00000676229.1	598	625	+	27	0	0	1582
O95831-1#79	0	27	27	O95831-1	387	414	+	27	O95831-1	284	409	ENST00000676144.1	0	184	+	252	O95831-1#79	0	22	ENST00000676144.1	162	184	+	22	0	5	1583
O95831-1#79	0	27	27	O95831-1	387	414	+	27	O95831-1	0	1839	ENST00000675857.1	82	1915	+	251	O95831-1#79	0	27	ENST00000675857.1	463	490	+	27	0	0	1584
O95831-1#79	0	27	27	O95831-1	387	414	+	27	O95831-1	0	1839	ENST00000675427.1	89	1925	+	249	O95831-1#79	0	27	ENST00000675427.1	476	503	+	27	0	0	1585
O95831-1#79	0	27	27	O95831-1	387	414	+	27	O95831-1	0	1762	ENST00000675240.1	169	1867	+	248	O95831-1#79	0	27	ENST00000675240.1	556	583	+	27	0	0	1586
O95831-1#79	0	27	27	O95831-1	387	414	+	27	O95831-1	0	1839	ENST00000675092.1	90	1956	+	247	O95831-1#79	0	27	ENST00000675092.1	477	504	+	27	0	0	1587
O95831-1#79	0	27	27	O95831-1	387	414	+	27	O95831-1	0	1839	ENST00000675050.1	71	1898	++	246	O95831-1#79	0	27	ENST00000675050.1	446	473	+	27	0	0	1588
O95831-1#79	0	27	27	O95831-1	387	414	+	27	O95831-1	0	1454	ENST00000675037.1	56	1439	+	245	O95831-1#79	0	27	ENST00000675037.1	443	470	+	27	0	0	1589
O95831-1#79	0	27	27	O95831-1	387	414	+	27	O95831-1	299	1183	ENST00000674957.1	0	880	+	243	O95831-1#79	0	27	ENST00000674957.1	88	115	+	27	0	0	1590
O95831-1#79	0	27	27	O95831-1	387	414	+	27	O95831-1	0	832	ENST00000674722.1	13	760	+	242	O95831-1#79	0	27	ENST00000674722.1	400	427	+	27	0	0	1591
O95831-1#79	0	27	27	O95831-1	387	414	+	27	O95831-1	0	1762	ENST00000674546.1	185	1955	+	239	O95831-1#79	0	27	ENST00000674546.1	572	599	+	27	0	0	1592
O95831-1#79	0	27	27	O95831-1	387	414	+	27	O95831-1	0	966	ENST00000535724.6	8	974	++	156	O95831-1#79	0	27	ENST00000535724.6	395	422	+	27	0	0	1593
O95831-1#79	0	27	27	O95831-1	387	414	+	27	O95831-1	0	1336	ENST00000416073.7	37	1363	+	76	O95831-1#79	0	27	ENST00000416073.7	418	445	+	27	0	0	1594
O95831-1#79	0	27	27	O95831-1	387	414	+	27	O95831-1	0	1839	ENST00000319908.8	174	2007	+	25	O95831-1#79	0	27	ENST00000319908.8	561	588	+	27	0	0	1595
O95831-1#79	0	27	27	O95831-1	387	414	+	27	O95831-1	0	1839	ENST00000287295.8	185	2024	++	16	O95831-1#79	0	27	ENST00000287295.8	572	599	+	27	0	0	1596
O95831-1#80	0	39	39	O95831-1	420	459	+	39	O95831-1	0	1839	ENST00000676436.1	34	1861	+	255	O95831-1#80	0	39	ENST00000676436.1	448	487	+	39	0	0	1597
O95831-1#80	0	39	39	O95831-1	420	459	+	39	O95831-1	0	1839	ENST00000676328.1	56	1892	+	254	O95831-1#80	0	39	ENST00000676328.1	476	515	+	39	0	0	1598
O95831-1#80	0	39	39	O95831-1	420	459	+	39	O95831-1	0	1839	ENST00000676229.1	223	2050	++	253	O95831-1#80	0	39	ENST00000676229.1	631	670	+	39	0	0	1599
O95831-1#80	0	39	39	O95831-1	420	459	+	39	O95831-1	0	1839	ENST00000675857.1	82	1915	+	251	O95831-1#80	0	39	ENST00000675857.1	496	535	+	39	0	0	1600
O95831-1#80	0	39	39	O95831-1	420	459	+	39	O95831-1	0	1839	ENST00000675427.1	89	1925	+	249	O95831-1#80	0	39	ENST00000675427.1	509	548	+	39	0	0	1601
O95831-1#80	0	39	39	O95831-1	420	459	+	39	O95831-1	0	1762	ENST00000675240.1	169	1867	+	248	O95831-1#80	0	39	ENST00000675240.1	589	628	+	39	0	0	1602
O95831-1#80	0	39	39	O95831-1	420	459	+	39	O95831-1	0	1839	ENST00000675092.1	90	1956	+	247	O95831-1#80	0	39	ENST00000675092.1	510	549	+	39	0	0	1603
O95831-1#80	0	39	39	O95831-1	420	459	+	39	O95831-1	0	1839	ENST00000675050.1	71	1898	++	246	O95831-1#80	0	39	ENST00000675050.1	479	518	+	39	0	0	1604
O95831-1#80	0	39	39	O95831-1	420	459	+	39	O95831-1	0	1454	ENST00000675037.1	56	1439	+	245	O95831-1#80	0	39	ENST00000675037.1	476	515	+	39	0	0	1605
O95831-1#80	0	39	39	O95831-1	420	459	+	39	O95831-1	299	1183	ENST00000674957.1	0	880	+	243	O95831-1#80	0	39	ENST00000674957.1	121	160	+	39	0	0	1606
O95831-1#80	0	39	39	O95831-1	420	459	+	39	O95831-1	0	832	ENST00000674722.1	13	760	+	242	O95831-1#80	0	39	ENST00000674722.1	433	472	+	39	0	0	1607
O95831-1#80	0	39	39	O95831-1	420	459	+	39	O95831-1	0	1762	ENST00000674546.1	185	1955	+	239	O95831-1#80	0	39	ENST00000674546.1	605	644	+	39	0	0	1608
O95831-1#80	0	39	39	O95831-1	420	459	+	39	O95831-1	0	966	ENST00000535724.6	8	974	++	156	O95831-1#80	0	39	ENST00000535724.6	428	467	+	39	0	0	1609
O95831-1#80	0	39	39	O95831-1	420	459	+	39	O95831-1	0	1336	ENST00000416073.7	37	1363	+	76	O95831-1#80	0	39	ENST00000416073.7	451	490	+	39	0	0	1610
O95831-1#80	0	39	39	O95831-1	420	459	+	39	O95831-1	0	1839	ENST00000319908.8	174	2007	+	25	O95831-1#80	0	39	ENST00000319908.8	594	633	+	39	0	0	1611
O95831-1#80	0	39	39	O95831-1	420	459	+	39	O95831-1	0	1839	ENST00000287295.8	185	2024	++	16	O95831-1#80	0	39	ENST00000287295.8	605	644	+	39	0	0	1612
O95831-1#81	0	15	15	O95831-1	471	486	+	15	O95831-1	0	1839	ENST00000676436.1	34	1861	+	255	O95831-1#81	0	15	ENST00000676436.1	499	514	+	15	0	0	1613
O95831-1#81	0	15	15	O95831-1	471	486	+	15	O95831-1	0	1839	ENST00000676328.1	56	1892	+	254	O95831-1#81	0	15	ENST00000676328.1	527	542	+	15	0	0	1614
O95831-1#81	0	15	15	O95831-1	471	486	+	15	O95831-1	0	1839	ENST00000676229.1	223	2050	++	253	O95831-1#81	0	15	ENST00000676229.1	682	697	+	15	0	0	1615
O95831-1#81	0	15	15	O95831-1	471	486	+	15	O95831-1	0	1839	ENST00000675857.1	82	1915	+	251	O95831-1#81	0	15	ENST00000675857.1	547	562	+	15	0	0	1616
O95831-1#81	0	15	15	O95831-1	471	486	+	15	O95831-1	0	1839	ENST00000675427.1	89	1925	+	249	O95831-1#81	0	15	ENST00000675427.1	560	575	+	15	0	0	1617
O95831-1#81	0	15	15	O95831-1	471	486	+	15	O95831-1	0	1762	ENST00000675240.1	169	1867	+	248	O95831-1#81	0	15	ENST00000675240.1	640	655	+	15	0	0	1618
O95831-1#81	0	15	15	O95831-1	471	486	+	15	O95831-1	0	1839	ENST00000675092.1	90	1956	+	247	O95831-1#81	0	15	ENST00000675092.1	561	576	+	15	0	0	1619
O95831-1#81	0	15	15	O95831-1	471	486	+	15	O95831-1	0	1839	ENST00000675050.1	71	1898	++	246	O95831-1#81	0	15	ENST00000675050.1	530	545	+	15	0	0	1620
O95831-1#81	0	15	15	O95831-1	471	486	+	15	O95831-1	0	1454	ENST00000675037.1	56	1439	+	245	O95831-1#81	0	15	ENST00000675037.1	527	542	+	15	0	0	1621
O95831-1#81	0	15	15	O95831-1	471	486	+	15	O95831-1	299	1183	ENST00000674957.1	0	880	+	243	O95831-1#81	0	15	ENST00000674957.1	172	187	+	15	0	0	1622
O95831-1#81	0	15	15	O95831-1	471	486	+	15	O95831-1	0	832	ENST00000674722.1	13	760	+	242	O95831-1#81	0	15	ENST00000674722.1	484	499	+	15	0	0	1623
O95831-1#81	0	15	15	O95831-1	471	486	+	15	O95831-1	0	1762	ENST00000674546.1	185	1955	+	239	O95831-1#81	0	15	ENST00000674546.1	656	671	+	15	0	0	1624
O95831-1#81	0	15	15	O95831-1	471	486	+	15	O95831-1	0	966	ENST00000535724.6	8	974	++	156	O95831-1#81	0	15	ENST00000535724.6	479	494	+	15	0	0	1625
O95831-1#81	0	15	15	O95831-1	471	486	+	15	O95831-1	0	1336	ENST00000416073.7	37	1363	+	76	O95831-1#81	0	15	ENST00000416073.7	502	517	+	15	0	0	1626
O95831-1#81	0	15	15	O95831-1	471	486	+	15	O95831-1	0	1839	ENST00000319908.8	174	2007	+	25	O95831-1#81	0	15	ENST00000319908.8	645	660	+	15	0	0	1627
O95831-1#81	0	15	15	O95831-1	471	486	+	15	O95831-1	0	1839	ENST00000287295.8	185	2024	++	16	O95831-1#81	0	15	ENST00000287295.8	656	671	+	15	0	0	1628
O95831-1#82	0	12	12	O95831-1	489	501	+	12	O95831-1	0	1839	ENST00000676436.1	34	1861	+	255	O95831-1#82	0	12	ENST00000676436.1	517	529	+	12	0	0	1629
O95831-1#82	0	12	12	O95831-1	489	501	+	12	O95831-1	0	1839	ENST00000676328.1	56	1892	+	254	O95831-1#82	0	12	ENST00000676328.1	545	557	+	12	0	0	1630
O95831-1#82	0	12	12	O95831-1	489	501	+	12	O95831-1	0	1839	ENST00000676229.1	223	2050	++	253	O95831-1#82	0	12	ENST00000676229.1	700	712	+	12	0	0	1631
O95831-1#82	0	12	12	O95831-1	489	501	+	12	O95831-1	0	1839	ENST00000675857.1	82	1915	+	251	O95831-1#82	0	12	ENST00000675857.1	565	577	+	12	0	0	1632
O95831-1#82	0	12	12	O95831-1	489	501	+	12	O95831-1	0	1839	ENST00000675427.1	89	1925	+	249	O95831-1#82	0	12	ENST00000675427.1	578	590	+	12	0	0	1633
O95831-1#82	0	12	12	O95831-1	489	501	+	12	O95831-1	0	1762	ENST00000675240.1	169	1867	+	248	O95831-1#82	0	12	ENST00000675240.1	658	670	+	12	0	0	1634
O95831-1#82	0	12	12	O95831-1	489	501	+	12	O95831-1	0	1839	ENST00000675092.1	90	1956	+	247	O95831-1#82	0	12	ENST00000675092.1	579	591	+	12	0	0	1635
O95831-1#82	0	12	12	O95831-1	489	501	+	12	O95831-1	0	1839	ENST00000675050.1	71	1898	++	246	O95831-1#82	0	12	ENST00000675050.1	548	560	+	12	0	0	1636
O95831-1#82	0	12	12	O95831-1	489	501	+	12	O95831-1	0	1454	ENST00000675037.1	56	1439	+	245	O95831-1#82	0	12	ENST00000675037.1	545	557	+	12	0	0	1637
O95831-1#82	0	12	12	O95831-1	489	501	+	12	O95831-1	299	1183	ENST00000674957.1	0	880	+	243	O95831-1#82	0	12	ENST00000674957.1	190	202	+	12	0	0	1638
O95831-1#82	0	12	12	O95831-1	489	501	+	12	O95831-1	0	832	ENST00000674722.1	13	760	+	242	O95831-1#82	0	12	ENST00000674722.1	502	514	+	12	0	0	1639
O95831-1#82	0	12	12	O95831-1	489	501	+	12	O95831-1	0	1762	ENST00000674546.1	185	1955	+	239	O95831-1#82	0	12	ENST00000674546.1	674	686	+	12	0	0	1640
O95831-1#82	0	12	12	O95831-1	489	501	+	12	O95831-1	0	966	ENST00000535724.6	8	974	++	156	O95831-1#82	0	12	ENST00000535724.6	497	509	+	12	0	0	1641
O95831-1#82	0	12	12	O95831-1	489	501	+	12	O95831-1	0	1336	ENST00000416073.7	37	1363	+	76	O95831-1#82	0	12	ENST00000416073.7	520	532	+	12	0	0	1642
O95831-1#82	0	12	12	O95831-1	489	501	+	12	O95831-1	0	1839	ENST00000319908.8	174	2007	+	25	O95831-1#82	0	12	ENST00000319908.8	663	675	+	12	0	0	1643
O95831-1#82	0	12	12	O95831-1	489	501	+	12	O95831-1	0	1839	ENST00000287295.8	185	2024	++	16	O95831-1#82	0	12	ENST00000287295.8	674	686	+	12	0	0	1644
O95831-1#83	0	12	12	O95831-1	516	528	+	12	O95831-1	0	1839	ENST00000676436.1	34	1861	+	255	O95831-1#83	0	12	ENST00000676436.1	544	556	+	12	0	0	1645
O95831-1#83	0	12	12	O95831-1	516	528	+	12	O95831-1	0	1839	ENST00000676328.1	56	1892	+	254	O95831-1#83	0	12	ENST00000676328.1	572	584	+	12	0	0	1646
O95831-1#83	0	12	12	O95831-1	516	528	+	12	O95831-1	0	1839	ENST00000676229.1	223	2050	++	253	O95831-1#83	0	12	ENST00000676229.1	727	739	+	12	0	0	1647
O95831-1#83	0	12	12	O95831-1	516	528	+	12	O95831-1	0	1839	ENST00000675857.1	82	1915	+	251	O95831-1#83	0	12	ENST00000675857.1	592	604	+	12	0	0	1648
O95831-1#83	0	12	12	O95831-1	516	528	+	12	O95831-1	0	1839	ENST00000675427.1	89	1925	+	249	O95831-1#83	0	12	ENST00000675427.1	605	617	+	12	0	0	1649
O95831-1#83	0	12	12	O95831-1	516	528	+	12	O95831-1	0	1762	ENST00000675240.1	169	1867	+	248	O95831-1#83	0	12	ENST00000675240.1	685	697	+	12	0	0	1650
O95831-1#83	0	12	12	O95831-1	516	528	+	12	O95831-1	0	1839	ENST00000675092.1	90	1956	+	247	O95831-1#83	0	12	ENST00000675092.1	606	618	+	12	0	0	1651
O95831-1#83	0	12	12	O95831-1	516	528	+	12	O95831-1	0	1839	ENST00000675050.1	71	1898	++	246	O95831-1#83	0	12	ENST00000675050.1	575	587	+	12	0	0	1652
O95831-1#83	0	12	12	O95831-1	516	528	+	12	O95831-1	0	1454	ENST00000675037.1	56	1439	+	245	O95831-1#83	0	12	ENST00000675037.1	572	584	+	12	0	0	1653
O95831-1#83	0	12	12	O95831-1	516	528	+	12	O95831-1	299	1183	ENST00000674957.1	0	880	+	243	O95831-1#83	0	12	ENST00000674957.1	217	229	+	12	0	0	1654
O95831-1#83	0	12	12	O95831-1	516	528	+	12	O95831-1	0	832	ENST00000674722.1	13	760	+	242	O95831-1#83	0	12	ENST00000674722.1	529	541	+	12	0	0	1655
O95831-1#83	0	12	12	O95831-1	516	528	+	12	O95831-1	0	1762	ENST00000674546.1	185	1955	+	239	O95831-1#83	0	12	ENST00000674546.1	701	713	+	12	0	0	1656
O95831-1#83	0	12	12	O95831-1	516	528	+	12	O95831-1	0	966	ENST00000535724.6	8	974	++	156	O95831-1#83	0	12	ENST00000535724.6	524	536	+	12	0	0	1657
O95831-1#83	0	12	12	O95831-1	516	528	+	12	O95831-1	0	1336	ENST00000416073.7	37	1363	+	76	O95831-1#83	0	12	ENST00000416073.7	547	559	+	12	0	0	1658
O95831-1#83	0	12	12	O95831-1	516	528	+	12	O95831-1	0	1839	ENST00000319908.8	174	2007	+	25	O95831-1#83	0	12	ENST00000319908.8	690	702	+	12	0	0	1659
O95831-1#83	0	12	12	O95831-1	516	528	+	12	O95831-1	0	1839	ENST00000287295.8	185	2024	++	16	O95831-1#83	0	12	ENST00000287295.8	701	713	+	12	0	0	1660
O95831-1#84	0	9	9	O95831-1	531	540	+	9	O95831-1	0	1839	ENST00000676436.1	34	1861	+	255	O95831-1#84	0	9	ENST00000676436.1	559	568	+	9	0	0	1661
O95831-1#84	0	9	9	O95831-1	531	540	+	9	O95831-1	0	1839	ENST00000676328.1	56	1892	+	254	O95831-1#84	0	9	ENST00000676328.1	587	596	+	9	0	0	1662
O95831-1#84	0	9	9	O95831-1	531	540	+	9	O95831-1	0	1839	ENST00000676229.1	223	2050	++	253	O95831-1#84	0	9	ENST00000676229.1	742	751	+	9	0	0	1663
O95831-1#84	0	9	9	O95831-1	531	540	+	9	O95831-1	0	1839	ENST00000675857.1	82	1915	+	251	O95831-1#84	0	9	ENST00000675857.1	607	616	+	9	0	0	1664
O95831-1#84	0	9	9	O95831-1	531	540	+	9	O95831-1	0	1839	ENST00000675427.1	89	1925	+	249	O95831-1#84	0	9	ENST00000675427.1	620	629	+	9	0	0	1665
O95831-1#84	0	9	9	O95831-1	531	540	+	9	O95831-1	0	1762	ENST00000675240.1	169	1867	+	248	O95831-1#84	0	9	ENST00000675240.1	700	709	+	9	0	0	1666
O95831-1#84	0	9	9	O95831-1	531	540	+	9	O95831-1	0	1839	ENST00000675092.1	90	1956	+	247	O95831-1#84	0	9	ENST00000675092.1	621	630	+	9	0	0	1667
O95831-1#84	0	9	9	O95831-1	531	540	+	9	O95831-1	0	1839	ENST00000675050.1	71	1898	++	246	O95831-1#84	0	9	ENST00000675050.1	590	599	+	9	0	0	1668
O95831-1#84	0	9	9	O95831-1	531	540	+	9	O95831-1	0	1454	ENST00000675037.1	56	1439	+	245	O95831-1#84	0	9	ENST00000675037.1	587	596	+	9	0	0	1669
O95831-1#84	0	9	9	O95831-1	531	540	+	9	O95831-1	299	1183	ENST00000674957.1	0	880	+	243	O95831-1#84	0	9	ENST00000674957.1	232	241	+	9	0	0	1670
O95831-1#84	0	9	9	O95831-1	531	540	+	9	O95831-1	0	832	ENST00000674722.1	13	760	+	242	O95831-1#84	0	9	ENST00000674722.1	544	553	+	9	0	0	1671
O95831-1#84	0	9	9	O95831-1	531	540	+	9	O95831-1	0	1762	ENST00000674546.1	185	1955	+	239	O95831-1#84	0	9	ENST00000674546.1	716	725	+	9	0	0	1672
O95831-1#84	0	9	9	O95831-1	531	540	+	9	O95831-1	0	966	ENST00000535724.6	8	974	++	156	O95831-1#84	0	9	ENST00000535724.6	539	548	+	9	0	0	1673
O95831-1#84	0	9	9	O95831-1	531	540	+	9	O95831-1	0	1336	ENST00000416073.7	37	1363	+	76	O95831-1#84	0	9	ENST00000416073.7	562	571	+	9	0	0	1674
O95831-1#84	0	9	9	O95831-1	531	540	+	9	O95831-1	0	1839	ENST00000319908.8	174	2007	+	25	O95831-1#84	0	9	ENST00000319908.8	705	714	+	9	0	0	1675
O95831-1#84	0	9	9	O95831-1	531	540	+	9	O95831-1	0	1839	ENST00000287295.8	185	2024	++	16	O95831-1#84	0	9	ENST00000287295.8	716	725	+	9	0	0	1676
O95831-1#85	0	12	12	O95831-1	558	570	+	12	O95831-1	0	1839	ENST00000676436.1	34	1861	+	255	O95831-1#85	0	12	ENST00000676436.1	586	598	+	12	0	0	1677
O95831-1#85	0	12	12	O95831-1	558	570	+	12	O95831-1	0	1839	ENST00000676328.1	56	1892	+	254	O95831-1#85	0	12	ENST00000676328.1	614	626	+	12	0	0	1678
O95831-1#85	0	12	12	O95831-1	558	570	+	12	O95831-1	0	1839	ENST00000676229.1	223	2050	++	253	O95831-1#85	0	12	ENST00000676229.1	769	781	+	12	0	0	1679
O95831-1#85	0	12	12	O95831-1	558	570	+	12	O95831-1	0	1839	ENST00000675857.1	82	1915	+	251	O95831-1#85	0	12	ENST00000675857.1	634	646	+	12	0	0	1680
O95831-1#85	0	12	12	O95831-1	558	570	+	12	O95831-1	0	1839	ENST00000675427.1	89	1925	+	249	O95831-1#85	0	12	ENST00000675427.1	647	659	+	12	0	0	1681
O95831-1#85	0	12	12	O95831-1	558	570	+	12	O95831-1	0	1762	ENST00000675240.1	169	1867	+	248	O95831-1#85	0	12	ENST00000675240.1	727	739	+	12	0	0	1682
O95831-1#85	0	12	12	O95831-1	558	570	+	12	O95831-1	0	1839	ENST00000675092.1	90	1956	+	247	O95831-1#85	0	12	ENST00000675092.1	648	660	+	12	0	0	1683
O95831-1#85	0	12	12	O95831-1	558	570	+	12	O95831-1	0	1839	ENST00000675050.1	71	1898	++	246	O95831-1#85	0	12	ENST00000675050.1	617	629	+	12	0	0	1684
O95831-1#85	0	12	12	O95831-1	558	570	+	12	O95831-1	0	1454	ENST00000675037.1	56	1439	+	245	O95831-1#85	0	12	ENST00000675037.1	614	626	+	12	0	0	1685
O95831-1#85	0	12	12	O95831-1	558	570	+	12	O95831-1	299	1183	ENST00000674957.1	0	880	+	243	O95831-1#85	0	12	ENST00000674957.1	259	271	+	12	0	0	1686
O95831-1#85	0	12	12	O95831-1	558	570	+	12	O95831-1	0	832	ENST00000674722.1	13	760	+	242	O95831-1#85	0	12	ENST00000674722.1	571	583	+	12	0	0	1687
O95831-1#85	0	12	12	O95831-1	558	570	+	12	O95831-1	0	1762	ENST00000674546.1	185	1955	+	239	O95831-1#85	0	12	ENST00000674546.1	743	755	+	12	0	0	1688
O95831-1#85	0	12	12	O95831-1	558	570	+	12	O95831-1	0	966	ENST00000535724.6	8	974	++	156	O95831-1#85	0	12	ENST00000535724.6	566	578	+	12	0	0	1689
O95831-1#85	0	12	12	O95831-1	558	570	+	12	O95831-1	0	1336	ENST00000416073.7	37	1363	+	76	O95831-1#85	0	12	ENST00000416073.7	589	601	+	12	0	0	1690
O95831-1#85	0	12	12	O95831-1	558	570	+	12	O95831-1	0	1839	ENST00000319908.8	174	2007	+	25	O95831-1#85	0	12	ENST00000319908.8	732	744	+	12	0	0	1691
O95831-1#85	0	12	12	O95831-1	558	570	+	12	O95831-1	0	1839	ENST00000287295.8	185	2024	++	16	O95831-1#85	0	12	ENST00000287295.8	743	755	+	12	0	0	1692
O95831-1#86	0	9	9	O95831-1	573	582	+	9	O95831-1	0	1839	ENST00000676436.1	34	1861	+	255	O95831-1#86	0	9	ENST00000676436.1	601	610	+	9	0	0	1693
O95831-1#86	0	9	9	O95831-1	573	582	+	9	O95831-1	0	1839	ENST00000676328.1	56	1892	+	254	O95831-1#86	0	9	ENST00000676328.1	629	638	+	9	0	0	1694
O95831-1#86	0	9	9	O95831-1	573	582	+	9	O95831-1	0	1839	ENST00000676229.1	223	2050	++	253	O95831-1#86	0	9	ENST00000676229.1	784	793	+	9	0	0	1695
O95831-1#86	0	9	9	O95831-1	573	582	+	9	O95831-1	0	1839	ENST00000675857.1	82	1915	+	251	O95831-1#86	0	9	ENST00000675857.1	649	658	+	9	0	0	1696
O95831-1#86	0	9	9	O95831-1	573	582	+	9	O95831-1	0	1839	ENST00000675427.1	89	1925	+	249	O95831-1#86	0	9	ENST00000675427.1	662	671	+	9	0	0	1697
O95831-1#86	0	9	9	O95831-1	573	582	+	9	O95831-1	0	1762	ENST00000675240.1	169	1867	+	248	O95831-1#86	0	9	ENST00000675240.1	742	751	+	9	0	0	1698
O95831-1#86	0	9	9	O95831-1	573	582	+	9	O95831-1	0	1839	ENST00000675092.1	90	1956	+	247	O95831-1#86	0	9	ENST00000675092.1	663	672	+	9	0	0	1699
O95831-1#86	0	9	9	O95831-1	573	582	+	9	O95831-1	0	1839	ENST00000675050.1	71	1898	++	246	O95831-1#86	0	9	ENST00000675050.1	632	641	+	9	0	0	1700
O95831-1#86	0	9	9	O95831-1	573	582	+	9	O95831-1	0	1454	ENST00000675037.1	56	1439	+	245	O95831-1#86	0	9	ENST00000675037.1	629	638	+	9	0	0	1701
O95831-1#86	0	9	9	O95831-1	573	582	+	9	O95831-1	299	1183	ENST00000674957.1	0	880	+	243	O95831-1#86	0	9	ENST00000674957.1	274	283	+	9	0	0	1702
O95831-1#86	0	9	9	O95831-1	573	582	+	9	O95831-1	0	832	ENST00000674722.1	13	760	+	242	O95831-1#86	0	9	ENST00000674722.1	586	595	+	9	0	0	1703
O95831-1#86	0	9	9	O95831-1	573	582	+	9	O95831-1	0	1762	ENST00000674546.1	185	1955	+	239	O95831-1#86	0	9	ENST00000674546.1	758	767	+	9	0	0	1704
O95831-1#86	0	9	9	O95831-1	573	582	+	9	O95831-1	0	966	ENST00000535724.6	8	974	++	156	O95831-1#86	0	9	ENST00000535724.6	581	590	+	9	0	0	1705
O95831-1#86	0	9	9	O95831-1	573	582	+	9	O95831-1	0	1336	ENST00000416073.7	37	1363	+	76	O95831-1#86	0	9	ENST00000416073.7	604	613	+	9	0	0	1706
O95831-1#86	0	9	9	O95831-1	573	582	+	9	O95831-1	0	1839	ENST00000319908.8	174	2007	+	25	O95831-1#86	0	9	ENST00000319908.8	747	756	+	9	0	0	1707
O95831-1#86	0	9	9	O95831-1	573	582	+	9	O95831-1	0	1839	ENST00000287295.8	185	2024	++	16	O95831-1#86	0	9	ENST00000287295.8	758	767	+	9	0	0	1708
O95831-1#87	0	21	21	O95831-1	597	618	+	21	O95831-1	0	1839	ENST00000676436.1	34	1861	+	255	O95831-1#87	0	21	ENST00000676436.1	625	646	+	21	0	0	1709
O95831-1#87	0	21	21	O95831-1	597	618	+	21	O95831-1	0	1839	ENST00000676328.1	56	1892	+	254	O95831-1#87	0	21	ENST00000676328.1	653	674	+	21	0	0	1710
O95831-1#87	0	21	21	O95831-1	597	618	+	21	O95831-1	0	1839	ENST00000676229.1	223	2050	++	253	O95831-1#87	0	21	ENST00000676229.1	808	829	+	21	0	0	1711
O95831-1#87	0	21	21	O95831-1	597	618	+	21	O95831-1	0	1839	ENST00000675857.1	82	1915	+	251	O95831-1#87	0	21	ENST00000675857.1	673	694	+	21	0	0	1712
O95831-1#87	0	21	21	O95831-1	597	618	+	21	O95831-1	0	1839	ENST00000675427.1	89	1925	+	249	O95831-1#87	0	21	ENST00000675427.1	686	707	+	21	0	0	1713
O95831-1#87	0	21	21	O95831-1	597	618	+	21	O95831-1	0	1762	ENST00000675240.1	169	1867	+	248	O95831-1#87	0	21	ENST00000675240.1	766	787	+	21	0	0	1714
O95831-1#87	0	21	21	O95831-1	597	618	+	21	O95831-1	0	1839	ENST00000675092.1	90	1956	+	247	O95831-1#87	0	21	ENST00000675092.1	687	708	+	21	0	0	1715
O95831-1#87	0	21	21	O95831-1	597	618	+	21	O95831-1	0	1839	ENST00000675050.1	71	1898	++	246	O95831-1#87	0	21	ENST00000675050.1	656	677	+	21	0	0	1716
O95831-1#87	0	21	21	O95831-1	597	618	+	21	O95831-1	0	1454	ENST00000675037.1	56	1439	+	245	O95831-1#87	0	21	ENST00000675037.1	653	674	+	21	0	0	1717
O95831-1#87	0	21	21	O95831-1	597	618	+	21	O95831-1	299	1183	ENST00000674957.1	0	880	+	243	O95831-1#87	0	21	ENST00000674957.1	298	319	+	21	0	0	1718
O95831-1#87	0	21	21	O95831-1	597	618	+	21	O95831-1	0	832	ENST00000674722.1	13	760	+	242	O95831-1#87	0	21	ENST00000674722.1	610	631	+	21	0	0	1719
O95831-1#87	0	21	21	O95831-1	597	618	+	21	O95831-1	0	1762	ENST00000674546.1	185	1955	+	239	O95831-1#87	0	21	ENST00000674546.1	782	803	+	21	0	0	1720
O95831-1#87	0	21	21	O95831-1	597	618	+	21	O95831-1	0	966	ENST00000535724.6	8	974	++	156	O95831-1#87	0	21	ENST00000535724.6	605	626	+	21	0	0	1721
O95831-1#87	0	21	21	O95831-1	597	618	+	21	O95831-1	0	1336	ENST00000416073.7	37	1363	+	76	O95831-1#87	0	21	ENST00000416073.7	628	649	+	21	0	0	1722
O95831-1#87	0	21	21	O95831-1	597	618	+	21	O95831-1	0	1839	ENST00000319908.8	174	2007	+	25	O95831-1#87	0	21	ENST00000319908.8	771	792	+	21	0	0	1723
O95831-1#87	0	21	21	O95831-1	597	618	+	21	O95831-1	0	1839	ENST00000287295.8	185	2024	++	16	O95831-1#87	0	21	ENST00000287295.8	782	803	+	21	0	0	1724
O95831-1#88	0	9	9	O95831-1	621	630	+	9	O95831-1	0	1839	ENST00000676436.1	34	1861	+	255	O95831-1#88	0	9	ENST00000676436.1	649	658	+	9	0	0	1725
O95831-1#88	0	9	9	O95831-1	621	630	+	9	O95831-1	0	1839	ENST00000676328.1	56	1892	+	254	O95831-1#88	0	9	ENST00000676328.1	677	686	+	9	0	0	1726
O95831-1#88	0	9	9	O95831-1	621	630	+	9	O95831-1	0	1839	ENST00000676229.1	223	2050	++	253	O95831-1#88	0	9	ENST00000676229.1	832	841	+	9	0	0	1727
O95831-1#88	0	9	9	O95831-1	621	630	+	9	O95831-1	0	1839	ENST00000675857.1	82	1915	+	251	O95831-1#88	0	9	ENST00000675857.1	697	706	+	9	0	0	1728
O95831-1#88	0	9	9	O95831-1	621	630	+	9	O95831-1	0	1839	ENST00000675427.1	89	1925	+	249	O95831-1#88	0	9	ENST00000675427.1	710	719	+	9	0	0	1729
O95831-1#88	0	9	9	O95831-1	621	630	+	9	O95831-1	0	1762	ENST00000675240.1	169	1867	+	248	O95831-1#88	0	9	ENST00000675240.1	790	799	+	9	0	0	1730
O95831-1#88	0	9	9	O95831-1	621	630	+	9	O95831-1	0	1839	ENST00000675092.1	90	1956	+	247	O95831-1#88	0	9	ENST00000675092.1	711	720	+	9	0	0	1731
O95831-1#88	0	9	9	O95831-1	621	630	+	9	O95831-1	0	1839	ENST00000675050.1	71	1898	++	246	O95831-1#88	0	9	ENST00000675050.1	680	689	+	9	0	0	1732
O95831-1#88	0	9	9	O95831-1	621	630	+	9	O95831-1	0	1454	ENST00000675037.1	56	1439	+	245	O95831-1#88	0	9	ENST00000675037.1	677	686	+	9	0	0	1733
O95831-1#88	0	9	9	O95831-1	621	630	+	9	O95831-1	299	1183	ENST00000674957.1	0	880	+	243	O95831-1#88	0	9	ENST00000674957.1	322	331	+	9	0	0	1734
O95831-1#88	0	9	9	O95831-1	621	630	+	9	O95831-1	0	832	ENST00000674722.1	13	760	+	242	O95831-1#88	0	9	ENST00000674722.1	634	643	+	9	0	0	1735
O95831-1#88	0	9	9	O95831-1	621	630	+	9	O95831-1	0	1762	ENST00000674546.1	185	1955	+	239	O95831-1#88	0	9	ENST00000674546.1	806	815	+	9	0	0	1736
O95831-1#88	0	9	9	O95831-1	621	630	+	9	O95831-1	0	966	ENST00000535724.6	8	974	++	156	O95831-1#88	0	9	ENST00000535724.6	629	638	+	9	0	0	1737
O95831-1#88	0	9	9	O95831-1	621	630	+	9	O95831-1	0	1336	ENST00000416073.7	37	1363	+	76	O95831-1#88	0	9	ENST00000416073.7	652	661	+	9	0	0	1738
O95831-1#88	0	9	9	O95831-1	621	630	+	9	O95831-1	0	1839	ENST00000319908.8	174	2007	+	25	O95831-1#88	0	9	ENST00000319908.8	795	804	+	9	0	0	1739
O95831-1#88	0	9	9	O95831-1	621	630	+	9	O95831-1	0	1839	ENST00000287295.8	185	2024	++	16	O95831-1#88	0	9	ENST00000287295.8	806	815	+	9	0	0	1740
O95831-1#89	0	18	18	O95831-1	639	657	+	18	O95831-1	0	1839	ENST00000676436.1	34	1861	+	255	O95831-1#89	0	18	ENST00000676436.1	667	685	+	18	0	0	1741
O95831-1#89	0	18	18	O95831-1	639	657	+	18	O95831-1	0	1839	ENST00000676328.1	56	1892	+	254	O95831-1#89	0	18	ENST00000676328.1	695	713	+	18	0	0	1742
O95831-1#89	0	18	18	O95831-1	639	657	+	18	O95831-1	0	1839	ENST00000676229.1	223	2050	++	253	O95831-1#89	0	18	ENST00000676229.1	850	868	+	18	0	0	1743
O95831-1#89	0	18	18	O95831-1	639	657	+	18	O95831-1	0	1839	ENST00000675857.1	82	1915	+	251	O95831-1#89	0	18	ENST00000675857.1	715	733	+	18	0	0	1744
O95831-1#89	0	18	18	O95831-1	639	657	+	18	O95831-1	0	1839	ENST00000675427.1	89	1925	+	249	O95831-1#89	0	18	ENST00000675427.1	728	746	+	18	0	0	1745
O95831-1#89	0	18	18	O95831-1	639	657	+	18	O95831-1	0	1762	ENST00000675240.1	169	1867	+	248	O95831-1#89	0	18	ENST00000675240.1	808	826	+	18	0	0	1746
O95831-1#89	0	18	18	O95831-1	639	657	+	18	O95831-1	0	1839	ENST00000675092.1	90	1956	+	247	O95831-1#89	0	18	ENST00000675092.1	729	747	+	18	0	0	1747
O95831-1#89	0	18	18	O95831-1	639	657	+	18	O95831-1	0	1839	ENST00000675050.1	71	1898	++	246	O95831-1#89	0	18	ENST00000675050.1	698	716	+	18	0	0	1748
O95831-1#89	0	18	18	O95831-1	639	657	+	18	O95831-1	0	1454	ENST00000675037.1	56	1439	+	245	O95831-1#89	0	18	ENST00000675037.1	695	713	+	18	0	0	1749
O95831-1#89	0	18	18	O95831-1	639	657	+	18	O95831-1	299	1183	ENST00000674957.1	0	880	+	243	O95831-1#89	0	18	ENST00000674957.1	340	358	+	18	0	0	1750
O95831-1#89	0	18	18	O95831-1	639	657	+	18	O95831-1	0	832	ENST00000674722.1	13	760	+	242	O95831-1#89	0	18	ENST00000674722.1	652	670	+	18	0	0	1751
O95831-1#89	0	18	18	O95831-1	639	657	+	18	O95831-1	0	1762	ENST00000674546.1	185	1955	+	239	O95831-1#89	0	18	ENST00000674546.1	824	842	+	18	0	0	1752
O95831-1#89	0	18	18	O95831-1	639	657	+	18	O95831-1	0	966	ENST00000535724.6	8	974	++	156	O95831-1#89	0	18	ENST00000535724.6	647	665	+	18	0	0	1753
O95831-1#89	0	18	18	O95831-1	639	657	+	18	O95831-1	0	1336	ENST00000416073.7	37	1363	+	76	O95831-1#89	0	18	ENST00000416073.7	670	688	+	18	0	0	1754
O95831-1#89	0	18	18	O95831-1	639	657	+	18	O95831-1	0	1839	ENST00000319908.8	174	2007	+	25	O95831-1#89	0	18	ENST00000319908.8	813	831	+	18	0	0	1755
O95831-1#89	0	18	18	O95831-1	639	657	+	18	O95831-1	0	1839	ENST00000287295.8	185	2024	++	16	O95831-1#89	0	18	ENST00000287295.8	824	842	+	18	0	0	1756
O95831-1#90	0	15	15	O95831-1	669	684	+	15	O95831-1	0	1839	ENST00000676436.1	34	1861	+	255	O95831-1#90	0	15	ENST00000676436.1	697	712	+	15	0	0	1757
O95831-1#90	0	15	15	O95831-1	669	684	+	15	O95831-1	0	1839	ENST00000676328.1	56	1892	+	254	O95831-1#90	0	15	ENST00000676328.1	725	740	+	15	0	0	1758
O95831-1#90	0	15	15	O95831-1	669	684	+	15	O95831-1	0	1839	ENST00000676229.1	223	2050	++	253	O95831-1#90	0	15	ENST00000676229.1	880	895	+	15	0	0	1759
O95831-1#90	0	15	15	O95831-1	669	684	+	15	O95831-1	0	1839	ENST00000675857.1	82	1915	+	251	O95831-1#90	0	15	ENST00000675857.1	745	760	+	15	0	0	1760
O95831-1#90	0	15	15	O95831-1	669	684	+	15	O95831-1	0	1839	ENST00000675427.1	89	1925	+	249	O95831-1#90	0	15	ENST00000675427.1	758	773	+	15	0	0	1761
O95831-1#90	0	15	15	O95831-1	669	684	+	15	O95831-1	0	1762	ENST00000675240.1	169	1867	+	248	O95831-1#90	0	15	ENST00000675240.1	838	853	+	15	0	0	1762
O95831-1#90	0	15	15	O95831-1	669	684	+	15	O95831-1	0	1839	ENST00000675092.1	90	1956	+	247	O95831-1#90	0	15	ENST00000675092.1	759	774	+	15	0	0	1763
O95831-1#90	0	15	15	O95831-1	669	684	+	15	O95831-1	0	1839	ENST00000675050.1	71	1898	++	246	O95831-1#90	0	15	ENST00000675050.1	728	743	+	15	0	0	1764
O95831-1#90	0	15	15	O95831-1	669	684	+	15	O95831-1	0	1454	ENST00000675037.1	56	1439	+	245	O95831-1#90	0	15	ENST00000675037.1	725	740	+	15	0	0	1765
O95831-1#90	0	15	15	O95831-1	669	684	+	15	O95831-1	299	1183	ENST00000674957.1	0	880	+	243	O95831-1#90	0	15	ENST00000674957.1	370	385	+	15	0	0	1766
O95831-1#90	0	15	15	O95831-1	669	684	+	15	O95831-1	0	832	ENST00000674722.1	13	760	+	242	O95831-1#90	0	15	ENST00000674722.1	682	697	+	15	0	0	1767
O95831-1#90	0	15	15	O95831-1	669	684	+	15	O95831-1	0	1762	ENST00000674546.1	185	1955	+	239	O95831-1#90	0	15	ENST00000674546.1	854	869	+	15	0	0	1768
O95831-1#90	0	15	15	O95831-1	669	684	+	15	O95831-1	0	966	ENST00000535724.6	8	974	++	156	O95831-1#90	0	15	ENST00000535724.6	677	692	+	15	0	0	1769
O95831-1#90	0	15	15	O95831-1	669	684	+	15	O95831-1	0	1336	ENST00000416073.7	37	1363	+	76	O95831-1#90	0	15	ENST00000416073.7	700	715	+	15	0	0	1770
O95831-1#90	0	15	15	O95831-1	669	684	+	15	O95831-1	0	1839	ENST00000319908.8	174	2007	+	25	O95831-1#90	0	15	ENST00000319908.8	843	858	+	15	0	0	1771
O95831-1#90	0	15	15	O95831-1	669	684	+	15	O95831-1	0	1839	ENST00000287295.8	185	2024	++	16	O95831-1#90	0	15	ENST00000287295.8	854	869	+	15	0	0	1772
O95831-1#91	0	15	15	O95831-1	696	711	+	15	O95831-1	0	1839	ENST00000676436.1	34	1861	+	255	O95831-1#91	0	15	ENST00000676436.1	724	739	+	15	0	0	1773
O95831-1#91	0	15	15	O95831-1	696	711	+	15	O95831-1	0	1839	ENST00000676328.1	56	1892	+	254	O95831-1#91	0	15	ENST00000676328.1	752	767	+	15	0	0	1774
O95831-1#91	0	15	15	O95831-1	696	711	+	15	O95831-1	0	1839	ENST00000676229.1	223	2050	++	253	O95831-1#91	0	15	ENST00000676229.1	907	922	+	15	0	0	1775
O95831-1#91	0	15	15	O95831-1	696	711	+	15	O95831-1	0	1839	ENST00000675857.1	82	1915	+	251	O95831-1#91	0	15	ENST00000675857.1	772	787	+	15	0	0	1776
O95831-1#91	0	15	15	O95831-1	696	711	+	15	O95831-1	0	1839	ENST00000675427.1	89	1925	+	249	O95831-1#91	0	15	ENST00000675427.1	785	800	+	15	0	0	1777
O95831-1#91	0	15	15	O95831-1	696	711	+	15	O95831-1	0	1762	ENST00000675240.1	169	1867	+	248	O95831-1#91	0	15	ENST00000675240.1	865	880	+	15	0	0	1778
O95831-1#91	0	15	15	O95831-1	696	711	+	15	O95831-1	0	1839	ENST00000675092.1	90	1956	+	247	O95831-1#91	0	15	ENST00000675092.1	786	801	+	15	0	0	1779
O95831-1#91	0	15	15	O95831-1	696	711	+	15	O95831-1	0	1839	ENST00000675050.1	71	1898	++	246	O95831-1#91	0	15	ENST00000675050.1	755	770	+	15	0	0	1780
O95831-1#91	0	15	15	O95831-1	696	711	+	15	O95831-1	0	1454	ENST00000675037.1	56	1439	+	245	O95831-1#91	0	15	ENST00000675037.1	752	767	+	15	0	0	1781
O95831-1#91	0	15	15	O95831-1	696	711	+	15	O95831-1	299	1183	ENST00000674957.1	0	880	+	243	O95831-1#91	0	15	ENST00000674957.1	397	412	+	15	0	0	1782
O95831-1#91	0	15	15	O95831-1	696	711	+	15	O95831-1	0	1762	ENST00000674546.1	185	1955	+	239	O95831-1#91	0	15	ENST00000674546.1	881	896	+	15	0	0	1783
O95831-1#91	0	15	15	O95831-1	696	711	+	15	O95831-1	0	966	ENST00000535724.6	8	974	++	156	O95831-1#91	0	15	ENST00000535724.6	704	719	+	15	0	0	1784
O95831-1#91	0	15	15	O95831-1	696	711	+	15	O95831-1	0	1336	ENST00000416073.7	37	1363	+	76	O95831-1#91	0	15	ENST00000416073.7	727	742	+	15	0	0	1785
O95831-1#91	0	15	15	O95831-1	696	711	+	15	O95831-1	0	1839	ENST00000319908.8	174	2007	+	25	O95831-1#91	0	15	ENST00000319908.8	870	885	+	15	0	0	1786
O95831-1#91	0	15	15	O95831-1	696	711	+	15	O95831-1	0	1839	ENST00000287295.8	185	2024	++	16	O95831-1#91	0	15	ENST00000287295.8	881	896	+	15	0	0	1787
O95831-1#92	0	12	12	O95831-1	711	723	+	12	O95831-1	0	1839	ENST00000676436.1	34	1861	+	255	O95831-1#92	0	12	ENST00000676436.1	739	751	+	12	0	0	1788
O95831-1#92	0	12	12	O95831-1	711	723	+	12	O95831-1	0	1839	ENST00000676328.1	56	1892	+	254	O95831-1#92	0	12	ENST00000676328.1	767	779	+	12	0	0	1789
O95831-1#92	0	12	12	O95831-1	711	723	+	12	O95831-1	0	1839	ENST00000676229.1	223	2050	++	253	O95831-1#92	0	12	ENST00000676229.1	922	934	+	12	0	0	1790
O95831-1#92	0	12	12	O95831-1	711	723	+	12	O95831-1	0	1839	ENST00000675857.1	82	1915	+	251	O95831-1#92	0	12	ENST00000675857.1	787	799	+	12	0	0	1791
O95831-1#92	0	12	12	O95831-1	711	723	+	12	O95831-1	0	1839	ENST00000675427.1	89	1925	+	249	O95831-1#92	0	12	ENST00000675427.1	800	812	+	12	0	0	1792
O95831-1#92	0	12	12	O95831-1	711	723	+	12	O95831-1	0	1762	ENST00000675240.1	169	1867	+	248	O95831-1#92	0	12	ENST00000675240.1	880	892	+	12	0	0	1793
O95831-1#92	0	12	12	O95831-1	711	723	+	12	O95831-1	0	1839	ENST00000675092.1	90	1956	+	247	O95831-1#92	0	12	ENST00000675092.1	801	813	+	12	0	0	1794
O95831-1#92	0	12	12	O95831-1	711	723	+	12	O95831-1	0	1839	ENST00000675050.1	71	1898	++	246	O95831-1#92	0	12	ENST00000675050.1	770	782	+	12	0	0	1795
O95831-1#92	0	12	12	O95831-1	711	723	+	12	O95831-1	0	1454	ENST00000675037.1	56	1439	+	245	O95831-1#92	0	12	ENST00000675037.1	767	779	+	12	0	0	1796
O95831-1#92	0	12	12	O95831-1	711	723	+	12	O95831-1	299	1183	ENST00000674957.1	0	880	+	243	O95831-1#92	0	12	ENST00000674957.1	412	424	+	12	0	0	1797
O95831-1#92	0	12	12	O95831-1	711	723	+	12	O95831-1	0	1762	ENST00000674546.1	185	1955	+	239	O95831-1#92	0	12	ENST00000674546.1	896	908	+	12	0	0	1798
O95831-1#92	0	12	12	O95831-1	711	723	+	12	O95831-1	0	966	ENST00000535724.6	8	974	++	156	O95831-1#92	0	12	ENST00000535724.6	719	731	+	12	0	0	1799
O95831-1#92	0	12	12	O95831-1	711	723	+	12	O95831-1	0	1336	ENST00000416073.7	37	1363	+	76	O95831-1#92	0	12	ENST00000416073.7	742	754	+	12	0	0	1800
O95831-1#92	0	12	12	O95831-1	711	723	+	12	O95831-1	0	1839	ENST00000319908.8	174	2007	+	25	O95831-1#92	0	12	ENST00000319908.8	885	897	+	12	0	0	1801
O95831-1#92	0	12	12	O95831-1	711	723	+	12	O95831-1	0	1839	ENST00000287295.8	185	2024	++	16	O95831-1#92	0	12	ENST00000287295.8	896	908	+	12	0	0	1802
O95831-1#93	0	12	12	O95831-1	723	735	+	12	O95831-1	0	1839	ENST00000676436.1	34	1861	+	255	O95831-1#93	0	12	ENST00000676436.1	751	763	+	12	0	0	1803
O95831-1#93	0	12	12	O95831-1	723	735	+	12	O95831-1	0	1839	ENST00000676328.1	56	1892	+	254	O95831-1#93	0	12	ENST00000676328.1	779	791	+	12	0	0	1804
O95831-1#93	0	12	12	O95831-1	723	735	+	12	O95831-1	0	1839	ENST00000676229.1	223	2050	++	253	O95831-1#93	0	12	ENST00000676229.1	934	946	+	12	0	0	1805
O95831-1#93	0	12	12	O95831-1	723	735	+	12	O95831-1	0	1839	ENST00000675857.1	82	1915	+	251	O95831-1#93	0	12	ENST00000675857.1	799	811	+	12	0	0	1806
O95831-1#93	0	12	12	O95831-1	723	735	+	12	O95831-1	0	1839	ENST00000675427.1	89	1925	+	249	O95831-1#93	0	12	ENST00000675427.1	812	824	+	12	0	0	1807
O95831-1#93	0	12	12	O95831-1	723	735	+	12	O95831-1	0	1762	ENST00000675240.1	169	1867	+	248	O95831-1#93	0	12	ENST00000675240.1	892	904	+	12	0	0	1808
O95831-1#93	0	12	12	O95831-1	723	735	+	12	O95831-1	0	1839	ENST00000675092.1	90	1956	+	247	O95831-1#93	0	12	ENST00000675092.1	813	825	+	12	0	0	1809
O95831-1#93	0	12	12	O95831-1	723	735	+	12	O95831-1	0	1839	ENST00000675050.1	71	1898	++	246	O95831-1#93	0	12	ENST00000675050.1	782	794	+	12	0	0	1810
O95831-1#93	0	12	12	O95831-1	723	735	+	12	O95831-1	0	1454	ENST00000675037.1	56	1439	+	245	O95831-1#93	0	12	ENST00000675037.1	779	791	+	12	0	0	1811
O95831-1#93	0	12	12	O95831-1	723	735	+	12	O95831-1	299	1183	ENST00000674957.1	0	880	+	243	O95831-1#93	0	12	ENST00000674957.1	424	436	+	12	0	0	1812
O95831-1#93	0	12	12	O95831-1	723	735	+	12	O95831-1	0	1762	ENST00000674546.1	185	1955	+	239	O95831-1#93	0	12	ENST00000674546.1	908	920	+	12	0	0	1813
O95831-1#93	0	12	12	O95831-1	723	735	+	12	O95831-1	0	966	ENST00000535724.6	8	974	++	156	O95831-1#93	0	12	ENST00000535724.6	731	743	+	12	0	0	1814
O95831-1#93	0	12	12	O95831-1	723	735	+	12	O95831-1	0	1336	ENST00000416073.7	37	1363	+	76	O95831-1#93	0	12	ENST00000416073.7	754	766	+	12	0	0	1815
O95831-1#93	0	12	12	O95831-1	723	735	+	12	O95831-1	0	1839	ENST00000319908.8	174	2007	+	25	O95831-1#93	0	12	ENST00000319908.8	897	909	+	12	0	0	1816
O95831-1#93	0	12	12	O95831-1	723	735	+	12	O95831-1	0	1839	ENST00000287295.8	185	2024	++	16	O95831-1#93	0	12	ENST00000287295.8	908	920	+	12	0	0	1817
O95831-1#94	0	27	27	O95831-1	747	774	+	27	O95831-1	0	1839	ENST00000676436.1	34	1861	+	255	O95831-1#94	0	27	ENST00000676436.1	775	802	+	27	0	0	1818
O95831-1#94	0	27	27	O95831-1	747	774	+	27	O95831-1	0	1839	ENST00000676328.1	56	1892	+	254	O95831-1#94	0	27	ENST00000676328.1	803	830	+	27	0	0	1819
O95831-1#94	0	27	27	O95831-1	747	774	+	27	O95831-1	0	1839	ENST00000676229.1	223	2050	++	253	O95831-1#94	0	27	ENST00000676229.1	958	985	+	27	0	0	1820
O95831-1#94	0	27	27	O95831-1	747	774	+	27	O95831-1	0	1839	ENST00000675857.1	82	1915	+	251	O95831-1#94	0	27	ENST00000675857.1	823	850	+	27	0	0	1821
O95831-1#94	0	27	27	O95831-1	747	774	+	27	O95831-1	0	1839	ENST00000675427.1	89	1925	+	249	O95831-1#94	0	27	ENST00000675427.1	836	863	+	27	0	0	1822
O95831-1#94	0	27	27	O95831-1	747	774	+	27	O95831-1	0	1762	ENST00000675240.1	169	1867	+	248	O95831-1#94	0	27	ENST00000675240.1	916	943	+	27	0	0	1823
O95831-1#94	0	27	27	O95831-1	747	774	+	27	O95831-1	0	1839	ENST00000675092.1	90	1956	+	247	O95831-1#94	0	27	ENST00000675092.1	837	864	+	27	0	0	1824
O95831-1#94	0	27	27	O95831-1	747	774	+	27	O95831-1	0	1839	ENST00000675050.1	71	1898	++	246	O95831-1#94	0	27	ENST00000675050.1	806	833	+	27	0	0	1825
O95831-1#94	0	27	27	O95831-1	747	774	+	27	O95831-1	0	1454	ENST00000675037.1	56	1439	+	245	O95831-1#94	0	27	ENST00000675037.1	803	830	+	27	0	0	1826
O95831-1#94	0	27	27	O95831-1	747	774	+	27	O95831-1	299	1183	ENST00000674957.1	0	880	+	243	O95831-1#94	0	27	ENST00000674957.1	448	475	+	27	0	0	1827
O95831-1#94	0	27	27	O95831-1	747	774	+	27	O95831-1	0	1762	ENST00000674546.1	185	1955	+	239	O95831-1#94	0	27	ENST00000674546.1	932	959	+	27	0	0	1828
O95831-1#94	0	27	27	O95831-1	747	774	+	27	O95831-1	0	966	ENST00000535724.6	8	974	++	156	O95831-1#94	0	27	ENST00000535724.6	755	782	+	27	0	0	1829
O95831-1#94	0	27	27	O95831-1	747	774	+	27	O95831-1	0	1336	ENST00000416073.7	37	1363	+	76	O95831-1#94	0	27	ENST00000416073.7	778	805	+	27	0	0	1830
O95831-1#94	0	27	27	O95831-1	747	774	+	27	O95831-1	0	1839	ENST00000319908.8	174	2007	+	25	O95831-1#94	0	27	ENST00000319908.8	921	948	+	27	0	0	1831
O95831-1#94	0	27	27	O95831-1	747	774	+	27	O95831-1	0	1839	ENST00000287295.8	185	2024	++	16	O95831-1#94	0	27	ENST00000287295.8	932	959	+	27	0	0	1832
O95831-1#95	0	9	9	O95831-1	783	792	+	9	O95831-1	0	1839	ENST00000676436.1	34	1861	+	255	O95831-1#95	0	9	ENST00000676436.1	811	820	+	9	0	0	1833
O95831-1#95	0	9	9	O95831-1	783	792	+	9	O95831-1	0	1839	ENST00000676328.1	56	1892	+	254	O95831-1#95	1	9	ENST00000676328.1	837	845	+	8	1	0	1834
O95831-1#95	0	9	9	O95831-1	783	792	+	9	O95831-1	0	1839	ENST00000676229.1	223	2050	++	253	O95831-1#95	0	9	ENST00000676229.1	994	1003	+	9	0	0	1835
O95831-1#95	0	9	9	O95831-1	783	792	+	9	O95831-1	0	1839	ENST00000675857.1	82	1915	+	251	O95831-1#95	0	9	ENST00000675857.1	859	868	+	9	0	0	1836
O95831-1#95	0	9	9	O95831-1	783	792	+	9	O95831-1	0	1839	ENST00000675427.1	89	1925	+	249	O95831-1#95	0	9	ENST00000675427.1	872	881	+	9	0	0	1837
O95831-1#95	0	9	9	O95831-1	783	792	+	9	O95831-1	0	1762	ENST00000675240.1	169	1867	+	248	O95831-1#95	0	9	ENST00000675240.1	952	961	+	9	0	0	1838
O95831-1#95	0	9	9	O95831-1	783	792	+	9	O95831-1	0	1839	ENST00000675092.1	90	1956	+	247	O95831-1#95	0	9	ENST00000675092.1	873	882	+	9	0	0	1839
O95831-1#95	0	9	9	O95831-1	783	792	+	9	O95831-1	0	1839	ENST00000675050.1	71	1898	++	246	O95831-1#95	0	9	ENST00000675050.1	842	851	+	9	0	0	1840
O95831-1#95	0	9	9	O95831-1	783	792	+	9	O95831-1	0	1454	ENST00000675037.1	56	1439	+	245	O95831-1#95	0	9	ENST00000675037.1	839	848	+	9	0	0	1841
O95831-1#95	0	9	9	O95831-1	783	792	+	9	O95831-1	299	1183	ENST00000674957.1	0	880	+	243	O95831-1#95	0	9	ENST00000674957.1	484	493	+	9	0	0	1842
O95831-1#95	0	9	9	O95831-1	783	792	+	9	O95831-1	0	832	ENST00000674722.1	13	760	+	242	O95831-1#95	0	9	ENST00000674722.1	711	720	+	9	0	0	1843
O95831-1#95	0	9	9	O95831-1	783	792	+	9	O95831-1	0	1762	ENST00000674546.1	185	1955	+	239	O95831-1#95	0	9	ENST00000674546.1	968	977	+	9	0	0	1844
O95831-1#95	0	9	9	O95831-1	783	792	+	9	O95831-1	0	966	ENST00000535724.6	8	974	++	156	O95831-1#95	0	9	ENST00000535724.6	791	800	+	9	0	0	1845
O95831-1#95	0	9	9	O95831-1	783	792	+	9	O95831-1	0	1336	ENST00000416073.7	37	1363	+	76	O95831-1#95	0	9	ENST00000416073.7	814	823	+	9	0	0	1846
O95831-1#95	0	9	9	O95831-1	783	792	+	9	O95831-1	0	1839	ENST00000319908.8	174	2007	+	25	O95831-1#95	1	9	ENST00000319908.8	955	963	+	8	1	0	1847
O95831-1#95	0	9	9	O95831-1	783	792	+	9	O95831-1	0	1839	ENST00000287295.8	185	2024	++	16	O95831-1#95	0	9	ENST00000287295.8	968	977	+	9	0	0	1848
O95831-1#96	0	12	12	O95831-1	801	813	+	12	O95831-1	0	1839	ENST00000676436.1	34	1861	+	255	O95831-1#96	0	12	ENST00000676436.1	829	841	+	12	0	0	1849
O95831-1#96	0	12	12	O95831-1	801	813	+	12	O95831-1	0	1839	ENST00000676328.1	56	1892	+	254	O95831-1#96	0	12	ENST00000676328.1	854	866	+	12	0	0	1850
O95831-1#96	0	12	12	O95831-1	801	813	+	12	O95831-1	0	1839	ENST00000676229.1	223	2050	++	253	O95831-1#96	0	12	ENST00000676229.1	1012	1024	+	12	0	0	1851
O95831-1#96	0	12	12	O95831-1	801	813	+	12	O95831-1	0	1839	ENST00000675857.1	82	1915	+	251	O95831-1#96	0	12	ENST00000675857.1	877	889	+	12	0	0	1852
O95831-1#96	0	12	12	O95831-1	801	813	+	12	O95831-1	0	1839	ENST00000675427.1	89	1925	+	249	O95831-1#96	0	12	ENST00000675427.1	890	902	+	12	0	0	1853
O95831-1#96	0	12	12	O95831-1	801	813	+	12	O95831-1	0	1762	ENST00000675240.1	169	1867	+	248	O95831-1#96	0	12	ENST00000675240.1	970	982	+	12	0	0	1854
O95831-1#96	0	12	12	O95831-1	801	813	+	12	O95831-1	0	1839	ENST00000675092.1	90	1956	+	247	O95831-1#96	0	12	ENST00000675092.1	891	903	+	12	0	0	1855
O95831-1#96	0	12	12	O95831-1	801	813	+	12	O95831-1	0	1839	ENST00000675050.1	71	1898	++	246	O95831-1#96	0	12	ENST00000675050.1	860	872	+	12	0	0	1856
O95831-1#96	0	12	12	O95831-1	801	813	+	12	O95831-1	0	1454	ENST00000675037.1	56	1439	+	245	O95831-1#96	0	12	ENST00000675037.1	857	869	+	12	0	0	1857
O95831-1#96	0	12	12	O95831-1	801	813	+	12	O95831-1	299	1183	ENST00000674957.1	0	880	+	243	O95831-1#96	0	12	ENST00000674957.1	502	514	+	12	0	0	1858
O95831-1#96	0	12	12	O95831-1	801	813	+	12	O95831-1	0	832	ENST00000674722.1	13	760	+	242	O95831-1#96	0	12	ENST00000674722.1	729	741	+	12	0	0	1859
O95831-1#96	0	12	12	O95831-1	801	813	+	12	O95831-1	0	1762	ENST00000674546.1	185	1955	+	239	O95831-1#96	0	12	ENST00000674546.1	986	998	+	12	0	0	1860
O95831-1#96	0	12	12	O95831-1	801	813	+	12	O95831-1	0	966	ENST00000535724.6	8	974	++	156	O95831-1#96	0	12	ENST00000535724.6	809	821	+	12	0	0	1861
O95831-1#96	0	12	12	O95831-1	801	813	+	12	O95831-1	0	1336	ENST00000416073.7	37	1363	+	76	O95831-1#96	0	12	ENST00000416073.7	832	844	+	12	0	0	1862
O95831-1#96	0	12	12	O95831-1	801	813	+	12	O95831-1	0	1839	ENST00000319908.8	174	2007	+	25	O95831-1#96	0	12	ENST00000319908.8	972	984	+	12	0	0	1863
O95831-1#96	0	12	12	O95831-1	801	813	+	12	O95831-1	0	1839	ENST00000287295.8	185	2024	++	16	O95831-1#96	0	12	ENST00000287295.8	986	998	+	12	0	0	1864
O95831-1#97	0	15	15	O95831-1	822	837	+	15	O95831-1	0	1839	ENST00000676436.1	34	1861	+	255	O95831-1#97	0	15	ENST00000676436.1	850	865	+	15	0	0	1865
O95831-1#97	0	15	15	O95831-1	822	837	+	15	O95831-1	0	1839	ENST00000676328.1	56	1892	+	254	O95831-1#97	0	15	ENST00000676328.1	875	890	+	15	0	0	1866
O95831-1#97	0	15	15	O95831-1	822	837	+	15	O95831-1	0	1839	ENST00000676229.1	223	2050	++	253	O95831-1#97	0	15	ENST00000676229.1	1033	1048	+	15	0	0	1867
O95831-1#97	0	15	15	O95831-1	822	837	+	15	O95831-1	0	1839	ENST00000675857.1	82	1915	+	251	O95831-1#97	0	15	ENST00000675857.1	898	913	+	15	0	0	1868
O95831-1#97	0	15	15	O95831-1	822	837	+	15	O95831-1	0	1839	ENST00000675427.1	89	1925	+	249	O95831-1#97	0	15	ENST00000675427.1	911	926	+	15	0	0	1869
O95831-1#97	0	15	15	O95831-1	822	837	+	15	O95831-1	0	1762	ENST00000675240.1	169	1867	+	248	O95831-1#97	0	15	ENST00000675240.1	991	1006	+	15	0	0	1870
O95831-1#97	0	15	15	O95831-1	822	837	+	15	O95831-1	0	1839	ENST00000675092.1	90	1956	+	247	O95831-1#97	0	15	ENST00000675092.1	912	927	+	15	0	0	1871
O95831-1#97	0	15	15	O95831-1	822	837	+	15	O95831-1	0	1839	ENST00000675050.1	71	1898	++	246	O95831-1#97	0	15	ENST00000675050.1	881	896	+	15	0	0	1872
O95831-1#97	0	15	15	O95831-1	822	837	+	15	O95831-1	0	1454	ENST00000675037.1	56	1439	+	245	O95831-1#97	0	15	ENST00000675037.1	878	893	+	15	0	0	1873
O95831-1#97	0	15	15	O95831-1	822	837	+	15	O95831-1	299	1183	ENST00000674957.1	0	880	+	243	O95831-1#97	0	15	ENST00000674957.1	523	538	+	15	0	0	1874
O95831-1#97	0	15	15	O95831-1	822	837	+	15	O95831-1	0	832	ENST00000674722.1	13	760	+	242	O95831-1#97	0	10	ENST00000674722.1	750	760	+	10	0	5	1875
O95831-1#97	0	15	15	O95831-1	822	837	+	15	O95831-1	0	1762	ENST00000674546.1	185	1955	+	239	O95831-1#97	0	15	ENST00000674546.1	1007	1022	+	15	0	0	1876
O95831-1#97	0	15	15	O95831-1	822	837	+	15	O95831-1	0	966	ENST00000535724.6	8	974	++	156	O95831-1#97	0	15	ENST00000535724.6	830	845	+	15	0	0	1877
O95831-1#97	0	15	15	O95831-1	822	837	+	15	O95831-1	0	1336	ENST00000416073.7	37	1363	+	76	O95831-1#97	0	15	ENST00000416073.7	853	868	+	15	0	0	1878
O95831-1#97	0	15	15	O95831-1	822	837	+	15	O95831-1	0	1839	ENST00000319908.8	174	2007	+	25	O95831-1#97	0	15	ENST00000319908.8	993	1008	+	15	0	0	1879
O95831-1#97	0	15	15	O95831-1	822	837	+	15	O95831-1	0	1839	ENST00000287295.8	185	2024	++	16	O95831-1#97	0	15	ENST00000287295.8	1007	1022	+	15	0	0	1880
O95831-1#98	0	9	9	O95831-1	840	849	+	9	O95831-1	0	1839	ENST00000676436.1	34	1861	+	255	O95831-1#98	0	9	ENST00000676436.1	868	877	+	9	0	0	1881
O95831-1#98	0	9	9	O95831-1	840	849	+	9	O95831-1	0	1839	ENST00000676328.1	56	1892	+	254	O95831-1#98	0	9	ENST00000676328.1	893	902	+	9	0	0	1882
O95831-1#98	0	9	9	O95831-1	840	849	+	9	O95831-1	0	1839	ENST00000676229.1	223	2050	++	253	O95831-1#98	0	9	ENST00000676229.1	1051	1060	+	9	0	0	1883
O95831-1#98	0	9	9	O95831-1	840	849	+	9	O95831-1	0	1839	ENST00000675857.1	82	1915	+	251	O95831-1#98	0	9	ENST00000675857.1	916	925	+	9	0	0	1884
O95831-1#98	0	9	9	O95831-1	840	849	+	9	O95831-1	0	1839	ENST00000675427.1	89	1925	+	249	O95831-1#98	0	9	ENST00000675427.1	929	938	+	9	0	0	1885
O95831-1#98	0	9	9	O95831-1	840	849	+	9	O95831-1	0	1762	ENST00000675240.1	169	1867	+	248	O95831-1#98	0	9	ENST00000675240.1	1009	1018	+	9	0	0	1886
O95831-1#98	0	9	9	O95831-1	840	849	+	9	O95831-1	0	1839	ENST00000675092.1	90	1956	+	247	O95831-1#98	0	9	ENST00000675092.1	930	939	+	9	0	0	1887
O95831-1#98	0	9	9	O95831-1	840	849	+	9	O95831-1	0	1839	ENST00000675050.1	71	1898	++	246	O95831-1#98	0	9	ENST00000675050.1	899	908	+	9	0	0	1888
O95831-1#98	0	9	9	O95831-1	840	849	+	9	O95831-1	0	1454	ENST00000675037.1	56	1439	+	245	O95831-1#98	0	9	ENST00000675037.1	896	905	+	9	0	0	1889
O95831-1#98	0	9	9	O95831-1	840	849	+	9	O95831-1	299	1183	ENST00000674957.1	0	880	+	243	O95831-1#98	0	9	ENST00000674957.1	541	550	+	9	0	0	1890
O95831-1#98	0	9	9	O95831-1	840	849	+	9	O95831-1	0	1762	ENST00000674546.1	185	1955	+	239	O95831-1#98	0	9	ENST00000674546.1	1025	1034	+	9	0	0	1891
O95831-1#98	0	9	9	O95831-1	840	849	+	9	O95831-1	0	966	ENST00000535724.6	8	974	++	156	O95831-1#98	0	9	ENST00000535724.6	848	857	+	9	0	0	1892
O95831-1#98	0	9	9	O95831-1	840	849	+	9	O95831-1	0	1336	ENST00000416073.7	37	1363	+	76	O95831-1#98	0	9	ENST00000416073.7	871	880	+	9	0	0	1893
O95831-1#98	0	9	9	O95831-1	840	849	+	9	O95831-1	0	1839	ENST00000319908.8	174	2007	+	25	O95831-1#98	0	9	ENST00000319908.8	1011	1020	+	9	0	0	1894
O95831-1#98	0	9	9	O95831-1	840	849	+	9	O95831-1	0	1839	ENST00000287295.8	185	2024	++	16	O95831-1#98	0	9	ENST00000287295.8	1025	1034	+	9	0	0	1895
O95831-1#99	0	39	39	O95831-1	858	897	+	39	O95831-1	0	1839	ENST00000676436.1	34	1861	+	255	O95831-1#99	0	39	ENST00000676436.1	886	925	+	39	0	0	1896
O95831-1#99	0	39	39	O95831-1	858	897	+	39	O95831-1	0	1839	ENST00000676328.1	56	1892	+	254	O95831-1#99	0	39	ENST00000676328.1	911	950	+	39	0	0	1897
O95831-1#99	0	39	39	O95831-1	858	897	+	39	O95831-1	0	1839	ENST00000676229.1	223	2050	++	253	O95831-1#99	0	39	ENST00000676229.1	1069	1108	+	39	0	0	1898
O95831-1#99	0	39	39	O95831-1	858	897	+	39	O95831-1	0	1839	ENST00000675857.1	82	1915	+	251	O95831-1#99	0	39	ENST00000675857.1	934	973	+	39	0	0	1899
O95831-1#99	0	39	39	O95831-1	858	897	+	39	O95831-1	0	1839	ENST00000675427.1	89	1925	+	249	O95831-1#99	0	39	ENST00000675427.1	947	986	+	39	0	0	1900
O95831-1#99	0	39	39	O95831-1	858	897	+	39	O95831-1	0	1762	ENST00000675240.1	169	1867	+	248	O95831-1#99	0	39	ENST00000675240.1	1027	1066	+	39	0	0	1901
O95831-1#99	0	39	39	O95831-1	858	897	+	39	O95831-1	0	1839	ENST00000675092.1	90	1956	+	247	O95831-1#99	0	39	ENST00000675092.1	948	987	+	39	0	0	1902
O95831-1#99	0	39	39	O95831-1	858	897	+	39	O95831-1	0	1839	ENST00000675050.1	71	1898	++	246	O95831-1#99	0	39	ENST00000675050.1	917	956	+	39	0	0	1903
O95831-1#99	0	39	39	O95831-1	858	897	+	39	O95831-1	0	1454	ENST00000675037.1	56	1439	+	245	O95831-1#99	0	39	ENST00000675037.1	914	953	+	39	0	0	1904
O95831-1#99	0	39	39	O95831-1	858	897	+	39	O95831-1	299	1183	ENST00000674957.1	0	880	+	243	O95831-1#99	0	39	ENST00000674957.1	559	598	+	39	0	0	1905
O95831-1#99	0	39	39	O95831-1	858	897	+	39	O95831-1	0	1762	ENST00000674546.1	185	1955	+	239	O95831-1#99	0	39	ENST00000674546.1	1043	1082	+	39	0	0	1906
O95831-1#99	0	39	39	O95831-1	858	897	+	39	O95831-1	0	966	ENST00000535724.6	8	974	++	156	O95831-1#99	0	39	ENST00000535724.6	866	905	+	39	0	0	1907
O95831-1#99	0	39	39	O95831-1	858	897	+	39	O95831-1	0	1336	ENST00000416073.7	37	1363	+	76	O95831-1#99	0	39	ENST00000416073.7	889	928	+	39	0	0	1908
O95831-1#99	0	39	39	O95831-1	858	897	+	39	O95831-1	0	1839	ENST00000319908.8	174	2007	+	25	O95831-1#99	0	39	ENST00000319908.8	1029	1068	+	39	0	0	1909
O95831-1#99	0	39	39	O95831-1	858	897	+	39	O95831-1	0	1839	ENST00000287295.8	185	2024	++	16	O95831-1#99	0	39	ENST00000287295.8	1043	1082	+	39	0	0	1910
O95831-1#100	0	18	18	O95831-1	900	918	+	18	O95831-1	0	1839	ENST00000676436.1	34	1861	+	255	O95831-1#100	0	18	ENST00000676436.1	928	946	+	18	0	0	1911
O95831-1#100	0	18	18	O95831-1	900	918	+	18	O95831-1	0	1839	ENST00000676328.1	56	1892	+	254	O95831-1#100	0	18	ENST00000676328.1	953	971	+	18	0	0	1912
O95831-1#100	0	18	18	O95831-1	900	918	+	18	O95831-1	0	1839	ENST00000676229.1	223	2050	++	253	O95831-1#100	0	18	ENST00000676229.1	1111	1129	+	18	0	0	1913
O95831-1#100	0	18	18	O95831-1	900	918	+	18	O95831-1	0	1839	ENST00000675857.1	82	1915	+	251	O95831-1#100	0	18	ENST00000675857.1	976	994	+	18	0	0	1914
O95831-1#100	0	18	18	O95831-1	900	918	+	18	O95831-1	0	1839	ENST00000675427.1	89	1925	+	249	O95831-1#100	0	18	ENST00000675427.1	989	1007	+	18	0	0	1915
O95831-1#100	0	18	18	O95831-1	900	918	+	18	O95831-1	0	1762	ENST00000675240.1	169	1867	+	248	O95831-1#100	0	18	ENST00000675240.1	1069	1087	+	18	0	0	1916
O95831-1#100	0	18	18	O95831-1	900	918	+	18	O95831-1	0	1839	ENST00000675092.1	90	1956	+	247	O95831-1#100	0	18	ENST00000675092.1	990	1008	+	18	0	0	1917
O95831-1#100	0	18	18	O95831-1	900	918	+	18	O95831-1	0	1839	ENST00000675050.1	71	1898	++	246	O95831-1#100	0	18	ENST00000675050.1	959	977	+	18	0	0	1918
O95831-1#100	0	18	18	O95831-1	900	918	+	18	O95831-1	0	1454	ENST00000675037.1	56	1439	+	245	O95831-1#100	0	18	ENST00000675037.1	956	974	+	18	0	0	1919
O95831-1#100	0	18	18	O95831-1	900	918	+	18	O95831-1	299	1183	ENST00000674957.1	0	880	+	243	O95831-1#100	0	18	ENST00000674957.1	601	619	+	18	0	0	1920
O95831-1#100	0	18	18	O95831-1	900	918	+	18	O95831-1	0	1762	ENST00000674546.1	185	1955	+	239	O95831-1#100	0	18	ENST00000674546.1	1085	1103	+	18	0	0	1921
O95831-1#100	0	18	18	O95831-1	900	918	+	18	O95831-1	0	966	ENST00000535724.6	8	974	++	156	O95831-1#100	0	18	ENST00000535724.6	908	926	+	18	0	0	1922
O95831-1#100	0	18	18	O95831-1	900	918	+	18	O95831-1	0	1336	ENST00000416073.7	37	1363	+	76	O95831-1#100	0	18	ENST00000416073.7	931	949	+	18	0	0	1923
O95831-1#100	0	18	18	O95831-1	900	918	+	18	O95831-1	0	1839	ENST00000319908.8	174	2007	+	25	O95831-1#100	0	18	ENST00000319908.8	1071	1089	+	18	0	0	1924
O95831-1#100	0	18	18	O95831-1	900	918	+	18	O95831-1	0	1839	ENST00000287295.8	185	2024	++	16	O95831-1#100	0	18	ENST00000287295.8	1085	1103	+	18	0	0	1925
O95831-1#101	0	51	51	O95831-1	927	978	+	51	O95831-1	0	1839	ENST00000676436.1	34	1861	+	255	O95831-1#101	0	51	ENST00000676436.1	955	1000	+	45	0	0	1926
O95831-1#101	0	51	51	O95831-1	927	978	+	51	O95831-1	0	1839	ENST00000676328.1	56	1892	+	254	O95831-1#101	0	51	ENST00000676328.1	980	1031	+	51	0	0	1927
O95831-1#101	0	51	51	O95831-1	927	978	+	51	O95831-1	0	1839	ENST00000676229.1	223	2050	++	253	O95831-1#101	0	51	ENST00000676229.1	1138	1189	+	51	0	0	1928
O95831-1#101	0	51	51	O95831-1	927	978	+	51	O95831-1	0	1839	ENST00000675857.1	82	1915	+	251	O95831-1#101	0	51	ENST00000675857.1	1003	1054	+	51	0	0	1929
O95831-1#101	0	51	51	O95831-1	927	978	+	51	O95831-1	0	1839	ENST00000675427.1	89	1925	+	249	O95831-1#101	0	51	ENST00000675427.1	1016	1067	+	51	0	0	1930
O95831-1#101	0	51	51	O95831-1	927	978	+	51	O95831-1	0	1762	ENST00000675240.1	169	1867	+	248	O95831-1#101	0	51	ENST00000675240.1	1096	1147	+	51	0	0	1931
O95831-1#101	0	51	51	O95831-1	927	978	+	51	O95831-1	0	1839	ENST00000675092.1	90	1956	+	247	O95831-1#101	0	51	ENST00000675092.1	1017	1068	+	51	0	0	1932
O95831-1#101	0	51	51	O95831-1	927	978	+	51	O95831-1	0	1839	ENST00000675050.1	71	1898	++	246	O95831-1#101	0	51	ENST00000675050.1	986	1037	+	51	0	0	1933
O95831-1#101	0	51	51	O95831-1	927	978	+	51	O95831-1	0	1454	ENST00000675037.1	56	1439	+	245	O95831-1#101	0	51	ENST00000675037.1	983	1034	+	51	0	0	1934
O95831-1#101	0	51	51	O95831-1	927	978	+	51	O95831-1	299	1183	ENST00000674957.1	0	880	+	243	O95831-1#101	0	51	ENST00000674957.1	628	679	+	51	0	0	1935
O95831-1#101	0	51	51	O95831-1	927	978	+	51	O95831-1	0	1762	ENST00000674546.1	185	1955	+	239	O95831-1#101	0	51	ENST00000674546.1	1112	1163	+	51	0	0	1936
O95831-1#101	0	51	51	O95831-1	927	978	+	51	O95831-1	0	966	ENST00000535724.6	8	974	++	156	O95831-1#101	0	39	ENST00000535724.6	935	974	+	39	0	12	1937
O95831-1#101	0	51	51	O95831-1	927	978	+	51	O95831-1	0	1336	ENST00000416073.7	37	1363	+	76	O95831-1#101	0	51	ENST00000416073.7	958	1009	+	51	0	0	1938
O95831-1#101	0	51	51	O95831-1	927	978	+	51	O95831-1	0	1839	ENST00000346424.6	24	1002	++	34	O95831-1#101	39	51	ENST00000346424.6	129	141	+	12	39	0	1939
O95831-1#101	0	51	51	O95831-1	927	978	+	51	O95831-1	0	1839	ENST00000319908.8	174	2007	+	25	O95831-1#101	0	51	ENST00000319908.8	1098	1149	+	51	0	0	1940
O95831-1#101	0	51	51	O95831-1	927	978	+	51	O95831-1	0	1839	ENST00000287295.8	185	2024	++	16	O95831-1#101	0	51	ENST00000287295.8	1112	1163	+	51	0	0	1941
O95831-1#102	0	15	15	O95831-1	984	999	+	15	O95831-1	0	1839	ENST00000676436.1	34	1861	+	255	O95831-1#102	0	15	ENST00000676436.1	1006	1021	+	15	0	0	1942
O95831-1#102	0	15	15	O95831-1	984	999	+	15	O95831-1	0	1839	ENST00000676328.1	56	1892	+	254	O95831-1#102	0	15	ENST00000676328.1	1037	1052	+	15	0	0	1943
O95831-1#102	0	15	15	O95831-1	984	999	+	15	O95831-1	0	1839	ENST00000676229.1	223	2050	++	253	O95831-1#102	0	15	ENST00000676229.1	1195	1210	+	15	0	0	1944
O95831-1#102	0	15	15	O95831-1	984	999	+	15	O95831-1	0	1839	ENST00000675857.1	82	1915	+	251	O95831-1#102	0	15	ENST00000675857.1	1060	1075	+	15	0	0	1945
O95831-1#102	0	15	15	O95831-1	984	999	+	15	O95831-1	0	1839	ENST00000675427.1	89	1925	+	249	O95831-1#102	0	15	ENST00000675427.1	1073	1088	+	15	0	0	1946
O95831-1#102	0	15	15	O95831-1	984	999	+	15	O95831-1	0	1762	ENST00000675240.1	169	1867	+	248	O95831-1#102	0	15	ENST00000675240.1	1153	1168	+	15	0	0	1947
O95831-1#102	0	15	15	O95831-1	984	999	+	15	O95831-1	0	1839	ENST00000675092.1	90	1956	+	247	O95831-1#102	0	15	ENST00000675092.1	1074	1089	+	15	0	0	1948
O95831-1#102	0	15	15	O95831-1	984	999	+	15	O95831-1	0	1839	ENST00000675050.1	71	1898	++	246	O95831-1#102	0	15	ENST00000675050.1	1043	1058	+	15	0	0	1949
O95831-1#102	0	15	15	O95831-1	984	999	+	15	O95831-1	0	1454	ENST00000675037.1	56	1439	+	245	O95831-1#102	0	15	ENST00000675037.1	1040	1055	+	15	0	0	1950
O95831-1#102	0	15	15	O95831-1	984	999	+	15	O95831-1	299	1183	ENST00000674957.1	0	880	+	243	O95831-1#102	0	15	ENST00000674957.1	685	700	+	15	0	0	1951
O95831-1#102	0	15	15	O95831-1	984	999	+	15	O95831-1	0	1762	ENST00000674546.1	185	1955	+	239	O95831-1#102	0	15	ENST00000674546.1	1169	1184	+	15	0	0	1952
O95831-1#102	0	15	15	O95831-1	984	999	+	15	O95831-1	0	1336	ENST00000416073.7	37	1363	+	76	O95831-1#102	0	15	ENST00000416073.7	1015	1030	+	15	0	0	1953
O95831-1#102	0	15	15	O95831-1	984	999	+	15	O95831-1	0	1839	ENST00000346424.6	24	1002	++	34	O95831-1#102	0	15	ENST00000346424.6	147	162	+	15	0	0	1954
O95831-1#102	0	15	15	O95831-1	984	999	+	15	O95831-1	0	1839	ENST00000319908.8	174	2007	+	25	O95831-1#102	0	15	ENST00000319908.8	1155	1170	+	15	0	0	1955
O95831-1#102	0	15	15	O95831-1	984	999	+	15	O95831-1	0	1839	ENST00000287295.8	185	2024	++	16	O95831-1#102	0	15	ENST00000287295.8	1169	1184	+	15	0	0	1956
O95831-1#103	0	12	12	O95831-1	1002	1014	+	12	O95831-1	0	1839	ENST00000676436.1	34	1861	+	255	O95831-1#103	0	12	ENST00000676436.1	1024	1036	+	12	0	0	1957
O95831-1#103	0	12	12	O95831-1	1002	1014	+	12	O95831-1	0	1839	ENST00000676328.1	56	1892	+	254	O95831-1#103	0	12	ENST00000676328.1	1055	1067	+	12	0	0	1958
O95831-1#103	0	12	12	O95831-1	1002	1014	+	12	O95831-1	0	1839	ENST00000676229.1	223	2050	++	253	O95831-1#103	0	12	ENST00000676229.1	1213	1225	+	12	0	0	1959
O95831-1#103	0	12	12	O95831-1	1002	1014	+	12	O95831-1	0	1839	ENST00000675857.1	82	1915	+	251	O95831-1#103	0	12	ENST00000675857.1	1078	1090	+	12	0	0	1960
O95831-1#103	0	12	12	O95831-1	1002	1014	+	12	O95831-1	0	1839	ENST00000675427.1	89	1925	+	249	O95831-1#103	0	12	ENST00000675427.1	1091	1103	+	12	0	0	1961
O95831-1#103	0	12	12	O95831-1	1002	1014	+	12	O95831-1	0	1762	ENST00000675240.1	169	1867	+	248	O95831-1#103	0	12	ENST00000675240.1	1171	1183	+	12	0	0	1962
O95831-1#103	0	12	12	O95831-1	1002	1014	+	12	O95831-1	0	1839	ENST00000675092.1	90	1956	+	247	O95831-1#103	0	12	ENST00000675092.1	1092	1104	+	12	0	0	1963
O95831-1#103	0	12	12	O95831-1	1002	1014	+	12	O95831-1	0	1839	ENST00000675050.1	71	1898	++	246	O95831-1#103	0	12	ENST00000675050.1	1061	1073	+	12	0	0	1964
O95831-1#103	0	12	12	O95831-1	1002	1014	+	12	O95831-1	0	1454	ENST00000675037.1	56	1439	+	245	O95831-1#103	0	12	ENST00000675037.1	1058	1070	+	12	0	0	1965
O95831-1#103	0	12	12	O95831-1	1002	1014	+	12	O95831-1	299	1183	ENST00000674957.1	0	880	+	243	O95831-1#103	0	12	ENST00000674957.1	703	715	+	12	0	0	1966
O95831-1#103	0	12	12	O95831-1	1002	1014	+	12	O95831-1	1012	1839	ENST00000674601.1	0	686	+	241	O95831-1#103	10	12	ENST00000674601.1	0	2	+	2	10	0	1967
O95831-1#103	0	12	12	O95831-1	1002	1014	+	12	O95831-1	0	1762	ENST00000674546.1	185	1955	+	239	O95831-1#103	0	12	ENST00000674546.1	1187	1199	+	12	0	0	1968
O95831-1#103	0	12	12	O95831-1	1002	1014	+	12	O95831-1	0	1336	ENST00000416073.7	37	1363	+	76	O95831-1#103	0	12	ENST00000416073.7	1033	1045	+	12	0	0	1969
O95831-1#103	0	12	12	O95831-1	1002	1014	+	12	O95831-1	0	1839	ENST00000346424.6	24	1002	++	34	O95831-1#103	0	12	ENST00000346424.6	165	177	+	12	0	0	1970
O95831-1#103	0	12	12	O95831-1	1002	1014	+	12	O95831-1	0	1839	ENST00000319908.8	174	2007	+	25	O95831-1#103	0	12	ENST00000319908.8	1173	1185	+	12	0	0	1971
O95831-1#103	0	12	12	O95831-1	1002	1014	+	12	O95831-1	0	1839	ENST00000287295.8	185	2024	++	16	O95831-1#103	0	12	ENST00000287295.8	1187	1199	+	12	0	0	1972
O95831-1#104	0	15	15	O95831-1	1014	1029	+	15	O95831-1	0	1839	ENST00000676436.1	34	1861	+	255	O95831-1#104	0	15	ENST00000676436.1	1036	1051	+	15	0	0	1973
O95831-1#104	0	15	15	O95831-1	1014	1029	+	15	O95831-1	0	1839	ENST00000676328.1	56	1892	+	254	O95831-1#104	0	15	ENST00000676328.1	1067	1082	+	15	0	0	1974
O95831-1#104	0	15	15	O95831-1	1014	1029	+	15	O95831-1	0	1839	ENST00000676229.1	223	2050	++	253	O95831-1#104	0	15	ENST00000676229.1	1225	1240	+	15	0	0	1975
O95831-1#104	0	15	15	O95831-1	1014	1029	+	15	O95831-1	0	1839	ENST00000675857.1	82	1915	+	251	O95831-1#104	0	15	ENST00000675857.1	1090	1105	+	15	0	0	1976
O95831-1#104	0	15	15	O95831-1	1014	1029	+	15	O95831-1	0	1839	ENST00000675427.1	89	1925	+	249	O95831-1#104	0	15	ENST00000675427.1	1103	1118	+	15	0	0	1977
O95831-1#104	0	15	15	O95831-1	1014	1029	+	15	O95831-1	0	1762	ENST00000675240.1	169	1867	+	248	O95831-1#104	0	15	ENST00000675240.1	1183	1198	+	15	0	0	1978
O95831-1#104	0	15	15	O95831-1	1014	1029	+	15	O95831-1	0	1839	ENST00000675092.1	90	1956	+	247	O95831-1#104	0	15	ENST00000675092.1	1104	1119	+	15	0	0	1979
O95831-1#104	0	15	15	O95831-1	1014	1029	+	15	O95831-1	0	1839	ENST00000675050.1	71	1898	++	246	O95831-1#104	0	15	ENST00000675050.1	1073	1088	+	15	0	0	1980
O95831-1#104	0	15	15	O95831-1	1014	1029	+	15	O95831-1	0	1454	ENST00000675037.1	56	1439	+	245	O95831-1#104	0	15	ENST00000675037.1	1070	1085	+	15	0	0	1981
O95831-1#104	0	15	15	O95831-1	1014	1029	+	15	O95831-1	299	1183	ENST00000674957.1	0	880	+	243	O95831-1#104	0	15	ENST00000674957.1	715	730	+	15	0	0	1982
O95831-1#104	0	15	15	O95831-1	1014	1029	+	15	O95831-1	1012	1839	ENST00000674601.1	0	686	+	241	O95831-1#104	0	15	ENST00000674601.1	2	17	+	15	0	0	1983
O95831-1#104	0	15	15	O95831-1	1014	1029	+	15	O95831-1	0	1762	ENST00000674546.1	185	1955	+	239	O95831-1#104	0	15	ENST00000674546.1	1199	1214	+	15	0	0	1984
O95831-1#104	0	15	15	O95831-1	1014	1029	+	15	O95831-1	1017	1839	ENST00000460436.6	905	1727	+	105	O95831-1#104	3	15	ENST00000460436.6	905	917	+	12	3	0	1985
O95831-1#104	0	15	15	O95831-1	1014	1029	+	15	O95831-1	0	1336	ENST00000416073.7	37	1363	+	76	O95831-1#104	0	15	ENST00000416073.7	1045	1060	+	15	0	0	1986
O95831-1#104	0	15	15	O95831-1	1014	1029	+	15	O95831-1	0	1839	ENST00000346424.6	24	1002	++	34	O95831-1#104	0	15	ENST00000346424.6	177	192	+	15	0	0	1987
O95831-1#104	0	15	15	O95831-1	1014	1029	+	15	O95831-1	0	1839	ENST00000319908.8	174	2007	+	25	O95831-1#104	0	15	ENST00000319908.8	1185	1200	+	15	0	0	1988
O95831-1#104	0	15	15	O95831-1	1014	1029	+	15	O95831-1	0	1839	ENST00000287295.8	185	2024	++	16	O95831-1#104	0	15	ENST00000287295.8	1199	1214	+	15	0	0	1989
O95831-1#105	0	39	39	O95831-1	1035	1074	+	39	O95831-1	0	1839	ENST00000676436.1	34	1861	+	255	O95831-1#105	0	39	ENST00000676436.1	1057	1096	+	39	0	0	1990
O95831-1#105	0	39	39	O95831-1	1035	1074	+	39	O95831-1	0	1839	ENST00000676328.1	56	1892	+	254	O95831-1#105	0	39	ENST00000676328.1	1088	1127	+	39	0	0	1991
O95831-1#105	0	39	39	O95831-1	1035	1074	+	39	O95831-1	0	1839	ENST00000676229.1	223	2050	++	253	O95831-1#105	0	39	ENST00000676229.1	1246	1285	+	39	0	0	1992
O95831-1#105	0	39	39	O95831-1	1035	1074	+	39	O95831-1	0	1839	ENST00000675857.1	82	1915	+	251	O95831-1#105	0	39	ENST00000675857.1	1111	1150	+	39	0	0	1993
O95831-1#105	0	39	39	O95831-1	1035	1074	+	39	O95831-1	0	1839	ENST00000675427.1	89	1925	+	249	O95831-1#105	0	39	ENST00000675427.1	1124	1163	+	39	0	0	1994
O95831-1#105	0	39	39	O95831-1	1035	1074	+	39	O95831-1	0	1762	ENST00000675240.1	169	1867	+	248	O95831-1#105	0	39	ENST00000675240.1	1204	1243	+	39	0	0	1995
O95831-1#105	0	39	39	O95831-1	1035	1074	+	39	O95831-1	0	1839	ENST00000675092.1	90	1956	+	247	O95831-1#105	0	39	ENST00000675092.1	1125	1164	+	39	0	0	1996
O95831-1#105	0	39	39	O95831-1	1035	1074	+	39	O95831-1	0	1839	ENST00000675050.1	71	1898	++	246	O95831-1#105	0	39	ENST00000675050.1	1094	1133	+	39	0	0	1997
O95831-1#105	0	39	39	O95831-1	1035	1074	+	39	O95831-1	0	1454	ENST00000675037.1	56	1439	+	245	O95831-1#105	0	39	ENST00000675037.1	1091	1130	+	39	0	0	1998
O95831-1#105	0	39	39	O95831-1	1035	1074	+	39	O95831-1	299	1183	ENST00000674957.1	0	880	+	243	O95831-1#105	0	39	ENST00000674957.1	736	775	+	39	0	0	1999
O95831-1#105	0	39	39	O95831-1	1035	1074	+	39	O95831-1	1012	1839	ENST00000674601.1	0	686	+	241	O95831-1#105	0	39	ENST00000674601.1	23	62	+	39	0	0	2000
O95831-1#105	0	39	39	O95831-1	1035	1074	+	39	O95831-1	0	1762	ENST00000674546.1	185	1955	+	239	O95831-1#105	0	39	ENST00000674546.1	1220	1259	+	39	0	0	2001
O95831-1#105	0	39	39	O95831-1	1035	1074	+	39	O95831-1	1017	1839	ENST00000460436.6	905	1727	+	105	O95831-1#105	0	39	ENST00000460436.6	923	962	+	39	0	0	2002
O95831-1#105	0	39	39	O95831-1	1035	1074	+	39	O95831-1	0	1336	ENST00000416073.7	37	1363	+	76	O95831-1#105	0	39	ENST00000416073.7	1066	1105	+	39	0	0	2003
O95831-1#105	0	39	39	O95831-1	1035	1074	+	39	O95831-1	0	1839	ENST00000346424.6	24	1002	++	34	O95831-1#105	0	39	ENST00000346424.6	198	237	+	39	0	0	2004
O95831-1#105	0	39	39	O95831-1	1035	1074	+	39	O95831-1	0	1839	ENST00000319908.8	174	2007	+	25	O95831-1#105	0	39	ENST00000319908.8	1206	1245	+	39	0	0	2005
O95831-1#105	0	39	39	O95831-1	1035	1074	+	39	O95831-1	0	1839	ENST00000287295.8	185	2024	++	16	O95831-1#105	0	39	ENST00000287295.8	1220	1259	+	39	0	0	2006
O95831-1#106	0	9	9	O95831-1	1083	1092	+	9	O95831-1	0	1839	ENST00000676436.1	34	1861	+	255	O95831-1#106	0	9	ENST00000676436.1	1105	1114	+	9	0	0	2007
O95831-1#106	0	9	9	O95831-1	1083	1092	+	9	O95831-1	0	1839	ENST00000676328.1	56	1892	+	254	O95831-1#106	0	9	ENST00000676328.1	1136	1145	+	9	0	0	2008
O95831-1#106	0	9	9	O95831-1	1083	1092	+	9	O95831-1	0	1839	ENST00000676229.1	223	2050	++	253	O95831-1#106	0	9	ENST00000676229.1	1294	1303	+	9	0	0	2009
O95831-1#106	0	9	9	O95831-1	1083	1092	+	9	O95831-1	0	1839	ENST00000675857.1	82	1915	+	251	O95831-1#106	0	9	ENST00000675857.1	1159	1168	+	9	0	0	2010
O95831-1#106	0	9	9	O95831-1	1083	1092	+	9	O95831-1	0	1839	ENST00000675427.1	89	1925	+	249	O95831-1#106	0	9	ENST00000675427.1	1172	1181	+	9	0	0	2011
O95831-1#106	0	9	9	O95831-1	1083	1092	+	9	O95831-1	0	1762	ENST00000675240.1	169	1867	+	248	O95831-1#106	0	9	ENST00000675240.1	1252	1261	+	9	0	0	2012
O95831-1#106	0	9	9	O95831-1	1083	1092	+	9	O95831-1	0	1839	ENST00000675092.1	90	1956	+	247	O95831-1#106	0	9	ENST00000675092.1	1173	1182	+	9	0	0	2013
O95831-1#106	0	9	9	O95831-1	1083	1092	+	9	O95831-1	0	1839	ENST00000675050.1	71	1898	++	246	O95831-1#106	0	9	ENST00000675050.1	1142	1151	+	9	0	0	2014
O95831-1#106	0	9	9	O95831-1	1083	1092	+	9	O95831-1	0	1454	ENST00000675037.1	56	1439	+	245	O95831-1#106	0	9	ENST00000675037.1	1139	1148	+	9	0	0	2015
O95831-1#106	0	9	9	O95831-1	1083	1092	+	9	O95831-1	299	1183	ENST00000674957.1	0	880	+	243	O95831-1#106	0	9	ENST00000674957.1	784	793	+	9	0	0	2016
O95831-1#106	0	9	9	O95831-1	1083	1092	+	9	O95831-1	1012	1839	ENST00000674601.1	0	686	+	241	O95831-1#106	0	9	ENST00000674601.1	71	80	+	9	0	0	2017
O95831-1#106	0	9	9	O95831-1	1083	1092	+	9	O95831-1	0	1762	ENST00000674546.1	185	1955	+	239	O95831-1#106	0	9	ENST00000674546.1	1268	1277	+	9	0	0	2018
O95831-1#106	0	9	9	O95831-1	1083	1092	+	9	O95831-1	1017	1839	ENST00000460436.6	905	1727	+	105	O95831-1#106	0	9	ENST00000460436.6	971	980	+	9	0	0	2019
O95831-1#106	0	9	9	O95831-1	1083	1092	+	9	O95831-1	0	1336	ENST00000416073.7	37	1363	+	76	O95831-1#106	0	9	ENST00000416073.7	1114	1123	+	9	0	0	2020
O95831-1#106	0	9	9	O95831-1	1083	1092	+	9	O95831-1	0	1839	ENST00000346424.6	24	1002	++	34	O95831-1#106	0	9	ENST00000346424.6	246	255	+	9	0	0	2021
O95831-1#106	0	9	9	O95831-1	1083	1092	+	9	O95831-1	0	1839	ENST00000319908.8	174	2007	+	25	O95831-1#106	0	9	ENST00000319908.8	1254	1263	+	9	0	0	2022
O95831-1#106	0	9	9	O95831-1	1083	1092	+	9	O95831-1	0	1839	ENST00000287295.8	185	2024	++	16	O95831-1#106	0	9	ENST00000287295.8	1268	1277	+	9	0	0	2023
O95831-1#107	0	21	21	O95831-1	1104	1125	+	21	O95831-1	0	1839	ENST00000676436.1	34	1861	+	255	O95831-1#107	0	21	ENST00000676436.1	1126	1147	+	21	0	0	2024
O95831-1#107	0	21	21	O95831-1	1104	1125	+	21	O95831-1	0	1839	ENST00000676328.1	56	1892	+	254	O95831-1#107	0	21	ENST00000676328.1	1157	1178	+	21	0	0	2025
O95831-1#107	0	21	21	O95831-1	1104	1125	+	21	O95831-1	0	1839	ENST00000676229.1	223	2050	++	253	O95831-1#107	0	21	ENST00000676229.1	1315	1336	+	21	0	0	2026
O95831-1#107	0	21	21	O95831-1	1104	1125	+	21	O95831-1	0	1839	ENST00000675857.1	82	1915	+	251	O95831-1#107	0	21	ENST00000675857.1	1180	1201	+	21	0	0	2027
O95831-1#107	0	21	21	O95831-1	1104	1125	+	21	O95831-1	0	1839	ENST00000675427.1	89	1925	+	249	O95831-1#107	0	21	ENST00000675427.1	1193	1214	+	21	0	0	2028
O95831-1#107	0	21	21	O95831-1	1104	1125	+	21	O95831-1	0	1762	ENST00000675240.1	169	1867	+	248	O95831-1#107	0	21	ENST00000675240.1	1273	1294	+	21	0	0	2029
O95831-1#107	0	21	21	O95831-1	1104	1125	+	21	O95831-1	0	1839	ENST00000675092.1	90	1956	+	247	O95831-1#107	0	21	ENST00000675092.1	1194	1215	+	21	0	0	2030
O95831-1#107	0	21	21	O95831-1	1104	1125	+	21	O95831-1	0	1839	ENST00000675050.1	71	1898	++	246	O95831-1#107	0	21	ENST00000675050.1	1163	1184	+	21	0	0	2031
O95831-1#107	0	21	21	O95831-1	1104	1125	+	21	O95831-1	0	1454	ENST00000675037.1	56	1439	+	245	O95831-1#107	0	21	ENST00000675037.1	1160	1181	+	21	0	0	2032
O95831-1#107	0	21	21	O95831-1	1104	1125	+	21	O95831-1	299	1183	ENST00000674957.1	0	880	+	243	O95831-1#107	0	21	ENST00000674957.1	805	826	+	21	0	0	2033
O95831-1#107	0	21	21	O95831-1	1104	1125	+	21	O95831-1	1012	1839	ENST00000674601.1	0	686	+	241	O95831-1#107	0	21	ENST00000674601.1	92	113	+	21	0	0	2034
O95831-1#107	0	21	21	O95831-1	1104	1125	+	21	O95831-1	0	1762	ENST00000674546.1	185	1955	+	239	O95831-1#107	0	21	ENST00000674546.1	1289	1310	+	21	0	0	2035
O95831-1#107	0	21	21	O95831-1	1104	1125	+	21	O95831-1	1017	1839	ENST00000460436.6	905	1727	+	105	O95831-1#107	0	21	ENST00000460436.6	992	1013	+	21	0	0	2036
O95831-1#107	0	21	21	O95831-1	1104	1125	+	21	O95831-1	0	1336	ENST00000416073.7	37	1363	+	76	O95831-1#107	0	21	ENST00000416073.7	1135	1156	+	21	0	0	2037
O95831-1#107	0	21	21	O95831-1	1104	1125	+	21	O95831-1	0	1839	ENST00000346424.6	24	1002	++	34	O95831-1#107	0	21	ENST00000346424.6	267	288	+	21	0	0	2038
O95831-1#107	0	21	21	O95831-1	1104	1125	+	21	O95831-1	0	1839	ENST00000319908.8	174	2007	+	25	O95831-1#107	0	21	ENST00000319908.8	1275	1296	+	21	0	0	2039
O95831-1#107	0	21	21	O95831-1	1104	1125	+	21	O95831-1	0	1839	ENST00000287295.8	185	2024	++	16	O95831-1#107	0	21	ENST00000287295.8	1289	1310	+	21	0	0	2040
O95831-1#108	0	18	18	O95831-1	1131	1149	+	18	O95831-1	0	1839	ENST00000676436.1	34	1861	+	255	O95831-1#108	0	18	ENST00000676436.1	1153	1171	+	18	0	0	2041
O95831-1#108	0	18	18	O95831-1	1131	1149	+	18	O95831-1	0	1839	ENST00000676328.1	56	1892	+	254	O95831-1#108	0	18	ENST00000676328.1	1184	1202	+	18	0	0	2042
O95831-1#108	0	18	18	O95831-1	1131	1149	+	18	O95831-1	0	1839	ENST00000676229.1	223	2050	++	253	O95831-1#108	0	18	ENST00000676229.1	1342	1360	+	18	0	0	2043
O95831-1#108	0	18	18	O95831-1	1131	1149	+	18	O95831-1	0	1839	ENST00000675857.1	82	1915	+	251	O95831-1#108	0	18	ENST00000675857.1	1207	1225	+	18	0	0	2044
O95831-1#108	0	18	18	O95831-1	1131	1149	+	18	O95831-1	0	1839	ENST00000675427.1	89	1925	+	249	O95831-1#108	0	18	ENST00000675427.1	1220	1238	+	18	0	0	2045
O95831-1#108	0	18	18	O95831-1	1131	1149	+	18	O95831-1	0	1762	ENST00000675240.1	169	1867	+	248	O95831-1#108	0	18	ENST00000675240.1	1300	1318	+	18	0	0	2046
O95831-1#108	0	18	18	O95831-1	1131	1149	+	18	O95831-1	0	1839	ENST00000675092.1	90	1956	+	247	O95831-1#108	0	18	ENST00000675092.1	1221	1239	+	18	0	0	2047
O95831-1#108	0	18	18	O95831-1	1131	1149	+	18	O95831-1	0	1839	ENST00000675050.1	71	1898	++	246	O95831-1#108	0	18	ENST00000675050.1	1190	1208	+	18	0	0	2048
O95831-1#108	0	18	18	O95831-1	1131	1149	+	18	O95831-1	0	1454	ENST00000675037.1	56	1439	+	245	O95831-1#108	0	18	ENST00000675037.1	1187	1205	+	18	0	0	2049
O95831-1#108	0	18	18	O95831-1	1131	1149	+	18	O95831-1	299	1183	ENST00000674957.1	0	880	+	243	O95831-1#108	0	18	ENST00000674957.1	832	850	+	18	0	0	2050
O95831-1#108	0	18	18	O95831-1	1131	1149	+	18	O95831-1	1012	1839	ENST00000674601.1	0	686	+	241	O95831-1#108	0	18	ENST00000674601.1	119	137	+	18	0	0	2051
O95831-1#108	0	18	18	O95831-1	1131	1149	+	18	O95831-1	0	1762	ENST00000674546.1	185	1955	+	239	O95831-1#108	0	18	ENST00000674546.1	1316	1334	+	18	0	0	2052
O95831-1#108	0	18	18	O95831-1	1131	1149	+	18	O95831-1	1017	1839	ENST00000460436.6	905	1727	+	105	O95831-1#108	0	18	ENST00000460436.6	1019	1037	+	18	0	0	2053
O95831-1#108	0	18	18	O95831-1	1131	1149	+	18	O95831-1	0	1336	ENST00000416073.7	37	1363	+	76	O95831-1#108	0	18	ENST00000416073.7	1162	1180	+	18	0	0	2054
O95831-1#108	0	18	18	O95831-1	1131	1149	+	18	O95831-1	0	1839	ENST00000346424.6	24	1002	++	34	O95831-1#108	0	18	ENST00000346424.6	294	312	+	18	0	0	2055
O95831-1#108	0	18	18	O95831-1	1131	1149	+	18	O95831-1	0	1839	ENST00000319908.8	174	2007	+	25	O95831-1#108	0	18	ENST00000319908.8	1302	1320	+	18	0	0	2056
O95831-1#108	0	18	18	O95831-1	1131	1149	+	18	O95831-1	0	1839	ENST00000287295.8	185	2024	++	16	O95831-1#108	0	18	ENST00000287295.8	1316	1334	+	18	0	0	2057
O95831-1#109	0	27	27	O95831-1	1161	1188	+	27	O95831-1	0	1839	ENST00000676436.1	34	1861	+	255	O95831-1#109	0	27	ENST00000676436.1	1183	1210	+	27	0	0	2058
O95831-1#109	0	27	27	O95831-1	1161	1188	+	27	O95831-1	0	1839	ENST00000676328.1	56	1892	+	254	O95831-1#109	0	27	ENST00000676328.1	1214	1241	+	27	0	0	2059
O95831-1#109	0	27	27	O95831-1	1161	1188	+	27	O95831-1	0	1839	ENST00000676229.1	223	2050	++	253	O95831-1#109	0	27	ENST00000676229.1	1372	1399	+	27	0	0	2060
O95831-1#109	0	27	27	O95831-1	1161	1188	+	27	O95831-1	0	1839	ENST00000675857.1	82	1915	+	251	O95831-1#109	0	27	ENST00000675857.1	1237	1264	+	27	0	0	2061
O95831-1#109	0	27	27	O95831-1	1161	1188	+	27	O95831-1	0	1839	ENST00000675427.1	89	1925	+	249	O95831-1#109	0	27	ENST00000675427.1	1250	1277	+	27	0	0	2062
O95831-1#109	0	27	27	O95831-1	1161	1188	+	27	O95831-1	0	1762	ENST00000675240.1	169	1867	+	248	O95831-1#109	0	27	ENST00000675240.1	1330	1357	+	27	0	0	2063
O95831-1#109	0	27	27	O95831-1	1161	1188	+	27	O95831-1	0	1839	ENST00000675092.1	90	1956	+	247	O95831-1#109	0	27	ENST00000675092.1	1251	1278	+	27	0	0	2064
O95831-1#109	0	27	27	O95831-1	1161	1188	+	27	O95831-1	0	1839	ENST00000675050.1	71	1898	++	246	O95831-1#109	0	27	ENST00000675050.1	1220	1247	+	27	0	0	2065
O95831-1#109	0	27	27	O95831-1	1161	1188	+	27	O95831-1	0	1454	ENST00000675037.1	56	1439	+	245	O95831-1#109	0	27	ENST00000675037.1	1217	1244	+	27	0	0	2066
O95831-1#109	0	27	27	O95831-1	1161	1188	+	27	O95831-1	299	1183	ENST00000674957.1	0	880	+	243	O95831-1#109	0	22	ENST00000674957.1	862	880	+	18	0	5	2067
O95831-1#109	0	27	27	O95831-1	1161	1188	+	27	O95831-1	1012	1839	ENST00000674601.1	0	686	+	241	O95831-1#109	0	3	ENST00000674601.1	149	152	+	3	0	24	2068
O95831-1#109	0	27	27	O95831-1	1161	1188	+	27	O95831-1	0	1762	ENST00000674546.1	185	1955	+	239	O95831-1#109	0	27	ENST00000674546.1	1346	1373	+	27	0	0	2069
O95831-1#109	0	27	27	O95831-1	1161	1188	+	27	O95831-1	1017	1839	ENST00000460436.6	905	1727	+	105	O95831-1#109	0	27	ENST00000460436.6	1049	1076	+	27	0	0	2070
O95831-1#109	0	27	27	O95831-1	1161	1188	+	27	O95831-1	0	1336	ENST00000416073.7	37	1363	+	76	O95831-1#109	0	27	ENST00000416073.7	1192	1219	+	27	0	0	2071
O95831-1#109	0	27	27	O95831-1	1161	1188	+	27	O95831-1	0	1839	ENST00000346424.6	24	1002	++	34	O95831-1#109	0	27	ENST00000346424.6	324	351	+	27	0	0	2072
O95831-1#109	0	27	27	O95831-1	1161	1188	+	27	O95831-1	0	1839	ENST00000319908.8	174	2007	+	25	O95831-1#109	0	27	ENST00000319908.8	1332	1359	+	27	0	0	2073
O95831-1#109	0	27	27	O95831-1	1161	1188	+	27	O95831-1	0	1839	ENST00000287295.8	185	2024	++	16	O95831-1#109	0	27	ENST00000287295.8	1346	1373	+	27	0	0	2074
O95831-1#110	0	9	9	O95831-1	1197	1206	+	9	O95831-1	0	1839	ENST00000676436.1	34	1861	+	255	O95831-1#110	0	9	ENST00000676436.1	1219	1228	+	9	0	0	2075
O95831-1#110	0	9	9	O95831-1	1197	1206	+	9	O95831-1	0	1839	ENST00000676328.1	56	1892	+	254	O95831-1#110	0	9	ENST00000676328.1	1250	1259	+	9	0	0	2076
O95831-1#110	0	9	9	O95831-1	1197	1206	+	9	O95831-1	0	1839	ENST00000676229.1	223	2050	++	253	O95831-1#110	0	9	ENST00000676229.1	1408	1417	+	9	0	0	2077
O95831-1#110	0	9	9	O95831-1	1197	1206	+	9	O95831-1	0	1839	ENST00000675857.1	82	1915	+	251	O95831-1#110	0	9	ENST00000675857.1	1273	1282	+	9	0	0	2078
O95831-1#110	0	9	9	O95831-1	1197	1206	+	9	O95831-1	0	1839	ENST00000675427.1	89	1925	+	249	O95831-1#110	0	9	ENST00000675427.1	1286	1295	+	9	0	0	2079
O95831-1#110	0	9	9	O95831-1	1197	1206	+	9	O95831-1	0	1762	ENST00000675240.1	169	1867	+	248	O95831-1#110	0	9	ENST00000675240.1	1366	1375	+	9	0	0	2080
O95831-1#110	0	9	9	O95831-1	1197	1206	+	9	O95831-1	0	1839	ENST00000675092.1	90	1956	+	247	O95831-1#110	0	9	ENST00000675092.1	1287	1296	+	9	0	0	2081
O95831-1#110	0	9	9	O95831-1	1197	1206	+	9	O95831-1	0	1839	ENST00000675050.1	71	1898	++	246	O95831-1#110	0	9	ENST00000675050.1	1256	1265	+	9	0	0	2082
O95831-1#110	0	9	9	O95831-1	1197	1206	+	9	O95831-1	0	1454	ENST00000675037.1	56	1439	+	245	O95831-1#110	0	9	ENST00000675037.1	1253	1262	+	9	0	0	2083
O95831-1#110	0	9	9	O95831-1	1197	1206	+	9	O95831-1	0	1762	ENST00000674546.1	185	1955	+	239	O95831-1#110	0	9	ENST00000674546.1	1382	1391	+	9	0	0	2084
O95831-1#110	0	9	9	O95831-1	1197	1206	+	9	O95831-1	1017	1839	ENST00000460436.6	905	1727	+	105	O95831-1#110	0	9	ENST00000460436.6	1085	1094	+	9	0	0	2085
O95831-1#110	0	9	9	O95831-1	1197	1206	+	9	O95831-1	0	1336	ENST00000416073.7	37	1363	+	76	O95831-1#110	0	9	ENST00000416073.7	1228	1237	+	9	0	0	2086
O95831-1#110	0	9	9	O95831-1	1197	1206	+	9	O95831-1	0	1839	ENST00000346424.6	24	1002	++	34	O95831-1#110	0	9	ENST00000346424.6	360	369	+	9	0	0	2087
O95831-1#110	0	9	9	O95831-1	1197	1206	+	9	O95831-1	0	1839	ENST00000319908.8	174	2007	+	25	O95831-1#110	0	9	ENST00000319908.8	1368	1377	+	9	0	0	2088
O95831-1#110	0	9	9	O95831-1	1197	1206	+	9	O95831-1	0	1839	ENST00000287295.8	185	2024	++	16	O95831-1#110	0	9	ENST00000287295.8	1382	1391	+	9	0	0	2089
O95831-1#111	0	12	12	O95831-1	1218	1230	+	12	O95831-1	0	1839	ENST00000676436.1	34	1861	+	255	O95831-1#111	0	12	ENST00000676436.1	1240	1252	+	12	0	0	2090
O95831-1#111	0	12	12	O95831-1	1218	1230	+	12	O95831-1	0	1839	ENST00000676328.1	56	1892	+	254	O95831-1#111	0	12	ENST00000676328.1	1271	1283	+	12	0	0	2091
O95831-1#111	0	12	12	O95831-1	1218	1230	+	12	O95831-1	0	1839	ENST00000676229.1	223	2050	++	253	O95831-1#111	0	12	ENST00000676229.1	1429	1441	+	12	0	0	2092
O95831-1#111	0	12	12	O95831-1	1218	1230	+	12	O95831-1	0	1839	ENST00000675857.1	82	1915	+	251	O95831-1#111	0	12	ENST00000675857.1	1294	1306	+	12	0	0	2093
O95831-1#111	0	12	12	O95831-1	1218	1230	+	12	O95831-1	0	1839	ENST00000675427.1	89	1925	+	249	O95831-1#111	0	12	ENST00000675427.1	1307	1319	+	12	0	0	2094
O95831-1#111	0	12	12	O95831-1	1218	1230	+	12	O95831-1	0	1762	ENST00000675240.1	169	1867	+	248	O95831-1#111	0	12	ENST00000675240.1	1387	1399	+	12	0	0	2095
O95831-1#111	0	12	12	O95831-1	1218	1230	+	12	O95831-1	0	1839	ENST00000675092.1	90	1956	+	247	O95831-1#111	0	12	ENST00000675092.1	1308	1320	+	12	0	0	2096
O95831-1#111	0	12	12	O95831-1	1218	1230	+	12	O95831-1	0	1839	ENST00000675050.1	71	1898	++	246	O95831-1#111	0	12	ENST00000675050.1	1277	1289	+	12	0	0	2097
O95831-1#111	0	12	12	O95831-1	1218	1230	+	12	O95831-1	0	1454	ENST00000675037.1	56	1439	+	245	O95831-1#111	0	12	ENST00000675037.1	1274	1286	+	12	0	0	2098
O95831-1#111	0	12	12	O95831-1	1218	1230	+	12	O95831-1	0	1762	ENST00000674546.1	185	1955	+	239	O95831-1#111	0	12	ENST00000674546.1	1403	1415	+	12	0	0	2099
O95831-1#111	0	12	12	O95831-1	1218	1230	+	12	O95831-1	1017	1839	ENST00000460436.6	905	1727	+	105	O95831-1#111	0	12	ENST00000460436.6	1106	1118	+	12	0	0	2100
O95831-1#111	0	12	12	O95831-1	1218	1230	+	12	O95831-1	0	1336	ENST00000416073.7	37	1363	+	76	O95831-1#111	0	12	ENST00000416073.7	1249	1261	+	12	0	0	2101
O95831-1#111	0	12	12	O95831-1	1218	1230	+	12	O95831-1	0	1839	ENST00000346424.6	24	1002	++	34	O95831-1#111	0	12	ENST00000346424.6	381	393	+	12	0	0	2102
O95831-1#111	0	12	12	O95831-1	1218	1230	+	12	O95831-1	0	1839	ENST00000319908.8	174	2007	+	25	O95831-1#111	0	12	ENST00000319908.8	1389	1401	+	12	0	0	2103
O95831-1#111	0	12	12	O95831-1	1218	1230	+	12	O95831-1	0	1839	ENST00000287295.8	185	2024	++	16	O95831-1#111	0	12	ENST00000287295.8	1403	1415	+	12	0	0	2104
O95831-1#112	0	9	9	O95831-1	1245	1254	+	9	O95831-1	0	1839	ENST00000676436.1	34	1861	+	255	O95831-1#112	0	9	ENST00000676436.1	1267	1276	+	9	0	0	2105
O95831-1#112	0	9	9	O95831-1	1245	1254	+	9	O95831-1	0	1839	ENST00000676328.1	56	1892	+	254	O95831-1#112	0	9	ENST00000676328.1	1298	1307	+	9	0	0	2106
O95831-1#112	0	9	9	O95831-1	1245	1254	+	9	O95831-1	0	1839	ENST00000676229.1	223	2050	++	253	O95831-1#112	0	9	ENST00000676229.1	1456	1465	+	9	0	0	2107
O95831-1#112	0	9	9	O95831-1	1245	1254	+	9	O95831-1	0	1839	ENST00000675857.1	82	1915	+	251	O95831-1#112	0	9	ENST00000675857.1	1321	1330	+	9	0	0	2108
O95831-1#112	0	9	9	O95831-1	1245	1254	+	9	O95831-1	0	1839	ENST00000675427.1	89	1925	+	249	O95831-1#112	0	9	ENST00000675427.1	1334	1343	+	9	0	0	2109
O95831-1#112	0	9	9	O95831-1	1245	1254	+	9	O95831-1	0	1762	ENST00000675240.1	169	1867	+	248	O95831-1#112	0	9	ENST00000675240.1	1414	1423	+	9	0	0	2110
O95831-1#112	0	9	9	O95831-1	1245	1254	+	9	O95831-1	0	1839	ENST00000675092.1	90	1956	+	247	O95831-1#112	0	9	ENST00000675092.1	1335	1344	+	9	0	0	2111
O95831-1#112	0	9	9	O95831-1	1245	1254	+	9	O95831-1	0	1839	ENST00000675050.1	71	1898	++	246	O95831-1#112	0	9	ENST00000675050.1	1304	1313	+	9	0	0	2112
O95831-1#112	0	9	9	O95831-1	1245	1254	+	9	O95831-1	0	1454	ENST00000675037.1	56	1439	+	245	O95831-1#112	0	9	ENST00000675037.1	1301	1310	+	9	0	0	2113
O95831-1#112	0	9	9	O95831-1	1245	1254	+	9	O95831-1	0	1762	ENST00000674546.1	185	1955	+	239	O95831-1#112	0	9	ENST00000674546.1	1430	1439	+	9	0	0	2114
O95831-1#112	0	9	9	O95831-1	1245	1254	+	9	O95831-1	1017	1839	ENST00000460436.6	905	1727	+	105	O95831-1#112	0	9	ENST00000460436.6	1133	1142	+	9	0	0	2115
O95831-1#112	0	9	9	O95831-1	1245	1254	+	9	O95831-1	0	1336	ENST00000416073.7	37	1363	+	76	O95831-1#112	0	9	ENST00000416073.7	1276	1285	+	9	0	0	2116
O95831-1#112	0	9	9	O95831-1	1245	1254	+	9	O95831-1	0	1839	ENST00000346424.6	24	1002	++	34	O95831-1#112	0	9	ENST00000346424.6	408	417	+	9	0	0	2117
O95831-1#112	0	9	9	O95831-1	1245	1254	+	9	O95831-1	0	1839	ENST00000319908.8	174	2007	+	25	O95831-1#112	0	9	ENST00000319908.8	1416	1425	+	9	0	0	2118
O95831-1#112	0	9	9	O95831-1	1245	1254	+	9	O95831-1	0	1839	ENST00000287295.8	185	2024	++	16	O95831-1#112	0	9	ENST00000287295.8	1430	1439	+	9	0	0	2119
O95831-1#113	0	9	9	O95831-1	1257	1266	+	9	O95831-1	0	1839	ENST00000676436.1	34	1861	+	255	O95831-1#113	0	9	ENST00000676436.1	1279	1288	+	9	0	0	2120
O95831-1#113	0	9	9	O95831-1	1257	1266	+	9	O95831-1	0	1839	ENST00000676328.1	56	1892	+	254	O95831-1#113	0	9	ENST00000676328.1	1310	1319	+	9	0	0	2121
O95831-1#113	0	9	9	O95831-1	1257	1266	+	9	O95831-1	0	1839	ENST00000676229.1	223	2050	++	253	O95831-1#113	0	9	ENST00000676229.1	1468	1477	+	9	0	0	2122
O95831-1#113	0	9	9	O95831-1	1257	1266	+	9	O95831-1	0	1839	ENST00000675857.1	82	1915	+	251	O95831-1#113	0	9	ENST00000675857.1	1333	1342	+	9	0	0	2123
O95831-1#113	0	9	9	O95831-1	1257	1266	+	9	O95831-1	0	1839	ENST00000675427.1	89	1925	+	249	O95831-1#113	0	9	ENST00000675427.1	1346	1355	+	9	0	0	2124
O95831-1#113	0	9	9	O95831-1	1257	1266	+	9	O95831-1	0	1762	ENST00000675240.1	169	1867	+	248	O95831-1#113	0	9	ENST00000675240.1	1426	1435	+	9	0	0	2125
O95831-1#113	0	9	9	O95831-1	1257	1266	+	9	O95831-1	0	1839	ENST00000675092.1	90	1956	+	247	O95831-1#113	0	9	ENST00000675092.1	1347	1356	+	9	0	0	2126
O95831-1#113	0	9	9	O95831-1	1257	1266	+	9	O95831-1	0	1839	ENST00000675050.1	71	1898	++	246	O95831-1#113	0	9	ENST00000675050.1	1316	1325	+	9	0	0	2127
O95831-1#113	0	9	9	O95831-1	1257	1266	+	9	O95831-1	0	1454	ENST00000675037.1	56	1439	+	245	O95831-1#113	0	9	ENST00000675037.1	1313	1322	+	9	0	0	2128
O95831-1#113	0	9	9	O95831-1	1257	1266	+	9	O95831-1	0	1762	ENST00000674546.1	185	1955	+	239	O95831-1#113	0	9	ENST00000674546.1	1442	1451	+	9	0	0	2129
O95831-1#113	0	9	9	O95831-1	1257	1266	+	9	O95831-1	1017	1839	ENST00000460436.6	905	1727	+	105	O95831-1#113	0	9	ENST00000460436.6	1145	1154	+	9	0	0	2130
O95831-1#113	0	9	9	O95831-1	1257	1266	+	9	O95831-1	0	1336	ENST00000416073.7	37	1363	+	76	O95831-1#113	0	9	ENST00000416073.7	1288	1297	+	9	0	0	2131
O95831-1#113	0	9	9	O95831-1	1257	1266	+	9	O95831-1	0	1839	ENST00000346424.6	24	1002	++	34	O95831-1#113	0	9	ENST00000346424.6	420	429	+	9	0	0	2132
O95831-1#113	0	9	9	O95831-1	1257	1266	+	9	O95831-1	0	1839	ENST00000319908.8	174	2007	+	25	O95831-1#113	0	9	ENST00000319908.8	1428	1437	+	9	0	0	2133
O95831-1#113	0	9	9	O95831-1	1257	1266	+	9	O95831-1	0	1839	ENST00000287295.8	185	2024	++	16	O95831-1#113	0	9	ENST00000287295.8	1442	1451	+	9	0	0	2134
O95831-1#114	0	12	12	O95831-1	1278	1290	+	12	O95831-1	0	1839	ENST00000676436.1	34	1861	+	255	O95831-1#114	0	12	ENST00000676436.1	1300	1312	+	12	0	0	2135
O95831-1#114	0	12	12	O95831-1	1278	1290	+	12	O95831-1	0	1839	ENST00000676328.1	56	1892	+	254	O95831-1#114	0	12	ENST00000676328.1	1331	1343	+	12	0	0	2136
O95831-1#114	0	12	12	O95831-1	1278	1290	+	12	O95831-1	0	1839	ENST00000676229.1	223	2050	++	253	O95831-1#114	0	12	ENST00000676229.1	1489	1501	+	12	0	0	2137
O95831-1#114	0	12	12	O95831-1	1278	1290	+	12	O95831-1	0	1839	ENST00000675857.1	82	1915	+	251	O95831-1#114	0	12	ENST00000675857.1	1354	1366	+	12	0	0	2138
O95831-1#114	0	12	12	O95831-1	1278	1290	+	12	O95831-1	0	1839	ENST00000675427.1	89	1925	+	249	O95831-1#114	0	12	ENST00000675427.1	1367	1379	+	12	0	0	2139
O95831-1#114	0	12	12	O95831-1	1278	1290	+	12	O95831-1	0	1762	ENST00000675240.1	169	1867	+	248	O95831-1#114	0	12	ENST00000675240.1	1447	1459	+	12	0	0	2140
O95831-1#114	0	12	12	O95831-1	1278	1290	+	12	O95831-1	0	1839	ENST00000675092.1	90	1956	+	247	O95831-1#114	0	12	ENST00000675092.1	1368	1380	+	12	0	0	2141
O95831-1#114	0	12	12	O95831-1	1278	1290	+	12	O95831-1	0	1839	ENST00000675050.1	71	1898	++	246	O95831-1#114	0	12	ENST00000675050.1	1337	1349	+	12	0	0	2142
O95831-1#114	0	12	12	O95831-1	1278	1290	+	12	O95831-1	0	1454	ENST00000675037.1	56	1439	+	245	O95831-1#114	0	12	ENST00000675037.1	1334	1346	+	12	0	0	2143
O95831-1#114	0	12	12	O95831-1	1278	1290	+	12	O95831-1	0	1762	ENST00000674546.1	185	1955	+	239	O95831-1#114	0	12	ENST00000674546.1	1463	1475	+	12	0	0	2144
O95831-1#114	0	12	12	O95831-1	1278	1290	+	12	O95831-1	1017	1839	ENST00000460436.6	905	1727	+	105	O95831-1#114	0	12	ENST00000460436.6	1166	1178	+	12	0	0	2145
O95831-1#114	0	12	12	O95831-1	1278	1290	+	12	O95831-1	0	1336	ENST00000416073.7	37	1363	+	76	O95831-1#114	0	12	ENST00000416073.7	1309	1321	+	12	0	0	2146
O95831-1#114	0	12	12	O95831-1	1278	1290	+	12	O95831-1	0	1839	ENST00000346424.6	24	1002	++	34	O95831-1#114	0	12	ENST00000346424.6	441	453	+	12	0	0	2147
O95831-1#114	0	12	12	O95831-1	1278	1290	+	12	O95831-1	0	1839	ENST00000319908.8	174	2007	+	25	O95831-1#114	0	12	ENST00000319908.8	1449	1461	+	12	0	0	2148
O95831-1#114	0	12	12	O95831-1	1278	1290	+	12	O95831-1	0	1839	ENST00000287295.8	185	2024	++	16	O95831-1#114	0	12	ENST00000287295.8	1463	1475	+	12	0	0	2149
O95831-1#115	0	9	9	O95831-1	1296	1305	+	9	O95831-1	0	1839	ENST00000676436.1	34	1861	+	255	O95831-1#115	0	9	ENST00000676436.1	1318	1327	+	9	0	0	2150
O95831-1#115	0	9	9	O95831-1	1296	1305	+	9	O95831-1	0	1839	ENST00000676328.1	56	1892	+	254	O95831-1#115	0	9	ENST00000676328.1	1349	1358	+	9	0	0	2151
O95831-1#115	0	9	9	O95831-1	1296	1305	+	9	O95831-1	0	1839	ENST00000676229.1	223	2050	++	253	O95831-1#115	0	9	ENST00000676229.1	1507	1516	+	9	0	0	2152
O95831-1#115	0	9	9	O95831-1	1296	1305	+	9	O95831-1	0	1839	ENST00000675857.1	82	1915	+	251	O95831-1#115	0	9	ENST00000675857.1	1372	1381	+	9	0	0	2153
O95831-1#115	0	9	9	O95831-1	1296	1305	+	9	O95831-1	0	1839	ENST00000675427.1	89	1925	+	249	O95831-1#115	0	6	ENST00000675427.1	1385	1391	+	6	0	3	2154
O95831-1#115	0	9	9	O95831-1	1296	1305	+	9	O95831-1	0	1762	ENST00000675240.1	169	1867	+	248	O95831-1#115	0	9	ENST00000675240.1	1465	1474	+	9	0	0	2155
O95831-1#115	0	9	9	O95831-1	1296	1305	+	9	O95831-1	0	1839	ENST00000675092.1	90	1956	+	247	O95831-1#115	0	9	ENST00000675092.1	1386	1395	+	9	0	0	2156
O95831-1#115	0	9	9	O95831-1	1296	1305	+	9	O95831-1	0	1839	ENST00000675050.1	71	1898	++	246	O95831-1#115	0	9	ENST00000675050.1	1355	1364	+	9	0	0	2157
O95831-1#115	0	9	9	O95831-1	1296	1305	+	9	O95831-1	0	1454	ENST00000675037.1	56	1439	+	245	O95831-1#115	0	9	ENST00000675037.1	1352	1361	+	9	0	0	2158
O95831-1#115	0	9	9	O95831-1	1296	1305	+	9	O95831-1	0	1762	ENST00000674546.1	185	1955	+	239	O95831-1#115	0	9	ENST00000674546.1	1481	1490	+	9	0	0	2159
O95831-1#115	0	9	9	O95831-1	1296	1305	+	9	O95831-1	1017	1839	ENST00000460436.6	905	1727	+	105	O95831-1#115	0	9	ENST00000460436.6	1184	1193	+	9	0	0	2160
O95831-1#115	0	9	9	O95831-1	1296	1305	+	9	O95831-1	0	1336	ENST00000416073.7	37	1363	+	76	O95831-1#115	0	9	ENST00000416073.7	1327	1336	+	9	0	0	2161
O95831-1#115	0	9	9	O95831-1	1296	1305	+	9	O95831-1	0	1839	ENST00000346424.6	24	1002	++	34	O95831-1#115	0	9	ENST00000346424.6	459	468	+	9	0	0	2162
O95831-1#115	0	9	9	O95831-1	1296	1305	+	9	O95831-1	0	1839	ENST00000319908.8	174	2007	+	25	O95831-1#115	0	9	ENST00000319908.8	1467	1476	+	9	0	0	2163
O95831-1#115	0	9	9	O95831-1	1296	1305	+	9	O95831-1	0	1839	ENST00000287295.8	185	2024	++	16	O95831-1#115	0	9	ENST00000287295.8	1481	1490	+	9	0	0	2164
O95831-1#116	0	9	9	O95831-1	1308	1317	+	9	O95831-1	0	1839	ENST00000676436.1	34	1861	+	255	O95831-1#116	0	9	ENST00000676436.1	1330	1339	+	9	0	0	2165
O95831-1#116	0	9	9	O95831-1	1308	1317	+	9	O95831-1	0	1839	ENST00000676328.1	56	1892	+	254	O95831-1#116	0	9	ENST00000676328.1	1361	1370	+	9	0	0	2166
O95831-1#116	0	9	9	O95831-1	1308	1317	+	9	O95831-1	0	1839	ENST00000676229.1	223	2050	++	253	O95831-1#116	0	9	ENST00000676229.1	1519	1528	+	9	0	0	2167
O95831-1#116	0	9	9	O95831-1	1308	1317	+	9	O95831-1	0	1839	ENST00000675857.1	82	1915	+	251	O95831-1#116	0	9	ENST00000675857.1	1384	1393	+	9	0	0	2168
O95831-1#116	0	9	9	O95831-1	1308	1317	+	9	O95831-1	0	1839	ENST00000675427.1	89	1925	+	249	O95831-1#116	0	9	ENST00000675427.1	1394	1403	+	9	0	0	2169
O95831-1#116	0	9	9	O95831-1	1308	1317	+	9	O95831-1	0	1762	ENST00000675240.1	169	1867	+	248	O95831-1#116	0	9	ENST00000675240.1	1477	1486	+	9	0	0	2170
O95831-1#116	0	9	9	O95831-1	1308	1317	+	9	O95831-1	0	1839	ENST00000675092.1	90	1956	+	247	O95831-1#116	0	9	ENST00000675092.1	1398	1407	+	9	0	0	2171
O95831-1#116	0	9	9	O95831-1	1308	1317	+	9	O95831-1	0	1839	ENST00000675050.1	71	1898	++	246	O95831-1#116	0	9	ENST00000675050.1	1367	1376	+	9	0	0	2172
O95831-1#116	0	9	9	O95831-1	1308	1317	+	9	O95831-1	0	1454	ENST00000675037.1	56	1439	+	245	O95831-1#116	0	9	ENST00000675037.1	1364	1373	+	9	0	0	2173
O95831-1#116	0	9	9	O95831-1	1308	1317	+	9	O95831-1	1012	1839	ENST00000674601.1	0	686	+	241	O95831-1#116	0	9	ENST00000674601.1	155	164	+	9	0	0	2174
O95831-1#116	0	9	9	O95831-1	1308	1317	+	9	O95831-1	0	1762	ENST00000674546.1	185	1955	+	239	O95831-1#116	0	9	ENST00000674546.1	1493	1502	+	9	0	0	2175
O95831-1#116	0	9	9	O95831-1	1308	1317	+	9	O95831-1	1017	1839	ENST00000460436.6	905	1727	+	105	O95831-1#116	0	9	ENST00000460436.6	1196	1205	+	9	0	0	2176
O95831-1#116	0	9	9	O95831-1	1308	1317	+	9	O95831-1	0	1336	ENST00000416073.7	37	1363	+	76	O95831-1#116	1	9	ENST00000416073.7	1336	1344	+	8	1	0	2177
O95831-1#116	0	9	9	O95831-1	1308	1317	+	9	O95831-1	0	1839	ENST00000346424.6	24	1002	++	34	O95831-1#116	0	9	ENST00000346424.6	471	480	+	9	0	0	2178
O95831-1#116	0	9	9	O95831-1	1308	1317	+	9	O95831-1	0	1839	ENST00000319908.8	174	2007	+	25	O95831-1#116	0	9	ENST00000319908.8	1479	1488	+	9	0	0	2179
O95831-1#116	0	9	9	O95831-1	1308	1317	+	9	O95831-1	0	1839	ENST00000287295.8	185	2024	++	16	O95831-1#116	0	9	ENST00000287295.8	1493	1502	+	9	0	0	2180
O95831-1#117	0	15	15	O95831-1	1317	1332	+	15	O95831-1	0	1839	ENST00000676436.1	34	1861	+	255	O95831-1#117	0	15	ENST00000676436.1	1339	1354	+	15	0	0	2181
O95831-1#117	0	15	15	O95831-1	1317	1332	+	15	O95831-1	0	1839	ENST00000676328.1	56	1892	+	254	O95831-1#117	0	15	ENST00000676328.1	1370	1385	+	15	0	0	2182
O95831-1#117	0	15	15	O95831-1	1317	1332	+	15	O95831-1	0	1839	ENST00000676229.1	223	2050	++	253	O95831-1#117	0	15	ENST00000676229.1	1528	1543	+	15	0	0	2183
O95831-1#117	0	15	15	O95831-1	1317	1332	+	15	O95831-1	0	1839	ENST00000675857.1	82	1915	+	251	O95831-1#117	0	15	ENST00000675857.1	1393	1408	+	15	0	0	2184
O95831-1#117	0	15	15	O95831-1	1317	1332	+	15	O95831-1	0	1839	ENST00000675427.1	89	1925	+	249	O95831-1#117	0	15	ENST00000675427.1	1403	1418	+	15	0	0	2185
O95831-1#117	0	15	15	O95831-1	1317	1332	+	15	O95831-1	0	1762	ENST00000675240.1	169	1867	+	248	O95831-1#117	0	15	ENST00000675240.1	1486	1501	+	15	0	0	2186
O95831-1#117	0	15	15	O95831-1	1317	1332	+	15	O95831-1	0	1839	ENST00000675092.1	90	1956	+	247	O95831-1#117	0	15	ENST00000675092.1	1407	1422	+	15	0	0	2187
O95831-1#117	0	15	15	O95831-1	1317	1332	+	15	O95831-1	0	1839	ENST00000675050.1	71	1898	++	246	O95831-1#117	0	15	ENST00000675050.1	1376	1391	+	15	0	0	2188
O95831-1#117	0	15	15	O95831-1	1317	1332	+	15	O95831-1	0	1454	ENST00000675037.1	56	1439	+	245	O95831-1#117	0	15	ENST00000675037.1	1373	1388	+	15	0	0	2189
O95831-1#117	0	15	15	O95831-1	1317	1332	+	15	O95831-1	1012	1839	ENST00000674601.1	0	686	+	241	O95831-1#117	0	15	ENST00000674601.1	164	179	+	15	0	0	2190
O95831-1#117	0	15	15	O95831-1	1317	1332	+	15	O95831-1	0	1762	ENST00000674546.1	185	1955	+	239	O95831-1#117	0	15	ENST00000674546.1	1502	1517	+	15	0	0	2191
O95831-1#117	0	15	15	O95831-1	1317	1332	+	15	O95831-1	1017	1839	ENST00000460436.6	905	1727	+	105	O95831-1#117	0	15	ENST00000460436.6	1205	1220	+	15	0	0	2192
O95831-1#117	0	15	15	O95831-1	1317	1332	+	15	O95831-1	0	1336	ENST00000416073.7	37	1363	+	76	O95831-1#117	0	15	ENST00000416073.7	1344	1359	+	15	0	0	2193
O95831-1#117	0	15	15	O95831-1	1317	1332	+	15	O95831-1	0	1839	ENST00000346424.6	24	1002	++	34	O95831-1#117	0	15	ENST00000346424.6	480	495	+	15	0	0	2194
O95831-1#117	0	15	15	O95831-1	1317	1332	+	15	O95831-1	0	1839	ENST00000319908.8	174	2007	+	25	O95831-1#117	0	15	ENST00000319908.8	1488	1503	+	15	0	0	2195
O95831-1#117	0	15	15	O95831-1	1317	1332	+	15	O95831-1	0	1839	ENST00000287295.8	185	2024	++	16	O95831-1#117	0	15	ENST00000287295.8	1502	1517	+	15	0	0	2196
O95831-1#118	0	9	9	O95831-1	1332	1341	+	9	O95831-1	0	1839	ENST00000676436.1	34	1861	+	255	O95831-1#118	0	9	ENST00000676436.1	1354	1363	+	9	0	0	2197
O95831-1#118	0	9	9	O95831-1	1332	1341	+	9	O95831-1	0	1839	ENST00000676328.1	56	1892	+	254	O95831-1#118	0	9	ENST00000676328.1	1385	1394	+	9	0	0	2198
O95831-1#118	0	9	9	O95831-1	1332	1341	+	9	O95831-1	0	1839	ENST00000676229.1	223	2050	++	253	O95831-1#118	0	9	ENST00000676229.1	1543	1552	+	9	0	0	2199
O95831-1#118	0	9	9	O95831-1	1332	1341	+	9	O95831-1	0	1839	ENST00000675857.1	82	1915	+	251	O95831-1#118	0	9	ENST00000675857.1	1408	1417	+	9	0	0	2200
O95831-1#118	0	9	9	O95831-1	1332	1341	+	9	O95831-1	0	1839	ENST00000675427.1	89	1925	+	249	O95831-1#118	0	9	ENST00000675427.1	1418	1427	+	9	0	0	2201
O95831-1#118	0	9	9	O95831-1	1332	1341	+	9	O95831-1	0	1762	ENST00000675240.1	169	1867	+	248	O95831-1#118	0	9	ENST00000675240.1	1501	1510	+	9	0	0	2202
O95831-1#118	0	9	9	O95831-1	1332	1341	+	9	O95831-1	0	1839	ENST00000675092.1	90	1956	+	247	O95831-1#118	0	9	ENST00000675092.1	1422	1431	+	9	0	0	2203
O95831-1#118	0	9	9	O95831-1	1332	1341	+	9	O95831-1	0	1839	ENST00000675050.1	71	1898	++	246	O95831-1#118	0	9	ENST00000675050.1	1391	1400	+	9	0	0	2204
O95831-1#118	0	9	9	O95831-1	1332	1341	+	9	O95831-1	0	1454	ENST00000675037.1	56	1439	+	245	O95831-1#118	0	9	ENST00000675037.1	1388	1397	+	9	0	0	2205
O95831-1#118	0	9	9	O95831-1	1332	1341	+	9	O95831-1	1012	1839	ENST00000674601.1	0	686	+	241	O95831-1#118	0	9	ENST00000674601.1	179	188	+	9	0	0	2206
O95831-1#118	0	9	9	O95831-1	1332	1341	+	9	O95831-1	0	1762	ENST00000674546.1	185	1955	+	239	O95831-1#118	0	9	ENST00000674546.1	1517	1526	+	9	0	0	2207
O95831-1#118	0	9	9	O95831-1	1332	1341	+	9	O95831-1	1017	1839	ENST00000460436.6	905	1727	+	105	O95831-1#118	0	9	ENST00000460436.6	1220	1229	+	9	0	0	2208
O95831-1#118	0	9	9	O95831-1	1332	1341	+	9	O95831-1	0	1336	ENST00000416073.7	37	1363	+	76	O95831-1#118	0	4	ENST00000416073.7	1359	1363	+	4	0	5	2209
O95831-1#118	0	9	9	O95831-1	1332	1341	+	9	O95831-1	0	1839	ENST00000346424.6	24	1002	++	34	O95831-1#118	0	9	ENST00000346424.6	495	504	+	9	0	0	2210
O95831-1#118	0	9	9	O95831-1	1332	1341	+	9	O95831-1	0	1839	ENST00000319908.8	174	2007	+	25	O95831-1#118	0	9	ENST00000319908.8	1503	1512	+	9	0	0	2211
O95831-1#118	0	9	9	O95831-1	1332	1341	+	9	O95831-1	0	1839	ENST00000287295.8	185	2024	++	16	O95831-1#118	0	9	ENST00000287295.8	1517	1526	+	9	0	0	2212
O95831-1#119	0	9	9	O95831-1	1341	1350	+	9	O95831-1	0	1839	ENST00000676436.1	34	1861	+	255	O95831-1#119	0	9	ENST00000676436.1	1363	1372	+	9	0	0	2213
O95831-1#119	0	9	9	O95831-1	1341	1350	+	9	O95831-1	0	1839	ENST00000676328.1	56	1892	+	254	O95831-1#119	0	9	ENST00000676328.1	1394	1403	+	9	0	0	2214
O95831-1#119	0	9	9	O95831-1	1341	1350	+	9	O95831-1	0	1839	ENST00000676229.1	223	2050	++	253	O95831-1#119	0	9	ENST00000676229.1	1552	1561	+	9	0	0	2215
O95831-1#119	0	9	9	O95831-1	1341	1350	+	9	O95831-1	0	1839	ENST00000675857.1	82	1915	+	251	O95831-1#119	0	9	ENST00000675857.1	1417	1426	+	9	0	0	2216
O95831-1#119	0	9	9	O95831-1	1341	1350	+	9	O95831-1	0	1839	ENST00000675427.1	89	1925	+	249	O95831-1#119	0	9	ENST00000675427.1	1427	1436	+	9	0	0	2217
O95831-1#119	0	9	9	O95831-1	1341	1350	+	9	O95831-1	0	1762	ENST00000675240.1	169	1867	+	248	O95831-1#119	0	9	ENST00000675240.1	1510	1519	+	9	0	0	2218
O95831-1#119	0	9	9	O95831-1	1341	1350	+	9	O95831-1	0	1839	ENST00000675092.1	90	1956	+	247	O95831-1#119	0	9	ENST00000675092.1	1431	1440	+	9	0	0	2219
O95831-1#119	0	9	9	O95831-1	1341	1350	+	9	O95831-1	0	1839	ENST00000675050.1	71	1898	++	246	O95831-1#119	0	9	ENST00000675050.1	1400	1409	+	9	0	0	2220
O95831-1#119	0	9	9	O95831-1	1341	1350	+	9	O95831-1	0	1454	ENST00000675037.1	56	1439	+	245	O95831-1#119	0	9	ENST00000675037.1	1397	1406	+	9	0	0	2221
O95831-1#119	0	9	9	O95831-1	1341	1350	+	9	O95831-1	1012	1839	ENST00000674601.1	0	686	+	241	O95831-1#119	0	9	ENST00000674601.1	188	197	+	9	0	0	2222
O95831-1#119	0	9	9	O95831-1	1341	1350	+	9	O95831-1	0	1762	ENST00000674546.1	185	1955	+	239	O95831-1#119	0	9	ENST00000674546.1	1526	1535	+	9	0	0	2223
O95831-1#119	0	9	9	O95831-1	1341	1350	+	9	O95831-1	1017	1839	ENST00000460436.6	905	1727	+	105	O95831-1#119	0	9	ENST00000460436.6	1229	1238	+	9	0	0	2224
O95831-1#119	0	9	9	O95831-1	1341	1350	+	9	O95831-1	0	1839	ENST00000346424.6	24	1002	++	34	O95831-1#119	0	9	ENST00000346424.6	504	513	+	9	0	0	2225
O95831-1#119	0	9	9	O95831-1	1341	1350	+	9	O95831-1	0	1839	ENST00000319908.8	174	2007	+	25	O95831-1#119	0	9	ENST00000319908.8	1512	1521	+	9	0	0	2226
O95831-1#119	0	9	9	O95831-1	1341	1350	+	9	O95831-1	0	1839	ENST00000287295.8	185	2024	++	16	O95831-1#119	0	9	ENST00000287295.8	1526	1535	+	9	0	0	2227
O95831-1#120	0	42	42	O95831-1	1362	1404	+	42	O95831-1	0	1839	ENST00000676436.1	34	1861	+	255	O95831-1#120	0	42	ENST00000676436.1	1384	1426	+	42	0	0	2228
O95831-1#120	0	42	42	O95831-1	1362	1404	+	42	O95831-1	0	1839	ENST00000676328.1	56	1892	+	254	O95831-1#120	0	42	ENST00000676328.1	1415	1457	+	42	0	0	2229
O95831-1#120	0	42	42	O95831-1	1362	1404	+	42	O95831-1	0	1839	ENST00000676229.1	223	2050	++	253	O95831-1#120	0	42	ENST00000676229.1	1573	1615	+	42	0	0	2230
O95831-1#120	0	42	42	O95831-1	1362	1404	+	42	O95831-1	0	1839	ENST00000675857.1	82	1915	+	251	O95831-1#120	0	42	ENST00000675857.1	1438	1480	+	42	0	0	2231
O95831-1#120	0	42	42	O95831-1	1362	1404	+	42	O95831-1	0	1839	ENST00000675427.1	89	1925	+	249	O95831-1#120	0	42	ENST00000675427.1	1448	1490	+	42	0	0	2232
O95831-1#120	0	42	42	O95831-1	1362	1404	+	42	O95831-1	0	1762	ENST00000675240.1	169	1867	+	248	O95831-1#120	0	42	ENST00000675240.1	1531	1573	+	42	0	0	2233
O95831-1#120	0	42	42	O95831-1	1362	1404	+	42	O95831-1	0	1839	ENST00000675092.1	90	1956	+	247	O95831-1#120	0	42	ENST00000675092.1	1452	1494	+	42	0	0	2234
O95831-1#120	0	42	42	O95831-1	1362	1404	+	42	O95831-1	0	1839	ENST00000675050.1	71	1898	++	246	O95831-1#120	0	42	ENST00000675050.1	1421	1463	+	42	0	0	2235
O95831-1#120	0	42	42	O95831-1	1362	1404	+	42	O95831-1	0	1454	ENST00000675037.1	56	1439	+	245	O95831-1#120	0	15	ENST00000675037.1	1418	1433	+	15	0	27	2236
O95831-1#120	0	42	42	O95831-1	1362	1404	+	42	O95831-1	1012	1839	ENST00000674601.1	0	686	+	241	O95831-1#120	0	42	ENST00000674601.1	209	251	+	42	0	0	2237
O95831-1#120	0	42	42	O95831-1	1362	1404	+	42	O95831-1	0	1762	ENST00000674546.1	185	1955	+	239	O95831-1#120	0	42	ENST00000674546.1	1547	1589	+	42	0	0	2238
O95831-1#120	0	42	42	O95831-1	1362	1404	+	42	O95831-1	1017	1839	ENST00000460436.6	905	1727	+	105	O95831-1#120	0	42	ENST00000460436.6	1250	1292	+	42	0	0	2239
O95831-1#120	0	42	42	O95831-1	1362	1404	+	42	O95831-1	0	1839	ENST00000346424.6	24	1002	++	34	O95831-1#120	0	42	ENST00000346424.6	525	567	+	42	0	0	2240
O95831-1#120	0	42	42	O95831-1	1362	1404	+	42	O95831-1	0	1839	ENST00000319908.8	174	2007	+	25	O95831-1#120	0	42	ENST00000319908.8	1533	1575	+	42	0	0	2241
O95831-1#120	0	42	42	O95831-1	1362	1404	+	42	O95831-1	0	1839	ENST00000287295.8	185	2024	++	16	O95831-1#120	0	42	ENST00000287295.8	1547	1589	+	42	0	0	2242
O95831-1#121	0	9	9	O95831-1	1404	1413	+	9	O95831-1	0	1839	ENST00000676436.1	34	1861	+	255	O95831-1#121	0	9	ENST00000676436.1	1426	1435	+	9	0	0	2243
O95831-1#121	0	9	9	O95831-1	1404	1413	+	9	O95831-1	0	1839	ENST00000676328.1	56	1892	+	254	O95831-1#121	0	9	ENST00000676328.1	1457	1466	+	9	0	0	2244
O95831-1#121	0	9	9	O95831-1	1404	1413	+	9	O95831-1	0	1839	ENST00000676229.1	223	2050	++	253	O95831-1#121	0	9	ENST00000676229.1	1615	1624	+	9	0	0	2245
O95831-1#121	0	9	9	O95831-1	1404	1413	+	9	O95831-1	0	1839	ENST00000675857.1	82	1915	+	251	O95831-1#121	0	9	ENST00000675857.1	1480	1489	+	9	0	0	2246
O95831-1#121	0	9	9	O95831-1	1404	1413	+	9	O95831-1	0	1839	ENST00000675427.1	89	1925	+	249	O95831-1#121	0	9	ENST00000675427.1	1490	1499	+	9	0	0	2247
O95831-1#121	0	9	9	O95831-1	1404	1413	+	9	O95831-1	0	1762	ENST00000675240.1	169	1867	+	248	O95831-1#121	0	9	ENST00000675240.1	1573	1582	+	9	0	0	2248
O95831-1#121	0	9	9	O95831-1	1404	1413	+	9	O95831-1	0	1839	ENST00000675092.1	90	1956	+	247	O95831-1#121	0	9	ENST00000675092.1	1494	1503	+	9	0	0	2249
O95831-1#121	0	9	9	O95831-1	1404	1413	+	9	O95831-1	0	1839	ENST00000675050.1	71	1898	++	246	O95831-1#121	0	9	ENST00000675050.1	1463	1472	+	9	0	0	2250
O95831-1#121	0	9	9	O95831-1	1404	1413	+	9	O95831-1	1012	1839	ENST00000674601.1	0	686	+	241	O95831-1#121	0	9	ENST00000674601.1	251	260	+	9	0	0	2251
O95831-1#121	0	9	9	O95831-1	1404	1413	+	9	O95831-1	0	1762	ENST00000674546.1	185	1955	+	239	O95831-1#121	0	9	ENST00000674546.1	1589	1598	+	9	0	0	2252
O95831-1#121	0	9	9	O95831-1	1404	1413	+	9	O95831-1	1017	1839	ENST00000460436.6	905	1727	+	105	O95831-1#121	0	9	ENST00000460436.6	1292	1301	+	9	0	0	2253
O95831-1#121	0	9	9	O95831-1	1404	1413	+	9	O95831-1	0	1839	ENST00000346424.6	24	1002	++	34	O95831-1#121	0	9	ENST00000346424.6	567	576	+	9	0	0	2254
O95831-1#121	0	9	9	O95831-1	1404	1413	+	9	O95831-1	0	1839	ENST00000319908.8	174	2007	+	25	O95831-1#121	0	9	ENST00000319908.8	1575	1584	+	9	0	0	2255
O95831-1#121	0	9	9	O95831-1	1404	1413	+	9	O95831-1	0	1839	ENST00000287295.8	185	2024	++	16	O95831-1#121	0	9	ENST00000287295.8	1589	1598	+	9	0	0	2256
O95831-1#122	0	21	21	O95831-1	1440	1461	+	21	O95831-1	0	1839	ENST00000676436.1	34	1861	+	255	O95831-1#122	0	21	ENST00000676436.1	1462	1483	+	21	0	0	2257
O95831-1#122	0	21	21	O95831-1	1440	1461	+	21	O95831-1	0	1839	ENST00000676328.1	56	1892	+	254	O95831-1#122	0	21	ENST00000676328.1	1493	1514	+	21	0	0	2258
O95831-1#122	0	21	21	O95831-1	1440	1461	+	21	O95831-1	0	1839	ENST00000676229.1	223	2050	++	253	O95831-1#122	0	21	ENST00000676229.1	1651	1672	+	21	0	0	2259
O95831-1#122	0	21	21	O95831-1	1440	1461	+	21	O95831-1	0	1839	ENST00000675857.1	82	1915	+	251	O95831-1#122	0	21	ENST00000675857.1	1516	1537	+	21	0	0	2260
O95831-1#122	0	21	21	O95831-1	1440	1461	+	21	O95831-1	0	1839	ENST00000675427.1	89	1925	+	249	O95831-1#122	0	21	ENST00000675427.1	1526	1547	+	21	0	0	2261
O95831-1#122	0	21	21	O95831-1	1440	1461	+	21	O95831-1	0	1762	ENST00000675240.1	169	1867	+	248	O95831-1#122	0	21	ENST00000675240.1	1609	1630	+	21	0	0	2262
O95831-1#122	0	21	21	O95831-1	1440	1461	+	21	O95831-1	0	1839	ENST00000675092.1	90	1956	+	247	O95831-1#122	0	21	ENST00000675092.1	1530	1551	+	21	0	0	2263
O95831-1#122	0	21	21	O95831-1	1440	1461	+	21	O95831-1	0	1839	ENST00000675050.1	71	1898	++	246	O95831-1#122	0	21	ENST00000675050.1	1499	1520	+	21	0	0	2264
O95831-1#122	0	21	21	O95831-1	1440	1461	+	21	O95831-1	0	1454	ENST00000675037.1	56	1439	+	245	O95831-1#122	8	14	ENST00000675037.1	1433	1439	+	6	8	7	2265
O95831-1#122	0	21	21	O95831-1	1440	1461	+	21	O95831-1	1012	1839	ENST00000674601.1	0	686	+	241	O95831-1#122	0	21	ENST00000674601.1	287	308	+	21	0	0	2266
O95831-1#122	0	21	21	O95831-1	1440	1461	+	21	O95831-1	0	1762	ENST00000674546.1	185	1955	+	239	O95831-1#122	0	21	ENST00000674546.1	1625	1646	+	21	0	0	2267
O95831-1#122	0	21	21	O95831-1	1440	1461	+	21	O95831-1	1017	1839	ENST00000460436.6	905	1727	+	105	O95831-1#122	0	21	ENST00000460436.6	1328	1349	+	21	0	0	2268
O95831-1#122	0	21	21	O95831-1	1440	1461	+	21	O95831-1	0	1839	ENST00000346424.6	24	1002	++	34	O95831-1#122	0	21	ENST00000346424.6	603	624	+	21	0	0	2269
O95831-1#122	0	21	21	O95831-1	1440	1461	+	21	O95831-1	0	1839	ENST00000319908.8	174	2007	+	25	O95831-1#122	0	21	ENST00000319908.8	1611	1629	+	18	0	0	2270
O95831-1#122	0	21	21	O95831-1	1440	1461	+	21	O95831-1	0	1839	ENST00000287295.8	185	2024	++	16	O95831-1#122	0	21	ENST00000287295.8	1625	1646	+	21	0	0	2271
O95831-1#123	0	18	18	O95831-1	1470	1488	+	18	O95831-1	0	1839	ENST00000676436.1	34	1861	+	255	O95831-1#123	0	18	ENST00000676436.1	1492	1510	+	18	0	0	2272
O95831-1#123	0	18	18	O95831-1	1470	1488	+	18	O95831-1	0	1839	ENST00000676328.1	56	1892	+	254	O95831-1#123	0	18	ENST00000676328.1	1523	1541	+	18	0	0	2273
O95831-1#123	0	18	18	O95831-1	1470	1488	+	18	O95831-1	0	1839	ENST00000676229.1	223	2050	++	253	O95831-1#123	0	18	ENST00000676229.1	1681	1699	+	18	0	0	2274
O95831-1#123	0	18	18	O95831-1	1470	1488	+	18	O95831-1	0	1839	ENST00000675857.1	82	1915	+	251	O95831-1#123	0	18	ENST00000675857.1	1546	1564	+	18	0	0	2275
O95831-1#123	0	18	18	O95831-1	1470	1488	+	18	O95831-1	0	1839	ENST00000675427.1	89	1925	+	249	O95831-1#123	0	18	ENST00000675427.1	1556	1574	+	18	0	0	2276
O95831-1#123	0	18	18	O95831-1	1470	1488	+	18	O95831-1	0	1762	ENST00000675240.1	169	1867	+	248	O95831-1#123	0	18	ENST00000675240.1	1639	1657	+	18	0	0	2277
O95831-1#123	0	18	18	O95831-1	1470	1488	+	18	O95831-1	0	1839	ENST00000675092.1	90	1956	+	247	O95831-1#123	0	18	ENST00000675092.1	1560	1578	+	18	0	0	2278
O95831-1#123	0	18	18	O95831-1	1470	1488	+	18	O95831-1	0	1839	ENST00000675050.1	71	1898	++	246	O95831-1#123	0	18	ENST00000675050.1	1529	1547	+	18	0	0	2279
O95831-1#123	0	18	18	O95831-1	1470	1488	+	18	O95831-1	1012	1839	ENST00000674601.1	0	686	+	241	O95831-1#123	0	18	ENST00000674601.1	317	335	+	18	0	0	2280
O95831-1#123	0	18	18	O95831-1	1470	1488	+	18	O95831-1	0	1762	ENST00000674546.1	185	1955	+	239	O95831-1#123	0	18	ENST00000674546.1	1655	1673	+	18	0	0	2281
O95831-1#123	0	18	18	O95831-1	1470	1488	+	18	O95831-1	1017	1839	ENST00000460436.6	905	1727	+	105	O95831-1#123	0	18	ENST00000460436.6	1358	1376	+	18	0	0	2282
O95831-1#123	0	18	18	O95831-1	1470	1488	+	18	O95831-1	0	1839	ENST00000346424.6	24	1002	++	34	O95831-1#123	0	18	ENST00000346424.6	633	651	+	18	0	0	2283
O95831-1#123	0	18	18	O95831-1	1470	1488	+	18	O95831-1	0	1839	ENST00000319908.8	174	2007	+	25	O95831-1#123	0	18	ENST00000319908.8	1638	1656	+	18	0	0	2284
O95831-1#123	0	18	18	O95831-1	1470	1488	+	18	O95831-1	0	1839	ENST00000287295.8	185	2024	++	16	O95831-1#123	0	18	ENST00000287295.8	1655	1673	+	18	0	0	2285
O95831-1#124	0	18	18	O95831-1	1509	1527	+	18	O95831-1	0	1839	ENST00000676436.1	34	1861	+	255	O95831-1#124	0	18	ENST00000676436.1	1531	1549	+	18	0	0	2286
O95831-1#124	0	18	18	O95831-1	1509	1527	+	18	O95831-1	0	1839	ENST00000676328.1	56	1892	+	254	O95831-1#124	0	18	ENST00000676328.1	1562	1580	+	18	0	0	2287
O95831-1#124	0	18	18	O95831-1	1509	1527	+	18	O95831-1	0	1839	ENST00000676229.1	223	2050	++	253	O95831-1#124	0	18	ENST00000676229.1	1720	1738	+	18	0	0	2288
O95831-1#124	0	18	18	O95831-1	1509	1527	+	18	O95831-1	0	1839	ENST00000675857.1	82	1915	+	251	O95831-1#124	0	18	ENST00000675857.1	1585	1603	+	18	0	0	2289
O95831-1#124	0	18	18	O95831-1	1509	1527	+	18	O95831-1	0	1839	ENST00000675427.1	89	1925	+	249	O95831-1#124	0	18	ENST00000675427.1	1595	1613	+	18	0	0	2290
O95831-1#124	0	18	18	O95831-1	1509	1527	+	18	O95831-1	0	1762	ENST00000675240.1	169	1867	+	248	O95831-1#124	0	18	ENST00000675240.1	1678	1696	+	18	0	0	2291
O95831-1#124	0	18	18	O95831-1	1509	1527	+	18	O95831-1	0	1839	ENST00000675092.1	90	1956	+	247	O95831-1#124	0	18	ENST00000675092.1	1599	1617	+	18	0	0	2292
O95831-1#124	0	18	18	O95831-1	1509	1527	+	18	O95831-1	0	1839	ENST00000675050.1	71	1898	++	246	O95831-1#124	0	18	ENST00000675050.1	1568	1586	+	18	0	0	2293
O95831-1#124	0	18	18	O95831-1	1509	1527	+	18	O95831-1	1012	1839	ENST00000674601.1	0	686	+	241	O95831-1#124	0	18	ENST00000674601.1	356	374	+	18	0	0	2294
O95831-1#124	0	18	18	O95831-1	1509	1527	+	18	O95831-1	0	1762	ENST00000674546.1	185	1955	+	239	O95831-1#124	0	18	ENST00000674546.1	1694	1712	+	18	0	0	2295
O95831-1#124	0	18	18	O95831-1	1509	1527	+	18	O95831-1	1017	1839	ENST00000460436.6	905	1727	+	105	O95831-1#124	0	18	ENST00000460436.6	1397	1415	+	18	0	0	2296
O95831-1#124	0	18	18	O95831-1	1509	1527	+	18	O95831-1	0	1839	ENST00000346424.6	24	1002	++	34	O95831-1#124	0	18	ENST00000346424.6	672	690	+	18	0	0	2297
O95831-1#124	0	18	18	O95831-1	1509	1527	+	18	O95831-1	0	1839	ENST00000319908.8	174	2007	+	25	O95831-1#124	0	18	ENST00000319908.8	1677	1695	+	18	0	0	2298
O95831-1#124	0	18	18	O95831-1	1509	1527	+	18	O95831-1	0	1839	ENST00000287295.8	185	2024	++	16	O95831-1#124	0	18	ENST00000287295.8	1694	1712	+	18	0	0	2299
O95831-1#125	0	9	9	O95831-1	1536	1545	+	9	O95831-1	0	1839	ENST00000676436.1	34	1861	+	255	O95831-1#125	0	9	ENST00000676436.1	1558	1567	+	9	0	0	2300
O95831-1#125	0	9	9	O95831-1	1536	1545	+	9	O95831-1	0	1839	ENST00000676328.1	56	1892	+	254	O95831-1#125	0	9	ENST00000676328.1	1589	1598	+	9	0	0	2301
O95831-1#125	0	9	9	O95831-1	1536	1545	+	9	O95831-1	0	1839	ENST00000676229.1	223	2050	++	253	O95831-1#125	0	9	ENST00000676229.1	1747	1756	+	9	0	0	2302
O95831-1#125	0	9	9	O95831-1	1536	1545	+	9	O95831-1	0	1839	ENST00000675857.1	82	1915	+	251	O95831-1#125	0	9	ENST00000675857.1	1612	1621	+	9	0	0	2303
O95831-1#125	0	9	9	O95831-1	1536	1545	+	9	O95831-1	0	1839	ENST00000675427.1	89	1925	+	249	O95831-1#125	0	9	ENST00000675427.1	1622	1631	+	9	0	0	2304
O95831-1#125	0	9	9	O95831-1	1536	1545	+	9	O95831-1	0	1762	ENST00000675240.1	169	1867	+	248	O95831-1#125	0	9	ENST00000675240.1	1705	1714	+	9	0	0	2305
O95831-1#125	0	9	9	O95831-1	1536	1545	+	9	O95831-1	0	1839	ENST00000675092.1	90	1956	+	247	O95831-1#125	0	9	ENST00000675092.1	1626	1635	+	9	0	0	2306
O95831-1#125	0	9	9	O95831-1	1536	1545	+	9	O95831-1	0	1839	ENST00000675050.1	71	1898	++	246	O95831-1#125	0	9	ENST00000675050.1	1595	1604	+	9	0	0	2307
O95831-1#125	0	9	9	O95831-1	1536	1545	+	9	O95831-1	1012	1839	ENST00000674601.1	0	686	+	241	O95831-1#125	0	9	ENST00000674601.1	383	392	+	9	0	0	2308
O95831-1#125	0	9	9	O95831-1	1536	1545	+	9	O95831-1	0	1762	ENST00000674546.1	185	1955	+	239	O95831-1#125	0	9	ENST00000674546.1	1721	1730	+	9	0	0	2309
O95831-1#125	0	9	9	O95831-1	1536	1545	+	9	O95831-1	1017	1839	ENST00000460436.6	905	1727	+	105	O95831-1#125	0	9	ENST00000460436.6	1424	1433	+	9	0	0	2310
O95831-1#125	0	9	9	O95831-1	1536	1545	+	9	O95831-1	0	1839	ENST00000346424.6	24	1002	++	34	O95831-1#125	0	9	ENST00000346424.6	699	708	+	9	0	0	2311
O95831-1#125	0	9	9	O95831-1	1536	1545	+	9	O95831-1	0	1839	ENST00000319908.8	174	2007	+	25	O95831-1#125	0	9	ENST00000319908.8	1704	1713	+	9	0	0	2312
O95831-1#125	0	9	9	O95831-1	1536	1545	+	9	O95831-1	0	1839	ENST00000287295.8	185	2024	++	16	O95831-1#125	0	9	ENST00000287295.8	1721	1730	+	9	0	0	2313
O95831-1#126	0	24	24	O95831-1	1548	1572	+	24	O95831-1	0	1839	ENST00000676436.1	34	1861	+	255	O95831-1#126	0	24	ENST00000676436.1	1570	1594	+	24	0	0	2314
O95831-1#126	0	24	24	O95831-1	1548	1572	+	24	O95831-1	0	1839	ENST00000676328.1	56	1892	+	254	O95831-1#126	0	24	ENST00000676328.1	1601	1625	+	24	0	0	2315
O95831-1#126	0	24	24	O95831-1	1548	1572	+	24	O95831-1	0	1839	ENST00000676229.1	223	2050	++	253	O95831-1#126	0	24	ENST00000676229.1	1759	1783	+	24	0	0	2316
O95831-1#126	0	24	24	O95831-1	1548	1572	+	24	O95831-1	0	1839	ENST00000675857.1	82	1915	+	251	O95831-1#126	0	24	ENST00000675857.1	1624	1648	+	24	0	0	2317
O95831-1#126	0	24	24	O95831-1	1548	1572	+	24	O95831-1	0	1839	ENST00000675427.1	89	1925	+	249	O95831-1#126	0	24	ENST00000675427.1	1634	1658	+	24	0	0	2318
O95831-1#126	0	24	24	O95831-1	1548	1572	+	24	O95831-1	0	1762	ENST00000675240.1	169	1867	+	248	O95831-1#126	0	24	ENST00000675240.1	1717	1741	+	24	0	0	2319
O95831-1#126	0	24	24	O95831-1	1548	1572	+	24	O95831-1	0	1839	ENST00000675092.1	90	1956	+	247	O95831-1#126	0	24	ENST00000675092.1	1638	1662	+	24	0	0	2320
O95831-1#126	0	24	24	O95831-1	1548	1572	+	24	O95831-1	0	1839	ENST00000675050.1	71	1898	++	246	O95831-1#126	0	24	ENST00000675050.1	1607	1631	+	24	0	0	2321
O95831-1#126	0	24	24	O95831-1	1548	1572	+	24	O95831-1	1012	1839	ENST00000674601.1	0	686	+	241	O95831-1#126	0	24	ENST00000674601.1	395	419	+	24	0	0	2322
O95831-1#126	0	24	24	O95831-1	1548	1572	+	24	O95831-1	0	1762	ENST00000674546.1	185	1955	+	239	O95831-1#126	0	24	ENST00000674546.1	1733	1757	+	24	0	0	2323
O95831-1#126	0	24	24	O95831-1	1548	1572	+	24	O95831-1	1017	1839	ENST00000460436.6	905	1727	+	105	O95831-1#126	0	24	ENST00000460436.6	1436	1460	+	24	0	0	2324
O95831-1#126	0	24	24	O95831-1	1548	1572	+	24	O95831-1	0	1839	ENST00000346424.6	24	1002	++	34	O95831-1#126	0	24	ENST00000346424.6	711	735	+	24	0	0	2325
O95831-1#126	0	24	24	O95831-1	1548	1572	+	24	O95831-1	0	1839	ENST00000319908.8	174	2007	+	25	O95831-1#126	0	24	ENST00000319908.8	1716	1740	+	24	0	0	2326
O95831-1#126	0	24	24	O95831-1	1548	1572	+	24	O95831-1	0	1839	ENST00000287295.8	185	2024	++	16	O95831-1#126	0	24	ENST00000287295.8	1733	1757	+	24	0	0	2327
O95831-1#127	0	15	15	O95831-1	1584	1599	+	15	O95831-1	0	1839	ENST00000676436.1	34	1861	+	255	O95831-1#127	0	15	ENST00000676436.1	1606	1621	+	15	0	0	2328
O95831-1#127	0	15	15	O95831-1	1584	1599	+	15	O95831-1	0	1839	ENST00000676328.1	56	1892	+	254	O95831-1#127	0	15	ENST00000676328.1	1637	1652	+	15	0	0	2329
O95831-1#127	0	15	15	O95831-1	1584	1599	+	15	O95831-1	0	1839	ENST00000676229.1	223	2050	++	253	O95831-1#127	0	15	ENST00000676229.1	1795	1810	+	15	0	0	2330
O95831-1#127	0	15	15	O95831-1	1584	1599	+	15	O95831-1	0	1839	ENST00000675857.1	82	1915	+	251	O95831-1#127	0	15	ENST00000675857.1	1660	1675	+	15	0	0	2331
O95831-1#127	0	15	15	O95831-1	1584	1599	+	15	O95831-1	0	1839	ENST00000675427.1	89	1925	+	249	O95831-1#127	0	15	ENST00000675427.1	1670	1685	+	15	0	0	2332
O95831-1#127	0	15	15	O95831-1	1584	1599	+	15	O95831-1	0	1839	ENST00000675092.1	90	1956	+	247	O95831-1#127	0	15	ENST00000675092.1	1701	1716	+	15	0	0	2333
O95831-1#127	0	15	15	O95831-1	1584	1599	+	15	O95831-1	0	1839	ENST00000675050.1	71	1898	++	246	O95831-1#127	0	15	ENST00000675050.1	1643	1658	+	15	0	0	2334
O95831-1#127	0	15	15	O95831-1	1584	1599	+	15	O95831-1	1012	1839	ENST00000674601.1	0	686	+	241	O95831-1#127	0	15	ENST00000674601.1	431	446	+	15	0	0	2335
O95831-1#127	0	15	15	O95831-1	1584	1599	+	15	O95831-1	0	1762	ENST00000674546.1	185	1955	+	239	O95831-1#127	0	15	ENST00000674546.1	1777	1792	+	15	0	0	2336
O95831-1#127	0	15	15	O95831-1	1584	1599	+	15	O95831-1	1017	1839	ENST00000460436.6	905	1727	+	105	O95831-1#127	0	15	ENST00000460436.6	1472	1487	+	15	0	0	2337
O95831-1#127	0	15	15	O95831-1	1584	1599	+	15	O95831-1	0	1839	ENST00000346424.6	24	1002	++	34	O95831-1#127	0	15	ENST00000346424.6	747	762	+	15	0	0	2338
O95831-1#127	0	15	15	O95831-1	1584	1599	+	15	O95831-1	0	1839	ENST00000319908.8	174	2007	+	25	O95831-1#127	0	15	ENST00000319908.8	1752	1767	+	15	0	0	2339
O95831-1#127	0	15	15	O95831-1	1584	1599	+	15	O95831-1	0	1839	ENST00000287295.8	185	2024	++	16	O95831-1#127	0	15	ENST00000287295.8	1769	1784	+	15	0	0	2340
O95831-1#128	0	15	15	O95831-1	1611	1626	+	15	O95831-1	0	1839	ENST00000676436.1	34	1861	+	255	O95831-1#128	0	15	ENST00000676436.1	1633	1648	+	15	0	0	2341
O95831-1#128	0	15	15	O95831-1	1611	1626	+	15	O95831-1	0	1839	ENST00000676328.1	56	1892	+	254	O95831-1#128	0	15	ENST00000676328.1	1664	1679	+	15	0	0	2342
O95831-1#128	0	15	15	O95831-1	1611	1626	+	15	O95831-1	0	1839	ENST00000676229.1	223	2050	++	253	O95831-1#128	0	15	ENST00000676229.1	1822	1837	+	15	0	0	2343
O95831-1#128	0	15	15	O95831-1	1611	1626	+	15	O95831-1	0	1839	ENST00000675857.1	82	1915	+	251	O95831-1#128	0	15	ENST00000675857.1	1687	1702	+	15	0	0	2344
O95831-1#128	0	15	15	O95831-1	1611	1626	+	15	O95831-1	0	1839	ENST00000675427.1	89	1925	+	249	O95831-1#128	0	15	ENST00000675427.1	1697	1712	+	15	0	0	2345
O95831-1#128	0	15	15	O95831-1	1611	1626	+	15	O95831-1	0	1839	ENST00000675092.1	90	1956	+	247	O95831-1#128	0	15	ENST00000675092.1	1728	1743	+	15	0	0	2346
O95831-1#128	0	15	15	O95831-1	1611	1626	+	15	O95831-1	0	1839	ENST00000675050.1	71	1898	++	246	O95831-1#128	0	15	ENST00000675050.1	1670	1685	+	15	0	0	2347
O95831-1#128	0	15	15	O95831-1	1611	1626	+	15	O95831-1	1012	1839	ENST00000674601.1	0	686	+	241	O95831-1#128	0	15	ENST00000674601.1	458	473	+	15	0	0	2348
O95831-1#128	0	15	15	O95831-1	1611	1626	+	15	O95831-1	0	1762	ENST00000674546.1	185	1955	+	239	O95831-1#128	0	15	ENST00000674546.1	1804	1819	+	15	0	0	2349
O95831-1#128	0	15	15	O95831-1	1611	1626	+	15	O95831-1	1017	1839	ENST00000460436.6	905	1727	+	105	O95831-1#128	0	15	ENST00000460436.6	1499	1514	+	15	0	0	2350
O95831-1#128	0	15	15	O95831-1	1611	1626	+	15	O95831-1	0	1839	ENST00000346424.6	24	1002	++	34	O95831-1#128	0	15	ENST00000346424.6	774	789	+	15	0	0	2351
O95831-1#128	0	15	15	O95831-1	1611	1626	+	15	O95831-1	0	1839	ENST00000319908.8	174	2007	+	25	O95831-1#128	0	15	ENST00000319908.8	1779	1794	+	15	0	0	2352
O95831-1#128	0	15	15	O95831-1	1611	1626	+	15	O95831-1	0	1839	ENST00000287295.8	185	2024	++	16	O95831-1#128	0	15	ENST00000287295.8	1796	1811	+	15	0	0	2353
O95831-1#129	0	24	24	O95831-1	1683	1707	+	24	O95831-1	0	1839	ENST00000676436.1	34	1861	+	255	O95831-1#129	0	24	ENST00000676436.1	1705	1729	+	24	0	0	2354
O95831-1#129	0	24	24	O95831-1	1683	1707	+	24	O95831-1	0	1839	ENST00000676328.1	56	1892	+	254	O95831-1#129	0	24	ENST00000676328.1	1736	1760	+	24	0	0	2355
O95831-1#129	0	24	24	O95831-1	1683	1707	+	24	O95831-1	0	1839	ENST00000676229.1	223	2050	++	253	O95831-1#129	0	24	ENST00000676229.1	1894	1918	+	24	0	0	2356
O95831-1#129	0	24	24	O95831-1	1683	1707	+	24	O95831-1	0	1839	ENST00000675857.1	82	1915	+	251	O95831-1#129	0	24	ENST00000675857.1	1759	1783	+	24	0	0	2357
O95831-1#129	0	24	24	O95831-1	1683	1707	+	24	O95831-1	0	1839	ENST00000675427.1	89	1925	+	249	O95831-1#129	0	24	ENST00000675427.1	1769	1793	+	24	0	0	2358
O95831-1#129	0	24	24	O95831-1	1683	1707	+	24	O95831-1	0	1762	ENST00000675240.1	169	1867	+	248	O95831-1#129	0	24	ENST00000675240.1	1788	1812	+	24	0	0	2359
O95831-1#129	0	24	24	O95831-1	1683	1707	+	24	O95831-1	0	1839	ENST00000675092.1	90	1956	+	247	O95831-1#129	0	24	ENST00000675092.1	1800	1824	+	24	0	0	2360
O95831-1#129	0	24	24	O95831-1	1683	1707	+	24	O95831-1	0	1839	ENST00000675050.1	71	1898	++	246	O95831-1#129	0	24	ENST00000675050.1	1742	1766	+	24	0	0	2361
O95831-1#129	0	24	24	O95831-1	1683	1707	+	24	O95831-1	1012	1839	ENST00000674601.1	0	686	+	241	O95831-1#129	0	24	ENST00000674601.1	530	554	+	24	0	0	2362
O95831-1#129	0	24	24	O95831-1	1683	1707	+	24	O95831-1	0	1762	ENST00000674546.1	185	1955	+	239	O95831-1#129	0	24	ENST00000674546.1	1876	1900	+	24	0	0	2363
O95831-1#129	0	24	24	O95831-1	1683	1707	+	24	O95831-1	1017	1839	ENST00000460436.6	905	1727	+	105	O95831-1#129	0	24	ENST00000460436.6	1571	1595	+	24	0	0	2364
O95831-1#129	0	24	24	O95831-1	1683	1707	+	24	O95831-1	0	1839	ENST00000346424.6	24	1002	++	34	O95831-1#129	0	24	ENST00000346424.6	846	870	+	24	0	0	2365
O95831-1#129	0	24	24	O95831-1	1683	1707	+	24	O95831-1	0	1839	ENST00000319908.8	174	2007	+	25	O95831-1#129	0	24	ENST00000319908.8	1851	1875	+	24	0	0	2366
O95831-1#129	0	24	24	O95831-1	1683	1707	+	24	O95831-1	0	1839	ENST00000287295.8	185	2024	++	16	O95831-1#129	0	24	ENST00000287295.8	1868	1892	+	24	0	0	2367
O95831-1#130	0	27	27	O95831-1	1713	1740	+	27	O95831-1	0	1839	ENST00000676436.1	34	1861	+	255	O95831-1#130	0	27	ENST00000676436.1	1735	1762	+	27	0	0	2368
O95831-1#130	0	27	27	O95831-1	1713	1740	+	27	O95831-1	0	1839	ENST00000676328.1	56	1892	+	254	O95831-1#130	0	27	ENST00000676328.1	1766	1793	+	27	0	0	2369
O95831-1#130	0	27	27	O95831-1	1713	1740	+	27	O95831-1	0	1839	ENST00000676229.1	223	2050	++	253	O95831-1#130	0	27	ENST00000676229.1	1924	1951	+	27	0	0	2370
O95831-1#130	0	27	27	O95831-1	1713	1740	+	27	O95831-1	0	1839	ENST00000675857.1	82	1915	+	251	O95831-1#130	0	27	ENST00000675857.1	1789	1816	+	27	0	0	2371
O95831-1#130	0	27	27	O95831-1	1713	1740	+	27	O95831-1	0	1839	ENST00000675427.1	89	1925	+	249	O95831-1#130	0	27	ENST00000675427.1	1799	1826	+	27	0	0	2372
O95831-1#130	0	27	27	O95831-1	1713	1740	+	27	O95831-1	0	1762	ENST00000675240.1	169	1867	+	248	O95831-1#130	0	27	ENST00000675240.1	1818	1845	+	27	0	0	2373
O95831-1#130	0	27	27	O95831-1	1713	1740	+	27	O95831-1	0	1839	ENST00000675092.1	90	1956	+	247	O95831-1#130	0	27	ENST00000675092.1	1830	1857	+	27	0	0	2374
O95831-1#130	0	27	27	O95831-1	1713	1740	+	27	O95831-1	0	1839	ENST00000675050.1	71	1898	++	246	O95831-1#130	0	27	ENST00000675050.1	1772	1799	+	27	0	0	2375
O95831-1#130	0	27	27	O95831-1	1713	1740	+	27	O95831-1	1012	1839	ENST00000674601.1	0	686	+	241	O95831-1#130	0	27	ENST00000674601.1	560	587	+	27	0	0	2376
O95831-1#130	0	27	27	O95831-1	1713	1740	+	27	O95831-1	0	1762	ENST00000674546.1	185	1955	+	239	O95831-1#130	0	27	ENST00000674546.1	1906	1933	+	27	0	0	2377
O95831-1#130	0	27	27	O95831-1	1713	1740	+	27	O95831-1	1017	1839	ENST00000460436.6	905	1727	+	105	O95831-1#130	0	27	ENST00000460436.6	1601	1628	+	27	0	0	2378
O95831-1#130	0	27	27	O95831-1	1713	1740	+	27	O95831-1	0	1839	ENST00000346424.6	24	1002	++	34	O95831-1#130	0	27	ENST00000346424.6	876	903	+	27	0	0	2379
O95831-1#130	0	27	27	O95831-1	1713	1740	+	27	O95831-1	0	1839	ENST00000319908.8	174	2007	+	25	O95831-1#130	0	27	ENST00000319908.8	1881	1908	+	27	0	0	2380
O95831-1#130	0	27	27	O95831-1	1713	1740	+	27	O95831-1	0	1839	ENST00000287295.8	185	2024	++	16	O95831-1#130	0	27	ENST00000287295.8	1898	1925	+	27	0	0	2381
O95831-1#131	0	30	30	O95831-1	1752	1782	+	30	O95831-1	0	1839	ENST00000676436.1	34	1861	+	255	O95831-1#131	0	30	ENST00000676436.1	1774	1804	+	30	0	0	2382
O95831-1#131	0	30	30	O95831-1	1752	1782	+	30	O95831-1	0	1839	ENST00000676328.1	56	1892	+	254	O95831-1#131	0	30	ENST00000676328.1	1805	1835	+	30	0	0	2383
O95831-1#131	0	30	30	O95831-1	1752	1782	+	30	O95831-1	0	1839	ENST00000676229.1	223	2050	++	253	O95831-1#131	0	30	ENST00000676229.1	1963	1993	+	30	0	0	2384
O95831-1#131	0	30	30	O95831-1	1752	1782	+	30	O95831-1	0	1839	ENST00000675857.1	82	1915	+	251	O95831-1#131	0	30	ENST00000675857.1	1828	1858	+	30	0	0	2385
O95831-1#131	0	30	30	O95831-1	1752	1782	+	30	O95831-1	0	1839	ENST00000675427.1	89	1925	+	249	O95831-1#131	0	30	ENST00000675427.1	1838	1868	+	30	0	0	2386
O95831-1#131	0	30	30	O95831-1	1752	1782	+	30	O95831-1	0	1762	ENST00000675240.1	169	1867	+	248	O95831-1#131	0	10	ENST00000675240.1	1857	1867	+	10	0	20	2387
O95831-1#131	0	30	30	O95831-1	1752	1782	+	30	O95831-1	0	1839	ENST00000675092.1	90	1956	+	247	O95831-1#131	0	30	ENST00000675092.1	1869	1899	+	30	0	0	2388
O95831-1#131	0	30	30	O95831-1	1752	1782	+	30	O95831-1	0	1839	ENST00000675050.1	71	1898	++	246	O95831-1#131	0	30	ENST00000675050.1	1811	1841	+	30	0	0	2389
O95831-1#131	0	30	30	O95831-1	1752	1782	+	30	O95831-1	1012	1839	ENST00000674601.1	0	686	+	241	O95831-1#131	0	30	ENST00000674601.1	599	629	+	30	0	0	2390
O95831-1#131	0	30	30	O95831-1	1752	1782	+	30	O95831-1	0	1762	ENST00000674546.1	185	1955	+	239	O95831-1#131	0	10	ENST00000674546.1	1945	1955	+	10	0	20	2391
O95831-1#131	0	30	30	O95831-1	1752	1782	+	30	O95831-1	1017	1839	ENST00000460436.6	905	1727	+	105	O95831-1#131	0	30	ENST00000460436.6	1640	1670	+	30	0	0	2392
O95831-1#131	0	30	30	O95831-1	1752	1782	+	30	O95831-1	0	1839	ENST00000346424.6	24	1002	++	34	O95831-1#131	0	30	ENST00000346424.6	915	945	+	30	0	0	2393
O95831-1#131	0	30	30	O95831-1	1752	1782	+	30	O95831-1	0	1839	ENST00000319908.8	174	2007	+	25	O95831-1#131	0	30	ENST00000319908.8	1920	1950	+	30	0	0	2394
O95831-1#131	0	30	30	O95831-1	1752	1782	+	30	O95831-1	0	1839	ENST00000287295.8	185	2024	++	16	O95831-1#131	0	30	ENST00000287295.8	1937	1967	+	30	0	0	2395
O95831-1#132	0	15	15	O95831-1	1800	1815	+	15	O95831-1	0	1839	ENST00000676436.1	34	1861	+	255	O95831-1#132	0	15	ENST00000676436.1	1822	1837	+	15	0	0	2396
O95831-1#132	0	15	15	O95831-1	1800	1815	+	15	O95831-1	0	1839	ENST00000676328.1	56	1892	+	254	O95831-1#132	0	15	ENST00000676328.1	1853	1868	+	15	0	0	2397
O95831-1#132	0	15	15	O95831-1	1800	1815	+	15	O95831-1	0	1839	ENST00000676229.1	223	2050	++	253	O95831-1#132	0	15	ENST00000676229.1	2011	2026	+	15	0	0	2398
O95831-1#132	0	15	15	O95831-1	1800	1815	+	15	O95831-1	0	1839	ENST00000675857.1	82	1915	+	251	O95831-1#132	0	15	ENST00000675857.1	1876	1891	+	15	0	0	2399
O95831-1#132	0	15	15	O95831-1	1800	1815	+	15	O95831-1	0	1839	ENST00000675427.1	89	1925	+	249	O95831-1#132	0	15	ENST00000675427.1	1886	1901	+	15	0	0	2400
O95831-1#132	0	15	15	O95831-1	1800	1815	+	15	O95831-1	0	1839	ENST00000675092.1	90	1956	+	247	O95831-1#132	0	15	ENST00000675092.1	1917	1932	+	15	0	0	2401
O95831-1#132	0	15	15	O95831-1	1800	1815	+	15	O95831-1	0	1839	ENST00000675050.1	71	1898	++	246	O95831-1#132	0	15	ENST00000675050.1	1859	1874	+	15	0	0	2402
O95831-1#132	0	15	15	O95831-1	1800	1815	+	15	O95831-1	1012	1839	ENST00000674601.1	0	686	+	241	O95831-1#132	0	15	ENST00000674601.1	647	662	+	15	0	0	2403
O95831-1#132	0	15	15	O95831-1	1800	1815	+	15	O95831-1	1017	1839	ENST00000460436.6	905	1727	+	105	O95831-1#132	0	15	ENST00000460436.6	1688	1703	+	15	0	0	2404
O95831-1#132	0	15	15	O95831-1	1800	1815	+	15	O95831-1	0	1839	ENST00000346424.6	24	1002	++	34	O95831-1#132	0	15	ENST00000346424.6	963	978	+	15	0	0	2405
O95831-1#132	0	15	15	O95831-1	1800	1815	+	15	O95831-1	0	1839	ENST00000319908.8	174	2007	+	25	O95831-1#132	0	15	ENST00000319908.8	1968	1983	+	15	0	0	2406
O95831-1#132	0	15	15	O95831-1	1800	1815	+	15	O95831-1	0	1839	ENST00000287295.8	185	2024	++	16	O95831-1#132	0	15	ENST00000287295.8	1985	2000	+	15	0	0	2407
O95831-1#133	0	9	9	O95831-1	1815	1824	+	9	O95831-1	0	1839	ENST00000676436.1	34	1861	+	255	O95831-1#133	0	9	ENST00000676436.1	1837	1846	+	9	0	0	2408
O95831-1#133	0	9	9	O95831-1	1815	1824	+	9	O95831-1	0	1839	ENST00000676328.1	56	1892	+	254	O95831-1#133	0	9	ENST00000676328.1	1868	1877	+	9	0	0	2409
O95831-1#133	0	9	9	O95831-1	1815	1824	+	9	O95831-1	0	1839	ENST00000676229.1	223	2050	++	253	O95831-1#133	0	9	ENST00000676229.1	2026	2035	+	9	0	0	2410
O95831-1#133	0	9	9	O95831-1	1815	1824	+	9	O95831-1	0	1839	ENST00000675857.1	82	1915	+	251	O95831-1#133	0	9	ENST00000675857.1	1891	1900	+	9	0	0	2411
O95831-1#133	0	9	9	O95831-1	1815	1824	+	9	O95831-1	0	1839	ENST00000675427.1	89	1925	+	249	O95831-1#133	0	9	ENST00000675427.1	1901	1910	+	9	0	0	2412
O95831-1#133	0	9	9	O95831-1	1815	1824	+	9	O95831-1	0	1839	ENST00000675092.1	90	1956	+	247	O95831-1#133	0	9	ENST00000675092.1	1932	1941	+	9	0	0	2413
O95831-1#133	0	9	9	O95831-1	1815	1824	+	9	O95831-1	0	1839	ENST00000675050.1	71	1898	++	246	O95831-1#133	0	9	ENST00000675050.1	1874	1883	+	9	0	0	2414
O95831-1#133	0	9	9	O95831-1	1815	1824	+	9	O95831-1	1012	1839	ENST00000674601.1	0	686	+	241	O95831-1#133	0	9	ENST00000674601.1	662	671	+	9	0	0	2415
O95831-1#133	0	9	9	O95831-1	1815	1824	+	9	O95831-1	1017	1839	ENST00000460436.6	905	1727	+	105	O95831-1#133	0	9	ENST00000460436.6	1703	1712	+	9	0	0	2416
O95831-1#133	0	9	9	O95831-1	1815	1824	+	9	O95831-1	0	1839	ENST00000346424.6	24	1002	++	34	O95831-1#133	0	9	ENST00000346424.6	978	987	+	9	0	0	2417
O95831-1#133	0	9	9	O95831-1	1815	1824	+	9	O95831-1	0	1839	ENST00000319908.8	174	2007	+	25	O95831-1#133	0	9	ENST00000319908.8	1983	1992	+	9	0	0	2418
O95831-1#133	0	9	9	O95831-1	1815	1824	+	9	O95831-1	0	1839	ENST00000287295.8	185	2024	++	16	O95831-1#133	0	9	ENST00000287295.8	2000	2009	+	9	0	0	2419
P14060#0	0	3	3	P14060	0	3	+	3	P14060	0	245	ENST00000531340.5	107	352	+	153	P14060#0	0	3	ENST00000531340.5	107	110	+	3	0	0	2420
P14060#0	0	3	3	P14060	0	3	+	3	P14060	0	1119	ENST00000528909.1	159	1278	++	146	P14060#0	0	3	ENST00000528909.1	159	162	+	3	0	0	2421
P14060#0	0	3	3	P14060	0	3	+	3	P14060	0	1119	ENST00000369413.8	138	1257	++	42	P14060#0	0	3	ENST00000369413.8	138	141	+	3	0	0	2422
P14060#1	0	1116	1116	P14060	3	1119	+	1116	P14060	6	1119	ENST00000543831.5	252	1365	++	163	P14060#1	3	1116	ENST00000543831.5	252	1365	+	1113	3	0	2423
P14060#1	0	1116	1116	P14060	3	1119	+	1116	P14060	0	245	ENST00000531340.5	107	352	+	153	P14060#1	0	242	ENST00000531340.5	110	352	+	242	0	874	2424
P14060#1	0	1116	1116	P14060	3	1119	+	1116	P14060	0	1119	ENST00000528909.1	159	1278	++	146	P14060#1	0	1116	ENST00000528909.1	162	1278	+	1116	0	0	2425
P14060#1	0	1116	1116	P14060	3	1119	+	1116	P14060	6	590	ENST00000433745.5	133	717	+	83	P14060#1	3	587	ENST00000433745.5	133	717	+	584	3	529	2426
P14060#1	0	1116	1116	P14060	3	1119	+	1116	P14060	6	1119	ENST00000369416.4	145	1258	++	45	P14060#1	3	1116	ENST00000369416.4	145	1258	+	1113	3	0	2427
P14060#1	0	1116	1116	P14060	3	1119	+	1116	P14060	0	1119	ENST00000369413.8	138	1257	++	42	P14060#1	0	1116	ENST00000369413.8	141	1257	+	1116	0	0	2428
P14060#2	0	63	63	P14060	861	924	+	63	P14060	6	1119	ENST00000543831.5	252	1365	++	163	P14060#2	0	63	ENST00000543831.5	1107	1170	+	63	0	0	2429
P14060#2	0	63	63	P14060	861	924	+	63	P14060	0	1119	ENST00000528909.1	159	1278	++	146	P14060#2	0	63	ENST00000528909.1	1020	1083	+	63	0	0	2430
P14060#2	0	63	63	P14060	861	924	+	63	P14060	6	1119	ENST00000369416.4	145	1258	++	45	P14060#2	0	63	ENST00000369416.4	1000	1063	+	63	0	0	2431
P14060#2	0	63	63	P14060	861	924	+	63	P14060	0	1119	ENST00000369413.8	138	1257	++	42	P14060#2	0	63	ENST00000369413.8	999	1062	+	63	0	0	2432
P14060#3	0	3	3	P14060	474	477	+	3	P14060	6	1119	ENST00000543831.5	252	1365	++	163	P14060#3	0	3	ENST00000543831.5	720	723	+	3	0	0	2433
P14060#3	0	3	3	P14060	474	477	+	3	P14060	0	1119	ENST00000528909.1	159	1278	++	146	P14060#3	0	3	ENST00000528909.1	633	636	+	3	0	0	2434
P14060#3	0	3	3	P14060	474	477	+	3	P14060	6	590	ENST00000433745.5	133	717	+	83	P14060#3	0	3	ENST00000433745.5	601	604	+	3	0	0	2435
P14060#3	0	3	3	P14060	474	477	+	3	P14060	6	1119	ENST00000369416.4	145	1258	++	45	P14060#3	0	3	ENST00000369416.4	613	616	+	3	0	0	2436
P14060#3	0	3	3	P14060	474	477	+	3	P14060	0	1119	ENST00000369413.8	138	1257	++	42	P14060#3	0	3	ENST00000369413.8	612	615	+	3	0	0	2437
P14060#4	0	18	18	P14060	27	45	+	18	P14060	6	1119	ENST00000543831.5	252	1365	++	163	P14060#4	0	18	ENST00000543831.5	273	291	+	18	0	0	2438
P14060#4	0	18	18	P14060	27	45	+	18	P14060	0	245	ENST00000531340.5	107	352	+	153	P14060#4	0	18	ENST00000531340.5	134	152	+	18	0	0	2439
P14060#4	0	18	18	P14060	27	45	+	18	P14060	0	1119	ENST00000528909.1	159	1278	++	146	P14060#4	0	18	ENST00000528909.1	186	204	+	18	0	0	2440
P14060#4	0	18	18	P14060	27	45	+	18	P14060	6	590	ENST00000433745.5	133	717	+	83	P14060#4	0	18	ENST00000433745.5	154	172	+	18	0	0	2441
P14060#4	0	18	18	P14060	27	45	+	18	P14060	6	1119	ENST00000369416.4	145	1258	++	45	P14060#4	0	18	ENST00000369416.4	166	184	+	18	0	0	2442
P14060#4	0	18	18	P14060	27	45	+	18	P14060	0	1119	ENST00000369413.8	138	1257	++	42	P14060#4	0	18	ENST00000369413.8	165	183	+	18	0	0	2443
P14060#5	0	3	3	P14060	462	465	+	3	P14060	6	1119	ENST00000543831.5	252	1365	++	163	P14060#5	0	3	ENST00000543831.5	708	711	+	3	0	0	2444
P14060#5	0	3	3	P14060	462	465	+	3	P14060	0	1119	ENST00000528909.1	159	1278	++	146	P14060#5	0	3	ENST00000528909.1	621	624	+	3	0	0	2445
P14060#5	0	3	3	P14060	462	465	+	3	P14060	6	590	ENST00000433745.5	133	717	+	83	P14060#5	0	3	ENST00000433745.5	589	592	+	3	0	0	2446
P14060#5	0	3	3	P14060	462	465	+	3	P14060	6	1119	ENST00000369416.4	145	1258	++	45	P14060#5	0	3	ENST00000369416.4	601	604	+	3	0	0	2447
P14060#5	0	3	3	P14060	462	465	+	3	P14060	0	1119	ENST00000369413.8	138	1257	++	42	P14060#5	0	3	ENST00000369413.8	600	603	+	3	0	0	2448
P14060#6	0	3	3	P14060	474	477	+	3	P14060	6	1119	ENST00000543831.5	252	1365	++	163	P14060#6	0	3	ENST00000543831.5	720	723	+	3	0	0	2449
P14060#6	0	3	3	P14060	474	477	+	3	P14060	0	1119	ENST00000528909.1	159	1278	++	146	P14060#6	0	3	ENST00000528909.1	633	636	+	3	0	0	2450
P14060#6	0	3	3	P14060	474	477	+	3	P14060	6	590	ENST00000433745.5	133	717	+	83	P14060#6	0	3	ENST00000433745.5	601	604	+	3	0	0	2451
P14060#6	0	3	3	P14060	474	477	+	3	P14060	6	1119	ENST00000369416.4	145	1258	++	45	P14060#6	0	3	ENST00000369416.4	613	616	+	3	0	0	2452
P14060#6	0	3	3	P14060	474	477	+	3	P14060	0	1119	ENST00000369413.8	138	1257	++	42	P14060#6	0	3	ENST00000369413.8	612	615	+	3	0	0	2453
P14060#7	0	3	3	P14060	159	162	+	3	P14060	6	1119	ENST00000543831.5	252	1365	++	163	P14060#7	0	3	ENST00000543831.5	405	408	+	3	0	0	2454
P14060#7	0	3	3	P14060	159	162	+	3	P14060	0	245	ENST00000531340.5	107	352	+	153	P14060#7	0	3	ENST00000531340.5	266	269	+	3	0	0	2455
P14060#7	0	3	3	P14060	159	162	+	3	P14060	0	1119	ENST00000528909.1	159	1278	++	146	P14060#7	0	3	ENST00000528909.1	318	321	+	3	0	0	2456
P14060#7	0	3	3	P14060	159	162	+	3	P14060	6	590	ENST00000433745.5	133	717	+	83	P14060#7	0	3	ENST00000433745.5	286	289	+	3	0	0	2457
P14060#7	0	3	3	P14060	159	162	+	3	P14060	6	1119	ENST00000369416.4	145	1258	++	45	P14060#7	0	3	ENST00000369416.4	298	301	+	3	0	0	2458
P14060#7	0	3	3	P14060	159	162	+	3	P14060	0	1119	ENST00000369413.8	138	1257	++	42	P14060#7	0	3	ENST00000369413.8	297	300	+	3	0	0	2459
P14060#8	0	3	3	P14060	210	213	+	3	P14060	6	1119	ENST00000543831.5	252	1365	++	163	P14060#8	0	3	ENST00000543831.5	456	459	+	3	0	0	2460
P14060#8	0	3	3	P14060	210	213	+	3	P14060	0	245	ENST00000531340.5	107	352	+	153	P14060#8	0	3	ENST00000531340.5	317	320	+	3	0	0	2461
P14060#8	0	3	3	P14060	210	213	+	3	P14060	0	1119	ENST00000528909.1	159	1278	++	146	P14060#8	0	3	ENST00000528909.1	369	372	+	3	0	0	2462
P14060#8	0	3	3	P14060	210	213	+	3	P14060	6	590	ENST00000433745.5	133	717	+	83	P14060#8	0	3	ENST00000433745.5	337	340	+	3	0	0	2463
P14060#8	0	3	3	P14060	210	213	+	3	P14060	6	1119	ENST00000369416.4	145	1258	++	45	P14060#8	0	3	ENST00000369416.4	349	352	+	3	0	0	2464
P14060#8	0	3	3	P14060	210	213	+	3	P14060	0	1119	ENST00000369413.8	138	1257	++	42	P14060#8	0	3	ENST00000369413.8	348	351	+	3	0	0	2465
P14060#9	0	3	3	P14060	234	237	+	3	P14060	6	1119	ENST00000543831.5	252	1365	++	163	P14060#9	0	3	ENST00000543831.5	480	483	+	3	0	0	2466
P14060#9	0	3	3	P14060	234	237	+	3	P14060	0	245	ENST00000531340.5	107	352	+	153	P14060#9	0	3	ENST00000531340.5	341	344	+	3	0	0	2467
P14060#9	0	3	3	P14060	234	237	+	3	P14060	0	1119	ENST00000528909.1	159	1278	++	146	P14060#9	0	3	ENST00000528909.1	393	396	+	3	0	0	2468
P14060#9	0	3	3	P14060	234	237	+	3	P14060	6	590	ENST00000433745.5	133	717	+	83	P14060#9	0	3	ENST00000433745.5	361	364	+	3	0	0	2469
P14060#9	0	3	3	P14060	234	237	+	3	P14060	6	1119	ENST00000369416.4	145	1258	++	45	P14060#9	0	3	ENST00000369416.4	373	376	+	3	0	0	2470
P14060#9	0	3	3	P14060	234	237	+	3	P14060	0	1119	ENST00000369413.8	138	1257	++	42	P14060#9	0	3	ENST00000369413.8	372	375	+	3	0	0	2471
P14060#10	0	3	3	P14060	267	270	+	3	P14060	6	1119	ENST00000543831.5	252	1365	++	163	P14060#10	0	3	ENST00000543831.5	513	516	+	3	0	0	2472
P14060#10	0	3	3	P14060	267	270	+	3	P14060	0	1119	ENST00000528909.1	159	1278	++	146	P14060#10	0	3	ENST00000528909.1	426	429	+	3	0	0	2473
P14060#10	0	3	3	P14060	267	270	+	3	P14060	6	590	ENST00000433745.5	133	717	+	83	P14060#10	0	3	ENST00000433745.5	394	397	+	3	0	0	2474
P14060#10	0	3	3	P14060	267	270	+	3	P14060	6	1119	ENST00000369416.4	145	1258	++	45	P14060#10	0	3	ENST00000369416.4	406	409	+	3	0	0	2475
P14060#10	0	3	3	P14060	267	270	+	3	P14060	0	1119	ENST00000369413.8	138	1257	++	42	P14060#10	0	3	ENST00000369413.8	405	408	+	3	0	0	2476
P14060#11	0	3	3	P14060	855	858	+	3	P14060	6	1119	ENST00000543831.5	252	1365	++	163	P14060#11	0	3	ENST00000543831.5	1101	1104	+	3	0	0	2477
P14060#11	0	3	3	P14060	855	858	+	3	P14060	0	1119	ENST00000528909.1	159	1278	++	146	P14060#11	0	3	ENST00000528909.1	1014	1017	+	3	0	0	2478
P14060#11	0	3	3	P14060	855	858	+	3	P14060	6	1119	ENST00000369416.4	145	1258	++	45	P14060#11	0	3	ENST00000369416.4	994	997	+	3	0	0	2479
P14060#11	0	3	3	P14060	855	858	+	3	P14060	0	1119	ENST00000369413.8	138	1257	++	42	P14060#11	0	3	ENST00000369413.8	993	996	+	3	0	0	2480
P14060#12	0	3	3	P14060	1098	1101	+	3	P14060	6	1119	ENST00000543831.5	252	1365	++	163	P14060#12	0	3	ENST00000543831.5	1344	1347	+	3	0	0	2481
P14060#12	0	3	3	P14060	1098	1101	+	3	P14060	0	1119	ENST00000528909.1	159	1278	++	146	P14060#12	0	3	ENST00000528909.1	1257	1260	+	3	0	0	2482
P14060#12	0	3	3	P14060	1098	1101	+	3	P14060	6	1119	ENST00000369416.4	145	1258	++	45	P14060#12	0	3	ENST00000369416.4	1237	1240	+	3	0	0	2483
P14060#12	0	3	3	P14060	1098	1101	+	3	P14060	0	1119	ENST00000369413.8	138	1257	++	42	P14060#12	0	3	ENST00000369413.8	1236	1239	+	3	0	0	2484
P26439-1#0	0	1116	1116	P26439-1	0	1116	+	1116	P26439-1	0	1116	ENST00000543831.5	249	1365	++	162	P26439-1#0	0	1116	ENST00000543831.5	249	1365	+	1116	0	0	2485
P26439-1#0	0	1116	1116	P26439-1	0	1116	+	1116	P26439-1	3	242	ENST00000531340.5	113	352	+	154	P26439-1#0	3	242	ENST00000531340.5	113	352	+	239	3	874	2486
P26439-1#0	0	1116	1116	P26439-1	0	1116	+	1116	P26439-1	3	1116	ENST00000528909.1	165	1278	++	147	P26439-1#0	3	1116	ENST00000528909.1	165	1278	+	1113	3	0	2487
P26439-1#0	0	1116	1116	P26439-1	0	1116	+	1116	P26439-1	0	587	ENST00000433745.5	130	717	+	82	P26439-1#0	0	587	ENST00000433745.5	130	717	+	587	0	529	2488
P26439-1#0	0	1116	1116	P26439-1	0	1116	+	1116	P26439-1	0	1116	ENST00000369416.4	142	1258	++	44	P26439-1#0	0	1116	ENST00000369416.4	142	1258	+	1116	0	0	2489
P26439-1#0	0	1116	1116	P26439-1	0	1116	+	1116	P26439-1	3	1116	ENST00000369413.8	144	1257	++	43	P26439-1#0	3	1116	ENST00000369413.8	144	1257	+	1113	3	0	2490
P26439-1#1	0	63	63	P26439-1	858	921	+	63	P26439-1	0	1116	ENST00000543831.5	249	1365	++	162	P26439-1#1	0	63	ENST00000543831.5	1107	1170	+	63	0	0	2491
P26439-1#1	0	63	63	P26439-1	858	921	+	63	P26439-1	3	1116	ENST00000528909.1	165	1278	++	147	P26439-1#1	0	63	ENST00000528909.1	1020	1083	+	63	0	0	2492
P26439-1#1	0	63	63	P26439-1	858	921	+	63	P26439-1	0	1116	ENST00000369416.4	142	1258	++	44	P26439-1#1	0	63	ENST00000369416.4	1000	1063	+	63	0	0	2493
P26439-1#1	0	63	63	P26439-1	858	921	+	63	P26439-1	3	1116	ENST00000369413.8	144	1257	++	43	P26439-1#1	0	63	ENST00000369413.8	999	1062	+	63	0	0	2494
P26439-1#2	0	3	3	P26439-1	459	462	+	3	P26439-1	0	1116	ENST00000543831.5	249	1365	++	162	P26439-1#2	0	3	ENST00000543831.5	708	711	+	3	0	0	2495
P26439-1#2	0	3	3	P26439-1	459	462	+	3	P26439-1	3	1116	ENST00000528909.1	165	1278	++	147	P26439-1#2	0	3	ENST00000528909.1	621	624	+	3	0	0	2496
P26439-1#2	0	3	3	P26439-1	459	462	+	3	P26439-1	0	587	ENST00000433745.5	130	717	+	82	P26439-1#2	0	3	ENST00000433745.5	589	592	+	3	0	0	2497
P26439-1#2	0	3	3	P26439-1	459	462	+	3	P26439-1	0	1116	ENST00000369416.4	142	1258	++	44	P26439-1#2	0	3	ENST00000369416.4	601	604	+	3	0	0	2498
P26439-1#2	0	3	3	P26439-1	459	462	+	3	P26439-1	3	1116	ENST00000369413.8	144	1257	++	43	P26439-1#2	0	3	ENST00000369413.8	600	603	+	3	0	0	2499
P26439-1#3	0	3	3	P26439-1	471	474	+	3	P26439-1	0	1116	ENST00000543831.5	249	1365	++	162	P26439-1#3	0	3	ENST00000543831.5	720	723	+	3	0	0	2500
P26439-1#3	0	3	3	P26439-1	471	474	+	3	P26439-1	3	1116	ENST00000528909.1	165	1278	++	147	P26439-1#3	0	3	ENST00000528909.1	633	636	+	3	0	0	2501
P26439-1#3	0	3	3	P26439-1	471	474	+	3	P26439-1	0	587	ENST00000433745.5	130	717	+	82	P26439-1#3	0	3	ENST00000433745.5	601	604	+	3	0	0	2502
P26439-1#3	0	3	3	P26439-1	471	474	+	3	P26439-1	0	1116	ENST00000369416.4	142	1258	++	44	P26439-1#3	0	3	ENST00000369416.4	613	616	+	3	0	0	2503
P26439-1#3	0	3	3	P26439-1	471	474	+	3	P26439-1	3	1116	ENST00000369413.8	144	1257	++	43	P26439-1#3	0	3	ENST00000369413.8	612	615	+	3	0	0	2504
P26439-1#4	0	360	360	P26439-1	306	666	+	360	P26439-1	0	1116	ENST00000543831.5	249	1365	++	162	P26439-1#4	0	360	ENST00000543831.5	555	915	+	360	0	0	2505
P26439-1#4	0	360	360	P26439-1	306	666	+	360	P26439-1	3	1116	ENST00000528909.1	165	1278	++	147	P26439-1#4	0	360	ENST00000528909.1	468	828	+	360	0	0	2506
P26439-1#4	0	360	360	P26439-1	306	666	+	360	P26439-1	0	587	ENST00000433745.5	130	717	+	82	P26439-1#4	0	281	ENST00000433745.5	436	717	+	281	0	79	2507
P26439-1#4	0	360	360	P26439-1	306	666	+	360	P26439-1	0	1116	ENST00000369416.4	142	1258	++	44	P26439-1#4	0	360	ENST00000369416.4	448	808	+	360	0	0	2508
P26439-1#4	0	360	360	P26439-1	306	666	+	360	P26439-1	3	1116	ENST00000369413.8	144	1257	++	43	P26439-1#4	0	360	ENST00000369413.8	447	807	+	360	0	0	2509
P26439-1#5	0	450	450	P26439-1	666	1116	+	450	P26439-1	0	1116	ENST00000543831.5	249	1365	++	162	P26439-1#5	0	450	ENST00000543831.5	915	1365	+	450	0	0	2510
P26439-1#5	0	450	450	P26439-1	666	1116	+	450	P26439-1	3	1116	ENST00000528909.1	165	1278	++	147	P26439-1#5	0	450	ENST00000528909.1	828	1278	+	450	0	0	2511
P26439-1#5	0	450	450	P26439-1	666	1116	+	450	P26439-1	0	1116	ENST00000369416.4	142	1258	++	44	P26439-1#5	0	450	ENST00000369416.4	808	1258	+	450	0	0	2512
P26439-1#5	0	450	450	P26439-1	666	1116	+	450	P26439-1	3	1116	ENST00000369413.8	144	1257	++	43	P26439-1#5	0	450	ENST00000369413.8	807	1257	+	450	0	0	2513
P26439-1#6	0	3	3	P26439-1	27	30	+	3	P26439-1	0	1116	ENST00000543831.5	249	1365	++	162	P26439-1#6	0	3	ENST00000543831.5	276	279	+	3	0	0	2514
P26439-1#6	0	3	3	P26439-1	27	30	+	3	P26439-1	3	242	ENST00000531340.5	113	352	+	154	P26439-1#6	0	3	ENST00000531340.5	137	140	+	3	0	0	2515
P26439-1#6	0	3	3	P26439-1	27	30	+	3	P26439-1	3	1116	ENST00000528909.1	165	1278	++	147	P26439-1#6	0	3	ENST00000528909.1	189	192	+	3	0	0	2516
P26439-1#6	0	3	3	P26439-1	27	30	+	3	P26439-1	0	587	ENST00000433745.5	130	717	+	82	P26439-1#6	0	3	ENST00000433745.5	157	160	+	3	0	0	2517
P26439-1#6	0	3	3	P26439-1	27	30	+	3	P26439-1	0	1116	ENST00000369416.4	142	1258	++	44	P26439-1#6	0	3	ENST00000369416.4	169	172	+	3	0	0	2518
P26439-1#6	0	3	3	P26439-1	27	30	+	3	P26439-1	3	1116	ENST00000369413.8	144	1257	++	43	P26439-1#6	0	3	ENST00000369413.8	168	171	+	3	0	0	2519
P26439-1#7	0	3	3	P26439-1	27	30	+	3	P26439-1	0	1116	ENST00000543831.5	249	1365	++	162	P26439-1#7	0	3	ENST00000543831.5	276	279	+	3	0	0	2520
P26439-1#7	0	3	3	P26439-1	27	30	+	3	P26439-1	3	242	ENST00000531340.5	113	352	+	154	P26439-1#7	0	3	ENST00000531340.5	137	140	+	3	0	0	2521
P26439-1#7	0	3	3	P26439-1	27	30	+	3	P26439-1	3	1116	ENST00000528909.1	165	1278	++	147	P26439-1#7	0	3	ENST00000528909.1	189	192	+	3	0	0	2522
P26439-1#7	0	3	3	P26439-1	27	30	+	3	P26439-1	0	587	ENST00000433745.5	130	717	+	82	P26439-1#7	0	3	ENST00000433745.5	157	160	+	3	0	0	2523
P26439-1#7	0	3	3	P26439-1	27	30	+	3	P26439-1	0	1116	ENST00000369416.4	142	1258	++	44	P26439-1#7	0	3	ENST00000369416.4	169	172	+	3	0	0	2524
P26439-1#7	0	3	3	P26439-1	27	30	+	3	P26439-1	3	1116	ENST00000369413.8	144	1257	++	43	P26439-1#7	0	3	ENST00000369413.8	168	171	+	3	0	0	2525
P26439-1#8	0	3	3	P26439-1	42	45	+	3	P26439-1	0	1116	ENST00000543831.5	249	1365	++	162	P26439-1#8	0	3	ENST00000543831.5	291	294	+	3	0	0	2526
P26439-1#8	0	3	3	P26439-1	42	45	+	3	P26439-1	3	242	ENST00000531340.5	113	352	+	154	P26439-1#8	0	3	ENST00000531340.5	152	155	+	3	0	0	2527
P26439-1#8	0	3	3	P26439-1	42	45	+	3	P26439-1	3	1116	ENST00000528909.1	165	1278	++	147	P26439-1#8	0	3	ENST00000528909.1	204	207	+	3	0	0	2528
P26439-1#8	0	3	3	P26439-1	42	45	+	3	P26439-1	0	587	ENST00000433745.5	130	717	+	82	P26439-1#8	0	3	ENST00000433745.5	172	175	+	3	0	0	2529
P26439-1#8	0	3	3	P26439-1	42	45	+	3	P26439-1	0	1116	ENST00000369416.4	142	1258	++	44	P26439-1#8	0	3	ENST00000369416.4	184	187	+	3	0	0	2530
P26439-1#8	0	3	3	P26439-1	42	45	+	3	P26439-1	3	1116	ENST00000369413.8	144	1257	++	43	P26439-1#8	0	3	ENST00000369413.8	183	186	+	3	0	0	2531
P26439-1#9	0	3	3	P26439-1	219	222	+	3	P26439-1	0	1116	ENST00000543831.5	249	1365	++	162	P26439-1#9	0	3	ENST00000543831.5	468	471	+	3	0	0	2532
P26439-1#9	0	3	3	P26439-1	219	222	+	3	P26439-1	3	242	ENST00000531340.5	113	352	+	154	P26439-1#9	0	3	ENST00000531340.5	329	332	+	3	0	0	2533
P26439-1#9	0	3	3	P26439-1	219	222	+	3	P26439-1	3	1116	ENST00000528909.1	165	1278	++	147	P26439-1#9	0	3	ENST00000528909.1	381	384	+	3	0	0	2534
P26439-1#9	0	3	3	P26439-1	219	222	+	3	P26439-1	0	587	ENST00000433745.5	130	717	+	82	P26439-1#9	0	3	ENST00000433745.5	349	352	+	3	0	0	2535
P26439-1#9	0	3	3	P26439-1	219	222	+	3	P26439-1	0	1116	ENST00000369416.4	142	1258	++	44	P26439-1#9	0	3	ENST00000369416.4	361	364	+	3	0	0	2536
P26439-1#9	0	3	3	P26439-1	219	222	+	3	P26439-1	3	1116	ENST00000369413.8	144	1257	++	43	P26439-1#9	0	3	ENST00000369413.8	360	363	+	3	0	0	2537
P26439-1#10	0	3	3	P26439-1	243	246	+	3	P26439-1	0	1116	ENST00000543831.5	249	1365	++	162	P26439-1#10	0	3	ENST00000543831.5	492	495	+	3	0	0	2538
P26439-1#10	0	3	3	P26439-1	243	246	+	3	P26439-1	3	1116	ENST00000528909.1	165	1278	++	147	P26439-1#10	0	3	ENST00000528909.1	405	408	+	3	0	0	2539
P26439-1#10	0	3	3	P26439-1	243	246	+	3	P26439-1	0	587	ENST00000433745.5	130	717	+	82	P26439-1#10	0	3	ENST00000433745.5	373	376	+	3	0	0	2540
P26439-1#10	0	3	3	P26439-1	243	246	+	3	P26439-1	0	1116	ENST00000369416.4	142	1258	++	44	P26439-1#10	0	3	ENST00000369416.4	385	388	+	3	0	0	2541
P26439-1#10	0	3	3	P26439-1	243	246	+	3	P26439-1	3	1116	ENST00000369413.8	144	1257	++	43	P26439-1#10	0	3	ENST00000369413.8	384	387	+	3	0	0	2542
P26439-1#11	0	3	3	P26439-1	243	246	+	3	P26439-1	0	1116	ENST00000543831.5	249	1365	++	162	P26439-1#11	0	3	ENST00000543831.5	492	495	+	3	0	0	2543
P26439-1#11	0	3	3	P26439-1	243	246	+	3	P26439-1	3	1116	ENST00000528909.1	165	1278	++	147	P26439-1#11	0	3	ENST00000528909.1	405	408	+	3	0	0	2544
P26439-1#11	0	3	3	P26439-1	243	246	+	3	P26439-1	0	587	ENST00000433745.5	130	717	+	82	P26439-1#11	0	3	ENST00000433745.5	373	376	+	3	0	0	2545
P26439-1#11	0	3	3	P26439-1	243	246	+	3	P26439-1	0	1116	ENST00000369416.4	142	1258	++	44	P26439-1#11	0	3	ENST00000369416.4	385	388	+	3	0	0	2546
P26439-1#11	0	3	3	P26439-1	243	246	+	3	P26439-1	3	1116	ENST00000369413.8	144	1257	++	43	P26439-1#11	0	3	ENST00000369413.8	384	387	+	3	0	0	2547
P26439-1#12	0	3	3	P26439-1	279	282	+	3	P26439-1	0	1116	ENST00000543831.5	249	1365	++	162	P26439-1#12	0	3	ENST00000543831.5	528	531	+	3	0	0	2548
P26439-1#12	0	3	3	P26439-1	279	282	+	3	P26439-1	3	1116	ENST00000528909.1	165	1278	++	147	P26439-1#12	0	3	ENST00000528909.1	441	444	+	3	0	0	2549
P26439-1#12	0	3	3	P26439-1	279	282	+	3	P26439-1	0	587	ENST00000433745.5	130	717	+	82	P26439-1#12	0	3	ENST00000433745.5	409	412	+	3	0	0	2550
P26439-1#12	0	3	3	P26439-1	279	282	+	3	P26439-1	0	1116	ENST00000369416.4	142	1258	++	44	P26439-1#12	0	3	ENST00000369416.4	421	424	+	3	0	0	2551
P26439-1#12	0	3	3	P26439-1	279	282	+	3	P26439-1	3	1116	ENST00000369413.8	144	1257	++	43	P26439-1#12	0	3	ENST00000369413.8	420	423	+	3	0	0	2552
P26439-1#13	0	3	3	P26439-1	297	300	+	3	P26439-1	0	1116	ENST00000543831.5	249	1365	++	162	P26439-1#13	0	3	ENST00000543831.5	546	549	+	3	0	0	2553
P26439-1#13	0	3	3	P26439-1	297	300	+	3	P26439-1	3	1116	ENST00000528909.1	165	1278	++	147	P26439-1#13	0	3	ENST00000528909.1	459	462	+	3	0	0	2554
P26439-1#13	0	3	3	P26439-1	297	300	+	3	P26439-1	0	587	ENST00000433745.5	130	717	+	82	P26439-1#13	0	3	ENST00000433745.5	427	430	+	3	0	0	2555
P26439-1#13	0	3	3	P26439-1	297	300	+	3	P26439-1	0	1116	ENST00000369416.4	142	1258	++	44	P26439-1#13	0	3	ENST00000369416.4	439	442	+	3	0	0	2556
P26439-1#13	0	3	3	P26439-1	297	300	+	3	P26439-1	3	1116	ENST00000369413.8	144	1257	++	43	P26439-1#13	0	3	ENST00000369413.8	438	441	+	3	0	0	2557
P26439-1#14	0	3	3	P26439-1	321	324	+	3	P26439-1	0	1116	ENST00000543831.5	249	1365	++	162	P26439-1#14	0	3	ENST00000543831.5	570	573	+	3	0	0	2558
P26439-1#14	0	3	3	P26439-1	321	324	+	3	P26439-1	3	1116	ENST00000528909.1	165	1278	++	147	P26439-1#14	0	3	ENST00000528909.1	483	486	+	3	0	0	2559
P26439-1#14	0	3	3	P26439-1	321	324	+	3	P26439-1	0	587	ENST00000433745.5	130	717	+	82	P26439-1#14	0	3	ENST00000433745.5	451	454	+	3	0	0	2560
P26439-1#14	0	3	3	P26439-1	321	324	+	3	P26439-1	0	1116	ENST00000369416.4	142	1258	++	44	P26439-1#14	0	3	ENST00000369416.4	463	466	+	3	0	0	2561
P26439-1#14	0	3	3	P26439-1	321	324	+	3	P26439-1	3	1116	ENST00000369413.8	144	1257	++	43	P26439-1#14	0	3	ENST00000369413.8	462	465	+	3	0	0	2562
P26439-1#15	0	3	3	P26439-1	384	387	+	3	P26439-1	0	1116	ENST00000543831.5	249	1365	++	162	P26439-1#15	0	3	ENST00000543831.5	633	636	+	3	0	0	2563
P26439-1#15	0	3	3	P26439-1	384	387	+	3	P26439-1	3	1116	ENST00000528909.1	165	1278	++	147	P26439-1#15	0	3	ENST00000528909.1	546	549	+	3	0	0	2564
P26439-1#15	0	3	3	P26439-1	384	387	+	3	P26439-1	0	587	ENST00000433745.5	130	717	+	82	P26439-1#15	0	3	ENST00000433745.5	514	517	+	3	0	0	2565
P26439-1#15	0	3	3	P26439-1	384	387	+	3	P26439-1	0	1116	ENST00000369416.4	142	1258	++	44	P26439-1#15	0	3	ENST00000369416.4	526	529	+	3	0	0	2566
P26439-1#15	0	3	3	P26439-1	384	387	+	3	P26439-1	3	1116	ENST00000369413.8	144	1257	++	43	P26439-1#15	0	3	ENST00000369413.8	525	528	+	3	0	0	2567
P26439-1#16	0	3	3	P26439-1	423	426	+	3	P26439-1	0	1116	ENST00000543831.5	249	1365	++	162	P26439-1#16	0	3	ENST00000543831.5	672	675	+	3	0	0	2568
P26439-1#16	0	3	3	P26439-1	423	426	+	3	P26439-1	3	1116	ENST00000528909.1	165	1278	++	147	P26439-1#16	0	3	ENST00000528909.1	585	588	+	3	0	0	2569
P26439-1#16	0	3	3	P26439-1	423	426	+	3	P26439-1	0	587	ENST00000433745.5	130	717	+	82	P26439-1#16	0	3	ENST00000433745.5	553	556	+	3	0	0	2570
P26439-1#16	0	3	3	P26439-1	423	426	+	3	P26439-1	0	1116	ENST00000369416.4	142	1258	++	44	P26439-1#16	0	3	ENST00000369416.4	565	568	+	3	0	0	2571
P26439-1#16	0	3	3	P26439-1	423	426	+	3	P26439-1	3	1116	ENST00000369413.8	144	1257	++	43	P26439-1#16	0	3	ENST00000369413.8	564	567	+	3	0	0	2572
P26439-1#17	0	3	3	P26439-1	462	465	+	3	P26439-1	0	1116	ENST00000543831.5	249	1365	++	162	P26439-1#17	0	3	ENST00000543831.5	711	714	+	3	0	0	2573
P26439-1#17	0	3	3	P26439-1	462	465	+	3	P26439-1	3	1116	ENST00000528909.1	165	1278	++	147	P26439-1#17	0	3	ENST00000528909.1	624	627	+	3	0	0	2574
P26439-1#17	0	3	3	P26439-1	462	465	+	3	P26439-1	0	587	ENST00000433745.5	130	717	+	82	P26439-1#17	0	3	ENST00000433745.5	592	595	+	3	0	0	2575
P26439-1#17	0	3	3	P26439-1	462	465	+	3	P26439-1	0	1116	ENST00000369416.4	142	1258	++	44	P26439-1#17	0	3	ENST00000369416.4	604	607	+	3	0	0	2576
P26439-1#17	0	3	3	P26439-1	462	465	+	3	P26439-1	3	1116	ENST00000369413.8	144	1257	++	43	P26439-1#17	0	3	ENST00000369413.8	603	606	+	3	0	0	2577
P26439-1#18	0	3	3	P26439-1	498	501	+	3	P26439-1	0	1116	ENST00000543831.5	249	1365	++	162	P26439-1#18	0	3	ENST00000543831.5	747	750	+	3	0	0	2578
P26439-1#18	0	3	3	P26439-1	498	501	+	3	P26439-1	3	1116	ENST00000528909.1	165	1278	++	147	P26439-1#18	0	3	ENST00000528909.1	660	663	+	3	0	0	2579
P26439-1#18	0	3	3	P26439-1	498	501	+	3	P26439-1	0	587	ENST00000433745.5	130	717	+	82	P26439-1#18	0	3	ENST00000433745.5	628	631	+	3	0	0	2580
P26439-1#18	0	3	3	P26439-1	498	501	+	3	P26439-1	0	1116	ENST00000369416.4	142	1258	++	44	P26439-1#18	0	3	ENST00000369416.4	640	643	+	3	0	0	2581
P26439-1#18	0	3	3	P26439-1	498	501	+	3	P26439-1	3	1116	ENST00000369413.8	144	1257	++	43	P26439-1#18	0	3	ENST00000369413.8	639	642	+	3	0	0	2582
P26439-1#19	0	3	3	P26439-1	516	519	+	3	P26439-1	0	1116	ENST00000543831.5	249	1365	++	162	P26439-1#19	0	3	ENST00000543831.5	765	768	+	3	0	0	2583
P26439-1#19	0	3	3	P26439-1	516	519	+	3	P26439-1	3	1116	ENST00000528909.1	165	1278	++	147	P26439-1#19	0	3	ENST00000528909.1	678	681	+	3	0	0	2584
P26439-1#19	0	3	3	P26439-1	516	519	+	3	P26439-1	0	587	ENST00000433745.5	130	717	+	82	P26439-1#19	0	3	ENST00000433745.5	646	649	+	3	0	0	2585
P26439-1#19	0	3	3	P26439-1	516	519	+	3	P26439-1	0	1116	ENST00000369416.4	142	1258	++	44	P26439-1#19	0	3	ENST00000369416.4	658	661	+	3	0	0	2586
P26439-1#19	0	3	3	P26439-1	516	519	+	3	P26439-1	3	1116	ENST00000369413.8	144	1257	++	43	P26439-1#19	0	3	ENST00000369413.8	657	660	+	3	0	0	2587
P26439-1#20	0	3	3	P26439-1	555	558	+	3	P26439-1	0	1116	ENST00000543831.5	249	1365	++	162	P26439-1#20	0	3	ENST00000543831.5	804	807	+	3	0	0	2588
P26439-1#20	0	3	3	P26439-1	555	558	+	3	P26439-1	3	1116	ENST00000528909.1	165	1278	++	147	P26439-1#20	0	3	ENST00000528909.1	717	720	+	3	0	0	2589
P26439-1#20	0	3	3	P26439-1	555	558	+	3	P26439-1	0	587	ENST00000433745.5	130	717	+	82	P26439-1#20	0	3	ENST00000433745.5	685	688	+	3	0	0	2590
P26439-1#20	0	3	3	P26439-1	555	558	+	3	P26439-1	0	1116	ENST00000369416.4	142	1258	++	44	P26439-1#20	0	3	ENST00000369416.4	697	700	+	3	0	0	2591
P26439-1#20	0	3	3	P26439-1	555	558	+	3	P26439-1	3	1116	ENST00000369413.8	144	1257	++	43	P26439-1#20	0	3	ENST00000369413.8	696	699	+	3	0	0	2592
P26439-1#21	0	3	3	P26439-1	612	615	+	3	P26439-1	0	1116	ENST00000543831.5	249	1365	++	162	P26439-1#21	0	3	ENST00000543831.5	861	864	+	3	0	0	2593
P26439-1#21	0	3	3	P26439-1	612	615	+	3	P26439-1	3	1116	ENST00000528909.1	165	1278	++	147	P26439-1#21	0	3	ENST00000528909.1	774	777	+	3	0	0	2594
P26439-1#21	0	3	3	P26439-1	612	615	+	3	P26439-1	0	1116	ENST00000369416.4	142	1258	++	44	P26439-1#21	0	3	ENST00000369416.4	754	757	+	3	0	0	2595
P26439-1#21	0	3	3	P26439-1	612	615	+	3	P26439-1	3	1116	ENST00000369413.8	144	1257	++	43	P26439-1#21	0	3	ENST00000369413.8	753	756	+	3	0	0	2596
P26439-1#22	0	3	3	P26439-1	636	639	+	3	P26439-1	0	1116	ENST00000543831.5	249	1365	++	162	P26439-1#22	0	3	ENST00000543831.5	885	888	+	3	0	0	2597
P26439-1#22	0	3	3	P26439-1	636	639	+	3	P26439-1	3	1116	ENST00000528909.1	165	1278	++	147	P26439-1#22	0	3	ENST00000528909.1	798	801	+	3	0	0	2598
P26439-1#22	0	3	3	P26439-1	636	639	+	3	P26439-1	0	1116	ENST00000369416.4	142	1258	++	44	P26439-1#22	0	3	ENST00000369416.4	778	781	+	3	0	0	2599
P26439-1#22	0	3	3	P26439-1	636	639	+	3	P26439-1	3	1116	ENST00000369413.8	144	1257	++	43	P26439-1#22	0	3	ENST00000369413.8	777	780	+	3	0	0	2600
P26439-1#23	0	3	3	P26439-1	645	648	+	3	P26439-1	0	1116	ENST00000543831.5	249	1365	++	162	P26439-1#23	0	3	ENST00000543831.5	894	897	+	3	0	0	2601
P26439-1#23	0	3	3	P26439-1	645	648	+	3	P26439-1	3	1116	ENST00000528909.1	165	1278	++	147	P26439-1#23	0	3	ENST00000528909.1	807	810	+	3	0	0	2602
P26439-1#23	0	3	3	P26439-1	645	648	+	3	P26439-1	0	1116	ENST00000369416.4	142	1258	++	44	P26439-1#23	0	3	ENST00000369416.4	787	790	+	3	0	0	2603
P26439-1#23	0	3	3	P26439-1	645	648	+	3	P26439-1	3	1116	ENST00000369413.8	144	1257	++	43	P26439-1#23	0	3	ENST00000369413.8	786	789	+	3	0	0	2604
P26439-1#24	0	3	3	P26439-1	663	666	+	3	P26439-1	0	1116	ENST00000543831.5	249	1365	++	162	P26439-1#24	0	3	ENST00000543831.5	912	915	+	3	0	0	2605
P26439-1#24	0	3	3	P26439-1	663	666	+	3	P26439-1	3	1116	ENST00000528909.1	165	1278	++	147	P26439-1#24	0	3	ENST00000528909.1	825	828	+	3	0	0	2606
P26439-1#24	0	3	3	P26439-1	663	666	+	3	P26439-1	0	1116	ENST00000369416.4	142	1258	++	44	P26439-1#24	0	3	ENST00000369416.4	805	808	+	3	0	0	2607
P26439-1#24	0	3	3	P26439-1	663	666	+	3	P26439-1	3	1116	ENST00000369413.8	144	1257	++	43	P26439-1#24	0	3	ENST00000369413.8	804	807	+	3	0	0	2608
P26439-1#25	0	3	3	P26439-1	663	666	+	3	P26439-1	0	1116	ENST00000543831.5	249	1365	++	162	P26439-1#25	0	3	ENST00000543831.5	912	915	+	3	0	0	2609
P26439-1#25	0	3	3	P26439-1	663	666	+	3	P26439-1	3	1116	ENST00000528909.1	165	1278	++	147	P26439-1#25	0	3	ENST00000528909.1	825	828	+	3	0	0	2610
P26439-1#25	0	3	3	P26439-1	663	666	+	3	P26439-1	0	1116	ENST00000369416.4	142	1258	++	44	P26439-1#25	0	3	ENST00000369416.4	805	808	+	3	0	0	2611
P26439-1#25	0	3	3	P26439-1	663	666	+	3	P26439-1	3	1116	ENST00000369413.8	144	1257	++	43	P26439-1#25	0	3	ENST00000369413.8	804	807	+	3	0	0	2612
P26439-1#26	0	3	3	P26439-1	663	666	+	3	P26439-1	0	1116	ENST00000543831.5	249	1365	++	162	P26439-1#26	0	3	ENST00000543831.5	912	915	+	3	0	0	2613
P26439-1#26	0	3	3	P26439-1	663	666	+	3	P26439-1	3	1116	ENST00000528909.1	165	1278	++	147	P26439-1#26	0	3	ENST00000528909.1	825	828	+	3	0	0	2614
P26439-1#26	0	3	3	P26439-1	663	666	+	3	P26439-1	0	1116	ENST00000369416.4	142	1258	++	44	P26439-1#26	0	3	ENST00000369416.4	805	808	+	3	0	0	2615
P26439-1#26	0	3	3	P26439-1	663	666	+	3	P26439-1	3	1116	ENST00000369413.8	144	1257	++	43	P26439-1#26	0	3	ENST00000369413.8	804	807	+	3	0	0	2616
P26439-1#27	0	24	24	P26439-1	690	714	+	24	P26439-1	0	1116	ENST00000543831.5	249	1365	++	162	P26439-1#27	0	24	ENST00000543831.5	939	963	+	24	0	0	2617
P26439-1#27	0	24	24	P26439-1	690	714	+	24	P26439-1	3	1116	ENST00000528909.1	165	1278	++	147	P26439-1#27	0	24	ENST00000528909.1	852	876	+	24	0	0	2618
P26439-1#27	0	24	24	P26439-1	690	714	+	24	P26439-1	0	1116	ENST00000369416.4	142	1258	++	44	P26439-1#27	0	24	ENST00000369416.4	832	856	+	24	0	0	2619
P26439-1#27	0	24	24	P26439-1	690	714	+	24	P26439-1	3	1116	ENST00000369413.8	144	1257	++	43	P26439-1#27	0	24	ENST00000369413.8	831	855	+	24	0	0	2620
P26439-1#28	0	3	3	P26439-1	705	708	+	3	P26439-1	0	1116	ENST00000543831.5	249	1365	++	162	P26439-1#28	0	3	ENST00000543831.5	954	957	+	3	0	0	2621
P26439-1#28	0	3	3	P26439-1	705	708	+	3	P26439-1	3	1116	ENST00000528909.1	165	1278	++	147	P26439-1#28	0	3	ENST00000528909.1	867	870	+	3	0	0	2622
P26439-1#28	0	3	3	P26439-1	705	708	+	3	P26439-1	0	1116	ENST00000369416.4	142	1258	++	44	P26439-1#28	0	3	ENST00000369416.4	847	850	+	3	0	0	2623
P26439-1#28	0	3	3	P26439-1	705	708	+	3	P26439-1	3	1116	ENST00000369413.8	144	1257	++	43	P26439-1#28	0	3	ENST00000369413.8	846	849	+	3	0	0	2624
P26439-1#29	0	3	3	P26439-1	732	735	+	3	P26439-1	0	1116	ENST00000543831.5	249	1365	++	162	P26439-1#29	0	3	ENST00000543831.5	981	984	+	3	0	0	2625
P26439-1#29	0	3	3	P26439-1	732	735	+	3	P26439-1	3	1116	ENST00000528909.1	165	1278	++	147	P26439-1#29	0	3	ENST00000528909.1	894	897	+	3	0	0	2626
P26439-1#29	0	3	3	P26439-1	732	735	+	3	P26439-1	0	1116	ENST00000369416.4	142	1258	++	44	P26439-1#29	0	3	ENST00000369416.4	874	877	+	3	0	0	2627
P26439-1#29	0	3	3	P26439-1	732	735	+	3	P26439-1	3	1116	ENST00000369413.8	144	1257	++	43	P26439-1#29	0	3	ENST00000369413.8	873	876	+	3	0	0	2628
P26439-1#30	0	3	3	P26439-1	747	750	+	3	P26439-1	0	1116	ENST00000543831.5	249	1365	++	162	P26439-1#30	0	3	ENST00000543831.5	996	999	+	3	0	0	2629
P26439-1#30	0	3	3	P26439-1	747	750	+	3	P26439-1	3	1116	ENST00000528909.1	165	1278	++	147	P26439-1#30	0	3	ENST00000528909.1	909	912	+	3	0	0	2630
P26439-1#30	0	3	3	P26439-1	747	750	+	3	P26439-1	0	1116	ENST00000369416.4	142	1258	++	44	P26439-1#30	0	3	ENST00000369416.4	889	892	+	3	0	0	2631
P26439-1#30	0	3	3	P26439-1	747	750	+	3	P26439-1	3	1116	ENST00000369413.8	144	1257	++	43	P26439-1#30	0	3	ENST00000369413.8	888	891	+	3	0	0	2632
P26439-1#31	0	3	3	P26439-1	756	759	+	3	P26439-1	0	1116	ENST00000543831.5	249	1365	++	162	P26439-1#31	0	3	ENST00000543831.5	1005	1008	+	3	0	0	2633
P26439-1#31	0	3	3	P26439-1	756	759	+	3	P26439-1	3	1116	ENST00000528909.1	165	1278	++	147	P26439-1#31	0	3	ENST00000528909.1	918	921	+	3	0	0	2634
P26439-1#31	0	3	3	P26439-1	756	759	+	3	P26439-1	0	1116	ENST00000369416.4	142	1258	++	44	P26439-1#31	0	3	ENST00000369416.4	898	901	+	3	0	0	2635
P26439-1#31	0	3	3	P26439-1	756	759	+	3	P26439-1	3	1116	ENST00000369413.8	144	1257	++	43	P26439-1#31	0	3	ENST00000369413.8	897	900	+	3	0	0	2636
P26439-1#32	0	3	3	P26439-1	759	762	+	3	P26439-1	0	1116	ENST00000543831.5	249	1365	++	162	P26439-1#32	0	3	ENST00000543831.5	1008	1011	+	3	0	0	2637
P26439-1#32	0	3	3	P26439-1	759	762	+	3	P26439-1	3	1116	ENST00000528909.1	165	1278	++	147	P26439-1#32	0	3	ENST00000528909.1	921	924	+	3	0	0	2638
P26439-1#32	0	3	3	P26439-1	759	762	+	3	P26439-1	0	1116	ENST00000369416.4	142	1258	++	44	P26439-1#32	0	3	ENST00000369416.4	901	904	+	3	0	0	2639
P26439-1#32	0	3	3	P26439-1	759	762	+	3	P26439-1	3	1116	ENST00000369413.8	144	1257	++	43	P26439-1#32	0	3	ENST00000369413.8	900	903	+	3	0	0	2640
P26439-1#33	0	3	3	P26439-1	774	777	+	3	P26439-1	0	1116	ENST00000543831.5	249	1365	++	162	P26439-1#33	0	3	ENST00000543831.5	1023	1026	+	3	0	0	2641
P26439-1#33	0	3	3	P26439-1	774	777	+	3	P26439-1	3	1116	ENST00000528909.1	165	1278	++	147	P26439-1#33	0	3	ENST00000528909.1	936	939	+	3	0	0	2642
P26439-1#33	0	3	3	P26439-1	774	777	+	3	P26439-1	0	1116	ENST00000369416.4	142	1258	++	44	P26439-1#33	0	3	ENST00000369416.4	916	919	+	3	0	0	2643
P26439-1#33	0	3	3	P26439-1	774	777	+	3	P26439-1	3	1116	ENST00000369413.8	144	1257	++	43	P26439-1#33	0	3	ENST00000369413.8	915	918	+	3	0	0	2644
P26439-1#34	0	3	3	P26439-1	774	777	+	3	P26439-1	0	1116	ENST00000543831.5	249	1365	++	162	P26439-1#34	0	3	ENST00000543831.5	1023	1026	+	3	0	0	2645
P26439-1#34	0	3	3	P26439-1	774	777	+	3	P26439-1	3	1116	ENST00000528909.1	165	1278	++	147	P26439-1#34	0	3	ENST00000528909.1	936	939	+	3	0	0	2646
P26439-1#34	0	3	3	P26439-1	774	777	+	3	P26439-1	0	1116	ENST00000369416.4	142	1258	++	44	P26439-1#34	0	3	ENST00000369416.4	916	919	+	3	0	0	2647
P26439-1#34	0	3	3	P26439-1	774	777	+	3	P26439-1	3	1116	ENST00000369413.8	144	1257	++	43	P26439-1#34	0	3	ENST00000369413.8	915	918	+	3	0	0	2648
P26439-1#35	0	3	3	P26439-1	879	882	+	3	P26439-1	0	1116	ENST00000543831.5	249	1365	++	162	P26439-1#35	0	3	ENST00000543831.5	1128	1131	+	3	0	0	2649
P26439-1#35	0	3	3	P26439-1	879	882	+	3	P26439-1	3	1116	ENST00000528909.1	165	1278	++	147	P26439-1#35	0	3	ENST00000528909.1	1041	1044	+	3	0	0	2650
P26439-1#35	0	3	3	P26439-1	879	882	+	3	P26439-1	0	1116	ENST00000369416.4	142	1258	++	44	P26439-1#35	0	3	ENST00000369416.4	1021	1024	+	3	0	0	2651
P26439-1#35	0	3	3	P26439-1	879	882	+	3	P26439-1	3	1116	ENST00000369413.8	144	1257	++	43	P26439-1#35	0	3	ENST00000369413.8	1020	1023	+	3	0	0	2652
P26439-1#36	0	3	3	P26439-1	1020	1023	+	3	P26439-1	0	1116	ENST00000543831.5	249	1365	++	162	P26439-1#36	0	3	ENST00000543831.5	1269	1272	+	3	0	0	2653
P26439-1#36	0	3	3	P26439-1	1020	1023	+	3	P26439-1	3	1116	ENST00000528909.1	165	1278	++	147	P26439-1#36	0	3	ENST00000528909.1	1182	1185	+	3	0	0	2654
P26439-1#36	0	3	3	P26439-1	1020	1023	+	3	P26439-1	0	1116	ENST00000369416.4	142	1258	++	44	P26439-1#36	0	3	ENST00000369416.4	1162	1165	+	3	0	0	2655
P26439-1#36	0	3	3	P26439-1	1020	1023	+	3	P26439-1	3	1116	ENST00000369413.8	144	1257	++	43	P26439-1#36	0	3	ENST00000369413.8	1161	1164	+	3	0	0	2656
P26439-1#37	0	6	6	P26439-1	153	159	+	6	P26439-1	0	1116	ENST00000543831.5	249	1365	++	162	P26439-1#37	0	6	ENST00000543831.5	402	408	+	6	0	0	2657
P26439-1#37	0	6	6	P26439-1	153	159	+	6	P26439-1	3	242	ENST00000531340.5	113	352	+	154	P26439-1#37	0	6	ENST00000531340.5	263	269	+	6	0	0	2658
P26439-1#37	0	6	6	P26439-1	153	159	+	6	P26439-1	3	1116	ENST00000528909.1	165	1278	++	147	P26439-1#37	0	6	ENST00000528909.1	315	321	+	6	0	0	2659
P26439-1#37	0	6	6	P26439-1	153	159	+	6	P26439-1	0	587	ENST00000433745.5	130	717	+	82	P26439-1#37	0	6	ENST00000433745.5	283	289	+	6	0	0	2660
P26439-1#37	0	6	6	P26439-1	153	159	+	6	P26439-1	0	1116	ENST00000369416.4	142	1258	++	44	P26439-1#37	0	6	ENST00000369416.4	295	301	+	6	0	0	2661
P26439-1#37	0	6	6	P26439-1	153	159	+	6	P26439-1	3	1116	ENST00000369413.8	144	1257	++	43	P26439-1#37	0	6	ENST00000369413.8	294	300	+	6	0	0	2662
P26439-1#38	0	9	9	P26439-1	273	282	+	9	P26439-1	0	1116	ENST00000543831.5	249	1365	++	162	P26439-1#38	0	9	ENST00000543831.5	522	531	+	9	0	0	2663
P26439-1#38	0	9	9	P26439-1	273	282	+	9	P26439-1	3	1116	ENST00000528909.1	165	1278	++	147	P26439-1#38	0	9	ENST00000528909.1	435	444	+	9	0	0	2664
P26439-1#38	0	9	9	P26439-1	273	282	+	9	P26439-1	0	587	ENST00000433745.5	130	717	+	82	P26439-1#38	0	9	ENST00000433745.5	403	412	+	9	0	0	2665
P26439-1#38	0	9	9	P26439-1	273	282	+	9	P26439-1	0	1116	ENST00000369416.4	142	1258	++	44	P26439-1#38	0	9	ENST00000369416.4	415	424	+	9	0	0	2666
P26439-1#38	0	9	9	P26439-1	273	282	+	9	P26439-1	3	1116	ENST00000369413.8	144	1257	++	43	P26439-1#38	0	9	ENST00000369413.8	414	423	+	9	0	0	2667
P26439-1#39	0	3	3	P26439-1	693	696	+	3	P26439-1	0	1116	ENST00000543831.5	249	1365	++	162	P26439-1#39	0	3	ENST00000543831.5	942	945	+	3	0	0	2668
P26439-1#39	0	3	3	P26439-1	693	696	+	3	P26439-1	3	1116	ENST00000528909.1	165	1278	++	147	P26439-1#39	0	3	ENST00000528909.1	855	858	+	3	0	0	2669
P26439-1#39	0	3	3	P26439-1	693	696	+	3	P26439-1	0	1116	ENST00000369416.4	142	1258	++	44	P26439-1#39	0	3	ENST00000369416.4	835	838	+	3	0	0	2670
P26439-1#39	0	3	3	P26439-1	693	696	+	3	P26439-1	3	1116	ENST00000369413.8	144	1257	++	43	P26439-1#39	0	3	ENST00000369413.8	834	837	+	3	0	0	2671
Q9GZX5#0	0	1596	1596	Q9GZX5	0	1596	+	1596	Q9GZX5	108	597	ENST00000601430.5	380	869	+	224	Q9GZX5#0	108	597	ENST00000601430.5	380	869	+	489	108	999	2672
Q9GZX5#0	0	1596	1596	Q9GZX5	0	1596	+	1596	Q9GZX5	0	186	ENST00000597788.5	347	533	+	214	Q9GZX5#0	0	186	ENST00000597788.5	347	533	+	186	0	1410	2673
Q9GZX5#0	0	1596	1596	Q9GZX5	0	1596	+	1596	Q9GZX5	0	202	ENST00000594929.5	351	553	+	208	Q9GZX5#0	0	202	ENST00000594929.5	351	553	+	202	0	1394	2674
Q9GZX5#0	0	1596	1596	Q9GZX5	0	1596	+	1596	Q9GZX5	0	157	ENST00000593596.1	332	489	+	203	Q9GZX5#0	0	157	ENST00000593596.1	332	489	+	157	0	1439	2675
Q9GZX5#0	0	1596	1596	Q9GZX5	0	1596	+	1596	Q9GZX5	0	1596	ENST00000243644.9	242	1838	++	4	Q9GZX5#0	0	1596	ENST00000243644.9	242	1838	+	1596	0	0	2676
Q9GZX5#1	0	216	216	Q9GZX5	21	237	+	216	Q9GZX5	108	597	ENST00000601430.5	380	869	+	224	Q9GZX5#1	87	216	ENST00000601430.5	380	509	+	129	87	0	2677
Q9GZX5#1	0	216	216	Q9GZX5	21	237	+	216	Q9GZX5	0	186	ENST00000597788.5	347	533	+	214	Q9GZX5#1	0	165	ENST00000597788.5	368	533	+	165	0	51	2678
Q9GZX5#1	0	216	216	Q9GZX5	21	237	+	216	Q9GZX5	0	202	ENST00000594929.5	351	553	+	208	Q9GZX5#1	0	181	ENST00000594929.5	372	553	+	181	0	35	2679
Q9GZX5#1	0	216	216	Q9GZX5	21	237	+	216	Q9GZX5	0	157	ENST00000593596.1	332	489	+	203	Q9GZX5#1	0	136	ENST00000593596.1	353	489	+	136	0	80	2680
Q9GZX5#1	0	216	216	Q9GZX5	21	237	+	216	Q9GZX5	0	1596	ENST00000243644.9	242	1838	++	4	Q9GZX5#1	0	216	ENST00000243644.9	263	479	+	216	0	0	2681
Q9GZX5#2	0	69	69	Q9GZX5	615	684	+	69	Q9GZX5	0	1596	ENST00000243644.9	242	1838	++	4	Q9GZX5#2	0	69	ENST00000243644.9	857	926	+	69	0	0	2682
Q9GZX5#3	0	69	69	Q9GZX5	699	768	+	69	Q9GZX5	0	1596	ENST00000243644.9	242	1838	++	4	Q9GZX5#3	0	69	ENST00000243644.9	941	1010	+	69	0	0	2683
Q9GZX5#4	0	69	69	Q9GZX5	783	852	+	69	Q9GZX5	0	1596	ENST00000243644.9	242	1838	++	4	Q9GZX5#4	0	69	ENST00000243644.9	1025	1094	+	69	0	0	2684
Q9GZX5#5	0	69	69	Q9GZX5	867	936	+	69	Q9GZX5	0	1596	ENST00000243644.9	242	1838	++	4	Q9GZX5#5	0	69	ENST00000243644.9	1109	1178	+	69	0	0	2685
Q9GZX5#6	0	69	69	Q9GZX5	951	1020	+	69	Q9GZX5	0	1596	ENST00000243644.9	242	1838	++	4	Q9GZX5#6	0	69	ENST00000243644.9	1193	1262	+	69	0	0	2686
Q9GZX5#7	0	69	69	Q9GZX5	1035	1104	+	69	Q9GZX5	0	1596	ENST00000243644.9	242	1838	++	4	Q9GZX5#7	0	69	ENST00000243644.9	1277	1346	+	69	0	0	2687
Q9GZX5#8	0	69	69	Q9GZX5	1119	1188	+	69	Q9GZX5	0	1596	ENST00000243644.9	242	1838	++	4	Q9GZX5#8	0	69	ENST00000243644.9	1361	1430	+	69	0	0	2688
Q9GZX5#9	0	69	69	Q9GZX5	1203	1272	+	69	Q9GZX5	0	1596	ENST00000243644.9	242	1838	++	4	Q9GZX5#9	0	69	ENST00000243644.9	1445	1514	+	69	0	0	2689
Q9GZX5#10	0	117	117	Q9GZX5	1278	1395	+	117	Q9GZX5	0	1596	ENST00000243644.9	242	1838	++	4	Q9GZX5#10	0	117	ENST00000243644.9	1520	1637	+	117	0	0	2690
Q9GZX5#11	0	66	66	Q9GZX5	1278	1344	+	66	Q9GZX5	0	1596	ENST00000243644.9	242	1838	++	4	Q9GZX5#11	0	66	ENST00000243644.9	1520	1586	+	66	0	0	2691
Q9GZX5#12	0	51	51	Q9GZX5	1344	1395	+	51	Q9GZX5	0	1596	ENST00000243644.9	242	1838	++	4	Q9GZX5#12	0	51	ENST00000243644.9	1586	1637	+	51	0	0	2692
Q9GZX5#13	0	3	3	Q9GZX5	108	111	+	3	Q9GZX5	108	597	ENST00000601430.5	380	869	+	224	Q9GZX5#13	0	3	ENST00000601430.5	380	383	+	3	0	0	2693
Q9GZX5#13	0	3	3	Q9GZX5	108	111	+	3	Q9GZX5	0	186	ENST00000597788.5	347	533	+	214	Q9GZX5#13	0	3	ENST00000597788.5	455	458	+	3	0	0	2694
Q9GZX5#13	0	3	3	Q9GZX5	108	111	+	3	Q9GZX5	0	202	ENST00000594929.5	351	553	+	208	Q9GZX5#13	0	3	ENST00000594929.5	459	462	+	3	0	0	2695
Q9GZX5#13	0	3	3	Q9GZX5	108	111	+	3	Q9GZX5	0	157	ENST00000593596.1	332	489	+	203	Q9GZX5#13	0	3	ENST00000593596.1	440	443	+	3	0	0	2696
Q9GZX5#13	0	3	3	Q9GZX5	108	111	+	3	Q9GZX5	0	1596	ENST00000243644.9	242	1838	++	4	Q9GZX5#13	0	3	ENST00000243644.9	350	353	+	3	0	0	2697
Q9GZX5#14	0	3	3	Q9GZX5	195	198	+	3	Q9GZX5	108	597	ENST00000601430.5	380	869	+	224	Q9GZX5#14	0	3	ENST00000601430.5	467	470	+	3	0	0	2698
Q9GZX5#14	0	3	3	Q9GZX5	195	198	+	3	Q9GZX5	0	202	ENST00000594929.5	351	553	+	208	Q9GZX5#14	0	3	ENST00000594929.5	546	549	+	3	0	0	2699
Q9GZX5#14	0	3	3	Q9GZX5	195	198	+	3	Q9GZX5	0	1596	ENST00000243644.9	242	1838	++	4	Q9GZX5#14	0	3	ENST00000243644.9	437	440	+	3	0	0	2700
Q9GZX5#15	0	3	3	Q9GZX5	204	207	+	3	Q9GZX5	108	597	ENST00000601430.5	380	869	+	224	Q9GZX5#15	0	3	ENST00000601430.5	476	479	+	3	0	0	2701
Q9GZX5#15	0	3	3	Q9GZX5	204	207	+	3	Q9GZX5	0	1596	ENST00000243644.9	242	1838	++	4	Q9GZX5#15	0	3	ENST00000243644.9	446	449	+	3	0	0	2702
Q9GZX5#16	0	3	3	Q9GZX5	393	396	+	3	Q9GZX5	108	597	ENST00000601430.5	380	869	+	224	Q9GZX5#16	0	3	ENST00000601430.5	665	668	+	3	0	0	2703
Q9GZX5#16	0	3	3	Q9GZX5	393	396	+	3	Q9GZX5	0	1596	ENST00000243644.9	242	1838	++	4	Q9GZX5#16	0	3	ENST00000243644.9	635	638	+	3	0	0	2704
Q9GZX5#17	0	3	3	Q9GZX5	1215	1218	+	3	Q9GZX5	0	1596	ENST00000243644.9	242	1838	++	4	Q9GZX5#17	0	3	ENST00000243644.9	1457	1460	+	3	0	0	2705
Q9GZX5#18	0	3	3	Q9GZX5	1413	1416	+	3	Q9GZX5	0	1596	ENST00000243644.9	242	1838	++	4	Q9GZX5#18	0	3	ENST00000243644.9	1655	1658	+	3	0	0	2706
Q9GZX5#19	0	3	3	Q9GZX5	1500	1503	+	3	Q9GZX5	0	1596	ENST00000243644.9	242	1838	++	4	Q9GZX5#19	0	3	ENST00000243644.9	1742	1745	+	3	0	0	2707
Q9GZX5#20	0	3	3	Q9GZX5	1569	1572	+	3	Q9GZX5	0	1596	ENST00000243644.9	242	1838	++	4	Q9GZX5#20	0	3	ENST00000243644.9	1811	1814	+	3	0	0	2708
P01009-1#0	0	72	72	P01009-1	0	72	+	72	P01009-1	0	1254	ENST00000636712.1	152	1406	++	236	P01009-1#0	0	72	ENST00000636712.1	152	224	+	72	0	0	2709
P01009-1#0	0	72	72	P01009-1	0	72	+	72	P01009-1	0	434	ENST00000557492.5	517	951	+	175	P01009-1#0	0	72	ENST00000557492.5	517	589	+	72	0	0	2710
P01009-1#0	0	72	72	P01009-1	0	72	+	72	P01009-1	0	67	ENST00000557118.5	516	583	+	174	P01009-1#0	0	67	ENST00000557118.5	516	583	+	67	0	5	2711
P01009-1#0	0	72	72	P01009-1	0	72	+	72	P01009-1	0	351	ENST00000556955.5	220	571	+	173	P01009-1#0	0	72	ENST00000556955.5	220	292	+	72	0	0	2712
P01009-1#0	0	72	72	P01009-1	0	72	+	72	P01009-1	0	469	ENST00000556091.1	174	643	+	172	P01009-1#0	0	72	ENST00000556091.1	174	246	+	72	0	0	2713
P01009-1#0	0	72	72	P01009-1	0	72	+	72	P01009-1	0	278	ENST00000553327.5	303	581	+	170	P01009-1#0	0	72	ENST00000553327.5	303	375	+	72	0	0	2714
P01009-1#0	0	72	72	P01009-1	0	72	+	72	P01009-1	0	918	ENST00000489769.1	9	927	++	119	P01009-1#0	0	72	ENST00000489769.1	9	81	+	72	0	0	2715
P01009-1#0	0	72	72	P01009-1	0	72	+	72	P01009-1	0	1254	ENST00000449399.7	302	1556	++	100	P01009-1#0	0	72	ENST00000449399.7	302	374	+	72	0	0	2716
P01009-1#0	0	72	72	P01009-1	0	72	+	72	P01009-1	0	1254	ENST00000448921.5	573	1827	++	98	P01009-1#0	0	72	ENST00000448921.5	573	645	+	72	0	0	2717
P01009-1#0	0	72	72	P01009-1	0	72	+	72	P01009-1	0	1254	ENST00000440909.5	185	1439	++	91	P01009-1#0	0	72	ENST00000440909.5	185	257	+	72	0	0	2718
P01009-1#0	0	72	72	P01009-1	0	72	+	72	P01009-1	0	1254	ENST00000437397.5	381	1635	++	89	P01009-1#0	0	72	ENST00000437397.5	381	453	+	72	0	0	2719
P01009-1#0	0	72	72	P01009-1	0	72	+	72	P01009-1	0	1254	ENST00000404814.8	311	1565	++	68	P01009-1#0	0	72	ENST00000404814.8	311	383	+	72	0	0	2720
P01009-1#0	0	72	72	P01009-1	0	72	+	72	P01009-1	0	1065	ENST00000402629.1	34	1099	++	67	P01009-1#0	0	72	ENST00000402629.1	34	106	+	72	0	0	2721
P01009-1#0	0	72	72	P01009-1	0	72	+	72	P01009-1	0	1254	ENST00000393088.8	555	1809	++	63	P01009-1#0	0	72	ENST00000393088.8	555	627	+	72	0	0	2722
P01009-1#0	0	72	72	P01009-1	0	72	+	72	P01009-1	0	1254	ENST00000393087.9	47	1301	++	62	P01009-1#0	0	72	ENST00000393087.9	47	119	+	72	0	0	2723
P01009-1#0	0	72	72	P01009-1	0	72	+	72	P01009-1	0	1254	ENST00000355814.8	277	1531	++	36	P01009-1#0	0	72	ENST00000355814.8	277	349	+	72	0	0	2724
P01009-1#1	0	1182	1182	P01009-1	72	1254	+	1182	P01009-1	0	1254	ENST00000636712.1	152	1406	++	236	P01009-1#1	0	1182	ENST00000636712.1	224	1406	+	1182	0	0	2725
P01009-1#1	0	1182	1182	P01009-1	72	1254	+	1182	P01009-1	0	434	ENST00000557492.5	517	951	+	175	P01009-1#1	0	362	ENST00000557492.5	589	951	+	362	0	820	2726
P01009-1#1	0	1182	1182	P01009-1	72	1254	+	1182	P01009-1	0	351	ENST00000556955.5	220	571	+	173	P01009-1#1	0	279	ENST00000556955.5	292	571	+	279	0	903	2727
P01009-1#1	0	1182	1182	P01009-1	72	1254	+	1182	P01009-1	0	469	ENST00000556091.1	174	643	+	172	P01009-1#1	0	397	ENST00000556091.1	246	643	+	397	0	785	2728
P01009-1#1	0	1182	1182	P01009-1	72	1254	+	1182	P01009-1	258	575	ENST00000554720.1	129	446	+	171	P01009-1#1	186	503	ENST00000554720.1	129	446	+	317	186	679	2729
P01009-1#1	0	1182	1182	P01009-1	72	1254	+	1182	P01009-1	0	278	ENST00000553327.5	303	581	+	170	P01009-1#1	0	206	ENST00000553327.5	375	581	+	206	0	976	2730
P01009-1#1	0	1182	1182	P01009-1	72	1254	+	1182	P01009-1	0	918	ENST00000489769.1	9	927	++	119	P01009-1#1	0	846	ENST00000489769.1	81	927	+	846	0	336	2731
P01009-1#1	0	1182	1182	P01009-1	72	1254	+	1182	P01009-1	0	1254	ENST00000449399.7	302	1556	++	100	P01009-1#1	0	1182	ENST00000449399.7	374	1556	+	1182	0	0	2732
P01009-1#1	0	1182	1182	P01009-1	72	1254	+	1182	P01009-1	0	1254	ENST00000448921.5	573	1827	++	98	P01009-1#1	0	1182	ENST00000448921.5	645	1827	+	1182	0	0	2733
P01009-1#1	0	1182	1182	P01009-1	72	1254	+	1182	P01009-1	0	1254	ENST00000440909.5	185	1439	++	91	P01009-1#1	0	1182	ENST00000440909.5	257	1439	+	1182	0	0	2734
P01009-1#1	0	1182	1182	P01009-1	72	1254	+	1182	P01009-1	0	1254	ENST00000437397.5	381	1635	++	89	P01009-1#1	0	1182	ENST00000437397.5	453	1635	+	1182	0	0	2735
P01009-1#1	0	1182	1182	P01009-1	72	1254	+	1182	P01009-1	0	1254	ENST00000404814.8	311	1565	++	68	P01009-1#1	0	1182	ENST00000404814.8	383	1565	+	1182	0	0	2736
P01009-1#1	0	1182	1182	P01009-1	72	1254	+	1182	P01009-1	0	1065	ENST00000402629.1	34	1099	++	67	P01009-1#1	0	993	ENST00000402629.1	106	1099	+	993	0	189	2737
P01009-1#1	0	1182	1182	P01009-1	72	1254	+	1182	P01009-1	0	1254	ENST00000393088.8	555	1809	++	63	P01009-1#1	0	1182	ENST00000393088.8	627	1809	+	1182	0	0	2738
P01009-1#1	0	1182	1182	P01009-1	72	1254	+	1182	P01009-1	0	1254	ENST00000393087.9	47	1301	++	62	P01009-1#1	0	1182	ENST00000393087.9	119	1301	+	1182	0	0	2739
P01009-1#1	0	1182	1182	P01009-1	72	1254	+	1182	P01009-1	0	1254	ENST00000355814.8	277	1531	++	36	P01009-1#1	0	1182	ENST00000355814.8	349	1531	+	1182	0	0	2740
P01009-1#2	0	132	132	P01009-1	1122	1254	+	132	P01009-1	0	1254	ENST00000636712.1	152	1406	++	236	P01009-1#2	0	132	ENST00000636712.1	1274	1406	+	132	0	0	2741
P01009-1#2	0	132	132	P01009-1	1122	1254	+	132	P01009-1	0	1254	ENST00000449399.7	302	1556	++	100	P01009-1#2	0	132	ENST00000449399.7	1424	1556	+	132	0	0	2742
P01009-1#2	0	132	132	P01009-1	1122	1254	+	132	P01009-1	0	1254	ENST00000448921.5	573	1827	++	98	P01009-1#2	0	132	ENST00000448921.5	1695	1827	+	132	0	0	2743
P01009-1#2	0	132	132	P01009-1	1122	1254	+	132	P01009-1	0	1254	ENST00000440909.5	185	1439	++	91	P01009-1#2	0	132	ENST00000440909.5	1307	1439	+	132	0	0	2744
P01009-1#2	0	132	132	P01009-1	1122	1254	+	132	P01009-1	0	1254	ENST00000437397.5	381	1635	++	89	P01009-1#2	0	132	ENST00000437397.5	1503	1635	+	132	0	0	2745
P01009-1#2	0	132	132	P01009-1	1122	1254	+	132	P01009-1	0	1254	ENST00000404814.8	311	1565	++	68	P01009-1#2	0	132	ENST00000404814.8	1433	1565	+	132	0	0	2746
P01009-1#2	0	132	132	P01009-1	1122	1254	+	132	P01009-1	0	1254	ENST00000393088.8	555	1809	++	63	P01009-1#2	0	132	ENST00000393088.8	1677	1809	+	132	0	0	2747
P01009-1#2	0	132	132	P01009-1	1122	1254	+	132	P01009-1	0	1254	ENST00000393087.9	47	1301	++	62	P01009-1#2	0	132	ENST00000393087.9	1169	1301	+	132	0	0	2748
P01009-1#2	0	132	132	P01009-1	1122	1254	+	132	P01009-1	0	1254	ENST00000355814.8	277	1531	++	36	P01009-1#2	0	132	ENST00000355814.8	1399	1531	+	132	0	0	2749
P01009-1#3	0	75	75	P01009-1	1101	1176	+	75	P01009-1	0	1254	ENST00000636712.1	152	1406	++	236	P01009-1#3	0	75	ENST00000636712.1	1253	1328	+	75	0	0	2750
P01009-1#3	0	75	75	P01009-1	1101	1176	+	75	P01009-1	0	1254	ENST00000449399.7	302	1556	++	100	P01009-1#3	0	75	ENST00000449399.7	1403	1478	+	75	0	0	2751
P01009-1#3	0	75	75	P01009-1	1101	1176	+	75	P01009-1	0	1254	ENST00000448921.5	573	1827	++	98	P01009-1#3	0	75	ENST00000448921.5	1674	1749	+	75	0	0	2752
P01009-1#3	0	75	75	P01009-1	1101	1176	+	75	P01009-1	0	1254	ENST00000440909.5	185	1439	++	91	P01009-1#3	0	75	ENST00000440909.5	1286	1361	+	75	0	0	2753
P01009-1#3	0	75	75	P01009-1	1101	1176	+	75	P01009-1	0	1254	ENST00000437397.5	381	1635	++	89	P01009-1#3	0	75	ENST00000437397.5	1482	1557	+	75	0	0	2754
P01009-1#3	0	75	75	P01009-1	1101	1176	+	75	P01009-1	0	1254	ENST00000404814.8	311	1565	++	68	P01009-1#3	0	75	ENST00000404814.8	1412	1487	+	75	0	0	2755
P01009-1#3	0	75	75	P01009-1	1101	1176	+	75	P01009-1	0	1254	ENST00000393088.8	555	1809	++	63	P01009-1#3	0	75	ENST00000393088.8	1656	1731	+	75	0	0	2756
P01009-1#3	0	75	75	P01009-1	1101	1176	+	75	P01009-1	0	1254	ENST00000393087.9	47	1301	++	62	P01009-1#3	0	75	ENST00000393087.9	1148	1223	+	75	0	0	2757
P01009-1#3	0	75	75	P01009-1	1101	1176	+	75	P01009-1	0	1254	ENST00000355814.8	277	1531	++	36	P01009-1#3	0	75	ENST00000355814.8	1378	1453	+	75	0	0	2758
P01009-1#4	0	6	6	P01009-1	1053	1059	+	6	P01009-1	0	1254	ENST00000636712.1	152	1406	++	236	P01009-1#4	0	6	ENST00000636712.1	1205	1211	+	6	0	0	2759
P01009-1#4	0	6	6	P01009-1	1053	1059	+	6	P01009-1	0	1254	ENST00000449399.7	302	1556	++	100	P01009-1#4	0	6	ENST00000449399.7	1355	1361	+	6	0	0	2760
P01009-1#4	0	6	6	P01009-1	1053	1059	+	6	P01009-1	0	1254	ENST00000448921.5	573	1827	++	98	P01009-1#4	0	6	ENST00000448921.5	1626	1632	+	6	0	0	2761
P01009-1#4	0	6	6	P01009-1	1053	1059	+	6	P01009-1	0	1254	ENST00000440909.5	185	1439	++	91	P01009-1#4	0	6	ENST00000440909.5	1238	1244	+	6	0	0	2762
P01009-1#4	0	6	6	P01009-1	1053	1059	+	6	P01009-1	0	1254	ENST00000437397.5	381	1635	++	89	P01009-1#4	0	6	ENST00000437397.5	1434	1440	+	6	0	0	2763
P01009-1#4	0	6	6	P01009-1	1053	1059	+	6	P01009-1	0	1254	ENST00000404814.8	311	1565	++	68	P01009-1#4	0	6	ENST00000404814.8	1364	1370	+	6	0	0	2764
P01009-1#4	0	6	6	P01009-1	1053	1059	+	6	P01009-1	0	1065	ENST00000402629.1	34	1099	++	67	P01009-1#4	0	6	ENST00000402629.1	1087	1093	+	6	0	0	2765
P01009-1#4	0	6	6	P01009-1	1053	1059	+	6	P01009-1	0	1254	ENST00000393088.8	555	1809	++	63	P01009-1#4	0	6	ENST00000393088.8	1608	1614	+	6	0	0	2766
P01009-1#4	0	6	6	P01009-1	1053	1059	+	6	P01009-1	0	1254	ENST00000393087.9	47	1301	++	62	P01009-1#4	0	6	ENST00000393087.9	1100	1106	+	6	0	0	2767
P01009-1#4	0	6	6	P01009-1	1053	1059	+	6	P01009-1	0	1254	ENST00000355814.8	277	1531	++	36	P01009-1#4	0	6	ENST00000355814.8	1330	1336	+	6	0	0	2768
P01009-1#5	0	6	6	P01009-1	1059	1065	+	6	P01009-1	0	1254	ENST00000636712.1	152	1406	++	236	P01009-1#5	0	6	ENST00000636712.1	1211	1217	+	6	0	0	2769
P01009-1#5	0	6	6	P01009-1	1059	1065	+	6	P01009-1	0	1254	ENST00000449399.7	302	1556	++	100	P01009-1#5	0	6	ENST00000449399.7	1361	1367	+	6	0	0	2770
P01009-1#5	0	6	6	P01009-1	1059	1065	+	6	P01009-1	0	1254	ENST00000448921.5	573	1827	++	98	P01009-1#5	0	6	ENST00000448921.5	1632	1638	+	6	0	0	2771
P01009-1#5	0	6	6	P01009-1	1059	1065	+	6	P01009-1	0	1254	ENST00000440909.5	185	1439	++	91	P01009-1#5	0	6	ENST00000440909.5	1244	1250	+	6	0	0	2772
P01009-1#5	0	6	6	P01009-1	1059	1065	+	6	P01009-1	0	1254	ENST00000437397.5	381	1635	++	89	P01009-1#5	0	6	ENST00000437397.5	1440	1446	+	6	0	0	2773
P01009-1#5	0	6	6	P01009-1	1059	1065	+	6	P01009-1	0	1254	ENST00000404814.8	311	1565	++	68	P01009-1#5	0	6	ENST00000404814.8	1370	1376	+	6	0	0	2774
P01009-1#5	0	6	6	P01009-1	1059	1065	+	6	P01009-1	0	1065	ENST00000402629.1	34	1099	++	67	P01009-1#5	0	6	ENST00000402629.1	1093	1099	+	6	0	0	2775
P01009-1#5	0	6	6	P01009-1	1059	1065	+	6	P01009-1	0	1254	ENST00000393088.8	555	1809	++	63	P01009-1#5	0	6	ENST00000393088.8	1614	1620	+	6	0	0	2776
P01009-1#5	0	6	6	P01009-1	1059	1065	+	6	P01009-1	0	1254	ENST00000393087.9	47	1301	++	62	P01009-1#5	0	6	ENST00000393087.9	1106	1112	+	6	0	0	2777
P01009-1#5	0	6	6	P01009-1	1059	1065	+	6	P01009-1	0	1254	ENST00000355814.8	277	1531	++	36	P01009-1#5	0	6	ENST00000355814.8	1336	1342	+	6	0	0	2778
P01009-1#6	0	6	6	P01009-1	1143	1149	+	6	P01009-1	0	1254	ENST00000636712.1	152	1406	++	236	P01009-1#6	0	6	ENST00000636712.1	1295	1301	+	6	0	0	2779
P01009-1#6	0	6	6	P01009-1	1143	1149	+	6	P01009-1	0	1254	ENST00000449399.7	302	1556	++	100	P01009-1#6	0	6	ENST00000449399.7	1445	1451	+	6	0	0	2780
P01009-1#6	0	6	6	P01009-1	1143	1149	+	6	P01009-1	0	1254	ENST00000448921.5	573	1827	++	98	P01009-1#6	0	6	ENST00000448921.5	1716	1722	+	6	0	0	2781
P01009-1#6	0	6	6	P01009-1	1143	1149	+	6	P01009-1	0	1254	ENST00000440909.5	185	1439	++	91	P01009-1#6	0	6	ENST00000440909.5	1328	1334	+	6	0	0	2782
P01009-1#6	0	6	6	P01009-1	1143	1149	+	6	P01009-1	0	1254	ENST00000437397.5	381	1635	++	89	P01009-1#6	0	6	ENST00000437397.5	1524	1530	+	6	0	0	2783
P01009-1#6	0	6	6	P01009-1	1143	1149	+	6	P01009-1	0	1254	ENST00000404814.8	311	1565	++	68	P01009-1#6	0	6	ENST00000404814.8	1454	1460	+	6	0	0	2784
P01009-1#6	0	6	6	P01009-1	1143	1149	+	6	P01009-1	0	1254	ENST00000393088.8	555	1809	++	63	P01009-1#6	0	6	ENST00000393088.8	1698	1704	+	6	0	0	2785
P01009-1#6	0	6	6	P01009-1	1143	1149	+	6	P01009-1	0	1254	ENST00000393087.9	47	1301	++	62	P01009-1#6	0	6	ENST00000393087.9	1190	1196	+	6	0	0	2786
P01009-1#6	0	6	6	P01009-1	1143	1149	+	6	P01009-1	0	1254	ENST00000355814.8	277	1531	++	36	P01009-1#6	0	6	ENST00000355814.8	1420	1426	+	6	0	0	2787
P01009-1#7	0	3	3	P01009-1	111	114	+	3	P01009-1	0	1254	ENST00000636712.1	152	1406	++	236	P01009-1#7	0	3	ENST00000636712.1	263	266	+	3	0	0	2788
P01009-1#7	0	3	3	P01009-1	111	114	+	3	P01009-1	0	434	ENST00000557492.5	517	951	+	175	P01009-1#7	0	3	ENST00000557492.5	628	631	+	3	0	0	2789
P01009-1#7	0	3	3	P01009-1	111	114	+	3	P01009-1	0	351	ENST00000556955.5	220	571	+	173	P01009-1#7	0	3	ENST00000556955.5	331	334	+	3	0	0	2790
P01009-1#7	0	3	3	P01009-1	111	114	+	3	P01009-1	0	469	ENST00000556091.1	174	643	+	172	P01009-1#7	0	3	ENST00000556091.1	285	288	+	3	0	0	2791
P01009-1#7	0	3	3	P01009-1	111	114	+	3	P01009-1	0	278	ENST00000553327.5	303	581	+	170	P01009-1#7	0	3	ENST00000553327.5	414	417	+	3	0	0	2792
P01009-1#7	0	3	3	P01009-1	111	114	+	3	P01009-1	0	918	ENST00000489769.1	9	927	++	119	P01009-1#7	0	3	ENST00000489769.1	120	123	+	3	0	0	2793
P01009-1#7	0	3	3	P01009-1	111	114	+	3	P01009-1	0	1254	ENST00000449399.7	302	1556	++	100	P01009-1#7	0	3	ENST00000449399.7	413	416	+	3	0	0	2794
P01009-1#7	0	3	3	P01009-1	111	114	+	3	P01009-1	0	1254	ENST00000448921.5	573	1827	++	98	P01009-1#7	0	3	ENST00000448921.5	684	687	+	3	0	0	2795
P01009-1#7	0	3	3	P01009-1	111	114	+	3	P01009-1	0	1254	ENST00000440909.5	185	1439	++	91	P01009-1#7	0	3	ENST00000440909.5	296	299	+	3	0	0	2796
P01009-1#7	0	3	3	P01009-1	111	114	+	3	P01009-1	0	1254	ENST00000437397.5	381	1635	++	89	P01009-1#7	0	3	ENST00000437397.5	492	495	+	3	0	0	2797
P01009-1#7	0	3	3	P01009-1	111	114	+	3	P01009-1	0	1254	ENST00000404814.8	311	1565	++	68	P01009-1#7	0	3	ENST00000404814.8	422	425	+	3	0	0	2798
P01009-1#7	0	3	3	P01009-1	111	114	+	3	P01009-1	0	1065	ENST00000402629.1	34	1099	++	67	P01009-1#7	0	3	ENST00000402629.1	145	148	+	3	0	0	2799
P01009-1#7	0	3	3	P01009-1	111	114	+	3	P01009-1	0	1254	ENST00000393088.8	555	1809	++	63	P01009-1#7	0	3	ENST00000393088.8	666	669	+	3	0	0	2800
P01009-1#7	0	3	3	P01009-1	111	114	+	3	P01009-1	0	1254	ENST00000393087.9	47	1301	++	62	P01009-1#7	0	3	ENST00000393087.9	158	161	+	3	0	0	2801
P01009-1#7	0	3	3	P01009-1	111	114	+	3	P01009-1	0	1254	ENST00000355814.8	277	1531	++	36	P01009-1#7	0	3	ENST00000355814.8	388	391	+	3	0	0	2802
P01009-1#8	0	3	3	P01009-1	765	768	+	3	P01009-1	0	1254	ENST00000636712.1	152	1406	++	236	P01009-1#8	0	3	ENST00000636712.1	917	920	+	3	0	0	2803
P01009-1#8	0	3	3	P01009-1	765	768	+	3	P01009-1	0	918	ENST00000489769.1	9	927	++	119	P01009-1#8	0	3	ENST00000489769.1	774	777	+	3	0	0	2804
P01009-1#8	0	3	3	P01009-1	765	768	+	3	P01009-1	0	1254	ENST00000449399.7	302	1556	++	100	P01009-1#8	0	3	ENST00000449399.7	1067	1070	+	3	0	0	2805
P01009-1#8	0	3	3	P01009-1	765	768	+	3	P01009-1	0	1254	ENST00000448921.5	573	1827	++	98	P01009-1#8	0	3	ENST00000448921.5	1338	1341	+	3	0	0	2806
P01009-1#8	0	3	3	P01009-1	765	768	+	3	P01009-1	0	1254	ENST00000440909.5	185	1439	++	91	P01009-1#8	0	3	ENST00000440909.5	950	953	+	3	0	0	2807
P01009-1#8	0	3	3	P01009-1	765	768	+	3	P01009-1	0	1254	ENST00000437397.5	381	1635	++	89	P01009-1#8	0	3	ENST00000437397.5	1146	1149	+	3	0	0	2808
P01009-1#8	0	3	3	P01009-1	765	768	+	3	P01009-1	0	1254	ENST00000404814.8	311	1565	++	68	P01009-1#8	0	3	ENST00000404814.8	1076	1079	+	3	0	0	2809
P01009-1#8	0	3	3	P01009-1	765	768	+	3	P01009-1	0	1065	ENST00000402629.1	34	1099	++	67	P01009-1#8	0	3	ENST00000402629.1	799	802	+	3	0	0	2810
P01009-1#8	0	3	3	P01009-1	765	768	+	3	P01009-1	0	1254	ENST00000393088.8	555	1809	++	63	P01009-1#8	0	3	ENST00000393088.8	1320	1323	+	3	0	0	2811
P01009-1#8	0	3	3	P01009-1	765	768	+	3	P01009-1	0	1254	ENST00000393087.9	47	1301	++	62	P01009-1#8	0	3	ENST00000393087.9	812	815	+	3	0	0	2812
P01009-1#8	0	3	3	P01009-1	765	768	+	3	P01009-1	0	1254	ENST00000355814.8	277	1531	++	36	P01009-1#8	0	3	ENST00000355814.8	1042	1045	+	3	0	0	2813
P01009-1#9	0	3	3	P01009-1	1146	1149	+	3	P01009-1	0	1254	ENST00000636712.1	152	1406	++	236	P01009-1#9	0	3	ENST00000636712.1	1298	1301	+	3	0	0	2814
P01009-1#9	0	3	3	P01009-1	1146	1149	+	3	P01009-1	0	1254	ENST00000449399.7	302	1556	++	100	P01009-1#9	0	3	ENST00000449399.7	1448	1451	+	3	0	0	2815
P01009-1#9	0	3	3	P01009-1	1146	1149	+	3	P01009-1	0	1254	ENST00000448921.5	573	1827	++	98	P01009-1#9	0	3	ENST00000448921.5	1719	1722	+	3	0	0	2816
P01009-1#9	0	3	3	P01009-1	1146	1149	+	3	P01009-1	0	1254	ENST00000440909.5	185	1439	++	91	P01009-1#9	0	3	ENST00000440909.5	1331	1334	+	3	0	0	2817
P01009-1#9	0	3	3	P01009-1	1146	1149	+	3	P01009-1	0	1254	ENST00000437397.5	381	1635	++	89	P01009-1#9	0	3	ENST00000437397.5	1527	1530	+	3	0	0	2818
P01009-1#9	0	3	3	P01009-1	1146	1149	+	3	P01009-1	0	1254	ENST00000404814.8	311	1565	++	68	P01009-1#9	0	3	ENST00000404814.8	1457	1460	+	3	0	0	2819
P01009-1#9	0	3	3	P01009-1	1146	1149	+	3	P01009-1	0	1254	ENST00000393088.8	555	1809	++	63	P01009-1#9	0	3	ENST00000393088.8	1701	1704	+	3	0	0	2820
P01009-1#9	0	3	3	P01009-1	1146	1149	+	3	P01009-1	0	1254	ENST00000393087.9	47	1301	++	62	P01009-1#9	0	3	ENST00000393087.9	1193	1196	+	3	0	0	2821
P01009-1#9	0	3	3	P01009-1	1146	1149	+	3	P01009-1	0	1254	ENST00000355814.8	277	1531	++	36	P01009-1#9	0	3	ENST00000355814.8	1423	1426	+	3	0	0	2822
P01009-1#10	0	3	3	P01009-1	207	210	+	3	P01009-1	0	1254	ENST00000636712.1	152	1406	++	236	P01009-1#10	0	3	ENST00000636712.1	359	362	+	3	0	0	2823
P01009-1#10	0	3	3	P01009-1	207	210	+	3	P01009-1	0	434	ENST00000557492.5	517	951	+	175	P01009-1#10	0	3	ENST00000557492.5	724	727	+	3	0	0	2824
P01009-1#10	0	3	3	P01009-1	207	210	+	3	P01009-1	0	351	ENST00000556955.5	220	571	+	173	P01009-1#10	0	3	ENST00000556955.5	427	430	+	3	0	0	2825
P01009-1#10	0	3	3	P01009-1	207	210	+	3	P01009-1	0	469	ENST00000556091.1	174	643	+	172	P01009-1#10	0	3	ENST00000556091.1	381	384	+	3	0	0	2826
P01009-1#10	0	3	3	P01009-1	207	210	+	3	P01009-1	0	278	ENST00000553327.5	303	581	+	170	P01009-1#10	0	3	ENST00000553327.5	510	513	+	3	0	0	2827
P01009-1#10	0	3	3	P01009-1	207	210	+	3	P01009-1	0	918	ENST00000489769.1	9	927	++	119	P01009-1#10	0	3	ENST00000489769.1	216	219	+	3	0	0	2828
P01009-1#10	0	3	3	P01009-1	207	210	+	3	P01009-1	0	1254	ENST00000449399.7	302	1556	++	100	P01009-1#10	0	3	ENST00000449399.7	509	512	+	3	0	0	2829
P01009-1#10	0	3	3	P01009-1	207	210	+	3	P01009-1	0	1254	ENST00000448921.5	573	1827	++	98	P01009-1#10	0	3	ENST00000448921.5	780	783	+	3	0	0	2830
P01009-1#10	0	3	3	P01009-1	207	210	+	3	P01009-1	0	1254	ENST00000440909.5	185	1439	++	91	P01009-1#10	0	3	ENST00000440909.5	392	395	+	3	0	0	2831
P01009-1#10	0	3	3	P01009-1	207	210	+	3	P01009-1	0	1254	ENST00000437397.5	381	1635	++	89	P01009-1#10	0	3	ENST00000437397.5	588	591	+	3	0	0	2832
P01009-1#10	0	3	3	P01009-1	207	210	+	3	P01009-1	0	1254	ENST00000404814.8	311	1565	++	68	P01009-1#10	0	3	ENST00000404814.8	518	521	+	3	0	0	2833
P01009-1#10	0	3	3	P01009-1	207	210	+	3	P01009-1	0	1065	ENST00000402629.1	34	1099	++	67	P01009-1#10	0	3	ENST00000402629.1	241	244	+	3	0	0	2834
P01009-1#10	0	3	3	P01009-1	207	210	+	3	P01009-1	0	1254	ENST00000393088.8	555	1809	++	63	P01009-1#10	0	3	ENST00000393088.8	762	765	+	3	0	0	2835
P01009-1#10	0	3	3	P01009-1	207	210	+	3	P01009-1	0	1254	ENST00000393087.9	47	1301	++	62	P01009-1#10	0	3	ENST00000393087.9	254	257	+	3	0	0	2836
P01009-1#10	0	3	3	P01009-1	207	210	+	3	P01009-1	0	1254	ENST00000355814.8	277	1531	++	36	P01009-1#10	0	3	ENST00000355814.8	484	487	+	3	0	0	2837
P01009-1#11	0	3	3	P01009-1	318	321	+	3	P01009-1	0	1254	ENST00000636712.1	152	1406	++	236	P01009-1#11	0	3	ENST00000636712.1	470	473	+	3	0	0	2838
P01009-1#11	0	3	3	P01009-1	318	321	+	3	P01009-1	0	434	ENST00000557492.5	517	951	+	175	P01009-1#11	0	3	ENST00000557492.5	835	838	+	3	0	0	2839
P01009-1#11	0	3	3	P01009-1	318	321	+	3	P01009-1	0	351	ENST00000556955.5	220	571	+	173	P01009-1#11	0	3	ENST00000556955.5	538	541	+	3	0	0	2840
P01009-1#11	0	3	3	P01009-1	318	321	+	3	P01009-1	0	469	ENST00000556091.1	174	643	+	172	P01009-1#11	0	3	ENST00000556091.1	492	495	+	3	0	0	2841
P01009-1#11	0	3	3	P01009-1	318	321	+	3	P01009-1	258	575	ENST00000554720.1	129	446	+	171	P01009-1#11	0	3	ENST00000554720.1	189	192	+	3	0	0	2842
P01009-1#11	0	3	3	P01009-1	318	321	+	3	P01009-1	0	918	ENST00000489769.1	9	927	++	119	P01009-1#11	0	3	ENST00000489769.1	327	330	+	3	0	0	2843
P01009-1#11	0	3	3	P01009-1	318	321	+	3	P01009-1	0	1254	ENST00000449399.7	302	1556	++	100	P01009-1#11	0	3	ENST00000449399.7	620	623	+	3	0	0	2844
P01009-1#11	0	3	3	P01009-1	318	321	+	3	P01009-1	0	1254	ENST00000448921.5	573	1827	++	98	P01009-1#11	0	3	ENST00000448921.5	891	894	+	3	0	0	2845
P01009-1#11	0	3	3	P01009-1	318	321	+	3	P01009-1	0	1254	ENST00000440909.5	185	1439	++	91	P01009-1#11	0	3	ENST00000440909.5	503	506	+	3	0	0	2846
P01009-1#11	0	3	3	P01009-1	318	321	+	3	P01009-1	0	1254	ENST00000437397.5	381	1635	++	89	P01009-1#11	0	3	ENST00000437397.5	699	702	+	3	0	0	2847
P01009-1#11	0	3	3	P01009-1	318	321	+	3	P01009-1	0	1254	ENST00000404814.8	311	1565	++	68	P01009-1#11	0	3	ENST00000404814.8	629	632	+	3	0	0	2848
P01009-1#11	0	3	3	P01009-1	318	321	+	3	P01009-1	0	1065	ENST00000402629.1	34	1099	++	67	P01009-1#11	0	3	ENST00000402629.1	352	355	+	3	0	0	2849
P01009-1#11	0	3	3	P01009-1	318	321	+	3	P01009-1	0	1254	ENST00000393088.8	555	1809	++	63	P01009-1#11	0	3	ENST00000393088.8	873	876	+	3	0	0	2850
P01009-1#11	0	3	3	P01009-1	318	321	+	3	P01009-1	0	1254	ENST00000393087.9	47	1301	++	62	P01009-1#11	0	3	ENST00000393087.9	365	368	+	3	0	0	2851
P01009-1#11	0	3	3	P01009-1	318	321	+	3	P01009-1	0	1254	ENST00000355814.8	277	1531	++	36	P01009-1#11	0	3	ENST00000355814.8	595	598	+	3	0	0	2852
P01009-1#12	0	3	3	P01009-1	810	813	+	3	P01009-1	0	1254	ENST00000636712.1	152	1406	++	236	P01009-1#12	0	3	ENST00000636712.1	962	965	+	3	0	0	2853
P01009-1#12	0	3	3	P01009-1	810	813	+	3	P01009-1	0	918	ENST00000489769.1	9	927	++	119	P01009-1#12	0	3	ENST00000489769.1	819	822	+	3	0	0	2854
P01009-1#12	0	3	3	P01009-1	810	813	+	3	P01009-1	0	1254	ENST00000449399.7	302	1556	++	100	P01009-1#12	0	3	ENST00000449399.7	1112	1115	+	3	0	0	2855
P01009-1#12	0	3	3	P01009-1	810	813	+	3	P01009-1	0	1254	ENST00000448921.5	573	1827	++	98	P01009-1#12	0	3	ENST00000448921.5	1383	1386	+	3	0	0	2856
P01009-1#12	0	3	3	P01009-1	810	813	+	3	P01009-1	0	1254	ENST00000440909.5	185	1439	++	91	P01009-1#12	0	3	ENST00000440909.5	995	998	+	3	0	0	2857
P01009-1#12	0	3	3	P01009-1	810	813	+	3	P01009-1	0	1254	ENST00000437397.5	381	1635	++	89	P01009-1#12	0	3	ENST00000437397.5	1191	1194	+	3	0	0	2858
P01009-1#12	0	3	3	P01009-1	810	813	+	3	P01009-1	0	1254	ENST00000404814.8	311	1565	++	68	P01009-1#12	0	3	ENST00000404814.8	1121	1124	+	3	0	0	2859
P01009-1#12	0	3	3	P01009-1	810	813	+	3	P01009-1	0	1065	ENST00000402629.1	34	1099	++	67	P01009-1#12	0	3	ENST00000402629.1	844	847	+	3	0	0	2860
P01009-1#12	0	3	3	P01009-1	810	813	+	3	P01009-1	0	1254	ENST00000393088.8	555	1809	++	63	P01009-1#12	0	3	ENST00000393088.8	1365	1368	+	3	0	0	2861
P01009-1#12	0	3	3	P01009-1	810	813	+	3	P01009-1	0	1254	ENST00000393087.9	47	1301	++	62	P01009-1#12	0	3	ENST00000393087.9	857	860	+	3	0	0	2862
P01009-1#12	0	3	3	P01009-1	810	813	+	3	P01009-1	0	1254	ENST00000355814.8	277	1531	++	36	P01009-1#12	0	3	ENST00000355814.8	1087	1090	+	3	0	0	2863
P01009-1#13	0	336	336	P01009-1	918	1254	+	336	P01009-1	0	1254	ENST00000636712.1	152	1406	++	236	P01009-1#13	0	336	ENST00000636712.1	1070	1406	+	336	0	0	2864
P01009-1#13	0	336	336	P01009-1	918	1254	+	336	P01009-1	0	1254	ENST00000449399.7	302	1556	++	100	P01009-1#13	0	336	ENST00000449399.7	1220	1556	+	336	0	0	2865
P01009-1#13	0	336	336	P01009-1	918	1254	+	336	P01009-1	0	1254	ENST00000448921.5	573	1827	++	98	P01009-1#13	0	336	ENST00000448921.5	1491	1827	+	336	0	0	2866
P01009-1#13	0	336	336	P01009-1	918	1254	+	336	P01009-1	0	1254	ENST00000440909.5	185	1439	++	91	P01009-1#13	0	336	ENST00000440909.5	1103	1439	+	336	0	0	2867
P01009-1#13	0	336	336	P01009-1	918	1254	+	336	P01009-1	0	1254	ENST00000437397.5	381	1635	++	89	P01009-1#13	0	336	ENST00000437397.5	1299	1635	+	336	0	0	2868
P01009-1#13	0	336	336	P01009-1	918	1254	+	336	P01009-1	0	1254	ENST00000404814.8	311	1565	++	68	P01009-1#13	0	336	ENST00000404814.8	1229	1565	+	336	0	0	2869
P01009-1#13	0	336	336	P01009-1	918	1254	+	336	P01009-1	0	1065	ENST00000402629.1	34	1099	++	67	P01009-1#13	0	147	ENST00000402629.1	952	1099	+	147	0	189	2870
P01009-1#13	0	336	336	P01009-1	918	1254	+	336	P01009-1	0	1254	ENST00000393088.8	555	1809	++	63	P01009-1#13	0	336	ENST00000393088.8	1473	1809	+	336	0	0	2871
P01009-1#13	0	336	336	P01009-1	918	1254	+	336	P01009-1	0	1254	ENST00000393087.9	47	1301	++	62	P01009-1#13	0	336	ENST00000393087.9	965	1301	+	336	0	0	2872
P01009-1#13	0	336	336	P01009-1	918	1254	+	336	P01009-1	0	1254	ENST00000355814.8	277	1531	++	36	P01009-1#13	0	336	ENST00000355814.8	1195	1531	+	336	0	0	2873
P01009-1#14	0	189	189	P01009-1	1065	1254	+	189	P01009-1	0	1254	ENST00000636712.1	152	1406	++	236	P01009-1#14	0	189	ENST00000636712.1	1217	1406	+	189	0	0	2874
P01009-1#14	0	189	189	P01009-1	1065	1254	+	189	P01009-1	0	1254	ENST00000449399.7	302	1556	++	100	P01009-1#14	0	189	ENST00000449399.7	1367	1556	+	189	0	0	2875
P01009-1#14	0	189	189	P01009-1	1065	1254	+	189	P01009-1	0	1254	ENST00000448921.5	573	1827	++	98	P01009-1#14	0	189	ENST00000448921.5	1638	1827	+	189	0	0	2876
P01009-1#14	0	189	189	P01009-1	1065	1254	+	189	P01009-1	0	1254	ENST00000440909.5	185	1439	++	91	P01009-1#14	0	189	ENST00000440909.5	1250	1439	+	189	0	0	2877
P01009-1#14	0	189	189	P01009-1	1065	1254	+	189	P01009-1	0	1254	ENST00000437397.5	381	1635	++	89	P01009-1#14	0	189	ENST00000437397.5	1446	1635	+	189	0	0	2878
P01009-1#14	0	189	189	P01009-1	1065	1254	+	189	P01009-1	0	1254	ENST00000404814.8	311	1565	++	68	P01009-1#14	0	189	ENST00000404814.8	1376	1565	+	189	0	0	2879
P01009-1#14	0	189	189	P01009-1	1065	1254	+	189	P01009-1	0	1254	ENST00000393088.8	555	1809	++	63	P01009-1#14	0	189	ENST00000393088.8	1620	1809	+	189	0	0	2880
P01009-1#14	0	189	189	P01009-1	1065	1254	+	189	P01009-1	0	1254	ENST00000393087.9	47	1301	++	62	P01009-1#14	0	189	ENST00000393087.9	1112	1301	+	189	0	0	2881
P01009-1#14	0	189	189	P01009-1	1065	1254	+	189	P01009-1	0	1254	ENST00000355814.8	277	1531	++	36	P01009-1#14	0	189	ENST00000355814.8	1342	1531	+	189	0	0	2882
P01009-1#15	0	3	3	P01009-1	9	12	+	3	P01009-1	0	1254	ENST00000636712.1	152	1406	++	236	P01009-1#15	0	3	ENST00000636712.1	161	164	+	3	0	0	2883
P01009-1#15	0	3	3	P01009-1	9	12	+	3	P01009-1	0	434	ENST00000557492.5	517	951	+	175	P01009-1#15	0	3	ENST00000557492.5	526	529	+	3	0	0	2884
P01009-1#15	0	3	3	P01009-1	9	12	+	3	P01009-1	0	67	ENST00000557118.5	516	583	+	174	P01009-1#15	0	3	ENST00000557118.5	525	528	+	3	0	0	2885
P01009-1#15	0	3	3	P01009-1	9	12	+	3	P01009-1	0	351	ENST00000556955.5	220	571	+	173	P01009-1#15	0	3	ENST00000556955.5	229	232	+	3	0	0	2886
P01009-1#15	0	3	3	P01009-1	9	12	+	3	P01009-1	0	469	ENST00000556091.1	174	643	+	172	P01009-1#15	0	3	ENST00000556091.1	183	186	+	3	0	0	2887
P01009-1#15	0	3	3	P01009-1	9	12	+	3	P01009-1	0	278	ENST00000553327.5	303	581	+	170	P01009-1#15	0	3	ENST00000553327.5	312	315	+	3	0	0	2888
P01009-1#15	0	3	3	P01009-1	9	12	+	3	P01009-1	0	918	ENST00000489769.1	9	927	++	119	P01009-1#15	0	3	ENST00000489769.1	18	21	+	3	0	0	2889
P01009-1#15	0	3	3	P01009-1	9	12	+	3	P01009-1	0	1254	ENST00000449399.7	302	1556	++	100	P01009-1#15	0	3	ENST00000449399.7	311	314	+	3	0	0	2890
P01009-1#15	0	3	3	P01009-1	9	12	+	3	P01009-1	0	1254	ENST00000448921.5	573	1827	++	98	P01009-1#15	0	3	ENST00000448921.5	582	585	+	3	0	0	2891
P01009-1#15	0	3	3	P01009-1	9	12	+	3	P01009-1	0	1254	ENST00000440909.5	185	1439	++	91	P01009-1#15	0	3	ENST00000440909.5	194	197	+	3	0	0	2892
P01009-1#15	0	3	3	P01009-1	9	12	+	3	P01009-1	0	1254	ENST00000437397.5	381	1635	++	89	P01009-1#15	0	3	ENST00000437397.5	390	393	+	3	0	0	2893
P01009-1#15	0	3	3	P01009-1	9	12	+	3	P01009-1	0	1254	ENST00000404814.8	311	1565	++	68	P01009-1#15	0	3	ENST00000404814.8	320	323	+	3	0	0	2894
P01009-1#15	0	3	3	P01009-1	9	12	+	3	P01009-1	0	1065	ENST00000402629.1	34	1099	++	67	P01009-1#15	0	3	ENST00000402629.1	43	46	+	3	0	0	2895
P01009-1#15	0	3	3	P01009-1	9	12	+	3	P01009-1	0	1254	ENST00000393088.8	555	1809	++	63	P01009-1#15	0	3	ENST00000393088.8	564	567	+	3	0	0	2896
P01009-1#15	0	3	3	P01009-1	9	12	+	3	P01009-1	0	1254	ENST00000393087.9	47	1301	++	62	P01009-1#15	0	3	ENST00000393087.9	56	59	+	3	0	0	2897
P01009-1#15	0	3	3	P01009-1	9	12	+	3	P01009-1	0	1254	ENST00000355814.8	277	1531	++	36	P01009-1#15	0	3	ENST00000355814.8	286	289	+	3	0	0	2898
P01009-1#16	0	3	3	P01009-1	75	78	+	3	P01009-1	0	1254	ENST00000636712.1	152	1406	++	236	P01009-1#16	0	3	ENST00000636712.1	227	230	+	3	0	0	2899
P01009-1#16	0	3	3	P01009-1	75	78	+	3	P01009-1	0	434	ENST00000557492.5	517	951	+	175	P01009-1#16	0	3	ENST00000557492.5	592	595	+	3	0	0	2900
P01009-1#16	0	3	3	P01009-1	75	78	+	3	P01009-1	0	351	ENST00000556955.5	220	571	+	173	P01009-1#16	0	3	ENST00000556955.5	295	298	+	3	0	0	2901
P01009-1#16	0	3	3	P01009-1	75	78	+	3	P01009-1	0	469	ENST00000556091.1	174	643	+	172	P01009-1#16	0	3	ENST00000556091.1	249	252	+	3	0	0	2902
P01009-1#16	0	3	3	P01009-1	75	78	+	3	P01009-1	0	278	ENST00000553327.5	303	581	+	170	P01009-1#16	0	3	ENST00000553327.5	378	381	+	3	0	0	2903
P01009-1#16	0	3	3	P01009-1	75	78	+	3	P01009-1	0	918	ENST00000489769.1	9	927	++	119	P01009-1#16	0	3	ENST00000489769.1	84	87	+	3	0	0	2904
P01009-1#16	0	3	3	P01009-1	75	78	+	3	P01009-1	0	1254	ENST00000449399.7	302	1556	++	100	P01009-1#16	0	3	ENST00000449399.7	377	380	+	3	0	0	2905
P01009-1#16	0	3	3	P01009-1	75	78	+	3	P01009-1	0	1254	ENST00000448921.5	573	1827	++	98	P01009-1#16	0	3	ENST00000448921.5	648	651	+	3	0	0	2906
P01009-1#16	0	3	3	P01009-1	75	78	+	3	P01009-1	0	1254	ENST00000440909.5	185	1439	++	91	P01009-1#16	0	3	ENST00000440909.5	260	263	+	3	0	0	2907
P01009-1#16	0	3	3	P01009-1	75	78	+	3	P01009-1	0	1254	ENST00000437397.5	381	1635	++	89	P01009-1#16	0	3	ENST00000437397.5	456	459	+	3	0	0	2908
P01009-1#16	0	3	3	P01009-1	75	78	+	3	P01009-1	0	1254	ENST00000404814.8	311	1565	++	68	P01009-1#16	0	3	ENST00000404814.8	386	389	+	3	0	0	2909
P01009-1#16	0	3	3	P01009-1	75	78	+	3	P01009-1	0	1065	ENST00000402629.1	34	1099	++	67	P01009-1#16	0	3	ENST00000402629.1	109	112	+	3	0	0	2910
P01009-1#16	0	3	3	P01009-1	75	78	+	3	P01009-1	0	1254	ENST00000393088.8	555	1809	++	63	P01009-1#16	0	3	ENST00000393088.8	630	633	+	3	0	0	2911
P01009-1#16	0	3	3	P01009-1	75	78	+	3	P01009-1	0	1254	ENST00000393087.9	47	1301	++	62	P01009-1#16	0	3	ENST00000393087.9	122	125	+	3	0	0	2912
P01009-1#16	0	3	3	P01009-1	75	78	+	3	P01009-1	0	1254	ENST00000355814.8	277	1531	++	36	P01009-1#16	0	3	ENST00000355814.8	352	355	+	3	0	0	2913
P01009-1#17	0	3	3	P01009-1	108	111	+	3	P01009-1	0	1254	ENST00000636712.1	152	1406	++	236	P01009-1#17	0	3	ENST00000636712.1	260	263	+	3	0	0	2914
P01009-1#17	0	3	3	P01009-1	108	111	+	3	P01009-1	0	434	ENST00000557492.5	517	951	+	175	P01009-1#17	0	3	ENST00000557492.5	625	628	+	3	0	0	2915
P01009-1#17	0	3	3	P01009-1	108	111	+	3	P01009-1	0	351	ENST00000556955.5	220	571	+	173	P01009-1#17	0	3	ENST00000556955.5	328	331	+	3	0	0	2916
P01009-1#17	0	3	3	P01009-1	108	111	+	3	P01009-1	0	469	ENST00000556091.1	174	643	+	172	P01009-1#17	0	3	ENST00000556091.1	282	285	+	3	0	0	2917
P01009-1#17	0	3	3	P01009-1	108	111	+	3	P01009-1	0	278	ENST00000553327.5	303	581	+	170	P01009-1#17	0	3	ENST00000553327.5	411	414	+	3	0	0	2918
P01009-1#17	0	3	3	P01009-1	108	111	+	3	P01009-1	0	918	ENST00000489769.1	9	927	++	119	P01009-1#17	0	3	ENST00000489769.1	117	120	+	3	0	0	2919
P01009-1#17	0	3	3	P01009-1	108	111	+	3	P01009-1	0	1254	ENST00000449399.7	302	1556	++	100	P01009-1#17	0	3	ENST00000449399.7	410	413	+	3	0	0	2920
P01009-1#17	0	3	3	P01009-1	108	111	+	3	P01009-1	0	1254	ENST00000448921.5	573	1827	++	98	P01009-1#17	0	3	ENST00000448921.5	681	684	+	3	0	0	2921
P01009-1#17	0	3	3	P01009-1	108	111	+	3	P01009-1	0	1254	ENST00000440909.5	185	1439	++	91	P01009-1#17	0	3	ENST00000440909.5	293	296	+	3	0	0	2922
P01009-1#17	0	3	3	P01009-1	108	111	+	3	P01009-1	0	1254	ENST00000437397.5	381	1635	++	89	P01009-1#17	0	3	ENST00000437397.5	489	492	+	3	0	0	2923
P01009-1#17	0	3	3	P01009-1	108	111	+	3	P01009-1	0	1254	ENST00000404814.8	311	1565	++	68	P01009-1#17	0	3	ENST00000404814.8	419	422	+	3	0	0	2924
P01009-1#17	0	3	3	P01009-1	108	111	+	3	P01009-1	0	1065	ENST00000402629.1	34	1099	++	67	P01009-1#17	0	3	ENST00000402629.1	142	145	+	3	0	0	2925
P01009-1#17	0	3	3	P01009-1	108	111	+	3	P01009-1	0	1254	ENST00000393088.8	555	1809	++	63	P01009-1#17	0	3	ENST00000393088.8	663	666	+	3	0	0	2926
P01009-1#17	0	3	3	P01009-1	108	111	+	3	P01009-1	0	1254	ENST00000393087.9	47	1301	++	62	P01009-1#17	0	3	ENST00000393087.9	155	158	+	3	0	0	2927
P01009-1#17	0	3	3	P01009-1	108	111	+	3	P01009-1	0	1254	ENST00000355814.8	277	1531	++	36	P01009-1#17	0	3	ENST00000355814.8	385	388	+	3	0	0	2928
P01009-1#18	0	3	3	P01009-1	171	174	+	3	P01009-1	0	1254	ENST00000636712.1	152	1406	++	236	P01009-1#18	0	3	ENST00000636712.1	323	326	+	3	0	0	2929
P01009-1#18	0	3	3	P01009-1	171	174	+	3	P01009-1	0	434	ENST00000557492.5	517	951	+	175	P01009-1#18	0	3	ENST00000557492.5	688	691	+	3	0	0	2930
P01009-1#18	0	3	3	P01009-1	171	174	+	3	P01009-1	0	351	ENST00000556955.5	220	571	+	173	P01009-1#18	0	3	ENST00000556955.5	391	394	+	3	0	0	2931
P01009-1#18	0	3	3	P01009-1	171	174	+	3	P01009-1	0	469	ENST00000556091.1	174	643	+	172	P01009-1#18	0	3	ENST00000556091.1	345	348	+	3	0	0	2932
P01009-1#18	0	3	3	P01009-1	171	174	+	3	P01009-1	0	278	ENST00000553327.5	303	581	+	170	P01009-1#18	0	3	ENST00000553327.5	474	477	+	3	0	0	2933
P01009-1#18	0	3	3	P01009-1	171	174	+	3	P01009-1	0	918	ENST00000489769.1	9	927	++	119	P01009-1#18	0	3	ENST00000489769.1	180	183	+	3	0	0	2934
P01009-1#18	0	3	3	P01009-1	171	174	+	3	P01009-1	0	1254	ENST00000449399.7	302	1556	++	100	P01009-1#18	0	3	ENST00000449399.7	473	476	+	3	0	0	2935
P01009-1#18	0	3	3	P01009-1	171	174	+	3	P01009-1	0	1254	ENST00000448921.5	573	1827	++	98	P01009-1#18	0	3	ENST00000448921.5	744	747	+	3	0	0	2936
P01009-1#18	0	3	3	P01009-1	171	174	+	3	P01009-1	0	1254	ENST00000440909.5	185	1439	++	91	P01009-1#18	0	3	ENST00000440909.5	356	359	+	3	0	0	2937
P01009-1#18	0	3	3	P01009-1	171	174	+	3	P01009-1	0	1254	ENST00000437397.5	381	1635	++	89	P01009-1#18	0	3	ENST00000437397.5	552	555	+	3	0	0	2938
P01009-1#18	0	3	3	P01009-1	171	174	+	3	P01009-1	0	1254	ENST00000404814.8	311	1565	++	68	P01009-1#18	0	3	ENST00000404814.8	482	485	+	3	0	0	2939
P01009-1#18	0	3	3	P01009-1	171	174	+	3	P01009-1	0	1065	ENST00000402629.1	34	1099	++	67	P01009-1#18	0	3	ENST00000402629.1	205	208	+	3	0	0	2940
P01009-1#18	0	3	3	P01009-1	171	174	+	3	P01009-1	0	1254	ENST00000393088.8	555	1809	++	63	P01009-1#18	0	3	ENST00000393088.8	726	729	+	3	0	0	2941
P01009-1#18	0	3	3	P01009-1	171	174	+	3	P01009-1	0	1254	ENST00000393087.9	47	1301	++	62	P01009-1#18	0	3	ENST00000393087.9	218	221	+	3	0	0	2942
P01009-1#18	0	3	3	P01009-1	171	174	+	3	P01009-1	0	1254	ENST00000355814.8	277	1531	++	36	P01009-1#18	0	3	ENST00000355814.8	448	451	+	3	0	0	2943
P01009-1#19	0	3	3	P01009-1	186	189	+	3	P01009-1	0	1254	ENST00000636712.1	152	1406	++	236	P01009-1#19	0	3	ENST00000636712.1	338	341	+	3	0	0	2944
P01009-1#19	0	3	3	P01009-1	186	189	+	3	P01009-1	0	434	ENST00000557492.5	517	951	+	175	P01009-1#19	0	3	ENST00000557492.5	703	706	+	3	0	0	2945
P01009-1#19	0	3	3	P01009-1	186	189	+	3	P01009-1	0	351	ENST00000556955.5	220	571	+	173	P01009-1#19	0	3	ENST00000556955.5	406	409	+	3	0	0	2946
P01009-1#19	0	3	3	P01009-1	186	189	+	3	P01009-1	0	469	ENST00000556091.1	174	643	+	172	P01009-1#19	0	3	ENST00000556091.1	360	363	+	3	0	0	2947
P01009-1#19	0	3	3	P01009-1	186	189	+	3	P01009-1	0	278	ENST00000553327.5	303	581	+	170	P01009-1#19	0	3	ENST00000553327.5	489	492	+	3	0	0	2948
P01009-1#19	0	3	3	P01009-1	186	189	+	3	P01009-1	0	918	ENST00000489769.1	9	927	++	119	P01009-1#19	0	3	ENST00000489769.1	195	198	+	3	0	0	2949
P01009-1#19	0	3	3	P01009-1	186	189	+	3	P01009-1	0	1254	ENST00000449399.7	302	1556	++	100	P01009-1#19	0	3	ENST00000449399.7	488	491	+	3	0	0	2950
P01009-1#19	0	3	3	P01009-1	186	189	+	3	P01009-1	0	1254	ENST00000448921.5	573	1827	++	98	P01009-1#19	0	3	ENST00000448921.5	759	762	+	3	0	0	2951
P01009-1#19	0	3	3	P01009-1	186	189	+	3	P01009-1	0	1254	ENST00000440909.5	185	1439	++	91	P01009-1#19	0	3	ENST00000440909.5	371	374	+	3	0	0	2952
P01009-1#19	0	3	3	P01009-1	186	189	+	3	P01009-1	0	1254	ENST00000437397.5	381	1635	++	89	P01009-1#19	0	3	ENST00000437397.5	567	570	+	3	0	0	2953
P01009-1#19	0	3	3	P01009-1	186	189	+	3	P01009-1	0	1254	ENST00000404814.8	311	1565	++	68	P01009-1#19	0	3	ENST00000404814.8	497	500	+	3	0	0	2954
P01009-1#19	0	3	3	P01009-1	186	189	+	3	P01009-1	0	1065	ENST00000402629.1	34	1099	++	67	P01009-1#19	0	3	ENST00000402629.1	220	223	+	3	0	0	2955
P01009-1#19	0	3	3	P01009-1	186	189	+	3	P01009-1	0	1254	ENST00000393088.8	555	1809	++	63	P01009-1#19	0	3	ENST00000393088.8	741	744	+	3	0	0	2956
P01009-1#19	0	3	3	P01009-1	186	189	+	3	P01009-1	0	1254	ENST00000393087.9	47	1301	++	62	P01009-1#19	0	3	ENST00000393087.9	233	236	+	3	0	0	2957
P01009-1#19	0	3	3	P01009-1	186	189	+	3	P01009-1	0	1254	ENST00000355814.8	277	1531	++	36	P01009-1#19	0	3	ENST00000355814.8	463	466	+	3	0	0	2958
P01009-1#20	0	3	3	P01009-1	192	195	+	3	P01009-1	0	1254	ENST00000636712.1	152	1406	++	236	P01009-1#20	0	3	ENST00000636712.1	344	347	+	3	0	0	2959
P01009-1#20	0	3	3	P01009-1	192	195	+	3	P01009-1	0	434	ENST00000557492.5	517	951	+	175	P01009-1#20	0	3	ENST00000557492.5	709	712	+	3	0	0	2960
P01009-1#20	0	3	3	P01009-1	192	195	+	3	P01009-1	0	351	ENST00000556955.5	220	571	+	173	P01009-1#20	0	3	ENST00000556955.5	412	415	+	3	0	0	2961
P01009-1#20	0	3	3	P01009-1	192	195	+	3	P01009-1	0	469	ENST00000556091.1	174	643	+	172	P01009-1#20	0	3	ENST00000556091.1	366	369	+	3	0	0	2962
P01009-1#20	0	3	3	P01009-1	192	195	+	3	P01009-1	0	278	ENST00000553327.5	303	581	+	170	P01009-1#20	0	3	ENST00000553327.5	495	498	+	3	0	0	2963
P01009-1#20	0	3	3	P01009-1	192	195	+	3	P01009-1	0	918	ENST00000489769.1	9	927	++	119	P01009-1#20	0	3	ENST00000489769.1	201	204	+	3	0	0	2964
P01009-1#20	0	3	3	P01009-1	192	195	+	3	P01009-1	0	1254	ENST00000449399.7	302	1556	++	100	P01009-1#20	0	3	ENST00000449399.7	494	497	+	3	0	0	2965
P01009-1#20	0	3	3	P01009-1	192	195	+	3	P01009-1	0	1254	ENST00000448921.5	573	1827	++	98	P01009-1#20	0	3	ENST00000448921.5	765	768	+	3	0	0	2966
P01009-1#20	0	3	3	P01009-1	192	195	+	3	P01009-1	0	1254	ENST00000440909.5	185	1439	++	91	P01009-1#20	0	3	ENST00000440909.5	377	380	+	3	0	0	2967
P01009-1#20	0	3	3	P01009-1	192	195	+	3	P01009-1	0	1254	ENST00000437397.5	381	1635	++	89	P01009-1#20	0	3	ENST00000437397.5	573	576	+	3	0	0	2968
P01009-1#20	0	3	3	P01009-1	192	195	+	3	P01009-1	0	1254	ENST00000404814.8	311	1565	++	68	P01009-1#20	0	3	ENST00000404814.8	503	506	+	3	0	0	2969
P01009-1#20	0	3	3	P01009-1	192	195	+	3	P01009-1	0	1065	ENST00000402629.1	34	1099	++	67	P01009-1#20	0	3	ENST00000402629.1	226	229	+	3	0	0	2970
P01009-1#20	0	3	3	P01009-1	192	195	+	3	P01009-1	0	1254	ENST00000393088.8	555	1809	++	63	P01009-1#20	0	3	ENST00000393088.8	747	750	+	3	0	0	2971
P01009-1#20	0	3	3	P01009-1	192	195	+	3	P01009-1	0	1254	ENST00000393087.9	47	1301	++	62	P01009-1#20	0	3	ENST00000393087.9	239	242	+	3	0	0	2972
P01009-1#20	0	3	3	P01009-1	192	195	+	3	P01009-1	0	1254	ENST00000355814.8	277	1531	++	36	P01009-1#20	0	3	ENST00000355814.8	469	472	+	3	0	0	2973
P01009-1#21	0	3	3	P01009-1	204	207	+	3	P01009-1	0	1254	ENST00000636712.1	152	1406	++	236	P01009-1#21	0	3	ENST00000636712.1	356	359	+	3	0	0	2974
P01009-1#21	0	3	3	P01009-1	204	207	+	3	P01009-1	0	434	ENST00000557492.5	517	951	+	175	P01009-1#21	0	3	ENST00000557492.5	721	724	+	3	0	0	2975
P01009-1#21	0	3	3	P01009-1	204	207	+	3	P01009-1	0	351	ENST00000556955.5	220	571	+	173	P01009-1#21	0	3	ENST00000556955.5	424	427	+	3	0	0	2976
P01009-1#21	0	3	3	P01009-1	204	207	+	3	P01009-1	0	469	ENST00000556091.1	174	643	+	172	P01009-1#21	0	3	ENST00000556091.1	378	381	+	3	0	0	2977
P01009-1#21	0	3	3	P01009-1	204	207	+	3	P01009-1	0	278	ENST00000553327.5	303	581	+	170	P01009-1#21	0	3	ENST00000553327.5	507	510	+	3	0	0	2978
P01009-1#21	0	3	3	P01009-1	204	207	+	3	P01009-1	0	918	ENST00000489769.1	9	927	++	119	P01009-1#21	0	3	ENST00000489769.1	213	216	+	3	0	0	2979
P01009-1#21	0	3	3	P01009-1	204	207	+	3	P01009-1	0	1254	ENST00000449399.7	302	1556	++	100	P01009-1#21	0	3	ENST00000449399.7	506	509	+	3	0	0	2980
P01009-1#21	0	3	3	P01009-1	204	207	+	3	P01009-1	0	1254	ENST00000448921.5	573	1827	++	98	P01009-1#21	0	3	ENST00000448921.5	777	780	+	3	0	0	2981
P01009-1#21	0	3	3	P01009-1	204	207	+	3	P01009-1	0	1254	ENST00000440909.5	185	1439	++	91	P01009-1#21	0	3	ENST00000440909.5	389	392	+	3	0	0	2982
P01009-1#21	0	3	3	P01009-1	204	207	+	3	P01009-1	0	1254	ENST00000437397.5	381	1635	++	89	P01009-1#21	0	3	ENST00000437397.5	585	588	+	3	0	0	2983
P01009-1#21	0	3	3	P01009-1	204	207	+	3	P01009-1	0	1254	ENST00000404814.8	311	1565	++	68	P01009-1#21	0	3	ENST00000404814.8	515	518	+	3	0	0	2984
P01009-1#21	0	3	3	P01009-1	204	207	+	3	P01009-1	0	1065	ENST00000402629.1	34	1099	++	67	P01009-1#21	0	3	ENST00000402629.1	238	241	+	3	0	0	2985
P01009-1#21	0	3	3	P01009-1	204	207	+	3	P01009-1	0	1254	ENST00000393088.8	555	1809	++	63	P01009-1#21	0	3	ENST00000393088.8	759	762	+	3	0	0	2986
P01009-1#21	0	3	3	P01009-1	204	207	+	3	P01009-1	0	1254	ENST00000393087.9	47	1301	++	62	P01009-1#21	0	3	ENST00000393087.9	251	254	+	3	0	0	2987
P01009-1#21	0	3	3	P01009-1	204	207	+	3	P01009-1	0	1254	ENST00000355814.8	277	1531	++	36	P01009-1#21	0	3	ENST00000355814.8	481	484	+	3	0	0	2988
P01009-1#22	0	3	3	P01009-1	222	225	+	3	P01009-1	0	1254	ENST00000636712.1	152	1406	++	236	P01009-1#22	0	3	ENST00000636712.1	374	377	+	3	0	0	2989
P01009-1#22	0	3	3	P01009-1	222	225	+	3	P01009-1	0	434	ENST00000557492.5	517	951	+	175	P01009-1#22	0	3	ENST00000557492.5	739	742	+	3	0	0	2990
P01009-1#22	0	3	3	P01009-1	222	225	+	3	P01009-1	0	351	ENST00000556955.5	220	571	+	173	P01009-1#22	0	3	ENST00000556955.5	442	445	+	3	0	0	2991
P01009-1#22	0	3	3	P01009-1	222	225	+	3	P01009-1	0	469	ENST00000556091.1	174	643	+	172	P01009-1#22	0	3	ENST00000556091.1	396	399	+	3	0	0	2992
P01009-1#22	0	3	3	P01009-1	222	225	+	3	P01009-1	0	278	ENST00000553327.5	303	581	+	170	P01009-1#22	0	3	ENST00000553327.5	525	528	+	3	0	0	2993
P01009-1#22	0	3	3	P01009-1	222	225	+	3	P01009-1	0	918	ENST00000489769.1	9	927	++	119	P01009-1#22	0	3	ENST00000489769.1	231	234	+	3	0	0	2994
P01009-1#22	0	3	3	P01009-1	222	225	+	3	P01009-1	0	1254	ENST00000449399.7	302	1556	++	100	P01009-1#22	0	3	ENST00000449399.7	524	527	+	3	0	0	2995
P01009-1#22	0	3	3	P01009-1	222	225	+	3	P01009-1	0	1254	ENST00000448921.5	573	1827	++	98	P01009-1#22	0	3	ENST00000448921.5	795	798	+	3	0	0	2996
P01009-1#22	0	3	3	P01009-1	222	225	+	3	P01009-1	0	1254	ENST00000440909.5	185	1439	++	91	P01009-1#22	0	3	ENST00000440909.5	407	410	+	3	0	0	2997
P01009-1#22	0	3	3	P01009-1	222	225	+	3	P01009-1	0	1254	ENST00000437397.5	381	1635	++	89	P01009-1#22	0	3	ENST00000437397.5	603	606	+	3	0	0	2998
P01009-1#22	0	3	3	P01009-1	222	225	+	3	P01009-1	0	1254	ENST00000404814.8	311	1565	++	68	P01009-1#22	0	3	ENST00000404814.8	533	536	+	3	0	0	2999
P01009-1#22	0	3	3	P01009-1	222	225	+	3	P01009-1	0	1065	ENST00000402629.1	34	1099	++	67	P01009-1#22	0	3	ENST00000402629.1	256	259	+	3	0	0	3000
P01009-1#22	0	3	3	P01009-1	222	225	+	3	P01009-1	0	1254	ENST00000393088.8	555	1809	++	63	P01009-1#22	0	3	ENST00000393088.8	777	780	+	3	0	0	3001
P01009-1#22	0	3	3	P01009-1	222	225	+	3	P01009-1	0	1254	ENST00000393087.9	47	1301	++	62	P01009-1#22	0	3	ENST00000393087.9	269	272	+	3	0	0	3002
P01009-1#22	0	3	3	P01009-1	222	225	+	3	P01009-1	0	1254	ENST00000355814.8	277	1531	++	36	P01009-1#22	0	3	ENST00000355814.8	499	502	+	3	0	0	3003
P01009-1#23	0	3	3	P01009-1	228	231	+	3	P01009-1	0	1254	ENST00000636712.1	152	1406	++	236	P01009-1#23	0	3	ENST00000636712.1	380	383	+	3	0	0	3004
P01009-1#23	0	3	3	P01009-1	228	231	+	3	P01009-1	0	434	ENST00000557492.5	517	951	+	175	P01009-1#23	0	3	ENST00000557492.5	745	748	+	3	0	0	3005
P01009-1#23	0	3	3	P01009-1	228	231	+	3	P01009-1	0	351	ENST00000556955.5	220	571	+	173	P01009-1#23	0	3	ENST00000556955.5	448	451	+	3	0	0	3006
P01009-1#23	0	3	3	P01009-1	228	231	+	3	P01009-1	0	469	ENST00000556091.1	174	643	+	172	P01009-1#23	0	3	ENST00000556091.1	402	405	+	3	0	0	3007
P01009-1#23	0	3	3	P01009-1	228	231	+	3	P01009-1	0	278	ENST00000553327.5	303	581	+	170	P01009-1#23	0	3	ENST00000553327.5	531	534	+	3	0	0	3008
P01009-1#23	0	3	3	P01009-1	228	231	+	3	P01009-1	0	918	ENST00000489769.1	9	927	++	119	P01009-1#23	0	3	ENST00000489769.1	237	240	+	3	0	0	3009
P01009-1#23	0	3	3	P01009-1	228	231	+	3	P01009-1	0	1254	ENST00000449399.7	302	1556	++	100	P01009-1#23	0	3	ENST00000449399.7	530	533	+	3	0	0	3010
P01009-1#23	0	3	3	P01009-1	228	231	+	3	P01009-1	0	1254	ENST00000448921.5	573	1827	++	98	P01009-1#23	0	3	ENST00000448921.5	801	804	+	3	0	0	3011
P01009-1#23	0	3	3	P01009-1	228	231	+	3	P01009-1	0	1254	ENST00000440909.5	185	1439	++	91	P01009-1#23	0	3	ENST00000440909.5	413	416	+	3	0	0	3012
P01009-1#23	0	3	3	P01009-1	228	231	+	3	P01009-1	0	1254	ENST00000437397.5	381	1635	++	89	P01009-1#23	0	3	ENST00000437397.5	609	612	+	3	0	0	3013
P01009-1#23	0	3	3	P01009-1	228	231	+	3	P01009-1	0	1254	ENST00000404814.8	311	1565	++	68	P01009-1#23	0	3	ENST00000404814.8	539	542	+	3	0	0	3014
P01009-1#23	0	3	3	P01009-1	228	231	+	3	P01009-1	0	1065	ENST00000402629.1	34	1099	++	67	P01009-1#23	0	3	ENST00000402629.1	262	265	+	3	0	0	3015
P01009-1#23	0	3	3	P01009-1	228	231	+	3	P01009-1	0	1254	ENST00000393088.8	555	1809	++	63	P01009-1#23	0	3	ENST00000393088.8	783	786	+	3	0	0	3016
P01009-1#23	0	3	3	P01009-1	228	231	+	3	P01009-1	0	1254	ENST00000393087.9	47	1301	++	62	P01009-1#23	0	3	ENST00000393087.9	275	278	+	3	0	0	3017
P01009-1#23	0	3	3	P01009-1	228	231	+	3	P01009-1	0	1254	ENST00000355814.8	277	1531	++	36	P01009-1#23	0	3	ENST00000355814.8	505	508	+	3	0	0	3018
P01009-1#24	0	3	3	P01009-1	249	252	+	3	P01009-1	0	1254	ENST00000636712.1	152	1406	++	236	P01009-1#24	0	3	ENST00000636712.1	401	404	+	3	0	0	3019
P01009-1#24	0	3	3	P01009-1	249	252	+	3	P01009-1	0	434	ENST00000557492.5	517	951	+	175	P01009-1#24	0	3	ENST00000557492.5	766	769	+	3	0	0	3020
P01009-1#24	0	3	3	P01009-1	249	252	+	3	P01009-1	0	351	ENST00000556955.5	220	571	+	173	P01009-1#24	0	3	ENST00000556955.5	469	472	+	3	0	0	3021
P01009-1#24	0	3	3	P01009-1	249	252	+	3	P01009-1	0	469	ENST00000556091.1	174	643	+	172	P01009-1#24	0	3	ENST00000556091.1	423	426	+	3	0	0	3022
P01009-1#24	0	3	3	P01009-1	249	252	+	3	P01009-1	0	278	ENST00000553327.5	303	581	+	170	P01009-1#24	0	3	ENST00000553327.5	552	555	+	3	0	0	3023
P01009-1#24	0	3	3	P01009-1	249	252	+	3	P01009-1	0	918	ENST00000489769.1	9	927	++	119	P01009-1#24	0	3	ENST00000489769.1	258	261	+	3	0	0	3024
P01009-1#24	0	3	3	P01009-1	249	252	+	3	P01009-1	0	1254	ENST00000449399.7	302	1556	++	100	P01009-1#24	0	3	ENST00000449399.7	551	554	+	3	0	0	3025
P01009-1#24	0	3	3	P01009-1	249	252	+	3	P01009-1	0	1254	ENST00000448921.5	573	1827	++	98	P01009-1#24	0	3	ENST00000448921.5	822	825	+	3	0	0	3026
P01009-1#24	0	3	3	P01009-1	249	252	+	3	P01009-1	0	1254	ENST00000440909.5	185	1439	++	91	P01009-1#24	0	3	ENST00000440909.5	434	437	+	3	0	0	3027
P01009-1#24	0	3	3	P01009-1	249	252	+	3	P01009-1	0	1254	ENST00000437397.5	381	1635	++	89	P01009-1#24	0	3	ENST00000437397.5	630	633	+	3	0	0	3028
P01009-1#24	0	3	3	P01009-1	249	252	+	3	P01009-1	0	1254	ENST00000404814.8	311	1565	++	68	P01009-1#24	0	3	ENST00000404814.8	560	563	+	3	0	0	3029
P01009-1#24	0	3	3	P01009-1	249	252	+	3	P01009-1	0	1065	ENST00000402629.1	34	1099	++	67	P01009-1#24	0	3	ENST00000402629.1	283	286	+	3	0	0	3030
P01009-1#24	0	3	3	P01009-1	249	252	+	3	P01009-1	0	1254	ENST00000393088.8	555	1809	++	63	P01009-1#24	0	3	ENST00000393088.8	804	807	+	3	0	0	3031
P01009-1#24	0	3	3	P01009-1	249	252	+	3	P01009-1	0	1254	ENST00000393087.9	47	1301	++	62	P01009-1#24	0	3	ENST00000393087.9	296	299	+	3	0	0	3032
P01009-1#24	0	3	3	P01009-1	249	252	+	3	P01009-1	0	1254	ENST00000355814.8	277	1531	++	36	P01009-1#24	0	3	ENST00000355814.8	526	529	+	3	0	0	3033
P01009-1#25	0	3	3	P01009-1	270	273	+	3	P01009-1	0	1254	ENST00000636712.1	152	1406	++	236	P01009-1#25	0	3	ENST00000636712.1	422	425	+	3	0	0	3034
P01009-1#25	0	3	3	P01009-1	270	273	+	3	P01009-1	0	434	ENST00000557492.5	517	951	+	175	P01009-1#25	0	3	ENST00000557492.5	787	790	+	3	0	0	3035
P01009-1#25	0	3	3	P01009-1	270	273	+	3	P01009-1	0	351	ENST00000556955.5	220	571	+	173	P01009-1#25	0	3	ENST00000556955.5	490	493	+	3	0	0	3036
P01009-1#25	0	3	3	P01009-1	270	273	+	3	P01009-1	0	469	ENST00000556091.1	174	643	+	172	P01009-1#25	0	3	ENST00000556091.1	444	447	+	3	0	0	3037
P01009-1#25	0	3	3	P01009-1	270	273	+	3	P01009-1	258	575	ENST00000554720.1	129	446	+	171	P01009-1#25	0	3	ENST00000554720.1	141	144	+	3	0	0	3038
P01009-1#25	0	3	3	P01009-1	270	273	+	3	P01009-1	0	278	ENST00000553327.5	303	581	+	170	P01009-1#25	0	3	ENST00000553327.5	573	576	+	3	0	0	3039
P01009-1#25	0	3	3	P01009-1	270	273	+	3	P01009-1	0	918	ENST00000489769.1	9	927	++	119	P01009-1#25	0	3	ENST00000489769.1	279	282	+	3	0	0	3040
P01009-1#25	0	3	3	P01009-1	270	273	+	3	P01009-1	0	1254	ENST00000449399.7	302	1556	++	100	P01009-1#25	0	3	ENST00000449399.7	572	575	+	3	0	0	3041
P01009-1#25	0	3	3	P01009-1	270	273	+	3	P01009-1	0	1254	ENST00000448921.5	573	1827	++	98	P01009-1#25	0	3	ENST00000448921.5	843	846	+	3	0	0	3042
P01009-1#25	0	3	3	P01009-1	270	273	+	3	P01009-1	0	1254	ENST00000440909.5	185	1439	++	91	P01009-1#25	0	3	ENST00000440909.5	455	458	+	3	0	0	3043
P01009-1#25	0	3	3	P01009-1	270	273	+	3	P01009-1	0	1254	ENST00000437397.5	381	1635	++	89	P01009-1#25	0	3	ENST00000437397.5	651	654	+	3	0	0	3044
P01009-1#25	0	3	3	P01009-1	270	273	+	3	P01009-1	0	1254	ENST00000404814.8	311	1565	++	68	P01009-1#25	0	3	ENST00000404814.8	581	584	+	3	0	0	3045
P01009-1#25	0	3	3	P01009-1	270	273	+	3	P01009-1	0	1065	ENST00000402629.1	34	1099	++	67	P01009-1#25	0	3	ENST00000402629.1	304	307	+	3	0	0	3046
P01009-1#25	0	3	3	P01009-1	270	273	+	3	P01009-1	0	1254	ENST00000393088.8	555	1809	++	63	P01009-1#25	0	3	ENST00000393088.8	825	828	+	3	0	0	3047
P01009-1#25	0	3	3	P01009-1	270	273	+	3	P01009-1	0	1254	ENST00000393087.9	47	1301	++	62	P01009-1#25	0	3	ENST00000393087.9	317	320	+	3	0	0	3048
P01009-1#25	0	3	3	P01009-1	270	273	+	3	P01009-1	0	1254	ENST00000355814.8	277	1531	++	36	P01009-1#25	0	3	ENST00000355814.8	547	550	+	3	0	0	3049
P01009-1#26	0	3	3	P01009-1	273	276	+	3	P01009-1	0	1254	ENST00000636712.1	152	1406	++	236	P01009-1#26	0	3	ENST00000636712.1	425	428	+	3	0	0	3050
P01009-1#26	0	3	3	P01009-1	273	276	+	3	P01009-1	0	434	ENST00000557492.5	517	951	+	175	P01009-1#26	0	3	ENST00000557492.5	790	793	+	3	0	0	3051
P01009-1#26	0	3	3	P01009-1	273	276	+	3	P01009-1	0	351	ENST00000556955.5	220	571	+	173	P01009-1#26	0	3	ENST00000556955.5	493	496	+	3	0	0	3052
P01009-1#26	0	3	3	P01009-1	273	276	+	3	P01009-1	0	469	ENST00000556091.1	174	643	+	172	P01009-1#26	0	3	ENST00000556091.1	447	450	+	3	0	0	3053
P01009-1#26	0	3	3	P01009-1	273	276	+	3	P01009-1	258	575	ENST00000554720.1	129	446	+	171	P01009-1#26	0	3	ENST00000554720.1	144	147	+	3	0	0	3054
P01009-1#26	0	3	3	P01009-1	273	276	+	3	P01009-1	0	278	ENST00000553327.5	303	581	+	170	P01009-1#26	0	3	ENST00000553327.5	576	579	+	3	0	0	3055
P01009-1#26	0	3	3	P01009-1	273	276	+	3	P01009-1	0	918	ENST00000489769.1	9	927	++	119	P01009-1#26	0	3	ENST00000489769.1	282	285	+	3	0	0	3056
P01009-1#26	0	3	3	P01009-1	273	276	+	3	P01009-1	0	1254	ENST00000449399.7	302	1556	++	100	P01009-1#26	0	3	ENST00000449399.7	575	578	+	3	0	0	3057
P01009-1#26	0	3	3	P01009-1	273	276	+	3	P01009-1	0	1254	ENST00000448921.5	573	1827	++	98	P01009-1#26	0	3	ENST00000448921.5	846	849	+	3	0	0	3058
P01009-1#26	0	3	3	P01009-1	273	276	+	3	P01009-1	0	1254	ENST00000440909.5	185	1439	++	91	P01009-1#26	0	3	ENST00000440909.5	458	461	+	3	0	0	3059
P01009-1#26	0	3	3	P01009-1	273	276	+	3	P01009-1	0	1254	ENST00000437397.5	381	1635	++	89	P01009-1#26	0	3	ENST00000437397.5	654	657	+	3	0	0	3060
P01009-1#26	0	3	3	P01009-1	273	276	+	3	P01009-1	0	1254	ENST00000404814.8	311	1565	++	68	P01009-1#26	0	3	ENST00000404814.8	584	587	+	3	0	0	3061
P01009-1#26	0	3	3	P01009-1	273	276	+	3	P01009-1	0	1065	ENST00000402629.1	34	1099	++	67	P01009-1#26	0	3	ENST00000402629.1	307	310	+	3	0	0	3062
P01009-1#26	0	3	3	P01009-1	273	276	+	3	P01009-1	0	1254	ENST00000393088.8	555	1809	++	63	P01009-1#26	0	3	ENST00000393088.8	828	831	+	3	0	0	3063
P01009-1#26	0	3	3	P01009-1	273	276	+	3	P01009-1	0	1254	ENST00000393087.9	47	1301	++	62	P01009-1#26	0	3	ENST00000393087.9	320	323	+	3	0	0	3064
P01009-1#26	0	3	3	P01009-1	273	276	+	3	P01009-1	0	1254	ENST00000355814.8	277	1531	++	36	P01009-1#26	0	3	ENST00000355814.8	550	553	+	3	0	0	3065
P01009-1#27	0	3	3	P01009-1	324	327	+	3	P01009-1	0	1254	ENST00000636712.1	152	1406	++	236	P01009-1#27	0	3	ENST00000636712.1	476	479	+	3	0	0	3066
P01009-1#27	0	3	3	P01009-1	324	327	+	3	P01009-1	0	434	ENST00000557492.5	517	951	+	175	P01009-1#27	0	3	ENST00000557492.5	841	844	+	3	0	0	3067
P01009-1#27	0	3	3	P01009-1	324	327	+	3	P01009-1	0	351	ENST00000556955.5	220	571	+	173	P01009-1#27	0	3	ENST00000556955.5	544	547	+	3	0	0	3068
P01009-1#27	0	3	3	P01009-1	324	327	+	3	P01009-1	0	469	ENST00000556091.1	174	643	+	172	P01009-1#27	0	3	ENST00000556091.1	498	501	+	3	0	0	3069
P01009-1#27	0	3	3	P01009-1	324	327	+	3	P01009-1	258	575	ENST00000554720.1	129	446	+	171	P01009-1#27	0	3	ENST00000554720.1	195	198	+	3	0	0	3070
P01009-1#27	0	3	3	P01009-1	324	327	+	3	P01009-1	0	918	ENST00000489769.1	9	927	++	119	P01009-1#27	0	3	ENST00000489769.1	333	336	+	3	0	0	3071
P01009-1#27	0	3	3	P01009-1	324	327	+	3	P01009-1	0	1254	ENST00000449399.7	302	1556	++	100	P01009-1#27	0	3	ENST00000449399.7	626	629	+	3	0	0	3072
P01009-1#27	0	3	3	P01009-1	324	327	+	3	P01009-1	0	1254	ENST00000448921.5	573	1827	++	98	P01009-1#27	0	3	ENST00000448921.5	897	900	+	3	0	0	3073
P01009-1#27	0	3	3	P01009-1	324	327	+	3	P01009-1	0	1254	ENST00000440909.5	185	1439	++	91	P01009-1#27	0	3	ENST00000440909.5	509	512	+	3	0	0	3074
P01009-1#27	0	3	3	P01009-1	324	327	+	3	P01009-1	0	1254	ENST00000437397.5	381	1635	++	89	P01009-1#27	0	3	ENST00000437397.5	705	708	+	3	0	0	3075
P01009-1#27	0	3	3	P01009-1	324	327	+	3	P01009-1	0	1254	ENST00000404814.8	311	1565	++	68	P01009-1#27	0	3	ENST00000404814.8	635	638	+	3	0	0	3076
P01009-1#27	0	3	3	P01009-1	324	327	+	3	P01009-1	0	1065	ENST00000402629.1	34	1099	++	67	P01009-1#27	0	3	ENST00000402629.1	358	361	+	3	0	0	3077
P01009-1#27	0	3	3	P01009-1	324	327	+	3	P01009-1	0	1254	ENST00000393088.8	555	1809	++	63	P01009-1#27	0	3	ENST00000393088.8	879	882	+	3	0	0	3078
P01009-1#27	0	3	3	P01009-1	324	327	+	3	P01009-1	0	1254	ENST00000393087.9	47	1301	++	62	P01009-1#27	0	3	ENST00000393087.9	371	374	+	3	0	0	3079
P01009-1#27	0	3	3	P01009-1	324	327	+	3	P01009-1	0	1254	ENST00000355814.8	277	1531	++	36	P01009-1#27	0	3	ENST00000355814.8	601	604	+	3	0	0	3080
P01009-1#28	0	3	3	P01009-1	333	336	+	3	P01009-1	0	1254	ENST00000636712.1	152	1406	++	236	P01009-1#28	0	3	ENST00000636712.1	485	488	+	3	0	0	3081
P01009-1#28	0	3	3	P01009-1	333	336	+	3	P01009-1	0	434	ENST00000557492.5	517	951	+	175	P01009-1#28	0	3	ENST00000557492.5	850	853	+	3	0	0	3082
P01009-1#28	0	3	3	P01009-1	333	336	+	3	P01009-1	0	351	ENST00000556955.5	220	571	+	173	P01009-1#28	0	3	ENST00000556955.5	553	556	+	3	0	0	3083
P01009-1#28	0	3	3	P01009-1	333	336	+	3	P01009-1	0	469	ENST00000556091.1	174	643	+	172	P01009-1#28	0	3	ENST00000556091.1	507	510	+	3	0	0	3084
P01009-1#28	0	3	3	P01009-1	333	336	+	3	P01009-1	258	575	ENST00000554720.1	129	446	+	171	P01009-1#28	0	3	ENST00000554720.1	204	207	+	3	0	0	3085
P01009-1#28	0	3	3	P01009-1	333	336	+	3	P01009-1	0	918	ENST00000489769.1	9	927	++	119	P01009-1#28	0	3	ENST00000489769.1	342	345	+	3	0	0	3086
P01009-1#28	0	3	3	P01009-1	333	336	+	3	P01009-1	0	1254	ENST00000449399.7	302	1556	++	100	P01009-1#28	0	3	ENST00000449399.7	635	638	+	3	0	0	3087
P01009-1#28	0	3	3	P01009-1	333	336	+	3	P01009-1	0	1254	ENST00000448921.5	573	1827	++	98	P01009-1#28	0	3	ENST00000448921.5	906	909	+	3	0	0	3088
P01009-1#28	0	3	3	P01009-1	333	336	+	3	P01009-1	0	1254	ENST00000440909.5	185	1439	++	91	P01009-1#28	0	3	ENST00000440909.5	518	521	+	3	0	0	3089
P01009-1#28	0	3	3	P01009-1	333	336	+	3	P01009-1	0	1254	ENST00000437397.5	381	1635	++	89	P01009-1#28	0	3	ENST00000437397.5	714	717	+	3	0	0	3090
P01009-1#28	0	3	3	P01009-1	333	336	+	3	P01009-1	0	1254	ENST00000404814.8	311	1565	++	68	P01009-1#28	0	3	ENST00000404814.8	644	647	+	3	0	0	3091
P01009-1#28	0	3	3	P01009-1	333	336	+	3	P01009-1	0	1065	ENST00000402629.1	34	1099	++	67	P01009-1#28	0	3	ENST00000402629.1	367	370	+	3	0	0	3092
P01009-1#28	0	3	3	P01009-1	333	336	+	3	P01009-1	0	1254	ENST00000393088.8	555	1809	++	63	P01009-1#28	0	3	ENST00000393088.8	888	891	+	3	0	0	3093
P01009-1#28	0	3	3	P01009-1	333	336	+	3	P01009-1	0	1254	ENST00000393087.9	47	1301	++	62	P01009-1#28	0	3	ENST00000393087.9	380	383	+	3	0	0	3094
P01009-1#28	0	3	3	P01009-1	333	336	+	3	P01009-1	0	1254	ENST00000355814.8	277	1531	++	36	P01009-1#28	0	3	ENST00000355814.8	610	613	+	3	0	0	3095
P01009-1#29	0	3	3	P01009-1	345	348	+	3	P01009-1	0	1254	ENST00000636712.1	152	1406	++	236	P01009-1#29	0	3	ENST00000636712.1	497	500	+	3	0	0	3096
P01009-1#29	0	3	3	P01009-1	345	348	+	3	P01009-1	0	434	ENST00000557492.5	517	951	+	175	P01009-1#29	0	3	ENST00000557492.5	862	865	+	3	0	0	3097
P01009-1#29	0	3	3	P01009-1	345	348	+	3	P01009-1	0	351	ENST00000556955.5	220	571	+	173	P01009-1#29	0	3	ENST00000556955.5	565	568	+	3	0	0	3098
P01009-1#29	0	3	3	P01009-1	345	348	+	3	P01009-1	0	469	ENST00000556091.1	174	643	+	172	P01009-1#29	0	3	ENST00000556091.1	519	522	+	3	0	0	3099
P01009-1#29	0	3	3	P01009-1	345	348	+	3	P01009-1	258	575	ENST00000554720.1	129	446	+	171	P01009-1#29	0	3	ENST00000554720.1	216	219	+	3	0	0	3100
P01009-1#29	0	3	3	P01009-1	345	348	+	3	P01009-1	0	918	ENST00000489769.1	9	927	++	119	P01009-1#29	0	3	ENST00000489769.1	354	357	+	3	0	0	3101
P01009-1#29	0	3	3	P01009-1	345	348	+	3	P01009-1	0	1254	ENST00000449399.7	302	1556	++	100	P01009-1#29	0	3	ENST00000449399.7	647	650	+	3	0	0	3102
P01009-1#29	0	3	3	P01009-1	345	348	+	3	P01009-1	0	1254	ENST00000448921.5	573	1827	++	98	P01009-1#29	0	3	ENST00000448921.5	918	921	+	3	0	0	3103
P01009-1#29	0	3	3	P01009-1	345	348	+	3	P01009-1	0	1254	ENST00000440909.5	185	1439	++	91	P01009-1#29	0	3	ENST00000440909.5	530	533	+	3	0	0	3104
P01009-1#29	0	3	3	P01009-1	345	348	+	3	P01009-1	0	1254	ENST00000437397.5	381	1635	++	89	P01009-1#29	0	3	ENST00000437397.5	726	729	+	3	0	0	3105
P01009-1#29	0	3	3	P01009-1	345	348	+	3	P01009-1	0	1254	ENST00000404814.8	311	1565	++	68	P01009-1#29	0	3	ENST00000404814.8	656	659	+	3	0	0	3106
P01009-1#29	0	3	3	P01009-1	345	348	+	3	P01009-1	0	1065	ENST00000402629.1	34	1099	++	67	P01009-1#29	0	3	ENST00000402629.1	379	382	+	3	0	0	3107
P01009-1#29	0	3	3	P01009-1	345	348	+	3	P01009-1	0	1254	ENST00000393088.8	555	1809	++	63	P01009-1#29	0	3	ENST00000393088.8	900	903	+	3	0	0	3108
P01009-1#29	0	3	3	P01009-1	345	348	+	3	P01009-1	0	1254	ENST00000393087.9	47	1301	++	62	P01009-1#29	0	3	ENST00000393087.9	392	395	+	3	0	0	3109
P01009-1#29	0	3	3	P01009-1	345	348	+	3	P01009-1	0	1254	ENST00000355814.8	277	1531	++	36	P01009-1#29	0	3	ENST00000355814.8	622	625	+	3	0	0	3110
P01009-1#30	0	3	3	P01009-1	372	375	+	3	P01009-1	0	1254	ENST00000636712.1	152	1406	++	236	P01009-1#30	0	3	ENST00000636712.1	524	527	+	3	0	0	3111
P01009-1#30	0	3	3	P01009-1	372	375	+	3	P01009-1	0	434	ENST00000557492.5	517	951	+	175	P01009-1#30	0	3	ENST00000557492.5	889	892	+	3	0	0	3112
P01009-1#30	0	3	3	P01009-1	372	375	+	3	P01009-1	0	469	ENST00000556091.1	174	643	+	172	P01009-1#30	0	3	ENST00000556091.1	546	549	+	3	0	0	3113
P01009-1#30	0	3	3	P01009-1	372	375	+	3	P01009-1	258	575	ENST00000554720.1	129	446	+	171	P01009-1#30	0	3	ENST00000554720.1	243	246	+	3	0	0	3114
P01009-1#30	0	3	3	P01009-1	372	375	+	3	P01009-1	0	918	ENST00000489769.1	9	927	++	119	P01009-1#30	0	3	ENST00000489769.1	381	384	+	3	0	0	3115
P01009-1#30	0	3	3	P01009-1	372	375	+	3	P01009-1	0	1254	ENST00000449399.7	302	1556	++	100	P01009-1#30	0	3	ENST00000449399.7	674	677	+	3	0	0	3116
P01009-1#30	0	3	3	P01009-1	372	375	+	3	P01009-1	0	1254	ENST00000448921.5	573	1827	++	98	P01009-1#30	0	3	ENST00000448921.5	945	948	+	3	0	0	3117
P01009-1#30	0	3	3	P01009-1	372	375	+	3	P01009-1	0	1254	ENST00000440909.5	185	1439	++	91	P01009-1#30	0	3	ENST00000440909.5	557	560	+	3	0	0	3118
P01009-1#30	0	3	3	P01009-1	372	375	+	3	P01009-1	0	1254	ENST00000437397.5	381	1635	++	89	P01009-1#30	0	3	ENST00000437397.5	753	756	+	3	0	0	3119
P01009-1#30	0	3	3	P01009-1	372	375	+	3	P01009-1	0	1254	ENST00000404814.8	311	1565	++	68	P01009-1#30	0	3	ENST00000404814.8	683	686	+	3	0	0	3120
P01009-1#30	0	3	3	P01009-1	372	375	+	3	P01009-1	0	1065	ENST00000402629.1	34	1099	++	67	P01009-1#30	0	3	ENST00000402629.1	406	409	+	3	0	0	3121
P01009-1#30	0	3	3	P01009-1	372	375	+	3	P01009-1	0	1254	ENST00000393088.8	555	1809	++	63	P01009-1#30	0	3	ENST00000393088.8	927	930	+	3	0	0	3122
P01009-1#30	0	3	3	P01009-1	372	375	+	3	P01009-1	0	1254	ENST00000393087.9	47	1301	++	62	P01009-1#30	0	3	ENST00000393087.9	419	422	+	3	0	0	3123
P01009-1#30	0	3	3	P01009-1	372	375	+	3	P01009-1	0	1254	ENST00000355814.8	277	1531	++	36	P01009-1#30	0	3	ENST00000355814.8	649	652	+	3	0	0	3124
P01009-1#31	0	3	3	P01009-1	414	417	+	3	P01009-1	0	1254	ENST00000636712.1	152	1406	++	236	P01009-1#31	0	3	ENST00000636712.1	566	569	+	3	0	0	3125
P01009-1#31	0	3	3	P01009-1	414	417	+	3	P01009-1	0	434	ENST00000557492.5	517	951	+	175	P01009-1#31	0	3	ENST00000557492.5	931	934	+	3	0	0	3126
P01009-1#31	0	3	3	P01009-1	414	417	+	3	P01009-1	0	469	ENST00000556091.1	174	643	+	172	P01009-1#31	0	3	ENST00000556091.1	588	591	+	3	0	0	3127
P01009-1#31	0	3	3	P01009-1	414	417	+	3	P01009-1	258	575	ENST00000554720.1	129	446	+	171	P01009-1#31	0	3	ENST00000554720.1	285	288	+	3	0	0	3128
P01009-1#31	0	3	3	P01009-1	414	417	+	3	P01009-1	0	918	ENST00000489769.1	9	927	++	119	P01009-1#31	0	3	ENST00000489769.1	423	426	+	3	0	0	3129
P01009-1#31	0	3	3	P01009-1	414	417	+	3	P01009-1	0	1254	ENST00000449399.7	302	1556	++	100	P01009-1#31	0	3	ENST00000449399.7	716	719	+	3	0	0	3130
P01009-1#31	0	3	3	P01009-1	414	417	+	3	P01009-1	0	1254	ENST00000448921.5	573	1827	++	98	P01009-1#31	0	3	ENST00000448921.5	987	990	+	3	0	0	3131
P01009-1#31	0	3	3	P01009-1	414	417	+	3	P01009-1	0	1254	ENST00000440909.5	185	1439	++	91	P01009-1#31	0	3	ENST00000440909.5	599	602	+	3	0	0	3132
P01009-1#31	0	3	3	P01009-1	414	417	+	3	P01009-1	0	1254	ENST00000437397.5	381	1635	++	89	P01009-1#31	0	3	ENST00000437397.5	795	798	+	3	0	0	3133
P01009-1#31	0	3	3	P01009-1	414	417	+	3	P01009-1	0	1254	ENST00000404814.8	311	1565	++	68	P01009-1#31	0	3	ENST00000404814.8	725	728	+	3	0	0	3134
P01009-1#31	0	3	3	P01009-1	414	417	+	3	P01009-1	0	1065	ENST00000402629.1	34	1099	++	67	P01009-1#31	0	3	ENST00000402629.1	448	451	+	3	0	0	3135
P01009-1#31	0	3	3	P01009-1	414	417	+	3	P01009-1	0	1254	ENST00000393088.8	555	1809	++	63	P01009-1#31	0	3	ENST00000393088.8	969	972	+	3	0	0	3136
P01009-1#31	0	3	3	P01009-1	414	417	+	3	P01009-1	0	1254	ENST00000393087.9	47	1301	++	62	P01009-1#31	0	3	ENST00000393087.9	461	464	+	3	0	0	3137
P01009-1#31	0	3	3	P01009-1	414	417	+	3	P01009-1	0	1254	ENST00000355814.8	277	1531	++	36	P01009-1#31	0	3	ENST00000355814.8	691	694	+	3	0	0	3138
P01009-1#32	0	3	3	P01009-1	513	516	+	3	P01009-1	0	1254	ENST00000636712.1	152	1406	++	236	P01009-1#32	0	3	ENST00000636712.1	665	668	+	3	0	0	3139
P01009-1#32	0	3	3	P01009-1	513	516	+	3	P01009-1	258	575	ENST00000554720.1	129	446	+	171	P01009-1#32	0	3	ENST00000554720.1	384	387	+	3	0	0	3140
P01009-1#32	0	3	3	P01009-1	513	516	+	3	P01009-1	0	918	ENST00000489769.1	9	927	++	119	P01009-1#32	0	3	ENST00000489769.1	522	525	+	3	0	0	3141
P01009-1#32	0	3	3	P01009-1	513	516	+	3	P01009-1	0	1254	ENST00000449399.7	302	1556	++	100	P01009-1#32	0	3	ENST00000449399.7	815	818	+	3	0	0	3142
P01009-1#32	0	3	3	P01009-1	513	516	+	3	P01009-1	0	1254	ENST00000448921.5	573	1827	++	98	P01009-1#32	0	3	ENST00000448921.5	1086	1089	+	3	0	0	3143
P01009-1#32	0	3	3	P01009-1	513	516	+	3	P01009-1	0	1254	ENST00000440909.5	185	1439	++	91	P01009-1#32	0	3	ENST00000440909.5	698	701	+	3	0	0	3144
P01009-1#32	0	3	3	P01009-1	513	516	+	3	P01009-1	0	1254	ENST00000437397.5	381	1635	++	89	P01009-1#32	0	3	ENST00000437397.5	894	897	+	3	0	0	3145
P01009-1#32	0	3	3	P01009-1	513	516	+	3	P01009-1	0	1254	ENST00000404814.8	311	1565	++	68	P01009-1#32	0	3	ENST00000404814.8	824	827	+	3	0	0	3146
P01009-1#32	0	3	3	P01009-1	513	516	+	3	P01009-1	0	1065	ENST00000402629.1	34	1099	++	67	P01009-1#32	0	3	ENST00000402629.1	547	550	+	3	0	0	3147
P01009-1#32	0	3	3	P01009-1	513	516	+	3	P01009-1	0	1254	ENST00000393088.8	555	1809	++	63	P01009-1#32	0	3	ENST00000393088.8	1068	1071	+	3	0	0	3148
P01009-1#32	0	3	3	P01009-1	513	516	+	3	P01009-1	0	1254	ENST00000393087.9	47	1301	++	62	P01009-1#32	0	3	ENST00000393087.9	560	563	+	3	0	0	3149
P01009-1#32	0	3	3	P01009-1	513	516	+	3	P01009-1	0	1254	ENST00000355814.8	277	1531	++	36	P01009-1#32	0	3	ENST00000355814.8	790	793	+	3	0	0	3150
P01009-1#33	0	3	3	P01009-1	513	516	+	3	P01009-1	0	1254	ENST00000636712.1	152	1406	++	236	P01009-1#33	0	3	ENST00000636712.1	665	668	+	3	0	0	3151
P01009-1#33	0	3	3	P01009-1	513	516	+	3	P01009-1	258	575	ENST00000554720.1	129	446	+	171	P01009-1#33	0	3	ENST00000554720.1	384	387	+	3	0	0	3152
P01009-1#33	0	3	3	P01009-1	513	516	+	3	P01009-1	0	918	ENST00000489769.1	9	927	++	119	P01009-1#33	0	3	ENST00000489769.1	522	525	+	3	0	0	3153
P01009-1#33	0	3	3	P01009-1	513	516	+	3	P01009-1	0	1254	ENST00000449399.7	302	1556	++	100	P01009-1#33	0	3	ENST00000449399.7	815	818	+	3	0	0	3154
P01009-1#33	0	3	3	P01009-1	513	516	+	3	P01009-1	0	1254	ENST00000448921.5	573	1827	++	98	P01009-1#33	0	3	ENST00000448921.5	1086	1089	+	3	0	0	3155
P01009-1#33	0	3	3	P01009-1	513	516	+	3	P01009-1	0	1254	ENST00000440909.5	185	1439	++	91	P01009-1#33	0	3	ENST00000440909.5	698	701	+	3	0	0	3156
P01009-1#33	0	3	3	P01009-1	513	516	+	3	P01009-1	0	1254	ENST00000437397.5	381	1635	++	89	P01009-1#33	0	3	ENST00000437397.5	894	897	+	3	0	0	3157
P01009-1#33	0	3	3	P01009-1	513	516	+	3	P01009-1	0	1254	ENST00000404814.8	311	1565	++	68	P01009-1#33	0	3	ENST00000404814.8	824	827	+	3	0	0	3158
P01009-1#33	0	3	3	P01009-1	513	516	+	3	P01009-1	0	1065	ENST00000402629.1	34	1099	++	67	P01009-1#33	0	3	ENST00000402629.1	547	550	+	3	0	0	3159
P01009-1#33	0	3	3	P01009-1	513	516	+	3	P01009-1	0	1254	ENST00000393088.8	555	1809	++	63	P01009-1#33	0	3	ENST00000393088.8	1068	1071	+	3	0	0	3160
P01009-1#33	0	3	3	P01009-1	513	516	+	3	P01009-1	0	1254	ENST00000393087.9	47	1301	++	62	P01009-1#33	0	3	ENST00000393087.9	560	563	+	3	0	0	3161
P01009-1#33	0	3	3	P01009-1	513	516	+	3	P01009-1	0	1254	ENST00000355814.8	277	1531	++	36	P01009-1#33	0	3	ENST00000355814.8	790	793	+	3	0	0	3162
P01009-1#34	0	3	3	P01009-1	537	540	+	3	P01009-1	0	1254	ENST00000636712.1	152	1406	++	236	P01009-1#34	0	3	ENST00000636712.1	689	692	+	3	0	0	3163
P01009-1#34	0	3	3	P01009-1	537	540	+	3	P01009-1	258	575	ENST00000554720.1	129	446	+	171	P01009-1#34	0	3	ENST00000554720.1	408	411	+	3	0	0	3164
P01009-1#34	0	3	3	P01009-1	537	540	+	3	P01009-1	0	918	ENST00000489769.1	9	927	++	119	P01009-1#34	0	3	ENST00000489769.1	546	549	+	3	0	0	3165
P01009-1#34	0	3	3	P01009-1	537	540	+	3	P01009-1	0	1254	ENST00000449399.7	302	1556	++	100	P01009-1#34	0	3	ENST00000449399.7	839	842	+	3	0	0	3166
P01009-1#34	0	3	3	P01009-1	537	540	+	3	P01009-1	0	1254	ENST00000448921.5	573	1827	++	98	P01009-1#34	0	3	ENST00000448921.5	1110	1113	+	3	0	0	3167
P01009-1#34	0	3	3	P01009-1	537	540	+	3	P01009-1	0	1254	ENST00000440909.5	185	1439	++	91	P01009-1#34	0	3	ENST00000440909.5	722	725	+	3	0	0	3168
P01009-1#34	0	3	3	P01009-1	537	540	+	3	P01009-1	0	1254	ENST00000437397.5	381	1635	++	89	P01009-1#34	0	3	ENST00000437397.5	918	921	+	3	0	0	3169
P01009-1#34	0	3	3	P01009-1	537	540	+	3	P01009-1	0	1254	ENST00000404814.8	311	1565	++	68	P01009-1#34	0	3	ENST00000404814.8	848	851	+	3	0	0	3170
P01009-1#34	0	3	3	P01009-1	537	540	+	3	P01009-1	0	1065	ENST00000402629.1	34	1099	++	67	P01009-1#34	0	3	ENST00000402629.1	571	574	+	3	0	0	3171
P01009-1#34	0	3	3	P01009-1	537	540	+	3	P01009-1	0	1254	ENST00000393088.8	555	1809	++	63	P01009-1#34	0	3	ENST00000393088.8	1092	1095	+	3	0	0	3172
P01009-1#34	0	3	3	P01009-1	537	540	+	3	P01009-1	0	1254	ENST00000393087.9	47	1301	++	62	P01009-1#34	0	3	ENST00000393087.9	584	587	+	3	0	0	3173
P01009-1#34	0	3	3	P01009-1	537	540	+	3	P01009-1	0	1254	ENST00000355814.8	277	1531	++	36	P01009-1#34	0	3	ENST00000355814.8	814	817	+	3	0	0	3174
P01009-1#35	0	27	27	P01009-1	567	594	+	27	P01009-1	0	1254	ENST00000636712.1	152	1406	++	236	P01009-1#35	0	27	ENST00000636712.1	719	746	+	27	0	0	3175
P01009-1#35	0	27	27	P01009-1	567	594	+	27	P01009-1	258	575	ENST00000554720.1	129	446	+	171	P01009-1#35	0	8	ENST00000554720.1	438	446	+	8	0	19	3176
P01009-1#35	0	27	27	P01009-1	567	594	+	27	P01009-1	0	918	ENST00000489769.1	9	927	++	119	P01009-1#35	0	27	ENST00000489769.1	576	603	+	27	0	0	3177
P01009-1#35	0	27	27	P01009-1	567	594	+	27	P01009-1	0	1254	ENST00000449399.7	302	1556	++	100	P01009-1#35	0	27	ENST00000449399.7	869	896	+	27	0	0	3178
P01009-1#35	0	27	27	P01009-1	567	594	+	27	P01009-1	0	1254	ENST00000448921.5	573	1827	++	98	P01009-1#35	0	27	ENST00000448921.5	1140	1167	+	27	0	0	3179
P01009-1#35	0	27	27	P01009-1	567	594	+	27	P01009-1	0	1254	ENST00000440909.5	185	1439	++	91	P01009-1#35	0	27	ENST00000440909.5	752	779	+	27	0	0	3180
P01009-1#35	0	27	27	P01009-1	567	594	+	27	P01009-1	0	1254	ENST00000437397.5	381	1635	++	89	P01009-1#35	0	27	ENST00000437397.5	948	975	+	27	0	0	3181
P01009-1#35	0	27	27	P01009-1	567	594	+	27	P01009-1	0	1254	ENST00000404814.8	311	1565	++	68	P01009-1#35	0	27	ENST00000404814.8	878	905	+	27	0	0	3182
P01009-1#35	0	27	27	P01009-1	567	594	+	27	P01009-1	0	1065	ENST00000402629.1	34	1099	++	67	P01009-1#35	0	27	ENST00000402629.1	601	628	+	27	0	0	3183
P01009-1#35	0	27	27	P01009-1	567	594	+	27	P01009-1	0	1254	ENST00000393088.8	555	1809	++	63	P01009-1#35	0	27	ENST00000393088.8	1122	1149	+	27	0	0	3184
P01009-1#35	0	27	27	P01009-1	567	594	+	27	P01009-1	0	1254	ENST00000393087.9	47	1301	++	62	P01009-1#35	0	27	ENST00000393087.9	614	641	+	27	0	0	3185
P01009-1#35	0	27	27	P01009-1	567	594	+	27	P01009-1	0	1254	ENST00000355814.8	277	1531	++	36	P01009-1#35	0	27	ENST00000355814.8	844	871	+	27	0	0	3186
P01009-1#36	0	3	3	P01009-1	681	684	+	3	P01009-1	0	1254	ENST00000636712.1	152	1406	++	236	P01009-1#36	0	3	ENST00000636712.1	833	836	+	3	0	0	3187
P01009-1#36	0	3	3	P01009-1	681	684	+	3	P01009-1	0	918	ENST00000489769.1	9	927	++	119	P01009-1#36	0	3	ENST00000489769.1	690	693	+	3	0	0	3188
P01009-1#36	0	3	3	P01009-1	681	684	+	3	P01009-1	0	1254	ENST00000449399.7	302	1556	++	100	P01009-1#36	0	3	ENST00000449399.7	983	986	+	3	0	0	3189
P01009-1#36	0	3	3	P01009-1	681	684	+	3	P01009-1	0	1254	ENST00000448921.5	573	1827	++	98	P01009-1#36	0	3	ENST00000448921.5	1254	1257	+	3	0	0	3190
P01009-1#36	0	3	3	P01009-1	681	684	+	3	P01009-1	0	1254	ENST00000440909.5	185	1439	++	91	P01009-1#36	0	3	ENST00000440909.5	866	869	+	3	0	0	3191
P01009-1#36	0	3	3	P01009-1	681	684	+	3	P01009-1	0	1254	ENST00000437397.5	381	1635	++	89	P01009-1#36	0	3	ENST00000437397.5	1062	1065	+	3	0	0	3192
P01009-1#36	0	3	3	P01009-1	681	684	+	3	P01009-1	0	1254	ENST00000404814.8	311	1565	++	68	P01009-1#36	0	3	ENST00000404814.8	992	995	+	3	0	0	3193
P01009-1#36	0	3	3	P01009-1	681	684	+	3	P01009-1	0	1065	ENST00000402629.1	34	1099	++	67	P01009-1#36	0	3	ENST00000402629.1	715	718	+	3	0	0	3194
P01009-1#36	0	3	3	P01009-1	681	684	+	3	P01009-1	0	1254	ENST00000393088.8	555	1809	++	63	P01009-1#36	0	3	ENST00000393088.8	1236	1239	+	3	0	0	3195
P01009-1#36	0	3	3	P01009-1	681	684	+	3	P01009-1	0	1254	ENST00000393087.9	47	1301	++	62	P01009-1#36	0	3	ENST00000393087.9	728	731	+	3	0	0	3196
P01009-1#36	0	3	3	P01009-1	681	684	+	3	P01009-1	0	1254	ENST00000355814.8	277	1531	++	36	P01009-1#36	0	3	ENST00000355814.8	958	961	+	3	0	0	3197
P01009-1#37	0	3	3	P01009-1	708	711	+	3	P01009-1	0	1254	ENST00000636712.1	152	1406	++	236	P01009-1#37	0	3	ENST00000636712.1	860	863	+	3	0	0	3198
P01009-1#37	0	3	3	P01009-1	708	711	+	3	P01009-1	0	918	ENST00000489769.1	9	927	++	119	P01009-1#37	0	3	ENST00000489769.1	717	720	+	3	0	0	3199
P01009-1#37	0	3	3	P01009-1	708	711	+	3	P01009-1	0	1254	ENST00000449399.7	302	1556	++	100	P01009-1#37	0	3	ENST00000449399.7	1010	1013	+	3	0	0	3200
P01009-1#37	0	3	3	P01009-1	708	711	+	3	P01009-1	0	1254	ENST00000448921.5	573	1827	++	98	P01009-1#37	0	3	ENST00000448921.5	1281	1284	+	3	0	0	3201
P01009-1#37	0	3	3	P01009-1	708	711	+	3	P01009-1	0	1254	ENST00000440909.5	185	1439	++	91	P01009-1#37	0	3	ENST00000440909.5	893	896	+	3	0	0	3202
P01009-1#37	0	3	3	P01009-1	708	711	+	3	P01009-1	0	1254	ENST00000437397.5	381	1635	++	89	P01009-1#37	0	3	ENST00000437397.5	1089	1092	+	3	0	0	3203
P01009-1#37	0	3	3	P01009-1	708	711	+	3	P01009-1	0	1254	ENST00000404814.8	311	1565	++	68	P01009-1#37	0	3	ENST00000404814.8	1019	1022	+	3	0	0	3204
P01009-1#37	0	3	3	P01009-1	708	711	+	3	P01009-1	0	1065	ENST00000402629.1	34	1099	++	67	P01009-1#37	0	3	ENST00000402629.1	742	745	+	3	0	0	3205
P01009-1#37	0	3	3	P01009-1	708	711	+	3	P01009-1	0	1254	ENST00000393088.8	555	1809	++	63	P01009-1#37	0	3	ENST00000393088.8	1263	1266	+	3	0	0	3206
P01009-1#37	0	3	3	P01009-1	708	711	+	3	P01009-1	0	1254	ENST00000393087.9	47	1301	++	62	P01009-1#37	0	3	ENST00000393087.9	755	758	+	3	0	0	3207
P01009-1#37	0	3	3	P01009-1	708	711	+	3	P01009-1	0	1254	ENST00000355814.8	277	1531	++	36	P01009-1#37	0	3	ENST00000355814.8	985	988	+	3	0	0	3208
P01009-1#38	0	3	3	P01009-1	738	741	+	3	P01009-1	0	1254	ENST00000636712.1	152	1406	++	236	P01009-1#38	0	3	ENST00000636712.1	890	893	+	3	0	0	3209
P01009-1#38	0	3	3	P01009-1	738	741	+	3	P01009-1	0	918	ENST00000489769.1	9	927	++	119	P01009-1#38	0	3	ENST00000489769.1	747	750	+	3	0	0	3210
P01009-1#38	0	3	3	P01009-1	738	741	+	3	P01009-1	0	1254	ENST00000449399.7	302	1556	++	100	P01009-1#38	0	3	ENST00000449399.7	1040	1043	+	3	0	0	3211
P01009-1#38	0	3	3	P01009-1	738	741	+	3	P01009-1	0	1254	ENST00000448921.5	573	1827	++	98	P01009-1#38	0	3	ENST00000448921.5	1311	1314	+	3	0	0	3212
P01009-1#38	0	3	3	P01009-1	738	741	+	3	P01009-1	0	1254	ENST00000440909.5	185	1439	++	91	P01009-1#38	0	3	ENST00000440909.5	923	926	+	3	0	0	3213
P01009-1#38	0	3	3	P01009-1	738	741	+	3	P01009-1	0	1254	ENST00000437397.5	381	1635	++	89	P01009-1#38	0	3	ENST00000437397.5	1119	1122	+	3	0	0	3214
P01009-1#38	0	3	3	P01009-1	738	741	+	3	P01009-1	0	1254	ENST00000404814.8	311	1565	++	68	P01009-1#38	0	3	ENST00000404814.8	1049	1052	+	3	0	0	3215
P01009-1#38	0	3	3	P01009-1	738	741	+	3	P01009-1	0	1065	ENST00000402629.1	34	1099	++	67	P01009-1#38	0	3	ENST00000402629.1	772	775	+	3	0	0	3216
P01009-1#38	0	3	3	P01009-1	738	741	+	3	P01009-1	0	1254	ENST00000393088.8	555	1809	++	63	P01009-1#38	0	3	ENST00000393088.8	1293	1296	+	3	0	0	3217
P01009-1#38	0	3	3	P01009-1	738	741	+	3	P01009-1	0	1254	ENST00000393087.9	47	1301	++	62	P01009-1#38	0	3	ENST00000393087.9	785	788	+	3	0	0	3218
P01009-1#38	0	3	3	P01009-1	738	741	+	3	P01009-1	0	1254	ENST00000355814.8	277	1531	++	36	P01009-1#38	0	3	ENST00000355814.8	1015	1018	+	3	0	0	3219
P01009-1#39	0	3	3	P01009-1	837	840	+	3	P01009-1	0	1254	ENST00000636712.1	152	1406	++	236	P01009-1#39	0	3	ENST00000636712.1	989	992	+	3	0	0	3220
P01009-1#39	0	3	3	P01009-1	837	840	+	3	P01009-1	0	918	ENST00000489769.1	9	927	++	119	P01009-1#39	0	3	ENST00000489769.1	846	849	+	3	0	0	3221
P01009-1#39	0	3	3	P01009-1	837	840	+	3	P01009-1	0	1254	ENST00000449399.7	302	1556	++	100	P01009-1#39	0	3	ENST00000449399.7	1139	1142	+	3	0	0	3222
P01009-1#39	0	3	3	P01009-1	837	840	+	3	P01009-1	0	1254	ENST00000448921.5	573	1827	++	98	P01009-1#39	0	3	ENST00000448921.5	1410	1413	+	3	0	0	3223
P01009-1#39	0	3	3	P01009-1	837	840	+	3	P01009-1	0	1254	ENST00000440909.5	185	1439	++	91	P01009-1#39	0	3	ENST00000440909.5	1022	1025	+	3	0	0	3224
P01009-1#39	0	3	3	P01009-1	837	840	+	3	P01009-1	0	1254	ENST00000437397.5	381	1635	++	89	P01009-1#39	0	3	ENST00000437397.5	1218	1221	+	3	0	0	3225
P01009-1#39	0	3	3	P01009-1	837	840	+	3	P01009-1	0	1254	ENST00000404814.8	311	1565	++	68	P01009-1#39	0	3	ENST00000404814.8	1148	1151	+	3	0	0	3226
P01009-1#39	0	3	3	P01009-1	837	840	+	3	P01009-1	0	1065	ENST00000402629.1	34	1099	++	67	P01009-1#39	0	3	ENST00000402629.1	871	874	+	3	0	0	3227
P01009-1#39	0	3	3	P01009-1	837	840	+	3	P01009-1	0	1254	ENST00000393088.8	555	1809	++	63	P01009-1#39	0	3	ENST00000393088.8	1392	1395	+	3	0	0	3228
P01009-1#39	0	3	3	P01009-1	837	840	+	3	P01009-1	0	1254	ENST00000393087.9	47	1301	++	62	P01009-1#39	0	3	ENST00000393087.9	884	887	+	3	0	0	3229
P01009-1#39	0	3	3	P01009-1	837	840	+	3	P01009-1	0	1254	ENST00000355814.8	277	1531	++	36	P01009-1#39	0	3	ENST00000355814.8	1114	1117	+	3	0	0	3230
P01009-1#40	0	3	3	P01009-1	861	864	+	3	P01009-1	0	1254	ENST00000636712.1	152	1406	++	236	P01009-1#40	0	3	ENST00000636712.1	1013	1016	+	3	0	0	3231
P01009-1#40	0	3	3	P01009-1	861	864	+	3	P01009-1	0	918	ENST00000489769.1	9	927	++	119	P01009-1#40	0	3	ENST00000489769.1	870	873	+	3	0	0	3232
P01009-1#40	0	3	3	P01009-1	861	864	+	3	P01009-1	0	1254	ENST00000449399.7	302	1556	++	100	P01009-1#40	0	3	ENST00000449399.7	1163	1166	+	3	0	0	3233
P01009-1#40	0	3	3	P01009-1	861	864	+	3	P01009-1	0	1254	ENST00000448921.5	573	1827	++	98	P01009-1#40	0	3	ENST00000448921.5	1434	1437	+	3	0	0	3234
P01009-1#40	0	3	3	P01009-1	861	864	+	3	P01009-1	0	1254	ENST00000440909.5	185	1439	++	91	P01009-1#40	0	3	ENST00000440909.5	1046	1049	+	3	0	0	3235
P01009-1#40	0	3	3	P01009-1	861	864	+	3	P01009-1	0	1254	ENST00000437397.5	381	1635	++	89	P01009-1#40	0	3	ENST00000437397.5	1242	1245	+	3	0	0	3236
P01009-1#40	0	3	3	P01009-1	861	864	+	3	P01009-1	0	1254	ENST00000404814.8	311	1565	++	68	P01009-1#40	0	3	ENST00000404814.8	1172	1175	+	3	0	0	3237
P01009-1#40	0	3	3	P01009-1	861	864	+	3	P01009-1	0	1065	ENST00000402629.1	34	1099	++	67	P01009-1#40	0	3	ENST00000402629.1	895	898	+	3	0	0	3238
P01009-1#40	0	3	3	P01009-1	861	864	+	3	P01009-1	0	1254	ENST00000393088.8	555	1809	++	63	P01009-1#40	0	3	ENST00000393088.8	1416	1419	+	3	0	0	3239
P01009-1#40	0	3	3	P01009-1	861	864	+	3	P01009-1	0	1254	ENST00000393087.9	47	1301	++	62	P01009-1#40	0	3	ENST00000393087.9	908	911	+	3	0	0	3240
P01009-1#40	0	3	3	P01009-1	861	864	+	3	P01009-1	0	1254	ENST00000355814.8	277	1531	++	36	P01009-1#40	0	3	ENST00000355814.8	1138	1141	+	3	0	0	3241
P01009-1#41	0	3	3	P01009-1	912	915	+	3	P01009-1	0	1254	ENST00000636712.1	152	1406	++	236	P01009-1#41	0	3	ENST00000636712.1	1064	1067	+	3	0	0	3242
P01009-1#41	0	3	3	P01009-1	912	915	+	3	P01009-1	0	918	ENST00000489769.1	9	927	++	119	P01009-1#41	0	3	ENST00000489769.1	921	924	+	3	0	0	3243
P01009-1#41	0	3	3	P01009-1	912	915	+	3	P01009-1	0	1254	ENST00000449399.7	302	1556	++	100	P01009-1#41	0	3	ENST00000449399.7	1214	1217	+	3	0	0	3244
P01009-1#41	0	3	3	P01009-1	912	915	+	3	P01009-1	0	1254	ENST00000448921.5	573	1827	++	98	P01009-1#41	0	3	ENST00000448921.5	1485	1488	+	3	0	0	3245
P01009-1#41	0	3	3	P01009-1	912	915	+	3	P01009-1	0	1254	ENST00000440909.5	185	1439	++	91	P01009-1#41	0	3	ENST00000440909.5	1097	1100	+	3	0	0	3246
P01009-1#41	0	3	3	P01009-1	912	915	+	3	P01009-1	0	1254	ENST00000437397.5	381	1635	++	89	P01009-1#41	0	3	ENST00000437397.5	1293	1296	+	3	0	0	3247
P01009-1#41	0	3	3	P01009-1	912	915	+	3	P01009-1	0	1254	ENST00000404814.8	311	1565	++	68	P01009-1#41	0	3	ENST00000404814.8	1223	1226	+	3	0	0	3248
P01009-1#41	0	3	3	P01009-1	912	915	+	3	P01009-1	0	1065	ENST00000402629.1	34	1099	++	67	P01009-1#41	0	3	ENST00000402629.1	946	949	+	3	0	0	3249
P01009-1#41	0	3	3	P01009-1	912	915	+	3	P01009-1	0	1254	ENST00000393088.8	555	1809	++	63	P01009-1#41	0	3	ENST00000393088.8	1467	1470	+	3	0	0	3250
P01009-1#41	0	3	3	P01009-1	912	915	+	3	P01009-1	0	1254	ENST00000393087.9	47	1301	++	62	P01009-1#41	0	3	ENST00000393087.9	959	962	+	3	0	0	3251
P01009-1#41	0	3	3	P01009-1	912	915	+	3	P01009-1	0	1254	ENST00000355814.8	277	1531	++	36	P01009-1#41	0	3	ENST00000355814.8	1189	1192	+	3	0	0	3252
P01009-1#42	0	3	3	P01009-1	1059	1062	+	3	P01009-1	0	1254	ENST00000636712.1	152	1406	++	236	P01009-1#42	0	3	ENST00000636712.1	1211	1214	+	3	0	0	3253
P01009-1#42	0	3	3	P01009-1	1059	1062	+	3	P01009-1	0	1254	ENST00000449399.7	302	1556	++	100	P01009-1#42	0	3	ENST00000449399.7	1361	1364	+	3	0	0	3254
P01009-1#42	0	3	3	P01009-1	1059	1062	+	3	P01009-1	0	1254	ENST00000448921.5	573	1827	++	98	P01009-1#42	0	3	ENST00000448921.5	1632	1635	+	3	0	0	3255
P01009-1#42	0	3	3	P01009-1	1059	1062	+	3	P01009-1	0	1254	ENST00000440909.5	185	1439	++	91	P01009-1#42	0	3	ENST00000440909.5	1244	1247	+	3	0	0	3256
P01009-1#42	0	3	3	P01009-1	1059	1062	+	3	P01009-1	0	1254	ENST00000437397.5	381	1635	++	89	P01009-1#42	0	3	ENST00000437397.5	1440	1443	+	3	0	0	3257
P01009-1#42	0	3	3	P01009-1	1059	1062	+	3	P01009-1	0	1254	ENST00000404814.8	311	1565	++	68	P01009-1#42	0	3	ENST00000404814.8	1370	1373	+	3	0	0	3258
P01009-1#42	0	3	3	P01009-1	1059	1062	+	3	P01009-1	0	1065	ENST00000402629.1	34	1099	++	67	P01009-1#42	0	3	ENST00000402629.1	1093	1096	+	3	0	0	3259
P01009-1#42	0	3	3	P01009-1	1059	1062	+	3	P01009-1	0	1254	ENST00000393088.8	555	1809	++	63	P01009-1#42	0	3	ENST00000393088.8	1614	1617	+	3	0	0	3260
P01009-1#42	0	3	3	P01009-1	1059	1062	+	3	P01009-1	0	1254	ENST00000393087.9	47	1301	++	62	P01009-1#42	0	3	ENST00000393087.9	1106	1109	+	3	0	0	3261
P01009-1#42	0	3	3	P01009-1	1059	1062	+	3	P01009-1	0	1254	ENST00000355814.8	277	1531	++	36	P01009-1#42	0	3	ENST00000355814.8	1336	1339	+	3	0	0	3262
P01009-1#43	0	3	3	P01009-1	1077	1080	+	3	P01009-1	0	1254	ENST00000636712.1	152	1406	++	236	P01009-1#43	0	3	ENST00000636712.1	1229	1232	+	3	0	0	3263
P01009-1#43	0	3	3	P01009-1	1077	1080	+	3	P01009-1	0	1254	ENST00000449399.7	302	1556	++	100	P01009-1#43	0	3	ENST00000449399.7	1379	1382	+	3	0	0	3264
P01009-1#43	0	3	3	P01009-1	1077	1080	+	3	P01009-1	0	1254	ENST00000448921.5	573	1827	++	98	P01009-1#43	0	3	ENST00000448921.5	1650	1653	+	3	0	0	3265
P01009-1#43	0	3	3	P01009-1	1077	1080	+	3	P01009-1	0	1254	ENST00000440909.5	185	1439	++	91	P01009-1#43	0	3	ENST00000440909.5	1262	1265	+	3	0	0	3266
P01009-1#43	0	3	3	P01009-1	1077	1080	+	3	P01009-1	0	1254	ENST00000437397.5	381	1635	++	89	P01009-1#43	0	3	ENST00000437397.5	1458	1461	+	3	0	0	3267
P01009-1#43	0	3	3	P01009-1	1077	1080	+	3	P01009-1	0	1254	ENST00000404814.8	311	1565	++	68	P01009-1#43	0	3	ENST00000404814.8	1388	1391	+	3	0	0	3268
P01009-1#43	0	3	3	P01009-1	1077	1080	+	3	P01009-1	0	1254	ENST00000393088.8	555	1809	++	63	P01009-1#43	0	3	ENST00000393088.8	1632	1635	+	3	0	0	3269
P01009-1#43	0	3	3	P01009-1	1077	1080	+	3	P01009-1	0	1254	ENST00000393087.9	47	1301	++	62	P01009-1#43	0	3	ENST00000393087.9	1124	1127	+	3	0	0	3270
P01009-1#43	0	3	3	P01009-1	1077	1080	+	3	P01009-1	0	1254	ENST00000355814.8	277	1531	++	36	P01009-1#43	0	3	ENST00000355814.8	1354	1357	+	3	0	0	3271
P01009-1#44	0	3	3	P01009-1	1092	1095	+	3	P01009-1	0	1254	ENST00000636712.1	152	1406	++	236	P01009-1#44	0	3	ENST00000636712.1	1244	1247	+	3	0	0	3272
P01009-1#44	0	3	3	P01009-1	1092	1095	+	3	P01009-1	0	1254	ENST00000449399.7	302	1556	++	100	P01009-1#44	0	3	ENST00000449399.7	1394	1397	+	3	0	0	3273
P01009-1#44	0	3	3	P01009-1	1092	1095	+	3	P01009-1	0	1254	ENST00000448921.5	573	1827	++	98	P01009-1#44	0	3	ENST00000448921.5	1665	1668	+	3	0	0	3274
P01009-1#44	0	3	3	P01009-1	1092	1095	+	3	P01009-1	0	1254	ENST00000440909.5	185	1439	++	91	P01009-1#44	0	3	ENST00000440909.5	1277	1280	+	3	0	0	3275
P01009-1#44	0	3	3	P01009-1	1092	1095	+	3	P01009-1	0	1254	ENST00000437397.5	381	1635	++	89	P01009-1#44	0	3	ENST00000437397.5	1473	1476	+	3	0	0	3276
P01009-1#44	0	3	3	P01009-1	1092	1095	+	3	P01009-1	0	1254	ENST00000404814.8	311	1565	++	68	P01009-1#44	0	3	ENST00000404814.8	1403	1406	+	3	0	0	3277
P01009-1#44	0	3	3	P01009-1	1092	1095	+	3	P01009-1	0	1254	ENST00000393088.8	555	1809	++	63	P01009-1#44	0	3	ENST00000393088.8	1647	1650	+	3	0	0	3278
P01009-1#44	0	3	3	P01009-1	1092	1095	+	3	P01009-1	0	1254	ENST00000393087.9	47	1301	++	62	P01009-1#44	0	3	ENST00000393087.9	1139	1142	+	3	0	0	3279
P01009-1#44	0	3	3	P01009-1	1092	1095	+	3	P01009-1	0	1254	ENST00000355814.8	277	1531	++	36	P01009-1#44	0	3	ENST00000355814.8	1369	1372	+	3	0	0	3280
P01009-1#45	0	3	3	P01009-1	1095	1098	+	3	P01009-1	0	1254	ENST00000636712.1	152	1406	++	236	P01009-1#45	0	3	ENST00000636712.1	1247	1250	+	3	0	0	3281
P01009-1#45	0	3	3	P01009-1	1095	1098	+	3	P01009-1	0	1254	ENST00000449399.7	302	1556	++	100	P01009-1#45	0	3	ENST00000449399.7	1397	1400	+	3	0	0	3282
P01009-1#45	0	3	3	P01009-1	1095	1098	+	3	P01009-1	0	1254	ENST00000448921.5	573	1827	++	98	P01009-1#45	0	3	ENST00000448921.5	1668	1671	+	3	0	0	3283
P01009-1#45	0	3	3	P01009-1	1095	1098	+	3	P01009-1	0	1254	ENST00000440909.5	185	1439	++	91	P01009-1#45	0	3	ENST00000440909.5	1280	1283	+	3	0	0	3284
P01009-1#45	0	3	3	P01009-1	1095	1098	+	3	P01009-1	0	1254	ENST00000437397.5	381	1635	++	89	P01009-1#45	0	3	ENST00000437397.5	1476	1479	+	3	0	0	3285
P01009-1#45	0	3	3	P01009-1	1095	1098	+	3	P01009-1	0	1254	ENST00000404814.8	311	1565	++	68	P01009-1#45	0	3	ENST00000404814.8	1406	1409	+	3	0	0	3286
P01009-1#45	0	3	3	P01009-1	1095	1098	+	3	P01009-1	0	1254	ENST00000393088.8	555	1809	++	63	P01009-1#45	0	3	ENST00000393088.8	1650	1653	+	3	0	0	3287
P01009-1#45	0	3	3	P01009-1	1095	1098	+	3	P01009-1	0	1254	ENST00000393087.9	47	1301	++	62	P01009-1#45	0	3	ENST00000393087.9	1142	1145	+	3	0	0	3288
P01009-1#45	0	3	3	P01009-1	1095	1098	+	3	P01009-1	0	1254	ENST00000355814.8	277	1531	++	36	P01009-1#45	0	3	ENST00000355814.8	1372	1375	+	3	0	0	3289
P01009-1#46	0	3	3	P01009-1	1143	1146	+	3	P01009-1	0	1254	ENST00000636712.1	152	1406	++	236	P01009-1#46	0	3	ENST00000636712.1	1295	1298	+	3	0	0	3290
P01009-1#46	0	3	3	P01009-1	1143	1146	+	3	P01009-1	0	1254	ENST00000449399.7	302	1556	++	100	P01009-1#46	0	3	ENST00000449399.7	1445	1448	+	3	0	0	3291
P01009-1#46	0	3	3	P01009-1	1143	1146	+	3	P01009-1	0	1254	ENST00000448921.5	573	1827	++	98	P01009-1#46	0	3	ENST00000448921.5	1716	1719	+	3	0	0	3292
P01009-1#46	0	3	3	P01009-1	1143	1146	+	3	P01009-1	0	1254	ENST00000440909.5	185	1439	++	91	P01009-1#46	0	3	ENST00000440909.5	1328	1331	+	3	0	0	3293
P01009-1#46	0	3	3	P01009-1	1143	1146	+	3	P01009-1	0	1254	ENST00000437397.5	381	1635	++	89	P01009-1#46	0	3	ENST00000437397.5	1524	1527	+	3	0	0	3294
P01009-1#46	0	3	3	P01009-1	1143	1146	+	3	P01009-1	0	1254	ENST00000404814.8	311	1565	++	68	P01009-1#46	0	3	ENST00000404814.8	1454	1457	+	3	0	0	3295
P01009-1#46	0	3	3	P01009-1	1143	1146	+	3	P01009-1	0	1254	ENST00000393088.8	555	1809	++	63	P01009-1#46	0	3	ENST00000393088.8	1698	1701	+	3	0	0	3296
P01009-1#46	0	3	3	P01009-1	1143	1146	+	3	P01009-1	0	1254	ENST00000393087.9	47	1301	++	62	P01009-1#46	0	3	ENST00000393087.9	1190	1193	+	3	0	0	3297
P01009-1#46	0	3	3	P01009-1	1143	1146	+	3	P01009-1	0	1254	ENST00000355814.8	277	1531	++	36	P01009-1#46	0	3	ENST00000355814.8	1420	1423	+	3	0	0	3298
P01009-1#47	0	3	3	P01009-1	1155	1158	+	3	P01009-1	0	1254	ENST00000636712.1	152	1406	++	236	P01009-1#47	0	3	ENST00000636712.1	1307	1310	+	3	0	0	3299
P01009-1#47	0	3	3	P01009-1	1155	1158	+	3	P01009-1	0	1254	ENST00000449399.7	302	1556	++	100	P01009-1#47	0	3	ENST00000449399.7	1457	1460	+	3	0	0	3300
P01009-1#47	0	3	3	P01009-1	1155	1158	+	3	P01009-1	0	1254	ENST00000448921.5	573	1827	++	98	P01009-1#47	0	3	ENST00000448921.5	1728	1731	+	3	0	0	3301
P01009-1#47	0	3	3	P01009-1	1155	1158	+	3	P01009-1	0	1254	ENST00000440909.5	185	1439	++	91	P01009-1#47	0	3	ENST00000440909.5	1340	1343	+	3	0	0	3302
P01009-1#47	0	3	3	P01009-1	1155	1158	+	3	P01009-1	0	1254	ENST00000437397.5	381	1635	++	89	P01009-1#47	0	3	ENST00000437397.5	1536	1539	+	3	0	0	3303
P01009-1#47	0	3	3	P01009-1	1155	1158	+	3	P01009-1	0	1254	ENST00000404814.8	311	1565	++	68	P01009-1#47	0	3	ENST00000404814.8	1466	1469	+	3	0	0	3304
P01009-1#47	0	3	3	P01009-1	1155	1158	+	3	P01009-1	0	1254	ENST00000393088.8	555	1809	++	63	P01009-1#47	0	3	ENST00000393088.8	1710	1713	+	3	0	0	3305
P01009-1#47	0	3	3	P01009-1	1155	1158	+	3	P01009-1	0	1254	ENST00000393087.9	47	1301	++	62	P01009-1#47	0	3	ENST00000393087.9	1202	1205	+	3	0	0	3306
P01009-1#47	0	3	3	P01009-1	1155	1158	+	3	P01009-1	0	1254	ENST00000355814.8	277	1531	++	36	P01009-1#47	0	3	ENST00000355814.8	1432	1435	+	3	0	0	3307
P01009-1#48	0	3	3	P01009-1	1155	1158	+	3	P01009-1	0	1254	ENST00000636712.1	152	1406	++	236	P01009-1#48	0	3	ENST00000636712.1	1307	1310	+	3	0	0	3308
P01009-1#48	0	3	3	P01009-1	1155	1158	+	3	P01009-1	0	1254	ENST00000449399.7	302	1556	++	100	P01009-1#48	0	3	ENST00000449399.7	1457	1460	+	3	0	0	3309
P01009-1#48	0	3	3	P01009-1	1155	1158	+	3	P01009-1	0	1254	ENST00000448921.5	573	1827	++	98	P01009-1#48	0	3	ENST00000448921.5	1728	1731	+	3	0	0	3310
P01009-1#48	0	3	3	P01009-1	1155	1158	+	3	P01009-1	0	1254	ENST00000440909.5	185	1439	++	91	P01009-1#48	0	3	ENST00000440909.5	1340	1343	+	3	0	0	3311
P01009-1#48	0	3	3	P01009-1	1155	1158	+	3	P01009-1	0	1254	ENST00000437397.5	381	1635	++	89	P01009-1#48	0	3	ENST00000437397.5	1536	1539	+	3	0	0	3312
P01009-1#48	0	3	3	P01009-1	1155	1158	+	3	P01009-1	0	1254	ENST00000404814.8	311	1565	++	68	P01009-1#48	0	3	ENST00000404814.8	1466	1469	+	3	0	0	3313
P01009-1#48	0	3	3	P01009-1	1155	1158	+	3	P01009-1	0	1254	ENST00000393088.8	555	1809	++	63	P01009-1#48	0	3	ENST00000393088.8	1710	1713	+	3	0	0	3314
P01009-1#48	0	3	3	P01009-1	1155	1158	+	3	P01009-1	0	1254	ENST00000393087.9	47	1301	++	62	P01009-1#48	0	3	ENST00000393087.9	1202	1205	+	3	0	0	3315
P01009-1#48	0	3	3	P01009-1	1155	1158	+	3	P01009-1	0	1254	ENST00000355814.8	277	1531	++	36	P01009-1#48	0	3	ENST00000355814.8	1432	1435	+	3	0	0	3316
P01009-1#49	0	3	3	P01009-1	1158	1161	+	3	P01009-1	0	1254	ENST00000636712.1	152	1406	++	236	P01009-1#49	0	3	ENST00000636712.1	1310	1313	+	3	0	0	3317
P01009-1#49	0	3	3	P01009-1	1158	1161	+	3	P01009-1	0	1254	ENST00000449399.7	302	1556	++	100	P01009-1#49	0	3	ENST00000449399.7	1460	1463	+	3	0	0	3318
P01009-1#49	0	3	3	P01009-1	1158	1161	+	3	P01009-1	0	1254	ENST00000448921.5	573	1827	++	98	P01009-1#49	0	3	ENST00000448921.5	1731	1734	+	3	0	0	3319
P01009-1#49	0	3	3	P01009-1	1158	1161	+	3	P01009-1	0	1254	ENST00000440909.5	185	1439	++	91	P01009-1#49	0	3	ENST00000440909.5	1343	1346	+	3	0	0	3320
P01009-1#49	0	3	3	P01009-1	1158	1161	+	3	P01009-1	0	1254	ENST00000437397.5	381	1635	++	89	P01009-1#49	0	3	ENST00000437397.5	1539	1542	+	3	0	0	3321
P01009-1#49	0	3	3	P01009-1	1158	1161	+	3	P01009-1	0	1254	ENST00000404814.8	311	1565	++	68	P01009-1#49	0	3	ENST00000404814.8	1469	1472	+	3	0	0	3322
P01009-1#49	0	3	3	P01009-1	1158	1161	+	3	P01009-1	0	1254	ENST00000393088.8	555	1809	++	63	P01009-1#49	0	3	ENST00000393088.8	1713	1716	+	3	0	0	3323
P01009-1#49	0	3	3	P01009-1	1158	1161	+	3	P01009-1	0	1254	ENST00000393087.9	47	1301	++	62	P01009-1#49	0	3	ENST00000393087.9	1205	1208	+	3	0	0	3324
P01009-1#49	0	3	3	P01009-1	1158	1161	+	3	P01009-1	0	1254	ENST00000355814.8	277	1531	++	36	P01009-1#49	0	3	ENST00000355814.8	1435	1438	+	3	0	0	3325
P01009-1#50	0	3	3	P01009-1	1176	1179	+	3	P01009-1	0	1254	ENST00000636712.1	152	1406	++	236	P01009-1#50	0	3	ENST00000636712.1	1328	1331	+	3	0	0	3326
P01009-1#50	0	3	3	P01009-1	1176	1179	+	3	P01009-1	0	1254	ENST00000449399.7	302	1556	++	100	P01009-1#50	0	3	ENST00000449399.7	1478	1481	+	3	0	0	3327
P01009-1#50	0	3	3	P01009-1	1176	1179	+	3	P01009-1	0	1254	ENST00000448921.5	573	1827	++	98	P01009-1#50	0	3	ENST00000448921.5	1749	1752	+	3	0	0	3328
P01009-1#50	0	3	3	P01009-1	1176	1179	+	3	P01009-1	0	1254	ENST00000440909.5	185	1439	++	91	P01009-1#50	0	3	ENST00000440909.5	1361	1364	+	3	0	0	3329
P01009-1#50	0	3	3	P01009-1	1176	1179	+	3	P01009-1	0	1254	ENST00000437397.5	381	1635	++	89	P01009-1#50	0	3	ENST00000437397.5	1557	1560	+	3	0	0	3330
P01009-1#50	0	3	3	P01009-1	1176	1179	+	3	P01009-1	0	1254	ENST00000404814.8	311	1565	++	68	P01009-1#50	0	3	ENST00000404814.8	1487	1490	+	3	0	0	3331
P01009-1#50	0	3	3	P01009-1	1176	1179	+	3	P01009-1	0	1254	ENST00000393088.8	555	1809	++	63	P01009-1#50	0	3	ENST00000393088.8	1731	1734	+	3	0	0	3332
P01009-1#50	0	3	3	P01009-1	1176	1179	+	3	P01009-1	0	1254	ENST00000393087.9	47	1301	++	62	P01009-1#50	0	3	ENST00000393087.9	1223	1226	+	3	0	0	3333
P01009-1#50	0	3	3	P01009-1	1176	1179	+	3	P01009-1	0	1254	ENST00000355814.8	277	1531	++	36	P01009-1#50	0	3	ENST00000355814.8	1453	1456	+	3	0	0	3334
P01009-1#51	0	3	3	P01009-1	1197	1200	+	3	P01009-1	0	1254	ENST00000636712.1	152	1406	++	236	P01009-1#51	0	3	ENST00000636712.1	1349	1352	+	3	0	0	3335
P01009-1#51	0	3	3	P01009-1	1197	1200	+	3	P01009-1	0	1254	ENST00000449399.7	302	1556	++	100	P01009-1#51	0	3	ENST00000449399.7	1499	1502	+	3	0	0	3336
P01009-1#51	0	3	3	P01009-1	1197	1200	+	3	P01009-1	0	1254	ENST00000448921.5	573	1827	++	98	P01009-1#51	0	3	ENST00000448921.5	1770	1773	+	3	0	0	3337
P01009-1#51	0	3	3	P01009-1	1197	1200	+	3	P01009-1	0	1254	ENST00000440909.5	185	1439	++	91	P01009-1#51	0	3	ENST00000440909.5	1382	1385	+	3	0	0	3338
P01009-1#51	0	3	3	P01009-1	1197	1200	+	3	P01009-1	0	1254	ENST00000437397.5	381	1635	++	89	P01009-1#51	0	3	ENST00000437397.5	1578	1581	+	3	0	0	3339
P01009-1#51	0	3	3	P01009-1	1197	1200	+	3	P01009-1	0	1254	ENST00000404814.8	311	1565	++	68	P01009-1#51	0	3	ENST00000404814.8	1508	1511	+	3	0	0	3340
P01009-1#51	0	3	3	P01009-1	1197	1200	+	3	P01009-1	0	1254	ENST00000393088.8	555	1809	++	63	P01009-1#51	0	3	ENST00000393088.8	1752	1755	+	3	0	0	3341
P01009-1#51	0	3	3	P01009-1	1197	1200	+	3	P01009-1	0	1254	ENST00000393087.9	47	1301	++	62	P01009-1#51	0	3	ENST00000393087.9	1244	1247	+	3	0	0	3342
P01009-1#51	0	3	3	P01009-1	1197	1200	+	3	P01009-1	0	1254	ENST00000355814.8	277	1531	++	36	P01009-1#51	0	3	ENST00000355814.8	1474	1477	+	3	0	0	3343
P01009-1#52	0	3	3	P01009-1	1242	1245	+	3	P01009-1	0	1254	ENST00000636712.1	152	1406	++	236	P01009-1#52	0	3	ENST00000636712.1	1394	1397	+	3	0	0	3344
P01009-1#52	0	3	3	P01009-1	1242	1245	+	3	P01009-1	0	1254	ENST00000449399.7	302	1556	++	100	P01009-1#52	0	3	ENST00000449399.7	1544	1547	+	3	0	0	3345
P01009-1#52	0	3	3	P01009-1	1242	1245	+	3	P01009-1	0	1254	ENST00000448921.5	573	1827	++	98	P01009-1#52	0	3	ENST00000448921.5	1815	1818	+	3	0	0	3346
P01009-1#52	0	3	3	P01009-1	1242	1245	+	3	P01009-1	0	1254	ENST00000440909.5	185	1439	++	91	P01009-1#52	0	3	ENST00000440909.5	1427	1430	+	3	0	0	3347
P01009-1#52	0	3	3	P01009-1	1242	1245	+	3	P01009-1	0	1254	ENST00000437397.5	381	1635	++	89	P01009-1#52	0	3	ENST00000437397.5	1623	1626	+	3	0	0	3348
P01009-1#52	0	3	3	P01009-1	1242	1245	+	3	P01009-1	0	1254	ENST00000404814.8	311	1565	++	68	P01009-1#52	0	3	ENST00000404814.8	1553	1556	+	3	0	0	3349
P01009-1#52	0	3	3	P01009-1	1242	1245	+	3	P01009-1	0	1254	ENST00000393088.8	555	1809	++	63	P01009-1#52	0	3	ENST00000393088.8	1797	1800	+	3	0	0	3350
P01009-1#52	0	3	3	P01009-1	1242	1245	+	3	P01009-1	0	1254	ENST00000393087.9	47	1301	++	62	P01009-1#52	0	3	ENST00000393087.9	1289	1292	+	3	0	0	3351
P01009-1#52	0	3	3	P01009-1	1242	1245	+	3	P01009-1	0	1254	ENST00000355814.8	277	1531	++	36	P01009-1#52	0	3	ENST00000355814.8	1519	1522	+	3	0	0	3352
P01009-1#53	0	3	3	P01009-1	1143	1146	+	3	P01009-1	0	1254	ENST00000636712.1	152	1406	++	236	P01009-1#53	0	3	ENST00000636712.1	1295	1298	+	3	0	0	3353
P01009-1#53	0	3	3	P01009-1	1143	1146	+	3	P01009-1	0	1254	ENST00000449399.7	302	1556	++	100	P01009-1#53	0	3	ENST00000449399.7	1445	1448	+	3	0	0	3354
P01009-1#53	0	3	3	P01009-1	1143	1146	+	3	P01009-1	0	1254	ENST00000448921.5	573	1827	++	98	P01009-1#53	0	3	ENST00000448921.5	1716	1719	+	3	0	0	3355
P01009-1#53	0	3	3	P01009-1	1143	1146	+	3	P01009-1	0	1254	ENST00000440909.5	185	1439	++	91	P01009-1#53	0	3	ENST00000440909.5	1328	1331	+	3	0	0	3356
P01009-1#53	0	3	3	P01009-1	1143	1146	+	3	P01009-1	0	1254	ENST00000437397.5	381	1635	++	89	P01009-1#53	0	3	ENST00000437397.5	1524	1527	+	3	0	0	3357
P01009-1#53	0	3	3	P01009-1	1143	1146	+	3	P01009-1	0	1254	ENST00000404814.8	311	1565	++	68	P01009-1#53	0	3	ENST00000404814.8	1454	1457	+	3	0	0	3358
P01009-1#53	0	3	3	P01009-1	1143	1146	+	3	P01009-1	0	1254	ENST00000393088.8	555	1809	++	63	P01009-1#53	0	3	ENST00000393088.8	1698	1701	+	3	0	0	3359
P01009-1#53	0	3	3	P01009-1	1143	1146	+	3	P01009-1	0	1254	ENST00000393087.9	47	1301	++	62	P01009-1#53	0	3	ENST00000393087.9	1190	1193	+	3	0	0	3360
P01009-1#53	0	3	3	P01009-1	1143	1146	+	3	P01009-1	0	1254	ENST00000355814.8	277	1531	++	36	P01009-1#53	0	3	ENST00000355814.8	1420	1423	+	3	0	0	3361
P01009-1#54	0	3	3	P01009-1	33	36	+	3	P01009-1	0	1254	ENST00000636712.1	152	1406	++	236	P01009-1#54	0	3	ENST00000636712.1	185	188	+	3	0	0	3362
P01009-1#54	0	3	3	P01009-1	33	36	+	3	P01009-1	0	434	ENST00000557492.5	517	951	+	175	P01009-1#54	0	3	ENST00000557492.5	550	553	+	3	0	0	3363
P01009-1#54	0	3	3	P01009-1	33	36	+	3	P01009-1	0	67	ENST00000557118.5	516	583	+	174	P01009-1#54	0	3	ENST00000557118.5	549	552	+	3	0	0	3364
P01009-1#54	0	3	3	P01009-1	33	36	+	3	P01009-1	0	351	ENST00000556955.5	220	571	+	173	P01009-1#54	0	3	ENST00000556955.5	253	256	+	3	0	0	3365
P01009-1#54	0	3	3	P01009-1	33	36	+	3	P01009-1	0	469	ENST00000556091.1	174	643	+	172	P01009-1#54	0	3	ENST00000556091.1	207	210	+	3	0	0	3366
P01009-1#54	0	3	3	P01009-1	33	36	+	3	P01009-1	0	278	ENST00000553327.5	303	581	+	170	P01009-1#54	0	3	ENST00000553327.5	336	339	+	3	0	0	3367
P01009-1#54	0	3	3	P01009-1	33	36	+	3	P01009-1	0	918	ENST00000489769.1	9	927	++	119	P01009-1#54	0	3	ENST00000489769.1	42	45	+	3	0	0	3368
P01009-1#54	0	3	3	P01009-1	33	36	+	3	P01009-1	0	1254	ENST00000449399.7	302	1556	++	100	P01009-1#54	0	3	ENST00000449399.7	335	338	+	3	0	0	3369
P01009-1#54	0	3	3	P01009-1	33	36	+	3	P01009-1	0	1254	ENST00000448921.5	573	1827	++	98	P01009-1#54	0	3	ENST00000448921.5	606	609	+	3	0	0	3370
P01009-1#54	0	3	3	P01009-1	33	36	+	3	P01009-1	0	1254	ENST00000440909.5	185	1439	++	91	P01009-1#54	0	3	ENST00000440909.5	218	221	+	3	0	0	3371
P01009-1#54	0	3	3	P01009-1	33	36	+	3	P01009-1	0	1254	ENST00000437397.5	381	1635	++	89	P01009-1#54	0	3	ENST00000437397.5	414	417	+	3	0	0	3372
P01009-1#54	0	3	3	P01009-1	33	36	+	3	P01009-1	0	1254	ENST00000404814.8	311	1565	++	68	P01009-1#54	0	3	ENST00000404814.8	344	347	+	3	0	0	3373
P01009-1#54	0	3	3	P01009-1	33	36	+	3	P01009-1	0	1065	ENST00000402629.1	34	1099	++	67	P01009-1#54	0	3	ENST00000402629.1	67	70	+	3	0	0	3374
P01009-1#54	0	3	3	P01009-1	33	36	+	3	P01009-1	0	1254	ENST00000393088.8	555	1809	++	63	P01009-1#54	0	3	ENST00000393088.8	588	591	+	3	0	0	3375
P01009-1#54	0	3	3	P01009-1	33	36	+	3	P01009-1	0	1254	ENST00000393087.9	47	1301	++	62	P01009-1#54	0	3	ENST00000393087.9	80	83	+	3	0	0	3376
P01009-1#54	0	3	3	P01009-1	33	36	+	3	P01009-1	0	1254	ENST00000355814.8	277	1531	++	36	P01009-1#54	0	3	ENST00000355814.8	310	313	+	3	0	0	3377
P01009-1#55	0	3	3	P01009-1	66	69	+	3	P01009-1	0	1254	ENST00000636712.1	152	1406	++	236	P01009-1#55	0	3	ENST00000636712.1	218	221	+	3	0	0	3378
P01009-1#55	0	3	3	P01009-1	66	69	+	3	P01009-1	0	434	ENST00000557492.5	517	951	+	175	P01009-1#55	0	3	ENST00000557492.5	583	586	+	3	0	0	3379
P01009-1#55	0	3	3	P01009-1	66	69	+	3	P01009-1	0	67	ENST00000557118.5	516	583	+	174	P01009-1#55	0	1	ENST00000557118.5	582	583	+	1	0	2	3380
P01009-1#55	0	3	3	P01009-1	66	69	+	3	P01009-1	0	351	ENST00000556955.5	220	571	+	173	P01009-1#55	0	3	ENST00000556955.5	286	289	+	3	0	0	3381
P01009-1#55	0	3	3	P01009-1	66	69	+	3	P01009-1	0	469	ENST00000556091.1	174	643	+	172	P01009-1#55	0	3	ENST00000556091.1	240	243	+	3	0	0	3382
P01009-1#55	0	3	3	P01009-1	66	69	+	3	P01009-1	0	278	ENST00000553327.5	303	581	+	170	P01009-1#55	0	3	ENST00000553327.5	369	372	+	3	0	0	3383
P01009-1#55	0	3	3	P01009-1	66	69	+	3	P01009-1	0	918	ENST00000489769.1	9	927	++	119	P01009-1#55	0	3	ENST00000489769.1	75	78	+	3	0	0	3384
P01009-1#55	0	3	3	P01009-1	66	69	+	3	P01009-1	0	1254	ENST00000449399.7	302	1556	++	100	P01009-1#55	0	3	ENST00000449399.7	368	371	+	3	0	0	3385
P01009-1#55	0	3	3	P01009-1	66	69	+	3	P01009-1	0	1254	ENST00000448921.5	573	1827	++	98	P01009-1#55	0	3	ENST00000448921.5	639	642	+	3	0	0	3386
P01009-1#55	0	3	3	P01009-1	66	69	+	3	P01009-1	0	1254	ENST00000440909.5	185	1439	++	91	P01009-1#55	0	3	ENST00000440909.5	251	254	+	3	0	0	3387
P01009-1#55	0	3	3	P01009-1	66	69	+	3	P01009-1	0	1254	ENST00000437397.5	381	1635	++	89	P01009-1#55	0	3	ENST00000437397.5	447	450	+	3	0	0	3388
P01009-1#55	0	3	3	P01009-1	66	69	+	3	P01009-1	0	1254	ENST00000404814.8	311	1565	++	68	P01009-1#55	0	3	ENST00000404814.8	377	380	+	3	0	0	3389
P01009-1#55	0	3	3	P01009-1	66	69	+	3	P01009-1	0	1065	ENST00000402629.1	34	1099	++	67	P01009-1#55	0	3	ENST00000402629.1	100	103	+	3	0	0	3390
P01009-1#55	0	3	3	P01009-1	66	69	+	3	P01009-1	0	1254	ENST00000393088.8	555	1809	++	63	P01009-1#55	0	3	ENST00000393088.8	621	624	+	3	0	0	3391
P01009-1#55	0	3	3	P01009-1	66	69	+	3	P01009-1	0	1254	ENST00000393087.9	47	1301	++	62	P01009-1#55	0	3	ENST00000393087.9	113	116	+	3	0	0	3392
P01009-1#55	0	3	3	P01009-1	66	69	+	3	P01009-1	0	1254	ENST00000355814.8	277	1531	++	36	P01009-1#55	0	3	ENST00000355814.8	343	346	+	3	0	0	3393
P01009-1#56	0	3	3	P01009-1	75	78	+	3	P01009-1	0	1254	ENST00000636712.1	152	1406	++	236	P01009-1#56	0	3	ENST00000636712.1	227	230	+	3	0	0	3394
P01009-1#56	0	3	3	P01009-1	75	78	+	3	P01009-1	0	434	ENST00000557492.5	517	951	+	175	P01009-1#56	0	3	ENST00000557492.5	592	595	+	3	0	0	3395
P01009-1#56	0	3	3	P01009-1	75	78	+	3	P01009-1	0	351	ENST00000556955.5	220	571	+	173	P01009-1#56	0	3	ENST00000556955.5	295	298	+	3	0	0	3396
P01009-1#56	0	3	3	P01009-1	75	78	+	3	P01009-1	0	469	ENST00000556091.1	174	643	+	172	P01009-1#56	0	3	ENST00000556091.1	249	252	+	3	0	0	3397
P01009-1#56	0	3	3	P01009-1	75	78	+	3	P01009-1	0	278	ENST00000553327.5	303	581	+	170	P01009-1#56	0	3	ENST00000553327.5	378	381	+	3	0	0	3398
P01009-1#56	0	3	3	P01009-1	75	78	+	3	P01009-1	0	918	ENST00000489769.1	9	927	++	119	P01009-1#56	0	3	ENST00000489769.1	84	87	+	3	0	0	3399
P01009-1#56	0	3	3	P01009-1	75	78	+	3	P01009-1	0	1254	ENST00000449399.7	302	1556	++	100	P01009-1#56	0	3	ENST00000449399.7	377	380	+	3	0	0	3400
P01009-1#56	0	3	3	P01009-1	75	78	+	3	P01009-1	0	1254	ENST00000448921.5	573	1827	++	98	P01009-1#56	0	3	ENST00000448921.5	648	651	+	3	0	0	3401
P01009-1#56	0	3	3	P01009-1	75	78	+	3	P01009-1	0	1254	ENST00000440909.5	185	1439	++	91	P01009-1#56	0	3	ENST00000440909.5	260	263	+	3	0	0	3402
P01009-1#56	0	3	3	P01009-1	75	78	+	3	P01009-1	0	1254	ENST00000437397.5	381	1635	++	89	P01009-1#56	0	3	ENST00000437397.5	456	459	+	3	0	0	3403
P01009-1#56	0	3	3	P01009-1	75	78	+	3	P01009-1	0	1254	ENST00000404814.8	311	1565	++	68	P01009-1#56	0	3	ENST00000404814.8	386	389	+	3	0	0	3404
P01009-1#56	0	3	3	P01009-1	75	78	+	3	P01009-1	0	1065	ENST00000402629.1	34	1099	++	67	P01009-1#56	0	3	ENST00000402629.1	109	112	+	3	0	0	3405
P01009-1#56	0	3	3	P01009-1	75	78	+	3	P01009-1	0	1254	ENST00000393088.8	555	1809	++	63	P01009-1#56	0	3	ENST00000393088.8	630	633	+	3	0	0	3406
P01009-1#56	0	3	3	P01009-1	75	78	+	3	P01009-1	0	1254	ENST00000393087.9	47	1301	++	62	P01009-1#56	0	3	ENST00000393087.9	122	125	+	3	0	0	3407
P01009-1#56	0	3	3	P01009-1	75	78	+	3	P01009-1	0	1254	ENST00000355814.8	277	1531	++	36	P01009-1#56	0	3	ENST00000355814.8	352	355	+	3	0	0	3408
P01009-1#57	0	3	3	P01009-1	114	117	+	3	P01009-1	0	1254	ENST00000636712.1	152	1406	++	236	P01009-1#57	0	3	ENST00000636712.1	266	269	+	3	0	0	3409
P01009-1#57	0	3	3	P01009-1	114	117	+	3	P01009-1	0	434	ENST00000557492.5	517	951	+	175	P01009-1#57	0	3	ENST00000557492.5	631	634	+	3	0	0	3410
P01009-1#57	0	3	3	P01009-1	114	117	+	3	P01009-1	0	351	ENST00000556955.5	220	571	+	173	P01009-1#57	0	3	ENST00000556955.5	334	337	+	3	0	0	3411
P01009-1#57	0	3	3	P01009-1	114	117	+	3	P01009-1	0	469	ENST00000556091.1	174	643	+	172	P01009-1#57	0	3	ENST00000556091.1	288	291	+	3	0	0	3412
P01009-1#57	0	3	3	P01009-1	114	117	+	3	P01009-1	0	278	ENST00000553327.5	303	581	+	170	P01009-1#57	0	3	ENST00000553327.5	417	420	+	3	0	0	3413
P01009-1#57	0	3	3	P01009-1	114	117	+	3	P01009-1	0	918	ENST00000489769.1	9	927	++	119	P01009-1#57	0	3	ENST00000489769.1	123	126	+	3	0	0	3414
P01009-1#57	0	3	3	P01009-1	114	117	+	3	P01009-1	0	1254	ENST00000449399.7	302	1556	++	100	P01009-1#57	0	3	ENST00000449399.7	416	419	+	3	0	0	3415
P01009-1#57	0	3	3	P01009-1	114	117	+	3	P01009-1	0	1254	ENST00000448921.5	573	1827	++	98	P01009-1#57	0	3	ENST00000448921.5	687	690	+	3	0	0	3416
P01009-1#57	0	3	3	P01009-1	114	117	+	3	P01009-1	0	1254	ENST00000440909.5	185	1439	++	91	P01009-1#57	0	3	ENST00000440909.5	299	302	+	3	0	0	3417
P01009-1#57	0	3	3	P01009-1	114	117	+	3	P01009-1	0	1254	ENST00000437397.5	381	1635	++	89	P01009-1#57	0	3	ENST00000437397.5	495	498	+	3	0	0	3418
P01009-1#57	0	3	3	P01009-1	114	117	+	3	P01009-1	0	1254	ENST00000404814.8	311	1565	++	68	P01009-1#57	0	3	ENST00000404814.8	425	428	+	3	0	0	3419
P01009-1#57	0	3	3	P01009-1	114	117	+	3	P01009-1	0	1065	ENST00000402629.1	34	1099	++	67	P01009-1#57	0	3	ENST00000402629.1	148	151	+	3	0	0	3420
P01009-1#57	0	3	3	P01009-1	114	117	+	3	P01009-1	0	1254	ENST00000393088.8	555	1809	++	63	P01009-1#57	0	3	ENST00000393088.8	669	672	+	3	0	0	3421
P01009-1#57	0	3	3	P01009-1	114	117	+	3	P01009-1	0	1254	ENST00000393087.9	47	1301	++	62	P01009-1#57	0	3	ENST00000393087.9	161	164	+	3	0	0	3422
P01009-1#57	0	3	3	P01009-1	114	117	+	3	P01009-1	0	1254	ENST00000355814.8	277	1531	++	36	P01009-1#57	0	3	ENST00000355814.8	391	394	+	3	0	0	3423
P01009-1#58	0	3	3	P01009-1	180	183	+	3	P01009-1	0	1254	ENST00000636712.1	152	1406	++	236	P01009-1#58	0	3	ENST00000636712.1	332	335	+	3	0	0	3424
P01009-1#58	0	3	3	P01009-1	180	183	+	3	P01009-1	0	434	ENST00000557492.5	517	951	+	175	P01009-1#58	0	3	ENST00000557492.5	697	700	+	3	0	0	3425
P01009-1#58	0	3	3	P01009-1	180	183	+	3	P01009-1	0	351	ENST00000556955.5	220	571	+	173	P01009-1#58	0	3	ENST00000556955.5	400	403	+	3	0	0	3426
P01009-1#58	0	3	3	P01009-1	180	183	+	3	P01009-1	0	469	ENST00000556091.1	174	643	+	172	P01009-1#58	0	3	ENST00000556091.1	354	357	+	3	0	0	3427
P01009-1#58	0	3	3	P01009-1	180	183	+	3	P01009-1	0	278	ENST00000553327.5	303	581	+	170	P01009-1#58	0	3	ENST00000553327.5	483	486	+	3	0	0	3428
P01009-1#58	0	3	3	P01009-1	180	183	+	3	P01009-1	0	918	ENST00000489769.1	9	927	++	119	P01009-1#58	0	3	ENST00000489769.1	189	192	+	3	0	0	3429
P01009-1#58	0	3	3	P01009-1	180	183	+	3	P01009-1	0	1254	ENST00000449399.7	302	1556	++	100	P01009-1#58	0	3	ENST00000449399.7	482	485	+	3	0	0	3430
P01009-1#58	0	3	3	P01009-1	180	183	+	3	P01009-1	0	1254	ENST00000448921.5	573	1827	++	98	P01009-1#58	0	3	ENST00000448921.5	753	756	+	3	0	0	3431
P01009-1#58	0	3	3	P01009-1	180	183	+	3	P01009-1	0	1254	ENST00000440909.5	185	1439	++	91	P01009-1#58	0	3	ENST00000440909.5	365	368	+	3	0	0	3432
P01009-1#58	0	3	3	P01009-1	180	183	+	3	P01009-1	0	1254	ENST00000437397.5	381	1635	++	89	P01009-1#58	0	3	ENST00000437397.5	561	564	+	3	0	0	3433
P01009-1#58	0	3	3	P01009-1	180	183	+	3	P01009-1	0	1254	ENST00000404814.8	311	1565	++	68	P01009-1#58	0	3	ENST00000404814.8	491	494	+	3	0	0	3434
P01009-1#58	0	3	3	P01009-1	180	183	+	3	P01009-1	0	1065	ENST00000402629.1	34	1099	++	67	P01009-1#58	0	3	ENST00000402629.1	214	217	+	3	0	0	3435
P01009-1#58	0	3	3	P01009-1	180	183	+	3	P01009-1	0	1254	ENST00000393088.8	555	1809	++	63	P01009-1#58	0	3	ENST00000393088.8	735	738	+	3	0	0	3436
P01009-1#58	0	3	3	P01009-1	180	183	+	3	P01009-1	0	1254	ENST00000393087.9	47	1301	++	62	P01009-1#58	0	3	ENST00000393087.9	227	230	+	3	0	0	3437
P01009-1#58	0	3	3	P01009-1	180	183	+	3	P01009-1	0	1254	ENST00000355814.8	277	1531	++	36	P01009-1#58	0	3	ENST00000355814.8	457	460	+	3	0	0	3438
P01009-1#59	0	3	3	P01009-1	285	288	+	3	P01009-1	0	1254	ENST00000636712.1	152	1406	++	236	P01009-1#59	0	3	ENST00000636712.1	437	440	+	3	0	0	3439
P01009-1#59	0	3	3	P01009-1	285	288	+	3	P01009-1	0	434	ENST00000557492.5	517	951	+	175	P01009-1#59	0	3	ENST00000557492.5	802	805	+	3	0	0	3440
P01009-1#59	0	3	3	P01009-1	285	288	+	3	P01009-1	0	351	ENST00000556955.5	220	571	+	173	P01009-1#59	0	3	ENST00000556955.5	505	508	+	3	0	0	3441
P01009-1#59	0	3	3	P01009-1	285	288	+	3	P01009-1	0	469	ENST00000556091.1	174	643	+	172	P01009-1#59	0	3	ENST00000556091.1	459	462	+	3	0	0	3442
P01009-1#59	0	3	3	P01009-1	285	288	+	3	P01009-1	258	575	ENST00000554720.1	129	446	+	171	P01009-1#59	0	3	ENST00000554720.1	156	159	+	3	0	0	3443
P01009-1#59	0	3	3	P01009-1	285	288	+	3	P01009-1	0	918	ENST00000489769.1	9	927	++	119	P01009-1#59	0	3	ENST00000489769.1	294	297	+	3	0	0	3444
P01009-1#59	0	3	3	P01009-1	285	288	+	3	P01009-1	0	1254	ENST00000449399.7	302	1556	++	100	P01009-1#59	0	3	ENST00000449399.7	587	590	+	3	0	0	3445
P01009-1#59	0	3	3	P01009-1	285	288	+	3	P01009-1	0	1254	ENST00000448921.5	573	1827	++	98	P01009-1#59	0	3	ENST00000448921.5	858	861	+	3	0	0	3446
P01009-1#59	0	3	3	P01009-1	285	288	+	3	P01009-1	0	1254	ENST00000440909.5	185	1439	++	91	P01009-1#59	0	3	ENST00000440909.5	470	473	+	3	0	0	3447
P01009-1#59	0	3	3	P01009-1	285	288	+	3	P01009-1	0	1254	ENST00000437397.5	381	1635	++	89	P01009-1#59	0	3	ENST00000437397.5	666	669	+	3	0	0	3448
P01009-1#59	0	3	3	P01009-1	285	288	+	3	P01009-1	0	1254	ENST00000404814.8	311	1565	++	68	P01009-1#59	0	3	ENST00000404814.8	596	599	+	3	0	0	3449
P01009-1#59	0	3	3	P01009-1	285	288	+	3	P01009-1	0	1065	ENST00000402629.1	34	1099	++	67	P01009-1#59	0	3	ENST00000402629.1	319	322	+	3	0	0	3450
P01009-1#59	0	3	3	P01009-1	285	288	+	3	P01009-1	0	1254	ENST00000393088.8	555	1809	++	63	P01009-1#59	0	3	ENST00000393088.8	840	843	+	3	0	0	3451
P01009-1#59	0	3	3	P01009-1	285	288	+	3	P01009-1	0	1254	ENST00000393087.9	47	1301	++	62	P01009-1#59	0	3	ENST00000393087.9	332	335	+	3	0	0	3452
P01009-1#59	0	3	3	P01009-1	285	288	+	3	P01009-1	0	1254	ENST00000355814.8	277	1531	++	36	P01009-1#59	0	3	ENST00000355814.8	562	565	+	3	0	0	3453
P01009-1#60	0	6	6	P01009-1	414	420	+	6	P01009-1	0	1254	ENST00000636712.1	152	1406	++	236	P01009-1#60	0	6	ENST00000636712.1	566	572	+	6	0	0	3454
P01009-1#60	0	6	6	P01009-1	414	420	+	6	P01009-1	0	434	ENST00000557492.5	517	951	+	175	P01009-1#60	0	6	ENST00000557492.5	931	937	+	6	0	0	3455
P01009-1#60	0	6	6	P01009-1	414	420	+	6	P01009-1	0	469	ENST00000556091.1	174	643	+	172	P01009-1#60	0	6	ENST00000556091.1	588	594	+	6	0	0	3456
P01009-1#60	0	6	6	P01009-1	414	420	+	6	P01009-1	258	575	ENST00000554720.1	129	446	+	171	P01009-1#60	0	6	ENST00000554720.1	285	291	+	6	0	0	3457
P01009-1#60	0	6	6	P01009-1	414	420	+	6	P01009-1	0	918	ENST00000489769.1	9	927	++	119	P01009-1#60	0	6	ENST00000489769.1	423	429	+	6	0	0	3458
P01009-1#60	0	6	6	P01009-1	414	420	+	6	P01009-1	0	1254	ENST00000449399.7	302	1556	++	100	P01009-1#60	0	6	ENST00000449399.7	716	722	+	6	0	0	3459
P01009-1#60	0	6	6	P01009-1	414	420	+	6	P01009-1	0	1254	ENST00000448921.5	573	1827	++	98	P01009-1#60	0	6	ENST00000448921.5	987	993	+	6	0	0	3460
P01009-1#60	0	6	6	P01009-1	414	420	+	6	P01009-1	0	1254	ENST00000440909.5	185	1439	++	91	P01009-1#60	0	6	ENST00000440909.5	599	605	+	6	0	0	3461
P01009-1#60	0	6	6	P01009-1	414	420	+	6	P01009-1	0	1254	ENST00000437397.5	381	1635	++	89	P01009-1#60	0	6	ENST00000437397.5	795	801	+	6	0	0	3462
P01009-1#60	0	6	6	P01009-1	414	420	+	6	P01009-1	0	1254	ENST00000404814.8	311	1565	++	68	P01009-1#60	0	6	ENST00000404814.8	725	731	+	6	0	0	3463
P01009-1#60	0	6	6	P01009-1	414	420	+	6	P01009-1	0	1065	ENST00000402629.1	34	1099	++	67	P01009-1#60	0	6	ENST00000402629.1	448	454	+	6	0	0	3464
P01009-1#60	0	6	6	P01009-1	414	420	+	6	P01009-1	0	1254	ENST00000393088.8	555	1809	++	63	P01009-1#60	0	6	ENST00000393088.8	969	975	+	6	0	0	3465
P01009-1#60	0	6	6	P01009-1	414	420	+	6	P01009-1	0	1254	ENST00000393087.9	47	1301	++	62	P01009-1#60	0	6	ENST00000393087.9	461	467	+	6	0	0	3466
P01009-1#60	0	6	6	P01009-1	414	420	+	6	P01009-1	0	1254	ENST00000355814.8	277	1531	++	36	P01009-1#60	0	6	ENST00000355814.8	691	697	+	6	0	0	3467
P01009-1#61	0	3	3	P01009-1	519	522	+	3	P01009-1	0	1254	ENST00000636712.1	152	1406	++	236	P01009-1#61	0	3	ENST00000636712.1	671	674	+	3	0	0	3468
P01009-1#61	0	3	3	P01009-1	519	522	+	3	P01009-1	258	575	ENST00000554720.1	129	446	+	171	P01009-1#61	0	3	ENST00000554720.1	390	393	+	3	0	0	3469
P01009-1#61	0	3	3	P01009-1	519	522	+	3	P01009-1	0	918	ENST00000489769.1	9	927	++	119	P01009-1#61	0	3	ENST00000489769.1	528	531	+	3	0	0	3470
P01009-1#61	0	3	3	P01009-1	519	522	+	3	P01009-1	0	1254	ENST00000449399.7	302	1556	++	100	P01009-1#61	0	3	ENST00000449399.7	821	824	+	3	0	0	3471
P01009-1#61	0	3	3	P01009-1	519	522	+	3	P01009-1	0	1254	ENST00000448921.5	573	1827	++	98	P01009-1#61	0	3	ENST00000448921.5	1092	1095	+	3	0	0	3472
P01009-1#61	0	3	3	P01009-1	519	522	+	3	P01009-1	0	1254	ENST00000440909.5	185	1439	++	91	P01009-1#61	0	3	ENST00000440909.5	704	707	+	3	0	0	3473
P01009-1#61	0	3	3	P01009-1	519	522	+	3	P01009-1	0	1254	ENST00000437397.5	381	1635	++	89	P01009-1#61	0	3	ENST00000437397.5	900	903	+	3	0	0	3474
P01009-1#61	0	3	3	P01009-1	519	522	+	3	P01009-1	0	1254	ENST00000404814.8	311	1565	++	68	P01009-1#61	0	3	ENST00000404814.8	830	833	+	3	0	0	3475
P01009-1#61	0	3	3	P01009-1	519	522	+	3	P01009-1	0	1065	ENST00000402629.1	34	1099	++	67	P01009-1#61	0	3	ENST00000402629.1	553	556	+	3	0	0	3476
P01009-1#61	0	3	3	P01009-1	519	522	+	3	P01009-1	0	1254	ENST00000393088.8	555	1809	++	63	P01009-1#61	0	3	ENST00000393088.8	1074	1077	+	3	0	0	3477
P01009-1#61	0	3	3	P01009-1	519	522	+	3	P01009-1	0	1254	ENST00000393087.9	47	1301	++	62	P01009-1#61	0	3	ENST00000393087.9	566	569	+	3	0	0	3478
P01009-1#61	0	3	3	P01009-1	519	522	+	3	P01009-1	0	1254	ENST00000355814.8	277	1531	++	36	P01009-1#61	0	3	ENST00000355814.8	796	799	+	3	0	0	3479
P01009-1#62	0	3	3	P01009-1	684	687	+	3	P01009-1	0	1254	ENST00000636712.1	152	1406	++	236	P01009-1#62	0	3	ENST00000636712.1	836	839	+	3	0	0	3480
P01009-1#62	0	3	3	P01009-1	684	687	+	3	P01009-1	0	918	ENST00000489769.1	9	927	++	119	P01009-1#62	0	3	ENST00000489769.1	693	696	+	3	0	0	3481
P01009-1#62	0	3	3	P01009-1	684	687	+	3	P01009-1	0	1254	ENST00000449399.7	302	1556	++	100	P01009-1#62	0	3	ENST00000449399.7	986	989	+	3	0	0	3482
P01009-1#62	0	3	3	P01009-1	684	687	+	3	P01009-1	0	1254	ENST00000448921.5	573	1827	++	98	P01009-1#62	0	3	ENST00000448921.5	1257	1260	+	3	0	0	3483
P01009-1#62	0	3	3	P01009-1	684	687	+	3	P01009-1	0	1254	ENST00000440909.5	185	1439	++	91	P01009-1#62	0	3	ENST00000440909.5	869	872	+	3	0	0	3484
P01009-1#62	0	3	3	P01009-1	684	687	+	3	P01009-1	0	1254	ENST00000437397.5	381	1635	++	89	P01009-1#62	0	3	ENST00000437397.5	1065	1068	+	3	0	0	3485
P01009-1#62	0	3	3	P01009-1	684	687	+	3	P01009-1	0	1254	ENST00000404814.8	311	1565	++	68	P01009-1#62	0	3	ENST00000404814.8	995	998	+	3	0	0	3486
P01009-1#62	0	3	3	P01009-1	684	687	+	3	P01009-1	0	1065	ENST00000402629.1	34	1099	++	67	P01009-1#62	0	3	ENST00000402629.1	718	721	+	3	0	0	3487
P01009-1#62	0	3	3	P01009-1	684	687	+	3	P01009-1	0	1254	ENST00000393088.8	555	1809	++	63	P01009-1#62	0	3	ENST00000393088.8	1239	1242	+	3	0	0	3488
P01009-1#62	0	3	3	P01009-1	684	687	+	3	P01009-1	0	1254	ENST00000393087.9	47	1301	++	62	P01009-1#62	0	3	ENST00000393087.9	731	734	+	3	0	0	3489
P01009-1#62	0	3	3	P01009-1	684	687	+	3	P01009-1	0	1254	ENST00000355814.8	277	1531	++	36	P01009-1#62	0	3	ENST00000355814.8	961	964	+	3	0	0	3490
P01009-1#63	0	3	3	P01009-1	816	819	+	3	P01009-1	0	1254	ENST00000636712.1	152	1406	++	236	P01009-1#63	0	3	ENST00000636712.1	968	971	+	3	0	0	3491
P01009-1#63	0	3	3	P01009-1	816	819	+	3	P01009-1	0	918	ENST00000489769.1	9	927	++	119	P01009-1#63	0	3	ENST00000489769.1	825	828	+	3	0	0	3492
P01009-1#63	0	3	3	P01009-1	816	819	+	3	P01009-1	0	1254	ENST00000449399.7	302	1556	++	100	P01009-1#63	0	3	ENST00000449399.7	1118	1121	+	3	0	0	3493
P01009-1#63	0	3	3	P01009-1	816	819	+	3	P01009-1	0	1254	ENST00000448921.5	573	1827	++	98	P01009-1#63	0	3	ENST00000448921.5	1389	1392	+	3	0	0	3494
P01009-1#63	0	3	3	P01009-1	816	819	+	3	P01009-1	0	1254	ENST00000440909.5	185	1439	++	91	P01009-1#63	0	3	ENST00000440909.5	1001	1004	+	3	0	0	3495
P01009-1#63	0	3	3	P01009-1	816	819	+	3	P01009-1	0	1254	ENST00000437397.5	381	1635	++	89	P01009-1#63	0	3	ENST00000437397.5	1197	1200	+	3	0	0	3496
P01009-1#63	0	3	3	P01009-1	816	819	+	3	P01009-1	0	1254	ENST00000404814.8	311	1565	++	68	P01009-1#63	0	3	ENST00000404814.8	1127	1130	+	3	0	0	3497
P01009-1#63	0	3	3	P01009-1	816	819	+	3	P01009-1	0	1065	ENST00000402629.1	34	1099	++	67	P01009-1#63	0	3	ENST00000402629.1	850	853	+	3	0	0	3498
P01009-1#63	0	3	3	P01009-1	816	819	+	3	P01009-1	0	1254	ENST00000393088.8	555	1809	++	63	P01009-1#63	0	3	ENST00000393088.8	1371	1374	+	3	0	0	3499
P01009-1#63	0	3	3	P01009-1	816	819	+	3	P01009-1	0	1254	ENST00000393087.9	47	1301	++	62	P01009-1#63	0	3	ENST00000393087.9	863	866	+	3	0	0	3500
P01009-1#63	0	3	3	P01009-1	816	819	+	3	P01009-1	0	1254	ENST00000355814.8	277	1531	++	36	P01009-1#63	0	3	ENST00000355814.8	1093	1096	+	3	0	0	3501
P01009-1#64	0	3	3	P01009-1	837	840	+	3	P01009-1	0	1254	ENST00000636712.1	152	1406	++	236	P01009-1#64	0	3	ENST00000636712.1	989	992	+	3	0	0	3502
P01009-1#64	0	3	3	P01009-1	837	840	+	3	P01009-1	0	918	ENST00000489769.1	9	927	++	119	P01009-1#64	0	3	ENST00000489769.1	846	849	+	3	0	0	3503
P01009-1#64	0	3	3	P01009-1	837	840	+	3	P01009-1	0	1254	ENST00000449399.7	302	1556	++	100	P01009-1#64	0	3	ENST00000449399.7	1139	1142	+	3	0	0	3504
P01009-1#64	0	3	3	P01009-1	837	840	+	3	P01009-1	0	1254	ENST00000448921.5	573	1827	++	98	P01009-1#64	0	3	ENST00000448921.5	1410	1413	+	3	0	0	3505
P01009-1#64	0	3	3	P01009-1	837	840	+	3	P01009-1	0	1254	ENST00000440909.5	185	1439	++	91	P01009-1#64	0	3	ENST00000440909.5	1022	1025	+	3	0	0	3506
P01009-1#64	0	3	3	P01009-1	837	840	+	3	P01009-1	0	1254	ENST00000437397.5	381	1635	++	89	P01009-1#64	0	3	ENST00000437397.5	1218	1221	+	3	0	0	3507
P01009-1#64	0	3	3	P01009-1	837	840	+	3	P01009-1	0	1254	ENST00000404814.8	311	1565	++	68	P01009-1#64	0	3	ENST00000404814.8	1148	1151	+	3	0	0	3508
P01009-1#64	0	3	3	P01009-1	837	840	+	3	P01009-1	0	1065	ENST00000402629.1	34	1099	++	67	P01009-1#64	0	3	ENST00000402629.1	871	874	+	3	0	0	3509
P01009-1#64	0	3	3	P01009-1	837	840	+	3	P01009-1	0	1254	ENST00000393088.8	555	1809	++	63	P01009-1#64	0	3	ENST00000393088.8	1392	1395	+	3	0	0	3510
P01009-1#64	0	3	3	P01009-1	837	840	+	3	P01009-1	0	1254	ENST00000393087.9	47	1301	++	62	P01009-1#64	0	3	ENST00000393087.9	884	887	+	3	0	0	3511
P01009-1#64	0	3	3	P01009-1	837	840	+	3	P01009-1	0	1254	ENST00000355814.8	277	1531	++	36	P01009-1#64	0	3	ENST00000355814.8	1114	1117	+	3	0	0	3512
P01009-1#65	0	3	3	P01009-1	975	978	+	3	P01009-1	0	1254	ENST00000636712.1	152	1406	++	236	P01009-1#65	0	3	ENST00000636712.1	1127	1130	+	3	0	0	3513
P01009-1#65	0	3	3	P01009-1	975	978	+	3	P01009-1	0	1254	ENST00000449399.7	302	1556	++	100	P01009-1#65	0	3	ENST00000449399.7	1277	1280	+	3	0	0	3514
P01009-1#65	0	3	3	P01009-1	975	978	+	3	P01009-1	0	1254	ENST00000448921.5	573	1827	++	98	P01009-1#65	0	3	ENST00000448921.5	1548	1551	+	3	0	0	3515
P01009-1#65	0	3	3	P01009-1	975	978	+	3	P01009-1	0	1254	ENST00000440909.5	185	1439	++	91	P01009-1#65	0	3	ENST00000440909.5	1160	1163	+	3	0	0	3516
P01009-1#65	0	3	3	P01009-1	975	978	+	3	P01009-1	0	1254	ENST00000437397.5	381	1635	++	89	P01009-1#65	0	3	ENST00000437397.5	1356	1359	+	3	0	0	3517
P01009-1#65	0	3	3	P01009-1	975	978	+	3	P01009-1	0	1254	ENST00000404814.8	311	1565	++	68	P01009-1#65	0	3	ENST00000404814.8	1286	1289	+	3	0	0	3518
P01009-1#65	0	3	3	P01009-1	975	978	+	3	P01009-1	0	1065	ENST00000402629.1	34	1099	++	67	P01009-1#65	0	3	ENST00000402629.1	1009	1012	+	3	0	0	3519
P01009-1#65	0	3	3	P01009-1	975	978	+	3	P01009-1	0	1254	ENST00000393088.8	555	1809	++	63	P01009-1#65	0	3	ENST00000393088.8	1530	1533	+	3	0	0	3520
P01009-1#65	0	3	3	P01009-1	975	978	+	3	P01009-1	0	1254	ENST00000393087.9	47	1301	++	62	P01009-1#65	0	3	ENST00000393087.9	1022	1025	+	3	0	0	3521
P01009-1#65	0	3	3	P01009-1	975	978	+	3	P01009-1	0	1254	ENST00000355814.8	277	1531	++	36	P01009-1#65	0	3	ENST00000355814.8	1252	1255	+	3	0	0	3522
P01009-1#66	0	3	3	P01009-1	1227	1230	+	3	P01009-1	0	1254	ENST00000636712.1	152	1406	++	236	P01009-1#66	0	3	ENST00000636712.1	1379	1382	+	3	0	0	3523
P01009-1#66	0	3	3	P01009-1	1227	1230	+	3	P01009-1	0	1254	ENST00000449399.7	302	1556	++	100	P01009-1#66	0	3	ENST00000449399.7	1529	1532	+	3	0	0	3524
P01009-1#66	0	3	3	P01009-1	1227	1230	+	3	P01009-1	0	1254	ENST00000448921.5	573	1827	++	98	P01009-1#66	0	3	ENST00000448921.5	1800	1803	+	3	0	0	3525
P01009-1#66	0	3	3	P01009-1	1227	1230	+	3	P01009-1	0	1254	ENST00000440909.5	185	1439	++	91	P01009-1#66	0	3	ENST00000440909.5	1412	1415	+	3	0	0	3526
P01009-1#66	0	3	3	P01009-1	1227	1230	+	3	P01009-1	0	1254	ENST00000437397.5	381	1635	++	89	P01009-1#66	0	3	ENST00000437397.5	1608	1611	+	3	0	0	3527
P01009-1#66	0	3	3	P01009-1	1227	1230	+	3	P01009-1	0	1254	ENST00000404814.8	311	1565	++	68	P01009-1#66	0	3	ENST00000404814.8	1538	1541	+	3	0	0	3528
P01009-1#66	0	3	3	P01009-1	1227	1230	+	3	P01009-1	0	1254	ENST00000393088.8	555	1809	++	63	P01009-1#66	0	3	ENST00000393088.8	1782	1785	+	3	0	0	3529
P01009-1#66	0	3	3	P01009-1	1227	1230	+	3	P01009-1	0	1254	ENST00000393087.9	47	1301	++	62	P01009-1#66	0	3	ENST00000393087.9	1274	1277	+	3	0	0	3530
P01009-1#66	0	3	3	P01009-1	1227	1230	+	3	P01009-1	0	1254	ENST00000355814.8	277	1531	++	36	P01009-1#66	0	3	ENST00000355814.8	1504	1507	+	3	0	0	3531
P01009-1#67	0	3	3	P01009-1	1239	1242	+	3	P01009-1	0	1254	ENST00000636712.1	152	1406	++	236	P01009-1#67	0	3	ENST00000636712.1	1391	1394	+	3	0	0	3532
P01009-1#67	0	3	3	P01009-1	1239	1242	+	3	P01009-1	0	1254	ENST00000449399.7	302	1556	++	100	P01009-1#67	0	3	ENST00000449399.7	1541	1544	+	3	0	0	3533
P01009-1#67	0	3	3	P01009-1	1239	1242	+	3	P01009-1	0	1254	ENST00000448921.5	573	1827	++	98	P01009-1#67	0	3	ENST00000448921.5	1812	1815	+	3	0	0	3534
P01009-1#67	0	3	3	P01009-1	1239	1242	+	3	P01009-1	0	1254	ENST00000440909.5	185	1439	++	91	P01009-1#67	0	3	ENST00000440909.5	1424	1427	+	3	0	0	3535
P01009-1#67	0	3	3	P01009-1	1239	1242	+	3	P01009-1	0	1254	ENST00000437397.5	381	1635	++	89	P01009-1#67	0	3	ENST00000437397.5	1620	1623	+	3	0	0	3536
P01009-1#67	0	3	3	P01009-1	1239	1242	+	3	P01009-1	0	1254	ENST00000404814.8	311	1565	++	68	P01009-1#67	0	3	ENST00000404814.8	1550	1553	+	3	0	0	3537
P01009-1#67	0	3	3	P01009-1	1239	1242	+	3	P01009-1	0	1254	ENST00000393088.8	555	1809	++	63	P01009-1#67	0	3	ENST00000393088.8	1794	1797	+	3	0	0	3538
P01009-1#67	0	3	3	P01009-1	1239	1242	+	3	P01009-1	0	1254	ENST00000393087.9	47	1301	++	62	P01009-1#67	0	3	ENST00000393087.9	1286	1289	+	3	0	0	3539
P01009-1#67	0	3	3	P01009-1	1239	1242	+	3	P01009-1	0	1254	ENST00000355814.8	277	1531	++	36	P01009-1#67	0	3	ENST00000355814.8	1516	1519	+	3	0	0	3540
P01009-1#68	0	9	9	P01009-1	141	150	+	9	P01009-1	0	1254	ENST00000636712.1	152	1406	++	236	P01009-1#68	0	9	ENST00000636712.1	293	302	+	9	0	0	3541
P01009-1#68	0	9	9	P01009-1	141	150	+	9	P01009-1	0	434	ENST00000557492.5	517	951	+	175	P01009-1#68	0	9	ENST00000557492.5	658	667	+	9	0	0	3542
P01009-1#68	0	9	9	P01009-1	141	150	+	9	P01009-1	0	351	ENST00000556955.5	220	571	+	173	P01009-1#68	0	9	ENST00000556955.5	361	370	+	9	0	0	3543
P01009-1#68	0	9	9	P01009-1	141	150	+	9	P01009-1	0	469	ENST00000556091.1	174	643	+	172	P01009-1#68	0	9	ENST00000556091.1	315	324	+	9	0	0	3544
P01009-1#68	0	9	9	P01009-1	141	150	+	9	P01009-1	0	278	ENST00000553327.5	303	581	+	170	P01009-1#68	0	9	ENST00000553327.5	444	453	+	9	0	0	3545
P01009-1#68	0	9	9	P01009-1	141	150	+	9	P01009-1	0	918	ENST00000489769.1	9	927	++	119	P01009-1#68	0	9	ENST00000489769.1	150	159	+	9	0	0	3546
P01009-1#68	0	9	9	P01009-1	141	150	+	9	P01009-1	0	1254	ENST00000449399.7	302	1556	++	100	P01009-1#68	0	9	ENST00000449399.7	443	452	+	9	0	0	3547
P01009-1#68	0	9	9	P01009-1	141	150	+	9	P01009-1	0	1254	ENST00000448921.5	573	1827	++	98	P01009-1#68	0	9	ENST00000448921.5	714	723	+	9	0	0	3548
P01009-1#68	0	9	9	P01009-1	141	150	+	9	P01009-1	0	1254	ENST00000440909.5	185	1439	++	91	P01009-1#68	0	9	ENST00000440909.5	326	335	+	9	0	0	3549
P01009-1#68	0	9	9	P01009-1	141	150	+	9	P01009-1	0	1254	ENST00000437397.5	381	1635	++	89	P01009-1#68	0	9	ENST00000437397.5	522	531	+	9	0	0	3550
P01009-1#68	0	9	9	P01009-1	141	150	+	9	P01009-1	0	1254	ENST00000404814.8	311	1565	++	68	P01009-1#68	0	9	ENST00000404814.8	452	461	+	9	0	0	3551
P01009-1#68	0	9	9	P01009-1	141	150	+	9	P01009-1	0	1065	ENST00000402629.1	34	1099	++	67	P01009-1#68	0	9	ENST00000402629.1	175	184	+	9	0	0	3552
P01009-1#68	0	9	9	P01009-1	141	150	+	9	P01009-1	0	1254	ENST00000393088.8	555	1809	++	63	P01009-1#68	0	9	ENST00000393088.8	696	705	+	9	0	0	3553
P01009-1#68	0	9	9	P01009-1	141	150	+	9	P01009-1	0	1254	ENST00000393087.9	47	1301	++	62	P01009-1#68	0	9	ENST00000393087.9	188	197	+	9	0	0	3554
P01009-1#68	0	9	9	P01009-1	141	150	+	9	P01009-1	0	1254	ENST00000355814.8	277	1531	++	36	P01009-1#68	0	9	ENST00000355814.8	418	427	+	9	0	0	3555
P01009-1#69	0	54	54	P01009-1	150	204	+	54	P01009-1	0	1254	ENST00000636712.1	152	1406	++	236	P01009-1#69	0	54	ENST00000636712.1	302	356	+	54	0	0	3556
P01009-1#69	0	54	54	P01009-1	150	204	+	54	P01009-1	0	434	ENST00000557492.5	517	951	+	175	P01009-1#69	0	54	ENST00000557492.5	667	721	+	54	0	0	3557
P01009-1#69	0	54	54	P01009-1	150	204	+	54	P01009-1	0	351	ENST00000556955.5	220	571	+	173	P01009-1#69	0	54	ENST00000556955.5	370	424	+	54	0	0	3558
P01009-1#69	0	54	54	P01009-1	150	204	+	54	P01009-1	0	469	ENST00000556091.1	174	643	+	172	P01009-1#69	0	54	ENST00000556091.1	324	378	+	54	0	0	3559
P01009-1#69	0	54	54	P01009-1	150	204	+	54	P01009-1	0	278	ENST00000553327.5	303	581	+	170	P01009-1#69	0	54	ENST00000553327.5	453	507	+	54	0	0	3560
P01009-1#69	0	54	54	P01009-1	150	204	+	54	P01009-1	0	918	ENST00000489769.1	9	927	++	119	P01009-1#69	0	54	ENST00000489769.1	159	213	+	54	0	0	3561
P01009-1#69	0	54	54	P01009-1	150	204	+	54	P01009-1	0	1254	ENST00000449399.7	302	1556	++	100	P01009-1#69	0	54	ENST00000449399.7	452	506	+	54	0	0	3562
P01009-1#69	0	54	54	P01009-1	150	204	+	54	P01009-1	0	1254	ENST00000448921.5	573	1827	++	98	P01009-1#69	0	54	ENST00000448921.5	723	777	+	54	0	0	3563
P01009-1#69	0	54	54	P01009-1	150	204	+	54	P01009-1	0	1254	ENST00000440909.5	185	1439	++	91	P01009-1#69	0	54	ENST00000440909.5	335	389	+	54	0	0	3564
P01009-1#69	0	54	54	P01009-1	150	204	+	54	P01009-1	0	1254	ENST00000437397.5	381	1635	++	89	P01009-1#69	0	54	ENST00000437397.5	531	585	+	54	0	0	3565
P01009-1#69	0	54	54	P01009-1	150	204	+	54	P01009-1	0	1254	ENST00000404814.8	311	1565	++	68	P01009-1#69	0	54	ENST00000404814.8	461	515	+	54	0	0	3566
P01009-1#69	0	54	54	P01009-1	150	204	+	54	P01009-1	0	1065	ENST00000402629.1	34	1099	++	67	P01009-1#69	0	54	ENST00000402629.1	184	238	+	54	0	0	3567
P01009-1#69	0	54	54	P01009-1	150	204	+	54	P01009-1	0	1254	ENST00000393088.8	555	1809	++	63	P01009-1#69	0	54	ENST00000393088.8	705	759	+	54	0	0	3568
P01009-1#69	0	54	54	P01009-1	150	204	+	54	P01009-1	0	1254	ENST00000393087.9	47	1301	++	62	P01009-1#69	0	54	ENST00000393087.9	197	251	+	54	0	0	3569
P01009-1#69	0	54	54	P01009-1	150	204	+	54	P01009-1	0	1254	ENST00000355814.8	277	1531	++	36	P01009-1#69	0	54	ENST00000355814.8	427	481	+	54	0	0	3570
P01009-1#70	0	9	9	P01009-1	207	216	+	9	P01009-1	0	1254	ENST00000636712.1	152	1406	++	236	P01009-1#70	0	9	ENST00000636712.1	359	368	+	9	0	0	3571
P01009-1#70	0	9	9	P01009-1	207	216	+	9	P01009-1	0	434	ENST00000557492.5	517	951	+	175	P01009-1#70	0	9	ENST00000557492.5	724	733	+	9	0	0	3572
P01009-1#70	0	9	9	P01009-1	207	216	+	9	P01009-1	0	351	ENST00000556955.5	220	571	+	173	P01009-1#70	0	9	ENST00000556955.5	427	436	+	9	0	0	3573
P01009-1#70	0	9	9	P01009-1	207	216	+	9	P01009-1	0	469	ENST00000556091.1	174	643	+	172	P01009-1#70	0	9	ENST00000556091.1	381	390	+	9	0	0	3574
P01009-1#70	0	9	9	P01009-1	207	216	+	9	P01009-1	0	278	ENST00000553327.5	303	581	+	170	P01009-1#70	0	9	ENST00000553327.5	510	519	+	9	0	0	3575
P01009-1#70	0	9	9	P01009-1	207	216	+	9	P01009-1	0	918	ENST00000489769.1	9	927	++	119	P01009-1#70	0	9	ENST00000489769.1	216	225	+	9	0	0	3576
P01009-1#70	0	9	9	P01009-1	207	216	+	9	P01009-1	0	1254	ENST00000449399.7	302	1556	++	100	P01009-1#70	0	9	ENST00000449399.7	509	518	+	9	0	0	3577
P01009-1#70	0	9	9	P01009-1	207	216	+	9	P01009-1	0	1254	ENST00000448921.5	573	1827	++	98	P01009-1#70	0	9	ENST00000448921.5	780	789	+	9	0	0	3578
P01009-1#70	0	9	9	P01009-1	207	216	+	9	P01009-1	0	1254	ENST00000440909.5	185	1439	++	91	P01009-1#70	0	9	ENST00000440909.5	392	401	+	9	0	0	3579
P01009-1#70	0	9	9	P01009-1	207	216	+	9	P01009-1	0	1254	ENST00000437397.5	381	1635	++	89	P01009-1#70	0	9	ENST00000437397.5	588	597	+	9	0	0	3580
P01009-1#70	0	9	9	P01009-1	207	216	+	9	P01009-1	0	1254	ENST00000404814.8	311	1565	++	68	P01009-1#70	0	9	ENST00000404814.8	518	527	+	9	0	0	3581
P01009-1#70	0	9	9	P01009-1	207	216	+	9	P01009-1	0	1065	ENST00000402629.1	34	1099	++	67	P01009-1#70	0	9	ENST00000402629.1	241	250	+	9	0	0	3582
P01009-1#70	0	9	9	P01009-1	207	216	+	9	P01009-1	0	1254	ENST00000393088.8	555	1809	++	63	P01009-1#70	0	9	ENST00000393088.8	762	771	+	9	0	0	3583
P01009-1#70	0	9	9	P01009-1	207	216	+	9	P01009-1	0	1254	ENST00000393087.9	47	1301	++	62	P01009-1#70	0	9	ENST00000393087.9	254	263	+	9	0	0	3584
P01009-1#70	0	9	9	P01009-1	207	216	+	9	P01009-1	0	1254	ENST00000355814.8	277	1531	++	36	P01009-1#70	0	9	ENST00000355814.8	484	493	+	9	0	0	3585
P01009-1#71	0	9	9	P01009-1	219	228	+	9	P01009-1	0	1254	ENST00000636712.1	152	1406	++	236	P01009-1#71	0	9	ENST00000636712.1	371	380	+	9	0	0	3586
P01009-1#71	0	9	9	P01009-1	219	228	+	9	P01009-1	0	434	ENST00000557492.5	517	951	+	175	P01009-1#71	0	9	ENST00000557492.5	736	745	+	9	0	0	3587
P01009-1#71	0	9	9	P01009-1	219	228	+	9	P01009-1	0	351	ENST00000556955.5	220	571	+	173	P01009-1#71	0	9	ENST00000556955.5	439	448	+	9	0	0	3588
P01009-1#71	0	9	9	P01009-1	219	228	+	9	P01009-1	0	469	ENST00000556091.1	174	643	+	172	P01009-1#71	0	9	ENST00000556091.1	393	402	+	9	0	0	3589
P01009-1#71	0	9	9	P01009-1	219	228	+	9	P01009-1	0	278	ENST00000553327.5	303	581	+	170	P01009-1#71	0	9	ENST00000553327.5	522	531	+	9	0	0	3590
P01009-1#71	0	9	9	P01009-1	219	228	+	9	P01009-1	0	918	ENST00000489769.1	9	927	++	119	P01009-1#71	0	9	ENST00000489769.1	228	237	+	9	0	0	3591
P01009-1#71	0	9	9	P01009-1	219	228	+	9	P01009-1	0	1254	ENST00000449399.7	302	1556	++	100	P01009-1#71	0	9	ENST00000449399.7	521	530	+	9	0	0	3592
P01009-1#71	0	9	9	P01009-1	219	228	+	9	P01009-1	0	1254	ENST00000448921.5	573	1827	++	98	P01009-1#71	0	9	ENST00000448921.5	792	801	+	9	0	0	3593
P01009-1#71	0	9	9	P01009-1	219	228	+	9	P01009-1	0	1254	ENST00000440909.5	185	1439	++	91	P01009-1#71	0	9	ENST00000440909.5	404	413	+	9	0	0	3594
P01009-1#71	0	9	9	P01009-1	219	228	+	9	P01009-1	0	1254	ENST00000437397.5	381	1635	++	89	P01009-1#71	0	9	ENST00000437397.5	600	609	+	9	0	0	3595
P01009-1#71	0	9	9	P01009-1	219	228	+	9	P01009-1	0	1254	ENST00000404814.8	311	1565	++	68	P01009-1#71	0	9	ENST00000404814.8	530	539	+	9	0	0	3596
P01009-1#71	0	9	9	P01009-1	219	228	+	9	P01009-1	0	1065	ENST00000402629.1	34	1099	++	67	P01009-1#71	0	9	ENST00000402629.1	253	262	+	9	0	0	3597
P01009-1#71	0	9	9	P01009-1	219	228	+	9	P01009-1	0	1254	ENST00000393088.8	555	1809	++	63	P01009-1#71	0	9	ENST00000393088.8	774	783	+	9	0	0	3598
P01009-1#71	0	9	9	P01009-1	219	228	+	9	P01009-1	0	1254	ENST00000393087.9	47	1301	++	62	P01009-1#71	0	9	ENST00000393087.9	266	275	+	9	0	0	3599
P01009-1#71	0	9	9	P01009-1	219	228	+	9	P01009-1	0	1254	ENST00000355814.8	277	1531	++	36	P01009-1#71	0	9	ENST00000355814.8	496	505	+	9	0	0	3600
P01009-1#72	0	36	36	P01009-1	231	267	+	36	P01009-1	0	1254	ENST00000636712.1	152	1406	++	236	P01009-1#72	0	36	ENST00000636712.1	383	419	+	36	0	0	3601
P01009-1#72	0	36	36	P01009-1	231	267	+	36	P01009-1	0	434	ENST00000557492.5	517	951	+	175	P01009-1#72	0	36	ENST00000557492.5	748	784	+	36	0	0	3602
P01009-1#72	0	36	36	P01009-1	231	267	+	36	P01009-1	0	351	ENST00000556955.5	220	571	+	173	P01009-1#72	0	36	ENST00000556955.5	451	487	+	36	0	0	3603
P01009-1#72	0	36	36	P01009-1	231	267	+	36	P01009-1	0	469	ENST00000556091.1	174	643	+	172	P01009-1#72	0	36	ENST00000556091.1	405	441	+	36	0	0	3604
P01009-1#72	0	36	36	P01009-1	231	267	+	36	P01009-1	258	575	ENST00000554720.1	129	446	+	171	P01009-1#72	27	36	ENST00000554720.1	129	138	+	9	27	0	3605
P01009-1#72	0	36	36	P01009-1	231	267	+	36	P01009-1	0	278	ENST00000553327.5	303	581	+	170	P01009-1#72	0	36	ENST00000553327.5	534	570	+	36	0	0	3606
P01009-1#72	0	36	36	P01009-1	231	267	+	36	P01009-1	0	918	ENST00000489769.1	9	927	++	119	P01009-1#72	0	36	ENST00000489769.1	240	276	+	36	0	0	3607
P01009-1#72	0	36	36	P01009-1	231	267	+	36	P01009-1	0	1254	ENST00000449399.7	302	1556	++	100	P01009-1#72	0	36	ENST00000449399.7	533	569	+	36	0	0	3608
P01009-1#72	0	36	36	P01009-1	231	267	+	36	P01009-1	0	1254	ENST00000448921.5	573	1827	++	98	P01009-1#72	0	36	ENST00000448921.5	804	840	+	36	0	0	3609
P01009-1#72	0	36	36	P01009-1	231	267	+	36	P01009-1	0	1254	ENST00000440909.5	185	1439	++	91	P01009-1#72	0	36	ENST00000440909.5	416	452	+	36	0	0	3610
P01009-1#72	0	36	36	P01009-1	231	267	+	36	P01009-1	0	1254	ENST00000437397.5	381	1635	++	89	P01009-1#72	0	36	ENST00000437397.5	612	648	+	36	0	0	3611
P01009-1#72	0	36	36	P01009-1	231	267	+	36	P01009-1	0	1254	ENST00000404814.8	311	1565	++	68	P01009-1#72	0	36	ENST00000404814.8	542	578	+	36	0	0	3612
P01009-1#72	0	36	36	P01009-1	231	267	+	36	P01009-1	0	1065	ENST00000402629.1	34	1099	++	67	P01009-1#72	0	36	ENST00000402629.1	265	301	+	36	0	0	3613
P01009-1#72	0	36	36	P01009-1	231	267	+	36	P01009-1	0	1254	ENST00000393088.8	555	1809	++	63	P01009-1#72	0	36	ENST00000393088.8	786	822	+	36	0	0	3614
P01009-1#72	0	36	36	P01009-1	231	267	+	36	P01009-1	0	1254	ENST00000393087.9	47	1301	++	62	P01009-1#72	0	36	ENST00000393087.9	278	314	+	36	0	0	3615
P01009-1#72	0	36	36	P01009-1	231	267	+	36	P01009-1	0	1254	ENST00000355814.8	277	1531	++	36	P01009-1#72	0	36	ENST00000355814.8	508	544	+	36	0	0	3616
P01009-1#73	0	30	30	P01009-1	279	309	+	30	P01009-1	0	1254	ENST00000636712.1	152	1406	++	236	P01009-1#73	0	30	ENST00000636712.1	431	461	+	30	0	0	3617
P01009-1#73	0	30	30	P01009-1	279	309	+	30	P01009-1	0	434	ENST00000557492.5	517	951	+	175	P01009-1#73	0	30	ENST00000557492.5	796	826	+	30	0	0	3618
P01009-1#73	0	30	30	P01009-1	279	309	+	30	P01009-1	0	351	ENST00000556955.5	220	571	+	173	P01009-1#73	0	30	ENST00000556955.5	499	529	+	30	0	0	3619
P01009-1#73	0	30	30	P01009-1	279	309	+	30	P01009-1	0	469	ENST00000556091.1	174	643	+	172	P01009-1#73	0	30	ENST00000556091.1	453	483	+	30	0	0	3620
P01009-1#73	0	30	30	P01009-1	279	309	+	30	P01009-1	258	575	ENST00000554720.1	129	446	+	171	P01009-1#73	0	30	ENST00000554720.1	150	180	+	30	0	0	3621
P01009-1#73	0	30	30	P01009-1	279	309	+	30	P01009-1	0	918	ENST00000489769.1	9	927	++	119	P01009-1#73	0	30	ENST00000489769.1	288	318	+	30	0	0	3622
P01009-1#73	0	30	30	P01009-1	279	309	+	30	P01009-1	0	1254	ENST00000449399.7	302	1556	++	100	P01009-1#73	0	30	ENST00000449399.7	581	611	+	30	0	0	3623
P01009-1#73	0	30	30	P01009-1	279	309	+	30	P01009-1	0	1254	ENST00000448921.5	573	1827	++	98	P01009-1#73	0	30	ENST00000448921.5	852	882	+	30	0	0	3624
P01009-1#73	0	30	30	P01009-1	279	309	+	30	P01009-1	0	1254	ENST00000440909.5	185	1439	++	91	P01009-1#73	0	30	ENST00000440909.5	464	494	+	30	0	0	3625
P01009-1#73	0	30	30	P01009-1	279	309	+	30	P01009-1	0	1254	ENST00000437397.5	381	1635	++	89	P01009-1#73	0	30	ENST00000437397.5	660	690	+	30	0	0	3626
P01009-1#73	0	30	30	P01009-1	279	309	+	30	P01009-1	0	1254	ENST00000404814.8	311	1565	++	68	P01009-1#73	0	30	ENST00000404814.8	590	620	+	30	0	0	3627
P01009-1#73	0	30	30	P01009-1	279	309	+	30	P01009-1	0	1065	ENST00000402629.1	34	1099	++	67	P01009-1#73	0	30	ENST00000402629.1	313	343	+	30	0	0	3628
P01009-1#73	0	30	30	P01009-1	279	309	+	30	P01009-1	0	1254	ENST00000393088.8	555	1809	++	63	P01009-1#73	0	30	ENST00000393088.8	834	864	+	30	0	0	3629
P01009-1#73	0	30	30	P01009-1	279	309	+	30	P01009-1	0	1254	ENST00000393087.9	47	1301	++	62	P01009-1#73	0	30	ENST00000393087.9	326	356	+	30	0	0	3630
P01009-1#73	0	30	30	P01009-1	279	309	+	30	P01009-1	0	1254	ENST00000355814.8	277	1531	++	36	P01009-1#73	0	30	ENST00000355814.8	556	586	+	30	0	0	3631
P01009-1#74	0	9	9	P01009-1	321	330	+	9	P01009-1	0	1254	ENST00000636712.1	152	1406	++	236	P01009-1#74	0	9	ENST00000636712.1	473	482	+	9	0	0	3632
P01009-1#74	0	9	9	P01009-1	321	330	+	9	P01009-1	0	434	ENST00000557492.5	517	951	+	175	P01009-1#74	0	9	ENST00000557492.5	838	847	+	9	0	0	3633
P01009-1#74	0	9	9	P01009-1	321	330	+	9	P01009-1	0	351	ENST00000556955.5	220	571	+	173	P01009-1#74	0	9	ENST00000556955.5	541	550	+	9	0	0	3634
P01009-1#74	0	9	9	P01009-1	321	330	+	9	P01009-1	0	469	ENST00000556091.1	174	643	+	172	P01009-1#74	0	9	ENST00000556091.1	495	504	+	9	0	0	3635
P01009-1#74	0	9	9	P01009-1	321	330	+	9	P01009-1	258	575	ENST00000554720.1	129	446	+	171	P01009-1#74	0	9	ENST00000554720.1	192	201	+	9	0	0	3636
P01009-1#74	0	9	9	P01009-1	321	330	+	9	P01009-1	0	918	ENST00000489769.1	9	927	++	119	P01009-1#74	0	9	ENST00000489769.1	330	339	+	9	0	0	3637
P01009-1#74	0	9	9	P01009-1	321	330	+	9	P01009-1	0	1254	ENST00000449399.7	302	1556	++	100	P01009-1#74	0	9	ENST00000449399.7	623	632	+	9	0	0	3638
P01009-1#74	0	9	9	P01009-1	321	330	+	9	P01009-1	0	1254	ENST00000448921.5	573	1827	++	98	P01009-1#74	0	9	ENST00000448921.5	894	903	+	9	0	0	3639
P01009-1#74	0	9	9	P01009-1	321	330	+	9	P01009-1	0	1254	ENST00000440909.5	185	1439	++	91	P01009-1#74	0	9	ENST00000440909.5	506	515	+	9	0	0	3640
P01009-1#74	0	9	9	P01009-1	321	330	+	9	P01009-1	0	1254	ENST00000437397.5	381	1635	++	89	P01009-1#74	0	9	ENST00000437397.5	702	711	+	9	0	0	3641
P01009-1#74	0	9	9	P01009-1	321	330	+	9	P01009-1	0	1254	ENST00000404814.8	311	1565	++	68	P01009-1#74	0	9	ENST00000404814.8	632	641	+	9	0	0	3642
P01009-1#74	0	9	9	P01009-1	321	330	+	9	P01009-1	0	1065	ENST00000402629.1	34	1099	++	67	P01009-1#74	0	9	ENST00000402629.1	355	364	+	9	0	0	3643
P01009-1#74	0	9	9	P01009-1	321	330	+	9	P01009-1	0	1254	ENST00000393088.8	555	1809	++	63	P01009-1#74	0	9	ENST00000393088.8	876	885	+	9	0	0	3644
P01009-1#74	0	9	9	P01009-1	321	330	+	9	P01009-1	0	1254	ENST00000393087.9	47	1301	++	62	P01009-1#74	0	9	ENST00000393087.9	368	377	+	9	0	0	3645
P01009-1#74	0	9	9	P01009-1	321	330	+	9	P01009-1	0	1254	ENST00000355814.8	277	1531	++	36	P01009-1#74	0	9	ENST00000355814.8	598	607	+	9	0	0	3646
P01009-1#75	0	45	45	P01009-1	336	381	+	45	P01009-1	0	1254	ENST00000636712.1	152	1406	++	236	P01009-1#75	0	45	ENST00000636712.1	488	533	+	45	0	0	3647
P01009-1#75	0	45	45	P01009-1	336	381	+	45	P01009-1	0	434	ENST00000557492.5	517	951	+	175	P01009-1#75	0	45	ENST00000557492.5	853	898	+	45	0	0	3648
P01009-1#75	0	45	45	P01009-1	336	381	+	45	P01009-1	0	351	ENST00000556955.5	220	571	+	173	P01009-1#75	0	15	ENST00000556955.5	556	571	+	15	0	30	3649
P01009-1#75	0	45	45	P01009-1	336	381	+	45	P01009-1	0	469	ENST00000556091.1	174	643	+	172	P01009-1#75	0	45	ENST00000556091.1	510	555	+	45	0	0	3650
P01009-1#75	0	45	45	P01009-1	336	381	+	45	P01009-1	258	575	ENST00000554720.1	129	446	+	171	P01009-1#75	0	45	ENST00000554720.1	207	252	+	45	0	0	3651
P01009-1#75	0	45	45	P01009-1	336	381	+	45	P01009-1	0	918	ENST00000489769.1	9	927	++	119	P01009-1#75	0	45	ENST00000489769.1	345	390	+	45	0	0	3652
P01009-1#75	0	45	45	P01009-1	336	381	+	45	P01009-1	0	1254	ENST00000449399.7	302	1556	++	100	P01009-1#75	0	45	ENST00000449399.7	638	683	+	45	0	0	3653
P01009-1#75	0	45	45	P01009-1	336	381	+	45	P01009-1	0	1254	ENST00000448921.5	573	1827	++	98	P01009-1#75	0	45	ENST00000448921.5	909	954	+	45	0	0	3654
P01009-1#75	0	45	45	P01009-1	336	381	+	45	P01009-1	0	1254	ENST00000440909.5	185	1439	++	91	P01009-1#75	0	45	ENST00000440909.5	521	566	+	45	0	0	3655
P01009-1#75	0	45	45	P01009-1	336	381	+	45	P01009-1	0	1254	ENST00000437397.5	381	1635	++	89	P01009-1#75	0	45	ENST00000437397.5	717	762	+	45	0	0	3656
P01009-1#75	0	45	45	P01009-1	336	381	+	45	P01009-1	0	1254	ENST00000404814.8	311	1565	++	68	P01009-1#75	0	45	ENST00000404814.8	647	692	+	45	0	0	3657
P01009-1#75	0	45	45	P01009-1	336	381	+	45	P01009-1	0	1065	ENST00000402629.1	34	1099	++	67	P01009-1#75	0	45	ENST00000402629.1	370	415	+	45	0	0	3658
P01009-1#75	0	45	45	P01009-1	336	381	+	45	P01009-1	0	1254	ENST00000393088.8	555	1809	++	63	P01009-1#75	0	45	ENST00000393088.8	891	936	+	45	0	0	3659
P01009-1#75	0	45	45	P01009-1	336	381	+	45	P01009-1	0	1254	ENST00000393087.9	47	1301	++	62	P01009-1#75	0	45	ENST00000393087.9	383	428	+	45	0	0	3660
P01009-1#75	0	45	45	P01009-1	336	381	+	45	P01009-1	0	1254	ENST00000355814.8	277	1531	++	36	P01009-1#75	0	45	ENST00000355814.8	613	658	+	45	0	0	3661
P01009-1#76	0	12	12	P01009-1	387	399	+	12	P01009-1	0	1254	ENST00000636712.1	152	1406	++	236	P01009-1#76	0	12	ENST00000636712.1	539	551	+	12	0	0	3662
P01009-1#76	0	12	12	P01009-1	387	399	+	12	P01009-1	0	434	ENST00000557492.5	517	951	+	175	P01009-1#76	0	12	ENST00000557492.5	904	916	+	12	0	0	3663
P01009-1#76	0	12	12	P01009-1	387	399	+	12	P01009-1	0	469	ENST00000556091.1	174	643	+	172	P01009-1#76	0	12	ENST00000556091.1	561	573	+	12	0	0	3664
P01009-1#76	0	12	12	P01009-1	387	399	+	12	P01009-1	258	575	ENST00000554720.1	129	446	+	171	P01009-1#76	0	12	ENST00000554720.1	258	270	+	12	0	0	3665
P01009-1#76	0	12	12	P01009-1	387	399	+	12	P01009-1	0	918	ENST00000489769.1	9	927	++	119	P01009-1#76	0	12	ENST00000489769.1	396	408	+	12	0	0	3666
P01009-1#76	0	12	12	P01009-1	387	399	+	12	P01009-1	0	1254	ENST00000449399.7	302	1556	++	100	P01009-1#76	0	12	ENST00000449399.7	689	701	+	12	0	0	3667
P01009-1#76	0	12	12	P01009-1	387	399	+	12	P01009-1	0	1254	ENST00000448921.5	573	1827	++	98	P01009-1#76	0	12	ENST00000448921.5	960	972	+	12	0	0	3668
P01009-1#76	0	12	12	P01009-1	387	399	+	12	P01009-1	0	1254	ENST00000440909.5	185	1439	++	91	P01009-1#76	0	12	ENST00000440909.5	572	584	+	12	0	0	3669
P01009-1#76	0	12	12	P01009-1	387	399	+	12	P01009-1	0	1254	ENST00000437397.5	381	1635	++	89	P01009-1#76	0	12	ENST00000437397.5	768	780	+	12	0	0	3670
P01009-1#76	0	12	12	P01009-1	387	399	+	12	P01009-1	0	1254	ENST00000404814.8	311	1565	++	68	P01009-1#76	0	12	ENST00000404814.8	698	710	+	12	0	0	3671
P01009-1#76	0	12	12	P01009-1	387	399	+	12	P01009-1	0	1065	ENST00000402629.1	34	1099	++	67	P01009-1#76	0	12	ENST00000402629.1	421	433	+	12	0	0	3672
P01009-1#76	0	12	12	P01009-1	387	399	+	12	P01009-1	0	1254	ENST00000393088.8	555	1809	++	63	P01009-1#76	0	12	ENST00000393088.8	942	954	+	12	0	0	3673
P01009-1#76	0	12	12	P01009-1	387	399	+	12	P01009-1	0	1254	ENST00000393087.9	47	1301	++	62	P01009-1#76	0	12	ENST00000393087.9	434	446	+	12	0	0	3674
P01009-1#76	0	12	12	P01009-1	387	399	+	12	P01009-1	0	1254	ENST00000355814.8	277	1531	++	36	P01009-1#76	0	12	ENST00000355814.8	664	676	+	12	0	0	3675
P01009-1#77	0	33	33	P01009-1	402	435	+	33	P01009-1	0	1254	ENST00000636712.1	152	1406	++	236	P01009-1#77	0	33	ENST00000636712.1	554	587	+	33	0	0	3676
P01009-1#77	0	33	33	P01009-1	402	435	+	33	P01009-1	0	434	ENST00000557492.5	517	951	+	175	P01009-1#77	0	32	ENST00000557492.5	919	951	+	32	0	1	3677
P01009-1#77	0	33	33	P01009-1	402	435	+	33	P01009-1	0	469	ENST00000556091.1	174	643	+	172	P01009-1#77	0	33	ENST00000556091.1	576	609	+	33	0	0	3678
P01009-1#77	0	33	33	P01009-1	402	435	+	33	P01009-1	258	575	ENST00000554720.1	129	446	+	171	P01009-1#77	0	33	ENST00000554720.1	273	306	+	33	0	0	3679
P01009-1#77	0	33	33	P01009-1	402	435	+	33	P01009-1	0	918	ENST00000489769.1	9	927	++	119	P01009-1#77	0	33	ENST00000489769.1	411	444	+	33	0	0	3680
P01009-1#77	0	33	33	P01009-1	402	435	+	33	P01009-1	0	1254	ENST00000449399.7	302	1556	++	100	P01009-1#77	0	33	ENST00000449399.7	704	737	+	33	0	0	3681
P01009-1#77	0	33	33	P01009-1	402	435	+	33	P01009-1	0	1254	ENST00000448921.5	573	1827	++	98	P01009-1#77	0	33	ENST00000448921.5	975	1008	+	33	0	0	3682
P01009-1#77	0	33	33	P01009-1	402	435	+	33	P01009-1	0	1254	ENST00000440909.5	185	1439	++	91	P01009-1#77	0	33	ENST00000440909.5	587	620	+	33	0	0	3683
P01009-1#77	0	33	33	P01009-1	402	435	+	33	P01009-1	0	1254	ENST00000437397.5	381	1635	++	89	P01009-1#77	0	33	ENST00000437397.5	783	816	+	33	0	0	3684
P01009-1#77	0	33	33	P01009-1	402	435	+	33	P01009-1	0	1254	ENST00000404814.8	311	1565	++	68	P01009-1#77	0	33	ENST00000404814.8	713	746	+	33	0	0	3685
P01009-1#77	0	33	33	P01009-1	402	435	+	33	P01009-1	0	1065	ENST00000402629.1	34	1099	++	67	P01009-1#77	0	33	ENST00000402629.1	436	469	+	33	0	0	3686
P01009-1#77	0	33	33	P01009-1	402	435	+	33	P01009-1	0	1254	ENST00000393088.8	555	1809	++	63	P01009-1#77	0	33	ENST00000393088.8	957	990	+	33	0	0	3687
P01009-1#77	0	33	33	P01009-1	402	435	+	33	P01009-1	0	1254	ENST00000393087.9	47	1301	++	62	P01009-1#77	0	33	ENST00000393087.9	449	482	+	33	0	0	3688
P01009-1#77	0	33	33	P01009-1	402	435	+	33	P01009-1	0	1254	ENST00000355814.8	277	1531	++	36	P01009-1#77	0	33	ENST00000355814.8	679	712	+	33	0	0	3689
P01009-1#78	0	9	9	P01009-1	435	444	+	9	P01009-1	0	1254	ENST00000636712.1	152	1406	++	236	P01009-1#78	0	9	ENST00000636712.1	587	596	+	9	0	0	3690
P01009-1#78	0	9	9	P01009-1	435	444	+	9	P01009-1	0	469	ENST00000556091.1	174	643	+	172	P01009-1#78	0	9	ENST00000556091.1	609	618	+	9	0	0	3691
P01009-1#78	0	9	9	P01009-1	435	444	+	9	P01009-1	258	575	ENST00000554720.1	129	446	+	171	P01009-1#78	0	9	ENST00000554720.1	306	315	+	9	0	0	3692
P01009-1#78	0	9	9	P01009-1	435	444	+	9	P01009-1	0	918	ENST00000489769.1	9	927	++	119	P01009-1#78	0	9	ENST00000489769.1	444	453	+	9	0	0	3693
P01009-1#78	0	9	9	P01009-1	435	444	+	9	P01009-1	0	1254	ENST00000449399.7	302	1556	++	100	P01009-1#78	0	9	ENST00000449399.7	737	746	+	9	0	0	3694
P01009-1#78	0	9	9	P01009-1	435	444	+	9	P01009-1	0	1254	ENST00000448921.5	573	1827	++	98	P01009-1#78	0	9	ENST00000448921.5	1008	1017	+	9	0	0	3695
P01009-1#78	0	9	9	P01009-1	435	444	+	9	P01009-1	0	1254	ENST00000440909.5	185	1439	++	91	P01009-1#78	0	9	ENST00000440909.5	620	629	+	9	0	0	3696
P01009-1#78	0	9	9	P01009-1	435	444	+	9	P01009-1	0	1254	ENST00000437397.5	381	1635	++	89	P01009-1#78	0	9	ENST00000437397.5	816	825	+	9	0	0	3697
P01009-1#78	0	9	9	P01009-1	435	444	+	9	P01009-1	0	1254	ENST00000404814.8	311	1565	++	68	P01009-1#78	0	9	ENST00000404814.8	746	755	+	9	0	0	3698
P01009-1#78	0	9	9	P01009-1	435	444	+	9	P01009-1	0	1065	ENST00000402629.1	34	1099	++	67	P01009-1#78	0	9	ENST00000402629.1	469	478	+	9	0	0	3699
P01009-1#78	0	9	9	P01009-1	435	444	+	9	P01009-1	0	1254	ENST00000393088.8	555	1809	++	63	P01009-1#78	0	9	ENST00000393088.8	990	999	+	9	0	0	3700
P01009-1#78	0	9	9	P01009-1	435	444	+	9	P01009-1	0	1254	ENST00000393087.9	47	1301	++	62	P01009-1#78	0	9	ENST00000393087.9	482	491	+	9	0	0	3701
P01009-1#78	0	9	9	P01009-1	435	444	+	9	P01009-1	0	1254	ENST00000355814.8	277	1531	++	36	P01009-1#78	0	9	ENST00000355814.8	712	721	+	9	0	0	3702
P01009-1#79	0	33	33	P01009-1	453	486	+	33	P01009-1	0	1254	ENST00000636712.1	152	1406	++	236	P01009-1#79	0	33	ENST00000636712.1	605	638	+	33	0	0	3703
P01009-1#79	0	33	33	P01009-1	453	486	+	33	P01009-1	0	469	ENST00000556091.1	174	643	+	172	P01009-1#79	0	16	ENST00000556091.1	627	643	+	16	0	17	3704
P01009-1#79	0	33	33	P01009-1	453	486	+	33	P01009-1	258	575	ENST00000554720.1	129	446	+	171	P01009-1#79	0	33	ENST00000554720.1	324	357	+	33	0	0	3705
P01009-1#79	0	33	33	P01009-1	453	486	+	33	P01009-1	0	918	ENST00000489769.1	9	927	++	119	P01009-1#79	0	33	ENST00000489769.1	462	495	+	33	0	0	3706
P01009-1#79	0	33	33	P01009-1	453	486	+	33	P01009-1	0	1254	ENST00000449399.7	302	1556	++	100	P01009-1#79	0	33	ENST00000449399.7	755	788	+	33	0	0	3707
P01009-1#79	0	33	33	P01009-1	453	486	+	33	P01009-1	0	1254	ENST00000448921.5	573	1827	++	98	P01009-1#79	0	33	ENST00000448921.5	1026	1059	+	33	0	0	3708
P01009-1#79	0	33	33	P01009-1	453	486	+	33	P01009-1	0	1254	ENST00000440909.5	185	1439	++	91	P01009-1#79	0	33	ENST00000440909.5	638	671	+	33	0	0	3709
P01009-1#79	0	33	33	P01009-1	453	486	+	33	P01009-1	0	1254	ENST00000437397.5	381	1635	++	89	P01009-1#79	0	33	ENST00000437397.5	834	867	+	33	0	0	3710
P01009-1#79	0	33	33	P01009-1	453	486	+	33	P01009-1	0	1254	ENST00000404814.8	311	1565	++	68	P01009-1#79	0	33	ENST00000404814.8	764	797	+	33	0	0	3711
P01009-1#79	0	33	33	P01009-1	453	486	+	33	P01009-1	0	1065	ENST00000402629.1	34	1099	++	67	P01009-1#79	0	33	ENST00000402629.1	487	520	+	33	0	0	3712
P01009-1#79	0	33	33	P01009-1	453	486	+	33	P01009-1	0	1254	ENST00000393088.8	555	1809	++	63	P01009-1#79	0	33	ENST00000393088.8	1008	1041	+	33	0	0	3713
P01009-1#79	0	33	33	P01009-1	453	486	+	33	P01009-1	0	1254	ENST00000393087.9	47	1301	++	62	P01009-1#79	0	33	ENST00000393087.9	500	533	+	33	0	0	3714
P01009-1#79	0	33	33	P01009-1	453	486	+	33	P01009-1	0	1254	ENST00000355814.8	277	1531	++	36	P01009-1#79	0	33	ENST00000355814.8	730	763	+	33	0	0	3715
P01009-1#80	0	18	18	P01009-1	489	507	+	18	P01009-1	0	1254	ENST00000636712.1	152	1406	++	236	P01009-1#80	0	18	ENST00000636712.1	641	659	+	18	0	0	3716
P01009-1#80	0	18	18	P01009-1	489	507	+	18	P01009-1	258	575	ENST00000554720.1	129	446	+	171	P01009-1#80	0	18	ENST00000554720.1	360	378	+	18	0	0	3717
P01009-1#80	0	18	18	P01009-1	489	507	+	18	P01009-1	0	918	ENST00000489769.1	9	927	++	119	P01009-1#80	0	18	ENST00000489769.1	498	516	+	18	0	0	3718
P01009-1#80	0	18	18	P01009-1	489	507	+	18	P01009-1	0	1254	ENST00000449399.7	302	1556	++	100	P01009-1#80	0	18	ENST00000449399.7	791	809	+	18	0	0	3719
P01009-1#80	0	18	18	P01009-1	489	507	+	18	P01009-1	0	1254	ENST00000448921.5	573	1827	++	98	P01009-1#80	0	18	ENST00000448921.5	1062	1080	+	18	0	0	3720
P01009-1#80	0	18	18	P01009-1	489	507	+	18	P01009-1	0	1254	ENST00000440909.5	185	1439	++	91	P01009-1#80	0	18	ENST00000440909.5	674	692	+	18	0	0	3721
P01009-1#80	0	18	18	P01009-1	489	507	+	18	P01009-1	0	1254	ENST00000437397.5	381	1635	++	89	P01009-1#80	0	18	ENST00000437397.5	870	888	+	18	0	0	3722
P01009-1#80	0	18	18	P01009-1	489	507	+	18	P01009-1	0	1254	ENST00000404814.8	311	1565	++	68	P01009-1#80	0	18	ENST00000404814.8	800	818	+	18	0	0	3723
P01009-1#80	0	18	18	P01009-1	489	507	+	18	P01009-1	0	1065	ENST00000402629.1	34	1099	++	67	P01009-1#80	0	18	ENST00000402629.1	523	541	+	18	0	0	3724
P01009-1#80	0	18	18	P01009-1	489	507	+	18	P01009-1	0	1254	ENST00000393088.8	555	1809	++	63	P01009-1#80	0	18	ENST00000393088.8	1044	1062	+	18	0	0	3725
P01009-1#80	0	18	18	P01009-1	489	507	+	18	P01009-1	0	1254	ENST00000393087.9	47	1301	++	62	P01009-1#80	0	18	ENST00000393087.9	536	554	+	18	0	0	3726
P01009-1#80	0	18	18	P01009-1	489	507	+	18	P01009-1	0	1254	ENST00000355814.8	277	1531	++	36	P01009-1#80	0	18	ENST00000355814.8	766	784	+	18	0	0	3727
P01009-1#81	0	9	9	P01009-1	510	519	+	9	P01009-1	0	1254	ENST00000636712.1	152	1406	++	236	P01009-1#81	0	9	ENST00000636712.1	662	671	+	9	0	0	3728
P01009-1#81	0	9	9	P01009-1	510	519	+	9	P01009-1	258	575	ENST00000554720.1	129	446	+	171	P01009-1#81	0	9	ENST00000554720.1	381	390	+	9	0	0	3729
P01009-1#81	0	9	9	P01009-1	510	519	+	9	P01009-1	0	918	ENST00000489769.1	9	927	++	119	P01009-1#81	0	9	ENST00000489769.1	519	528	+	9	0	0	3730
P01009-1#81	0	9	9	P01009-1	510	519	+	9	P01009-1	0	1254	ENST00000449399.7	302	1556	++	100	P01009-1#81	0	9	ENST00000449399.7	812	821	+	9	0	0	3731
P01009-1#81	0	9	9	P01009-1	510	519	+	9	P01009-1	0	1254	ENST00000448921.5	573	1827	++	98	P01009-1#81	0	9	ENST00000448921.5	1083	1092	+	9	0	0	3732
P01009-1#81	0	9	9	P01009-1	510	519	+	9	P01009-1	0	1254	ENST00000440909.5	185	1439	++	91	P01009-1#81	0	9	ENST00000440909.5	695	704	+	9	0	0	3733
P01009-1#81	0	9	9	P01009-1	510	519	+	9	P01009-1	0	1254	ENST00000437397.5	381	1635	++	89	P01009-1#81	0	9	ENST00000437397.5	891	900	+	9	0	0	3734
P01009-1#81	0	9	9	P01009-1	510	519	+	9	P01009-1	0	1254	ENST00000404814.8	311	1565	++	68	P01009-1#81	0	9	ENST00000404814.8	821	830	+	9	0	0	3735
P01009-1#81	0	9	9	P01009-1	510	519	+	9	P01009-1	0	1065	ENST00000402629.1	34	1099	++	67	P01009-1#81	0	9	ENST00000402629.1	544	553	+	9	0	0	3736
P01009-1#81	0	9	9	P01009-1	510	519	+	9	P01009-1	0	1254	ENST00000393088.8	555	1809	++	63	P01009-1#81	0	9	ENST00000393088.8	1065	1074	+	9	0	0	3737
P01009-1#81	0	9	9	P01009-1	510	519	+	9	P01009-1	0	1254	ENST00000393087.9	47	1301	++	62	P01009-1#81	0	9	ENST00000393087.9	557	566	+	9	0	0	3738
P01009-1#81	0	9	9	P01009-1	510	519	+	9	P01009-1	0	1254	ENST00000355814.8	277	1531	++	36	P01009-1#81	0	9	ENST00000355814.8	787	796	+	9	0	0	3739
P01009-1#82	0	45	45	P01009-1	519	564	+	45	P01009-1	0	1254	ENST00000636712.1	152	1406	++	236	P01009-1#82	0	45	ENST00000636712.1	671	716	+	45	0	0	3740
P01009-1#82	0	45	45	P01009-1	519	564	+	45	P01009-1	258	575	ENST00000554720.1	129	446	+	171	P01009-1#82	0	45	ENST00000554720.1	390	435	+	45	0	0	3741
P01009-1#82	0	45	45	P01009-1	519	564	+	45	P01009-1	0	918	ENST00000489769.1	9	927	++	119	P01009-1#82	0	45	ENST00000489769.1	528	573	+	45	0	0	3742
P01009-1#82	0	45	45	P01009-1	519	564	+	45	P01009-1	0	1254	ENST00000449399.7	302	1556	++	100	P01009-1#82	0	45	ENST00000449399.7	821	866	+	45	0	0	3743
P01009-1#82	0	45	45	P01009-1	519	564	+	45	P01009-1	0	1254	ENST00000448921.5	573	1827	++	98	P01009-1#82	0	45	ENST00000448921.5	1092	1137	+	45	0	0	3744
P01009-1#82	0	45	45	P01009-1	519	564	+	45	P01009-1	0	1254	ENST00000440909.5	185	1439	++	91	P01009-1#82	0	45	ENST00000440909.5	704	749	+	45	0	0	3745
P01009-1#82	0	45	45	P01009-1	519	564	+	45	P01009-1	0	1254	ENST00000437397.5	381	1635	++	89	P01009-1#82	0	45	ENST00000437397.5	900	945	+	45	0	0	3746
P01009-1#82	0	45	45	P01009-1	519	564	+	45	P01009-1	0	1254	ENST00000404814.8	311	1565	++	68	P01009-1#82	0	45	ENST00000404814.8	830	875	+	45	0	0	3747
P01009-1#82	0	45	45	P01009-1	519	564	+	45	P01009-1	0	1065	ENST00000402629.1	34	1099	++	67	P01009-1#82	0	45	ENST00000402629.1	553	598	+	45	0	0	3748
P01009-1#82	0	45	45	P01009-1	519	564	+	45	P01009-1	0	1254	ENST00000393088.8	555	1809	++	63	P01009-1#82	0	45	ENST00000393088.8	1074	1119	+	45	0	0	3749
P01009-1#82	0	45	45	P01009-1	519	564	+	45	P01009-1	0	1254	ENST00000393087.9	47	1301	++	62	P01009-1#82	0	45	ENST00000393087.9	566	611	+	45	0	0	3750
P01009-1#82	0	45	45	P01009-1	519	564	+	45	P01009-1	0	1254	ENST00000355814.8	277	1531	++	36	P01009-1#82	0	45	ENST00000355814.8	796	841	+	45	0	0	3751
P01009-1#83	0	9	9	P01009-1	564	573	+	9	P01009-1	0	1254	ENST00000636712.1	152	1406	++	236	P01009-1#83	0	9	ENST00000636712.1	716	725	+	9	0	0	3752
P01009-1#83	0	9	9	P01009-1	564	573	+	9	P01009-1	258	575	ENST00000554720.1	129	446	+	171	P01009-1#83	0	9	ENST00000554720.1	435	444	+	9	0	0	3753
P01009-1#83	0	9	9	P01009-1	564	573	+	9	P01009-1	0	918	ENST00000489769.1	9	927	++	119	P01009-1#83	0	9	ENST00000489769.1	573	582	+	9	0	0	3754
P01009-1#83	0	9	9	P01009-1	564	573	+	9	P01009-1	0	1254	ENST00000449399.7	302	1556	++	100	P01009-1#83	0	9	ENST00000449399.7	866	875	+	9	0	0	3755
P01009-1#83	0	9	9	P01009-1	564	573	+	9	P01009-1	0	1254	ENST00000448921.5	573	1827	++	98	P01009-1#83	0	9	ENST00000448921.5	1137	1146	+	9	0	0	3756
P01009-1#83	0	9	9	P01009-1	564	573	+	9	P01009-1	0	1254	ENST00000440909.5	185	1439	++	91	P01009-1#83	0	9	ENST00000440909.5	749	758	+	9	0	0	3757
P01009-1#83	0	9	9	P01009-1	564	573	+	9	P01009-1	0	1254	ENST00000437397.5	381	1635	++	89	P01009-1#83	0	9	ENST00000437397.5	945	954	+	9	0	0	3758
P01009-1#83	0	9	9	P01009-1	564	573	+	9	P01009-1	0	1254	ENST00000404814.8	311	1565	++	68	P01009-1#83	0	9	ENST00000404814.8	875	884	+	9	0	0	3759
P01009-1#83	0	9	9	P01009-1	564	573	+	9	P01009-1	0	1065	ENST00000402629.1	34	1099	++	67	P01009-1#83	0	9	ENST00000402629.1	598	607	+	9	0	0	3760
P01009-1#83	0	9	9	P01009-1	564	573	+	9	P01009-1	0	1254	ENST00000393088.8	555	1809	++	63	P01009-1#83	0	9	ENST00000393088.8	1119	1128	+	9	0	0	3761
P01009-1#83	0	9	9	P01009-1	564	573	+	9	P01009-1	0	1254	ENST00000393087.9	47	1301	++	62	P01009-1#83	0	9	ENST00000393087.9	611	620	+	9	0	0	3762
P01009-1#83	0	9	9	P01009-1	564	573	+	9	P01009-1	0	1254	ENST00000355814.8	277	1531	++	36	P01009-1#83	0	9	ENST00000355814.8	841	850	+	9	0	0	3763
P01009-1#84	0	45	45	P01009-1	615	660	+	45	P01009-1	0	1254	ENST00000636712.1	152	1406	++	236	P01009-1#84	0	45	ENST00000636712.1	767	812	+	45	0	0	3764
P01009-1#84	0	45	45	P01009-1	615	660	+	45	P01009-1	0	918	ENST00000489769.1	9	927	++	119	P01009-1#84	0	45	ENST00000489769.1	624	669	+	45	0	0	3765
P01009-1#84	0	45	45	P01009-1	615	660	+	45	P01009-1	0	1254	ENST00000449399.7	302	1556	++	100	P01009-1#84	0	45	ENST00000449399.7	917	962	+	45	0	0	3766
P01009-1#84	0	45	45	P01009-1	615	660	+	45	P01009-1	0	1254	ENST00000448921.5	573	1827	++	98	P01009-1#84	0	45	ENST00000448921.5	1188	1233	+	45	0	0	3767
P01009-1#84	0	45	45	P01009-1	615	660	+	45	P01009-1	0	1254	ENST00000440909.5	185	1439	++	91	P01009-1#84	0	45	ENST00000440909.5	800	845	+	45	0	0	3768
P01009-1#84	0	45	45	P01009-1	615	660	+	45	P01009-1	0	1254	ENST00000437397.5	381	1635	++	89	P01009-1#84	0	45	ENST00000437397.5	996	1041	+	45	0	0	3769
P01009-1#84	0	45	45	P01009-1	615	660	+	45	P01009-1	0	1254	ENST00000404814.8	311	1565	++	68	P01009-1#84	0	45	ENST00000404814.8	926	971	+	45	0	0	3770
P01009-1#84	0	45	45	P01009-1	615	660	+	45	P01009-1	0	1065	ENST00000402629.1	34	1099	++	67	P01009-1#84	0	45	ENST00000402629.1	649	694	+	45	0	0	3771
P01009-1#84	0	45	45	P01009-1	615	660	+	45	P01009-1	0	1254	ENST00000393088.8	555	1809	++	63	P01009-1#84	0	45	ENST00000393088.8	1170	1215	+	45	0	0	3772
P01009-1#84	0	45	45	P01009-1	615	660	+	45	P01009-1	0	1254	ENST00000393087.9	47	1301	++	62	P01009-1#84	0	45	ENST00000393087.9	662	707	+	45	0	0	3773
P01009-1#84	0	45	45	P01009-1	615	660	+	45	P01009-1	0	1254	ENST00000355814.8	277	1531	++	36	P01009-1#84	0	45	ENST00000355814.8	892	937	+	45	0	0	3774
P01009-1#85	0	9	9	P01009-1	669	678	+	9	P01009-1	0	1254	ENST00000636712.1	152	1406	++	236	P01009-1#85	0	9	ENST00000636712.1	821	830	+	9	0	0	3775
P01009-1#85	0	9	9	P01009-1	669	678	+	9	P01009-1	0	918	ENST00000489769.1	9	927	++	119	P01009-1#85	0	9	ENST00000489769.1	678	687	+	9	0	0	3776
P01009-1#85	0	9	9	P01009-1	669	678	+	9	P01009-1	0	1254	ENST00000449399.7	302	1556	++	100	P01009-1#85	0	9	ENST00000449399.7	971	980	+	9	0	0	3777
P01009-1#85	0	9	9	P01009-1	669	678	+	9	P01009-1	0	1254	ENST00000448921.5	573	1827	++	98	P01009-1#85	0	9	ENST00000448921.5	1242	1251	+	9	0	0	3778
P01009-1#85	0	9	9	P01009-1	669	678	+	9	P01009-1	0	1254	ENST00000440909.5	185	1439	++	91	P01009-1#85	0	9	ENST00000440909.5	854	863	+	9	0	0	3779
P01009-1#85	0	9	9	P01009-1	669	678	+	9	P01009-1	0	1254	ENST00000437397.5	381	1635	++	89	P01009-1#85	0	9	ENST00000437397.5	1050	1059	+	9	0	0	3780
P01009-1#85	0	9	9	P01009-1	669	678	+	9	P01009-1	0	1254	ENST00000404814.8	311	1565	++	68	P01009-1#85	0	9	ENST00000404814.8	980	989	+	9	0	0	3781
P01009-1#85	0	9	9	P01009-1	669	678	+	9	P01009-1	0	1065	ENST00000402629.1	34	1099	++	67	P01009-1#85	0	9	ENST00000402629.1	703	712	+	9	0	0	3782
P01009-1#85	0	9	9	P01009-1	669	678	+	9	P01009-1	0	1254	ENST00000393088.8	555	1809	++	63	P01009-1#85	0	9	ENST00000393088.8	1224	1233	+	9	0	0	3783
P01009-1#85	0	9	9	P01009-1	669	678	+	9	P01009-1	0	1254	ENST00000393087.9	47	1301	++	62	P01009-1#85	0	9	ENST00000393087.9	716	725	+	9	0	0	3784
P01009-1#85	0	9	9	P01009-1	669	678	+	9	P01009-1	0	1254	ENST00000355814.8	277	1531	++	36	P01009-1#85	0	9	ENST00000355814.8	946	955	+	9	0	0	3785
P01009-1#86	0	24	24	P01009-1	681	705	+	24	P01009-1	0	1254	ENST00000636712.1	152	1406	++	236	P01009-1#86	0	24	ENST00000636712.1	833	857	+	24	0	0	3786
P01009-1#86	0	24	24	P01009-1	681	705	+	24	P01009-1	0	918	ENST00000489769.1	9	927	++	119	P01009-1#86	0	24	ENST00000489769.1	690	714	+	24	0	0	3787
P01009-1#86	0	24	24	P01009-1	681	705	+	24	P01009-1	0	1254	ENST00000449399.7	302	1556	++	100	P01009-1#86	0	24	ENST00000449399.7	983	1007	+	24	0	0	3788
P01009-1#86	0	24	24	P01009-1	681	705	+	24	P01009-1	0	1254	ENST00000448921.5	573	1827	++	98	P01009-1#86	0	24	ENST00000448921.5	1254	1278	+	24	0	0	3789
P01009-1#86	0	24	24	P01009-1	681	705	+	24	P01009-1	0	1254	ENST00000440909.5	185	1439	++	91	P01009-1#86	0	24	ENST00000440909.5	866	890	+	24	0	0	3790
P01009-1#86	0	24	24	P01009-1	681	705	+	24	P01009-1	0	1254	ENST00000437397.5	381	1635	++	89	P01009-1#86	0	24	ENST00000437397.5	1062	1086	+	24	0	0	3791
P01009-1#86	0	24	24	P01009-1	681	705	+	24	P01009-1	0	1254	ENST00000404814.8	311	1565	++	68	P01009-1#86	0	24	ENST00000404814.8	992	1016	+	24	0	0	3792
P01009-1#86	0	24	24	P01009-1	681	705	+	24	P01009-1	0	1065	ENST00000402629.1	34	1099	++	67	P01009-1#86	0	24	ENST00000402629.1	715	739	+	24	0	0	3793
P01009-1#86	0	24	24	P01009-1	681	705	+	24	P01009-1	0	1254	ENST00000393088.8	555	1809	++	63	P01009-1#86	0	24	ENST00000393088.8	1236	1260	+	24	0	0	3794
P01009-1#86	0	24	24	P01009-1	681	705	+	24	P01009-1	0	1254	ENST00000393087.9	47	1301	++	62	P01009-1#86	0	24	ENST00000393087.9	728	752	+	24	0	0	3795
P01009-1#86	0	24	24	P01009-1	681	705	+	24	P01009-1	0	1254	ENST00000355814.8	277	1531	++	36	P01009-1#86	0	24	ENST00000355814.8	958	982	+	24	0	0	3796
P01009-1#87	0	57	57	P01009-1	711	768	+	57	P01009-1	0	1254	ENST00000636712.1	152	1406	++	236	P01009-1#87	0	57	ENST00000636712.1	863	920	+	57	0	0	3797
P01009-1#87	0	57	57	P01009-1	711	768	+	57	P01009-1	0	918	ENST00000489769.1	9	927	++	119	P01009-1#87	0	57	ENST00000489769.1	720	777	+	57	0	0	3798
P01009-1#87	0	57	57	P01009-1	711	768	+	57	P01009-1	0	1254	ENST00000449399.7	302	1556	++	100	P01009-1#87	0	57	ENST00000449399.7	1013	1070	+	57	0	0	3799
P01009-1#87	0	57	57	P01009-1	711	768	+	57	P01009-1	0	1254	ENST00000448921.5	573	1827	++	98	P01009-1#87	0	57	ENST00000448921.5	1284	1341	+	57	0	0	3800
P01009-1#87	0	57	57	P01009-1	711	768	+	57	P01009-1	0	1254	ENST00000440909.5	185	1439	++	91	P01009-1#87	0	57	ENST00000440909.5	896	953	+	57	0	0	3801
P01009-1#87	0	57	57	P01009-1	711	768	+	57	P01009-1	0	1254	ENST00000437397.5	381	1635	++	89	P01009-1#87	0	57	ENST00000437397.5	1092	1149	+	57	0	0	3802
P01009-1#87	0	57	57	P01009-1	711	768	+	57	P01009-1	0	1254	ENST00000404814.8	311	1565	++	68	P01009-1#87	0	57	ENST00000404814.8	1022	1079	+	57	0	0	3803
P01009-1#87	0	57	57	P01009-1	711	768	+	57	P01009-1	0	1065	ENST00000402629.1	34	1099	++	67	P01009-1#87	0	57	ENST00000402629.1	745	802	+	57	0	0	3804
P01009-1#87	0	57	57	P01009-1	711	768	+	57	P01009-1	0	1254	ENST00000393088.8	555	1809	++	63	P01009-1#87	0	57	ENST00000393088.8	1266	1323	+	57	0	0	3805
P01009-1#87	0	57	57	P01009-1	711	768	+	57	P01009-1	0	1254	ENST00000393087.9	47	1301	++	62	P01009-1#87	0	57	ENST00000393087.9	758	815	+	57	0	0	3806
P01009-1#87	0	57	57	P01009-1	711	768	+	57	P01009-1	0	1254	ENST00000355814.8	277	1531	++	36	P01009-1#87	0	57	ENST00000355814.8	988	1045	+	57	0	0	3807
P01009-1#88	0	12	12	P01009-1	768	780	+	12	P01009-1	0	1254	ENST00000636712.1	152	1406	++	236	P01009-1#88	0	12	ENST00000636712.1	920	932	+	12	0	0	3808
P01009-1#88	0	12	12	P01009-1	768	780	+	12	P01009-1	0	918	ENST00000489769.1	9	927	++	119	P01009-1#88	0	12	ENST00000489769.1	777	789	+	12	0	0	3809
P01009-1#88	0	12	12	P01009-1	768	780	+	12	P01009-1	0	1254	ENST00000449399.7	302	1556	++	100	P01009-1#88	0	12	ENST00000449399.7	1070	1082	+	12	0	0	3810
P01009-1#88	0	12	12	P01009-1	768	780	+	12	P01009-1	0	1254	ENST00000448921.5	573	1827	++	98	P01009-1#88	0	12	ENST00000448921.5	1341	1353	+	12	0	0	3811
P01009-1#88	0	12	12	P01009-1	768	780	+	12	P01009-1	0	1254	ENST00000440909.5	185	1439	++	91	P01009-1#88	0	12	ENST00000440909.5	953	965	+	12	0	0	3812
P01009-1#88	0	12	12	P01009-1	768	780	+	12	P01009-1	0	1254	ENST00000437397.5	381	1635	++	89	P01009-1#88	0	12	ENST00000437397.5	1149	1161	+	12	0	0	3813
P01009-1#88	0	12	12	P01009-1	768	780	+	12	P01009-1	0	1254	ENST00000404814.8	311	1565	++	68	P01009-1#88	0	12	ENST00000404814.8	1079	1091	+	12	0	0	3814
P01009-1#88	0	12	12	P01009-1	768	780	+	12	P01009-1	0	1065	ENST00000402629.1	34	1099	++	67	P01009-1#88	0	12	ENST00000402629.1	802	814	+	12	0	0	3815
P01009-1#88	0	12	12	P01009-1	768	780	+	12	P01009-1	0	1254	ENST00000393088.8	555	1809	++	63	P01009-1#88	0	12	ENST00000393088.8	1323	1335	+	12	0	0	3816
P01009-1#88	0	12	12	P01009-1	768	780	+	12	P01009-1	0	1254	ENST00000393087.9	47	1301	++	62	P01009-1#88	0	12	ENST00000393087.9	815	827	+	12	0	0	3817
P01009-1#88	0	12	12	P01009-1	768	780	+	12	P01009-1	0	1254	ENST00000355814.8	277	1531	++	36	P01009-1#88	0	12	ENST00000355814.8	1045	1057	+	12	0	0	3818
P01009-1#89	0	57	57	P01009-1	780	837	+	57	P01009-1	0	1254	ENST00000636712.1	152	1406	++	236	P01009-1#89	0	57	ENST00000636712.1	932	989	+	57	0	0	3819
P01009-1#89	0	57	57	P01009-1	780	837	+	57	P01009-1	0	918	ENST00000489769.1	9	927	++	119	P01009-1#89	0	57	ENST00000489769.1	789	846	+	57	0	0	3820
P01009-1#89	0	57	57	P01009-1	780	837	+	57	P01009-1	0	1254	ENST00000449399.7	302	1556	++	100	P01009-1#89	0	57	ENST00000449399.7	1082	1139	+	57	0	0	3821
P01009-1#89	0	57	57	P01009-1	780	837	+	57	P01009-1	0	1254	ENST00000448921.5	573	1827	++	98	P01009-1#89	0	57	ENST00000448921.5	1353	1410	+	57	0	0	3822
P01009-1#89	0	57	57	P01009-1	780	837	+	57	P01009-1	0	1254	ENST00000440909.5	185	1439	++	91	P01009-1#89	0	57	ENST00000440909.5	965	1022	+	57	0	0	3823
P01009-1#89	0	57	57	P01009-1	780	837	+	57	P01009-1	0	1254	ENST00000437397.5	381	1635	++	89	P01009-1#89	0	57	ENST00000437397.5	1161	1218	+	57	0	0	3824
P01009-1#89	0	57	57	P01009-1	780	837	+	57	P01009-1	0	1254	ENST00000404814.8	311	1565	++	68	P01009-1#89	0	57	ENST00000404814.8	1091	1148	+	57	0	0	3825
P01009-1#89	0	57	57	P01009-1	780	837	+	57	P01009-1	0	1065	ENST00000402629.1	34	1099	++	67	P01009-1#89	0	57	ENST00000402629.1	814	871	+	57	0	0	3826
P01009-1#89	0	57	57	P01009-1	780	837	+	57	P01009-1	0	1254	ENST00000393088.8	555	1809	++	63	P01009-1#89	0	57	ENST00000393088.8	1335	1392	+	57	0	0	3827
P01009-1#89	0	57	57	P01009-1	780	837	+	57	P01009-1	0	1254	ENST00000393087.9	47	1301	++	62	P01009-1#89	0	57	ENST00000393087.9	827	884	+	57	0	0	3828
P01009-1#89	0	57	57	P01009-1	780	837	+	57	P01009-1	0	1254	ENST00000355814.8	277	1531	++	36	P01009-1#89	0	57	ENST00000355814.8	1057	1114	+	57	0	0	3829
P01009-1#90	0	9	9	P01009-1	837	846	+	9	P01009-1	0	1254	ENST00000636712.1	152	1406	++	236	P01009-1#90	0	9	ENST00000636712.1	989	998	+	9	0	0	3830
P01009-1#90	0	9	9	P01009-1	837	846	+	9	P01009-1	0	918	ENST00000489769.1	9	927	++	119	P01009-1#90	0	9	ENST00000489769.1	846	855	+	9	0	0	3831
P01009-1#90	0	9	9	P01009-1	837	846	+	9	P01009-1	0	1254	ENST00000449399.7	302	1556	++	100	P01009-1#90	0	9	ENST00000449399.7	1139	1148	+	9	0	0	3832
P01009-1#90	0	9	9	P01009-1	837	846	+	9	P01009-1	0	1254	ENST00000448921.5	573	1827	++	98	P01009-1#90	0	9	ENST00000448921.5	1410	1419	+	9	0	0	3833
P01009-1#90	0	9	9	P01009-1	837	846	+	9	P01009-1	0	1254	ENST00000440909.5	185	1439	++	91	P01009-1#90	0	9	ENST00000440909.5	1022	1031	+	9	0	0	3834
P01009-1#90	0	9	9	P01009-1	837	846	+	9	P01009-1	0	1254	ENST00000437397.5	381	1635	++	89	P01009-1#90	0	9	ENST00000437397.5	1218	1227	+	9	0	0	3835
P01009-1#90	0	9	9	P01009-1	837	846	+	9	P01009-1	0	1254	ENST00000404814.8	311	1565	++	68	P01009-1#90	0	9	ENST00000404814.8	1148	1157	+	9	0	0	3836
P01009-1#90	0	9	9	P01009-1	837	846	+	9	P01009-1	0	1065	ENST00000402629.1	34	1099	++	67	P01009-1#90	0	9	ENST00000402629.1	871	880	+	9	0	0	3837
P01009-1#90	0	9	9	P01009-1	837	846	+	9	P01009-1	0	1254	ENST00000393088.8	555	1809	++	63	P01009-1#90	0	9	ENST00000393088.8	1392	1401	+	9	0	0	3838
P01009-1#90	0	9	9	P01009-1	837	846	+	9	P01009-1	0	1254	ENST00000393087.9	47	1301	++	62	P01009-1#90	0	9	ENST00000393087.9	884	893	+	9	0	0	3839
P01009-1#90	0	9	9	P01009-1	837	846	+	9	P01009-1	0	1254	ENST00000355814.8	277	1531	++	36	P01009-1#90	0	9	ENST00000355814.8	1114	1123	+	9	0	0	3840
P01009-1#91	0	21	21	P01009-1	849	870	+	21	P01009-1	0	1254	ENST00000636712.1	152	1406	++	236	P01009-1#91	0	21	ENST00000636712.1	1001	1022	+	21	0	0	3841
P01009-1#91	0	21	21	P01009-1	849	870	+	21	P01009-1	0	918	ENST00000489769.1	9	927	++	119	P01009-1#91	0	21	ENST00000489769.1	858	879	+	21	0	0	3842
P01009-1#91	0	21	21	P01009-1	849	870	+	21	P01009-1	0	1254	ENST00000449399.7	302	1556	++	100	P01009-1#91	0	21	ENST00000449399.7	1151	1172	+	21	0	0	3843
P01009-1#91	0	21	21	P01009-1	849	870	+	21	P01009-1	0	1254	ENST00000448921.5	573	1827	++	98	P01009-1#91	0	21	ENST00000448921.5	1422	1443	+	21	0	0	3844
P01009-1#91	0	21	21	P01009-1	849	870	+	21	P01009-1	0	1254	ENST00000440909.5	185	1439	++	91	P01009-1#91	0	21	ENST00000440909.5	1034	1055	+	21	0	0	3845
P01009-1#91	0	21	21	P01009-1	849	870	+	21	P01009-1	0	1254	ENST00000437397.5	381	1635	++	89	P01009-1#91	0	21	ENST00000437397.5	1230	1251	+	21	0	0	3846
P01009-1#91	0	21	21	P01009-1	849	870	+	21	P01009-1	0	1254	ENST00000404814.8	311	1565	++	68	P01009-1#91	0	21	ENST00000404814.8	1160	1181	+	21	0	0	3847
P01009-1#91	0	21	21	P01009-1	849	870	+	21	P01009-1	0	1065	ENST00000402629.1	34	1099	++	67	P01009-1#91	0	21	ENST00000402629.1	883	904	+	21	0	0	3848
P01009-1#91	0	21	21	P01009-1	849	870	+	21	P01009-1	0	1254	ENST00000393088.8	555	1809	++	63	P01009-1#91	0	21	ENST00000393088.8	1404	1425	+	21	0	0	3849
P01009-1#91	0	21	21	P01009-1	849	870	+	21	P01009-1	0	1254	ENST00000393087.9	47	1301	++	62	P01009-1#91	0	21	ENST00000393087.9	896	917	+	21	0	0	3850
P01009-1#91	0	21	21	P01009-1	849	870	+	21	P01009-1	0	1254	ENST00000355814.8	277	1531	++	36	P01009-1#91	0	21	ENST00000355814.8	1126	1147	+	21	0	0	3851
P01009-1#92	0	27	27	P01009-1	876	903	+	27	P01009-1	0	1254	ENST00000636712.1	152	1406	++	236	P01009-1#92	0	27	ENST00000636712.1	1028	1055	+	27	0	0	3852
P01009-1#92	0	27	27	P01009-1	876	903	+	27	P01009-1	0	918	ENST00000489769.1	9	927	++	119	P01009-1#92	0	27	ENST00000489769.1	885	912	+	27	0	0	3853
P01009-1#92	0	27	27	P01009-1	876	903	+	27	P01009-1	0	1254	ENST00000449399.7	302	1556	++	100	P01009-1#92	0	27	ENST00000449399.7	1178	1205	+	27	0	0	3854
P01009-1#92	0	27	27	P01009-1	876	903	+	27	P01009-1	0	1254	ENST00000448921.5	573	1827	++	98	P01009-1#92	0	27	ENST00000448921.5	1449	1476	+	27	0	0	3855
P01009-1#92	0	27	27	P01009-1	876	903	+	27	P01009-1	0	1254	ENST00000440909.5	185	1439	++	91	P01009-1#92	0	27	ENST00000440909.5	1061	1088	+	27	0	0	3856
P01009-1#92	0	27	27	P01009-1	876	903	+	27	P01009-1	0	1254	ENST00000437397.5	381	1635	++	89	P01009-1#92	0	27	ENST00000437397.5	1257	1284	+	27	0	0	3857
P01009-1#92	0	27	27	P01009-1	876	903	+	27	P01009-1	0	1254	ENST00000404814.8	311	1565	++	68	P01009-1#92	0	27	ENST00000404814.8	1187	1214	+	27	0	0	3858
P01009-1#92	0	27	27	P01009-1	876	903	+	27	P01009-1	0	1065	ENST00000402629.1	34	1099	++	67	P01009-1#92	0	27	ENST00000402629.1	910	937	+	27	0	0	3859
P01009-1#92	0	27	27	P01009-1	876	903	+	27	P01009-1	0	1254	ENST00000393088.8	555	1809	++	63	P01009-1#92	0	27	ENST00000393088.8	1431	1458	+	27	0	0	3860
P01009-1#92	0	27	27	P01009-1	876	903	+	27	P01009-1	0	1254	ENST00000393087.9	47	1301	++	62	P01009-1#92	0	27	ENST00000393087.9	923	950	+	27	0	0	3861
P01009-1#92	0	27	27	P01009-1	876	903	+	27	P01009-1	0	1254	ENST00000355814.8	277	1531	++	36	P01009-1#92	0	27	ENST00000355814.8	1153	1180	+	27	0	0	3862
P01009-1#93	0	24	24	P01009-1	915	939	+	24	P01009-1	0	1254	ENST00000636712.1	152	1406	++	236	P01009-1#93	0	24	ENST00000636712.1	1067	1091	+	24	0	0	3863
P01009-1#93	0	24	24	P01009-1	915	939	+	24	P01009-1	0	918	ENST00000489769.1	9	927	++	119	P01009-1#93	0	3	ENST00000489769.1	924	927	+	3	0	21	3864
P01009-1#93	0	24	24	P01009-1	915	939	+	24	P01009-1	0	1254	ENST00000449399.7	302	1556	++	100	P01009-1#93	0	24	ENST00000449399.7	1217	1241	+	24	0	0	3865
P01009-1#93	0	24	24	P01009-1	915	939	+	24	P01009-1	0	1254	ENST00000448921.5	573	1827	++	98	P01009-1#93	0	24	ENST00000448921.5	1488	1512	+	24	0	0	3866
P01009-1#93	0	24	24	P01009-1	915	939	+	24	P01009-1	0	1254	ENST00000440909.5	185	1439	++	91	P01009-1#93	0	24	ENST00000440909.5	1100	1124	+	24	0	0	3867
P01009-1#93	0	24	24	P01009-1	915	939	+	24	P01009-1	0	1254	ENST00000437397.5	381	1635	++	89	P01009-1#93	0	24	ENST00000437397.5	1296	1320	+	24	0	0	3868
P01009-1#93	0	24	24	P01009-1	915	939	+	24	P01009-1	0	1254	ENST00000404814.8	311	1565	++	68	P01009-1#93	0	24	ENST00000404814.8	1226	1250	+	24	0	0	3869
P01009-1#93	0	24	24	P01009-1	915	939	+	24	P01009-1	0	1065	ENST00000402629.1	34	1099	++	67	P01009-1#93	0	24	ENST00000402629.1	949	973	+	24	0	0	3870
P01009-1#93	0	24	24	P01009-1	915	939	+	24	P01009-1	0	1254	ENST00000393088.8	555	1809	++	63	P01009-1#93	0	24	ENST00000393088.8	1470	1494	+	24	0	0	3871
P01009-1#93	0	24	24	P01009-1	915	939	+	24	P01009-1	0	1254	ENST00000393087.9	47	1301	++	62	P01009-1#93	0	24	ENST00000393087.9	962	986	+	24	0	0	3872
P01009-1#93	0	24	24	P01009-1	915	939	+	24	P01009-1	0	1254	ENST00000355814.8	277	1531	++	36	P01009-1#93	0	24	ENST00000355814.8	1192	1216	+	24	0	0	3873
P01009-1#94	0	24	24	P01009-1	942	966	+	24	P01009-1	0	1254	ENST00000636712.1	152	1406	++	236	P01009-1#94	0	24	ENST00000636712.1	1094	1118	+	24	0	0	3874
P01009-1#94	0	24	24	P01009-1	942	966	+	24	P01009-1	0	1254	ENST00000449399.7	302	1556	++	100	P01009-1#94	0	24	ENST00000449399.7	1244	1268	+	24	0	0	3875
P01009-1#94	0	24	24	P01009-1	942	966	+	24	P01009-1	0	1254	ENST00000448921.5	573	1827	++	98	P01009-1#94	0	24	ENST00000448921.5	1515	1539	+	24	0	0	3876
P01009-1#94	0	24	24	P01009-1	942	966	+	24	P01009-1	0	1254	ENST00000440909.5	185	1439	++	91	P01009-1#94	0	24	ENST00000440909.5	1127	1151	+	24	0	0	3877
P01009-1#94	0	24	24	P01009-1	942	966	+	24	P01009-1	0	1254	ENST00000437397.5	381	1635	++	89	P01009-1#94	0	24	ENST00000437397.5	1323	1347	+	24	0	0	3878
P01009-1#94	0	24	24	P01009-1	942	966	+	24	P01009-1	0	1254	ENST00000404814.8	311	1565	++	68	P01009-1#94	0	24	ENST00000404814.8	1253	1277	+	24	0	0	3879
P01009-1#94	0	24	24	P01009-1	942	966	+	24	P01009-1	0	1065	ENST00000402629.1	34	1099	++	67	P01009-1#94	0	24	ENST00000402629.1	976	1000	+	24	0	0	3880
P01009-1#94	0	24	24	P01009-1	942	966	+	24	P01009-1	0	1254	ENST00000393088.8	555	1809	++	63	P01009-1#94	0	24	ENST00000393088.8	1497	1521	+	24	0	0	3881
P01009-1#94	0	24	24	P01009-1	942	966	+	24	P01009-1	0	1254	ENST00000393087.9	47	1301	++	62	P01009-1#94	0	24	ENST00000393087.9	989	1013	+	24	0	0	3882
P01009-1#94	0	24	24	P01009-1	942	966	+	24	P01009-1	0	1254	ENST00000355814.8	277	1531	++	36	P01009-1#94	0	24	ENST00000355814.8	1219	1243	+	24	0	0	3883
P01009-1#95	0	18	18	P01009-1	969	987	+	18	P01009-1	0	1254	ENST00000636712.1	152	1406	++	236	P01009-1#95	0	18	ENST00000636712.1	1121	1139	+	18	0	0	3884
P01009-1#95	0	18	18	P01009-1	969	987	+	18	P01009-1	0	1254	ENST00000449399.7	302	1556	++	100	P01009-1#95	0	18	ENST00000449399.7	1271	1289	+	18	0	0	3885
P01009-1#95	0	18	18	P01009-1	969	987	+	18	P01009-1	0	1254	ENST00000448921.5	573	1827	++	98	P01009-1#95	0	18	ENST00000448921.5	1542	1560	+	18	0	0	3886
P01009-1#95	0	18	18	P01009-1	969	987	+	18	P01009-1	0	1254	ENST00000440909.5	185	1439	++	91	P01009-1#95	0	18	ENST00000440909.5	1154	1172	+	18	0	0	3887
P01009-1#95	0	18	18	P01009-1	969	987	+	18	P01009-1	0	1254	ENST00000437397.5	381	1635	++	89	P01009-1#95	0	18	ENST00000437397.5	1350	1368	+	18	0	0	3888
P01009-1#95	0	18	18	P01009-1	969	987	+	18	P01009-1	0	1254	ENST00000404814.8	311	1565	++	68	P01009-1#95	0	18	ENST00000404814.8	1280	1298	+	18	0	0	3889
P01009-1#95	0	18	18	P01009-1	969	987	+	18	P01009-1	0	1065	ENST00000402629.1	34	1099	++	67	P01009-1#95	0	18	ENST00000402629.1	1003	1021	+	18	0	0	3890
P01009-1#95	0	18	18	P01009-1	969	987	+	18	P01009-1	0	1254	ENST00000393088.8	555	1809	++	63	P01009-1#95	0	18	ENST00000393088.8	1524	1542	+	18	0	0	3891
P01009-1#95	0	18	18	P01009-1	969	987	+	18	P01009-1	0	1254	ENST00000393087.9	47	1301	++	62	P01009-1#95	0	18	ENST00000393087.9	1016	1034	+	18	0	0	3892
P01009-1#95	0	18	18	P01009-1	969	987	+	18	P01009-1	0	1254	ENST00000355814.8	277	1531	++	36	P01009-1#95	0	18	ENST00000355814.8	1246	1264	+	18	0	0	3893
P01009-1#96	0	9	9	P01009-1	999	1008	+	9	P01009-1	0	1254	ENST00000636712.1	152	1406	++	236	P01009-1#96	0	9	ENST00000636712.1	1151	1160	+	9	0	0	3894
P01009-1#96	0	9	9	P01009-1	999	1008	+	9	P01009-1	0	1254	ENST00000449399.7	302	1556	++	100	P01009-1#96	0	9	ENST00000449399.7	1301	1310	+	9	0	0	3895
P01009-1#96	0	9	9	P01009-1	999	1008	+	9	P01009-1	0	1254	ENST00000448921.5	573	1827	++	98	P01009-1#96	0	9	ENST00000448921.5	1572	1581	+	9	0	0	3896
P01009-1#96	0	9	9	P01009-1	999	1008	+	9	P01009-1	0	1254	ENST00000440909.5	185	1439	++	91	P01009-1#96	0	9	ENST00000440909.5	1184	1193	+	9	0	0	3897
P01009-1#96	0	9	9	P01009-1	999	1008	+	9	P01009-1	0	1254	ENST00000437397.5	381	1635	++	89	P01009-1#96	0	9	ENST00000437397.5	1380	1389	+	9	0	0	3898
P01009-1#96	0	9	9	P01009-1	999	1008	+	9	P01009-1	0	1254	ENST00000404814.8	311	1565	++	68	P01009-1#96	0	9	ENST00000404814.8	1310	1319	+	9	0	0	3899
P01009-1#96	0	9	9	P01009-1	999	1008	+	9	P01009-1	0	1065	ENST00000402629.1	34	1099	++	67	P01009-1#96	0	9	ENST00000402629.1	1033	1042	+	9	0	0	3900
P01009-1#96	0	9	9	P01009-1	999	1008	+	9	P01009-1	0	1254	ENST00000393088.8	555	1809	++	63	P01009-1#96	0	9	ENST00000393088.8	1554	1563	+	9	0	0	3901
P01009-1#96	0	9	9	P01009-1	999	1008	+	9	P01009-1	0	1254	ENST00000393087.9	47	1301	++	62	P01009-1#96	0	9	ENST00000393087.9	1046	1055	+	9	0	0	3902
P01009-1#96	0	9	9	P01009-1	999	1008	+	9	P01009-1	0	1254	ENST00000355814.8	277	1531	++	36	P01009-1#96	0	9	ENST00000355814.8	1276	1285	+	9	0	0	3903
P01009-1#97	0	9	9	P01009-1	1008	1017	+	9	P01009-1	0	1254	ENST00000636712.1	152	1406	++	236	P01009-1#97	0	9	ENST00000636712.1	1160	1169	+	9	0	0	3904
P01009-1#97	0	9	9	P01009-1	1008	1017	+	9	P01009-1	0	1254	ENST00000449399.7	302	1556	++	100	P01009-1#97	0	9	ENST00000449399.7	1310	1319	+	9	0	0	3905
P01009-1#97	0	9	9	P01009-1	1008	1017	+	9	P01009-1	0	1254	ENST00000448921.5	573	1827	++	98	P01009-1#97	0	9	ENST00000448921.5	1581	1590	+	9	0	0	3906
P01009-1#97	0	9	9	P01009-1	1008	1017	+	9	P01009-1	0	1254	ENST00000440909.5	185	1439	++	91	P01009-1#97	0	9	ENST00000440909.5	1193	1202	+	9	0	0	3907
P01009-1#97	0	9	9	P01009-1	1008	1017	+	9	P01009-1	0	1254	ENST00000437397.5	381	1635	++	89	P01009-1#97	0	9	ENST00000437397.5	1389	1398	+	9	0	0	3908
P01009-1#97	0	9	9	P01009-1	1008	1017	+	9	P01009-1	0	1254	ENST00000404814.8	311	1565	++	68	P01009-1#97	0	9	ENST00000404814.8	1319	1328	+	9	0	0	3909
P01009-1#97	0	9	9	P01009-1	1008	1017	+	9	P01009-1	0	1065	ENST00000402629.1	34	1099	++	67	P01009-1#97	0	9	ENST00000402629.1	1042	1051	+	9	0	0	3910
P01009-1#97	0	9	9	P01009-1	1008	1017	+	9	P01009-1	0	1254	ENST00000393088.8	555	1809	++	63	P01009-1#97	0	9	ENST00000393088.8	1563	1572	+	9	0	0	3911
P01009-1#97	0	9	9	P01009-1	1008	1017	+	9	P01009-1	0	1254	ENST00000393087.9	47	1301	++	62	P01009-1#97	0	9	ENST00000393087.9	1055	1064	+	9	0	0	3912
P01009-1#97	0	9	9	P01009-1	1008	1017	+	9	P01009-1	0	1254	ENST00000355814.8	277	1531	++	36	P01009-1#97	0	9	ENST00000355814.8	1285	1294	+	9	0	0	3913
P01009-1#98	0	9	9	P01009-1	1026	1035	+	9	P01009-1	0	1254	ENST00000636712.1	152	1406	++	236	P01009-1#98	0	9	ENST00000636712.1	1178	1187	+	9	0	0	3914
P01009-1#98	0	9	9	P01009-1	1026	1035	+	9	P01009-1	0	1254	ENST00000449399.7	302	1556	++	100	P01009-1#98	0	9	ENST00000449399.7	1328	1337	+	9	0	0	3915
P01009-1#98	0	9	9	P01009-1	1026	1035	+	9	P01009-1	0	1254	ENST00000448921.5	573	1827	++	98	P01009-1#98	0	9	ENST00000448921.5	1599	1608	+	9	0	0	3916
P01009-1#98	0	9	9	P01009-1	1026	1035	+	9	P01009-1	0	1254	ENST00000440909.5	185	1439	++	91	P01009-1#98	0	9	ENST00000440909.5	1211	1220	+	9	0	0	3917
P01009-1#98	0	9	9	P01009-1	1026	1035	+	9	P01009-1	0	1254	ENST00000437397.5	381	1635	++	89	P01009-1#98	0	9	ENST00000437397.5	1407	1416	+	9	0	0	3918
P01009-1#98	0	9	9	P01009-1	1026	1035	+	9	P01009-1	0	1254	ENST00000404814.8	311	1565	++	68	P01009-1#98	0	9	ENST00000404814.8	1337	1346	+	9	0	0	3919
P01009-1#98	0	9	9	P01009-1	1026	1035	+	9	P01009-1	0	1065	ENST00000402629.1	34	1099	++	67	P01009-1#98	0	9	ENST00000402629.1	1060	1069	+	9	0	0	3920
P01009-1#98	0	9	9	P01009-1	1026	1035	+	9	P01009-1	0	1254	ENST00000393088.8	555	1809	++	63	P01009-1#98	0	9	ENST00000393088.8	1581	1590	+	9	0	0	3921
P01009-1#98	0	9	9	P01009-1	1026	1035	+	9	P01009-1	0	1254	ENST00000393087.9	47	1301	++	62	P01009-1#98	0	9	ENST00000393087.9	1073	1082	+	9	0	0	3922
P01009-1#98	0	9	9	P01009-1	1026	1035	+	9	P01009-1	0	1254	ENST00000355814.8	277	1531	++	36	P01009-1#98	0	9	ENST00000355814.8	1303	1312	+	9	0	0	3923
P01009-1#99	0	9	9	P01009-1	1038	1047	+	9	P01009-1	0	1254	ENST00000636712.1	152	1406	++	236	P01009-1#99	0	9	ENST00000636712.1	1190	1199	+	9	0	0	3924
P01009-1#99	0	9	9	P01009-1	1038	1047	+	9	P01009-1	0	1254	ENST00000449399.7	302	1556	++	100	P01009-1#99	0	9	ENST00000449399.7	1340	1349	+	9	0	0	3925
P01009-1#99	0	9	9	P01009-1	1038	1047	+	9	P01009-1	0	1254	ENST00000448921.5	573	1827	++	98	P01009-1#99	0	9	ENST00000448921.5	1611	1620	+	9	0	0	3926
P01009-1#99	0	9	9	P01009-1	1038	1047	+	9	P01009-1	0	1254	ENST00000440909.5	185	1439	++	91	P01009-1#99	0	9	ENST00000440909.5	1223	1232	+	9	0	0	3927
P01009-1#99	0	9	9	P01009-1	1038	1047	+	9	P01009-1	0	1254	ENST00000437397.5	381	1635	++	89	P01009-1#99	0	9	ENST00000437397.5	1419	1428	+	9	0	0	3928
P01009-1#99	0	9	9	P01009-1	1038	1047	+	9	P01009-1	0	1254	ENST00000404814.8	311	1565	++	68	P01009-1#99	0	9	ENST00000404814.8	1349	1358	+	9	0	0	3929
P01009-1#99	0	9	9	P01009-1	1038	1047	+	9	P01009-1	0	1065	ENST00000402629.1	34	1099	++	67	P01009-1#99	0	9	ENST00000402629.1	1072	1081	+	9	0	0	3930
P01009-1#99	0	9	9	P01009-1	1038	1047	+	9	P01009-1	0	1254	ENST00000393088.8	555	1809	++	63	P01009-1#99	0	9	ENST00000393088.8	1593	1602	+	9	0	0	3931
P01009-1#99	0	9	9	P01009-1	1038	1047	+	9	P01009-1	0	1254	ENST00000393087.9	47	1301	++	62	P01009-1#99	0	9	ENST00000393087.9	1085	1094	+	9	0	0	3932
P01009-1#99	0	9	9	P01009-1	1038	1047	+	9	P01009-1	0	1254	ENST00000355814.8	277	1531	++	36	P01009-1#99	0	9	ENST00000355814.8	1315	1324	+	9	0	0	3933
P01009-1#100	0	42	42	P01009-1	1050	1092	+	42	P01009-1	0	1254	ENST00000636712.1	152	1406	++	236	P01009-1#100	0	42	ENST00000636712.1	1202	1244	+	42	0	0	3934
P01009-1#100	0	42	42	P01009-1	1050	1092	+	42	P01009-1	0	1254	ENST00000449399.7	302	1556	++	100	P01009-1#100	0	42	ENST00000449399.7	1352	1394	+	42	0	0	3935
P01009-1#100	0	42	42	P01009-1	1050	1092	+	42	P01009-1	0	1254	ENST00000448921.5	573	1827	++	98	P01009-1#100	0	42	ENST00000448921.5	1623	1665	+	42	0	0	3936
P01009-1#100	0	42	42	P01009-1	1050	1092	+	42	P01009-1	0	1254	ENST00000440909.5	185	1439	++	91	P01009-1#100	0	42	ENST00000440909.5	1235	1277	+	42	0	0	3937
P01009-1#100	0	42	42	P01009-1	1050	1092	+	42	P01009-1	0	1254	ENST00000437397.5	381	1635	++	89	P01009-1#100	0	42	ENST00000437397.5	1431	1473	+	42	0	0	3938
P01009-1#100	0	42	42	P01009-1	1050	1092	+	42	P01009-1	0	1254	ENST00000404814.8	311	1565	++	68	P01009-1#100	0	42	ENST00000404814.8	1361	1403	+	42	0	0	3939
P01009-1#100	0	42	42	P01009-1	1050	1092	+	42	P01009-1	0	1065	ENST00000402629.1	34	1099	++	67	P01009-1#100	0	15	ENST00000402629.1	1084	1099	+	15	0	27	3940
P01009-1#100	0	42	42	P01009-1	1050	1092	+	42	P01009-1	0	1254	ENST00000393088.8	555	1809	++	63	P01009-1#100	0	42	ENST00000393088.8	1605	1647	+	42	0	0	3941
P01009-1#100	0	42	42	P01009-1	1050	1092	+	42	P01009-1	0	1254	ENST00000393087.9	47	1301	++	62	P01009-1#100	0	42	ENST00000393087.9	1097	1139	+	42	0	0	3942
P01009-1#100	0	42	42	P01009-1	1050	1092	+	42	P01009-1	0	1254	ENST00000355814.8	277	1531	++	36	P01009-1#100	0	42	ENST00000355814.8	1327	1369	+	42	0	0	3943
P01009-1#101	0	48	48	P01009-1	1095	1143	+	48	P01009-1	0	1254	ENST00000636712.1	152	1406	++	236	P01009-1#101	0	48	ENST00000636712.1	1247	1295	+	48	0	0	3944
P01009-1#101	0	48	48	P01009-1	1095	1143	+	48	P01009-1	0	1254	ENST00000449399.7	302	1556	++	100	P01009-1#101	0	48	ENST00000449399.7	1397	1445	+	48	0	0	3945
P01009-1#101	0	48	48	P01009-1	1095	1143	+	48	P01009-1	0	1254	ENST00000448921.5	573	1827	++	98	P01009-1#101	0	48	ENST00000448921.5	1668	1716	+	48	0	0	3946
P01009-1#101	0	48	48	P01009-1	1095	1143	+	48	P01009-1	0	1254	ENST00000440909.5	185	1439	++	91	P01009-1#101	0	48	ENST00000440909.5	1280	1328	+	48	0	0	3947
P01009-1#101	0	48	48	P01009-1	1095	1143	+	48	P01009-1	0	1254	ENST00000437397.5	381	1635	++	89	P01009-1#101	0	48	ENST00000437397.5	1476	1524	+	48	0	0	3948
P01009-1#101	0	48	48	P01009-1	1095	1143	+	48	P01009-1	0	1254	ENST00000404814.8	311	1565	++	68	P01009-1#101	0	48	ENST00000404814.8	1406	1454	+	48	0	0	3949
P01009-1#101	0	48	48	P01009-1	1095	1143	+	48	P01009-1	0	1254	ENST00000393088.8	555	1809	++	63	P01009-1#101	0	48	ENST00000393088.8	1650	1698	+	48	0	0	3950
P01009-1#101	0	48	48	P01009-1	1095	1143	+	48	P01009-1	0	1254	ENST00000393087.9	47	1301	++	62	P01009-1#101	0	48	ENST00000393087.9	1142	1190	+	48	0	0	3951
P01009-1#101	0	48	48	P01009-1	1095	1143	+	48	P01009-1	0	1254	ENST00000355814.8	277	1531	++	36	P01009-1#101	0	48	ENST00000355814.8	1372	1420	+	48	0	0	3952
P01009-1#102	0	9	9	P01009-1	1158	1167	+	9	P01009-1	0	1254	ENST00000636712.1	152	1406	++	236	P01009-1#102	0	9	ENST00000636712.1	1310	1319	+	9	0	0	3953
P01009-1#102	0	9	9	P01009-1	1158	1167	+	9	P01009-1	0	1254	ENST00000449399.7	302	1556	++	100	P01009-1#102	0	9	ENST00000449399.7	1460	1469	+	9	0	0	3954
P01009-1#102	0	9	9	P01009-1	1158	1167	+	9	P01009-1	0	1254	ENST00000448921.5	573	1827	++	98	P01009-1#102	0	9	ENST00000448921.5	1731	1740	+	9	0	0	3955
P01009-1#102	0	9	9	P01009-1	1158	1167	+	9	P01009-1	0	1254	ENST00000440909.5	185	1439	++	91	P01009-1#102	0	9	ENST00000440909.5	1343	1352	+	9	0	0	3956
P01009-1#102	0	9	9	P01009-1	1158	1167	+	9	P01009-1	0	1254	ENST00000437397.5	381	1635	++	89	P01009-1#102	0	9	ENST00000437397.5	1539	1548	+	9	0	0	3957
P01009-1#102	0	9	9	P01009-1	1158	1167	+	9	P01009-1	0	1254	ENST00000404814.8	311	1565	++	68	P01009-1#102	0	9	ENST00000404814.8	1469	1478	+	9	0	0	3958
P01009-1#102	0	9	9	P01009-1	1158	1167	+	9	P01009-1	0	1254	ENST00000393088.8	555	1809	++	63	P01009-1#102	0	9	ENST00000393088.8	1713	1722	+	9	0	0	3959
P01009-1#102	0	9	9	P01009-1	1158	1167	+	9	P01009-1	0	1254	ENST00000393087.9	47	1301	++	62	P01009-1#102	0	9	ENST00000393087.9	1205	1214	+	9	0	0	3960
P01009-1#102	0	9	9	P01009-1	1158	1167	+	9	P01009-1	0	1254	ENST00000355814.8	277	1531	++	36	P01009-1#102	0	9	ENST00000355814.8	1435	1444	+	9	0	0	3961
P01009-1#103	0	21	21	P01009-1	1179	1200	+	21	P01009-1	0	1254	ENST00000636712.1	152	1406	++	236	P01009-1#103	0	21	ENST00000636712.1	1331	1352	+	21	0	0	3962
P01009-1#103	0	21	21	P01009-1	1179	1200	+	21	P01009-1	0	1254	ENST00000449399.7	302	1556	++	100	P01009-1#103	0	21	ENST00000449399.7	1481	1502	+	21	0	0	3963
P01009-1#103	0	21	21	P01009-1	1179	1200	+	21	P01009-1	0	1254	ENST00000448921.5	573	1827	++	98	P01009-1#103	0	21	ENST00000448921.5	1752	1773	+	21	0	0	3964
P01009-1#103	0	21	21	P01009-1	1179	1200	+	21	P01009-1	0	1254	ENST00000440909.5	185	1439	++	91	P01009-1#103	0	21	ENST00000440909.5	1364	1385	+	21	0	0	3965
P01009-1#103	0	21	21	P01009-1	1179	1200	+	21	P01009-1	0	1254	ENST00000437397.5	381	1635	++	89	P01009-1#103	0	21	ENST00000437397.5	1560	1581	+	21	0	0	3966
P01009-1#103	0	21	21	P01009-1	1179	1200	+	21	P01009-1	0	1254	ENST00000404814.8	311	1565	++	68	P01009-1#103	0	21	ENST00000404814.8	1490	1511	+	21	0	0	3967
P01009-1#103	0	21	21	P01009-1	1179	1200	+	21	P01009-1	0	1254	ENST00000393088.8	555	1809	++	63	P01009-1#103	0	21	ENST00000393088.8	1734	1755	+	21	0	0	3968
P01009-1#103	0	21	21	P01009-1	1179	1200	+	21	P01009-1	0	1254	ENST00000393087.9	47	1301	++	62	P01009-1#103	0	21	ENST00000393087.9	1226	1247	+	21	0	0	3969
P01009-1#103	0	21	21	P01009-1	1179	1200	+	21	P01009-1	0	1254	ENST00000355814.8	277	1531	++	36	P01009-1#103	0	21	ENST00000355814.8	1456	1477	+	21	0	0	3970
P01009-1#104	0	9	9	P01009-1	1200	1209	+	9	P01009-1	0	1254	ENST00000636712.1	152	1406	++	236	P01009-1#104	0	9	ENST00000636712.1	1352	1361	+	9	0	0	3971
P01009-1#104	0	9	9	P01009-1	1200	1209	+	9	P01009-1	0	1254	ENST00000449399.7	302	1556	++	100	P01009-1#104	0	9	ENST00000449399.7	1502	1511	+	9	0	0	3972
P01009-1#104	0	9	9	P01009-1	1200	1209	+	9	P01009-1	0	1254	ENST00000448921.5	573	1827	++	98	P01009-1#104	0	9	ENST00000448921.5	1773	1782	+	9	0	0	3973
P01009-1#104	0	9	9	P01009-1	1200	1209	+	9	P01009-1	0	1254	ENST00000440909.5	185	1439	++	91	P01009-1#104	0	9	ENST00000440909.5	1385	1394	+	9	0	0	3974
P01009-1#104	0	9	9	P01009-1	1200	1209	+	9	P01009-1	0	1254	ENST00000437397.5	381	1635	++	89	P01009-1#104	0	9	ENST00000437397.5	1581	1590	+	9	0	0	3975
P01009-1#104	0	9	9	P01009-1	1200	1209	+	9	P01009-1	0	1254	ENST00000404814.8	311	1565	++	68	P01009-1#104	0	9	ENST00000404814.8	1511	1520	+	9	0	0	3976
P01009-1#104	0	9	9	P01009-1	1200	1209	+	9	P01009-1	0	1254	ENST00000393088.8	555	1809	++	63	P01009-1#104	0	9	ENST00000393088.8	1755	1764	+	9	0	0	3977
P01009-1#104	0	9	9	P01009-1	1200	1209	+	9	P01009-1	0	1254	ENST00000393087.9	47	1301	++	62	P01009-1#104	0	9	ENST00000393087.9	1247	1256	+	9	0	0	3978
P01009-1#104	0	9	9	P01009-1	1200	1209	+	9	P01009-1	0	1254	ENST00000355814.8	277	1531	++	36	P01009-1#104	0	9	ENST00000355814.8	1477	1486	+	9	0	0	3979
P01009-1#105	0	27	27	P01009-1	1215	1242	+	27	P01009-1	0	1254	ENST00000636712.1	152	1406	++	236	P01009-1#105	0	27	ENST00000636712.1	1367	1394	+	27	0	0	3980
P01009-1#105	0	27	27	P01009-1	1215	1242	+	27	P01009-1	0	1254	ENST00000449399.7	302	1556	++	100	P01009-1#105	0	27	ENST00000449399.7	1517	1544	+	27	0	0	3981
P01009-1#105	0	27	27	P01009-1	1215	1242	+	27	P01009-1	0	1254	ENST00000448921.5	573	1827	++	98	P01009-1#105	0	27	ENST00000448921.5	1788	1815	+	27	0	0	3982
P01009-1#105	0	27	27	P01009-1	1215	1242	+	27	P01009-1	0	1254	ENST00000440909.5	185	1439	++	91	P01009-1#105	0	27	ENST00000440909.5	1400	1427	+	27	0	0	3983
P01009-1#105	0	27	27	P01009-1	1215	1242	+	27	P01009-1	0	1254	ENST00000437397.5	381	1635	++	89	P01009-1#105	0	27	ENST00000437397.5	1596	1623	+	27	0	0	3984
P01009-1#105	0	27	27	P01009-1	1215	1242	+	27	P01009-1	0	1254	ENST00000404814.8	311	1565	++	68	P01009-1#105	0	27	ENST00000404814.8	1526	1553	+	27	0	0	3985
P01009-1#105	0	27	27	P01009-1	1215	1242	+	27	P01009-1	0	1254	ENST00000393088.8	555	1809	++	63	P01009-1#105	0	27	ENST00000393088.8	1770	1797	+	27	0	0	3986
P01009-1#105	0	27	27	P01009-1	1215	1242	+	27	P01009-1	0	1254	ENST00000393087.9	47	1301	++	62	P01009-1#105	0	27	ENST00000393087.9	1262	1289	+	27	0	0	3987
P01009-1#105	0	27	27	P01009-1	1215	1242	+	27	P01009-1	0	1254	ENST00000355814.8	277	1531	++	36	P01009-1#105	0	27	ENST00000355814.8	1492	1519	+	27	0	0	3988
Q99732-1#0	0	483	483	Q99732-1	0	483	+	483	Q99732-1	0	483	ENST00000622633.5	39	522	++	234	Q99732-1#0	0	483	ENST00000622633.5	39	522	+	483	0	0	3989
Q99732-1#0	0	483	483	Q99732-1	0	483	+	483	Q99732-1	0	9	ENST00000576334.1	547	556	+	192	Q99732-1#0	0	9	ENST00000576334.1	547	556	+	9	0	474	3990
Q99732-1#0	0	483	483	Q99732-1	0	483	+	483	Q99732-1	0	483	ENST00000576036.5	93	576	++	191	Q99732-1#0	0	483	ENST00000576036.5	93	576	+	483	0	0	3991
Q99732-1#0	0	483	483	Q99732-1	0	483	+	483	Q99732-1	0	174	ENST00000574848.5	380	554	+	190	Q99732-1#0	0	174	ENST00000574848.5	380	554	+	174	0	309	3992
Q99732-1#0	0	483	483	Q99732-1	0	483	+	483	Q99732-1	0	483	ENST00000574763.5	220	703	++	189	Q99732-1#0	0	483	ENST00000574763.5	220	703	+	483	0	0	3993
Q99732-1#0	0	483	483	Q99732-1	0	483	+	483	Q99732-1	0	220	ENST00000574703.5	39	259	+	188	Q99732-1#0	0	220	ENST00000574703.5	39	259	+	220	0	263	3994
Q99732-1#0	0	483	483	Q99732-1	0	483	+	483	Q99732-1	0	378	ENST00000574701.5	144	522	+	187	Q99732-1#0	0	378	ENST00000574701.5	144	522	+	378	0	105	3995
Q99732-1#0	0	483	483	Q99732-1	0	483	+	483	Q99732-1	0	220	ENST00000573332.5	39	259	+	186	Q99732-1#0	0	220	ENST00000573332.5	39	259	+	220	0	263	3996
Q99732-1#0	0	483	483	Q99732-1	0	483	+	483	Q99732-1	279	483	ENST00000572255.5	274	478	+	185	Q99732-1#0	279	483	ENST00000572255.5	274	478	+	204	279	0	3997
Q99732-1#0	0	483	483	Q99732-1	0	483	+	483	Q99732-1	0	377	ENST00000571976.1	61	438	+	184	Q99732-1#0	0	377	ENST00000571976.1	61	438	+	377	0	106	3998
Q99732-1#0	0	483	483	Q99732-1	0	483	+	483	Q99732-1	0	483	ENST00000571688.5	231	714	++	183	Q99732-1#0	0	483	ENST00000571688.5	231	714	+	483	0	0	3999
Q99732-1#0	0	483	483	Q99732-1	0	483	+	483	Q99732-1	0	461	ENST00000571627.5	118	579	+	182	Q99732-1#0	0	461	ENST00000571627.5	118	579	+	461	0	22	4000
Q99732-1#0	0	483	483	Q99732-1	0	483	+	483	Q99732-1	0	385	ENST00000571459.5	23	251	+	181	Q99732-1#0	0	385	ENST00000571459.5	23	251	+	228	0	98	4001
Q99732-1#0	0	483	483	Q99732-1	0	483	+	483	Q99732-1	0	119	ENST00000571277.1	468	587	+	180	Q99732-1#0	0	119	ENST00000571277.1	468	587	+	119	0	364	4002
Q99732-1#0	0	483	483	Q99732-1	0	483	+	483	Q99732-1	0	483	ENST00000570904.5	102	585	++	179	Q99732-1#0	0	483	ENST00000570904.5	102	585	+	483	0	0	4003
Q99732-1#0	0	483	483	Q99732-1	0	483	+	483	Q99732-1	0	412	ENST00000570798.5	181	593	+	178	Q99732-1#0	0	412	ENST00000570798.5	181	593	+	412	0	71	4004
Q99732-1#0	0	483	483	Q99732-1	0	483	+	483	Q99732-1	0	378	ENST00000413364.6	70	448	++	74	Q99732-1#0	0	378	ENST00000413364.6	70	448	+	378	0	105	4005
Q99732-1#0	0	483	483	Q99732-1	0	483	+	483	Q99732-1	0	483	ENST00000339430.9	233	716	++	31	Q99732-1#0	0	483	ENST00000339430.9	233	716	+	483	0	0	4006
Q99732-1#1	0	255	255	Q99732-1	225	480	+	255	Q99732-1	0	483	ENST00000622633.5	39	522	++	234	Q99732-1#1	0	255	ENST00000622633.5	264	519	+	255	0	0	4007
Q99732-1#1	0	255	255	Q99732-1	225	480	+	255	Q99732-1	0	483	ENST00000576036.5	93	576	++	191	Q99732-1#1	0	255	ENST00000576036.5	318	573	+	255	0	0	4008
Q99732-1#1	0	255	255	Q99732-1	225	480	+	255	Q99732-1	0	483	ENST00000574763.5	220	703	++	189	Q99732-1#1	0	255	ENST00000574763.5	445	700	+	255	0	0	4009
Q99732-1#1	0	255	255	Q99732-1	225	480	+	255	Q99732-1	0	378	ENST00000574701.5	144	522	+	187	Q99732-1#1	0	153	ENST00000574701.5	369	522	+	153	0	102	4010
Q99732-1#1	0	255	255	Q99732-1	225	480	+	255	Q99732-1	279	483	ENST00000572255.5	274	478	+	185	Q99732-1#1	54	255	ENST00000572255.5	274	475	+	201	54	0	4011
Q99732-1#1	0	255	255	Q99732-1	225	480	+	255	Q99732-1	0	377	ENST00000571976.1	61	438	+	184	Q99732-1#1	0	152	ENST00000571976.1	286	438	+	152	0	103	4012
Q99732-1#1	0	255	255	Q99732-1	225	480	+	255	Q99732-1	0	483	ENST00000571688.5	231	714	++	183	Q99732-1#1	0	255	ENST00000571688.5	456	711	+	255	0	0	4013
Q99732-1#1	0	255	255	Q99732-1	225	480	+	255	Q99732-1	0	461	ENST00000571627.5	118	579	+	182	Q99732-1#1	0	236	ENST00000571627.5	343	579	+	236	0	19	4014
Q99732-1#1	0	255	255	Q99732-1	225	480	+	255	Q99732-1	0	385	ENST00000571459.5	23	251	+	181	Q99732-1#1	152	160	ENST00000571459.5	243	251	+	8	152	95	4015
Q99732-1#1	0	255	255	Q99732-1	225	480	+	255	Q99732-1	0	483	ENST00000570904.5	102	585	++	179	Q99732-1#1	0	255	ENST00000570904.5	327	582	+	255	0	0	4016
Q99732-1#1	0	255	255	Q99732-1	225	480	+	255	Q99732-1	0	412	ENST00000570798.5	181	593	+	178	Q99732-1#1	0	187	ENST00000570798.5	406	593	+	187	0	68	4017
Q99732-1#1	0	255	255	Q99732-1	225	480	+	255	Q99732-1	0	378	ENST00000413364.6	70	448	++	74	Q99732-1#1	0	153	ENST00000413364.6	295	448	+	153	0	102	4018
Q99732-1#1	0	255	255	Q99732-1	225	480	+	255	Q99732-1	0	483	ENST00000339430.9	233	716	++	31	Q99732-1#1	0	255	ENST00000339430.9	458	713	+	255	0	0	4019
Q99732-1#2	0	66	66	Q99732-1	0	66	+	66	Q99732-1	0	483	ENST00000622633.5	39	522	++	234	Q99732-1#2	0	66	ENST00000622633.5	39	105	+	66	0	0	4020
Q99732-1#2	0	66	66	Q99732-1	0	66	+	66	Q99732-1	0	9	ENST00000576334.1	547	556	+	192	Q99732-1#2	0	9	ENST00000576334.1	547	556	+	9	0	57	4021
Q99732-1#2	0	66	66	Q99732-1	0	66	+	66	Q99732-1	0	483	ENST00000576036.5	93	576	++	191	Q99732-1#2	0	66	ENST00000576036.5	93	159	+	66	0	0	4022
Q99732-1#2	0	66	66	Q99732-1	0	66	+	66	Q99732-1	0	174	ENST00000574848.5	380	554	+	190	Q99732-1#2	0	66	ENST00000574848.5	380	446	+	66	0	0	4023
Q99732-1#2	0	66	66	Q99732-1	0	66	+	66	Q99732-1	0	483	ENST00000574763.5	220	703	++	189	Q99732-1#2	0	66	ENST00000574763.5	220	286	+	66	0	0	4024
Q99732-1#2	0	66	66	Q99732-1	0	66	+	66	Q99732-1	0	220	ENST00000574703.5	39	259	+	188	Q99732-1#2	0	66	ENST00000574703.5	39	105	+	66	0	0	4025
Q99732-1#2	0	66	66	Q99732-1	0	66	+	66	Q99732-1	0	378	ENST00000574701.5	144	522	+	187	Q99732-1#2	0	66	ENST00000574701.5	144	210	+	66	0	0	4026
Q99732-1#2	0	66	66	Q99732-1	0	66	+	66	Q99732-1	0	220	ENST00000573332.5	39	259	+	186	Q99732-1#2	0	66	ENST00000573332.5	39	105	+	66	0	0	4027
Q99732-1#2	0	66	66	Q99732-1	0	66	+	66	Q99732-1	0	377	ENST00000571976.1	61	438	+	184	Q99732-1#2	0	66	ENST00000571976.1	61	127	+	66	0	0	4028
Q99732-1#2	0	66	66	Q99732-1	0	66	+	66	Q99732-1	0	483	ENST00000571688.5	231	714	++	183	Q99732-1#2	0	66	ENST00000571688.5	231	297	+	66	0	0	4029
Q99732-1#2	0	66	66	Q99732-1	0	66	+	66	Q99732-1	0	461	ENST00000571627.5	118	579	+	182	Q99732-1#2	0	66	ENST00000571627.5	118	184	+	66	0	0	4030
Q99732-1#2	0	66	66	Q99732-1	0	66	+	66	Q99732-1	0	385	ENST00000571459.5	23	251	+	181	Q99732-1#2	0	66	ENST00000571459.5	23	89	+	66	0	0	4031
Q99732-1#2	0	66	66	Q99732-1	0	66	+	66	Q99732-1	0	119	ENST00000571277.1	468	587	+	180	Q99732-1#2	0	66	ENST00000571277.1	468	534	+	66	0	0	4032
Q99732-1#2	0	66	66	Q99732-1	0	66	+	66	Q99732-1	0	483	ENST00000570904.5	102	585	++	179	Q99732-1#2	0	66	ENST00000570904.5	102	168	+	66	0	0	4033
Q99732-1#2	0	66	66	Q99732-1	0	66	+	66	Q99732-1	0	412	ENST00000570798.5	181	593	+	178	Q99732-1#2	0	66	ENST00000570798.5	181	247	+	66	0	0	4034
Q99732-1#2	0	66	66	Q99732-1	0	66	+	66	Q99732-1	0	378	ENST00000413364.6	70	448	++	74	Q99732-1#2	0	66	ENST00000413364.6	70	136	+	66	0	0	4035
Q99732-1#2	0	66	66	Q99732-1	0	66	+	66	Q99732-1	0	483	ENST00000339430.9	233	716	++	31	Q99732-1#2	0	66	ENST00000339430.9	233	299	+	66	0	0	4036
Q99732-1#3	0	72	72	Q99732-1	330	402	+	72	Q99732-1	0	483	ENST00000622633.5	39	522	++	234	Q99732-1#3	0	72	ENST00000622633.5	369	441	+	72	0	0	4037
Q99732-1#3	0	72	72	Q99732-1	330	402	+	72	Q99732-1	0	483	ENST00000576036.5	93	576	++	191	Q99732-1#3	0	72	ENST00000576036.5	423	495	+	72	0	0	4038
Q99732-1#3	0	72	72	Q99732-1	330	402	+	72	Q99732-1	0	483	ENST00000574763.5	220	703	++	189	Q99732-1#3	0	72	ENST00000574763.5	550	622	+	72	0	0	4039
Q99732-1#3	0	72	72	Q99732-1	330	402	+	72	Q99732-1	0	378	ENST00000574701.5	144	522	+	187	Q99732-1#3	0	48	ENST00000574701.5	474	522	+	48	0	24	4040
Q99732-1#3	0	72	72	Q99732-1	330	402	+	72	Q99732-1	279	483	ENST00000572255.5	274	478	+	185	Q99732-1#3	0	72	ENST00000572255.5	325	397	+	72	0	0	4041
Q99732-1#3	0	72	72	Q99732-1	330	402	+	72	Q99732-1	0	377	ENST00000571976.1	61	438	+	184	Q99732-1#3	0	47	ENST00000571976.1	391	438	+	47	0	25	4042
Q99732-1#3	0	72	72	Q99732-1	330	402	+	72	Q99732-1	0	483	ENST00000571688.5	231	714	++	183	Q99732-1#3	0	72	ENST00000571688.5	561	633	+	72	0	0	4043
Q99732-1#3	0	72	72	Q99732-1	330	402	+	72	Q99732-1	0	461	ENST00000571627.5	118	579	+	182	Q99732-1#3	0	72	ENST00000571627.5	448	520	+	72	0	0	4044
Q99732-1#3	0	72	72	Q99732-1	330	402	+	72	Q99732-1	0	385	ENST00000571459.5	23	251	+	181	Q99732-1#3	47	55	ENST00000571459.5	243	251	+	8	47	17	4045
Q99732-1#3	0	72	72	Q99732-1	330	402	+	72	Q99732-1	0	483	ENST00000570904.5	102	585	++	179	Q99732-1#3	0	72	ENST00000570904.5	432	504	+	72	0	0	4046
Q99732-1#3	0	72	72	Q99732-1	330	402	+	72	Q99732-1	0	412	ENST00000570798.5	181	593	+	178	Q99732-1#3	0	72	ENST00000570798.5	511	583	+	72	0	0	4047
Q99732-1#3	0	72	72	Q99732-1	330	402	+	72	Q99732-1	0	378	ENST00000413364.6	70	448	++	74	Q99732-1#3	0	48	ENST00000413364.6	400	448	+	48	0	24	4048
Q99732-1#3	0	72	72	Q99732-1	330	402	+	72	Q99732-1	0	483	ENST00000339430.9	233	716	++	31	Q99732-1#3	0	72	ENST00000339430.9	563	635	+	72	0	0	4049
Q99732-1#4	0	12	12	Q99732-1	48	60	+	12	Q99732-1	0	483	ENST00000622633.5	39	522	++	234	Q99732-1#4	0	12	ENST00000622633.5	87	99	+	12	0	0	4050
Q99732-1#4	0	12	12	Q99732-1	48	60	+	12	Q99732-1	0	483	ENST00000576036.5	93	576	++	191	Q99732-1#4	0	12	ENST00000576036.5	141	153	+	12	0	0	4051
Q99732-1#4	0	12	12	Q99732-1	48	60	+	12	Q99732-1	0	174	ENST00000574848.5	380	554	+	190	Q99732-1#4	0	12	ENST00000574848.5	428	440	+	12	0	0	4052
Q99732-1#4	0	12	12	Q99732-1	48	60	+	12	Q99732-1	0	483	ENST00000574763.5	220	703	++	189	Q99732-1#4	0	12	ENST00000574763.5	268	280	+	12	0	0	4053
Q99732-1#4	0	12	12	Q99732-1	48	60	+	12	Q99732-1	0	220	ENST00000574703.5	39	259	+	188	Q99732-1#4	0	12	ENST00000574703.5	87	99	+	12	0	0	4054
Q99732-1#4	0	12	12	Q99732-1	48	60	+	12	Q99732-1	0	378	ENST00000574701.5	144	522	+	187	Q99732-1#4	0	12	ENST00000574701.5	192	204	+	12	0	0	4055
Q99732-1#4	0	12	12	Q99732-1	48	60	+	12	Q99732-1	0	220	ENST00000573332.5	39	259	+	186	Q99732-1#4	0	12	ENST00000573332.5	87	99	+	12	0	0	4056
Q99732-1#4	0	12	12	Q99732-1	48	60	+	12	Q99732-1	0	377	ENST00000571976.1	61	438	+	184	Q99732-1#4	0	12	ENST00000571976.1	109	121	+	12	0	0	4057
Q99732-1#4	0	12	12	Q99732-1	48	60	+	12	Q99732-1	0	483	ENST00000571688.5	231	714	++	183	Q99732-1#4	0	12	ENST00000571688.5	279	291	+	12	0	0	4058
Q99732-1#4	0	12	12	Q99732-1	48	60	+	12	Q99732-1	0	461	ENST00000571627.5	118	579	+	182	Q99732-1#4	0	12	ENST00000571627.5	166	178	+	12	0	0	4059
Q99732-1#4	0	12	12	Q99732-1	48	60	+	12	Q99732-1	0	385	ENST00000571459.5	23	251	+	181	Q99732-1#4	0	12	ENST00000571459.5	71	83	+	12	0	0	4060
Q99732-1#4	0	12	12	Q99732-1	48	60	+	12	Q99732-1	0	119	ENST00000571277.1	468	587	+	180	Q99732-1#4	0	12	ENST00000571277.1	516	528	+	12	0	0	4061
Q99732-1#4	0	12	12	Q99732-1	48	60	+	12	Q99732-1	0	483	ENST00000570904.5	102	585	++	179	Q99732-1#4	0	12	ENST00000570904.5	150	162	+	12	0	0	4062
Q99732-1#4	0	12	12	Q99732-1	48	60	+	12	Q99732-1	0	412	ENST00000570798.5	181	593	+	178	Q99732-1#4	0	12	ENST00000570798.5	229	241	+	12	0	0	4063
Q99732-1#4	0	12	12	Q99732-1	48	60	+	12	Q99732-1	0	378	ENST00000413364.6	70	448	++	74	Q99732-1#4	0	12	ENST00000413364.6	118	130	+	12	0	0	4064
Q99732-1#4	0	12	12	Q99732-1	48	60	+	12	Q99732-1	0	483	ENST00000339430.9	233	716	++	31	Q99732-1#4	0	12	ENST00000339430.9	281	293	+	12	0	0	4065
Q99732-1#5	0	12	12	Q99732-1	57	69	+	12	Q99732-1	0	483	ENST00000622633.5	39	522	++	234	Q99732-1#5	0	12	ENST00000622633.5	96	108	+	12	0	0	4066
Q99732-1#5	0	12	12	Q99732-1	57	69	+	12	Q99732-1	0	483	ENST00000576036.5	93	576	++	191	Q99732-1#5	0	12	ENST00000576036.5	150	162	+	12	0	0	4067
Q99732-1#5	0	12	12	Q99732-1	57	69	+	12	Q99732-1	0	174	ENST00000574848.5	380	554	+	190	Q99732-1#5	0	12	ENST00000574848.5	437	449	+	12	0	0	4068
Q99732-1#5	0	12	12	Q99732-1	57	69	+	12	Q99732-1	0	483	ENST00000574763.5	220	703	++	189	Q99732-1#5	0	12	ENST00000574763.5	277	289	+	12	0	0	4069
Q99732-1#5	0	12	12	Q99732-1	57	69	+	12	Q99732-1	0	220	ENST00000574703.5	39	259	+	188	Q99732-1#5	0	12	ENST00000574703.5	96	108	+	12	0	0	4070
Q99732-1#5	0	12	12	Q99732-1	57	69	+	12	Q99732-1	0	378	ENST00000574701.5	144	522	+	187	Q99732-1#5	0	12	ENST00000574701.5	201	213	+	12	0	0	4071
Q99732-1#5	0	12	12	Q99732-1	57	69	+	12	Q99732-1	0	220	ENST00000573332.5	39	259	+	186	Q99732-1#5	0	12	ENST00000573332.5	96	108	+	12	0	0	4072
Q99732-1#5	0	12	12	Q99732-1	57	69	+	12	Q99732-1	0	377	ENST00000571976.1	61	438	+	184	Q99732-1#5	0	12	ENST00000571976.1	118	130	+	12	0	0	4073
Q99732-1#5	0	12	12	Q99732-1	57	69	+	12	Q99732-1	0	483	ENST00000571688.5	231	714	++	183	Q99732-1#5	0	12	ENST00000571688.5	288	300	+	12	0	0	4074
Q99732-1#5	0	12	12	Q99732-1	57	69	+	12	Q99732-1	0	461	ENST00000571627.5	118	579	+	182	Q99732-1#5	0	12	ENST00000571627.5	175	187	+	12	0	0	4075
Q99732-1#5	0	12	12	Q99732-1	57	69	+	12	Q99732-1	0	385	ENST00000571459.5	23	251	+	181	Q99732-1#5	0	12	ENST00000571459.5	80	92	+	12	0	0	4076
Q99732-1#5	0	12	12	Q99732-1	57	69	+	12	Q99732-1	0	119	ENST00000571277.1	468	587	+	180	Q99732-1#5	0	12	ENST00000571277.1	525	537	+	12	0	0	4077
Q99732-1#5	0	12	12	Q99732-1	57	69	+	12	Q99732-1	0	483	ENST00000570904.5	102	585	++	179	Q99732-1#5	0	12	ENST00000570904.5	159	171	+	12	0	0	4078
Q99732-1#5	0	12	12	Q99732-1	57	69	+	12	Q99732-1	0	412	ENST00000570798.5	181	593	+	178	Q99732-1#5	0	12	ENST00000570798.5	238	250	+	12	0	0	4079
Q99732-1#5	0	12	12	Q99732-1	57	69	+	12	Q99732-1	0	378	ENST00000413364.6	70	448	++	74	Q99732-1#5	0	12	ENST00000413364.6	127	139	+	12	0	0	4080
Q99732-1#5	0	12	12	Q99732-1	57	69	+	12	Q99732-1	0	483	ENST00000339430.9	233	716	++	31	Q99732-1#5	0	12	ENST00000339430.9	290	302	+	12	0	0	4081
Q99732-1#6	0	48	48	Q99732-1	18	66	+	48	Q99732-1	0	483	ENST00000622633.5	39	522	++	234	Q99732-1#6	0	48	ENST00000622633.5	57	105	+	48	0	0	4082
Q99732-1#6	0	48	48	Q99732-1	18	66	+	48	Q99732-1	0	483	ENST00000576036.5	93	576	++	191	Q99732-1#6	0	48	ENST00000576036.5	111	159	+	48	0	0	4083
Q99732-1#6	0	48	48	Q99732-1	18	66	+	48	Q99732-1	0	174	ENST00000574848.5	380	554	+	190	Q99732-1#6	0	48	ENST00000574848.5	398	446	+	48	0	0	4084
Q99732-1#6	0	48	48	Q99732-1	18	66	+	48	Q99732-1	0	483	ENST00000574763.5	220	703	++	189	Q99732-1#6	0	48	ENST00000574763.5	238	286	+	48	0	0	4085
Q99732-1#6	0	48	48	Q99732-1	18	66	+	48	Q99732-1	0	220	ENST00000574703.5	39	259	+	188	Q99732-1#6	0	48	ENST00000574703.5	57	105	+	48	0	0	4086
Q99732-1#6	0	48	48	Q99732-1	18	66	+	48	Q99732-1	0	378	ENST00000574701.5	144	522	+	187	Q99732-1#6	0	48	ENST00000574701.5	162	210	+	48	0	0	4087
Q99732-1#6	0	48	48	Q99732-1	18	66	+	48	Q99732-1	0	220	ENST00000573332.5	39	259	+	186	Q99732-1#6	0	48	ENST00000573332.5	57	105	+	48	0	0	4088
Q99732-1#6	0	48	48	Q99732-1	18	66	+	48	Q99732-1	0	377	ENST00000571976.1	61	438	+	184	Q99732-1#6	0	48	ENST00000571976.1	79	127	+	48	0	0	4089
Q99732-1#6	0	48	48	Q99732-1	18	66	+	48	Q99732-1	0	483	ENST00000571688.5	231	714	++	183	Q99732-1#6	0	48	ENST00000571688.5	249	297	+	48	0	0	4090
Q99732-1#6	0	48	48	Q99732-1	18	66	+	48	Q99732-1	0	461	ENST00000571627.5	118	579	+	182	Q99732-1#6	0	48	ENST00000571627.5	136	184	+	48	0	0	4091
Q99732-1#6	0	48	48	Q99732-1	18	66	+	48	Q99732-1	0	385	ENST00000571459.5	23	251	+	181	Q99732-1#6	0	48	ENST00000571459.5	41	89	+	48	0	0	4092
Q99732-1#6	0	48	48	Q99732-1	18	66	+	48	Q99732-1	0	119	ENST00000571277.1	468	587	+	180	Q99732-1#6	0	48	ENST00000571277.1	486	534	+	48	0	0	4093
Q99732-1#6	0	48	48	Q99732-1	18	66	+	48	Q99732-1	0	483	ENST00000570904.5	102	585	++	179	Q99732-1#6	0	48	ENST00000570904.5	120	168	+	48	0	0	4094
Q99732-1#6	0	48	48	Q99732-1	18	66	+	48	Q99732-1	0	412	ENST00000570798.5	181	593	+	178	Q99732-1#6	0	48	ENST00000570798.5	199	247	+	48	0	0	4095
Q99732-1#6	0	48	48	Q99732-1	18	66	+	48	Q99732-1	0	378	ENST00000413364.6	70	448	++	74	Q99732-1#6	0	48	ENST00000413364.6	88	136	+	48	0	0	4096
Q99732-1#6	0	48	48	Q99732-1	18	66	+	48	Q99732-1	0	483	ENST00000339430.9	233	716	++	31	Q99732-1#6	0	48	ENST00000339430.9	251	299	+	48	0	0	4097
Q99732-1#7	0	3	3	Q99732-1	285	288	+	3	Q99732-1	0	483	ENST00000622633.5	39	522	++	234	Q99732-1#7	0	3	ENST00000622633.5	324	327	+	3	0	0	4098
Q99732-1#7	0	3	3	Q99732-1	285	288	+	3	Q99732-1	0	483	ENST00000576036.5	93	576	++	191	Q99732-1#7	0	3	ENST00000576036.5	378	381	+	3	0	0	4099
Q99732-1#7	0	3	3	Q99732-1	285	288	+	3	Q99732-1	0	483	ENST00000574763.5	220	703	++	189	Q99732-1#7	0	3	ENST00000574763.5	505	508	+	3	0	0	4100
Q99732-1#7	0	3	3	Q99732-1	285	288	+	3	Q99732-1	0	378	ENST00000574701.5	144	522	+	187	Q99732-1#7	0	3	ENST00000574701.5	429	432	+	3	0	0	4101
Q99732-1#7	0	3	3	Q99732-1	285	288	+	3	Q99732-1	279	483	ENST00000572255.5	274	478	+	185	Q99732-1#7	0	3	ENST00000572255.5	280	283	+	3	0	0	4102
Q99732-1#7	0	3	3	Q99732-1	285	288	+	3	Q99732-1	0	377	ENST00000571976.1	61	438	+	184	Q99732-1#7	0	3	ENST00000571976.1	346	349	+	3	0	0	4103
Q99732-1#7	0	3	3	Q99732-1	285	288	+	3	Q99732-1	0	483	ENST00000571688.5	231	714	++	183	Q99732-1#7	0	3	ENST00000571688.5	516	519	+	3	0	0	4104
Q99732-1#7	0	3	3	Q99732-1	285	288	+	3	Q99732-1	0	461	ENST00000571627.5	118	579	+	182	Q99732-1#7	0	3	ENST00000571627.5	403	406	+	3	0	0	4105
Q99732-1#7	0	3	3	Q99732-1	285	288	+	3	Q99732-1	0	483	ENST00000570904.5	102	585	++	179	Q99732-1#7	0	3	ENST00000570904.5	387	390	+	3	0	0	4106
Q99732-1#7	0	3	3	Q99732-1	285	288	+	3	Q99732-1	0	412	ENST00000570798.5	181	593	+	178	Q99732-1#7	0	3	ENST00000570798.5	466	469	+	3	0	0	4107
Q99732-1#7	0	3	3	Q99732-1	285	288	+	3	Q99732-1	0	378	ENST00000413364.6	70	448	++	74	Q99732-1#7	0	3	ENST00000413364.6	355	358	+	3	0	0	4108
Q99732-1#7	0	3	3	Q99732-1	285	288	+	3	Q99732-1	0	483	ENST00000339430.9	233	716	++	31	Q99732-1#7	0	3	ENST00000339430.9	518	521	+	3	0	0	4109
Q99732-1#8	0	3	3	Q99732-1	294	297	+	3	Q99732-1	0	483	ENST00000622633.5	39	522	++	234	Q99732-1#8	0	3	ENST00000622633.5	333	336	+	3	0	0	4110
Q99732-1#8	0	3	3	Q99732-1	294	297	+	3	Q99732-1	0	483	ENST00000576036.5	93	576	++	191	Q99732-1#8	0	3	ENST00000576036.5	387	390	+	3	0	0	4111
Q99732-1#8	0	3	3	Q99732-1	294	297	+	3	Q99732-1	0	483	ENST00000574763.5	220	703	++	189	Q99732-1#8	0	3	ENST00000574763.5	514	517	+	3	0	0	4112
Q99732-1#8	0	3	3	Q99732-1	294	297	+	3	Q99732-1	0	378	ENST00000574701.5	144	522	+	187	Q99732-1#8	0	3	ENST00000574701.5	438	441	+	3	0	0	4113
Q99732-1#8	0	3	3	Q99732-1	294	297	+	3	Q99732-1	279	483	ENST00000572255.5	274	478	+	185	Q99732-1#8	0	3	ENST00000572255.5	289	292	+	3	0	0	4114
Q99732-1#8	0	3	3	Q99732-1	294	297	+	3	Q99732-1	0	377	ENST00000571976.1	61	438	+	184	Q99732-1#8	0	3	ENST00000571976.1	355	358	+	3	0	0	4115
Q99732-1#8	0	3	3	Q99732-1	294	297	+	3	Q99732-1	0	483	ENST00000571688.5	231	714	++	183	Q99732-1#8	0	3	ENST00000571688.5	525	528	+	3	0	0	4116
Q99732-1#8	0	3	3	Q99732-1	294	297	+	3	Q99732-1	0	461	ENST00000571627.5	118	579	+	182	Q99732-1#8	0	3	ENST00000571627.5	412	415	+	3	0	0	4117
Q99732-1#8	0	3	3	Q99732-1	294	297	+	3	Q99732-1	0	483	ENST00000570904.5	102	585	++	179	Q99732-1#8	0	3	ENST00000570904.5	396	399	+	3	0	0	4118
Q99732-1#8	0	3	3	Q99732-1	294	297	+	3	Q99732-1	0	412	ENST00000570798.5	181	593	+	178	Q99732-1#8	0	3	ENST00000570798.5	475	478	+	3	0	0	4119
Q99732-1#8	0	3	3	Q99732-1	294	297	+	3	Q99732-1	0	378	ENST00000413364.6	70	448	++	74	Q99732-1#8	0	3	ENST00000413364.6	364	367	+	3	0	0	4120
Q99732-1#8	0	3	3	Q99732-1	294	297	+	3	Q99732-1	0	483	ENST00000339430.9	233	716	++	31	Q99732-1#8	0	3	ENST00000339430.9	527	530	+	3	0	0	4121
Q99732-1#9	0	3	3	Q99732-1	441	444	+	3	Q99732-1	0	483	ENST00000622633.5	39	522	++	234	Q99732-1#9	0	3	ENST00000622633.5	480	483	+	3	0	0	4122
Q99732-1#9	0	3	3	Q99732-1	441	444	+	3	Q99732-1	0	483	ENST00000576036.5	93	576	++	191	Q99732-1#9	0	3	ENST00000576036.5	534	537	+	3	0	0	4123
Q99732-1#9	0	3	3	Q99732-1	441	444	+	3	Q99732-1	0	483	ENST00000574763.5	220	703	++	189	Q99732-1#9	0	3	ENST00000574763.5	661	664	+	3	0	0	4124
Q99732-1#9	0	3	3	Q99732-1	441	444	+	3	Q99732-1	279	483	ENST00000572255.5	274	478	+	185	Q99732-1#9	0	3	ENST00000572255.5	436	439	+	3	0	0	4125
Q99732-1#9	0	3	3	Q99732-1	441	444	+	3	Q99732-1	0	483	ENST00000571688.5	231	714	++	183	Q99732-1#9	0	3	ENST00000571688.5	672	675	+	3	0	0	4126
Q99732-1#9	0	3	3	Q99732-1	441	444	+	3	Q99732-1	0	461	ENST00000571627.5	118	579	+	182	Q99732-1#9	0	3	ENST00000571627.5	559	562	+	3	0	0	4127
Q99732-1#9	0	3	3	Q99732-1	441	444	+	3	Q99732-1	0	483	ENST00000570904.5	102	585	++	179	Q99732-1#9	0	3	ENST00000570904.5	543	546	+	3	0	0	4128
Q99732-1#9	0	3	3	Q99732-1	441	444	+	3	Q99732-1	0	483	ENST00000339430.9	233	716	++	31	Q99732-1#9	0	3	ENST00000339430.9	674	677	+	3	0	0	4129
Q99732-1#10	0	3	3	Q99732-1	450	453	+	3	Q99732-1	0	483	ENST00000622633.5	39	522	++	234	Q99732-1#10	0	3	ENST00000622633.5	489	492	+	3	0	0	4130
Q99732-1#10	0	3	3	Q99732-1	450	453	+	3	Q99732-1	0	483	ENST00000576036.5	93	576	++	191	Q99732-1#10	0	3	ENST00000576036.5	543	546	+	3	0	0	4131
Q99732-1#10	0	3	3	Q99732-1	450	453	+	3	Q99732-1	0	483	ENST00000574763.5	220	703	++	189	Q99732-1#10	0	3	ENST00000574763.5	670	673	+	3	0	0	4132
Q99732-1#10	0	3	3	Q99732-1	450	453	+	3	Q99732-1	279	483	ENST00000572255.5	274	478	+	185	Q99732-1#10	0	3	ENST00000572255.5	445	448	+	3	0	0	4133
Q99732-1#10	0	3	3	Q99732-1	450	453	+	3	Q99732-1	0	483	ENST00000571688.5	231	714	++	183	Q99732-1#10	0	3	ENST00000571688.5	681	684	+	3	0	0	4134
Q99732-1#10	0	3	3	Q99732-1	450	453	+	3	Q99732-1	0	461	ENST00000571627.5	118	579	+	182	Q99732-1#10	0	3	ENST00000571627.5	568	571	+	3	0	0	4135
Q99732-1#10	0	3	3	Q99732-1	450	453	+	3	Q99732-1	0	483	ENST00000570904.5	102	585	++	179	Q99732-1#10	0	3	ENST00000570904.5	552	555	+	3	0	0	4136
Q99732-1#10	0	3	3	Q99732-1	450	453	+	3	Q99732-1	0	483	ENST00000339430.9	233	716	++	31	Q99732-1#10	0	3	ENST00000339430.9	683	686	+	3	0	0	4137
Q99732-1#11	0	105	105	Q99732-1	378	483	+	105	Q99732-1	0	483	ENST00000622633.5	39	522	++	234	Q99732-1#11	0	105	ENST00000622633.5	417	522	+	105	0	0	4138
Q99732-1#11	0	105	105	Q99732-1	378	483	+	105	Q99732-1	0	483	ENST00000576036.5	93	576	++	191	Q99732-1#11	0	105	ENST00000576036.5	471	576	+	105	0	0	4139
Q99732-1#11	0	105	105	Q99732-1	378	483	+	105	Q99732-1	0	483	ENST00000574763.5	220	703	++	189	Q99732-1#11	0	105	ENST00000574763.5	598	703	+	105	0	0	4140
Q99732-1#11	0	105	105	Q99732-1	378	483	+	105	Q99732-1	279	483	ENST00000572255.5	274	478	+	185	Q99732-1#11	0	105	ENST00000572255.5	373	478	+	105	0	0	4141
Q99732-1#11	0	105	105	Q99732-1	378	483	+	105	Q99732-1	0	483	ENST00000571688.5	231	714	++	183	Q99732-1#11	0	105	ENST00000571688.5	609	714	+	105	0	0	4142
Q99732-1#11	0	105	105	Q99732-1	378	483	+	105	Q99732-1	0	461	ENST00000571627.5	118	579	+	182	Q99732-1#11	0	83	ENST00000571627.5	496	579	+	83	0	22	4143
Q99732-1#11	0	105	105	Q99732-1	378	483	+	105	Q99732-1	0	385	ENST00000571459.5	23	251	+	181	Q99732-1#11	0	7	ENST00000571459.5	244	251	+	7	0	98	4144
Q99732-1#11	0	105	105	Q99732-1	378	483	+	105	Q99732-1	0	483	ENST00000570904.5	102	585	++	179	Q99732-1#11	0	105	ENST00000570904.5	480	585	+	105	0	0	4145
Q99732-1#11	0	105	105	Q99732-1	378	483	+	105	Q99732-1	0	412	ENST00000570798.5	181	593	+	178	Q99732-1#11	0	34	ENST00000570798.5	559	593	+	34	0	71	4146
Q99732-1#11	0	105	105	Q99732-1	378	483	+	105	Q99732-1	0	483	ENST00000339430.9	233	716	++	31	Q99732-1#11	0	105	ENST00000339430.9	611	716	+	105	0	0	4147
Q99732-1#12	0	105	105	Q99732-1	378	483	+	105	Q99732-1	0	483	ENST00000622633.5	39	522	++	234	Q99732-1#12	0	105	ENST00000622633.5	417	522	+	105	0	0	4148
Q99732-1#12	0	105	105	Q99732-1	378	483	+	105	Q99732-1	0	483	ENST00000576036.5	93	576	++	191	Q99732-1#12	0	105	ENST00000576036.5	471	576	+	105	0	0	4149
Q99732-1#12	0	105	105	Q99732-1	378	483	+	105	Q99732-1	0	483	ENST00000574763.5	220	703	++	189	Q99732-1#12	0	105	ENST00000574763.5	598	703	+	105	0	0	4150
Q99732-1#12	0	105	105	Q99732-1	378	483	+	105	Q99732-1	279	483	ENST00000572255.5	274	478	+	185	Q99732-1#12	0	105	ENST00000572255.5	373	478	+	105	0	0	4151
Q99732-1#12	0	105	105	Q99732-1	378	483	+	105	Q99732-1	0	483	ENST00000571688.5	231	714	++	183	Q99732-1#12	0	105	ENST00000571688.5	609	714	+	105	0	0	4152
Q99732-1#12	0	105	105	Q99732-1	378	483	+	105	Q99732-1	0	461	ENST00000571627.5	118	579	+	182	Q99732-1#12	0	83	ENST00000571627.5	496	579	+	83	0	22	4153
Q99732-1#12	0	105	105	Q99732-1	378	483	+	105	Q99732-1	0	385	ENST00000571459.5	23	251	+	181	Q99732-1#12	0	7	ENST00000571459.5	244	251	+	7	0	98	4154
Q99732-1#12	0	105	105	Q99732-1	378	483	+	105	Q99732-1	0	483	ENST00000570904.5	102	585	++	179	Q99732-1#12	0	105	ENST00000570904.5	480	585	+	105	0	0	4155
Q99732-1#12	0	105	105	Q99732-1	378	483	+	105	Q99732-1	0	412	ENST00000570798.5	181	593	+	178	Q99732-1#12	0	34	ENST00000570798.5	559	593	+	34	0	71	4156
Q99732-1#12	0	105	105	Q99732-1	378	483	+	105	Q99732-1	0	483	ENST00000339430.9	233	716	++	31	Q99732-1#12	0	105	ENST00000339430.9	611	716	+	105	0	0	4157
Q99732-1#13	0	3	3	Q99732-1	66	69	+	3	Q99732-1	0	483	ENST00000622633.5	39	522	++	234	Q99732-1#13	0	3	ENST00000622633.5	105	108	+	3	0	0	4158
Q99732-1#13	0	3	3	Q99732-1	66	69	+	3	Q99732-1	0	483	ENST00000576036.5	93	576	++	191	Q99732-1#13	0	3	ENST00000576036.5	159	162	+	3	0	0	4159
Q99732-1#13	0	3	3	Q99732-1	66	69	+	3	Q99732-1	0	174	ENST00000574848.5	380	554	+	190	Q99732-1#13	0	3	ENST00000574848.5	446	449	+	3	0	0	4160
Q99732-1#13	0	3	3	Q99732-1	66	69	+	3	Q99732-1	0	483	ENST00000574763.5	220	703	++	189	Q99732-1#13	0	3	ENST00000574763.5	286	289	+	3	0	0	4161
Q99732-1#13	0	3	3	Q99732-1	66	69	+	3	Q99732-1	0	220	ENST00000574703.5	39	259	+	188	Q99732-1#13	0	3	ENST00000574703.5	105	108	+	3	0	0	4162
Q99732-1#13	0	3	3	Q99732-1	66	69	+	3	Q99732-1	0	378	ENST00000574701.5	144	522	+	187	Q99732-1#13	0	3	ENST00000574701.5	210	213	+	3	0	0	4163
Q99732-1#13	0	3	3	Q99732-1	66	69	+	3	Q99732-1	0	220	ENST00000573332.5	39	259	+	186	Q99732-1#13	0	3	ENST00000573332.5	105	108	+	3	0	0	4164
Q99732-1#13	0	3	3	Q99732-1	66	69	+	3	Q99732-1	0	377	ENST00000571976.1	61	438	+	184	Q99732-1#13	0	3	ENST00000571976.1	127	130	+	3	0	0	4165
Q99732-1#13	0	3	3	Q99732-1	66	69	+	3	Q99732-1	0	483	ENST00000571688.5	231	714	++	183	Q99732-1#13	0	3	ENST00000571688.5	297	300	+	3	0	0	4166
Q99732-1#13	0	3	3	Q99732-1	66	69	+	3	Q99732-1	0	461	ENST00000571627.5	118	579	+	182	Q99732-1#13	0	3	ENST00000571627.5	184	187	+	3	0	0	4167
Q99732-1#13	0	3	3	Q99732-1	66	69	+	3	Q99732-1	0	385	ENST00000571459.5	23	251	+	181	Q99732-1#13	0	3	ENST00000571459.5	89	92	+	3	0	0	4168
Q99732-1#13	0	3	3	Q99732-1	66	69	+	3	Q99732-1	0	119	ENST00000571277.1	468	587	+	180	Q99732-1#13	0	3	ENST00000571277.1	534	537	+	3	0	0	4169
Q99732-1#13	0	3	3	Q99732-1	66	69	+	3	Q99732-1	0	483	ENST00000570904.5	102	585	++	179	Q99732-1#13	0	3	ENST00000570904.5	168	171	+	3	0	0	4170
Q99732-1#13	0	3	3	Q99732-1	66	69	+	3	Q99732-1	0	412	ENST00000570798.5	181	593	+	178	Q99732-1#13	0	3	ENST00000570798.5	247	250	+	3	0	0	4171
Q99732-1#13	0	3	3	Q99732-1	66	69	+	3	Q99732-1	0	378	ENST00000413364.6	70	448	++	74	Q99732-1#13	0	3	ENST00000413364.6	136	139	+	3	0	0	4172
Q99732-1#13	0	3	3	Q99732-1	66	69	+	3	Q99732-1	0	483	ENST00000339430.9	233	716	++	31	Q99732-1#13	0	3	ENST00000339430.9	299	302	+	3	0	0	4173
Q99732-1#14	0	3	3	Q99732-1	144	147	+	3	Q99732-1	0	483	ENST00000622633.5	39	522	++	234	Q99732-1#14	0	3	ENST00000622633.5	183	186	+	3	0	0	4174
Q99732-1#14	0	3	3	Q99732-1	144	147	+	3	Q99732-1	0	483	ENST00000576036.5	93	576	++	191	Q99732-1#14	0	3	ENST00000576036.5	237	240	+	3	0	0	4175
Q99732-1#14	0	3	3	Q99732-1	144	147	+	3	Q99732-1	0	174	ENST00000574848.5	380	554	+	190	Q99732-1#14	0	3	ENST00000574848.5	524	527	+	3	0	0	4176
Q99732-1#14	0	3	3	Q99732-1	144	147	+	3	Q99732-1	0	483	ENST00000574763.5	220	703	++	189	Q99732-1#14	0	3	ENST00000574763.5	364	367	+	3	0	0	4177
Q99732-1#14	0	3	3	Q99732-1	144	147	+	3	Q99732-1	0	220	ENST00000574703.5	39	259	+	188	Q99732-1#14	0	3	ENST00000574703.5	183	186	+	3	0	0	4178
Q99732-1#14	0	3	3	Q99732-1	144	147	+	3	Q99732-1	0	378	ENST00000574701.5	144	522	+	187	Q99732-1#14	0	3	ENST00000574701.5	288	291	+	3	0	0	4179
Q99732-1#14	0	3	3	Q99732-1	144	147	+	3	Q99732-1	0	220	ENST00000573332.5	39	259	+	186	Q99732-1#14	0	3	ENST00000573332.5	183	186	+	3	0	0	4180
Q99732-1#14	0	3	3	Q99732-1	144	147	+	3	Q99732-1	0	377	ENST00000571976.1	61	438	+	184	Q99732-1#14	0	3	ENST00000571976.1	205	208	+	3	0	0	4181
Q99732-1#14	0	3	3	Q99732-1	144	147	+	3	Q99732-1	0	483	ENST00000571688.5	231	714	++	183	Q99732-1#14	0	3	ENST00000571688.5	375	378	+	3	0	0	4182
Q99732-1#14	0	3	3	Q99732-1	144	147	+	3	Q99732-1	0	461	ENST00000571627.5	118	579	+	182	Q99732-1#14	0	3	ENST00000571627.5	262	265	+	3	0	0	4183
Q99732-1#14	0	3	3	Q99732-1	144	147	+	3	Q99732-1	0	385	ENST00000571459.5	23	251	+	181	Q99732-1#14	0	3	ENST00000571459.5	167	170	+	3	0	0	4184
Q99732-1#14	0	3	3	Q99732-1	144	147	+	3	Q99732-1	0	483	ENST00000570904.5	102	585	++	179	Q99732-1#14	0	3	ENST00000570904.5	246	249	+	3	0	0	4185
Q99732-1#14	0	3	3	Q99732-1	144	147	+	3	Q99732-1	0	412	ENST00000570798.5	181	593	+	178	Q99732-1#14	0	3	ENST00000570798.5	325	328	+	3	0	0	4186
Q99732-1#14	0	3	3	Q99732-1	144	147	+	3	Q99732-1	0	378	ENST00000413364.6	70	448	++	74	Q99732-1#14	0	3	ENST00000413364.6	214	217	+	3	0	0	4187
Q99732-1#14	0	3	3	Q99732-1	144	147	+	3	Q99732-1	0	483	ENST00000339430.9	233	716	++	31	Q99732-1#14	0	3	ENST00000339430.9	377	380	+	3	0	0	4188
Q99732-1#15	0	3	3	Q99732-1	273	276	+	3	Q99732-1	0	483	ENST00000622633.5	39	522	++	234	Q99732-1#15	0	3	ENST00000622633.5	312	315	+	3	0	0	4189
Q99732-1#15	0	3	3	Q99732-1	273	276	+	3	Q99732-1	0	483	ENST00000576036.5	93	576	++	191	Q99732-1#15	0	3	ENST00000576036.5	366	369	+	3	0	0	4190
Q99732-1#15	0	3	3	Q99732-1	273	276	+	3	Q99732-1	0	483	ENST00000574763.5	220	703	++	189	Q99732-1#15	0	3	ENST00000574763.5	493	496	+	3	0	0	4191
Q99732-1#15	0	3	3	Q99732-1	273	276	+	3	Q99732-1	0	378	ENST00000574701.5	144	522	+	187	Q99732-1#15	0	3	ENST00000574701.5	417	420	+	3	0	0	4192
Q99732-1#15	0	3	3	Q99732-1	273	276	+	3	Q99732-1	0	377	ENST00000571976.1	61	438	+	184	Q99732-1#15	0	3	ENST00000571976.1	334	337	+	3	0	0	4193
Q99732-1#15	0	3	3	Q99732-1	273	276	+	3	Q99732-1	0	483	ENST00000571688.5	231	714	++	183	Q99732-1#15	0	3	ENST00000571688.5	504	507	+	3	0	0	4194
Q99732-1#15	0	3	3	Q99732-1	273	276	+	3	Q99732-1	0	461	ENST00000571627.5	118	579	+	182	Q99732-1#15	0	3	ENST00000571627.5	391	394	+	3	0	0	4195
Q99732-1#15	0	3	3	Q99732-1	273	276	+	3	Q99732-1	0	483	ENST00000570904.5	102	585	++	179	Q99732-1#15	0	3	ENST00000570904.5	375	378	+	3	0	0	4196
Q99732-1#15	0	3	3	Q99732-1	273	276	+	3	Q99732-1	0	412	ENST00000570798.5	181	593	+	178	Q99732-1#15	0	3	ENST00000570798.5	454	457	+	3	0	0	4197
Q99732-1#15	0	3	3	Q99732-1	273	276	+	3	Q99732-1	0	378	ENST00000413364.6	70	448	++	74	Q99732-1#15	0	3	ENST00000413364.6	343	346	+	3	0	0	4198
Q99732-1#15	0	3	3	Q99732-1	273	276	+	3	Q99732-1	0	483	ENST00000339430.9	233	716	++	31	Q99732-1#15	0	3	ENST00000339430.9	506	509	+	3	0	0	4199
Q99732-1#16	0	3	3	Q99732-1	333	336	+	3	Q99732-1	0	483	ENST00000622633.5	39	522	++	234	Q99732-1#16	0	3	ENST00000622633.5	372	375	+	3	0	0	4200
Q99732-1#16	0	3	3	Q99732-1	333	336	+	3	Q99732-1	0	483	ENST00000576036.5	93	576	++	191	Q99732-1#16	0	3	ENST00000576036.5	426	429	+	3	0	0	4201
Q99732-1#16	0	3	3	Q99732-1	333	336	+	3	Q99732-1	0	483	ENST00000574763.5	220	703	++	189	Q99732-1#16	0	3	ENST00000574763.5	553	556	+	3	0	0	4202
Q99732-1#16	0	3	3	Q99732-1	333	336	+	3	Q99732-1	0	378	ENST00000574701.5	144	522	+	187	Q99732-1#16	0	3	ENST00000574701.5	477	480	+	3	0	0	4203
Q99732-1#16	0	3	3	Q99732-1	333	336	+	3	Q99732-1	279	483	ENST00000572255.5	274	478	+	185	Q99732-1#16	0	3	ENST00000572255.5	328	331	+	3	0	0	4204
Q99732-1#16	0	3	3	Q99732-1	333	336	+	3	Q99732-1	0	377	ENST00000571976.1	61	438	+	184	Q99732-1#16	0	3	ENST00000571976.1	394	397	+	3	0	0	4205
Q99732-1#16	0	3	3	Q99732-1	333	336	+	3	Q99732-1	0	483	ENST00000571688.5	231	714	++	183	Q99732-1#16	0	3	ENST00000571688.5	564	567	+	3	0	0	4206
Q99732-1#16	0	3	3	Q99732-1	333	336	+	3	Q99732-1	0	461	ENST00000571627.5	118	579	+	182	Q99732-1#16	0	3	ENST00000571627.5	451	454	+	3	0	0	4207
Q99732-1#16	0	3	3	Q99732-1	333	336	+	3	Q99732-1	0	483	ENST00000570904.5	102	585	++	179	Q99732-1#16	0	3	ENST00000570904.5	435	438	+	3	0	0	4208
Q99732-1#16	0	3	3	Q99732-1	333	336	+	3	Q99732-1	0	412	ENST00000570798.5	181	593	+	178	Q99732-1#16	0	3	ENST00000570798.5	514	517	+	3	0	0	4209
Q99732-1#16	0	3	3	Q99732-1	333	336	+	3	Q99732-1	0	378	ENST00000413364.6	70	448	++	74	Q99732-1#16	0	3	ENST00000413364.6	403	406	+	3	0	0	4210
Q99732-1#16	0	3	3	Q99732-1	333	336	+	3	Q99732-1	0	483	ENST00000339430.9	233	716	++	31	Q99732-1#16	0	3	ENST00000339430.9	566	569	+	3	0	0	4211
Q99732-1#17	0	3	3	Q99732-1	342	345	+	3	Q99732-1	0	483	ENST00000622633.5	39	522	++	234	Q99732-1#17	0	3	ENST00000622633.5	381	384	+	3	0	0	4212
Q99732-1#17	0	3	3	Q99732-1	342	345	+	3	Q99732-1	0	483	ENST00000576036.5	93	576	++	191	Q99732-1#17	0	3	ENST00000576036.5	435	438	+	3	0	0	4213
Q99732-1#17	0	3	3	Q99732-1	342	345	+	3	Q99732-1	0	483	ENST00000574763.5	220	703	++	189	Q99732-1#17	0	3	ENST00000574763.5	562	565	+	3	0	0	4214
Q99732-1#17	0	3	3	Q99732-1	342	345	+	3	Q99732-1	0	378	ENST00000574701.5	144	522	+	187	Q99732-1#17	0	3	ENST00000574701.5	486	489	+	3	0	0	4215
Q99732-1#17	0	3	3	Q99732-1	342	345	+	3	Q99732-1	279	483	ENST00000572255.5	274	478	+	185	Q99732-1#17	0	3	ENST00000572255.5	337	340	+	3	0	0	4216
Q99732-1#17	0	3	3	Q99732-1	342	345	+	3	Q99732-1	0	377	ENST00000571976.1	61	438	+	184	Q99732-1#17	0	3	ENST00000571976.1	403	406	+	3	0	0	4217
Q99732-1#17	0	3	3	Q99732-1	342	345	+	3	Q99732-1	0	483	ENST00000571688.5	231	714	++	183	Q99732-1#17	0	3	ENST00000571688.5	573	576	+	3	0	0	4218
Q99732-1#17	0	3	3	Q99732-1	342	345	+	3	Q99732-1	0	461	ENST00000571627.5	118	579	+	182	Q99732-1#17	0	3	ENST00000571627.5	460	463	+	3	0	0	4219
Q99732-1#17	0	3	3	Q99732-1	342	345	+	3	Q99732-1	0	483	ENST00000570904.5	102	585	++	179	Q99732-1#17	0	3	ENST00000570904.5	444	447	+	3	0	0	4220
Q99732-1#17	0	3	3	Q99732-1	342	345	+	3	Q99732-1	0	412	ENST00000570798.5	181	593	+	178	Q99732-1#17	0	3	ENST00000570798.5	523	526	+	3	0	0	4221
Q99732-1#17	0	3	3	Q99732-1	342	345	+	3	Q99732-1	0	378	ENST00000413364.6	70	448	++	74	Q99732-1#17	0	3	ENST00000413364.6	412	415	+	3	0	0	4222
Q99732-1#17	0	3	3	Q99732-1	342	345	+	3	Q99732-1	0	483	ENST00000339430.9	233	716	++	31	Q99732-1#17	0	3	ENST00000339430.9	575	578	+	3	0	0	4223
Q99732-1#18	0	3	3	Q99732-1	345	348	+	3	Q99732-1	0	483	ENST00000622633.5	39	522	++	234	Q99732-1#18	0	3	ENST00000622633.5	384	387	+	3	0	0	4224
Q99732-1#18	0	3	3	Q99732-1	345	348	+	3	Q99732-1	0	483	ENST00000576036.5	93	576	++	191	Q99732-1#18	0	3	ENST00000576036.5	438	441	+	3	0	0	4225
Q99732-1#18	0	3	3	Q99732-1	345	348	+	3	Q99732-1	0	483	ENST00000574763.5	220	703	++	189	Q99732-1#18	0	3	ENST00000574763.5	565	568	+	3	0	0	4226
Q99732-1#18	0	3	3	Q99732-1	345	348	+	3	Q99732-1	0	378	ENST00000574701.5	144	522	+	187	Q99732-1#18	0	3	ENST00000574701.5	489	492	+	3	0	0	4227
Q99732-1#18	0	3	3	Q99732-1	345	348	+	3	Q99732-1	279	483	ENST00000572255.5	274	478	+	185	Q99732-1#18	0	3	ENST00000572255.5	340	343	+	3	0	0	4228
Q99732-1#18	0	3	3	Q99732-1	345	348	+	3	Q99732-1	0	377	ENST00000571976.1	61	438	+	184	Q99732-1#18	0	3	ENST00000571976.1	406	409	+	3	0	0	4229
Q99732-1#18	0	3	3	Q99732-1	345	348	+	3	Q99732-1	0	483	ENST00000571688.5	231	714	++	183	Q99732-1#18	0	3	ENST00000571688.5	576	579	+	3	0	0	4230
Q99732-1#18	0	3	3	Q99732-1	345	348	+	3	Q99732-1	0	461	ENST00000571627.5	118	579	+	182	Q99732-1#18	0	3	ENST00000571627.5	463	466	+	3	0	0	4231
Q99732-1#18	0	3	3	Q99732-1	345	348	+	3	Q99732-1	0	483	ENST00000570904.5	102	585	++	179	Q99732-1#18	0	3	ENST00000570904.5	447	450	+	3	0	0	4232
Q99732-1#18	0	3	3	Q99732-1	345	348	+	3	Q99732-1	0	412	ENST00000570798.5	181	593	+	178	Q99732-1#18	0	3	ENST00000570798.5	526	529	+	3	0	0	4233
Q99732-1#18	0	3	3	Q99732-1	345	348	+	3	Q99732-1	0	378	ENST00000413364.6	70	448	++	74	Q99732-1#18	0	3	ENST00000413364.6	415	418	+	3	0	0	4234
Q99732-1#18	0	3	3	Q99732-1	345	348	+	3	Q99732-1	0	483	ENST00000339430.9	233	716	++	31	Q99732-1#18	0	3	ENST00000339430.9	578	581	+	3	0	0	4235
Q99732-1#19	0	3	3	Q99732-1	363	366	+	3	Q99732-1	0	483	ENST00000622633.5	39	522	++	234	Q99732-1#19	0	3	ENST00000622633.5	402	405	+	3	0	0	4236
Q99732-1#19	0	3	3	Q99732-1	363	366	+	3	Q99732-1	0	483	ENST00000576036.5	93	576	++	191	Q99732-1#19	0	3	ENST00000576036.5	456	459	+	3	0	0	4237
Q99732-1#19	0	3	3	Q99732-1	363	366	+	3	Q99732-1	0	483	ENST00000574763.5	220	703	++	189	Q99732-1#19	0	3	ENST00000574763.5	583	586	+	3	0	0	4238
Q99732-1#19	0	3	3	Q99732-1	363	366	+	3	Q99732-1	0	378	ENST00000574701.5	144	522	+	187	Q99732-1#19	0	3	ENST00000574701.5	507	510	+	3	0	0	4239
Q99732-1#19	0	3	3	Q99732-1	363	366	+	3	Q99732-1	279	483	ENST00000572255.5	274	478	+	185	Q99732-1#19	0	3	ENST00000572255.5	358	361	+	3	0	0	4240
Q99732-1#19	0	3	3	Q99732-1	363	366	+	3	Q99732-1	0	377	ENST00000571976.1	61	438	+	184	Q99732-1#19	0	3	ENST00000571976.1	424	427	+	3	0	0	4241
Q99732-1#19	0	3	3	Q99732-1	363	366	+	3	Q99732-1	0	483	ENST00000571688.5	231	714	++	183	Q99732-1#19	0	3	ENST00000571688.5	594	597	+	3	0	0	4242
Q99732-1#19	0	3	3	Q99732-1	363	366	+	3	Q99732-1	0	461	ENST00000571627.5	118	579	+	182	Q99732-1#19	0	3	ENST00000571627.5	481	484	+	3	0	0	4243
Q99732-1#19	0	3	3	Q99732-1	363	366	+	3	Q99732-1	0	483	ENST00000570904.5	102	585	++	179	Q99732-1#19	0	3	ENST00000570904.5	465	468	+	3	0	0	4244
Q99732-1#19	0	3	3	Q99732-1	363	366	+	3	Q99732-1	0	412	ENST00000570798.5	181	593	+	178	Q99732-1#19	0	3	ENST00000570798.5	544	547	+	3	0	0	4245
Q99732-1#19	0	3	3	Q99732-1	363	366	+	3	Q99732-1	0	378	ENST00000413364.6	70	448	++	74	Q99732-1#19	0	3	ENST00000413364.6	433	436	+	3	0	0	4246
Q99732-1#19	0	3	3	Q99732-1	363	366	+	3	Q99732-1	0	483	ENST00000339430.9	233	716	++	31	Q99732-1#19	0	3	ENST00000339430.9	596	599	+	3	0	0	4247
Q99732-1#20	0	12	12	Q99732-1	48	60	+	12	Q99732-1	0	483	ENST00000622633.5	39	522	++	234	Q99732-1#20	0	12	ENST00000622633.5	87	99	+	12	0	0	4248
Q99732-1#20	0	12	12	Q99732-1	48	60	+	12	Q99732-1	0	483	ENST00000576036.5	93	576	++	191	Q99732-1#20	0	12	ENST00000576036.5	141	153	+	12	0	0	4249
Q99732-1#20	0	12	12	Q99732-1	48	60	+	12	Q99732-1	0	174	ENST00000574848.5	380	554	+	190	Q99732-1#20	0	12	ENST00000574848.5	428	440	+	12	0	0	4250
Q99732-1#20	0	12	12	Q99732-1	48	60	+	12	Q99732-1	0	483	ENST00000574763.5	220	703	++	189	Q99732-1#20	0	12	ENST00000574763.5	268	280	+	12	0	0	4251
Q99732-1#20	0	12	12	Q99732-1	48	60	+	12	Q99732-1	0	220	ENST00000574703.5	39	259	+	188	Q99732-1#20	0	12	ENST00000574703.5	87	99	+	12	0	0	4252
Q99732-1#20	0	12	12	Q99732-1	48	60	+	12	Q99732-1	0	378	ENST00000574701.5	144	522	+	187	Q99732-1#20	0	12	ENST00000574701.5	192	204	+	12	0	0	4253
Q99732-1#20	0	12	12	Q99732-1	48	60	+	12	Q99732-1	0	220	ENST00000573332.5	39	259	+	186	Q99732-1#20	0	12	ENST00000573332.5	87	99	+	12	0	0	4254
Q99732-1#20	0	12	12	Q99732-1	48	60	+	12	Q99732-1	0	377	ENST00000571976.1	61	438	+	184	Q99732-1#20	0	12	ENST00000571976.1	109	121	+	12	0	0	4255
Q99732-1#20	0	12	12	Q99732-1	48	60	+	12	Q99732-1	0	483	ENST00000571688.5	231	714	++	183	Q99732-1#20	0	12	ENST00000571688.5	279	291	+	12	0	0	4256
Q99732-1#20	0	12	12	Q99732-1	48	60	+	12	Q99732-1	0	461	ENST00000571627.5	118	579	+	182	Q99732-1#20	0	12	ENST00000571627.5	166	178	+	12	0	0	4257
Q99732-1#20	0	12	12	Q99732-1	48	60	+	12	Q99732-1	0	385	ENST00000571459.5	23	251	+	181	Q99732-1#20	0	12	ENST00000571459.5	71	83	+	12	0	0	4258
Q99732-1#20	0	12	12	Q99732-1	48	60	+	12	Q99732-1	0	119	ENST00000571277.1	468	587	+	180	Q99732-1#20	0	12	ENST00000571277.1	516	528	+	12	0	0	4259
Q99732-1#20	0	12	12	Q99732-1	48	60	+	12	Q99732-1	0	483	ENST00000570904.5	102	585	++	179	Q99732-1#20	0	12	ENST00000570904.5	150	162	+	12	0	0	4260
Q99732-1#20	0	12	12	Q99732-1	48	60	+	12	Q99732-1	0	412	ENST00000570798.5	181	593	+	178	Q99732-1#20	0	12	ENST00000570798.5	229	241	+	12	0	0	4261
Q99732-1#20	0	12	12	Q99732-1	48	60	+	12	Q99732-1	0	378	ENST00000413364.6	70	448	++	74	Q99732-1#20	0	12	ENST00000413364.6	118	130	+	12	0	0	4262
Q99732-1#20	0	12	12	Q99732-1	48	60	+	12	Q99732-1	0	483	ENST00000339430.9	233	716	++	31	Q99732-1#20	0	12	ENST00000339430.9	281	293	+	12	0	0	4263
Q99732-1#21	0	9	9	Q99732-1	48	57	+	9	Q99732-1	0	483	ENST00000622633.5	39	522	++	234	Q99732-1#21	0	9	ENST00000622633.5	87	96	+	9	0	0	4264
Q99732-1#21	0	9	9	Q99732-1	48	57	+	9	Q99732-1	0	483	ENST00000576036.5	93	576	++	191	Q99732-1#21	0	9	ENST00000576036.5	141	150	+	9	0	0	4265
Q99732-1#21	0	9	9	Q99732-1	48	57	+	9	Q99732-1	0	174	ENST00000574848.5	380	554	+	190	Q99732-1#21	0	9	ENST00000574848.5	428	437	+	9	0	0	4266
Q99732-1#21	0	9	9	Q99732-1	48	57	+	9	Q99732-1	0	483	ENST00000574763.5	220	703	++	189	Q99732-1#21	0	9	ENST00000574763.5	268	277	+	9	0	0	4267
Q99732-1#21	0	9	9	Q99732-1	48	57	+	9	Q99732-1	0	220	ENST00000574703.5	39	259	+	188	Q99732-1#21	0	9	ENST00000574703.5	87	96	+	9	0	0	4268
Q99732-1#21	0	9	9	Q99732-1	48	57	+	9	Q99732-1	0	378	ENST00000574701.5	144	522	+	187	Q99732-1#21	0	9	ENST00000574701.5	192	201	+	9	0	0	4269
Q99732-1#21	0	9	9	Q99732-1	48	57	+	9	Q99732-1	0	220	ENST00000573332.5	39	259	+	186	Q99732-1#21	0	9	ENST00000573332.5	87	96	+	9	0	0	4270
Q99732-1#21	0	9	9	Q99732-1	48	57	+	9	Q99732-1	0	377	ENST00000571976.1	61	438	+	184	Q99732-1#21	0	9	ENST00000571976.1	109	118	+	9	0	0	4271
Q99732-1#21	0	9	9	Q99732-1	48	57	+	9	Q99732-1	0	483	ENST00000571688.5	231	714	++	183	Q99732-1#21	0	9	ENST00000571688.5	279	288	+	9	0	0	4272
Q99732-1#21	0	9	9	Q99732-1	48	57	+	9	Q99732-1	0	461	ENST00000571627.5	118	579	+	182	Q99732-1#21	0	9	ENST00000571627.5	166	175	+	9	0	0	4273
Q99732-1#21	0	9	9	Q99732-1	48	57	+	9	Q99732-1	0	385	ENST00000571459.5	23	251	+	181	Q99732-1#21	0	9	ENST00000571459.5	71	80	+	9	0	0	4274
Q99732-1#21	0	9	9	Q99732-1	48	57	+	9	Q99732-1	0	119	ENST00000571277.1	468	587	+	180	Q99732-1#21	0	9	ENST00000571277.1	516	525	+	9	0	0	4275
Q99732-1#21	0	9	9	Q99732-1	48	57	+	9	Q99732-1	0	483	ENST00000570904.5	102	585	++	179	Q99732-1#21	0	9	ENST00000570904.5	150	159	+	9	0	0	4276
Q99732-1#21	0	9	9	Q99732-1	48	57	+	9	Q99732-1	0	412	ENST00000570798.5	181	593	+	178	Q99732-1#21	0	9	ENST00000570798.5	229	238	+	9	0	0	4277
Q99732-1#21	0	9	9	Q99732-1	48	57	+	9	Q99732-1	0	378	ENST00000413364.6	70	448	++	74	Q99732-1#21	0	9	ENST00000413364.6	118	127	+	9	0	0	4278
Q99732-1#21	0	9	9	Q99732-1	48	57	+	9	Q99732-1	0	483	ENST00000339430.9	233	716	++	31	Q99732-1#21	0	9	ENST00000339430.9	281	290	+	9	0	0	4279
Q99732-1#22	0	3	3	Q99732-1	66	69	+	3	Q99732-1	0	483	ENST00000622633.5	39	522	++	234	Q99732-1#22	0	3	ENST00000622633.5	105	108	+	3	0	0	4280
Q99732-1#22	0	3	3	Q99732-1	66	69	+	3	Q99732-1	0	483	ENST00000576036.5	93	576	++	191	Q99732-1#22	0	3	ENST00000576036.5	159	162	+	3	0	0	4281
Q99732-1#22	0	3	3	Q99732-1	66	69	+	3	Q99732-1	0	174	ENST00000574848.5	380	554	+	190	Q99732-1#22	0	3	ENST00000574848.5	446	449	+	3	0	0	4282
Q99732-1#22	0	3	3	Q99732-1	66	69	+	3	Q99732-1	0	483	ENST00000574763.5	220	703	++	189	Q99732-1#22	0	3	ENST00000574763.5	286	289	+	3	0	0	4283
Q99732-1#22	0	3	3	Q99732-1	66	69	+	3	Q99732-1	0	220	ENST00000574703.5	39	259	+	188	Q99732-1#22	0	3	ENST00000574703.5	105	108	+	3	0	0	4284
Q99732-1#22	0	3	3	Q99732-1	66	69	+	3	Q99732-1	0	378	ENST00000574701.5	144	522	+	187	Q99732-1#22	0	3	ENST00000574701.5	210	213	+	3	0	0	4285
Q99732-1#22	0	3	3	Q99732-1	66	69	+	3	Q99732-1	0	220	ENST00000573332.5	39	259	+	186	Q99732-1#22	0	3	ENST00000573332.5	105	108	+	3	0	0	4286
Q99732-1#22	0	3	3	Q99732-1	66	69	+	3	Q99732-1	0	377	ENST00000571976.1	61	438	+	184	Q99732-1#22	0	3	ENST00000571976.1	127	130	+	3	0	0	4287
Q99732-1#22	0	3	3	Q99732-1	66	69	+	3	Q99732-1	0	483	ENST00000571688.5	231	714	++	183	Q99732-1#22	0	3	ENST00000571688.5	297	300	+	3	0	0	4288
Q99732-1#22	0	3	3	Q99732-1	66	69	+	3	Q99732-1	0	461	ENST00000571627.5	118	579	+	182	Q99732-1#22	0	3	ENST00000571627.5	184	187	+	3	0	0	4289
Q99732-1#22	0	3	3	Q99732-1	66	69	+	3	Q99732-1	0	385	ENST00000571459.5	23	251	+	181	Q99732-1#22	0	3	ENST00000571459.5	89	92	+	3	0	0	4290
Q99732-1#22	0	3	3	Q99732-1	66	69	+	3	Q99732-1	0	119	ENST00000571277.1	468	587	+	180	Q99732-1#22	0	3	ENST00000571277.1	534	537	+	3	0	0	4291
Q99732-1#22	0	3	3	Q99732-1	66	69	+	3	Q99732-1	0	483	ENST00000570904.5	102	585	++	179	Q99732-1#22	0	3	ENST00000570904.5	168	171	+	3	0	0	4292
Q99732-1#22	0	3	3	Q99732-1	66	69	+	3	Q99732-1	0	412	ENST00000570798.5	181	593	+	178	Q99732-1#22	0	3	ENST00000570798.5	247	250	+	3	0	0	4293
Q99732-1#22	0	3	3	Q99732-1	66	69	+	3	Q99732-1	0	378	ENST00000413364.6	70	448	++	74	Q99732-1#22	0	3	ENST00000413364.6	136	139	+	3	0	0	4294
Q99732-1#22	0	3	3	Q99732-1	66	69	+	3	Q99732-1	0	483	ENST00000339430.9	233	716	++	31	Q99732-1#22	0	3	ENST00000339430.9	299	302	+	3	0	0	4295
Q99732-1#23	0	3	3	Q99732-1	66	69	+	3	Q99732-1	0	483	ENST00000622633.5	39	522	++	234	Q99732-1#23	0	3	ENST00000622633.5	105	108	+	3	0	0	4296
Q99732-1#23	0	3	3	Q99732-1	66	69	+	3	Q99732-1	0	483	ENST00000576036.5	93	576	++	191	Q99732-1#23	0	3	ENST00000576036.5	159	162	+	3	0	0	4297
Q99732-1#23	0	3	3	Q99732-1	66	69	+	3	Q99732-1	0	174	ENST00000574848.5	380	554	+	190	Q99732-1#23	0	3	ENST00000574848.5	446	449	+	3	0	0	4298
Q99732-1#23	0	3	3	Q99732-1	66	69	+	3	Q99732-1	0	483	ENST00000574763.5	220	703	++	189	Q99732-1#23	0	3	ENST00000574763.5	286	289	+	3	0	0	4299
Q99732-1#23	0	3	3	Q99732-1	66	69	+	3	Q99732-1	0	220	ENST00000574703.5	39	259	+	188	Q99732-1#23	0	3	ENST00000574703.5	105	108	+	3	0	0	4300
Q99732-1#23	0	3	3	Q99732-1	66	69	+	3	Q99732-1	0	378	ENST00000574701.5	144	522	+	187	Q99732-1#23	0	3	ENST00000574701.5	210	213	+	3	0	0	4301
Q99732-1#23	0	3	3	Q99732-1	66	69	+	3	Q99732-1	0	220	ENST00000573332.5	39	259	+	186	Q99732-1#23	0	3	ENST00000573332.5	105	108	+	3	0	0	4302
Q99732-1#23	0	3	3	Q99732-1	66	69	+	3	Q99732-1	0	377	ENST00000571976.1	61	438	+	184	Q99732-1#23	0	3	ENST00000571976.1	127	130	+	3	0	0	4303
Q99732-1#23	0	3	3	Q99732-1	66	69	+	3	Q99732-1	0	483	ENST00000571688.5	231	714	++	183	Q99732-1#23	0	3	ENST00000571688.5	297	300	+	3	0	0	4304
Q99732-1#23	0	3	3	Q99732-1	66	69	+	3	Q99732-1	0	461	ENST00000571627.5	118	579	+	182	Q99732-1#23	0	3	ENST00000571627.5	184	187	+	3	0	0	4305
Q99732-1#23	0	3	3	Q99732-1	66	69	+	3	Q99732-1	0	385	ENST00000571459.5	23	251	+	181	Q99732-1#23	0	3	ENST00000571459.5	89	92	+	3	0	0	4306
Q99732-1#23	0	3	3	Q99732-1	66	69	+	3	Q99732-1	0	119	ENST00000571277.1	468	587	+	180	Q99732-1#23	0	3	ENST00000571277.1	534	537	+	3	0	0	4307
Q99732-1#23	0	3	3	Q99732-1	66	69	+	3	Q99732-1	0	483	ENST00000570904.5	102	585	++	179	Q99732-1#23	0	3	ENST00000570904.5	168	171	+	3	0	0	4308
Q99732-1#23	0	3	3	Q99732-1	66	69	+	3	Q99732-1	0	412	ENST00000570798.5	181	593	+	178	Q99732-1#23	0	3	ENST00000570798.5	247	250	+	3	0	0	4309
Q99732-1#23	0	3	3	Q99732-1	66	69	+	3	Q99732-1	0	378	ENST00000413364.6	70	448	++	74	Q99732-1#23	0	3	ENST00000413364.6	136	139	+	3	0	0	4310
Q99732-1#23	0	3	3	Q99732-1	66	69	+	3	Q99732-1	0	483	ENST00000339430.9	233	716	++	31	Q99732-1#23	0	3	ENST00000339430.9	299	302	+	3	0	0	4311
Q99732-1#24	0	3	3	Q99732-1	180	183	+	3	Q99732-1	0	483	ENST00000622633.5	39	522	++	234	Q99732-1#24	0	3	ENST00000622633.5	219	222	+	3	0	0	4312
Q99732-1#24	0	3	3	Q99732-1	180	183	+	3	Q99732-1	0	483	ENST00000576036.5	93	576	++	191	Q99732-1#24	0	3	ENST00000576036.5	273	276	+	3	0	0	4313
Q99732-1#24	0	3	3	Q99732-1	180	183	+	3	Q99732-1	0	483	ENST00000574763.5	220	703	++	189	Q99732-1#24	0	3	ENST00000574763.5	400	403	+	3	0	0	4314
Q99732-1#24	0	3	3	Q99732-1	180	183	+	3	Q99732-1	0	220	ENST00000574703.5	39	259	+	188	Q99732-1#24	0	3	ENST00000574703.5	219	222	+	3	0	0	4315
Q99732-1#24	0	3	3	Q99732-1	180	183	+	3	Q99732-1	0	378	ENST00000574701.5	144	522	+	187	Q99732-1#24	0	3	ENST00000574701.5	324	327	+	3	0	0	4316
Q99732-1#24	0	3	3	Q99732-1	180	183	+	3	Q99732-1	0	220	ENST00000573332.5	39	259	+	186	Q99732-1#24	0	3	ENST00000573332.5	219	222	+	3	0	0	4317
Q99732-1#24	0	3	3	Q99732-1	180	183	+	3	Q99732-1	0	377	ENST00000571976.1	61	438	+	184	Q99732-1#24	0	3	ENST00000571976.1	241	244	+	3	0	0	4318
Q99732-1#24	0	3	3	Q99732-1	180	183	+	3	Q99732-1	0	483	ENST00000571688.5	231	714	++	183	Q99732-1#24	0	3	ENST00000571688.5	411	414	+	3	0	0	4319
Q99732-1#24	0	3	3	Q99732-1	180	183	+	3	Q99732-1	0	461	ENST00000571627.5	118	579	+	182	Q99732-1#24	0	3	ENST00000571627.5	298	301	+	3	0	0	4320
Q99732-1#24	0	3	3	Q99732-1	180	183	+	3	Q99732-1	0	385	ENST00000571459.5	23	251	+	181	Q99732-1#24	0	3	ENST00000571459.5	203	206	+	3	0	0	4321
Q99732-1#24	0	3	3	Q99732-1	180	183	+	3	Q99732-1	0	483	ENST00000570904.5	102	585	++	179	Q99732-1#24	0	3	ENST00000570904.5	282	285	+	3	0	0	4322
Q99732-1#24	0	3	3	Q99732-1	180	183	+	3	Q99732-1	0	412	ENST00000570798.5	181	593	+	178	Q99732-1#24	0	3	ENST00000570798.5	361	364	+	3	0	0	4323
Q99732-1#24	0	3	3	Q99732-1	180	183	+	3	Q99732-1	0	378	ENST00000413364.6	70	448	++	74	Q99732-1#24	0	3	ENST00000413364.6	250	253	+	3	0	0	4324
Q99732-1#24	0	3	3	Q99732-1	180	183	+	3	Q99732-1	0	483	ENST00000339430.9	233	716	++	31	Q99732-1#24	0	3	ENST00000339430.9	413	416	+	3	0	0	4325
Q99732-1#25	0	3	3	Q99732-1	285	288	+	3	Q99732-1	0	483	ENST00000622633.5	39	522	++	234	Q99732-1#25	0	3	ENST00000622633.5	324	327	+	3	0	0	4326
Q99732-1#25	0	3	3	Q99732-1	285	288	+	3	Q99732-1	0	483	ENST00000576036.5	93	576	++	191	Q99732-1#25	0	3	ENST00000576036.5	378	381	+	3	0	0	4327
Q99732-1#25	0	3	3	Q99732-1	285	288	+	3	Q99732-1	0	483	ENST00000574763.5	220	703	++	189	Q99732-1#25	0	3	ENST00000574763.5	505	508	+	3	0	0	4328
Q99732-1#25	0	3	3	Q99732-1	285	288	+	3	Q99732-1	0	378	ENST00000574701.5	144	522	+	187	Q99732-1#25	0	3	ENST00000574701.5	429	432	+	3	0	0	4329
Q99732-1#25	0	3	3	Q99732-1	285	288	+	3	Q99732-1	279	483	ENST00000572255.5	274	478	+	185	Q99732-1#25	0	3	ENST00000572255.5	280	283	+	3	0	0	4330
Q99732-1#25	0	3	3	Q99732-1	285	288	+	3	Q99732-1	0	377	ENST00000571976.1	61	438	+	184	Q99732-1#25	0	3	ENST00000571976.1	346	349	+	3	0	0	4331
Q99732-1#25	0	3	3	Q99732-1	285	288	+	3	Q99732-1	0	483	ENST00000571688.5	231	714	++	183	Q99732-1#25	0	3	ENST00000571688.5	516	519	+	3	0	0	4332
Q99732-1#25	0	3	3	Q99732-1	285	288	+	3	Q99732-1	0	461	ENST00000571627.5	118	579	+	182	Q99732-1#25	0	3	ENST00000571627.5	403	406	+	3	0	0	4333
Q99732-1#25	0	3	3	Q99732-1	285	288	+	3	Q99732-1	0	483	ENST00000570904.5	102	585	++	179	Q99732-1#25	0	3	ENST00000570904.5	387	390	+	3	0	0	4334
Q99732-1#25	0	3	3	Q99732-1	285	288	+	3	Q99732-1	0	412	ENST00000570798.5	181	593	+	178	Q99732-1#25	0	3	ENST00000570798.5	466	469	+	3	0	0	4335
Q99732-1#25	0	3	3	Q99732-1	285	288	+	3	Q99732-1	0	378	ENST00000413364.6	70	448	++	74	Q99732-1#25	0	3	ENST00000413364.6	355	358	+	3	0	0	4336
Q99732-1#25	0	3	3	Q99732-1	285	288	+	3	Q99732-1	0	483	ENST00000339430.9	233	716	++	31	Q99732-1#25	0	3	ENST00000339430.9	518	521	+	3	0	0	4337
Q99732-1#26	0	3	3	Q99732-1	402	405	+	3	Q99732-1	0	483	ENST00000622633.5	39	522	++	234	Q99732-1#26	0	3	ENST00000622633.5	441	444	+	3	0	0	4338
Q99732-1#26	0	3	3	Q99732-1	402	405	+	3	Q99732-1	0	483	ENST00000576036.5	93	576	++	191	Q99732-1#26	0	3	ENST00000576036.5	495	498	+	3	0	0	4339
Q99732-1#26	0	3	3	Q99732-1	402	405	+	3	Q99732-1	0	483	ENST00000574763.5	220	703	++	189	Q99732-1#26	0	3	ENST00000574763.5	622	625	+	3	0	0	4340
Q99732-1#26	0	3	3	Q99732-1	402	405	+	3	Q99732-1	279	483	ENST00000572255.5	274	478	+	185	Q99732-1#26	0	3	ENST00000572255.5	397	400	+	3	0	0	4341
Q99732-1#26	0	3	3	Q99732-1	402	405	+	3	Q99732-1	0	483	ENST00000571688.5	231	714	++	183	Q99732-1#26	0	3	ENST00000571688.5	633	636	+	3	0	0	4342
Q99732-1#26	0	3	3	Q99732-1	402	405	+	3	Q99732-1	0	461	ENST00000571627.5	118	579	+	182	Q99732-1#26	0	3	ENST00000571627.5	520	523	+	3	0	0	4343
Q99732-1#26	0	3	3	Q99732-1	402	405	+	3	Q99732-1	0	483	ENST00000570904.5	102	585	++	179	Q99732-1#26	0	3	ENST00000570904.5	504	507	+	3	0	0	4344
Q99732-1#26	0	3	3	Q99732-1	402	405	+	3	Q99732-1	0	412	ENST00000570798.5	181	593	+	178	Q99732-1#26	0	3	ENST00000570798.5	583	586	+	3	0	0	4345
Q99732-1#26	0	3	3	Q99732-1	402	405	+	3	Q99732-1	0	483	ENST00000339430.9	233	716	++	31	Q99732-1#26	0	3	ENST00000339430.9	635	638	+	3	0	0	4346
Q99732-1#27	0	3	3	Q99732-1	429	432	+	3	Q99732-1	0	483	ENST00000622633.5	39	522	++	234	Q99732-1#27	0	3	ENST00000622633.5	468	471	+	3	0	0	4347
Q99732-1#27	0	3	3	Q99732-1	429	432	+	3	Q99732-1	0	483	ENST00000576036.5	93	576	++	191	Q99732-1#27	0	3	ENST00000576036.5	522	525	+	3	0	0	4348
Q99732-1#27	0	3	3	Q99732-1	429	432	+	3	Q99732-1	0	483	ENST00000574763.5	220	703	++	189	Q99732-1#27	0	3	ENST00000574763.5	649	652	+	3	0	0	4349
Q99732-1#27	0	3	3	Q99732-1	429	432	+	3	Q99732-1	279	483	ENST00000572255.5	274	478	+	185	Q99732-1#27	0	3	ENST00000572255.5	424	427	+	3	0	0	4350
Q99732-1#27	0	3	3	Q99732-1	429	432	+	3	Q99732-1	0	483	ENST00000571688.5	231	714	++	183	Q99732-1#27	0	3	ENST00000571688.5	660	663	+	3	0	0	4351
Q99732-1#27	0	3	3	Q99732-1	429	432	+	3	Q99732-1	0	461	ENST00000571627.5	118	579	+	182	Q99732-1#27	0	3	ENST00000571627.5	547	550	+	3	0	0	4352
Q99732-1#27	0	3	3	Q99732-1	429	432	+	3	Q99732-1	0	483	ENST00000570904.5	102	585	++	179	Q99732-1#27	0	3	ENST00000570904.5	531	534	+	3	0	0	4353
Q99732-1#27	0	3	3	Q99732-1	429	432	+	3	Q99732-1	0	483	ENST00000339430.9	233	716	++	31	Q99732-1#27	0	3	ENST00000339430.9	662	665	+	3	0	0	4354
Q99732-1#28	0	3	3	Q99732-1	441	444	+	3	Q99732-1	0	483	ENST00000622633.5	39	522	++	234	Q99732-1#28	0	3	ENST00000622633.5	480	483	+	3	0	0	4355
Q99732-1#28	0	3	3	Q99732-1	441	444	+	3	Q99732-1	0	483	ENST00000576036.5	93	576	++	191	Q99732-1#28	0	3	ENST00000576036.5	534	537	+	3	0	0	4356
Q99732-1#28	0	3	3	Q99732-1	441	444	+	3	Q99732-1	0	483	ENST00000574763.5	220	703	++	189	Q99732-1#28	0	3	ENST00000574763.5	661	664	+	3	0	0	4357
Q99732-1#28	0	3	3	Q99732-1	441	444	+	3	Q99732-1	279	483	ENST00000572255.5	274	478	+	185	Q99732-1#28	0	3	ENST00000572255.5	436	439	+	3	0	0	4358
Q99732-1#28	0	3	3	Q99732-1	441	444	+	3	Q99732-1	0	483	ENST00000571688.5	231	714	++	183	Q99732-1#28	0	3	ENST00000571688.5	672	675	+	3	0	0	4359
Q99732-1#28	0	3	3	Q99732-1	441	444	+	3	Q99732-1	0	461	ENST00000571627.5	118	579	+	182	Q99732-1#28	0	3	ENST00000571627.5	559	562	+	3	0	0	4360
Q99732-1#28	0	3	3	Q99732-1	441	444	+	3	Q99732-1	0	483	ENST00000570904.5	102	585	++	179	Q99732-1#28	0	3	ENST00000570904.5	543	546	+	3	0	0	4361
Q99732-1#28	0	3	3	Q99732-1	441	444	+	3	Q99732-1	0	483	ENST00000339430.9	233	716	++	31	Q99732-1#28	0	3	ENST00000339430.9	674	677	+	3	0	0	4362
Q9UI95#0	0	633	633	Q9UI95	0	633	+	633	Q9UI95	0	529	ENST00000697274.1	72	601	+	279	Q9UI95#0	0	529	ENST00000697274.1	72	601	+	529	0	104	4363
Q9UI95#0	0	633	633	Q9UI95	0	633	+	633	Q9UI95	0	181	ENST00000697273.1	96	258	+	278	Q9UI95#0	0	181	ENST00000697273.1	96	258	+	162	0	452	4364
Q9UI95#0	0	633	633	Q9UI95	0	633	+	633	Q9UI95	436	633	ENST00000697272.1	0	197	+	277	Q9UI95#0	436	633	ENST00000697272.1	0	197	+	197	436	0	4365
Q9UI95#0	0	633	633	Q9UI95	0	633	+	633	Q9UI95	0	633	ENST00000456915.2	530	1163	++	104	Q9UI95#0	0	633	ENST00000456915.2	530	1163	+	633	0	0	4366
Q9UI95#0	0	633	633	Q9UI95	0	633	+	633	Q9UI95	0	501	ENST00000445656.5	85	676	+	95	Q9UI95#0	0	501	ENST00000445656.5	85	676	+	501	0	132	4367
Q9UI95#0	0	633	633	Q9UI95	0	633	+	633	Q9UI95	0	633	ENST00000376692.9	122	755	++	52	Q9UI95#0	0	633	ENST00000376692.9	122	755	+	633	0	0	4368
Q9UI95#0	0	633	633	Q9UI95	0	633	+	633	Q9UI95	0	633	ENST00000376672.5	77	749	+	51	Q9UI95#0	0	633	ENST00000376672.5	77	749	+	633	0	0	4369
Q9UI95#0	0	633	633	Q9UI95	0	633	+	633	Q9UI95	0	633	ENST00000376669.9	92	764	+	50	Q9UI95#0	0	633	ENST00000376669.9	92	764	+	633	0	0	4370
Q9UI95#0	0	633	633	Q9UI95	0	633	+	633	Q9UI95	0	633	ENST00000376667.7	209	842	++	49	Q9UI95#0	0	633	ENST00000376667.7	209	842	+	633	0	0	4371
Q9UI95#0	0	633	633	Q9UI95	0	633	+	633	Q9UI95	0	633	ENST00000235310.7	929	1562	++	0	Q9UI95#0	0	633	ENST00000235310.7	929	1562	+	633	0	0	4372
Q9UI95#1	0	573	573	Q9UI95	36	609	+	573	Q9UI95	0	529	ENST00000697274.1	72	601	+	279	Q9UI95#1	0	493	ENST00000697274.1	108	601	+	493	0	80	4373
Q9UI95#1	0	573	573	Q9UI95	36	609	+	573	Q9UI95	0	181	ENST00000697273.1	96	258	+	278	Q9UI95#1	0	145	ENST00000697273.1	132	258	+	126	0	428	4374
Q9UI95#1	0	573	573	Q9UI95	36	609	+	573	Q9UI95	436	633	ENST00000697272.1	0	197	+	277	Q9UI95#1	400	573	ENST00000697272.1	0	173	+	173	400	0	4375
Q9UI95#1	0	573	573	Q9UI95	36	609	+	573	Q9UI95	0	633	ENST00000456915.2	530	1163	++	104	Q9UI95#1	0	573	ENST00000456915.2	566	1139	+	573	0	0	4376
Q9UI95#1	0	573	573	Q9UI95	36	609	+	573	Q9UI95	0	501	ENST00000445656.5	85	676	+	95	Q9UI95#1	0	465	ENST00000445656.5	121	676	+	465	0	108	4377
Q9UI95#1	0	573	573	Q9UI95	36	609	+	573	Q9UI95	0	633	ENST00000376692.9	122	755	++	52	Q9UI95#1	0	573	ENST00000376692.9	158	731	+	573	0	0	4378
Q9UI95#1	0	573	573	Q9UI95	36	609	+	573	Q9UI95	0	633	ENST00000376672.5	77	749	+	51	Q9UI95#1	0	573	ENST00000376672.5	113	725	+	573	0	0	4379
Q9UI95#1	0	573	573	Q9UI95	36	609	+	573	Q9UI95	0	633	ENST00000376669.9	92	764	+	50	Q9UI95#1	0	573	ENST00000376669.9	128	740	+	573	0	0	4380
Q9UI95#1	0	573	573	Q9UI95	36	609	+	573	Q9UI95	0	633	ENST00000376667.7	209	842	++	49	Q9UI95#1	0	573	ENST00000376667.7	245	818	+	573	0	0	4381
Q9UI95#1	0	573	573	Q9UI95	36	609	+	573	Q9UI95	0	633	ENST00000235310.7	929	1562	++	0	Q9UI95#1	0	573	ENST00000235310.7	965	1538	+	573	0	0	4382
Q9UI95#2	0	405	405	Q9UI95	60	465	+	405	Q9UI95	0	529	ENST00000697274.1	72	601	+	279	Q9UI95#2	0	405	ENST00000697274.1	132	537	+	405	0	0	4383
Q9UI95#2	0	405	405	Q9UI95	60	465	+	405	Q9UI95	0	181	ENST00000697273.1	96	258	+	278	Q9UI95#2	0	121	ENST00000697273.1	156	258	+	102	0	284	4384
Q9UI95#2	0	405	405	Q9UI95	60	465	+	405	Q9UI95	436	633	ENST00000697272.1	0	197	+	277	Q9UI95#2	376	405	ENST00000697272.1	0	29	+	29	376	0	4385
Q9UI95#2	0	405	405	Q9UI95	60	465	+	405	Q9UI95	0	633	ENST00000456915.2	530	1163	++	104	Q9UI95#2	0	405	ENST00000456915.2	590	995	+	405	0	0	4386
Q9UI95#2	0	405	405	Q9UI95	60	465	+	405	Q9UI95	0	501	ENST00000445656.5	85	676	+	95	Q9UI95#2	0	405	ENST00000445656.5	235	640	+	405	0	0	4387
Q9UI95#2	0	405	405	Q9UI95	60	465	+	405	Q9UI95	0	633	ENST00000376692.9	122	755	++	52	Q9UI95#2	0	405	ENST00000376692.9	182	587	+	405	0	0	4388
Q9UI95#2	0	405	405	Q9UI95	60	465	+	405	Q9UI95	0	633	ENST00000376672.5	77	749	+	51	Q9UI95#2	0	405	ENST00000376672.5	137	581	+	405	0	0	4389
Q9UI95#2	0	405	405	Q9UI95	60	465	+	405	Q9UI95	0	633	ENST00000376669.9	92	764	+	50	Q9UI95#2	0	405	ENST00000376669.9	152	596	+	405	0	0	4390
Q9UI95#2	0	405	405	Q9UI95	60	465	+	405	Q9UI95	0	633	ENST00000376667.7	209	842	++	49	Q9UI95#2	0	405	ENST00000376667.7	269	674	+	405	0	0	4391
Q9UI95#2	0	405	405	Q9UI95	60	465	+	405	Q9UI95	0	633	ENST00000235310.7	929	1562	++	0	Q9UI95#2	0	405	ENST00000235310.7	989	1394	+	405	0	0	4392
Q9UI95#3	0	186	186	Q9UI95	447	633	+	186	Q9UI95	0	529	ENST00000697274.1	72	601	+	279	Q9UI95#3	0	82	ENST00000697274.1	519	601	+	82	0	104	4393
Q9UI95#3	0	186	186	Q9UI95	447	633	+	186	Q9UI95	436	633	ENST00000697272.1	0	197	+	277	Q9UI95#3	0	186	ENST00000697272.1	11	197	+	186	0	0	4394
Q9UI95#3	0	186	186	Q9UI95	447	633	+	186	Q9UI95	0	633	ENST00000456915.2	530	1163	++	104	Q9UI95#3	0	186	ENST00000456915.2	977	1163	+	186	0	0	4395
Q9UI95#3	0	186	186	Q9UI95	447	633	+	186	Q9UI95	0	501	ENST00000445656.5	85	676	+	95	Q9UI95#3	0	54	ENST00000445656.5	622	676	+	54	0	132	4396
Q9UI95#3	0	186	186	Q9UI95	447	633	+	186	Q9UI95	0	633	ENST00000376692.9	122	755	++	52	Q9UI95#3	0	186	ENST00000376692.9	569	755	+	186	0	0	4397
Q9UI95#3	0	186	186	Q9UI95	447	633	+	186	Q9UI95	0	633	ENST00000376672.5	77	749	+	51	Q9UI95#3	0	186	ENST00000376672.5	563	749	+	186	0	0	4398
Q9UI95#3	0	186	186	Q9UI95	447	633	+	186	Q9UI95	0	633	ENST00000376669.9	92	764	+	50	Q9UI95#3	0	186	ENST00000376669.9	578	764	+	186	0	0	4399
Q9UI95#3	0	186	186	Q9UI95	447	633	+	186	Q9UI95	0	633	ENST00000376667.7	209	842	++	49	Q9UI95#3	0	186	ENST00000376667.7	656	842	+	186	0	0	4400
Q9UI95#3	0	186	186	Q9UI95	447	633	+	186	Q9UI95	0	633	ENST00000235310.7	929	1562	++	0	Q9UI95#3	0	186	ENST00000235310.7	1376	1562	+	186	0	0	4401
Q9UI95#4	0	3	3	Q9UI95	252	255	+	3	Q9UI95	0	529	ENST00000697274.1	72	601	+	279	Q9UI95#4	0	3	ENST00000697274.1	324	327	+	3	0	0	4402
Q9UI95#4	0	3	3	Q9UI95	252	255	+	3	Q9UI95	0	633	ENST00000456915.2	530	1163	++	104	Q9UI95#4	0	3	ENST00000456915.2	782	785	+	3	0	0	4403
Q9UI95#4	0	3	3	Q9UI95	252	255	+	3	Q9UI95	0	501	ENST00000445656.5	85	676	+	95	Q9UI95#4	0	3	ENST00000445656.5	427	430	+	3	0	0	4404
Q9UI95#4	0	3	3	Q9UI95	252	255	+	3	Q9UI95	0	633	ENST00000376692.9	122	755	++	52	Q9UI95#4	0	3	ENST00000376692.9	374	377	+	3	0	0	4405
Q9UI95#4	0	3	3	Q9UI95	252	255	+	3	Q9UI95	0	633	ENST00000376672.5	77	749	+	51	Q9UI95#4	0	3	ENST00000376672.5	329	332	+	3	0	0	4406
Q9UI95#4	0	3	3	Q9UI95	252	255	+	3	Q9UI95	0	633	ENST00000376669.9	92	764	+	50	Q9UI95#4	0	3	ENST00000376669.9	344	347	+	3	0	0	4407
Q9UI95#4	0	3	3	Q9UI95	252	255	+	3	Q9UI95	0	633	ENST00000376667.7	209	842	++	49	Q9UI95#4	0	3	ENST00000376667.7	461	464	+	3	0	0	4408
Q9UI95#4	0	3	3	Q9UI95	252	255	+	3	Q9UI95	0	633	ENST00000235310.7	929	1562	++	0	Q9UI95#4	0	3	ENST00000235310.7	1181	1184	+	3	0	0	4409
Q9UI95#5	0	3	3	Q9UI95	186	189	+	3	Q9UI95	0	529	ENST00000697274.1	72	601	+	279	Q9UI95#5	0	3	ENST00000697274.1	258	261	+	3	0	0	4410
Q9UI95#5	0	3	3	Q9UI95	186	189	+	3	Q9UI95	0	633	ENST00000456915.2	530	1163	++	104	Q9UI95#5	0	3	ENST00000456915.2	716	719	+	3	0	0	4411
Q9UI95#5	0	3	3	Q9UI95	186	189	+	3	Q9UI95	0	501	ENST00000445656.5	85	676	+	95	Q9UI95#5	0	3	ENST00000445656.5	361	364	+	3	0	0	4412
Q9UI95#5	0	3	3	Q9UI95	186	189	+	3	Q9UI95	0	633	ENST00000376692.9	122	755	++	52	Q9UI95#5	0	3	ENST00000376692.9	308	311	+	3	0	0	4413
Q9UI95#5	0	3	3	Q9UI95	186	189	+	3	Q9UI95	0	633	ENST00000376672.5	77	749	+	51	Q9UI95#5	0	3	ENST00000376672.5	263	266	+	3	0	0	4414
Q9UI95#5	0	3	3	Q9UI95	186	189	+	3	Q9UI95	0	633	ENST00000376669.9	92	764	+	50	Q9UI95#5	0	3	ENST00000376669.9	278	281	+	3	0	0	4415
Q9UI95#5	0	3	3	Q9UI95	186	189	+	3	Q9UI95	0	633	ENST00000376667.7	209	842	++	49	Q9UI95#5	0	3	ENST00000376667.7	395	398	+	3	0	0	4416
Q9UI95#5	0	3	3	Q9UI95	186	189	+	3	Q9UI95	0	633	ENST00000235310.7	929	1562	++	0	Q9UI95#5	0	3	ENST00000235310.7	1115	1118	+	3	0	0	4417
Q9UI95#6	0	3	3	Q9UI95	369	372	+	3	Q9UI95	0	529	ENST00000697274.1	72	601	+	279	Q9UI95#6	0	3	ENST00000697274.1	441	444	+	3	0	0	4418
Q9UI95#6	0	3	3	Q9UI95	369	372	+	3	Q9UI95	0	633	ENST00000456915.2	530	1163	++	104	Q9UI95#6	0	3	ENST00000456915.2	899	902	+	3	0	0	4419
Q9UI95#6	0	3	3	Q9UI95	369	372	+	3	Q9UI95	0	501	ENST00000445656.5	85	676	+	95	Q9UI95#6	0	3	ENST00000445656.5	544	547	+	3	0	0	4420
Q9UI95#6	0	3	3	Q9UI95	369	372	+	3	Q9UI95	0	633	ENST00000376692.9	122	755	++	52	Q9UI95#6	0	3	ENST00000376692.9	491	494	+	3	0	0	4421
Q9UI95#6	0	3	3	Q9UI95	369	372	+	3	Q9UI95	0	633	ENST00000376672.5	77	749	+	51	Q9UI95#6	0	3	ENST00000376672.5	485	488	+	3	0	0	4422
Q9UI95#6	0	3	3	Q9UI95	369	372	+	3	Q9UI95	0	633	ENST00000376669.9	92	764	+	50	Q9UI95#6	0	3	ENST00000376669.9	500	503	+	3	0	0	4423
Q9UI95#6	0	3	3	Q9UI95	369	372	+	3	Q9UI95	0	633	ENST00000376667.7	209	842	++	49	Q9UI95#6	0	3	ENST00000376667.7	578	581	+	3	0	0	4424
Q9UI95#6	0	3	3	Q9UI95	369	372	+	3	Q9UI95	0	633	ENST00000235310.7	929	1562	++	0	Q9UI95#6	0	3	ENST00000235310.7	1298	1301	+	3	0	0	4425
Q9UI95#7	0	3	3	Q9UI95	510	513	+	3	Q9UI95	0	529	ENST00000697274.1	72	601	+	279	Q9UI95#7	0	3	ENST00000697274.1	582	585	+	3	0	0	4426
Q9UI95#7	0	3	3	Q9UI95	510	513	+	3	Q9UI95	436	633	ENST00000697272.1	0	197	+	277	Q9UI95#7	0	3	ENST00000697272.1	74	77	+	3	0	0	4427
Q9UI95#7	0	3	3	Q9UI95	510	513	+	3	Q9UI95	0	633	ENST00000456915.2	530	1163	++	104	Q9UI95#7	0	3	ENST00000456915.2	1040	1043	+	3	0	0	4428
Q9UI95#7	0	3	3	Q9UI95	510	513	+	3	Q9UI95	0	633	ENST00000376692.9	122	755	++	52	Q9UI95#7	0	3	ENST00000376692.9	632	635	+	3	0	0	4429
Q9UI95#7	0	3	3	Q9UI95	510	513	+	3	Q9UI95	0	633	ENST00000376672.5	77	749	+	51	Q9UI95#7	0	3	ENST00000376672.5	626	629	+	3	0	0	4430
Q9UI95#7	0	3	3	Q9UI95	510	513	+	3	Q9UI95	0	633	ENST00000376669.9	92	764	+	50	Q9UI95#7	0	3	ENST00000376669.9	641	644	+	3	0	0	4431
Q9UI95#7	0	3	3	Q9UI95	510	513	+	3	Q9UI95	0	633	ENST00000376667.7	209	842	++	49	Q9UI95#7	0	3	ENST00000376667.7	719	722	+	3	0	0	4432
Q9UI95#7	0	3	3	Q9UI95	510	513	+	3	Q9UI95	0	633	ENST00000235310.7	929	1562	++	0	Q9UI95#7	0	3	ENST00000235310.7	1439	1442	+	3	0	0	4433
Q9UI95#8	0	3	3	Q9UI95	555	558	+	3	Q9UI95	436	633	ENST00000697272.1	0	197	+	277	Q9UI95#8	0	3	ENST00000697272.1	119	122	+	3	0	0	4434
Q9UI95#8	0	3	3	Q9UI95	555	558	+	3	Q9UI95	0	633	ENST00000456915.2	530	1163	++	104	Q9UI95#8	0	3	ENST00000456915.2	1085	1088	+	3	0	0	4435
Q9UI95#8	0	3	3	Q9UI95	555	558	+	3	Q9UI95	0	633	ENST00000376692.9	122	755	++	52	Q9UI95#8	0	3	ENST00000376692.9	677	680	+	3	0	0	4436
Q9UI95#8	0	3	3	Q9UI95	555	558	+	3	Q9UI95	0	633	ENST00000376672.5	77	749	+	51	Q9UI95#8	0	3	ENST00000376672.5	671	674	+	3	0	0	4437
Q9UI95#8	0	3	3	Q9UI95	555	558	+	3	Q9UI95	0	633	ENST00000376669.9	92	764	+	50	Q9UI95#8	0	3	ENST00000376669.9	686	689	+	3	0	0	4438
Q9UI95#8	0	3	3	Q9UI95	555	558	+	3	Q9UI95	0	633	ENST00000376667.7	209	842	++	49	Q9UI95#8	0	3	ENST00000376667.7	764	767	+	3	0	0	4439
Q9UI95#8	0	3	3	Q9UI95	555	558	+	3	Q9UI95	0	633	ENST00000235310.7	929	1562	++	0	Q9UI95#8	0	3	ENST00000235310.7	1484	1487	+	3	0	0	4440
Q9UI95#9	0	3	3	Q9UI95	597	600	+	3	Q9UI95	436	633	ENST00000697272.1	0	197	+	277	Q9UI95#9	0	3	ENST00000697272.1	161	164	+	3	0	0	4441
Q9UI95#9	0	3	3	Q9UI95	597	600	+	3	Q9UI95	0	633	ENST00000456915.2	530	1163	++	104	Q9UI95#9	0	3	ENST00000456915.2	1127	1130	+	3	0	0	4442
Q9UI95#9	0	3	3	Q9UI95	597	600	+	3	Q9UI95	0	633	ENST00000376692.9	122	755	++	52	Q9UI95#9	0	3	ENST00000376692.9	719	722	+	3	0	0	4443
Q9UI95#9	0	3	3	Q9UI95	597	600	+	3	Q9UI95	0	633	ENST00000376672.5	77	749	+	51	Q9UI95#9	0	3	ENST00000376672.5	713	716	+	3	0	0	4444
Q9UI95#9	0	3	3	Q9UI95	597	600	+	3	Q9UI95	0	633	ENST00000376669.9	92	764	+	50	Q9UI95#9	0	3	ENST00000376669.9	728	731	+	3	0	0	4445
Q9UI95#9	0	3	3	Q9UI95	597	600	+	3	Q9UI95	0	633	ENST00000376667.7	209	842	++	49	Q9UI95#9	0	3	ENST00000376667.7	806	809	+	3	0	0	4446
Q9UI95#9	0	3	3	Q9UI95	597	600	+	3	Q9UI95	0	633	ENST00000235310.7	929	1562	++	0	Q9UI95#9	0	3	ENST00000235310.7	1526	1529	+	3	0	0	4447
Q9UI95#10	0	3	3	Q9UI95	603	606	+	3	Q9UI95	436	633	ENST00000697272.1	0	197	+	277	Q9UI95#10	0	3	ENST00000697272.1	167	170	+	3	0	0	4448
Q9UI95#10	0	3	3	Q9UI95	603	606	+	3	Q9UI95	0	633	ENST00000456915.2	530	1163	++	104	Q9UI95#10	0	3	ENST00000456915.2	1133	1136	+	3	0	0	4449
Q9UI95#10	0	3	3	Q9UI95	603	606	+	3	Q9UI95	0	633	ENST00000376692.9	122	755	++	52	Q9UI95#10	0	3	ENST00000376692.9	725	728	+	3	0	0	4450
Q9UI95#10	0	3	3	Q9UI95	603	606	+	3	Q9UI95	0	633	ENST00000376672.5	77	749	+	51	Q9UI95#10	0	3	ENST00000376672.5	719	722	+	3	0	0	4451
Q9UI95#10	0	3	3	Q9UI95	603	606	+	3	Q9UI95	0	633	ENST00000376669.9	92	764	+	50	Q9UI95#10	0	3	ENST00000376669.9	734	737	+	3	0	0	4452
Q9UI95#10	0	3	3	Q9UI95	603	606	+	3	Q9UI95	0	633	ENST00000376667.7	209	842	++	49	Q9UI95#10	0	3	ENST00000376667.7	812	815	+	3	0	0	4453
Q9UI95#10	0	3	3	Q9UI95	603	606	+	3	Q9UI95	0	633	ENST00000235310.7	929	1562	++	0	Q9UI95#10	0	3	ENST00000235310.7	1532	1535	+	3	0	0	4454
Q9UI95#11	0	3	3	Q9UI95	48	51	+	3	Q9UI95	0	529	ENST00000697274.1	72	601	+	279	Q9UI95#11	0	3	ENST00000697274.1	120	123	+	3	0	0	4455
Q9UI95#11	0	3	3	Q9UI95	48	51	+	3	Q9UI95	0	181	ENST00000697273.1	96	258	+	278	Q9UI95#11	0	3	ENST00000697273.1	144	147	+	3	0	0	4456
Q9UI95#11	0	3	3	Q9UI95	48	51	+	3	Q9UI95	0	633	ENST00000456915.2	530	1163	++	104	Q9UI95#11	0	3	ENST00000456915.2	578	581	+	3	0	0	4457
Q9UI95#11	0	3	3	Q9UI95	48	51	+	3	Q9UI95	0	501	ENST00000445656.5	85	676	+	95	Q9UI95#11	0	3	ENST00000445656.5	223	226	+	3	0	0	4458
Q9UI95#11	0	3	3	Q9UI95	48	51	+	3	Q9UI95	0	633	ENST00000376692.9	122	755	++	52	Q9UI95#11	0	3	ENST00000376692.9	170	173	+	3	0	0	4459
Q9UI95#11	0	3	3	Q9UI95	48	51	+	3	Q9UI95	0	633	ENST00000376672.5	77	749	+	51	Q9UI95#11	0	3	ENST00000376672.5	125	128	+	3	0	0	4460
Q9UI95#11	0	3	3	Q9UI95	48	51	+	3	Q9UI95	0	633	ENST00000376669.9	92	764	+	50	Q9UI95#11	0	3	ENST00000376669.9	140	143	+	3	0	0	4461
Q9UI95#11	0	3	3	Q9UI95	48	51	+	3	Q9UI95	0	633	ENST00000376667.7	209	842	++	49	Q9UI95#11	0	3	ENST00000376667.7	257	260	+	3	0	0	4462
Q9UI95#11	0	3	3	Q9UI95	48	51	+	3	Q9UI95	0	633	ENST00000235310.7	929	1562	++	0	Q9UI95#11	0	3	ENST00000235310.7	977	980	+	3	0	0	4463
Q9UI95#12	0	3	3	Q9UI95	285	288	+	3	Q9UI95	0	529	ENST00000697274.1	72	601	+	279	Q9UI95#12	0	3	ENST00000697274.1	357	360	+	3	0	0	4464
Q9UI95#12	0	3	3	Q9UI95	285	288	+	3	Q9UI95	0	633	ENST00000456915.2	530	1163	++	104	Q9UI95#12	0	3	ENST00000456915.2	815	818	+	3	0	0	4465
Q9UI95#12	0	3	3	Q9UI95	285	288	+	3	Q9UI95	0	501	ENST00000445656.5	85	676	+	95	Q9UI95#12	0	3	ENST00000445656.5	460	463	+	3	0	0	4466
Q9UI95#12	0	3	3	Q9UI95	285	288	+	3	Q9UI95	0	633	ENST00000376692.9	122	755	++	52	Q9UI95#12	0	3	ENST00000376692.9	407	410	+	3	0	0	4467
Q9UI95#12	0	3	3	Q9UI95	285	288	+	3	Q9UI95	0	633	ENST00000376672.5	77	749	+	51	Q9UI95#12	0	3	ENST00000376672.5	362	365	+	3	0	0	4468
Q9UI95#12	0	3	3	Q9UI95	285	288	+	3	Q9UI95	0	633	ENST00000376669.9	92	764	+	50	Q9UI95#12	0	3	ENST00000376669.9	377	380	+	3	0	0	4469
Q9UI95#12	0	3	3	Q9UI95	285	288	+	3	Q9UI95	0	633	ENST00000376667.7	209	842	++	49	Q9UI95#12	0	3	ENST00000376667.7	494	497	+	3	0	0	4470
Q9UI95#12	0	3	3	Q9UI95	285	288	+	3	Q9UI95	0	633	ENST00000235310.7	929	1562	++	0	Q9UI95#12	0	3	ENST00000235310.7	1214	1217	+	3	0	0	4471
Q9UI95#13	0	3	3	Q9UI95	594	597	+	3	Q9UI95	436	633	ENST00000697272.1	0	197	+	277	Q9UI95#13	0	3	ENST00000697272.1	158	161	+	3	0	0	4472
Q9UI95#13	0	3	3	Q9UI95	594	597	+	3	Q9UI95	0	633	ENST00000456915.2	530	1163	++	104	Q9UI95#13	0	3	ENST00000456915.2	1124	1127	+	3	0	0	4473
Q9UI95#13	0	3	3	Q9UI95	594	597	+	3	Q9UI95	0	633	ENST00000376692.9	122	755	++	52	Q9UI95#13	0	3	ENST00000376692.9	716	719	+	3	0	0	4474
Q9UI95#13	0	3	3	Q9UI95	594	597	+	3	Q9UI95	0	633	ENST00000376672.5	77	749	+	51	Q9UI95#13	0	3	ENST00000376672.5	710	713	+	3	0	0	4475
Q9UI95#13	0	3	3	Q9UI95	594	597	+	3	Q9UI95	0	633	ENST00000376669.9	92	764	+	50	Q9UI95#13	0	3	ENST00000376669.9	725	728	+	3	0	0	4476
Q9UI95#13	0	3	3	Q9UI95	594	597	+	3	Q9UI95	0	633	ENST00000376667.7	209	842	++	49	Q9UI95#13	0	3	ENST00000376667.7	803	806	+	3	0	0	4477
Q9UI95#13	0	3	3	Q9UI95	594	597	+	3	Q9UI95	0	633	ENST00000235310.7	929	1562	++	0	Q9UI95#13	0	3	ENST00000235310.7	1523	1526	+	3	0	0	4478
Q9UI95#14	0	9	9	Q9UI95	15	24	+	9	Q9UI95	0	529	ENST00000697274.1	72	601	+	279	Q9UI95#14	0	9	ENST00000697274.1	87	96	+	9	0	0	4479
Q9UI95#14	0	9	9	Q9UI95	15	24	+	9	Q9UI95	0	181	ENST00000697273.1	96	258	+	278	Q9UI95#14	0	9	ENST00000697273.1	111	120	+	9	0	0	4480
Q9UI95#14	0	9	9	Q9UI95	15	24	+	9	Q9UI95	0	633	ENST00000456915.2	530	1163	++	104	Q9UI95#14	0	9	ENST00000456915.2	545	554	+	9	0	0	4481
Q9UI95#14	0	9	9	Q9UI95	15	24	+	9	Q9UI95	0	501	ENST00000445656.5	85	676	+	95	Q9UI95#14	0	9	ENST00000445656.5	100	109	+	9	0	0	4482
Q9UI95#14	0	9	9	Q9UI95	15	24	+	9	Q9UI95	0	633	ENST00000376692.9	122	755	++	52	Q9UI95#14	0	9	ENST00000376692.9	137	146	+	9	0	0	4483
Q9UI95#14	0	9	9	Q9UI95	15	24	+	9	Q9UI95	0	633	ENST00000376672.5	77	749	+	51	Q9UI95#14	0	9	ENST00000376672.5	92	101	+	9	0	0	4484
Q9UI95#14	0	9	9	Q9UI95	15	24	+	9	Q9UI95	0	633	ENST00000376669.9	92	764	+	50	Q9UI95#14	0	9	ENST00000376669.9	107	116	+	9	0	0	4485
Q9UI95#14	0	9	9	Q9UI95	15	24	+	9	Q9UI95	0	633	ENST00000376667.7	209	842	++	49	Q9UI95#14	0	9	ENST00000376667.7	224	233	+	9	0	0	4486
Q9UI95#14	0	9	9	Q9UI95	15	24	+	9	Q9UI95	0	633	ENST00000235310.7	929	1562	++	0	Q9UI95#14	0	9	ENST00000235310.7	944	953	+	9	0	0	4487
Q9UI95#15	0	9	9	Q9UI95	27	36	+	9	Q9UI95	0	529	ENST00000697274.1	72	601	+	279	Q9UI95#15	0	9	ENST00000697274.1	99	108	+	9	0	0	4488
Q9UI95#15	0	9	9	Q9UI95	27	36	+	9	Q9UI95	0	181	ENST00000697273.1	96	258	+	278	Q9UI95#15	0	9	ENST00000697273.1	123	132	+	9	0	0	4489
Q9UI95#15	0	9	9	Q9UI95	27	36	+	9	Q9UI95	0	633	ENST00000456915.2	530	1163	++	104	Q9UI95#15	0	9	ENST00000456915.2	557	566	+	9	0	0	4490
Q9UI95#15	0	9	9	Q9UI95	27	36	+	9	Q9UI95	0	501	ENST00000445656.5	85	676	+	95	Q9UI95#15	0	9	ENST00000445656.5	112	121	+	9	0	0	4491
Q9UI95#15	0	9	9	Q9UI95	27	36	+	9	Q9UI95	0	633	ENST00000376692.9	122	755	++	52	Q9UI95#15	0	9	ENST00000376692.9	149	158	+	9	0	0	4492
Q9UI95#15	0	9	9	Q9UI95	27	36	+	9	Q9UI95	0	633	ENST00000376672.5	77	749	+	51	Q9UI95#15	0	9	ENST00000376672.5	104	113	+	9	0	0	4493
Q9UI95#15	0	9	9	Q9UI95	27	36	+	9	Q9UI95	0	633	ENST00000376669.9	92	764	+	50	Q9UI95#15	0	9	ENST00000376669.9	119	128	+	9	0	0	4494
Q9UI95#15	0	9	9	Q9UI95	27	36	+	9	Q9UI95	0	633	ENST00000376667.7	209	842	++	49	Q9UI95#15	0	9	ENST00000376667.7	236	245	+	9	0	0	4495
Q9UI95#15	0	9	9	Q9UI95	27	36	+	9	Q9UI95	0	633	ENST00000235310.7	929	1562	++	0	Q9UI95#15	0	9	ENST00000235310.7	956	965	+	9	0	0	4496
Q9UI95#16	0	63	63	Q9UI95	36	99	+	63	Q9UI95	0	529	ENST00000697274.1	72	601	+	279	Q9UI95#16	0	63	ENST00000697274.1	108	171	+	63	0	0	4497
Q9UI95#16	0	63	63	Q9UI95	36	99	+	63	Q9UI95	0	181	ENST00000697273.1	96	258	+	278	Q9UI95#16	0	63	ENST00000697273.1	132	195	+	63	0	0	4498
Q9UI95#16	0	63	63	Q9UI95	36	99	+	63	Q9UI95	0	633	ENST00000456915.2	530	1163	++	104	Q9UI95#16	0	63	ENST00000456915.2	566	629	+	63	0	0	4499
Q9UI95#16	0	63	63	Q9UI95	36	99	+	63	Q9UI95	0	501	ENST00000445656.5	85	676	+	95	Q9UI95#16	0	63	ENST00000445656.5	121	274	+	63	0	0	4500
Q9UI95#16	0	63	63	Q9UI95	36	99	+	63	Q9UI95	0	633	ENST00000376692.9	122	755	++	52	Q9UI95#16	0	63	ENST00000376692.9	158	221	+	63	0	0	4501
Q9UI95#16	0	63	63	Q9UI95	36	99	+	63	Q9UI95	0	633	ENST00000376672.5	77	749	+	51	Q9UI95#16	0	63	ENST00000376672.5	113	176	+	63	0	0	4502
Q9UI95#16	0	63	63	Q9UI95	36	99	+	63	Q9UI95	0	633	ENST00000376669.9	92	764	+	50	Q9UI95#16	0	63	ENST00000376669.9	128	191	+	63	0	0	4503
Q9UI95#16	0	63	63	Q9UI95	36	99	+	63	Q9UI95	0	633	ENST00000376667.7	209	842	++	49	Q9UI95#16	0	63	ENST00000376667.7	245	308	+	63	0	0	4504
Q9UI95#16	0	63	63	Q9UI95	36	99	+	63	Q9UI95	0	633	ENST00000235310.7	929	1562	++	0	Q9UI95#16	0	63	ENST00000235310.7	965	1028	+	63	0	0	4505
Q9UI95#17	0	9	9	Q9UI95	114	123	+	9	Q9UI95	0	529	ENST00000697274.1	72	601	+	279	Q9UI95#17	0	9	ENST00000697274.1	186	195	+	9	0	0	4506
Q9UI95#17	0	9	9	Q9UI95	114	123	+	9	Q9UI95	0	181	ENST00000697273.1	96	258	+	278	Q9UI95#17	0	9	ENST00000697273.1	210	219	+	9	0	0	4507
Q9UI95#17	0	9	9	Q9UI95	114	123	+	9	Q9UI95	0	633	ENST00000456915.2	530	1163	++	104	Q9UI95#17	0	9	ENST00000456915.2	644	653	+	9	0	0	4508
Q9UI95#17	0	9	9	Q9UI95	114	123	+	9	Q9UI95	0	501	ENST00000445656.5	85	676	+	95	Q9UI95#17	0	9	ENST00000445656.5	289	298	+	9	0	0	4509
Q9UI95#17	0	9	9	Q9UI95	114	123	+	9	Q9UI95	0	633	ENST00000376692.9	122	755	++	52	Q9UI95#17	0	9	ENST00000376692.9	236	245	+	9	0	0	4510
Q9UI95#17	0	9	9	Q9UI95	114	123	+	9	Q9UI95	0	633	ENST00000376672.5	77	749	+	51	Q9UI95#17	0	9	ENST00000376672.5	191	200	+	9	0	0	4511
Q9UI95#17	0	9	9	Q9UI95	114	123	+	9	Q9UI95	0	633	ENST00000376669.9	92	764	+	50	Q9UI95#17	0	9	ENST00000376669.9	206	215	+	9	0	0	4512
Q9UI95#17	0	9	9	Q9UI95	114	123	+	9	Q9UI95	0	633	ENST00000376667.7	209	842	++	49	Q9UI95#17	0	9	ENST00000376667.7	323	332	+	9	0	0	4513
Q9UI95#17	0	9	9	Q9UI95	114	123	+	9	Q9UI95	0	633	ENST00000235310.7	929	1562	++	0	Q9UI95#17	0	9	ENST00000235310.7	1043	1052	+	9	0	0	4514
Q9UI95#18	0	18	18	Q9UI95	123	141	+	18	Q9UI95	0	529	ENST00000697274.1	72	601	+	279	Q9UI95#18	0	18	ENST00000697274.1	195	213	+	18	0	0	4515
Q9UI95#18	0	18	18	Q9UI95	123	141	+	18	Q9UI95	0	181	ENST00000697273.1	96	258	+	278	Q9UI95#18	0	17	ENST00000697273.1	219	236	+	17	0	1	4516
Q9UI95#18	0	18	18	Q9UI95	123	141	+	18	Q9UI95	0	633	ENST00000456915.2	530	1163	++	104	Q9UI95#18	0	18	ENST00000456915.2	653	671	+	18	0	0	4517
Q9UI95#18	0	18	18	Q9UI95	123	141	+	18	Q9UI95	0	501	ENST00000445656.5	85	676	+	95	Q9UI95#18	0	18	ENST00000445656.5	298	316	+	18	0	0	4518
Q9UI95#18	0	18	18	Q9UI95	123	141	+	18	Q9UI95	0	633	ENST00000376692.9	122	755	++	52	Q9UI95#18	0	18	ENST00000376692.9	245	263	+	18	0	0	4519
Q9UI95#18	0	18	18	Q9UI95	123	141	+	18	Q9UI95	0	633	ENST00000376672.5	77	749	+	51	Q9UI95#18	0	18	ENST00000376672.5	200	218	+	18	0	0	4520
Q9UI95#18	0	18	18	Q9UI95	123	141	+	18	Q9UI95	0	633	ENST00000376669.9	92	764	+	50	Q9UI95#18	0	18	ENST00000376669.9	215	233	+	18	0	0	4521
Q9UI95#18	0	18	18	Q9UI95	123	141	+	18	Q9UI95	0	633	ENST00000376667.7	209	842	++	49	Q9UI95#18	0	18	ENST00000376667.7	332	350	+	18	0	0	4522
Q9UI95#18	0	18	18	Q9UI95	123	141	+	18	Q9UI95	0	633	ENST00000235310.7	929	1562	++	0	Q9UI95#18	0	18	ENST00000235310.7	1052	1070	+	18	0	0	4523
Q9UI95#19	0	18	18	Q9UI95	147	165	+	18	Q9UI95	0	529	ENST00000697274.1	72	601	+	279	Q9UI95#19	0	18	ENST00000697274.1	219	237	+	18	0	0	4524
Q9UI95#19	0	18	18	Q9UI95	147	165	+	18	Q9UI95	0	181	ENST00000697273.1	96	258	+	278	Q9UI95#19	12	18	ENST00000697273.1	236	242	+	6	12	0	4525
Q9UI95#19	0	18	18	Q9UI95	147	165	+	18	Q9UI95	0	633	ENST00000456915.2	530	1163	++	104	Q9UI95#19	0	18	ENST00000456915.2	677	695	+	18	0	0	4526
Q9UI95#19	0	18	18	Q9UI95	147	165	+	18	Q9UI95	0	501	ENST00000445656.5	85	676	+	95	Q9UI95#19	0	18	ENST00000445656.5	322	340	+	18	0	0	4527
Q9UI95#19	0	18	18	Q9UI95	147	165	+	18	Q9UI95	0	633	ENST00000376692.9	122	755	++	52	Q9UI95#19	0	18	ENST00000376692.9	269	287	+	18	0	0	4528
Q9UI95#19	0	18	18	Q9UI95	147	165	+	18	Q9UI95	0	633	ENST00000376672.5	77	749	+	51	Q9UI95#19	0	18	ENST00000376672.5	224	242	+	18	0	0	4529
Q9UI95#19	0	18	18	Q9UI95	147	165	+	18	Q9UI95	0	633	ENST00000376669.9	92	764	+	50	Q9UI95#19	0	18	ENST00000376669.9	239	257	+	18	0	0	4530
Q9UI95#19	0	18	18	Q9UI95	147	165	+	18	Q9UI95	0	633	ENST00000376667.7	209	842	++	49	Q9UI95#19	0	18	ENST00000376667.7	356	374	+	18	0	0	4531
Q9UI95#19	0	18	18	Q9UI95	147	165	+	18	Q9UI95	0	633	ENST00000235310.7	929	1562	++	0	Q9UI95#19	0	18	ENST00000235310.7	1076	1094	+	18	0	0	4532
Q9UI95#20	0	57	57	Q9UI95	171	228	+	57	Q9UI95	0	529	ENST00000697274.1	72	601	+	279	Q9UI95#20	0	57	ENST00000697274.1	243	300	+	57	0	0	4533
Q9UI95#20	0	57	57	Q9UI95	171	228	+	57	Q9UI95	0	181	ENST00000697273.1	96	258	+	278	Q9UI95#20	0	10	ENST00000697273.1	248	258	+	10	0	47	4534
Q9UI95#20	0	57	57	Q9UI95	171	228	+	57	Q9UI95	0	633	ENST00000456915.2	530	1163	++	104	Q9UI95#20	0	57	ENST00000456915.2	701	758	+	57	0	0	4535
Q9UI95#20	0	57	57	Q9UI95	171	228	+	57	Q9UI95	0	501	ENST00000445656.5	85	676	+	95	Q9UI95#20	0	57	ENST00000445656.5	346	403	+	57	0	0	4536
Q9UI95#20	0	57	57	Q9UI95	171	228	+	57	Q9UI95	0	633	ENST00000376692.9	122	755	++	52	Q9UI95#20	0	57	ENST00000376692.9	293	350	+	57	0	0	4537
Q9UI95#20	0	57	57	Q9UI95	171	228	+	57	Q9UI95	0	633	ENST00000376672.5	77	749	+	51	Q9UI95#20	0	57	ENST00000376672.5	248	305	+	57	0	0	4538
Q9UI95#20	0	57	57	Q9UI95	171	228	+	57	Q9UI95	0	633	ENST00000376669.9	92	764	+	50	Q9UI95#20	0	57	ENST00000376669.9	263	320	+	57	0	0	4539
Q9UI95#20	0	57	57	Q9UI95	171	228	+	57	Q9UI95	0	633	ENST00000376667.7	209	842	++	49	Q9UI95#20	0	57	ENST00000376667.7	380	437	+	57	0	0	4540
Q9UI95#20	0	57	57	Q9UI95	171	228	+	57	Q9UI95	0	633	ENST00000235310.7	929	1562	++	0	Q9UI95#20	0	57	ENST00000235310.7	1100	1157	+	57	0	0	4541
Q9UI95#21	0	27	27	Q9UI95	237	264	+	27	Q9UI95	0	529	ENST00000697274.1	72	601	+	279	Q9UI95#21	0	27	ENST00000697274.1	309	336	+	27	0	0	4542
Q9UI95#21	0	27	27	Q9UI95	237	264	+	27	Q9UI95	0	633	ENST00000456915.2	530	1163	++	104	Q9UI95#21	0	27	ENST00000456915.2	767	794	+	27	0	0	4543
Q9UI95#21	0	27	27	Q9UI95	237	264	+	27	Q9UI95	0	501	ENST00000445656.5	85	676	+	95	Q9UI95#21	0	27	ENST00000445656.5	412	439	+	27	0	0	4544
Q9UI95#21	0	27	27	Q9UI95	237	264	+	27	Q9UI95	0	633	ENST00000376692.9	122	755	++	52	Q9UI95#21	0	27	ENST00000376692.9	359	386	+	27	0	0	4545
Q9UI95#21	0	27	27	Q9UI95	237	264	+	27	Q9UI95	0	633	ENST00000376672.5	77	749	+	51	Q9UI95#21	0	27	ENST00000376672.5	314	341	+	27	0	0	4546
Q9UI95#21	0	27	27	Q9UI95	237	264	+	27	Q9UI95	0	633	ENST00000376669.9	92	764	+	50	Q9UI95#21	0	27	ENST00000376669.9	329	356	+	27	0	0	4547
Q9UI95#21	0	27	27	Q9UI95	237	264	+	27	Q9UI95	0	633	ENST00000376667.7	209	842	++	49	Q9UI95#21	0	27	ENST00000376667.7	446	473	+	27	0	0	4548
Q9UI95#21	0	27	27	Q9UI95	237	264	+	27	Q9UI95	0	633	ENST00000235310.7	929	1562	++	0	Q9UI95#21	0	27	ENST00000235310.7	1166	1193	+	27	0	0	4549
Q9UI95#22	0	9	9	Q9UI95	267	276	+	9	Q9UI95	0	529	ENST00000697274.1	72	601	+	279	Q9UI95#22	0	9	ENST00000697274.1	339	348	+	9	0	0	4550
Q9UI95#22	0	9	9	Q9UI95	267	276	+	9	Q9UI95	0	633	ENST00000456915.2	530	1163	++	104	Q9UI95#22	0	9	ENST00000456915.2	797	806	+	9	0	0	4551
Q9UI95#22	0	9	9	Q9UI95	267	276	+	9	Q9UI95	0	501	ENST00000445656.5	85	676	+	95	Q9UI95#22	0	9	ENST00000445656.5	442	451	+	9	0	0	4552
Q9UI95#22	0	9	9	Q9UI95	267	276	+	9	Q9UI95	0	633	ENST00000376692.9	122	755	++	52	Q9UI95#22	0	9	ENST00000376692.9	389	398	+	9	0	0	4553
Q9UI95#22	0	9	9	Q9UI95	267	276	+	9	Q9UI95	0	633	ENST00000376672.5	77	749	+	51	Q9UI95#22	0	9	ENST00000376672.5	344	353	+	9	0	0	4554
Q9UI95#22	0	9	9	Q9UI95	267	276	+	9	Q9UI95	0	633	ENST00000376669.9	92	764	+	50	Q9UI95#22	0	9	ENST00000376669.9	359	368	+	9	0	0	4555
Q9UI95#22	0	9	9	Q9UI95	267	276	+	9	Q9UI95	0	633	ENST00000376667.7	209	842	++	49	Q9UI95#22	0	9	ENST00000376667.7	476	485	+	9	0	0	4556
Q9UI95#22	0	9	9	Q9UI95	267	276	+	9	Q9UI95	0	633	ENST00000235310.7	929	1562	++	0	Q9UI95#22	0	9	ENST00000235310.7	1196	1205	+	9	0	0	4557
Q9UI95#23	0	30	30	Q9UI95	279	309	+	30	Q9UI95	0	529	ENST00000697274.1	72	601	+	279	Q9UI95#23	0	30	ENST00000697274.1	351	381	+	30	0	0	4558
Q9UI95#23	0	30	30	Q9UI95	279	309	+	30	Q9UI95	0	633	ENST00000456915.2	530	1163	++	104	Q9UI95#23	0	30	ENST00000456915.2	809	839	+	30	0	0	4559
Q9UI95#23	0	30	30	Q9UI95	279	309	+	30	Q9UI95	0	501	ENST00000445656.5	85	676	+	95	Q9UI95#23	0	30	ENST00000445656.5	454	484	+	30	0	0	4560
Q9UI95#23	0	30	30	Q9UI95	279	309	+	30	Q9UI95	0	633	ENST00000376692.9	122	755	++	52	Q9UI95#23	0	30	ENST00000376692.9	401	431	+	30	0	0	4561
Q9UI95#23	0	30	30	Q9UI95	279	309	+	30	Q9UI95	0	633	ENST00000376672.5	77	749	+	51	Q9UI95#23	0	30	ENST00000376672.5	356	386	+	30	0	0	4562
Q9UI95#23	0	30	30	Q9UI95	279	309	+	30	Q9UI95	0	633	ENST00000376669.9	92	764	+	50	Q9UI95#23	0	30	ENST00000376669.9	371	401	+	30	0	0	4563
Q9UI95#23	0	30	30	Q9UI95	279	309	+	30	Q9UI95	0	633	ENST00000376667.7	209	842	++	49	Q9UI95#23	0	30	ENST00000376667.7	488	518	+	30	0	0	4564
Q9UI95#23	0	30	30	Q9UI95	279	309	+	30	Q9UI95	0	633	ENST00000235310.7	929	1562	++	0	Q9UI95#23	0	30	ENST00000235310.7	1208	1238	+	30	0	0	4565
Q9UI95#24	0	18	18	Q9UI95	315	333	+	18	Q9UI95	0	529	ENST00000697274.1	72	601	+	279	Q9UI95#24	0	18	ENST00000697274.1	387	405	+	18	0	0	4566
Q9UI95#24	0	18	18	Q9UI95	315	333	+	18	Q9UI95	0	633	ENST00000456915.2	530	1163	++	104	Q9UI95#24	0	18	ENST00000456915.2	845	863	+	18	0	0	4567
Q9UI95#24	0	18	18	Q9UI95	315	333	+	18	Q9UI95	0	501	ENST00000445656.5	85	676	+	95	Q9UI95#24	0	18	ENST00000445656.5	490	508	+	18	0	0	4568
Q9UI95#24	0	18	18	Q9UI95	315	333	+	18	Q9UI95	0	633	ENST00000376692.9	122	755	++	52	Q9UI95#24	0	18	ENST00000376692.9	437	455	+	18	0	0	4569
Q9UI95#24	0	18	18	Q9UI95	315	333	+	18	Q9UI95	0	633	ENST00000376672.5	77	749	+	51	Q9UI95#24	0	18	ENST00000376672.5	392	449	+	18	0	0	4570
Q9UI95#24	0	18	18	Q9UI95	315	333	+	18	Q9UI95	0	633	ENST00000376669.9	92	764	+	50	Q9UI95#24	0	18	ENST00000376669.9	407	464	+	18	0	0	4571
Q9UI95#24	0	18	18	Q9UI95	315	333	+	18	Q9UI95	0	633	ENST00000376667.7	209	842	++	49	Q9UI95#24	0	18	ENST00000376667.7	524	542	+	18	0	0	4572
Q9UI95#24	0	18	18	Q9UI95	315	333	+	18	Q9UI95	0	633	ENST00000235310.7	929	1562	++	0	Q9UI95#24	0	18	ENST00000235310.7	1244	1262	+	18	0	0	4573
Q9UI95#25	0	9	9	Q9UI95	333	342	+	9	Q9UI95	0	529	ENST00000697274.1	72	601	+	279	Q9UI95#25	0	9	ENST00000697274.1	405	414	+	9	0	0	4574
Q9UI95#25	0	9	9	Q9UI95	333	342	+	9	Q9UI95	0	633	ENST00000456915.2	530	1163	++	104	Q9UI95#25	0	9	ENST00000456915.2	863	872	+	9	0	0	4575
Q9UI95#25	0	9	9	Q9UI95	333	342	+	9	Q9UI95	0	501	ENST00000445656.5	85	676	+	95	Q9UI95#25	0	9	ENST00000445656.5	508	517	+	9	0	0	4576
Q9UI95#25	0	9	9	Q9UI95	333	342	+	9	Q9UI95	0	633	ENST00000376692.9	122	755	++	52	Q9UI95#25	0	9	ENST00000376692.9	455	464	+	9	0	0	4577
Q9UI95#25	0	9	9	Q9UI95	333	342	+	9	Q9UI95	0	633	ENST00000376672.5	77	749	+	51	Q9UI95#25	0	9	ENST00000376672.5	449	458	+	9	0	0	4578
Q9UI95#25	0	9	9	Q9UI95	333	342	+	9	Q9UI95	0	633	ENST00000376669.9	92	764	+	50	Q9UI95#25	0	9	ENST00000376669.9	464	473	+	9	0	0	4579
Q9UI95#25	0	9	9	Q9UI95	333	342	+	9	Q9UI95	0	633	ENST00000376667.7	209	842	++	49	Q9UI95#25	0	9	ENST00000376667.7	542	551	+	9	0	0	4580
Q9UI95#25	0	9	9	Q9UI95	333	342	+	9	Q9UI95	0	633	ENST00000235310.7	929	1562	++	0	Q9UI95#25	0	9	ENST00000235310.7	1262	1271	+	9	0	0	4581
Q9UI95#26	0	12	12	Q9UI95	342	354	+	12	Q9UI95	0	529	ENST00000697274.1	72	601	+	279	Q9UI95#26	0	12	ENST00000697274.1	414	426	+	12	0	0	4582
Q9UI95#26	0	12	12	Q9UI95	342	354	+	12	Q9UI95	0	633	ENST00000456915.2	530	1163	++	104	Q9UI95#26	0	12	ENST00000456915.2	872	884	+	12	0	0	4583
Q9UI95#26	0	12	12	Q9UI95	342	354	+	12	Q9UI95	0	501	ENST00000445656.5	85	676	+	95	Q9UI95#26	0	12	ENST00000445656.5	517	529	+	12	0	0	4584
Q9UI95#26	0	12	12	Q9UI95	342	354	+	12	Q9UI95	0	633	ENST00000376692.9	122	755	++	52	Q9UI95#26	0	12	ENST00000376692.9	464	476	+	12	0	0	4585
Q9UI95#26	0	12	12	Q9UI95	342	354	+	12	Q9UI95	0	633	ENST00000376672.5	77	749	+	51	Q9UI95#26	0	12	ENST00000376672.5	458	470	+	12	0	0	4586
Q9UI95#26	0	12	12	Q9UI95	342	354	+	12	Q9UI95	0	633	ENST00000376669.9	92	764	+	50	Q9UI95#26	0	12	ENST00000376669.9	473	485	+	12	0	0	4587
Q9UI95#26	0	12	12	Q9UI95	342	354	+	12	Q9UI95	0	633	ENST00000376667.7	209	842	++	49	Q9UI95#26	0	12	ENST00000376667.7	551	563	+	12	0	0	4588
Q9UI95#26	0	12	12	Q9UI95	342	354	+	12	Q9UI95	0	633	ENST00000235310.7	929	1562	++	0	Q9UI95#26	0	12	ENST00000235310.7	1271	1283	+	12	0	0	4589
Q9UI95#27	0	39	39	Q9UI95	354	393	+	39	Q9UI95	0	529	ENST00000697274.1	72	601	+	279	Q9UI95#27	0	39	ENST00000697274.1	426	465	+	39	0	0	4590
Q9UI95#27	0	39	39	Q9UI95	354	393	+	39	Q9UI95	0	633	ENST00000456915.2	530	1163	++	104	Q9UI95#27	0	39	ENST00000456915.2	884	923	+	39	0	0	4591
Q9UI95#27	0	39	39	Q9UI95	354	393	+	39	Q9UI95	0	501	ENST00000445656.5	85	676	+	95	Q9UI95#27	0	39	ENST00000445656.5	529	568	+	39	0	0	4592
Q9UI95#27	0	39	39	Q9UI95	354	393	+	39	Q9UI95	0	633	ENST00000376692.9	122	755	++	52	Q9UI95#27	0	39	ENST00000376692.9	476	515	+	39	0	0	4593
Q9UI95#27	0	39	39	Q9UI95	354	393	+	39	Q9UI95	0	633	ENST00000376672.5	77	749	+	51	Q9UI95#27	0	39	ENST00000376672.5	470	509	+	39	0	0	4594
Q9UI95#27	0	39	39	Q9UI95	354	393	+	39	Q9UI95	0	633	ENST00000376669.9	92	764	+	50	Q9UI95#27	0	39	ENST00000376669.9	485	524	+	39	0	0	4595
Q9UI95#27	0	39	39	Q9UI95	354	393	+	39	Q9UI95	0	633	ENST00000376667.7	209	842	++	49	Q9UI95#27	0	39	ENST00000376667.7	563	602	+	39	0	0	4596
Q9UI95#27	0	39	39	Q9UI95	354	393	+	39	Q9UI95	0	633	ENST00000235310.7	929	1562	++	0	Q9UI95#27	0	39	ENST00000235310.7	1283	1322	+	39	0	0	4597
Q9UI95#28	0	9	9	Q9UI95	396	405	+	9	Q9UI95	0	529	ENST00000697274.1	72	601	+	279	Q9UI95#28	0	9	ENST00000697274.1	468	477	+	9	0	0	4598
Q9UI95#28	0	9	9	Q9UI95	396	405	+	9	Q9UI95	0	633	ENST00000456915.2	530	1163	++	104	Q9UI95#28	0	9	ENST00000456915.2	926	935	+	9	0	0	4599
Q9UI95#28	0	9	9	Q9UI95	396	405	+	9	Q9UI95	0	501	ENST00000445656.5	85	676	+	95	Q9UI95#28	0	9	ENST00000445656.5	571	580	+	9	0	0	4600
Q9UI95#28	0	9	9	Q9UI95	396	405	+	9	Q9UI95	0	633	ENST00000376692.9	122	755	++	52	Q9UI95#28	0	9	ENST00000376692.9	518	527	+	9	0	0	4601
Q9UI95#28	0	9	9	Q9UI95	396	405	+	9	Q9UI95	0	633	ENST00000376672.5	77	749	+	51	Q9UI95#28	0	9	ENST00000376672.5	512	521	+	9	0	0	4602
Q9UI95#28	0	9	9	Q9UI95	396	405	+	9	Q9UI95	0	633	ENST00000376669.9	92	764	+	50	Q9UI95#28	0	9	ENST00000376669.9	527	536	+	9	0	0	4603
Q9UI95#28	0	9	9	Q9UI95	396	405	+	9	Q9UI95	0	633	ENST00000376667.7	209	842	++	49	Q9UI95#28	0	9	ENST00000376667.7	605	614	+	9	0	0	4604
Q9UI95#28	0	9	9	Q9UI95	396	405	+	9	Q9UI95	0	633	ENST00000235310.7	929	1562	++	0	Q9UI95#28	0	9	ENST00000235310.7	1325	1334	+	9	0	0	4605
Q9UI95#29	0	33	33	Q9UI95	432	465	+	33	Q9UI95	0	529	ENST00000697274.1	72	601	+	279	Q9UI95#29	0	33	ENST00000697274.1	504	537	+	33	0	0	4606
Q9UI95#29	0	33	33	Q9UI95	432	465	+	33	Q9UI95	436	633	ENST00000697272.1	0	197	+	277	Q9UI95#29	4	33	ENST00000697272.1	0	29	+	29	4	0	4607
Q9UI95#29	0	33	33	Q9UI95	432	465	+	33	Q9UI95	0	633	ENST00000456915.2	530	1163	++	104	Q9UI95#29	0	33	ENST00000456915.2	962	995	+	33	0	0	4608
Q9UI95#29	0	33	33	Q9UI95	432	465	+	33	Q9UI95	0	501	ENST00000445656.5	85	676	+	95	Q9UI95#29	0	33	ENST00000445656.5	607	640	+	33	0	0	4609
Q9UI95#29	0	33	33	Q9UI95	432	465	+	33	Q9UI95	0	633	ENST00000376692.9	122	755	++	52	Q9UI95#29	0	33	ENST00000376692.9	554	587	+	33	0	0	4610
Q9UI95#29	0	33	33	Q9UI95	432	465	+	33	Q9UI95	0	633	ENST00000376672.5	77	749	+	51	Q9UI95#29	0	33	ENST00000376672.5	548	581	+	33	0	0	4611
Q9UI95#29	0	33	33	Q9UI95	432	465	+	33	Q9UI95	0	633	ENST00000376669.9	92	764	+	50	Q9UI95#29	0	33	ENST00000376669.9	563	596	+	33	0	0	4612
Q9UI95#29	0	33	33	Q9UI95	432	465	+	33	Q9UI95	0	633	ENST00000376667.7	209	842	++	49	Q9UI95#29	0	33	ENST00000376667.7	641	674	+	33	0	0	4613
Q9UI95#29	0	33	33	Q9UI95	432	465	+	33	Q9UI95	0	633	ENST00000235310.7	929	1562	++	0	Q9UI95#29	0	33	ENST00000235310.7	1361	1394	+	33	0	0	4614
Q9UI95#30	0	12	12	Q9UI95	465	477	+	12	Q9UI95	0	529	ENST00000697274.1	72	601	+	279	Q9UI95#30	0	12	ENST00000697274.1	537	549	+	12	0	0	4615
Q9UI95#30	0	12	12	Q9UI95	465	477	+	12	Q9UI95	436	633	ENST00000697272.1	0	197	+	277	Q9UI95#30	0	12	ENST00000697272.1	29	41	+	12	0	0	4616
Q9UI95#30	0	12	12	Q9UI95	465	477	+	12	Q9UI95	0	633	ENST00000456915.2	530	1163	++	104	Q9UI95#30	0	12	ENST00000456915.2	995	1007	+	12	0	0	4617
Q9UI95#30	0	12	12	Q9UI95	465	477	+	12	Q9UI95	0	501	ENST00000445656.5	85	676	+	95	Q9UI95#30	0	12	ENST00000445656.5	640	652	+	12	0	0	4618
Q9UI95#30	0	12	12	Q9UI95	465	477	+	12	Q9UI95	0	633	ENST00000376692.9	122	755	++	52	Q9UI95#30	0	12	ENST00000376692.9	587	599	+	12	0	0	4619
Q9UI95#30	0	12	12	Q9UI95	465	477	+	12	Q9UI95	0	633	ENST00000376672.5	77	749	+	51	Q9UI95#30	0	12	ENST00000376672.5	581	593	+	12	0	0	4620
Q9UI95#30	0	12	12	Q9UI95	465	477	+	12	Q9UI95	0	633	ENST00000376669.9	92	764	+	50	Q9UI95#30	0	12	ENST00000376669.9	596	608	+	12	0	0	4621
Q9UI95#30	0	12	12	Q9UI95	465	477	+	12	Q9UI95	0	633	ENST00000376667.7	209	842	++	49	Q9UI95#30	0	12	ENST00000376667.7	674	686	+	12	0	0	4622
Q9UI95#30	0	12	12	Q9UI95	465	477	+	12	Q9UI95	0	633	ENST00000235310.7	929	1562	++	0	Q9UI95#30	0	12	ENST00000235310.7	1394	1406	+	12	0	0	4623
Q9UI95#31	0	15	15	Q9UI95	483	498	+	15	Q9UI95	0	529	ENST00000697274.1	72	601	+	279	Q9UI95#31	0	15	ENST00000697274.1	555	570	+	15	0	0	4624
Q9UI95#31	0	15	15	Q9UI95	483	498	+	15	Q9UI95	436	633	ENST00000697272.1	0	197	+	277	Q9UI95#31	0	15	ENST00000697272.1	47	62	+	15	0	0	4625
Q9UI95#31	0	15	15	Q9UI95	483	498	+	15	Q9UI95	0	633	ENST00000456915.2	530	1163	++	104	Q9UI95#31	0	15	ENST00000456915.2	1013	1028	+	15	0	0	4626
Q9UI95#31	0	15	15	Q9UI95	483	498	+	15	Q9UI95	0	501	ENST00000445656.5	85	676	+	95	Q9UI95#31	0	15	ENST00000445656.5	658	673	+	15	0	0	4627
Q9UI95#31	0	15	15	Q9UI95	483	498	+	15	Q9UI95	0	633	ENST00000376692.9	122	755	++	52	Q9UI95#31	0	15	ENST00000376692.9	605	620	+	15	0	0	4628
Q9UI95#31	0	15	15	Q9UI95	483	498	+	15	Q9UI95	0	633	ENST00000376672.5	77	749	+	51	Q9UI95#31	0	15	ENST00000376672.5	599	614	+	15	0	0	4629
Q9UI95#31	0	15	15	Q9UI95	483	498	+	15	Q9UI95	0	633	ENST00000376669.9	92	764	+	50	Q9UI95#31	0	15	ENST00000376669.9	614	629	+	15	0	0	4630
Q9UI95#31	0	15	15	Q9UI95	483	498	+	15	Q9UI95	0	633	ENST00000376667.7	209	842	++	49	Q9UI95#31	0	15	ENST00000376667.7	692	707	+	15	0	0	4631
Q9UI95#31	0	15	15	Q9UI95	483	498	+	15	Q9UI95	0	633	ENST00000235310.7	929	1562	++	0	Q9UI95#31	0	15	ENST00000235310.7	1412	1427	+	15	0	0	4632
Q9UI95#32	0	15	15	Q9UI95	504	519	+	15	Q9UI95	0	529	ENST00000697274.1	72	601	+	279	Q9UI95#32	0	15	ENST00000697274.1	576	591	+	15	0	0	4633
Q9UI95#32	0	15	15	Q9UI95	504	519	+	15	Q9UI95	436	633	ENST00000697272.1	0	197	+	277	Q9UI95#32	0	15	ENST00000697272.1	68	83	+	15	0	0	4634
Q9UI95#32	0	15	15	Q9UI95	504	519	+	15	Q9UI95	0	633	ENST00000456915.2	530	1163	++	104	Q9UI95#32	0	15	ENST00000456915.2	1034	1049	+	15	0	0	4635
Q9UI95#32	0	15	15	Q9UI95	504	519	+	15	Q9UI95	0	633	ENST00000376692.9	122	755	++	52	Q9UI95#32	0	15	ENST00000376692.9	626	641	+	15	0	0	4636
Q9UI95#32	0	15	15	Q9UI95	504	519	+	15	Q9UI95	0	633	ENST00000376672.5	77	749	+	51	Q9UI95#32	0	15	ENST00000376672.5	620	635	+	15	0	0	4637
Q9UI95#32	0	15	15	Q9UI95	504	519	+	15	Q9UI95	0	633	ENST00000376669.9	92	764	+	50	Q9UI95#32	0	15	ENST00000376669.9	635	650	+	15	0	0	4638
Q9UI95#32	0	15	15	Q9UI95	504	519	+	15	Q9UI95	0	633	ENST00000376667.7	209	842	++	49	Q9UI95#32	0	15	ENST00000376667.7	713	728	+	15	0	0	4639
Q9UI95#32	0	15	15	Q9UI95	504	519	+	15	Q9UI95	0	633	ENST00000235310.7	929	1562	++	0	Q9UI95#32	0	15	ENST00000235310.7	1433	1448	+	15	0	0	4640
Q9UI95#33	0	12	12	Q9UI95	525	537	+	12	Q9UI95	0	529	ENST00000697274.1	72	601	+	279	Q9UI95#33	0	4	ENST00000697274.1	597	601	+	4	0	8	4641
Q9UI95#33	0	12	12	Q9UI95	525	537	+	12	Q9UI95	436	633	ENST00000697272.1	0	197	+	277	Q9UI95#33	0	12	ENST00000697272.1	89	101	+	12	0	0	4642
Q9UI95#33	0	12	12	Q9UI95	525	537	+	12	Q9UI95	0	633	ENST00000456915.2	530	1163	++	104	Q9UI95#33	0	12	ENST00000456915.2	1055	1067	+	12	0	0	4643
Q9UI95#33	0	12	12	Q9UI95	525	537	+	12	Q9UI95	0	633	ENST00000376692.9	122	755	++	52	Q9UI95#33	0	12	ENST00000376692.9	647	659	+	12	0	0	4644
Q9UI95#33	0	12	12	Q9UI95	525	537	+	12	Q9UI95	0	633	ENST00000376672.5	77	749	+	51	Q9UI95#33	0	12	ENST00000376672.5	641	653	+	12	0	0	4645
Q9UI95#33	0	12	12	Q9UI95	525	537	+	12	Q9UI95	0	633	ENST00000376669.9	92	764	+	50	Q9UI95#33	0	12	ENST00000376669.9	656	668	+	12	0	0	4646
Q9UI95#33	0	12	12	Q9UI95	525	537	+	12	Q9UI95	0	633	ENST00000376667.7	209	842	++	49	Q9UI95#33	0	12	ENST00000376667.7	734	746	+	12	0	0	4647
Q9UI95#33	0	12	12	Q9UI95	525	537	+	12	Q9UI95	0	633	ENST00000235310.7	929	1562	++	0	Q9UI95#33	0	12	ENST00000235310.7	1454	1466	+	12	0	0	4648
Q9UI95#34	0	36	36	Q9UI95	552	588	+	36	Q9UI95	436	633	ENST00000697272.1	0	197	+	277	Q9UI95#34	0	36	ENST00000697272.1	116	152	+	36	0	0	4649
Q9UI95#34	0	36	36	Q9UI95	552	588	+	36	Q9UI95	0	633	ENST00000456915.2	530	1163	++	104	Q9UI95#34	0	36	ENST00000456915.2	1082	1118	+	36	0	0	4650
Q9UI95#34	0	36	36	Q9UI95	552	588	+	36	Q9UI95	0	633	ENST00000376692.9	122	755	++	52	Q9UI95#34	0	36	ENST00000376692.9	674	710	+	36	0	0	4651
Q9UI95#34	0	36	36	Q9UI95	552	588	+	36	Q9UI95	0	633	ENST00000376672.5	77	749	+	51	Q9UI95#34	0	36	ENST00000376672.5	668	704	+	36	0	0	4652
Q9UI95#34	0	36	36	Q9UI95	552	588	+	36	Q9UI95	0	633	ENST00000376669.9	92	764	+	50	Q9UI95#34	0	36	ENST00000376669.9	683	719	+	36	0	0	4653
Q9UI95#34	0	36	36	Q9UI95	552	588	+	36	Q9UI95	0	633	ENST00000376667.7	209	842	++	49	Q9UI95#34	0	36	ENST00000376667.7	761	797	+	36	0	0	4654
Q9UI95#34	0	36	36	Q9UI95	552	588	+	36	Q9UI95	0	633	ENST00000235310.7	929	1562	++	0	Q9UI95#34	0	36	ENST00000235310.7	1481	1517	+	36	0	0	4655
Q9UI95#35	0	24	24	Q9UI95	591	615	+	24	Q9UI95	436	633	ENST00000697272.1	0	197	+	277	Q9UI95#35	0	24	ENST00000697272.1	155	179	+	24	0	0	4656
Q9UI95#35	0	24	24	Q9UI95	591	615	+	24	Q9UI95	0	633	ENST00000456915.2	530	1163	++	104	Q9UI95#35	0	24	ENST00000456915.2	1121	1145	+	24	0	0	4657
Q9UI95#35	0	24	24	Q9UI95	591	615	+	24	Q9UI95	0	633	ENST00000376692.9	122	755	++	52	Q9UI95#35	0	24	ENST00000376692.9	713	737	+	24	0	0	4658
Q9UI95#35	0	24	24	Q9UI95	591	615	+	24	Q9UI95	0	633	ENST00000376672.5	77	749	+	51	Q9UI95#35	0	24	ENST00000376672.5	707	731	+	24	0	0	4659
Q9UI95#35	0	24	24	Q9UI95	591	615	+	24	Q9UI95	0	633	ENST00000376669.9	92	764	+	50	Q9UI95#35	0	24	ENST00000376669.9	722	746	+	24	0	0	4660
Q9UI95#35	0	24	24	Q9UI95	591	615	+	24	Q9UI95	0	633	ENST00000376667.7	209	842	++	49	Q9UI95#35	0	24	ENST00000376667.7	800	824	+	24	0	0	4661
Q9UI95#35	0	24	24	Q9UI95	591	615	+	24	Q9UI95	0	633	ENST00000235310.7	929	1562	++	0	Q9UI95#35	0	24	ENST00000235310.7	1520	1544	+	24	0	0	4662
Q9BS31#0	0	1515	1515	Q9BS31	0	1515	+	1515	Q9BS31	0	1515	ENST00000600738.5	285	1716	+	220	Q9BS31#0	0	1515	ENST00000600738.5	285	1716	+	1431	0	0	4663
Q9BS31#0	0	1515	1515	Q9BS31	0	1515	+	1515	Q9BS31	15	142	ENST00000599530.1	603	730	+	215	Q9BS31#0	15	142	ENST00000599530.1	603	730	+	127	15	1373	4664
Q9BS31#0	0	1515	1515	Q9BS31	0	1515	+	1515	Q9BS31	15	135	ENST00000596690.1	444	564	+	213	Q9BS31#0	15	135	ENST00000596690.1	444	564	+	120	15	1380	4665
Q9BS31#0	0	1515	1515	Q9BS31	0	1515	+	1515	Q9BS31	0	142	ENST00000595418.5	404	546	+	210	Q9BS31#0	0	142	ENST00000595418.5	404	546	+	142	0	1373	4666
Q9BS31#0	0	1515	1515	Q9BS31	0	1515	+	1515	Q9BS31	0	1515	ENST00000354957.8	291	1806	++	35	Q9BS31#0	0	1515	ENST00000354957.8	291	1806	+	1515	0	0	4667
Q9BS31#1	0	216	216	Q9BS31	21	237	+	216	Q9BS31	0	1515	ENST00000600738.5	285	1716	+	220	Q9BS31#1	0	216	ENST00000600738.5	306	522	+	216	0	0	4668
Q9BS31#1	0	216	216	Q9BS31	21	237	+	216	Q9BS31	15	142	ENST00000599530.1	603	730	+	215	Q9BS31#1	0	121	ENST00000599530.1	609	730	+	121	0	95	4669
Q9BS31#1	0	216	216	Q9BS31	21	237	+	216	Q9BS31	15	135	ENST00000596690.1	444	564	+	213	Q9BS31#1	0	114	ENST00000596690.1	450	564	+	114	0	102	4670
Q9BS31#1	0	216	216	Q9BS31	21	237	+	216	Q9BS31	0	142	ENST00000595418.5	404	546	+	210	Q9BS31#1	0	121	ENST00000595418.5	425	546	+	121	0	95	4671
Q9BS31#1	0	216	216	Q9BS31	21	237	+	216	Q9BS31	0	1515	ENST00000354957.8	291	1806	++	35	Q9BS31#1	0	216	ENST00000354957.8	312	528	+	216	0	0	4672
Q9BS31#2	0	69	69	Q9BS31	531	600	+	69	Q9BS31	0	1515	ENST00000600738.5	285	1716	+	220	Q9BS31#2	0	69	ENST00000600738.5	816	885	+	69	0	0	4673
Q9BS31#2	0	69	69	Q9BS31	531	600	+	69	Q9BS31	0	1515	ENST00000354957.8	291	1806	++	35	Q9BS31#2	0	69	ENST00000354957.8	822	891	+	69	0	0	4674
Q9BS31#3	0	69	69	Q9BS31	615	684	+	69	Q9BS31	0	1515	ENST00000600738.5	285	1716	+	220	Q9BS31#3	0	38	ENST00000600738.5	900	938	+	38	0	31	4675
Q9BS31#3	0	69	69	Q9BS31	615	684	+	69	Q9BS31	0	1515	ENST00000354957.8	291	1806	++	35	Q9BS31#3	0	69	ENST00000354957.8	906	975	+	69	0	0	4676
Q9BS31#4	0	69	69	Q9BS31	699	768	+	69	Q9BS31	0	1515	ENST00000600738.5	285	1716	+	220	Q9BS31#4	38	69	ENST00000600738.5	938	969	+	31	38	0	4677
Q9BS31#4	0	69	69	Q9BS31	699	768	+	69	Q9BS31	0	1515	ENST00000354957.8	291	1806	++	35	Q9BS31#4	0	69	ENST00000354957.8	990	1059	+	69	0	0	4678
Q9BS31#5	0	69	69	Q9BS31	783	852	+	69	Q9BS31	0	1515	ENST00000600738.5	285	1716	+	220	Q9BS31#5	0	69	ENST00000600738.5	984	1053	+	69	0	0	4679
Q9BS31#5	0	69	69	Q9BS31	783	852	+	69	Q9BS31	0	1515	ENST00000354957.8	291	1806	++	35	Q9BS31#5	0	69	ENST00000354957.8	1074	1143	+	69	0	0	4680
Q9BS31#6	0	69	69	Q9BS31	867	936	+	69	Q9BS31	0	1515	ENST00000600738.5	285	1716	+	220	Q9BS31#6	0	69	ENST00000600738.5	1068	1137	+	69	0	0	4681
Q9BS31#6	0	69	69	Q9BS31	867	936	+	69	Q9BS31	0	1515	ENST00000354957.8	291	1806	++	35	Q9BS31#6	0	69	ENST00000354957.8	1158	1227	+	69	0	0	4682
Q9BS31#7	0	69	69	Q9BS31	951	1020	+	69	Q9BS31	0	1515	ENST00000600738.5	285	1716	+	220	Q9BS31#7	0	69	ENST00000600738.5	1152	1221	+	69	0	0	4683
Q9BS31#7	0	69	69	Q9BS31	951	1020	+	69	Q9BS31	0	1515	ENST00000354957.8	291	1806	++	35	Q9BS31#7	0	69	ENST00000354957.8	1242	1311	+	69	0	0	4684
Q9BS31#8	0	69	69	Q9BS31	1035	1104	+	69	Q9BS31	0	1515	ENST00000600738.5	285	1716	+	220	Q9BS31#8	0	69	ENST00000600738.5	1236	1305	+	69	0	0	4685
Q9BS31#8	0	69	69	Q9BS31	1035	1104	+	69	Q9BS31	0	1515	ENST00000354957.8	291	1806	++	35	Q9BS31#8	0	69	ENST00000354957.8	1326	1395	+	69	0	0	4686
Q9BS31#9	0	69	69	Q9BS31	1119	1188	+	69	Q9BS31	0	1515	ENST00000600738.5	285	1716	+	220	Q9BS31#9	0	69	ENST00000600738.5	1320	1389	+	69	0	0	4687
Q9BS31#9	0	69	69	Q9BS31	1119	1188	+	69	Q9BS31	0	1515	ENST00000354957.8	291	1806	++	35	Q9BS31#9	0	69	ENST00000354957.8	1410	1479	+	69	0	0	4688
Q9BS31#10	0	69	69	Q9BS31	1203	1272	+	69	Q9BS31	0	1515	ENST00000600738.5	285	1716	+	220	Q9BS31#10	0	69	ENST00000600738.5	1404	1473	+	69	0	0	4689
Q9BS31#10	0	69	69	Q9BS31	1203	1272	+	69	Q9BS31	0	1515	ENST00000354957.8	291	1806	++	35	Q9BS31#10	0	69	ENST00000354957.8	1494	1563	+	69	0	0	4690
Q9BS31#11	0	69	69	Q9BS31	1287	1356	+	69	Q9BS31	0	1515	ENST00000600738.5	285	1716	+	220	Q9BS31#11	0	69	ENST00000600738.5	1488	1557	+	69	0	0	4691
Q9BS31#11	0	69	69	Q9BS31	1287	1356	+	69	Q9BS31	0	1515	ENST00000354957.8	291	1806	++	35	Q9BS31#11	0	69	ENST00000354957.8	1578	1647	+	69	0	0	4692
Q9BS31#12	0	81	81	Q9BS31	1362	1443	+	81	Q9BS31	0	1515	ENST00000600738.5	285	1716	+	220	Q9BS31#12	0	81	ENST00000600738.5	1563	1644	+	81	0	0	4693
Q9BS31#12	0	81	81	Q9BS31	1362	1443	+	81	Q9BS31	0	1515	ENST00000354957.8	291	1806	++	35	Q9BS31#12	0	81	ENST00000354957.8	1653	1734	+	81	0	0	4694
Q9BS31#13	0	57	57	Q9BS31	1386	1443	+	57	Q9BS31	0	1515	ENST00000600738.5	285	1716	+	220	Q9BS31#13	0	57	ENST00000600738.5	1587	1644	+	57	0	0	4695
Q9BS31#13	0	57	57	Q9BS31	1386	1443	+	57	Q9BS31	0	1515	ENST00000354957.8	291	1806	++	35	Q9BS31#13	0	57	ENST00000354957.8	1677	1734	+	57	0	0	4696
Q9BS31#14	0	3	3	Q9BS31	333	336	+	3	Q9BS31	0	1515	ENST00000600738.5	285	1716	+	220	Q9BS31#14	0	3	ENST00000600738.5	618	621	+	3	0	0	4697
Q9BS31#14	0	3	3	Q9BS31	333	336	+	3	Q9BS31	0	1515	ENST00000354957.8	291	1806	++	35	Q9BS31#14	0	3	ENST00000354957.8	624	627	+	3	0	0	4698
Q9BS31#15	0	3	3	Q9BS31	1053	1056	+	3	Q9BS31	0	1515	ENST00000600738.5	285	1716	+	220	Q9BS31#15	0	3	ENST00000600738.5	1254	1257	+	3	0	0	4699
Q9BS31#15	0	3	3	Q9BS31	1053	1056	+	3	Q9BS31	0	1515	ENST00000354957.8	291	1806	++	35	Q9BS31#15	0	3	ENST00000354957.8	1344	1347	+	3	0	0	4700
Q9BS31#16	0	3	3	Q9BS31	1404	1407	+	3	Q9BS31	0	1515	ENST00000600738.5	285	1716	+	220	Q9BS31#16	0	3	ENST00000600738.5	1605	1608	+	3	0	0	4701
Q9BS31#16	0	3	3	Q9BS31	1404	1407	+	3	Q9BS31	0	1515	ENST00000354957.8	291	1806	++	35	Q9BS31#16	0	3	ENST00000354957.8	1695	1698	+	3	0	0	4702
Q9BS31#17	0	3	3	Q9BS31	21	24	+	3	Q9BS31	0	1515	ENST00000600738.5	285	1716	+	220	Q9BS31#17	0	3	ENST00000600738.5	306	309	+	3	0	0	4703
Q9BS31#17	0	3	3	Q9BS31	21	24	+	3	Q9BS31	15	142	ENST00000599530.1	603	730	+	215	Q9BS31#17	0	3	ENST00000599530.1	609	612	+	3	0	0	4704
Q9BS31#17	0	3	3	Q9BS31	21	24	+	3	Q9BS31	15	135	ENST00000596690.1	444	564	+	213	Q9BS31#17	0	3	ENST00000596690.1	450	453	+	3	0	0	4705
Q9BS31#17	0	3	3	Q9BS31	21	24	+	3	Q9BS31	0	142	ENST00000595418.5	404	546	+	210	Q9BS31#17	0	3	ENST00000595418.5	425	428	+	3	0	0	4706
Q9BS31#17	0	3	3	Q9BS31	21	24	+	3	Q9BS31	0	1515	ENST00000354957.8	291	1806	++	35	Q9BS31#17	0	3	ENST00000354957.8	312	315	+	3	0	0	4707
Q9BS31#18	0	3	3	Q9BS31	939	942	+	3	Q9BS31	0	1515	ENST00000600738.5	285	1716	+	220	Q9BS31#18	0	3	ENST00000600738.5	1140	1143	+	3	0	0	4708
Q9BS31#18	0	3	3	Q9BS31	939	942	+	3	Q9BS31	0	1515	ENST00000354957.8	291	1806	++	35	Q9BS31#18	0	3	ENST00000354957.8	1230	1233	+	3	0	0	4709
Q8N139-1#0	0	4851	4851	Q8N139-1	0	4851	+	4851	Q8N139-1	0	459	ENST00000590645.1	189	648	++	202	Q8N139-1#0	0	459	ENST00000590645.1	189	648	+	459	0	4392	4710
Q8N139-1#0	0	4851	4851	Q8N139-1	0	4851	+	4851	Q8N139-1	0	4851	ENST00000284425.7	196	5047	++	14	Q8N139-1#0	0	4851	ENST00000284425.7	196	5047	+	4851	0	0	4711
Q8N139-1#1	0	63	63	Q8N139-1	90	153	+	63	Q8N139-1	0	459	ENST00000590645.1	189	648	++	202	Q8N139-1#1	0	63	ENST00000590645.1	279	342	+	63	0	0	4712
Q8N139-1#1	0	63	63	Q8N139-1	90	153	+	63	Q8N139-1	0	4851	ENST00000284425.7	196	5047	++	14	Q8N139-1#1	0	63	ENST00000284425.7	286	349	+	63	0	0	4713
Q8N139-1#2	0	63	63	Q8N139-1	663	726	+	63	Q8N139-1	0	4851	ENST00000284425.7	196	5047	++	14	Q8N139-1#2	0	63	ENST00000284425.7	859	922	+	63	0	0	4714
Q8N139-1#3	0	63	63	Q8N139-1	801	864	+	63	Q8N139-1	0	4851	ENST00000284425.7	196	5047	++	14	Q8N139-1#3	0	63	ENST00000284425.7	997	1060	+	63	0	0	4715
Q8N139-1#4	0	63	63	Q8N139-1	888	951	+	63	Q8N139-1	0	4851	ENST00000284425.7	196	5047	++	14	Q8N139-1#4	0	63	ENST00000284425.7	1084	1147	+	63	0	0	4716
Q8N139-1#5	0	63	63	Q8N139-1	978	1041	+	63	Q8N139-1	0	4851	ENST00000284425.7	196	5047	++	14	Q8N139-1#5	0	63	ENST00000284425.7	1174	1237	+	63	0	0	4717
Q8N139-1#6	0	63	63	Q8N139-1	1062	1125	+	63	Q8N139-1	0	4851	ENST00000284425.7	196	5047	++	14	Q8N139-1#6	0	63	ENST00000284425.7	1258	1321	+	63	0	0	4718
Q8N139-1#7	0	63	63	Q8N139-1	1188	1251	+	63	Q8N139-1	0	4851	ENST00000284425.7	196	5047	++	14	Q8N139-1#7	0	63	ENST00000284425.7	1384	1447	+	63	0	0	4719
Q8N139-1#8	0	63	63	Q8N139-1	2559	2622	+	63	Q8N139-1	0	4851	ENST00000284425.7	196	5047	++	14	Q8N139-1#8	0	63	ENST00000284425.7	2755	2818	+	63	0	0	4720
Q8N139-1#9	0	63	63	Q8N139-1	3018	3081	+	63	Q8N139-1	0	4851	ENST00000284425.7	196	5047	++	14	Q8N139-1#9	0	63	ENST00000284425.7	3214	3277	+	63	0	0	4721
Q8N139-1#10	0	63	63	Q8N139-1	3183	3246	+	63	Q8N139-1	0	4851	ENST00000284425.7	196	5047	++	14	Q8N139-1#10	0	63	ENST00000284425.7	3379	3442	+	63	0	0	4722
Q8N139-1#11	0	63	63	Q8N139-1	3279	3342	+	63	Q8N139-1	0	4851	ENST00000284425.7	196	5047	++	14	Q8N139-1#11	0	63	ENST00000284425.7	3475	3538	+	63	0	0	4723
Q8N139-1#12	0	63	63	Q8N139-1	3378	3441	+	63	Q8N139-1	0	4851	ENST00000284425.7	196	5047	++	14	Q8N139-1#12	0	63	ENST00000284425.7	3574	3637	+	63	0	0	4724
Q8N139-1#13	0	63	63	Q8N139-1	3447	3510	+	63	Q8N139-1	0	4851	ENST00000284425.7	196	5047	++	14	Q8N139-1#13	0	63	ENST00000284425.7	3643	3706	+	63	0	0	4725
Q8N139-1#14	0	63	63	Q8N139-1	3579	3642	+	63	Q8N139-1	0	4851	ENST00000284425.7	196	5047	++	14	Q8N139-1#14	0	63	ENST00000284425.7	3775	3838	+	63	0	0	4726
Q8N139-1#15	0	708	708	Q8N139-1	1431	2139	+	708	Q8N139-1	0	4851	ENST00000284425.7	196	5047	++	14	Q8N139-1#15	0	708	ENST00000284425.7	1627	2335	+	708	0	0	4727
Q8N139-1#16	0	678	678	Q8N139-1	3861	4539	+	678	Q8N139-1	0	4851	ENST00000284425.7	196	5047	++	14	Q8N139-1#16	0	678	ENST00000284425.7	4057	4735	+	678	0	0	4728
Q8N139-1#17	0	24	24	Q8N139-1	1539	1563	+	24	Q8N139-1	0	4851	ENST00000284425.7	196	5047	++	14	Q8N139-1#17	0	24	ENST00000284425.7	1735	1759	+	24	0	0	4729
Q8N139-1#18	0	24	24	Q8N139-1	3957	3981	+	24	Q8N139-1	0	4851	ENST00000284425.7	196	5047	++	14	Q8N139-1#18	0	24	ENST00000284425.7	4153	4177	+	24	0	0	4730
Q8N139-1#19	0	3	3	Q8N139-1	249	252	+	3	Q8N139-1	0	459	ENST00000590645.1	189	648	++	202	Q8N139-1#19	0	3	ENST00000590645.1	438	441	+	3	0	0	4731
Q8N139-1#19	0	3	3	Q8N139-1	249	252	+	3	Q8N139-1	0	4851	ENST00000284425.7	196	5047	++	14	Q8N139-1#19	0	3	ENST00000284425.7	445	448	+	3	0	0	4732
Q8N139-1#20	0	3	3	Q8N139-1	324	327	+	3	Q8N139-1	0	459	ENST00000590645.1	189	648	++	202	Q8N139-1#20	0	3	ENST00000590645.1	513	516	+	3	0	0	4733
Q8N139-1#20	0	3	3	Q8N139-1	324	327	+	3	Q8N139-1	0	4851	ENST00000284425.7	196	5047	++	14	Q8N139-1#20	0	3	ENST00000284425.7	520	523	+	3	0	0	4734
Q8N139-1#21	0	3	3	Q8N139-1	2817	2820	+	3	Q8N139-1	0	4851	ENST00000284425.7	196	5047	++	14	Q8N139-1#21	0	3	ENST00000284425.7	3013	3016	+	3	0	0	4735
Q8N139-1#22	0	96	96	Q8N139-1	459	555	+	96	Q8N139-1	0	4851	ENST00000284425.7	196	5047	++	14	Q8N139-1#22	0	96	ENST00000284425.7	655	751	+	96	0	0	4736
Q8N139-1#23	0	4296	4296	Q8N139-1	555	4851	+	4296	Q8N139-1	0	4851	ENST00000284425.7	196	5047	++	14	Q8N139-1#23	0	4296	ENST00000284425.7	751	5047	+	4296	0	0	4737
Q8N139-1#24	0	6	6	Q8N139-1	1905	1911	+	6	Q8N139-1	0	4851	ENST00000284425.7	196	5047	++	14	Q8N139-1#24	0	6	ENST00000284425.7	2101	2107	+	6	0	0	4738
Q8N139-1#25	0	2940	2940	Q8N139-1	1911	4851	+	2940	Q8N139-1	0	4851	ENST00000284425.7	196	5047	++	14	Q8N139-1#25	0	2940	ENST00000284425.7	2107	5047	+	2940	0	0	4739
Q8N139-1#26	0	3	3	Q8N139-1	843	846	+	3	Q8N139-1	0	4851	ENST00000284425.7	196	5047	++	14	Q8N139-1#26	0	3	ENST00000284425.7	1039	1042	+	3	0	0	4740
Q8N139-1#27	0	3	3	Q8N139-1	1827	1830	+	3	Q8N139-1	0	4851	ENST00000284425.7	196	5047	++	14	Q8N139-1#27	0	3	ENST00000284425.7	2023	2026	+	3	0	0	4741
Q8N139-1#28	0	3	3	Q8N139-1	2091	2094	+	3	Q8N139-1	0	4851	ENST00000284425.7	196	5047	++	14	Q8N139-1#28	0	3	ENST00000284425.7	2287	2290	+	3	0	0	4742
Q8N139-1#29	0	3	3	Q8N139-1	2622	2625	+	3	Q8N139-1	0	4851	ENST00000284425.7	196	5047	++	14	Q8N139-1#29	0	3	ENST00000284425.7	2818	2821	+	3	0	0	4743
Q8N139-1#30	0	3	3	Q8N139-1	3963	3966	+	3	Q8N139-1	0	4851	ENST00000284425.7	196	5047	++	14	Q8N139-1#30	0	3	ENST00000284425.7	4159	4162	+	3	0	0	4744
Q8N139-1#31	0	3	3	Q8N139-1	150	153	+	3	Q8N139-1	0	459	ENST00000590645.1	189	648	++	202	Q8N139-1#31	0	3	ENST00000590645.1	339	342	+	3	0	0	4745
Q8N139-1#31	0	3	3	Q8N139-1	150	153	+	3	Q8N139-1	0	4851	ENST00000284425.7	196	5047	++	14	Q8N139-1#31	0	3	ENST00000284425.7	346	349	+	3	0	0	4746
Q8N139-1#32	0	3	3	Q8N139-1	438	441	+	3	Q8N139-1	0	459	ENST00000590645.1	189	648	++	202	Q8N139-1#32	0	3	ENST00000590645.1	627	630	+	3	0	0	4747
Q8N139-1#32	0	3	3	Q8N139-1	438	441	+	3	Q8N139-1	0	4851	ENST00000284425.7	196	5047	++	14	Q8N139-1#32	0	3	ENST00000284425.7	634	637	+	3	0	0	4748
Q8N139-1#33	0	3	3	Q8N139-1	2433	2436	+	3	Q8N139-1	0	4851	ENST00000284425.7	196	5047	++	14	Q8N139-1#33	0	3	ENST00000284425.7	2629	2632	+	3	0	0	4749
Q8N139-1#34	0	6	6	Q8N139-1	2622	2628	+	6	Q8N139-1	0	4851	ENST00000284425.7	196	5047	++	14	Q8N139-1#34	0	6	ENST00000284425.7	2818	2824	+	6	0	0	4750
Q8IZY2-1#0	0	6438	6438	Q8IZY2-1	0	6438	+	6438	Q8IZY2-1	5577	6438	ENST00000612569.1	0	840	+	232	Q8IZY2-1#0	5577	6438	ENST00000612569.1	0	840	+	840	5577	0	4751
Q8IZY2-1#0	0	6438	6438	Q8IZY2-1	0	6438	+	6438	Q8IZY2-1	0	415	ENST00000531467.5	160	569	+	155	Q8IZY2-1#0	0	415	ENST00000531467.5	160	569	+	409	0	6023	4752
Q8IZY2-1#0	0	6438	6438	Q8IZY2-1	0	6438	+	6438	Q8IZY2-1	3542	3854	ENST00000530092.2	0	187	+	150	Q8IZY2-1#0	3542	3854	ENST00000530092.2	0	187	+	187	3542	2584	4753
Q8IZY2-1#0	0	6438	6438	Q8IZY2-1	0	6438	+	6438	Q8IZY2-1	4607	5041	ENST00000529442.7	0	289	+	148	Q8IZY2-1#0	4607	5041	ENST00000529442.7	0	289	+	289	4607	1397	4754
Q8IZY2-1#0	0	6438	6438	Q8IZY2-1	0	6438	+	6438	Q8IZY2-1	4613	6438	ENST00000525073.6	0	1771	+	144	Q8IZY2-1#0	4613	6438	ENST00000525073.6	0	1771	+	1771	4613	0	4755
Q8IZY2-1#0	0	6438	6438	Q8IZY2-1	0	6438	+	6438	Q8IZY2-1	0	492	ENST00000524850.5	84	576	+	143	Q8IZY2-1#0	0	492	ENST00000524850.5	84	576	+	492	0	5946	4756
Q8IZY2-1#0	0	6438	6438	Q8IZY2-1	0	6438	+	6438	Q8IZY2-1	2529	4117	ENST00000435683.7	0	1602	+	86	Q8IZY2-1#0	2529	4117	ENST00000435683.7	0	1602	+	1588	2529	2321	4757
Q8IZY2-1#0	0	6438	6438	Q8IZY2-1	0	6438	+	6438	Q8IZY2-1	0	6438	ENST00000263094.11	227	6665	++	9	Q8IZY2-1#0	0	6438	ENST00000263094.11	227	6665	+	6438	0	0	4758
Q8IZY2-1#1	0	63	63	Q8IZY2-1	63	126	+	63	Q8IZY2-1	0	415	ENST00000531467.5	160	569	+	155	Q8IZY2-1#1	0	63	ENST00000531467.5	223	280	+	57	0	0	4759
Q8IZY2-1#1	0	63	63	Q8IZY2-1	63	126	+	63	Q8IZY2-1	0	492	ENST00000524850.5	84	576	+	143	Q8IZY2-1#1	0	63	ENST00000524850.5	147	210	+	63	0	0	4760
Q8IZY2-1#1	0	63	63	Q8IZY2-1	63	126	+	63	Q8IZY2-1	0	6438	ENST00000263094.11	227	6665	++	9	Q8IZY2-1#1	0	63	ENST00000263094.11	290	353	+	63	0	0	4761
Q8IZY2-1#2	0	1521	1521	Q8IZY2-1	126	1647	+	1521	Q8IZY2-1	0	415	ENST00000531467.5	160	569	+	155	Q8IZY2-1#2	0	289	ENST00000531467.5	280	569	+	289	0	1232	4762
Q8IZY2-1#2	0	1521	1521	Q8IZY2-1	126	1647	+	1521	Q8IZY2-1	0	492	ENST00000524850.5	84	576	+	143	Q8IZY2-1#2	0	366	ENST00000524850.5	210	576	+	366	0	1155	4763
Q8IZY2-1#2	0	1521	1521	Q8IZY2-1	126	1647	+	1521	Q8IZY2-1	0	6438	ENST00000263094.11	227	6665	++	9	Q8IZY2-1#2	0	1521	ENST00000263094.11	353	1874	+	1521	0	0	4764
Q8IZY2-1#3	0	63	63	Q8IZY2-1	1647	1710	+	63	Q8IZY2-1	0	6438	ENST00000263094.11	227	6665	++	9	Q8IZY2-1#3	0	63	ENST00000263094.11	1874	1937	+	63	0	0	4765
Q8IZY2-1#4	0	63	63	Q8IZY2-1	1776	1839	+	63	Q8IZY2-1	0	6438	ENST00000263094.11	227	6665	++	9	Q8IZY2-1#4	0	63	ENST00000263094.11	2003	2066	+	63	0	0	4766
Q8IZY2-1#5	0	63	63	Q8IZY2-1	1875	1938	+	63	Q8IZY2-1	0	6438	ENST00000263094.11	227	6665	++	9	Q8IZY2-1#5	0	63	ENST00000263094.11	2102	2165	+	63	0	0	4767
Q8IZY2-1#6	0	63	63	Q8IZY2-1	1962	2025	+	63	Q8IZY2-1	0	6438	ENST00000263094.11	227	6665	++	9	Q8IZY2-1#6	0	63	ENST00000263094.11	2189	2252	+	63	0	0	4768
Q8IZY2-1#7	0	63	63	Q8IZY2-1	2058	2121	+	63	Q8IZY2-1	0	6438	ENST00000263094.11	227	6665	++	9	Q8IZY2-1#7	0	63	ENST00000263094.11	2285	2348	+	63	0	0	4769
Q8IZY2-1#8	0	63	63	Q8IZY2-1	2178	2241	+	63	Q8IZY2-1	0	6438	ENST00000263094.11	227	6665	++	9	Q8IZY2-1#8	0	63	ENST00000263094.11	2405	2468	+	63	0	0	4770
Q8IZY2-1#9	0	63	63	Q8IZY2-1	2544	2607	+	63	Q8IZY2-1	2529	4117	ENST00000435683.7	0	1602	+	86	Q8IZY2-1#9	0	63	ENST00000435683.7	15	78	+	63	0	0	4771
Q8IZY2-1#9	0	63	63	Q8IZY2-1	2544	2607	+	63	Q8IZY2-1	0	6438	ENST00000263094.11	227	6665	++	9	Q8IZY2-1#9	0	63	ENST00000263094.11	2771	2834	+	63	0	0	4772
Q8IZY2-1#10	0	63	63	Q8IZY2-1	3726	3789	+	63	Q8IZY2-1	2529	4117	ENST00000435683.7	0	1602	+	86	Q8IZY2-1#10	0	63	ENST00000435683.7	1197	1260	+	63	0	0	4773
Q8IZY2-1#10	0	63	63	Q8IZY2-1	3726	3789	+	63	Q8IZY2-1	0	6438	ENST00000263094.11	227	6665	++	9	Q8IZY2-1#10	0	63	ENST00000263094.11	3953	4016	+	63	0	0	4774
Q8IZY2-1#11	0	822	822	Q8IZY2-1	3789	4611	+	822	Q8IZY2-1	3542	3854	ENST00000530092.2	0	187	+	150	Q8IZY2-1#11	62	65	ENST00000530092.2	184	187	+	3	62	757	4775
Q8IZY2-1#11	0	822	822	Q8IZY2-1	3789	4611	+	822	Q8IZY2-1	4607	5041	ENST00000529442.7	0	289	+	148	Q8IZY2-1#11	818	822	ENST00000529442.7	0	4	+	4	818	0	4776
Q8IZY2-1#11	0	822	822	Q8IZY2-1	3789	4611	+	822	Q8IZY2-1	2529	4117	ENST00000435683.7	0	1602	+	86	Q8IZY2-1#11	0	328	ENST00000435683.7	1260	1602	+	328	0	494	4777
Q8IZY2-1#11	0	822	822	Q8IZY2-1	3789	4611	+	822	Q8IZY2-1	0	6438	ENST00000263094.11	227	6665	++	9	Q8IZY2-1#11	0	822	ENST00000263094.11	4016	4838	+	822	0	0	4778
Q8IZY2-1#12	0	63	63	Q8IZY2-1	4611	4674	+	63	Q8IZY2-1	4607	5041	ENST00000529442.7	0	289	+	148	Q8IZY2-1#12	0	63	ENST00000529442.7	4	67	+	63	0	0	4779
Q8IZY2-1#12	0	63	63	Q8IZY2-1	4611	4674	+	63	Q8IZY2-1	4613	6438	ENST00000525073.6	0	1771	+	144	Q8IZY2-1#12	2	63	ENST00000525073.6	0	61	+	61	2	0	4780
Q8IZY2-1#12	0	63	63	Q8IZY2-1	4611	4674	+	63	Q8IZY2-1	0	6438	ENST00000263094.11	227	6665	++	9	Q8IZY2-1#12	0	63	ENST00000263094.11	4838	4901	+	63	0	0	4781
Q8IZY2-1#13	0	63	63	Q8IZY2-1	4749	4812	+	63	Q8IZY2-1	4607	5041	ENST00000529442.7	0	289	+	148	Q8IZY2-1#13	0	63	ENST00000529442.7	142	205	+	63	0	0	4782
Q8IZY2-1#13	0	63	63	Q8IZY2-1	4749	4812	+	63	Q8IZY2-1	4613	6438	ENST00000525073.6	0	1771	+	144	Q8IZY2-1#13	0	63	ENST00000525073.6	136	199	+	63	0	0	4783
Q8IZY2-1#13	0	63	63	Q8IZY2-1	4749	4812	+	63	Q8IZY2-1	0	6438	ENST00000263094.11	227	6665	++	9	Q8IZY2-1#13	0	63	ENST00000263094.11	4976	5039	+	63	0	0	4784
Q8IZY2-1#14	0	63	63	Q8IZY2-1	4860	4923	+	63	Q8IZY2-1	4607	5041	ENST00000529442.7	0	289	+	148	Q8IZY2-1#14	0	20	ENST00000529442.7	253	273	+	20	0	43	4785
Q8IZY2-1#14	0	63	63	Q8IZY2-1	4860	4923	+	63	Q8IZY2-1	4613	6438	ENST00000525073.6	0	1771	+	144	Q8IZY2-1#14	0	20	ENST00000525073.6	247	267	+	20	0	43	4786
Q8IZY2-1#14	0	63	63	Q8IZY2-1	4860	4923	+	63	Q8IZY2-1	0	6438	ENST00000263094.11	227	6665	++	9	Q8IZY2-1#14	0	63	ENST00000263094.11	5087	5150	+	63	0	0	4787
Q8IZY2-1#15	0	63	63	Q8IZY2-1	4944	5007	+	63	Q8IZY2-1	4613	6438	ENST00000525073.6	0	1771	+	144	Q8IZY2-1#15	0	63	ENST00000525073.6	277	340	+	63	0	0	4788
Q8IZY2-1#15	0	63	63	Q8IZY2-1	4944	5007	+	63	Q8IZY2-1	0	6438	ENST00000263094.11	227	6665	++	9	Q8IZY2-1#15	0	63	ENST00000263094.11	5171	5234	+	63	0	0	4789
Q8IZY2-1#16	0	63	63	Q8IZY2-1	5046	5109	+	63	Q8IZY2-1	4613	6438	ENST00000525073.6	0	1771	+	144	Q8IZY2-1#16	0	63	ENST00000525073.6	379	442	+	63	0	0	4790
Q8IZY2-1#16	0	63	63	Q8IZY2-1	5046	5109	+	63	Q8IZY2-1	0	6438	ENST00000263094.11	227	6665	++	9	Q8IZY2-1#16	0	63	ENST00000263094.11	5273	5336	+	63	0	0	4791
Q8IZY2-1#17	0	63	63	Q8IZY2-1	5184	5247	+	63	Q8IZY2-1	4613	6438	ENST00000525073.6	0	1771	+	144	Q8IZY2-1#17	0	63	ENST00000525073.6	517	580	+	63	0	0	4792
Q8IZY2-1#17	0	63	63	Q8IZY2-1	5184	5247	+	63	Q8IZY2-1	0	6438	ENST00000263094.11	227	6665	++	9	Q8IZY2-1#17	0	63	ENST00000263094.11	5411	5474	+	63	0	0	4793
Q8IZY2-1#18	0	696	696	Q8IZY2-1	2418	3114	+	696	Q8IZY2-1	2529	4117	ENST00000435683.7	0	1602	+	86	Q8IZY2-1#18	111	696	ENST00000435683.7	0	585	+	585	111	0	4794
Q8IZY2-1#18	0	696	696	Q8IZY2-1	2418	3114	+	696	Q8IZY2-1	0	6438	ENST00000263094.11	227	6665	++	9	Q8IZY2-1#18	0	696	ENST00000263094.11	2645	3341	+	696	0	0	4795
Q8IZY2-1#19	0	699	699	Q8IZY2-1	5376	6075	+	699	Q8IZY2-1	5577	6438	ENST00000612569.1	0	840	+	232	Q8IZY2-1#19	201	699	ENST00000612569.1	0	498	+	498	201	0	4796
Q8IZY2-1#19	0	699	699	Q8IZY2-1	5376	6075	+	699	Q8IZY2-1	4613	6438	ENST00000525073.6	0	1771	+	144	Q8IZY2-1#19	0	699	ENST00000525073.6	709	1408	+	699	0	0	4797
Q8IZY2-1#19	0	699	699	Q8IZY2-1	5376	6075	+	699	Q8IZY2-1	0	6438	ENST00000263094.11	227	6665	++	9	Q8IZY2-1#19	0	699	ENST00000263094.11	5603	6302	+	699	0	0	4798
Q8IZY2-1#20	0	75	75	Q8IZY2-1	3141	3216	+	75	Q8IZY2-1	2529	4117	ENST00000435683.7	0	1602	+	86	Q8IZY2-1#20	0	75	ENST00000435683.7	612	687	+	75	0	0	4799
Q8IZY2-1#20	0	75	75	Q8IZY2-1	3141	3216	+	75	Q8IZY2-1	0	6438	ENST00000263094.11	227	6665	++	9	Q8IZY2-1#20	0	75	ENST00000263094.11	3368	3443	+	75	0	0	4800
Q8IZY2-1#21	0	75	75	Q8IZY2-1	3552	3627	+	75	Q8IZY2-1	3542	3854	ENST00000530092.2	0	187	+	150	Q8IZY2-1#21	0	75	ENST00000530092.2	10	85	+	75	0	0	4801
Q8IZY2-1#21	0	75	75	Q8IZY2-1	3552	3627	+	75	Q8IZY2-1	2529	4117	ENST00000435683.7	0	1602	+	86	Q8IZY2-1#21	0	75	ENST00000435683.7	1023	1098	+	75	0	0	4802
Q8IZY2-1#21	0	75	75	Q8IZY2-1	3552	3627	+	75	Q8IZY2-1	0	6438	ENST00000263094.11	227	6665	++	9	Q8IZY2-1#21	0	75	ENST00000263094.11	3779	3854	+	75	0	0	4803
Q8IZY2-1#22	0	129	129	Q8IZY2-1	6309	6438	+	129	Q8IZY2-1	5577	6438	ENST00000612569.1	0	840	+	232	Q8IZY2-1#22	0	129	ENST00000612569.1	711	840	+	129	0	0	4804
Q8IZY2-1#22	0	129	129	Q8IZY2-1	6309	6438	+	129	Q8IZY2-1	4613	6438	ENST00000525073.6	0	1771	+	144	Q8IZY2-1#22	0	129	ENST00000525073.6	1642	1771	+	129	0	0	4805
Q8IZY2-1#22	0	129	129	Q8IZY2-1	6309	6438	+	129	Q8IZY2-1	0	6438	ENST00000263094.11	227	6665	++	9	Q8IZY2-1#22	0	129	ENST00000263094.11	6536	6665	+	129	0	0	4806
Q8IZY2-1#23	0	57	57	Q8IZY2-1	3141	3198	+	57	Q8IZY2-1	2529	4117	ENST00000435683.7	0	1602	+	86	Q8IZY2-1#23	0	57	ENST00000435683.7	612	669	+	57	0	0	4807
Q8IZY2-1#23	0	57	57	Q8IZY2-1	3141	3198	+	57	Q8IZY2-1	0	6438	ENST00000263094.11	227	6665	++	9	Q8IZY2-1#23	0	57	ENST00000263094.11	3368	3425	+	57	0	0	4808
Q8IZY2-1#24	0	24	24	Q8IZY2-1	2520	2544	+	24	Q8IZY2-1	2529	4117	ENST00000435683.7	0	1602	+	86	Q8IZY2-1#24	9	24	ENST00000435683.7	0	15	+	15	9	0	4809
Q8IZY2-1#24	0	24	24	Q8IZY2-1	2520	2544	+	24	Q8IZY2-1	0	6438	ENST00000263094.11	227	6665	++	9	Q8IZY2-1#24	0	24	ENST00000263094.11	2747	2771	+	24	0	0	4810
Q8IZY2-1#25	0	24	24	Q8IZY2-1	5478	5502	+	24	Q8IZY2-1	4613	6438	ENST00000525073.6	0	1771	+	144	Q8IZY2-1#25	0	24	ENST00000525073.6	811	835	+	24	0	0	4811
Q8IZY2-1#25	0	24	24	Q8IZY2-1	5478	5502	+	24	Q8IZY2-1	0	6438	ENST00000263094.11	227	6665	++	9	Q8IZY2-1#25	0	24	ENST00000263094.11	5705	5729	+	24	0	0	4812
Q8IZY2-1#26	0	3	3	Q8IZY2-1	933	936	+	3	Q8IZY2-1	0	6438	ENST00000263094.11	227	6665	++	9	Q8IZY2-1#26	0	3	ENST00000263094.11	1160	1163	+	3	0	0	4813
Q8IZY2-1#27	0	453	453	Q8IZY2-1	222	675	+	453	Q8IZY2-1	0	415	ENST00000531467.5	160	569	+	155	Q8IZY2-1#27	0	193	ENST00000531467.5	376	569	+	193	0	260	4814
Q8IZY2-1#27	0	453	453	Q8IZY2-1	222	675	+	453	Q8IZY2-1	0	492	ENST00000524850.5	84	576	+	143	Q8IZY2-1#27	0	270	ENST00000524850.5	306	576	+	270	0	183	4815
Q8IZY2-1#27	0	453	453	Q8IZY2-1	222	675	+	453	Q8IZY2-1	0	6438	ENST00000263094.11	227	6665	++	9	Q8IZY2-1#27	0	453	ENST00000263094.11	449	902	+	453	0	0	4816
Q8IZY2-1#28	0	45	45	Q8IZY2-1	4032	4077	+	45	Q8IZY2-1	2529	4117	ENST00000435683.7	0	1602	+	86	Q8IZY2-1#28	0	45	ENST00000435683.7	1517	1562	+	45	0	0	4817
Q8IZY2-1#28	0	45	45	Q8IZY2-1	4032	4077	+	45	Q8IZY2-1	0	6438	ENST00000263094.11	227	6665	++	9	Q8IZY2-1#28	0	45	ENST00000263094.11	4259	4304	+	45	0	0	4818
Q8IZY2-1#29	0	414	414	Q8IZY2-1	0	414	+	414	Q8IZY2-1	0	415	ENST00000531467.5	160	569	+	155	Q8IZY2-1#29	0	414	ENST00000531467.5	160	568	+	408	0	0	4819
Q8IZY2-1#29	0	414	414	Q8IZY2-1	0	414	+	414	Q8IZY2-1	0	492	ENST00000524850.5	84	576	+	143	Q8IZY2-1#29	0	414	ENST00000524850.5	84	498	+	414	0	0	4820
Q8IZY2-1#29	0	414	414	Q8IZY2-1	0	414	+	414	Q8IZY2-1	0	6438	ENST00000263094.11	227	6665	++	9	Q8IZY2-1#29	0	414	ENST00000263094.11	227	641	+	414	0	0	4821
Q8IZY2-1#30	0	84	84	Q8IZY2-1	414	498	+	84	Q8IZY2-1	0	415	ENST00000531467.5	160	569	+	155	Q8IZY2-1#30	0	1	ENST00000531467.5	568	569	+	1	0	83	4822
Q8IZY2-1#30	0	84	84	Q8IZY2-1	414	498	+	84	Q8IZY2-1	0	492	ENST00000524850.5	84	576	+	143	Q8IZY2-1#30	0	78	ENST00000524850.5	498	576	+	78	0	6	4823
Q8IZY2-1#30	0	84	84	Q8IZY2-1	414	498	+	84	Q8IZY2-1	0	6438	ENST00000263094.11	227	6665	++	9	Q8IZY2-1#30	0	84	ENST00000263094.11	641	725	+	84	0	0	4824
Q8IZY2-1#31	0	3	3	Q8IZY2-1	561	564	+	3	Q8IZY2-1	0	6438	ENST00000263094.11	227	6665	++	9	Q8IZY2-1#31	0	3	ENST00000263094.11	788	791	+	3	0	0	4825
Q8IZY2-1#32	0	3	3	Q8IZY2-1	954	957	+	3	Q8IZY2-1	0	6438	ENST00000263094.11	227	6665	++	9	Q8IZY2-1#32	0	3	ENST00000263094.11	1181	1184	+	3	0	0	4826
Q8IZY2-1#33	0	3	3	Q8IZY2-1	1182	1185	+	3	Q8IZY2-1	0	6438	ENST00000263094.11	227	6665	++	9	Q8IZY2-1#33	0	3	ENST00000263094.11	1409	1412	+	3	0	0	4827
Q8IZY2-1#34	0	3	3	Q8IZY2-1	1386	1389	+	3	Q8IZY2-1	0	6438	ENST00000263094.11	227	6665	++	9	Q8IZY2-1#34	0	3	ENST00000263094.11	1613	1616	+	3	0	0	4828
Q8IZY2-1#35	0	3	3	Q8IZY2-1	2025	2028	+	3	Q8IZY2-1	0	6438	ENST00000263094.11	227	6665	++	9	Q8IZY2-1#35	0	3	ENST00000263094.11	2252	2255	+	3	0	0	4829
Q8IZY2-1#36	0	3	3	Q8IZY2-1	2151	2154	+	3	Q8IZY2-1	0	6438	ENST00000263094.11	227	6665	++	9	Q8IZY2-1#36	0	3	ENST00000263094.11	2378	2381	+	3	0	0	4830
Q8IZY2-1#37	0	3	3	Q8IZY2-1	2637	2640	+	3	Q8IZY2-1	2529	4117	ENST00000435683.7	0	1602	+	86	Q8IZY2-1#37	0	3	ENST00000435683.7	108	111	+	3	0	0	4831
Q8IZY2-1#37	0	3	3	Q8IZY2-1	2637	2640	+	3	Q8IZY2-1	0	6438	ENST00000263094.11	227	6665	++	9	Q8IZY2-1#37	0	3	ENST00000263094.11	2864	2867	+	3	0	0	4832
Q8IZY2-1#38	0	3	3	Q8IZY2-1	4044	4047	+	3	Q8IZY2-1	2529	4117	ENST00000435683.7	0	1602	+	86	Q8IZY2-1#38	0	3	ENST00000435683.7	1529	1532	+	3	0	0	4833
Q8IZY2-1#38	0	3	3	Q8IZY2-1	4044	4047	+	3	Q8IZY2-1	0	6438	ENST00000263094.11	227	6665	++	9	Q8IZY2-1#38	0	3	ENST00000263094.11	4271	4274	+	3	0	0	4834
Q8IZY2-1#39	0	3	3	Q8IZY2-1	4578	4581	+	3	Q8IZY2-1	0	6438	ENST00000263094.11	227	6665	++	9	Q8IZY2-1#39	0	3	ENST00000263094.11	4805	4808	+	3	0	0	4835
Q8IZY2-1#40	0	3	3	Q8IZY2-1	5055	5058	+	3	Q8IZY2-1	4613	6438	ENST00000525073.6	0	1771	+	144	Q8IZY2-1#40	0	3	ENST00000525073.6	388	391	+	3	0	0	4836
Q8IZY2-1#40	0	3	3	Q8IZY2-1	5055	5058	+	3	Q8IZY2-1	0	6438	ENST00000263094.11	227	6665	++	9	Q8IZY2-1#40	0	3	ENST00000263094.11	5282	5285	+	3	0	0	4837
Q8IZY2-1#41	0	3	3	Q8IZY2-1	6132	6135	+	3	Q8IZY2-1	5577	6438	ENST00000612569.1	0	840	+	232	Q8IZY2-1#41	0	3	ENST00000612569.1	555	558	+	3	0	0	4838
Q8IZY2-1#41	0	3	3	Q8IZY2-1	6132	6135	+	3	Q8IZY2-1	4613	6438	ENST00000525073.6	0	1771	+	144	Q8IZY2-1#41	0	3	ENST00000525073.6	1465	1468	+	3	0	0	4839
Q8IZY2-1#41	0	3	3	Q8IZY2-1	6132	6135	+	3	Q8IZY2-1	0	6438	ENST00000263094.11	227	6665	++	9	Q8IZY2-1#41	0	3	ENST00000263094.11	6359	6362	+	3	0	0	4840
Q8IZY2-1#42	0	3	3	Q8IZY2-1	4506	4509	+	3	Q8IZY2-1	0	6438	ENST00000263094.11	227	6665	++	9	Q8IZY2-1#42	0	3	ENST00000263094.11	4733	4736	+	3	0	0	4841
Q8IZY2-1#43	0	3	3	Q8IZY2-1	4572	4575	+	3	Q8IZY2-1	0	6438	ENST00000263094.11	227	6665	++	9	Q8IZY2-1#43	0	3	ENST00000263094.11	4799	4802	+	3	0	0	4842
Q8N726-1#0	0	396	396	Q8N726-1	0	396	+	396	Q8N726-1	0	396	ENST00000579755.2	61	457	++	197	Q8N726-1#0	0	396	ENST00000579755.2	61	457	+	396	0	0	4843
Q8N726-1#0	0	396	396	Q8N726-1	0	396	+	396	Q8N726-1	189	396	ENST00000579122.1	177	384	+	196	Q8N726-1#0	189	396	ENST00000579122.1	177	384	+	207	189	0	4844
Q8N726-1#0	0	396	396	Q8N726-1	0	396	+	396	Q8N726-1	198	396	ENST00000578845.2	129	327	++	194	Q8N726-1#0	198	396	ENST00000578845.2	129	327	+	198	198	0	4845
Q8N726-1#0	0	396	396	Q8N726-1	0	396	+	396	Q8N726-1	0	396	ENST00000530628.2	80	476	++	151	Q8N726-1#0	0	396	ENST00000530628.2	80	476	+	396	0	0	4846
Q8N726-1#0	0	396	396	Q8N726-1	0	396	+	396	Q8N726-1	198	396	ENST00000498628.6	486	684	++	129	Q8N726-1#0	198	396	ENST00000498628.6	486	684	+	198	198	0	4847
Q8N726-1#0	0	396	396	Q8N726-1	0	396	+	396	Q8N726-1	189	396	ENST00000498124.1	185	392	++	127	Q8N726-1#0	189	396	ENST00000498124.1	185	392	+	207	189	0	4848
Q8N726-1#0	0	396	396	Q8N726-1	0	396	+	396	Q8N726-1	196	396	ENST00000497750.1	75	275	+	124	Q8N726-1#0	196	396	ENST00000497750.1	75	275	+	200	196	0	4849
Q8N726-1#0	0	396	396	Q8N726-1	0	396	+	396	Q8N726-1	198	396	ENST00000494262.5	626	824	++	121	Q8N726-1#0	198	396	ENST00000494262.5	626	824	+	198	198	0	4850
Q8N726-1#0	0	396	396	Q8N726-1	0	396	+	396	Q8N726-1	196	396	ENST00000479692.2	15	215	+	113	Q8N726-1#0	196	396	ENST00000479692.2	15	215	+	200	196	0	4851
Q8N726-1#0	0	396	396	Q8N726-1	0	396	+	396	Q8N726-1	189	396	ENST00000304494.10	176	383	++	23	Q8N726-1#0	189	396	ENST00000304494.10	176	383	+	207	189	0	4852
Q8N726-1#1	0	192	192	Q8N726-1	0	192	+	192	Q8N726-1	0	396	ENST00000579755.2	61	457	++	197	Q8N726-1#1	0	192	ENST00000579755.2	61	253	+	192	0	0	4853
Q8N726-1#1	0	192	192	Q8N726-1	0	192	+	192	Q8N726-1	189	396	ENST00000579122.1	177	384	+	196	Q8N726-1#1	189	192	ENST00000579122.1	177	180	+	3	189	0	4854
Q8N726-1#1	0	192	192	Q8N726-1	0	192	+	192	Q8N726-1	0	396	ENST00000530628.2	80	476	++	151	Q8N726-1#1	0	192	ENST00000530628.2	80	272	+	192	0	0	4855
Q8N726-1#1	0	192	192	Q8N726-1	0	192	+	192	Q8N726-1	189	396	ENST00000498124.1	185	392	++	127	Q8N726-1#1	189	192	ENST00000498124.1	185	188	+	3	189	0	4856
Q8N726-1#1	0	192	192	Q8N726-1	0	192	+	192	Q8N726-1	189	396	ENST00000304494.10	176	383	++	23	Q8N726-1#1	189	192	ENST00000304494.10	176	179	+	3	189	0	4857
Q8N726-1#2	0	231	231	Q8N726-1	165	396	+	231	Q8N726-1	0	396	ENST00000579755.2	61	457	++	197	Q8N726-1#2	0	231	ENST00000579755.2	226	457	+	231	0	0	4858
Q8N726-1#2	0	231	231	Q8N726-1	165	396	+	231	Q8N726-1	189	396	ENST00000579122.1	177	384	+	196	Q8N726-1#2	24	231	ENST00000579122.1	177	384	+	207	24	0	4859
Q8N726-1#2	0	231	231	Q8N726-1	165	396	+	231	Q8N726-1	198	396	ENST00000578845.2	129	327	++	194	Q8N726-1#2	33	231	ENST00000578845.2	129	327	+	198	33	0	4860
Q8N726-1#2	0	231	231	Q8N726-1	165	396	+	231	Q8N726-1	0	396	ENST00000530628.2	80	476	++	151	Q8N726-1#2	0	231	ENST00000530628.2	245	476	+	231	0	0	4861
Q8N726-1#2	0	231	231	Q8N726-1	165	396	+	231	Q8N726-1	198	396	ENST00000498628.6	486	684	++	129	Q8N726-1#2	33	231	ENST00000498628.6	486	684	+	198	33	0	4862
Q8N726-1#2	0	231	231	Q8N726-1	165	396	+	231	Q8N726-1	189	396	ENST00000498124.1	185	392	++	127	Q8N726-1#2	24	231	ENST00000498124.1	185	392	+	207	24	0	4863
Q8N726-1#2	0	231	231	Q8N726-1	165	396	+	231	Q8N726-1	196	396	ENST00000497750.1	75	275	+	124	Q8N726-1#2	31	231	ENST00000497750.1	75	275	+	200	31	0	4864
Q8N726-1#2	0	231	231	Q8N726-1	165	396	+	231	Q8N726-1	198	396	ENST00000494262.5	626	824	++	121	Q8N726-1#2	33	231	ENST00000494262.5	626	824	+	198	33	0	4865
Q8N726-1#2	0	231	231	Q8N726-1	165	396	+	231	Q8N726-1	196	396	ENST00000479692.2	15	215	+	113	Q8N726-1#2	31	231	ENST00000479692.2	15	215	+	200	31	0	4866
Q8N726-1#2	0	231	231	Q8N726-1	165	396	+	231	Q8N726-1	189	396	ENST00000304494.10	176	383	++	23	Q8N726-1#2	24	231	ENST00000304494.10	176	383	+	207	24	0	4867
Q8N726-1#3	0	141	141	Q8N726-1	0	141	+	141	Q8N726-1	0	396	ENST00000579755.2	61	457	++	197	Q8N726-1#3	0	141	ENST00000579755.2	61	202	+	141	0	0	4868
Q8N726-1#3	0	141	141	Q8N726-1	0	141	+	141	Q8N726-1	0	396	ENST00000530628.2	80	476	++	151	Q8N726-1#3	0	141	ENST00000530628.2	80	221	+	141	0	0	4869
Q8N726-1#4	0	3	3	Q8N726-1	48	51	+	3	Q8N726-1	0	396	ENST00000579755.2	61	457	++	197	Q8N726-1#4	0	3	ENST00000579755.2	109	112	+	3	0	0	4870
Q8N726-1#4	0	3	3	Q8N726-1	48	51	+	3	Q8N726-1	0	396	ENST00000530628.2	80	476	++	151	Q8N726-1#4	0	3	ENST00000530628.2	128	131	+	3	0	0	4871
Q8N726-1#5	0	3	3	Q8N726-1	315	318	+	3	Q8N726-1	0	396	ENST00000579755.2	61	457	++	197	Q8N726-1#5	0	3	ENST00000579755.2	376	379	+	3	0	0	4872
Q8N726-1#5	0	3	3	Q8N726-1	315	318	+	3	Q8N726-1	189	396	ENST00000579122.1	177	384	+	196	Q8N726-1#5	0	3	ENST00000579122.1	303	306	+	3	0	0	4873
Q8N726-1#5	0	3	3	Q8N726-1	315	318	+	3	Q8N726-1	198	396	ENST00000578845.2	129	327	++	194	Q8N726-1#5	0	3	ENST00000578845.2	246	249	+	3	0	0	4874
Q8N726-1#5	0	3	3	Q8N726-1	315	318	+	3	Q8N726-1	0	396	ENST00000530628.2	80	476	++	151	Q8N726-1#5	0	3	ENST00000530628.2	395	398	+	3	0	0	4875
Q8N726-1#5	0	3	3	Q8N726-1	315	318	+	3	Q8N726-1	198	396	ENST00000498628.6	486	684	++	129	Q8N726-1#5	0	3	ENST00000498628.6	603	606	+	3	0	0	4876
Q8N726-1#5	0	3	3	Q8N726-1	315	318	+	3	Q8N726-1	189	396	ENST00000498124.1	185	392	++	127	Q8N726-1#5	0	3	ENST00000498124.1	311	314	+	3	0	0	4877
Q8N726-1#5	0	3	3	Q8N726-1	315	318	+	3	Q8N726-1	196	396	ENST00000497750.1	75	275	+	124	Q8N726-1#5	0	3	ENST00000497750.1	194	197	+	3	0	0	4878
Q8N726-1#5	0	3	3	Q8N726-1	315	318	+	3	Q8N726-1	198	396	ENST00000494262.5	626	824	++	121	Q8N726-1#5	0	3	ENST00000494262.5	743	746	+	3	0	0	4879
Q8N726-1#5	0	3	3	Q8N726-1	315	318	+	3	Q8N726-1	196	396	ENST00000479692.2	15	215	+	113	Q8N726-1#5	0	3	ENST00000479692.2	134	137	+	3	0	0	4880
Q8N726-1#5	0	3	3	Q8N726-1	315	318	+	3	Q8N726-1	189	396	ENST00000304494.10	176	383	++	23	Q8N726-1#5	0	3	ENST00000304494.10	302	305	+	3	0	0	4881
Q8N726-1#6	0	3	3	Q8N726-1	336	339	+	3	Q8N726-1	0	396	ENST00000579755.2	61	457	++	197	Q8N726-1#6	0	3	ENST00000579755.2	397	400	+	3	0	0	4882
Q8N726-1#6	0	3	3	Q8N726-1	336	339	+	3	Q8N726-1	189	396	ENST00000579122.1	177	384	+	196	Q8N726-1#6	0	3	ENST00000579122.1	324	327	+	3	0	0	4883
Q8N726-1#6	0	3	3	Q8N726-1	336	339	+	3	Q8N726-1	198	396	ENST00000578845.2	129	327	++	194	Q8N726-1#6	0	3	ENST00000578845.2	267	270	+	3	0	0	4884
Q8N726-1#6	0	3	3	Q8N726-1	336	339	+	3	Q8N726-1	0	396	ENST00000530628.2	80	476	++	151	Q8N726-1#6	0	3	ENST00000530628.2	416	419	+	3	0	0	4885
Q8N726-1#6	0	3	3	Q8N726-1	336	339	+	3	Q8N726-1	198	396	ENST00000498628.6	486	684	++	129	Q8N726-1#6	0	3	ENST00000498628.6	624	627	+	3	0	0	4886
Q8N726-1#6	0	3	3	Q8N726-1	336	339	+	3	Q8N726-1	189	396	ENST00000498124.1	185	392	++	127	Q8N726-1#6	0	3	ENST00000498124.1	332	335	+	3	0	0	4887
Q8N726-1#6	0	3	3	Q8N726-1	336	339	+	3	Q8N726-1	196	396	ENST00000497750.1	75	275	+	124	Q8N726-1#6	0	3	ENST00000497750.1	215	218	+	3	0	0	4888
Q8N726-1#6	0	3	3	Q8N726-1	336	339	+	3	Q8N726-1	198	396	ENST00000494262.5	626	824	++	121	Q8N726-1#6	0	3	ENST00000494262.5	764	767	+	3	0	0	4889
Q8N726-1#6	0	3	3	Q8N726-1	336	339	+	3	Q8N726-1	196	396	ENST00000479692.2	15	215	+	113	Q8N726-1#6	0	3	ENST00000479692.2	155	158	+	3	0	0	4890
Q8N726-1#6	0	3	3	Q8N726-1	336	339	+	3	Q8N726-1	189	396	ENST00000304494.10	176	383	++	23	Q8N726-1#6	0	3	ENST00000304494.10	323	326	+	3	0	0	4891
Q8N726-1#7	0	3	3	Q8N726-1	345	348	+	3	Q8N726-1	0	396	ENST00000579755.2	61	457	++	197	Q8N726-1#7	0	3	ENST00000579755.2	406	409	+	3	0	0	4892
Q8N726-1#7	0	3	3	Q8N726-1	345	348	+	3	Q8N726-1	189	396	ENST00000579122.1	177	384	+	196	Q8N726-1#7	0	3	ENST00000579122.1	333	336	+	3	0	0	4893
Q8N726-1#7	0	3	3	Q8N726-1	345	348	+	3	Q8N726-1	198	396	ENST00000578845.2	129	327	++	194	Q8N726-1#7	0	3	ENST00000578845.2	276	279	+	3	0	0	4894
Q8N726-1#7	0	3	3	Q8N726-1	345	348	+	3	Q8N726-1	0	396	ENST00000530628.2	80	476	++	151	Q8N726-1#7	0	3	ENST00000530628.2	425	428	+	3	0	0	4895
Q8N726-1#7	0	3	3	Q8N726-1	345	348	+	3	Q8N726-1	198	396	ENST00000498628.6	486	684	++	129	Q8N726-1#7	0	3	ENST00000498628.6	633	636	+	3	0	0	4896
Q8N726-1#7	0	3	3	Q8N726-1	345	348	+	3	Q8N726-1	189	396	ENST00000498124.1	185	392	++	127	Q8N726-1#7	0	3	ENST00000498124.1	341	344	+	3	0	0	4897
Q8N726-1#7	0	3	3	Q8N726-1	345	348	+	3	Q8N726-1	196	396	ENST00000497750.1	75	275	+	124	Q8N726-1#7	0	3	ENST00000497750.1	224	227	+	3	0	0	4898
Q8N726-1#7	0	3	3	Q8N726-1	345	348	+	3	Q8N726-1	198	396	ENST00000494262.5	626	824	++	121	Q8N726-1#7	0	3	ENST00000494262.5	773	776	+	3	0	0	4899
Q8N726-1#7	0	3	3	Q8N726-1	345	348	+	3	Q8N726-1	196	396	ENST00000479692.2	15	215	+	113	Q8N726-1#7	0	3	ENST00000479692.2	164	167	+	3	0	0	4900
Q8N726-1#7	0	3	3	Q8N726-1	345	348	+	3	Q8N726-1	189	396	ENST00000304494.10	176	383	++	23	Q8N726-1#7	0	3	ENST00000304494.10	332	335	+	3	0	0	4901
Q8N726-1#8	0	9	9	Q8N726-1	81	90	+	9	Q8N726-1	0	396	ENST00000579755.2	61	457	++	197	Q8N726-1#8	0	9	ENST00000579755.2	142	151	+	9	0	0	4902
Q8N726-1#8	0	9	9	Q8N726-1	81	90	+	9	Q8N726-1	0	396	ENST00000530628.2	80	476	++	151	Q8N726-1#8	0	9	ENST00000530628.2	161	170	+	9	0	0	4903
Q8N726-1#9	0	3	3	Q8N726-1	279	282	+	3	Q8N726-1	0	396	ENST00000579755.2	61	457	++	197	Q8N726-1#9	0	3	ENST00000579755.2	340	343	+	3	0	0	4904
Q8N726-1#9	0	3	3	Q8N726-1	279	282	+	3	Q8N726-1	189	396	ENST00000579122.1	177	384	+	196	Q8N726-1#9	0	3	ENST00000579122.1	267	270	+	3	0	0	4905
Q8N726-1#9	0	3	3	Q8N726-1	279	282	+	3	Q8N726-1	198	396	ENST00000578845.2	129	327	++	194	Q8N726-1#9	0	3	ENST00000578845.2	210	213	+	3	0	0	4906
Q8N726-1#9	0	3	3	Q8N726-1	279	282	+	3	Q8N726-1	0	396	ENST00000530628.2	80	476	++	151	Q8N726-1#9	0	3	ENST00000530628.2	359	362	+	3	0	0	4907
Q8N726-1#9	0	3	3	Q8N726-1	279	282	+	3	Q8N726-1	198	396	ENST00000498628.6	486	684	++	129	Q8N726-1#9	0	3	ENST00000498628.6	567	570	+	3	0	0	4908
Q8N726-1#9	0	3	3	Q8N726-1	279	282	+	3	Q8N726-1	189	396	ENST00000498124.1	185	392	++	127	Q8N726-1#9	0	3	ENST00000498124.1	275	278	+	3	0	0	4909
Q8N726-1#9	0	3	3	Q8N726-1	279	282	+	3	Q8N726-1	196	396	ENST00000497750.1	75	275	+	124	Q8N726-1#9	0	3	ENST00000497750.1	158	161	+	3	0	0	4910
Q8N726-1#9	0	3	3	Q8N726-1	279	282	+	3	Q8N726-1	198	396	ENST00000494262.5	626	824	++	121	Q8N726-1#9	0	3	ENST00000494262.5	707	710	+	3	0	0	4911
Q8N726-1#9	0	3	3	Q8N726-1	279	282	+	3	Q8N726-1	196	396	ENST00000479692.2	15	215	+	113	Q8N726-1#9	0	3	ENST00000479692.2	98	101	+	3	0	0	4912
Q8N726-1#9	0	3	3	Q8N726-1	279	282	+	3	Q8N726-1	189	396	ENST00000304494.10	176	383	++	23	Q8N726-1#9	0	3	ENST00000304494.10	266	269	+	3	0	0	4913
Q9Y215-1#0	0	66	66	Q9Y215-1	0	66	+	66	Q9Y215-1	0	813	ENST00000681097.1	91	904	++	274	Q9Y215-1#0	0	66	ENST00000681097.1	91	157	+	66	0	0	4914
Q9Y215-1#0	0	66	66	Q9Y215-1	0	66	+	66	Q9Y215-1	0	238	ENST00000679838.1	95	320	+	273	Q9Y215-1#0	0	66	ENST00000679838.1	95	161	+	66	0	0	4915
Q9Y215-1#0	0	66	66	Q9Y215-1	0	66	+	66	Q9Y215-1	0	1365	ENST00000603808.5	126	1494	+	227	Q9Y215-1#0	0	66	ENST00000603808.5	126	192	+	66	0	0	4916
Q9Y215-1#0	0	66	66	Q9Y215-1	0	66	+	66	Q9Y215-1	0	1365	ENST00000383788.10	81	1446	++	57	Q9Y215-1#0	0	66	ENST00000383788.10	81	147	+	66	0	0	4917
Q9Y215-1#0	0	66	66	Q9Y215-1	0	66	+	66	Q9Y215-1	0	1365	ENST00000383786.9	111	1374	++	56	Q9Y215-1#0	0	66	ENST00000383786.9	111	177	+	66	0	0	4918
Q9Y215-1#1	0	1299	1299	Q9Y215-1	66	1365	+	1299	Q9Y215-1	0	813	ENST00000681097.1	91	904	++	274	Q9Y215-1#1	0	747	ENST00000681097.1	157	904	+	747	0	552	4919
Q9Y215-1#1	0	1299	1299	Q9Y215-1	66	1365	+	1299	Q9Y215-1	0	238	ENST00000679838.1	95	320	+	273	Q9Y215-1#1	0	172	ENST00000679838.1	161	320	+	159	0	1127	4920
Q9Y215-1#1	0	1299	1299	Q9Y215-1	66	1365	+	1299	Q9Y215-1	105	753	ENST00000605797.1	36	582	+	228	Q9Y215-1#1	39	687	ENST00000605797.1	36	582	+	546	39	612	4921
Q9Y215-1#1	0	1299	1299	Q9Y215-1	66	1365	+	1299	Q9Y215-1	0	1365	ENST00000603808.5	126	1494	+	227	Q9Y215-1#1	0	1299	ENST00000603808.5	192	1494	+	1298	0	0	4922
Q9Y215-1#1	0	1299	1299	Q9Y215-1	66	1365	+	1299	Q9Y215-1	0	1365	ENST00000383788.10	81	1446	++	57	Q9Y215-1#1	0	1299	ENST00000383788.10	147	1446	+	1299	0	0	4923
Q9Y215-1#1	0	1299	1299	Q9Y215-1	66	1365	+	1299	Q9Y215-1	0	1365	ENST00000383786.9	111	1374	++	56	Q9Y215-1#1	0	1299	ENST00000383786.9	177	1374	+	1197	0	0	4924
Q9Y215-1#1	0	1299	1299	Q9Y215-1	66	1365	+	1299	Q9Y215-1	105	1365	ENST00000383781.8	360	1620	++	55	Q9Y215-1#1	39	1299	ENST00000383781.8	360	1620	+	1260	39	0	4925
Q9Y215-1#2	0	522	522	Q9Y215-1	285	807	+	522	Q9Y215-1	0	813	ENST00000681097.1	91	904	++	274	Q9Y215-1#2	0	522	ENST00000681097.1	376	898	+	522	0	0	4926
Q9Y215-1#2	0	522	522	Q9Y215-1	285	807	+	522	Q9Y215-1	105	753	ENST00000605797.1	36	582	+	228	Q9Y215-1#2	36	468	ENST00000605797.1	150	582	+	432	36	54	4927
Q9Y215-1#2	0	522	522	Q9Y215-1	285	807	+	522	Q9Y215-1	0	1365	ENST00000603808.5	126	1494	+	227	Q9Y215-1#2	0	522	ENST00000603808.5	411	933	+	522	0	0	4928
Q9Y215-1#2	0	522	522	Q9Y215-1	285	807	+	522	Q9Y215-1	0	1365	ENST00000383788.10	81	1446	++	57	Q9Y215-1#2	0	522	ENST00000383788.10	366	888	+	522	0	0	4929
Q9Y215-1#2	0	522	522	Q9Y215-1	285	807	+	522	Q9Y215-1	0	1365	ENST00000383786.9	111	1374	++	56	Q9Y215-1#2	36	522	ENST00000383786.9	330	816	+	486	36	0	4930
Q9Y215-1#2	0	522	522	Q9Y215-1	285	807	+	522	Q9Y215-1	105	1365	ENST00000383781.8	360	1620	++	55	Q9Y215-1#2	0	522	ENST00000383781.8	540	1062	+	522	0	0	4931
Q9Y215-1#3	0	45	45	Q9Y215-1	828	873	+	45	Q9Y215-1	0	1365	ENST00000603808.5	126	1494	+	227	Q9Y215-1#3	0	45	ENST00000603808.5	954	999	+	45	0	0	4932
Q9Y215-1#3	0	45	45	Q9Y215-1	828	873	+	45	Q9Y215-1	0	1365	ENST00000383788.10	81	1446	++	57	Q9Y215-1#3	0	45	ENST00000383788.10	909	954	+	45	0	0	4933
Q9Y215-1#3	0	45	45	Q9Y215-1	828	873	+	45	Q9Y215-1	0	1365	ENST00000383786.9	111	1374	++	56	Q9Y215-1#3	0	45	ENST00000383786.9	837	882	+	45	0	0	4934
Q9Y215-1#3	0	45	45	Q9Y215-1	828	873	+	45	Q9Y215-1	105	1365	ENST00000383781.8	360	1620	++	55	Q9Y215-1#3	0	45	ENST00000383781.8	1083	1128	+	45	0	0	4935
Q9Y215-1#4	0	51	51	Q9Y215-1	150	201	+	51	Q9Y215-1	0	813	ENST00000681097.1	91	904	++	274	Q9Y215-1#4	0	51	ENST00000681097.1	241	292	+	51	0	0	4936
Q9Y215-1#4	0	51	51	Q9Y215-1	150	201	+	51	Q9Y215-1	0	238	ENST00000679838.1	95	320	+	273	Q9Y215-1#4	0	51	ENST00000679838.1	245	296	+	51	0	0	4937
Q9Y215-1#4	0	51	51	Q9Y215-1	150	201	+	51	Q9Y215-1	105	753	ENST00000605797.1	36	582	+	228	Q9Y215-1#4	0	51	ENST00000605797.1	81	132	+	51	0	0	4938
Q9Y215-1#4	0	51	51	Q9Y215-1	150	201	+	51	Q9Y215-1	0	1365	ENST00000603808.5	126	1494	+	227	Q9Y215-1#4	0	51	ENST00000603808.5	276	327	+	51	0	0	4939
Q9Y215-1#4	0	51	51	Q9Y215-1	150	201	+	51	Q9Y215-1	0	1365	ENST00000383788.10	81	1446	++	57	Q9Y215-1#4	0	51	ENST00000383788.10	231	282	+	51	0	0	4940
Q9Y215-1#4	0	51	51	Q9Y215-1	150	201	+	51	Q9Y215-1	0	1365	ENST00000383786.9	111	1374	++	56	Q9Y215-1#4	0	51	ENST00000383786.9	261	312	+	51	0	0	4941
Q9Y215-1#4	0	51	51	Q9Y215-1	150	201	+	51	Q9Y215-1	105	1365	ENST00000383781.8	360	1620	++	55	Q9Y215-1#4	0	51	ENST00000383781.8	405	456	+	51	0	0	4942
Q9Y215-1#5	0	579	579	Q9Y215-1	267	846	+	579	Q9Y215-1	0	813	ENST00000681097.1	91	904	++	274	Q9Y215-1#5	0	546	ENST00000681097.1	358	904	+	546	0	33	4943
Q9Y215-1#5	0	579	579	Q9Y215-1	267	846	+	579	Q9Y215-1	105	753	ENST00000605797.1	36	582	+	228	Q9Y215-1#5	54	486	ENST00000605797.1	150	582	+	432	54	93	4944
Q9Y215-1#5	0	579	579	Q9Y215-1	267	846	+	579	Q9Y215-1	0	1365	ENST00000603808.5	126	1494	+	227	Q9Y215-1#5	0	579	ENST00000603808.5	393	972	+	579	0	0	4945
Q9Y215-1#5	0	579	579	Q9Y215-1	267	846	+	579	Q9Y215-1	0	1365	ENST00000383788.10	81	1446	++	57	Q9Y215-1#5	0	579	ENST00000383788.10	348	927	+	579	0	0	4946
Q9Y215-1#5	0	579	579	Q9Y215-1	267	846	+	579	Q9Y215-1	0	1365	ENST00000383786.9	111	1374	++	56	Q9Y215-1#5	54	579	ENST00000383786.9	330	855	+	525	54	0	4947
Q9Y215-1#5	0	579	579	Q9Y215-1	267	846	+	579	Q9Y215-1	105	1365	ENST00000383781.8	360	1620	++	55	Q9Y215-1#5	0	579	ENST00000383781.8	522	1101	+	579	0	0	4948
Q9Y215-1#6	0	12	12	Q9Y215-1	387	399	+	12	Q9Y215-1	0	813	ENST00000681097.1	91	904	++	274	Q9Y215-1#6	0	12	ENST00000681097.1	478	490	+	12	0	0	4949
Q9Y215-1#6	0	12	12	Q9Y215-1	387	399	+	12	Q9Y215-1	105	753	ENST00000605797.1	36	582	+	228	Q9Y215-1#6	0	12	ENST00000605797.1	216	228	+	12	0	0	4950
Q9Y215-1#6	0	12	12	Q9Y215-1	387	399	+	12	Q9Y215-1	0	1365	ENST00000603808.5	126	1494	+	227	Q9Y215-1#6	0	12	ENST00000603808.5	513	525	+	12	0	0	4951
Q9Y215-1#6	0	12	12	Q9Y215-1	387	399	+	12	Q9Y215-1	0	1365	ENST00000383788.10	81	1446	++	57	Q9Y215-1#6	0	12	ENST00000383788.10	468	480	+	12	0	0	4952
Q9Y215-1#6	0	12	12	Q9Y215-1	387	399	+	12	Q9Y215-1	0	1365	ENST00000383786.9	111	1374	++	56	Q9Y215-1#6	0	12	ENST00000383786.9	396	408	+	12	0	0	4953
Q9Y215-1#6	0	12	12	Q9Y215-1	387	399	+	12	Q9Y215-1	105	1365	ENST00000383781.8	360	1620	++	55	Q9Y215-1#6	0	12	ENST00000383781.8	642	654	+	12	0	0	4954
Q9Y215-1#7	0	12	12	Q9Y215-1	702	714	+	12	Q9Y215-1	0	813	ENST00000681097.1	91	904	++	274	Q9Y215-1#7	0	12	ENST00000681097.1	793	805	+	12	0	0	4955
Q9Y215-1#7	0	12	12	Q9Y215-1	702	714	+	12	Q9Y215-1	105	753	ENST00000605797.1	36	582	+	228	Q9Y215-1#7	0	12	ENST00000605797.1	531	543	+	12	0	0	4956
Q9Y215-1#7	0	12	12	Q9Y215-1	702	714	+	12	Q9Y215-1	0	1365	ENST00000603808.5	126	1494	+	227	Q9Y215-1#7	0	12	ENST00000603808.5	828	840	+	12	0	0	4957
Q9Y215-1#7	0	12	12	Q9Y215-1	702	714	+	12	Q9Y215-1	0	1365	ENST00000383788.10	81	1446	++	57	Q9Y215-1#7	0	12	ENST00000383788.10	783	795	+	12	0	0	4958
Q9Y215-1#7	0	12	12	Q9Y215-1	702	714	+	12	Q9Y215-1	0	1365	ENST00000383786.9	111	1374	++	56	Q9Y215-1#7	0	12	ENST00000383786.9	711	723	+	12	0	0	4959
Q9Y215-1#7	0	12	12	Q9Y215-1	702	714	+	12	Q9Y215-1	105	1365	ENST00000383781.8	360	1620	++	55	Q9Y215-1#7	0	12	ENST00000383781.8	957	969	+	12	0	0	4960
Q9Y215-1#8	0	54	54	Q9Y215-1	396	450	+	54	Q9Y215-1	0	813	ENST00000681097.1	91	904	++	274	Q9Y215-1#8	0	54	ENST00000681097.1	487	541	+	54	0	0	4961
Q9Y215-1#8	0	54	54	Q9Y215-1	396	450	+	54	Q9Y215-1	105	753	ENST00000605797.1	36	582	+	228	Q9Y215-1#8	0	54	ENST00000605797.1	225	279	+	54	0	0	4962
Q9Y215-1#8	0	54	54	Q9Y215-1	396	450	+	54	Q9Y215-1	0	1365	ENST00000603808.5	126	1494	+	227	Q9Y215-1#8	0	54	ENST00000603808.5	522	576	+	54	0	0	4963
Q9Y215-1#8	0	54	54	Q9Y215-1	396	450	+	54	Q9Y215-1	0	1365	ENST00000383788.10	81	1446	++	57	Q9Y215-1#8	0	54	ENST00000383788.10	477	531	+	54	0	0	4964
Q9Y215-1#8	0	54	54	Q9Y215-1	396	450	+	54	Q9Y215-1	0	1365	ENST00000383786.9	111	1374	++	56	Q9Y215-1#8	0	54	ENST00000383786.9	405	459	+	54	0	0	4965
Q9Y215-1#8	0	54	54	Q9Y215-1	396	450	+	54	Q9Y215-1	105	1365	ENST00000383781.8	360	1620	++	55	Q9Y215-1#8	0	54	ENST00000383781.8	651	705	+	54	0	0	4966
Q9Y215-1#9	0	45	45	Q9Y215-1	546	591	+	45	Q9Y215-1	0	813	ENST00000681097.1	91	904	++	274	Q9Y215-1#9	0	45	ENST00000681097.1	637	682	+	45	0	0	4967
Q9Y215-1#9	0	45	45	Q9Y215-1	546	591	+	45	Q9Y215-1	105	753	ENST00000605797.1	36	582	+	228	Q9Y215-1#9	0	45	ENST00000605797.1	375	420	+	45	0	0	4968
Q9Y215-1#9	0	45	45	Q9Y215-1	546	591	+	45	Q9Y215-1	0	1365	ENST00000603808.5	126	1494	+	227	Q9Y215-1#9	0	45	ENST00000603808.5	672	717	+	45	0	0	4969
Q9Y215-1#9	0	45	45	Q9Y215-1	546	591	+	45	Q9Y215-1	0	1365	ENST00000383788.10	81	1446	++	57	Q9Y215-1#9	0	45	ENST00000383788.10	627	672	+	45	0	0	4970
Q9Y215-1#9	0	45	45	Q9Y215-1	546	591	+	45	Q9Y215-1	0	1365	ENST00000383786.9	111	1374	++	56	Q9Y215-1#9	0	45	ENST00000383786.9	555	600	+	45	0	0	4971
Q9Y215-1#9	0	45	45	Q9Y215-1	546	591	+	45	Q9Y215-1	105	1365	ENST00000383781.8	360	1620	++	55	Q9Y215-1#9	0	45	ENST00000383781.8	801	846	+	45	0	0	4972
Q9Y215-1#10	0	63	63	Q9Y215-1	756	819	+	63	Q9Y215-1	0	813	ENST00000681097.1	91	904	++	274	Q9Y215-1#10	0	57	ENST00000681097.1	847	904	+	57	0	6	4973
Q9Y215-1#10	0	63	63	Q9Y215-1	756	819	+	63	Q9Y215-1	0	1365	ENST00000603808.5	126	1494	+	227	Q9Y215-1#10	0	63	ENST00000603808.5	882	945	+	63	0	0	4974
Q9Y215-1#10	0	63	63	Q9Y215-1	756	819	+	63	Q9Y215-1	0	1365	ENST00000383788.10	81	1446	++	57	Q9Y215-1#10	0	63	ENST00000383788.10	837	900	+	63	0	0	4975
Q9Y215-1#10	0	63	63	Q9Y215-1	756	819	+	63	Q9Y215-1	0	1365	ENST00000383786.9	111	1374	++	56	Q9Y215-1#10	0	63	ENST00000383786.9	765	828	+	63	0	0	4976
Q9Y215-1#10	0	63	63	Q9Y215-1	756	819	+	63	Q9Y215-1	105	1365	ENST00000383781.8	360	1620	++	55	Q9Y215-1#10	0	63	ENST00000383781.8	1011	1074	+	63	0	0	4977
Q9Y215-1#11	0	3	3	Q9Y215-1	150	153	+	3	Q9Y215-1	0	813	ENST00000681097.1	91	904	++	274	Q9Y215-1#11	0	3	ENST00000681097.1	241	244	+	3	0	0	4978
Q9Y215-1#11	0	3	3	Q9Y215-1	150	153	+	3	Q9Y215-1	0	238	ENST00000679838.1	95	320	+	273	Q9Y215-1#11	0	3	ENST00000679838.1	245	248	+	3	0	0	4979
Q9Y215-1#11	0	3	3	Q9Y215-1	150	153	+	3	Q9Y215-1	105	753	ENST00000605797.1	36	582	+	228	Q9Y215-1#11	0	3	ENST00000605797.1	81	84	+	3	0	0	4980
Q9Y215-1#11	0	3	3	Q9Y215-1	150	153	+	3	Q9Y215-1	0	1365	ENST00000603808.5	126	1494	+	227	Q9Y215-1#11	0	3	ENST00000603808.5	276	279	+	3	0	0	4981
Q9Y215-1#11	0	3	3	Q9Y215-1	150	153	+	3	Q9Y215-1	0	1365	ENST00000383788.10	81	1446	++	57	Q9Y215-1#11	0	3	ENST00000383788.10	231	234	+	3	0	0	4982
Q9Y215-1#11	0	3	3	Q9Y215-1	150	153	+	3	Q9Y215-1	0	1365	ENST00000383786.9	111	1374	++	56	Q9Y215-1#11	0	3	ENST00000383786.9	261	264	+	3	0	0	4983
Q9Y215-1#11	0	3	3	Q9Y215-1	150	153	+	3	Q9Y215-1	105	1365	ENST00000383781.8	360	1620	++	55	Q9Y215-1#11	0	3	ENST00000383781.8	405	408	+	3	0	0	4984
Q9Y215-1#12	0	3	3	Q9Y215-1	153	156	+	3	Q9Y215-1	0	813	ENST00000681097.1	91	904	++	274	Q9Y215-1#12	0	3	ENST00000681097.1	244	247	+	3	0	0	4985
Q9Y215-1#12	0	3	3	Q9Y215-1	153	156	+	3	Q9Y215-1	0	238	ENST00000679838.1	95	320	+	273	Q9Y215-1#12	0	3	ENST00000679838.1	248	251	+	3	0	0	4986
Q9Y215-1#12	0	3	3	Q9Y215-1	153	156	+	3	Q9Y215-1	105	753	ENST00000605797.1	36	582	+	228	Q9Y215-1#12	0	3	ENST00000605797.1	84	87	+	3	0	0	4987
Q9Y215-1#12	0	3	3	Q9Y215-1	153	156	+	3	Q9Y215-1	0	1365	ENST00000603808.5	126	1494	+	227	Q9Y215-1#12	0	3	ENST00000603808.5	279	282	+	3	0	0	4988
Q9Y215-1#12	0	3	3	Q9Y215-1	153	156	+	3	Q9Y215-1	0	1365	ENST00000383788.10	81	1446	++	57	Q9Y215-1#12	0	3	ENST00000383788.10	234	237	+	3	0	0	4989
Q9Y215-1#12	0	3	3	Q9Y215-1	153	156	+	3	Q9Y215-1	0	1365	ENST00000383786.9	111	1374	++	56	Q9Y215-1#12	0	3	ENST00000383786.9	264	267	+	3	0	0	4990
Q9Y215-1#12	0	3	3	Q9Y215-1	153	156	+	3	Q9Y215-1	105	1365	ENST00000383781.8	360	1620	++	55	Q9Y215-1#12	0	3	ENST00000383781.8	408	411	+	3	0	0	4991
Q9Y215-1#13	0	3	3	Q9Y215-1	276	279	+	3	Q9Y215-1	0	813	ENST00000681097.1	91	904	++	274	Q9Y215-1#13	0	3	ENST00000681097.1	367	370	+	3	0	0	4992
Q9Y215-1#13	0	3	3	Q9Y215-1	276	279	+	3	Q9Y215-1	0	1365	ENST00000603808.5	126	1494	+	227	Q9Y215-1#13	0	3	ENST00000603808.5	402	405	+	3	0	0	4993
Q9Y215-1#13	0	3	3	Q9Y215-1	276	279	+	3	Q9Y215-1	0	1365	ENST00000383788.10	81	1446	++	57	Q9Y215-1#13	0	3	ENST00000383788.10	357	360	+	3	0	0	4994
Q9Y215-1#13	0	3	3	Q9Y215-1	276	279	+	3	Q9Y215-1	105	1365	ENST00000383781.8	360	1620	++	55	Q9Y215-1#13	0	3	ENST00000383781.8	531	534	+	3	0	0	4995
Q9Y215-1#14	0	3	3	Q9Y215-1	870	873	+	3	Q9Y215-1	0	1365	ENST00000603808.5	126	1494	+	227	Q9Y215-1#14	0	3	ENST00000603808.5	996	999	+	3	0	0	4996
Q9Y215-1#14	0	3	3	Q9Y215-1	870	873	+	3	Q9Y215-1	0	1365	ENST00000383788.10	81	1446	++	57	Q9Y215-1#14	0	3	ENST00000383788.10	951	954	+	3	0	0	4997
Q9Y215-1#14	0	3	3	Q9Y215-1	870	873	+	3	Q9Y215-1	0	1365	ENST00000383786.9	111	1374	++	56	Q9Y215-1#14	0	3	ENST00000383786.9	879	882	+	3	0	0	4998
Q9Y215-1#14	0	3	3	Q9Y215-1	870	873	+	3	Q9Y215-1	105	1365	ENST00000383781.8	360	1620	++	55	Q9Y215-1#14	0	3	ENST00000383781.8	1125	1128	+	3	0	0	4999
Q9Y215-1#15	0	3	3	Q9Y215-1	876	879	+	3	Q9Y215-1	0	1365	ENST00000603808.5	126	1494	+	227	Q9Y215-1#15	0	3	ENST00000603808.5	1002	1005	+	3	0	0	5000
Q9Y215-1#15	0	3	3	Q9Y215-1	876	879	+	3	Q9Y215-1	0	1365	ENST00000383788.10	81	1446	++	57	Q9Y215-1#15	0	3	ENST00000383788.10	957	960	+	3	0	0	5001
Q9Y215-1#15	0	3	3	Q9Y215-1	876	879	+	3	Q9Y215-1	0	1365	ENST00000383786.9	111	1374	++	56	Q9Y215-1#15	0	3	ENST00000383786.9	885	888	+	3	0	0	5002
Q9Y215-1#15	0	3	3	Q9Y215-1	876	879	+	3	Q9Y215-1	105	1365	ENST00000383781.8	360	1620	++	55	Q9Y215-1#15	0	3	ENST00000383781.8	1131	1134	+	3	0	0	5003
Q9Y215-1#16	0	105	105	Q9Y215-1	0	105	+	105	Q9Y215-1	0	813	ENST00000681097.1	91	904	++	274	Q9Y215-1#16	0	105	ENST00000681097.1	91	196	+	105	0	0	5004
Q9Y215-1#16	0	105	105	Q9Y215-1	0	105	+	105	Q9Y215-1	0	238	ENST00000679838.1	95	320	+	273	Q9Y215-1#16	0	105	ENST00000679838.1	95	200	+	105	0	0	5005
Q9Y215-1#16	0	105	105	Q9Y215-1	0	105	+	105	Q9Y215-1	0	1365	ENST00000603808.5	126	1494	+	227	Q9Y215-1#16	0	105	ENST00000603808.5	126	231	+	105	0	0	5006
Q9Y215-1#16	0	105	105	Q9Y215-1	0	105	+	105	Q9Y215-1	0	1365	ENST00000383788.10	81	1446	++	57	Q9Y215-1#16	0	105	ENST00000383788.10	81	186	+	105	0	0	5007
Q9Y215-1#16	0	105	105	Q9Y215-1	0	105	+	105	Q9Y215-1	0	1365	ENST00000383786.9	111	1374	++	56	Q9Y215-1#16	0	105	ENST00000383786.9	111	216	+	105	0	0	5008
Q9Y215-1#17	0	12	12	Q9Y215-1	216	228	+	12	Q9Y215-1	0	813	ENST00000681097.1	91	904	++	274	Q9Y215-1#17	0	12	ENST00000681097.1	307	319	+	12	0	0	5009
Q9Y215-1#17	0	12	12	Q9Y215-1	216	228	+	12	Q9Y215-1	0	238	ENST00000679838.1	95	320	+	273	Q9Y215-1#17	0	3	ENST00000679838.1	311	314	+	3	0	9	5010
Q9Y215-1#17	0	12	12	Q9Y215-1	216	228	+	12	Q9Y215-1	105	753	ENST00000605797.1	36	582	+	228	Q9Y215-1#17	0	3	ENST00000605797.1	147	150	+	3	0	9	5011
Q9Y215-1#17	0	12	12	Q9Y215-1	216	228	+	12	Q9Y215-1	0	1365	ENST00000603808.5	126	1494	+	227	Q9Y215-1#17	0	12	ENST00000603808.5	342	354	+	12	0	0	5012
Q9Y215-1#17	0	12	12	Q9Y215-1	216	228	+	12	Q9Y215-1	0	1365	ENST00000383788.10	81	1446	++	57	Q9Y215-1#17	0	12	ENST00000383788.10	297	309	+	12	0	0	5013
Q9Y215-1#17	0	12	12	Q9Y215-1	216	228	+	12	Q9Y215-1	0	1365	ENST00000383786.9	111	1374	++	56	Q9Y215-1#17	0	3	ENST00000383786.9	327	330	+	3	0	9	5014
Q9Y215-1#17	0	12	12	Q9Y215-1	216	228	+	12	Q9Y215-1	105	1365	ENST00000383781.8	360	1620	++	55	Q9Y215-1#17	0	12	ENST00000383781.8	471	483	+	12	0	0	5015
Q9Y215-1#18	0	102	102	Q9Y215-1	219	321	+	102	Q9Y215-1	0	813	ENST00000681097.1	91	904	++	274	Q9Y215-1#18	0	102	ENST00000681097.1	310	412	+	102	0	0	5016
Q9Y215-1#18	0	102	102	Q9Y215-1	219	321	+	102	Q9Y215-1	0	238	ENST00000679838.1	95	320	+	273	Q9Y215-1#18	13	19	ENST00000679838.1	314	320	+	6	13	83	5017
Q9Y215-1#18	0	102	102	Q9Y215-1	219	321	+	102	Q9Y215-1	0	1365	ENST00000603808.5	126	1494	+	227	Q9Y215-1#18	0	102	ENST00000603808.5	345	447	+	102	0	0	5018
Q9Y215-1#18	0	102	102	Q9Y215-1	219	321	+	102	Q9Y215-1	0	1365	ENST00000383788.10	81	1446	++	57	Q9Y215-1#18	0	102	ENST00000383788.10	300	402	+	102	0	0	5019
Q9Y215-1#18	0	102	102	Q9Y215-1	219	321	+	102	Q9Y215-1	105	1365	ENST00000383781.8	360	1620	++	55	Q9Y215-1#18	0	102	ENST00000383781.8	474	576	+	102	0	0	5020
Q9Y215-1#19	0	27	27	Q9Y215-1	369	396	+	27	Q9Y215-1	0	813	ENST00000681097.1	91	904	++	274	Q9Y215-1#19	0	27	ENST00000681097.1	460	487	+	27	0	0	5021
Q9Y215-1#19	0	27	27	Q9Y215-1	369	396	+	27	Q9Y215-1	105	753	ENST00000605797.1	36	582	+	228	Q9Y215-1#19	0	27	ENST00000605797.1	198	225	+	27	0	0	5022
Q9Y215-1#19	0	27	27	Q9Y215-1	369	396	+	27	Q9Y215-1	0	1365	ENST00000603808.5	126	1494	+	227	Q9Y215-1#19	0	27	ENST00000603808.5	495	522	+	27	0	0	5023
Q9Y215-1#19	0	27	27	Q9Y215-1	369	396	+	27	Q9Y215-1	0	1365	ENST00000383788.10	81	1446	++	57	Q9Y215-1#19	0	27	ENST00000383788.10	450	477	+	27	0	0	5024
Q9Y215-1#19	0	27	27	Q9Y215-1	369	396	+	27	Q9Y215-1	0	1365	ENST00000383786.9	111	1374	++	56	Q9Y215-1#19	0	27	ENST00000383786.9	378	405	+	27	0	0	5025
Q9Y215-1#19	0	27	27	Q9Y215-1	369	396	+	27	Q9Y215-1	105	1365	ENST00000383781.8	360	1620	++	55	Q9Y215-1#19	0	27	ENST00000383781.8	624	651	+	27	0	0	5026
Q9Y215-1#20	0	156	156	Q9Y215-1	717	873	+	156	Q9Y215-1	0	813	ENST00000681097.1	91	904	++	274	Q9Y215-1#20	0	96	ENST00000681097.1	808	904	+	96	0	60	5027
Q9Y215-1#20	0	156	156	Q9Y215-1	717	873	+	156	Q9Y215-1	105	753	ENST00000605797.1	36	582	+	228	Q9Y215-1#20	0	36	ENST00000605797.1	546	582	+	36	0	120	5028
Q9Y215-1#20	0	156	156	Q9Y215-1	717	873	+	156	Q9Y215-1	0	1365	ENST00000603808.5	126	1494	+	227	Q9Y215-1#20	0	156	ENST00000603808.5	843	999	+	156	0	0	5029
Q9Y215-1#20	0	156	156	Q9Y215-1	717	873	+	156	Q9Y215-1	0	1365	ENST00000383788.10	81	1446	++	57	Q9Y215-1#20	0	156	ENST00000383788.10	798	954	+	156	0	0	5030
Q9Y215-1#20	0	156	156	Q9Y215-1	717	873	+	156	Q9Y215-1	0	1365	ENST00000383786.9	111	1374	++	56	Q9Y215-1#20	0	156	ENST00000383786.9	726	882	+	156	0	0	5031
Q9Y215-1#20	0	156	156	Q9Y215-1	717	873	+	156	Q9Y215-1	105	1365	ENST00000383781.8	360	1620	++	55	Q9Y215-1#20	0	156	ENST00000383781.8	972	1128	+	156	0	0	5032
Q9Y215-1#21	0	30	30	Q9Y215-1	813	843	+	30	Q9Y215-1	0	1365	ENST00000603808.5	126	1494	+	227	Q9Y215-1#21	0	30	ENST00000603808.5	939	969	+	30	0	0	5033
Q9Y215-1#21	0	30	30	Q9Y215-1	813	843	+	30	Q9Y215-1	0	1365	ENST00000383788.10	81	1446	++	57	Q9Y215-1#21	0	30	ENST00000383788.10	894	924	+	30	0	0	5034
Q9Y215-1#21	0	30	30	Q9Y215-1	813	843	+	30	Q9Y215-1	0	1365	ENST00000383786.9	111	1374	++	56	Q9Y215-1#21	0	30	ENST00000383786.9	822	852	+	30	0	0	5035
Q9Y215-1#21	0	30	30	Q9Y215-1	813	843	+	30	Q9Y215-1	105	1365	ENST00000383781.8	360	1620	++	55	Q9Y215-1#21	0	30	ENST00000383781.8	1068	1098	+	30	0	0	5036
Q9Y215-1#22	0	171	171	Q9Y215-1	816	987	+	171	Q9Y215-1	0	1365	ENST00000603808.5	126	1494	+	227	Q9Y215-1#22	0	171	ENST00000603808.5	942	1113	+	171	0	0	5037
Q9Y215-1#22	0	171	171	Q9Y215-1	816	987	+	171	Q9Y215-1	0	1365	ENST00000383788.10	81	1446	++	57	Q9Y215-1#22	0	171	ENST00000383788.10	897	1068	+	171	0	0	5038
Q9Y215-1#22	0	171	171	Q9Y215-1	816	987	+	171	Q9Y215-1	0	1365	ENST00000383786.9	111	1374	++	56	Q9Y215-1#22	0	171	ENST00000383786.9	825	996	+	171	0	0	5039
Q9Y215-1#22	0	171	171	Q9Y215-1	816	987	+	171	Q9Y215-1	105	1365	ENST00000383781.8	360	1620	++	55	Q9Y215-1#22	0	171	ENST00000383781.8	1071	1242	+	171	0	0	5040
Q9Y215-1#23	0	522	522	Q9Y215-1	843	1365	+	522	Q9Y215-1	0	1365	ENST00000603808.5	126	1494	+	227	Q9Y215-1#23	0	522	ENST00000603808.5	969	1494	+	521	0	0	5041
Q9Y215-1#23	0	522	522	Q9Y215-1	843	1365	+	522	Q9Y215-1	0	1365	ENST00000383788.10	81	1446	++	57	Q9Y215-1#23	0	522	ENST00000383788.10	924	1446	+	522	0	0	5042
Q9Y215-1#23	0	522	522	Q9Y215-1	843	1365	+	522	Q9Y215-1	0	1365	ENST00000383786.9	111	1374	++	56	Q9Y215-1#23	0	522	ENST00000383786.9	852	1374	+	522	0	0	5043
Q9Y215-1#23	0	522	522	Q9Y215-1	843	1365	+	522	Q9Y215-1	105	1365	ENST00000383781.8	360	1620	++	55	Q9Y215-1#23	0	522	ENST00000383781.8	1098	1620	+	522	0	0	5044
Q9Y215-1#24	0	492	492	Q9Y215-1	873	1365	+	492	Q9Y215-1	0	1365	ENST00000603808.5	126	1494	+	227	Q9Y215-1#24	0	492	ENST00000603808.5	999	1494	+	491	0	0	5045
Q9Y215-1#24	0	492	492	Q9Y215-1	873	1365	+	492	Q9Y215-1	0	1365	ENST00000383788.10	81	1446	++	57	Q9Y215-1#24	0	492	ENST00000383788.10	954	1446	+	492	0	0	5046
Q9Y215-1#24	0	492	492	Q9Y215-1	873	1365	+	492	Q9Y215-1	0	1365	ENST00000383786.9	111	1374	++	56	Q9Y215-1#24	0	492	ENST00000383786.9	882	1374	+	492	0	0	5047
Q9Y215-1#24	0	492	492	Q9Y215-1	873	1365	+	492	Q9Y215-1	105	1365	ENST00000383781.8	360	1620	++	55	Q9Y215-1#24	0	492	ENST00000383781.8	1128	1620	+	492	0	0	5048
Q9Y215-1#25	0	378	378	Q9Y215-1	987	1365	+	378	Q9Y215-1	0	1365	ENST00000603808.5	126	1494	+	227	Q9Y215-1#25	0	378	ENST00000603808.5	1113	1494	+	377	0	0	5049
Q9Y215-1#25	0	378	378	Q9Y215-1	987	1365	+	378	Q9Y215-1	0	1365	ENST00000383788.10	81	1446	++	57	Q9Y215-1#25	0	378	ENST00000383788.10	1068	1446	+	378	0	0	5050
Q9Y215-1#25	0	378	378	Q9Y215-1	987	1365	+	378	Q9Y215-1	0	1365	ENST00000383786.9	111	1374	++	56	Q9Y215-1#25	0	378	ENST00000383786.9	996	1374	+	378	0	0	5051
Q9Y215-1#25	0	378	378	Q9Y215-1	987	1365	+	378	Q9Y215-1	105	1365	ENST00000383781.8	360	1620	++	55	Q9Y215-1#25	0	378	ENST00000383781.8	1242	1620	+	378	0	0	5052
Q9Y215-1#26	0	3	3	Q9Y215-1	174	177	+	3	Q9Y215-1	0	813	ENST00000681097.1	91	904	++	274	Q9Y215-1#26	0	3	ENST00000681097.1	265	268	+	3	0	0	5053
Q9Y215-1#26	0	3	3	Q9Y215-1	174	177	+	3	Q9Y215-1	0	238	ENST00000679838.1	95	320	+	273	Q9Y215-1#26	0	3	ENST00000679838.1	269	272	+	3	0	0	5054
Q9Y215-1#26	0	3	3	Q9Y215-1	174	177	+	3	Q9Y215-1	105	753	ENST00000605797.1	36	582	+	228	Q9Y215-1#26	0	3	ENST00000605797.1	105	108	+	3	0	0	5055
Q9Y215-1#26	0	3	3	Q9Y215-1	174	177	+	3	Q9Y215-1	0	1365	ENST00000603808.5	126	1494	+	227	Q9Y215-1#26	0	3	ENST00000603808.5	300	303	+	3	0	0	5056
Q9Y215-1#26	0	3	3	Q9Y215-1	174	177	+	3	Q9Y215-1	0	1365	ENST00000383788.10	81	1446	++	57	Q9Y215-1#26	0	3	ENST00000383788.10	255	258	+	3	0	0	5057
Q9Y215-1#26	0	3	3	Q9Y215-1	174	177	+	3	Q9Y215-1	0	1365	ENST00000383786.9	111	1374	++	56	Q9Y215-1#26	0	3	ENST00000383786.9	285	288	+	3	0	0	5058
Q9Y215-1#26	0	3	3	Q9Y215-1	174	177	+	3	Q9Y215-1	105	1365	ENST00000383781.8	360	1620	++	55	Q9Y215-1#26	0	3	ENST00000383781.8	429	432	+	3	0	0	5059
Q9Y215-1#27	0	3	3	Q9Y215-1	933	936	+	3	Q9Y215-1	0	1365	ENST00000603808.5	126	1494	+	227	Q9Y215-1#27	0	3	ENST00000603808.5	1059	1062	+	3	0	0	5060
Q9Y215-1#27	0	3	3	Q9Y215-1	933	936	+	3	Q9Y215-1	0	1365	ENST00000383788.10	81	1446	++	57	Q9Y215-1#27	0	3	ENST00000383788.10	1014	1017	+	3	0	0	5061
Q9Y215-1#27	0	3	3	Q9Y215-1	933	936	+	3	Q9Y215-1	0	1365	ENST00000383786.9	111	1374	++	56	Q9Y215-1#27	0	3	ENST00000383786.9	942	945	+	3	0	0	5062
Q9Y215-1#27	0	3	3	Q9Y215-1	933	936	+	3	Q9Y215-1	105	1365	ENST00000383781.8	360	1620	++	55	Q9Y215-1#27	0	3	ENST00000383781.8	1188	1191	+	3	0	0	5063
Q9Y215-1#28	0	3	3	Q9Y215-1	1008	1011	+	3	Q9Y215-1	0	1365	ENST00000603808.5	126	1494	+	227	Q9Y215-1#28	0	3	ENST00000603808.5	1134	1137	+	3	0	0	5064
Q9Y215-1#28	0	3	3	Q9Y215-1	1008	1011	+	3	Q9Y215-1	0	1365	ENST00000383788.10	81	1446	++	57	Q9Y215-1#28	0	3	ENST00000383788.10	1089	1092	+	3	0	0	5065
Q9Y215-1#28	0	3	3	Q9Y215-1	1008	1011	+	3	Q9Y215-1	0	1365	ENST00000383786.9	111	1374	++	56	Q9Y215-1#28	0	3	ENST00000383786.9	1017	1020	+	3	0	0	5066
Q9Y215-1#28	0	3	3	Q9Y215-1	1008	1011	+	3	Q9Y215-1	105	1365	ENST00000383781.8	360	1620	++	55	Q9Y215-1#28	0	3	ENST00000383781.8	1263	1266	+	3	0	0	5067
Q9Y215-1#29	0	3	3	Q9Y215-1	1023	1026	+	3	Q9Y215-1	0	1365	ENST00000603808.5	126	1494	+	227	Q9Y215-1#29	0	3	ENST00000603808.5	1149	1152	+	3	0	0	5068
Q9Y215-1#29	0	3	3	Q9Y215-1	1023	1026	+	3	Q9Y215-1	0	1365	ENST00000383788.10	81	1446	++	57	Q9Y215-1#29	0	3	ENST00000383788.10	1104	1107	+	3	0	0	5069
Q9Y215-1#29	0	3	3	Q9Y215-1	1023	1026	+	3	Q9Y215-1	0	1365	ENST00000383786.9	111	1374	++	56	Q9Y215-1#29	0	3	ENST00000383786.9	1032	1035	+	3	0	0	5070
Q9Y215-1#29	0	3	3	Q9Y215-1	1023	1026	+	3	Q9Y215-1	105	1365	ENST00000383781.8	360	1620	++	55	Q9Y215-1#29	0	3	ENST00000383781.8	1278	1281	+	3	0	0	5071
Q9Y215-1#30	0	3	3	Q9Y215-1	1227	1230	+	3	Q9Y215-1	0	1365	ENST00000603808.5	126	1494	+	227	Q9Y215-1#30	0	3	ENST00000603808.5	1356	1359	+	3	0	0	5072
Q9Y215-1#30	0	3	3	Q9Y215-1	1227	1230	+	3	Q9Y215-1	0	1365	ENST00000383788.10	81	1446	++	57	Q9Y215-1#30	0	3	ENST00000383788.10	1308	1311	+	3	0	0	5073
Q9Y215-1#30	0	3	3	Q9Y215-1	1227	1230	+	3	Q9Y215-1	0	1365	ENST00000383786.9	111	1374	++	56	Q9Y215-1#30	0	3	ENST00000383786.9	1236	1239	+	3	0	0	5074
Q9Y215-1#30	0	3	3	Q9Y215-1	1227	1230	+	3	Q9Y215-1	105	1365	ENST00000383781.8	360	1620	++	55	Q9Y215-1#30	0	3	ENST00000383781.8	1482	1485	+	3	0	0	5075
Q9Y215-1#31	0	3	3	Q9Y215-1	1287	1290	+	3	Q9Y215-1	0	1365	ENST00000603808.5	126	1494	+	227	Q9Y215-1#31	0	3	ENST00000603808.5	1416	1419	+	3	0	0	5076
Q9Y215-1#31	0	3	3	Q9Y215-1	1287	1290	+	3	Q9Y215-1	0	1365	ENST00000383788.10	81	1446	++	57	Q9Y215-1#31	0	3	ENST00000383788.10	1368	1371	+	3	0	0	5077
Q9Y215-1#31	0	3	3	Q9Y215-1	1287	1290	+	3	Q9Y215-1	0	1365	ENST00000383786.9	111	1374	++	56	Q9Y215-1#31	0	3	ENST00000383786.9	1296	1299	+	3	0	0	5078
Q9Y215-1#31	0	3	3	Q9Y215-1	1287	1290	+	3	Q9Y215-1	105	1365	ENST00000383781.8	360	1620	++	55	Q9Y215-1#31	0	3	ENST00000383781.8	1542	1545	+	3	0	0	5079
Q9Y215-1#32	0	3	3	Q9Y215-1	1329	1332	+	3	Q9Y215-1	0	1365	ENST00000603808.5	126	1494	+	227	Q9Y215-1#32	0	3	ENST00000603808.5	1458	1461	+	3	0	0	5080
Q9Y215-1#32	0	3	3	Q9Y215-1	1329	1332	+	3	Q9Y215-1	0	1365	ENST00000383788.10	81	1446	++	57	Q9Y215-1#32	0	3	ENST00000383788.10	1410	1413	+	3	0	0	5081
Q9Y215-1#32	0	3	3	Q9Y215-1	1329	1332	+	3	Q9Y215-1	0	1365	ENST00000383786.9	111	1374	++	56	Q9Y215-1#32	0	3	ENST00000383786.9	1338	1341	+	3	0	0	5082
Q9Y215-1#32	0	3	3	Q9Y215-1	1329	1332	+	3	Q9Y215-1	105	1365	ENST00000383781.8	360	1620	++	55	Q9Y215-1#32	0	3	ENST00000383781.8	1584	1587	+	3	0	0	5083
Q9Y215-1#33	0	3	3	Q9Y215-1	1107	1110	+	3	Q9Y215-1	0	1365	ENST00000603808.5	126	1494	+	227	Q9Y215-1#33	0	3	ENST00000603808.5	1233	1236	+	3	0	0	5084
Q9Y215-1#33	0	3	3	Q9Y215-1	1107	1110	+	3	Q9Y215-1	0	1365	ENST00000383788.10	81	1446	++	57	Q9Y215-1#33	0	3	ENST00000383788.10	1188	1191	+	3	0	0	5085
Q9Y215-1#33	0	3	3	Q9Y215-1	1107	1110	+	3	Q9Y215-1	0	1365	ENST00000383786.9	111	1374	++	56	Q9Y215-1#33	0	3	ENST00000383786.9	1116	1119	+	3	0	0	5086
Q9Y215-1#33	0	3	3	Q9Y215-1	1107	1110	+	3	Q9Y215-1	105	1365	ENST00000383781.8	360	1620	++	55	Q9Y215-1#33	0	3	ENST00000383781.8	1362	1365	+	3	0	0	5087
Q9Y215-1#34	0	3	3	Q9Y215-1	1194	1197	+	3	Q9Y215-1	0	1365	ENST00000603808.5	126	1494	+	227	Q9Y215-1#34	0	3	ENST00000603808.5	1320	1326	+	2	0	0	5088
Q9Y215-1#34	0	3	3	Q9Y215-1	1194	1197	+	3	Q9Y215-1	0	1365	ENST00000383788.10	81	1446	++	57	Q9Y215-1#34	0	3	ENST00000383788.10	1275	1278	+	3	0	0	5089
Q9Y215-1#34	0	3	3	Q9Y215-1	1194	1197	+	3	Q9Y215-1	0	1365	ENST00000383786.9	111	1374	++	56	Q9Y215-1#34	0	3	ENST00000383786.9	1203	1206	+	3	0	0	5090
Q9Y215-1#34	0	3	3	Q9Y215-1	1194	1197	+	3	Q9Y215-1	105	1365	ENST00000383781.8	360	1620	++	55	Q9Y215-1#34	0	3	ENST00000383781.8	1449	1452	+	3	0	0	5091
Q9Y215-1#35	0	3	3	Q9Y215-1	1197	1200	+	3	Q9Y215-1	0	1365	ENST00000603808.5	126	1494	+	227	Q9Y215-1#35	0	3	ENST00000603808.5	1326	1329	+	3	0	0	5092
Q9Y215-1#35	0	3	3	Q9Y215-1	1197	1200	+	3	Q9Y215-1	0	1365	ENST00000383788.10	81	1446	++	57	Q9Y215-1#35	0	3	ENST00000383788.10	1278	1281	+	3	0	0	5093
Q9Y215-1#35	0	3	3	Q9Y215-1	1197	1200	+	3	Q9Y215-1	0	1365	ENST00000383786.9	111	1374	++	56	Q9Y215-1#35	0	3	ENST00000383786.9	1206	1209	+	3	0	0	5094
Q9Y215-1#35	0	3	3	Q9Y215-1	1197	1200	+	3	Q9Y215-1	105	1365	ENST00000383781.8	360	1620	++	55	Q9Y215-1#35	0	3	ENST00000383781.8	1452	1455	+	3	0	0	5095
Q9Y215-1#36	0	3	3	Q9Y215-1	1209	1212	+	3	Q9Y215-1	0	1365	ENST00000603808.5	126	1494	+	227	Q9Y215-1#36	0	3	ENST00000603808.5	1338	1341	+	3	0	0	5096
Q9Y215-1#36	0	3	3	Q9Y215-1	1209	1212	+	3	Q9Y215-1	0	1365	ENST00000383788.10	81	1446	++	57	Q9Y215-1#36	0	3	ENST00000383788.10	1290	1293	+	3	0	0	5097
Q9Y215-1#36	0	3	3	Q9Y215-1	1209	1212	+	3	Q9Y215-1	0	1365	ENST00000383786.9	111	1374	++	56	Q9Y215-1#36	0	3	ENST00000383786.9	1218	1221	+	3	0	0	5098
Q9Y215-1#36	0	3	3	Q9Y215-1	1209	1212	+	3	Q9Y215-1	105	1365	ENST00000383781.8	360	1620	++	55	Q9Y215-1#36	0	3	ENST00000383781.8	1464	1467	+	3	0	0	5099
Q9Y215-1#37	0	3	3	Q9Y215-1	1266	1269	+	3	Q9Y215-1	0	1365	ENST00000603808.5	126	1494	+	227	Q9Y215-1#37	0	3	ENST00000603808.5	1395	1398	+	3	0	0	5100
Q9Y215-1#37	0	3	3	Q9Y215-1	1266	1269	+	3	Q9Y215-1	0	1365	ENST00000383788.10	81	1446	++	57	Q9Y215-1#37	0	3	ENST00000383788.10	1347	1350	+	3	0	0	5101
Q9Y215-1#37	0	3	3	Q9Y215-1	1266	1269	+	3	Q9Y215-1	0	1365	ENST00000383786.9	111	1374	++	56	Q9Y215-1#37	0	3	ENST00000383786.9	1275	1278	+	3	0	0	5102
Q9Y215-1#37	0	3	3	Q9Y215-1	1266	1269	+	3	Q9Y215-1	105	1365	ENST00000383781.8	360	1620	++	55	Q9Y215-1#37	0	3	ENST00000383781.8	1521	1524	+	3	0	0	5103
Q6PF04-1#0	0	1851	1851	Q6PF04-1	0	1851	+	1851	Q6PF04-1	1001	1620	ENST00000601794.1	0	619	+	225	Q6PF04-1#0	1001	1620	ENST00000601794.1	0	619	+	619	1001	231	5104
Q6PF04-1#0	0	1851	1851	Q6PF04-1	0	1851	+	1851	Q6PF04-1	0	282	ENST00000600853.1	260	542	+	221	Q6PF04-1#0	0	282	ENST00000600853.1	260	542	+	282	0	1569	5105
Q6PF04-1#0	0	1851	1851	Q6PF04-1	0	1851	+	1851	Q6PF04-1	108	363	ENST00000599683.5	351	606	+	217	Q6PF04-1#0	108	363	ENST00000599683.5	351	606	+	255	108	1488	5106
Q6PF04-1#0	0	1851	1851	Q6PF04-1	0	1851	+	1851	Q6PF04-1	108	1851	ENST00000391794.8	464	2207	++	59	Q6PF04-1#0	108	1851	ENST00000391794.8	464	2207	+	1743	108	0	5107
Q6PF04-1#0	0	1851	1851	Q6PF04-1	0	1851	+	1851	Q6PF04-1	0	1851	ENST00000293471.11	427	2278	++	17	Q6PF04-1#0	0	1851	ENST00000293471.11	427	2278	+	1851	0	0	5108
Q6PF04-1#1	0	213	213	Q6PF04-1	21	234	+	213	Q6PF04-1	0	282	ENST00000600853.1	260	542	+	221	Q6PF04-1#1	0	213	ENST00000600853.1	281	494	+	213	0	0	5109
Q6PF04-1#1	0	213	213	Q6PF04-1	21	234	+	213	Q6PF04-1	108	363	ENST00000599683.5	351	606	+	217	Q6PF04-1#1	87	213	ENST00000599683.5	351	477	+	126	87	0	5110
Q6PF04-1#1	0	213	213	Q6PF04-1	21	234	+	213	Q6PF04-1	108	1851	ENST00000391794.8	464	2207	++	59	Q6PF04-1#1	87	213	ENST00000391794.8	464	590	+	126	87	0	5111
Q6PF04-1#1	0	213	213	Q6PF04-1	21	234	+	213	Q6PF04-1	0	1851	ENST00000293471.11	427	2278	++	17	Q6PF04-1#1	0	213	ENST00000293471.11	448	661	+	213	0	0	5112
Q6PF04-1#2	0	69	69	Q6PF04-1	609	678	+	69	Q6PF04-1	108	1851	ENST00000391794.8	464	2207	++	59	Q6PF04-1#2	0	69	ENST00000391794.8	965	1034	+	69	0	0	5113
Q6PF04-1#2	0	69	69	Q6PF04-1	609	678	+	69	Q6PF04-1	0	1851	ENST00000293471.11	427	2278	++	17	Q6PF04-1#2	0	69	ENST00000293471.11	1036	1105	+	69	0	0	5114
Q6PF04-1#3	0	69	69	Q6PF04-1	693	762	+	69	Q6PF04-1	108	1851	ENST00000391794.8	464	2207	++	59	Q6PF04-1#3	0	69	ENST00000391794.8	1049	1118	+	69	0	0	5115
Q6PF04-1#3	0	69	69	Q6PF04-1	693	762	+	69	Q6PF04-1	0	1851	ENST00000293471.11	427	2278	++	17	Q6PF04-1#3	0	69	ENST00000293471.11	1120	1189	+	69	0	0	5116
Q6PF04-1#4	0	69	69	Q6PF04-1	777	846	+	69	Q6PF04-1	108	1851	ENST00000391794.8	464	2207	++	59	Q6PF04-1#4	0	69	ENST00000391794.8	1133	1202	+	69	0	0	5117
Q6PF04-1#4	0	69	69	Q6PF04-1	777	846	+	69	Q6PF04-1	0	1851	ENST00000293471.11	427	2278	++	17	Q6PF04-1#4	0	69	ENST00000293471.11	1204	1273	+	69	0	0	5118
Q6PF04-1#5	0	69	69	Q6PF04-1	861	930	+	69	Q6PF04-1	108	1851	ENST00000391794.8	464	2207	++	59	Q6PF04-1#5	0	69	ENST00000391794.8	1217	1286	+	69	0	0	5119
Q6PF04-1#5	0	69	69	Q6PF04-1	861	930	+	69	Q6PF04-1	0	1851	ENST00000293471.11	427	2278	++	17	Q6PF04-1#5	0	69	ENST00000293471.11	1288	1357	+	69	0	0	5120
Q6PF04-1#6	0	69	69	Q6PF04-1	945	1014	+	69	Q6PF04-1	1001	1620	ENST00000601794.1	0	619	+	225	Q6PF04-1#6	56	69	ENST00000601794.1	0	13	+	13	56	0	5121
Q6PF04-1#6	0	69	69	Q6PF04-1	945	1014	+	69	Q6PF04-1	108	1851	ENST00000391794.8	464	2207	++	59	Q6PF04-1#6	0	69	ENST00000391794.8	1301	1370	+	69	0	0	5122
Q6PF04-1#6	0	69	69	Q6PF04-1	945	1014	+	69	Q6PF04-1	0	1851	ENST00000293471.11	427	2278	++	17	Q6PF04-1#6	0	69	ENST00000293471.11	1372	1441	+	69	0	0	5123
Q6PF04-1#7	0	69	69	Q6PF04-1	1029	1098	+	69	Q6PF04-1	1001	1620	ENST00000601794.1	0	619	+	225	Q6PF04-1#7	0	69	ENST00000601794.1	28	97	+	69	0	0	5124
Q6PF04-1#7	0	69	69	Q6PF04-1	1029	1098	+	69	Q6PF04-1	108	1851	ENST00000391794.8	464	2207	++	59	Q6PF04-1#7	0	69	ENST00000391794.8	1385	1454	+	69	0	0	5125
Q6PF04-1#7	0	69	69	Q6PF04-1	1029	1098	+	69	Q6PF04-1	0	1851	ENST00000293471.11	427	2278	++	17	Q6PF04-1#7	0	69	ENST00000293471.11	1456	1525	+	69	0	0	5126
Q6PF04-1#8	0	69	69	Q6PF04-1	1113	1182	+	69	Q6PF04-1	1001	1620	ENST00000601794.1	0	619	+	225	Q6PF04-1#8	0	69	ENST00000601794.1	112	181	+	69	0	0	5127
Q6PF04-1#8	0	69	69	Q6PF04-1	1113	1182	+	69	Q6PF04-1	108	1851	ENST00000391794.8	464	2207	++	59	Q6PF04-1#8	0	69	ENST00000391794.8	1469	1538	+	69	0	0	5128
Q6PF04-1#8	0	69	69	Q6PF04-1	1113	1182	+	69	Q6PF04-1	0	1851	ENST00000293471.11	427	2278	++	17	Q6PF04-1#8	0	69	ENST00000293471.11	1540	1609	+	69	0	0	5129
Q6PF04-1#9	0	69	69	Q6PF04-1	1197	1266	+	69	Q6PF04-1	1001	1620	ENST00000601794.1	0	619	+	225	Q6PF04-1#9	0	69	ENST00000601794.1	196	265	+	69	0	0	5130
Q6PF04-1#9	0	69	69	Q6PF04-1	1197	1266	+	69	Q6PF04-1	108	1851	ENST00000391794.8	464	2207	++	59	Q6PF04-1#9	0	69	ENST00000391794.8	1553	1622	+	69	0	0	5131
Q6PF04-1#9	0	69	69	Q6PF04-1	1197	1266	+	69	Q6PF04-1	0	1851	ENST00000293471.11	427	2278	++	17	Q6PF04-1#9	0	69	ENST00000293471.11	1624	1693	+	69	0	0	5132
Q6PF04-1#10	0	69	69	Q6PF04-1	1281	1350	+	69	Q6PF04-1	1001	1620	ENST00000601794.1	0	619	+	225	Q6PF04-1#10	0	69	ENST00000601794.1	280	349	+	69	0	0	5133
Q6PF04-1#10	0	69	69	Q6PF04-1	1281	1350	+	69	Q6PF04-1	108	1851	ENST00000391794.8	464	2207	++	59	Q6PF04-1#10	0	69	ENST00000391794.8	1637	1706	+	69	0	0	5134
Q6PF04-1#10	0	69	69	Q6PF04-1	1281	1350	+	69	Q6PF04-1	0	1851	ENST00000293471.11	427	2278	++	17	Q6PF04-1#10	0	69	ENST00000293471.11	1708	1777	+	69	0	0	5135
Q6PF04-1#11	0	69	69	Q6PF04-1	1365	1434	+	69	Q6PF04-1	1001	1620	ENST00000601794.1	0	619	+	225	Q6PF04-1#11	0	69	ENST00000601794.1	364	433	+	69	0	0	5136
Q6PF04-1#11	0	69	69	Q6PF04-1	1365	1434	+	69	Q6PF04-1	108	1851	ENST00000391794.8	464	2207	++	59	Q6PF04-1#11	0	69	ENST00000391794.8	1721	1790	+	69	0	0	5137
Q6PF04-1#11	0	69	69	Q6PF04-1	1365	1434	+	69	Q6PF04-1	0	1851	ENST00000293471.11	427	2278	++	17	Q6PF04-1#11	0	69	ENST00000293471.11	1792	1861	+	69	0	0	5138
Q6PF04-1#12	0	69	69	Q6PF04-1	1449	1518	+	69	Q6PF04-1	1001	1620	ENST00000601794.1	0	619	+	225	Q6PF04-1#12	0	69	ENST00000601794.1	448	517	+	69	0	0	5139
Q6PF04-1#12	0	69	69	Q6PF04-1	1449	1518	+	69	Q6PF04-1	108	1851	ENST00000391794.8	464	2207	++	59	Q6PF04-1#12	0	69	ENST00000391794.8	1805	1874	+	69	0	0	5140
Q6PF04-1#12	0	69	69	Q6PF04-1	1449	1518	+	69	Q6PF04-1	0	1851	ENST00000293471.11	427	2278	++	17	Q6PF04-1#12	0	69	ENST00000293471.11	1876	1945	+	69	0	0	5141
Q6PF04-1#13	0	72	72	Q6PF04-1	1533	1605	+	72	Q6PF04-1	1001	1620	ENST00000601794.1	0	619	+	225	Q6PF04-1#13	0	72	ENST00000601794.1	532	604	+	72	0	0	5142
Q6PF04-1#13	0	72	72	Q6PF04-1	1533	1605	+	72	Q6PF04-1	108	1851	ENST00000391794.8	464	2207	++	59	Q6PF04-1#13	0	72	ENST00000391794.8	1889	1961	+	72	0	0	5143
Q6PF04-1#13	0	72	72	Q6PF04-1	1533	1605	+	72	Q6PF04-1	0	1851	ENST00000293471.11	427	2278	++	17	Q6PF04-1#13	0	72	ENST00000293471.11	1960	2032	+	72	0	0	5144
Q6PF04-1#14	0	108	108	Q6PF04-1	0	108	+	108	Q6PF04-1	0	282	ENST00000600853.1	260	542	+	221	Q6PF04-1#14	0	108	ENST00000600853.1	260	368	+	108	0	0	5145
Q6PF04-1#14	0	108	108	Q6PF04-1	0	108	+	108	Q6PF04-1	0	1851	ENST00000293471.11	427	2278	++	17	Q6PF04-1#14	0	108	ENST00000293471.11	427	535	+	108	0	0	5146
Q6PF04-1#15	0	3	3	Q6PF04-1	249	252	+	3	Q6PF04-1	0	282	ENST00000600853.1	260	542	+	221	Q6PF04-1#15	0	3	ENST00000600853.1	509	512	+	3	0	0	5147
Q6PF04-1#15	0	3	3	Q6PF04-1	249	252	+	3	Q6PF04-1	108	363	ENST00000599683.5	351	606	+	217	Q6PF04-1#15	0	3	ENST00000599683.5	492	495	+	3	0	0	5148
Q6PF04-1#15	0	3	3	Q6PF04-1	249	252	+	3	Q6PF04-1	108	1851	ENST00000391794.8	464	2207	++	59	Q6PF04-1#15	0	3	ENST00000391794.8	605	608	+	3	0	0	5149
Q6PF04-1#15	0	3	3	Q6PF04-1	249	252	+	3	Q6PF04-1	0	1851	ENST00000293471.11	427	2278	++	17	Q6PF04-1#15	0	3	ENST00000293471.11	676	679	+	3	0	0	5150
Q6PF04-1#16	0	3	3	Q6PF04-1	276	279	+	3	Q6PF04-1	0	282	ENST00000600853.1	260	542	+	221	Q6PF04-1#16	0	3	ENST00000600853.1	536	539	+	3	0	0	5151
Q6PF04-1#16	0	3	3	Q6PF04-1	276	279	+	3	Q6PF04-1	108	363	ENST00000599683.5	351	606	+	217	Q6PF04-1#16	0	3	ENST00000599683.5	519	522	+	3	0	0	5152
Q6PF04-1#16	0	3	3	Q6PF04-1	276	279	+	3	Q6PF04-1	108	1851	ENST00000391794.8	464	2207	++	59	Q6PF04-1#16	0	3	ENST00000391794.8	632	635	+	3	0	0	5153
Q6PF04-1#16	0	3	3	Q6PF04-1	276	279	+	3	Q6PF04-1	0	1851	ENST00000293471.11	427	2278	++	17	Q6PF04-1#16	0	3	ENST00000293471.11	703	706	+	3	0	0	5154
Q6PF04-1#17	0	3	3	Q6PF04-1	402	405	+	3	Q6PF04-1	108	1851	ENST00000391794.8	464	2207	++	59	Q6PF04-1#17	0	3	ENST00000391794.8	758	761	+	3	0	0	5155
Q6PF04-1#17	0	3	3	Q6PF04-1	402	405	+	3	Q6PF04-1	0	1851	ENST00000293471.11	427	2278	++	17	Q6PF04-1#17	0	3	ENST00000293471.11	829	832	+	3	0	0	5156
Q6PF04-1#18	0	3	3	Q6PF04-1	486	489	+	3	Q6PF04-1	108	1851	ENST00000391794.8	464	2207	++	59	Q6PF04-1#18	0	3	ENST00000391794.8	842	845	+	3	0	0	5157
Q6PF04-1#18	0	3	3	Q6PF04-1	486	489	+	3	Q6PF04-1	0	1851	ENST00000293471.11	427	2278	++	17	Q6PF04-1#18	0	3	ENST00000293471.11	913	916	+	3	0	0	5158
Q6PF04-1#19	0	3	3	Q6PF04-1	1830	1833	+	3	Q6PF04-1	108	1851	ENST00000391794.8	464	2207	++	59	Q6PF04-1#19	0	3	ENST00000391794.8	2186	2189	+	3	0	0	5159
Q6PF04-1#19	0	3	3	Q6PF04-1	1830	1833	+	3	Q6PF04-1	0	1851	ENST00000293471.11	427	2278	++	17	Q6PF04-1#19	0	3	ENST00000293471.11	2257	2260	+	3	0	0	5160
A7E2S9-1#0	0	774	774	A7E2S9-1	0	774	+	774	A7E2S9-1	0	774	ENST00000409867.6	247	1021	++	72	A7E2S9-1#0	0	774	ENST00000409867.6	247	1021	+	774	0	0	5161
A7E2S9-1#0	0	774	774	A7E2S9-1	0	774	+	774	A7E2S9-1	0	615	ENST00000295181.6	250	865	++	18	A7E2S9-1#0	0	615	ENST00000295181.6	250	865	+	615	0	159	5162
A7E2S9-1#1	0	90	90	A7E2S9-1	210	300	+	90	A7E2S9-1	0	774	ENST00000409867.6	247	1021	++	72	A7E2S9-1#1	0	90	ENST00000409867.6	457	547	+	90	0	0	5163
A7E2S9-1#1	0	90	90	A7E2S9-1	210	300	+	90	A7E2S9-1	0	615	ENST00000295181.6	250	865	++	18	A7E2S9-1#1	0	90	ENST00000295181.6	460	550	+	90	0	0	5164
A7E2S9-1#2	0	90	90	A7E2S9-1	309	399	+	90	A7E2S9-1	0	774	ENST00000409867.6	247	1021	++	72	A7E2S9-1#2	0	90	ENST00000409867.6	556	646	+	90	0	0	5165
A7E2S9-1#2	0	90	90	A7E2S9-1	309	399	+	90	A7E2S9-1	0	615	ENST00000295181.6	250	865	++	18	A7E2S9-1#2	0	90	ENST00000295181.6	559	649	+	90	0	0	5166
A7E2S9-1#3	0	90	90	A7E2S9-1	408	498	+	90	A7E2S9-1	0	774	ENST00000409867.6	247	1021	++	72	A7E2S9-1#3	0	90	ENST00000409867.6	655	745	+	90	0	0	5167
A7E2S9-1#3	0	90	90	A7E2S9-1	408	498	+	90	A7E2S9-1	0	615	ENST00000295181.6	250	865	++	18	A7E2S9-1#3	0	90	ENST00000295181.6	658	748	+	90	0	0	5168
A7E2S9-1#4	0	90	90	A7E2S9-1	507	597	+	90	A7E2S9-1	0	774	ENST00000409867.6	247	1021	++	72	A7E2S9-1#4	0	90	ENST00000409867.6	754	844	+	90	0	0	5169
A7E2S9-1#4	0	90	90	A7E2S9-1	507	597	+	90	A7E2S9-1	0	615	ENST00000295181.6	250	865	++	18	A7E2S9-1#4	0	90	ENST00000295181.6	757	847	+	90	0	0	5170
A7E2S9-1#5	0	63	63	A7E2S9-1	0	63	+	63	A7E2S9-1	0	774	ENST00000409867.6	247	1021	++	72	A7E2S9-1#5	0	63	ENST00000409867.6	247	310	+	63	0	0	5171
A7E2S9-1#5	0	63	63	A7E2S9-1	0	63	+	63	A7E2S9-1	0	615	ENST00000295181.6	250	865	++	18	A7E2S9-1#5	0	63	ENST00000295181.6	250	313	+	63	0	0	5172
A7E2S9-1#6	0	129	129	A7E2S9-1	645	774	+	129	A7E2S9-1	0	774	ENST00000409867.6	247	1021	++	72	A7E2S9-1#6	0	129	ENST00000409867.6	892	1021	+	129	0	0	5173
A7E2S9-1#7	0	48	48	A7E2S9-1	645	693	+	48	A7E2S9-1	0	774	ENST00000409867.6	247	1021	++	72	A7E2S9-1#7	0	48	ENST00000409867.6	892	940	+	48	0	0	5174
A7E2S9-1#8	0	159	159	A7E2S9-1	615	774	+	159	A7E2S9-1	0	774	ENST00000409867.6	247	1021	++	72	A7E2S9-1#8	0	159	ENST00000409867.6	862	1021	+	159	0	0	5175
Q6PD74-1#0	0	945	945	Q6PD74-1	0	945	+	945	Q6PD74-1	327	945	ENST00000561452.5	516	1134	++	177	Q6PD74-1#0	327	945	ENST00000561452.5	516	1134	+	618	327	0	5176
Q6PD74-1#0	0	945	945	Q6PD74-1	0	945	+	945	Q6PD74-1	327	501	ENST00000560362.1	389	563	+	176	Q6PD74-1#0	327	501	ENST00000560362.1	389	563	+	174	327	444	5177
Q6PD74-1#0	0	945	945	Q6PD74-1	0	945	+	945	Q6PD74-1	327	945	ENST00000542650.5	313	931	++	161	Q6PD74-1#0	327	945	ENST00000542650.5	313	931	+	618	327	0	5178
Q6PD74-1#0	0	945	945	Q6PD74-1	0	945	+	945	Q6PD74-1	0	945	ENST00000261880.10	30	975	++	7	Q6PD74-1#0	0	945	ENST00000261880.10	30	975	+	945	0	0	5179
Q6PD74-1#1	0	114	114	Q6PD74-1	588	702	+	114	Q6PD74-1	327	945	ENST00000561452.5	516	1134	++	177	Q6PD74-1#1	0	114	ENST00000561452.5	777	891	+	114	0	0	5180
Q6PD74-1#1	0	114	114	Q6PD74-1	588	702	+	114	Q6PD74-1	327	945	ENST00000542650.5	313	931	++	161	Q6PD74-1#1	0	114	ENST00000542650.5	574	688	+	114	0	0	5181
Q6PD74-1#1	0	114	114	Q6PD74-1	588	702	+	114	Q6PD74-1	0	945	ENST00000261880.10	30	975	++	7	Q6PD74-1#1	0	114	ENST00000261880.10	618	732	+	114	0	0	5182
Q6PD74-1#2	0	45	45	Q6PD74-1	657	702	+	45	Q6PD74-1	327	945	ENST00000561452.5	516	1134	++	177	Q6PD74-1#2	0	45	ENST00000561452.5	846	891	+	45	0	0	5183
Q6PD74-1#2	0	45	45	Q6PD74-1	657	702	+	45	Q6PD74-1	327	945	ENST00000542650.5	313	931	++	161	Q6PD74-1#2	0	45	ENST00000542650.5	643	688	+	45	0	0	5184
Q6PD74-1#2	0	45	45	Q6PD74-1	657	702	+	45	Q6PD74-1	0	945	ENST00000261880.10	30	975	++	7	Q6PD74-1#2	0	45	ENST00000261880.10	687	732	+	45	0	0	5185
Q6PD74-1#3	0	3	3	Q6PD74-1	927	930	+	3	Q6PD74-1	327	945	ENST00000561452.5	516	1134	++	177	Q6PD74-1#3	0	3	ENST00000561452.5	1116	1119	+	3	0	0	5186
Q6PD74-1#3	0	3	3	Q6PD74-1	927	930	+	3	Q6PD74-1	327	945	ENST00000542650.5	313	931	++	161	Q6PD74-1#3	0	3	ENST00000542650.5	913	916	+	3	0	0	5187
Q6PD74-1#3	0	3	3	Q6PD74-1	927	930	+	3	Q6PD74-1	0	945	ENST00000261880.10	30	975	++	7	Q6PD74-1#3	0	3	ENST00000261880.10	957	960	+	3	0	0	5188
Q6PD74-1#4	0	3	3	Q6PD74-1	930	933	+	3	Q6PD74-1	327	945	ENST00000561452.5	516	1134	++	177	Q6PD74-1#4	0	3	ENST00000561452.5	1119	1122	+	3	0	0	5189
Q6PD74-1#4	0	3	3	Q6PD74-1	930	933	+	3	Q6PD74-1	327	945	ENST00000542650.5	313	931	++	161	Q6PD74-1#4	0	3	ENST00000542650.5	916	919	+	3	0	0	5190
Q6PD74-1#4	0	3	3	Q6PD74-1	930	933	+	3	Q6PD74-1	0	945	ENST00000261880.10	30	975	++	7	Q6PD74-1#4	0	3	ENST00000261880.10	960	963	+	3	0	0	5191
Q6PD74-1#5	0	327	327	Q6PD74-1	0	327	+	327	Q6PD74-1	0	945	ENST00000261880.10	30	975	++	7	Q6PD74-1#5	0	327	ENST00000261880.10	30	357	+	327	0	0	5192
Q6PD74-1#6	0	3	3	Q6PD74-1	393	396	+	3	Q6PD74-1	327	945	ENST00000561452.5	516	1134	++	177	Q6PD74-1#6	0	3	ENST00000561452.5	582	585	+	3	0	0	5193
Q6PD74-1#6	0	3	3	Q6PD74-1	393	396	+	3	Q6PD74-1	327	501	ENST00000560362.1	389	563	+	176	Q6PD74-1#6	0	3	ENST00000560362.1	455	458	+	3	0	0	5194
Q6PD74-1#6	0	3	3	Q6PD74-1	393	396	+	3	Q6PD74-1	327	945	ENST00000542650.5	313	931	++	161	Q6PD74-1#6	0	3	ENST00000542650.5	379	382	+	3	0	0	5195
Q6PD74-1#6	0	3	3	Q6PD74-1	393	396	+	3	Q6PD74-1	0	945	ENST00000261880.10	30	975	++	7	Q6PD74-1#6	0	3	ENST00000261880.10	423	426	+	3	0	0	5196
Q6PD74-1#7	0	3	3	Q6PD74-1	75	78	+	3	Q6PD74-1	0	945	ENST00000261880.10	30	975	++	7	Q6PD74-1#7	0	3	ENST00000261880.10	105	108	+	3	0	0	5197
Q6PD74-1#8	0	3	3	Q6PD74-1	228	231	+	3	Q6PD74-1	0	945	ENST00000261880.10	30	975	++	7	Q6PD74-1#8	0	3	ENST00000261880.10	258	261	+	3	0	0	5198
Q6PD74-1#9	0	3	3	Q6PD74-1	261	264	+	3	Q6PD74-1	0	945	ENST00000261880.10	30	975	++	7	Q6PD74-1#9	0	3	ENST00000261880.10	291	294	+	3	0	0	5199
Q6PD74-1#10	0	3	3	Q6PD74-1	390	393	+	3	Q6PD74-1	327	945	ENST00000561452.5	516	1134	++	177	Q6PD74-1#10	0	3	ENST00000561452.5	579	582	+	3	0	0	5200
Q6PD74-1#10	0	3	3	Q6PD74-1	390	393	+	3	Q6PD74-1	327	501	ENST00000560362.1	389	563	+	176	Q6PD74-1#10	0	3	ENST00000560362.1	452	455	+	3	0	0	5201
Q6PD74-1#10	0	3	3	Q6PD74-1	390	393	+	3	Q6PD74-1	327	945	ENST00000542650.5	313	931	++	161	Q6PD74-1#10	0	3	ENST00000542650.5	376	379	+	3	0	0	5202
Q6PD74-1#10	0	3	3	Q6PD74-1	390	393	+	3	Q6PD74-1	0	945	ENST00000261880.10	30	975	++	7	Q6PD74-1#10	0	3	ENST00000261880.10	420	423	+	3	0	0	5203
Q6PD74-1#11	0	3	3	Q6PD74-1	792	795	+	3	Q6PD74-1	327	945	ENST00000561452.5	516	1134	++	177	Q6PD74-1#11	0	3	ENST00000561452.5	981	984	+	3	0	0	5204
Q6PD74-1#11	0	3	3	Q6PD74-1	792	795	+	3	Q6PD74-1	327	945	ENST00000542650.5	313	931	++	161	Q6PD74-1#11	0	3	ENST00000542650.5	778	781	+	3	0	0	5205
Q6PD74-1#11	0	3	3	Q6PD74-1	792	795	+	3	Q6PD74-1	0	945	ENST00000261880.10	30	975	++	7	Q6PD74-1#11	0	3	ENST00000261880.10	822	825	+	3	0	0	5206
Q6PD74-1#12	0	3	3	Q6PD74-1	936	939	+	3	Q6PD74-1	327	945	ENST00000561452.5	516	1134	++	177	Q6PD74-1#12	0	3	ENST00000561452.5	1125	1128	+	3	0	0	5207
Q6PD74-1#12	0	3	3	Q6PD74-1	936	939	+	3	Q6PD74-1	327	945	ENST00000542650.5	313	931	++	161	Q6PD74-1#12	0	3	ENST00000542650.5	922	925	+	3	0	0	5208
Q6PD74-1#12	0	3	3	Q6PD74-1	936	939	+	3	Q6PD74-1	0	945	ENST00000261880.10	30	975	++	7	Q6PD74-1#12	0	3	ENST00000261880.10	966	969	+	3	0	0	5209
Q8N1M1-2#0	0	2004	2004	Q8N1M1-2	0	2004	+	2004	Q8N1M1-2	318	2004	ENST00000553096.5	152	1838	++	169	Q8N1M1-2#0	318	2004	ENST00000553096.5	152	1838	+	1686	318	0	5210
Q8N1M1-2#0	0	2004	2004	Q8N1M1-2	0	2004	+	2004	Q8N1M1-2	318	955	ENST00000552295.5	236	720	+	168	Q8N1M1-2#0	318	955	ENST00000552295.5	236	720	+	484	318	1049	5211
Q8N1M1-2#0	0	2004	2004	Q8N1M1-2	0	2004	+	2004	Q8N1M1-2	318	480	ENST00000551160.5	357	519	++	167	Q8N1M1-2#0	318	480	ENST00000551160.5	357	519	+	162	318	1524	5212
Q8N1M1-2#0	0	2004	2004	Q8N1M1-2	0	2004	+	2004	Q8N1M1-2	0	660	ENST00000548658.1	146	572	+	166	Q8N1M1-2#0	0	660	ENST00000548658.1	146	572	+	426	0	1344	5213
Q8N1M1-2#0	0	2004	2004	Q8N1M1-2	0	2004	+	2004	Q8N1M1-2	384	982	ENST00000547208.5	209	641	+	165	Q8N1M1-2#0	384	982	ENST00000547208.5	209	641	+	432	384	1022	5214
Q8N1M1-2#0	0	2004	2004	Q8N1M1-2	0	2004	+	2004	Q8N1M1-2	486	2004	ENST00000488961.5	212	1577	++	118	Q8N1M1-2#0	486	2004	ENST00000488961.5	212	1577	+	1365	486	0	5215
Q8N1M1-2#0	0	2004	2004	Q8N1M1-2	0	2004	+	2004	Q8N1M1-2	486	1100	ENST00000476098.5	331	792	+	112	Q8N1M1-2#0	486	1100	ENST00000476098.5	331	792	+	461	486	904	5216
Q8N1M1-2#0	0	2004	2004	Q8N1M1-2	0	2004	+	2004	Q8N1M1-2	0	1134	ENST00000331471.8	172	1297	++	28	Q8N1M1-2#0	0	1134	ENST00000331471.8	172	1297	+	1125	0	870	5217
Q8N1M1-2#0	0	2004	2004	Q8N1M1-2	0	2004	+	2004	Q8N1M1-2	0	2004	ENST00000330891.10	114	2118	++	27	Q8N1M1-2#0	0	2004	ENST00000330891.10	114	2118	+	2004	0	0	5218
Q8N1M1-2#0	0	2004	2004	Q8N1M1-2	0	2004	+	2004	Q8N1M1-2	318	480	ENST00000266661.8	343	505	++	10	Q8N1M1-2#0	318	480	ENST00000266661.8	343	505	+	162	318	1524	5219
Q8N1M1-2#1	0	75	75	Q8N1M1-2	0	75	+	75	Q8N1M1-2	0	660	ENST00000548658.1	146	572	+	166	Q8N1M1-2#1	0	75	ENST00000548658.1	146	221	+	75	0	0	5220
Q8N1M1-2#1	0	75	75	Q8N1M1-2	0	75	+	75	Q8N1M1-2	0	1134	ENST00000331471.8	172	1297	++	28	Q8N1M1-2#1	0	75	ENST00000331471.8	172	247	+	75	0	0	5221
Q8N1M1-2#1	0	75	75	Q8N1M1-2	0	75	+	75	Q8N1M1-2	0	2004	ENST00000330891.10	114	2118	++	27	Q8N1M1-2#1	0	75	ENST00000330891.10	114	189	+	75	0	0	5222
Q8N1M1-2#2	0	63	63	Q8N1M1-2	75	138	+	63	Q8N1M1-2	0	660	ENST00000548658.1	146	572	+	166	Q8N1M1-2#2	0	63	ENST00000548658.1	221	284	+	63	0	0	5223
Q8N1M1-2#2	0	63	63	Q8N1M1-2	75	138	+	63	Q8N1M1-2	0	1134	ENST00000331471.8	172	1297	++	28	Q8N1M1-2#2	0	63	ENST00000331471.8	247	310	+	63	0	0	5224
Q8N1M1-2#2	0	63	63	Q8N1M1-2	75	138	+	63	Q8N1M1-2	0	2004	ENST00000330891.10	114	2118	++	27	Q8N1M1-2#2	0	63	ENST00000330891.10	189	252	+	63	0	0	5225
Q8N1M1-2#3	0	72	72	Q8N1M1-2	138	210	+	72	Q8N1M1-2	0	660	ENST00000548658.1	146	572	+	166	Q8N1M1-2#3	0	72	ENST00000548658.1	284	356	+	72	0	0	5226
Q8N1M1-2#3	0	72	72	Q8N1M1-2	138	210	+	72	Q8N1M1-2	0	1134	ENST00000331471.8	172	1297	++	28	Q8N1M1-2#3	0	72	ENST00000331471.8	310	382	+	72	0	0	5227
Q8N1M1-2#3	0	72	72	Q8N1M1-2	138	210	+	72	Q8N1M1-2	0	2004	ENST00000330891.10	114	2118	++	27	Q8N1M1-2#3	0	72	ENST00000330891.10	252	324	+	72	0	0	5228
Q8N1M1-2#4	0	63	63	Q8N1M1-2	210	273	+	63	Q8N1M1-2	0	660	ENST00000548658.1	146	572	+	166	Q8N1M1-2#4	0	37	ENST00000548658.1	356	393	+	37	0	26	5229
Q8N1M1-2#4	0	63	63	Q8N1M1-2	210	273	+	63	Q8N1M1-2	0	1134	ENST00000331471.8	172	1297	++	28	Q8N1M1-2#4	0	63	ENST00000331471.8	382	445	+	63	0	0	5230
Q8N1M1-2#4	0	63	63	Q8N1M1-2	210	273	+	63	Q8N1M1-2	0	2004	ENST00000330891.10	114	2118	++	27	Q8N1M1-2#4	0	63	ENST00000330891.10	324	387	+	63	0	0	5231
Q8N1M1-2#5	0	261	261	Q8N1M1-2	273	534	+	261	Q8N1M1-2	318	2004	ENST00000553096.5	152	1838	++	169	Q8N1M1-2#5	45	261	ENST00000553096.5	152	368	+	216	45	0	5232
Q8N1M1-2#5	0	261	261	Q8N1M1-2	273	534	+	261	Q8N1M1-2	318	955	ENST00000552295.5	236	720	+	168	Q8N1M1-2#5	45	261	ENST00000552295.5	236	452	+	216	45	0	5233
Q8N1M1-2#5	0	261	261	Q8N1M1-2	273	534	+	261	Q8N1M1-2	318	480	ENST00000551160.5	357	519	++	167	Q8N1M1-2#5	45	207	ENST00000551160.5	357	519	+	162	45	54	5234
Q8N1M1-2#5	0	261	261	Q8N1M1-2	273	534	+	261	Q8N1M1-2	0	660	ENST00000548658.1	146	572	+	166	Q8N1M1-2#5	208	261	ENST00000548658.1	393	446	+	53	208	0	5235
Q8N1M1-2#5	0	261	261	Q8N1M1-2	273	534	+	261	Q8N1M1-2	384	982	ENST00000547208.5	209	641	+	165	Q8N1M1-2#5	111	261	ENST00000547208.5	209	359	+	150	111	0	5236
Q8N1M1-2#5	0	261	261	Q8N1M1-2	273	534	+	261	Q8N1M1-2	486	2004	ENST00000488961.5	212	1577	++	118	Q8N1M1-2#5	213	261	ENST00000488961.5	212	260	+	48	213	0	5237
Q8N1M1-2#5	0	261	261	Q8N1M1-2	273	534	+	261	Q8N1M1-2	486	1100	ENST00000476098.5	331	792	+	112	Q8N1M1-2#5	213	261	ENST00000476098.5	331	379	+	48	213	0	5238
Q8N1M1-2#5	0	261	261	Q8N1M1-2	273	534	+	261	Q8N1M1-2	0	1134	ENST00000331471.8	172	1297	++	28	Q8N1M1-2#5	0	261	ENST00000331471.8	445	706	+	261	0	0	5239
Q8N1M1-2#5	0	261	261	Q8N1M1-2	273	534	+	261	Q8N1M1-2	0	2004	ENST00000330891.10	114	2118	++	27	Q8N1M1-2#5	0	261	ENST00000330891.10	387	648	+	261	0	0	5240
Q8N1M1-2#5	0	261	261	Q8N1M1-2	273	534	+	261	Q8N1M1-2	318	480	ENST00000266661.8	343	505	++	10	Q8N1M1-2#5	45	207	ENST00000266661.8	343	505	+	162	45	54	5241
Q8N1M1-2#6	0	63	63	Q8N1M1-2	534	597	+	63	Q8N1M1-2	318	2004	ENST00000553096.5	152	1838	++	169	Q8N1M1-2#6	0	63	ENST00000553096.5	368	431	+	63	0	0	5242
Q8N1M1-2#6	0	63	63	Q8N1M1-2	534	597	+	63	Q8N1M1-2	318	955	ENST00000552295.5	236	720	+	168	Q8N1M1-2#6	0	63	ENST00000552295.5	452	515	+	63	0	0	5243
Q8N1M1-2#6	0	63	63	Q8N1M1-2	534	597	+	63	Q8N1M1-2	0	660	ENST00000548658.1	146	572	+	166	Q8N1M1-2#6	0	63	ENST00000548658.1	446	509	+	63	0	0	5244
Q8N1M1-2#6	0	63	63	Q8N1M1-2	534	597	+	63	Q8N1M1-2	384	982	ENST00000547208.5	209	641	+	165	Q8N1M1-2#6	0	63	ENST00000547208.5	359	422	+	63	0	0	5245
Q8N1M1-2#6	0	63	63	Q8N1M1-2	534	597	+	63	Q8N1M1-2	486	2004	ENST00000488961.5	212	1577	++	118	Q8N1M1-2#6	0	63	ENST00000488961.5	260	323	+	63	0	0	5246
Q8N1M1-2#6	0	63	63	Q8N1M1-2	534	597	+	63	Q8N1M1-2	486	1100	ENST00000476098.5	331	792	+	112	Q8N1M1-2#6	0	63	ENST00000476098.5	379	442	+	63	0	0	5247
Q8N1M1-2#6	0	63	63	Q8N1M1-2	534	597	+	63	Q8N1M1-2	0	1134	ENST00000331471.8	172	1297	++	28	Q8N1M1-2#6	0	63	ENST00000331471.8	706	769	+	63	0	0	5248
Q8N1M1-2#6	0	63	63	Q8N1M1-2	534	597	+	63	Q8N1M1-2	0	2004	ENST00000330891.10	114	2118	++	27	Q8N1M1-2#6	0	63	ENST00000330891.10	648	711	+	63	0	0	5249
Q8N1M1-2#7	0	87	87	Q8N1M1-2	597	684	+	87	Q8N1M1-2	318	2004	ENST00000553096.5	152	1838	++	169	Q8N1M1-2#7	0	87	ENST00000553096.5	431	518	+	87	0	0	5250
Q8N1M1-2#7	0	87	87	Q8N1M1-2	597	684	+	87	Q8N1M1-2	318	955	ENST00000552295.5	236	720	+	168	Q8N1M1-2#7	0	87	ENST00000552295.5	515	602	+	87	0	0	5251
Q8N1M1-2#7	0	87	87	Q8N1M1-2	597	684	+	87	Q8N1M1-2	0	660	ENST00000548658.1	146	572	+	166	Q8N1M1-2#7	0	63	ENST00000548658.1	509	572	+	63	0	24	5252
Q8N1M1-2#7	0	87	87	Q8N1M1-2	597	684	+	87	Q8N1M1-2	384	982	ENST00000547208.5	209	641	+	165	Q8N1M1-2#7	0	87	ENST00000547208.5	422	509	+	87	0	0	5253
Q8N1M1-2#7	0	87	87	Q8N1M1-2	597	684	+	87	Q8N1M1-2	486	2004	ENST00000488961.5	212	1577	++	118	Q8N1M1-2#7	0	87	ENST00000488961.5	323	410	+	87	0	0	5254
Q8N1M1-2#7	0	87	87	Q8N1M1-2	597	684	+	87	Q8N1M1-2	486	1100	ENST00000476098.5	331	792	+	112	Q8N1M1-2#7	0	87	ENST00000476098.5	442	529	+	87	0	0	5255
Q8N1M1-2#7	0	87	87	Q8N1M1-2	597	684	+	87	Q8N1M1-2	0	1134	ENST00000331471.8	172	1297	++	28	Q8N1M1-2#7	0	87	ENST00000331471.8	769	856	+	87	0	0	5256
Q8N1M1-2#7	0	87	87	Q8N1M1-2	597	684	+	87	Q8N1M1-2	0	2004	ENST00000330891.10	114	2118	++	27	Q8N1M1-2#7	0	87	ENST00000330891.10	711	798	+	87	0	0	5257
Q8N1M1-2#8	0	63	63	Q8N1M1-2	684	747	+	63	Q8N1M1-2	318	2004	ENST00000553096.5	152	1838	++	169	Q8N1M1-2#8	0	63	ENST00000553096.5	518	581	+	63	0	0	5258
Q8N1M1-2#8	0	63	63	Q8N1M1-2	684	747	+	63	Q8N1M1-2	318	955	ENST00000552295.5	236	720	+	168	Q8N1M1-2#8	0	30	ENST00000552295.5	602	632	+	30	0	33	5259
Q8N1M1-2#8	0	63	63	Q8N1M1-2	684	747	+	63	Q8N1M1-2	384	982	ENST00000547208.5	209	641	+	165	Q8N1M1-2#8	0	30	ENST00000547208.5	509	539	+	30	0	33	5260
Q8N1M1-2#8	0	63	63	Q8N1M1-2	684	747	+	63	Q8N1M1-2	486	2004	ENST00000488961.5	212	1577	++	118	Q8N1M1-2#8	0	30	ENST00000488961.5	410	440	+	30	0	33	5261
Q8N1M1-2#8	0	63	63	Q8N1M1-2	684	747	+	63	Q8N1M1-2	486	1100	ENST00000476098.5	331	792	+	112	Q8N1M1-2#8	0	30	ENST00000476098.5	529	559	+	30	0	33	5262
Q8N1M1-2#8	0	63	63	Q8N1M1-2	684	747	+	63	Q8N1M1-2	0	1134	ENST00000331471.8	172	1297	++	28	Q8N1M1-2#8	0	63	ENST00000331471.8	856	919	+	63	0	0	5263
Q8N1M1-2#8	0	63	63	Q8N1M1-2	684	747	+	63	Q8N1M1-2	0	2004	ENST00000330891.10	114	2118	++	27	Q8N1M1-2#8	0	63	ENST00000330891.10	798	861	+	63	0	0	5264
Q8N1M1-2#9	0	63	63	Q8N1M1-2	747	810	+	63	Q8N1M1-2	318	2004	ENST00000553096.5	152	1838	++	169	Q8N1M1-2#9	0	63	ENST00000553096.5	581	644	+	63	0	0	5265
Q8N1M1-2#9	0	63	63	Q8N1M1-2	747	810	+	63	Q8N1M1-2	0	1134	ENST00000331471.8	172	1297	++	28	Q8N1M1-2#9	0	63	ENST00000331471.8	919	982	+	63	0	0	5266
Q8N1M1-2#9	0	63	63	Q8N1M1-2	747	810	+	63	Q8N1M1-2	0	2004	ENST00000330891.10	114	2118	++	27	Q8N1M1-2#9	0	63	ENST00000330891.10	861	924	+	63	0	0	5267
Q8N1M1-2#10	0	63	63	Q8N1M1-2	810	873	+	63	Q8N1M1-2	318	2004	ENST00000553096.5	152	1838	++	169	Q8N1M1-2#10	0	63	ENST00000553096.5	644	707	+	63	0	0	5268
Q8N1M1-2#10	0	63	63	Q8N1M1-2	810	873	+	63	Q8N1M1-2	318	955	ENST00000552295.5	236	720	+	168	Q8N1M1-2#10	57	63	ENST00000552295.5	632	638	+	6	57	0	5269
Q8N1M1-2#10	0	63	63	Q8N1M1-2	810	873	+	63	Q8N1M1-2	384	982	ENST00000547208.5	209	641	+	165	Q8N1M1-2#10	57	63	ENST00000547208.5	539	545	+	6	57	0	5270
Q8N1M1-2#10	0	63	63	Q8N1M1-2	810	873	+	63	Q8N1M1-2	486	2004	ENST00000488961.5	212	1577	++	118	Q8N1M1-2#10	57	63	ENST00000488961.5	440	446	+	6	57	0	5271
Q8N1M1-2#10	0	63	63	Q8N1M1-2	810	873	+	63	Q8N1M1-2	486	1100	ENST00000476098.5	331	792	+	112	Q8N1M1-2#10	57	63	ENST00000476098.5	559	565	+	6	57	0	5272
Q8N1M1-2#10	0	63	63	Q8N1M1-2	810	873	+	63	Q8N1M1-2	0	1134	ENST00000331471.8	172	1297	++	28	Q8N1M1-2#10	0	63	ENST00000331471.8	982	1045	+	63	0	0	5273
Q8N1M1-2#10	0	63	63	Q8N1M1-2	810	873	+	63	Q8N1M1-2	0	2004	ENST00000330891.10	114	2118	++	27	Q8N1M1-2#10	0	63	ENST00000330891.10	924	987	+	63	0	0	5274
Q8N1M1-2#11	0	1131	1131	Q8N1M1-2	873	2004	+	1131	Q8N1M1-2	318	2004	ENST00000553096.5	152	1838	++	169	Q8N1M1-2#11	0	1131	ENST00000553096.5	707	1838	+	1131	0	0	5275
Q8N1M1-2#11	0	1131	1131	Q8N1M1-2	873	2004	+	1131	Q8N1M1-2	318	955	ENST00000552295.5	236	720	+	168	Q8N1M1-2#11	0	82	ENST00000552295.5	638	720	+	82	0	1049	5276
Q8N1M1-2#11	0	1131	1131	Q8N1M1-2	873	2004	+	1131	Q8N1M1-2	384	982	ENST00000547208.5	209	641	+	165	Q8N1M1-2#11	0	109	ENST00000547208.5	545	641	+	96	0	1022	5277
Q8N1M1-2#11	0	1131	1131	Q8N1M1-2	873	2004	+	1131	Q8N1M1-2	486	2004	ENST00000488961.5	212	1577	++	118	Q8N1M1-2#11	0	1131	ENST00000488961.5	446	1577	+	1131	0	0	5278
Q8N1M1-2#11	0	1131	1131	Q8N1M1-2	873	2004	+	1131	Q8N1M1-2	486	1100	ENST00000476098.5	331	792	+	112	Q8N1M1-2#11	0	227	ENST00000476098.5	565	792	+	227	0	904	5279
Q8N1M1-2#11	0	1131	1131	Q8N1M1-2	873	2004	+	1131	Q8N1M1-2	0	1134	ENST00000331471.8	172	1297	++	28	Q8N1M1-2#11	0	261	ENST00000331471.8	1045	1297	+	252	0	870	5280
Q8N1M1-2#11	0	1131	1131	Q8N1M1-2	873	2004	+	1131	Q8N1M1-2	0	2004	ENST00000330891.10	114	2118	++	27	Q8N1M1-2#11	0	1131	ENST00000330891.10	987	2118	+	1131	0	0	5281
Q8N1M1-2#12	0	165	165	Q8N1M1-2	1197	1362	+	165	Q8N1M1-2	318	2004	ENST00000553096.5	152	1838	++	169	Q8N1M1-2#12	0	165	ENST00000553096.5	1031	1196	+	165	0	0	5282
Q8N1M1-2#12	0	165	165	Q8N1M1-2	1197	1362	+	165	Q8N1M1-2	486	2004	ENST00000488961.5	212	1577	++	118	Q8N1M1-2#12	0	165	ENST00000488961.5	770	935	+	165	0	0	5283
Q8N1M1-2#12	0	165	165	Q8N1M1-2	1197	1362	+	165	Q8N1M1-2	0	2004	ENST00000330891.10	114	2118	++	27	Q8N1M1-2#12	0	165	ENST00000330891.10	1311	1476	+	165	0	0	5284
Q8N1M1-2#13	0	63	63	Q8N1M1-2	1416	1479	+	63	Q8N1M1-2	318	2004	ENST00000553096.5	152	1838	++	169	Q8N1M1-2#13	0	63	ENST00000553096.5	1250	1313	+	63	0	0	5285
Q8N1M1-2#13	0	63	63	Q8N1M1-2	1416	1479	+	63	Q8N1M1-2	486	2004	ENST00000488961.5	212	1577	++	118	Q8N1M1-2#13	0	63	ENST00000488961.5	989	1052	+	63	0	0	5286
Q8N1M1-2#13	0	63	63	Q8N1M1-2	1416	1479	+	63	Q8N1M1-2	0	2004	ENST00000330891.10	114	2118	++	27	Q8N1M1-2#13	0	63	ENST00000330891.10	1530	1593	+	63	0	0	5287
Q8N1M1-2#14	0	117	117	Q8N1M1-2	1593	1710	+	117	Q8N1M1-2	318	2004	ENST00000553096.5	152	1838	++	169	Q8N1M1-2#14	0	117	ENST00000553096.5	1427	1544	+	117	0	0	5288
Q8N1M1-2#14	0	117	117	Q8N1M1-2	1593	1710	+	117	Q8N1M1-2	486	2004	ENST00000488961.5	212	1577	++	118	Q8N1M1-2#14	0	117	ENST00000488961.5	1166	1283	+	117	0	0	5289
Q8N1M1-2#14	0	117	117	Q8N1M1-2	1593	1710	+	117	Q8N1M1-2	0	2004	ENST00000330891.10	114	2118	++	27	Q8N1M1-2#14	0	117	ENST00000330891.10	1707	1824	+	117	0	0	5290
Q8N1M1-2#15	0	51	51	Q8N1M1-2	1197	1248	+	51	Q8N1M1-2	318	2004	ENST00000553096.5	152	1838	++	169	Q8N1M1-2#15	0	51	ENST00000553096.5	1031	1082	+	51	0	0	5291
Q8N1M1-2#15	0	51	51	Q8N1M1-2	1197	1248	+	51	Q8N1M1-2	486	2004	ENST00000488961.5	212	1577	++	118	Q8N1M1-2#15	0	51	ENST00000488961.5	770	821	+	51	0	0	5292
Q8N1M1-2#15	0	51	51	Q8N1M1-2	1197	1248	+	51	Q8N1M1-2	0	2004	ENST00000330891.10	114	2118	++	27	Q8N1M1-2#15	0	51	ENST00000330891.10	1311	1362	+	51	0	0	5293
Q8N1M1-2#16	0	57	57	Q8N1M1-2	1593	1650	+	57	Q8N1M1-2	318	2004	ENST00000553096.5	152	1838	++	169	Q8N1M1-2#16	0	57	ENST00000553096.5	1427	1484	+	57	0	0	5294
Q8N1M1-2#16	0	57	57	Q8N1M1-2	1593	1650	+	57	Q8N1M1-2	486	2004	ENST00000488961.5	212	1577	++	118	Q8N1M1-2#16	0	57	ENST00000488961.5	1166	1223	+	57	0	0	5295
Q8N1M1-2#16	0	57	57	Q8N1M1-2	1593	1650	+	57	Q8N1M1-2	0	2004	ENST00000330891.10	114	2118	++	27	Q8N1M1-2#16	0	57	ENST00000330891.10	1707	1764	+	57	0	0	5296
Q8N1M1-2#17	0	486	486	Q8N1M1-2	0	486	+	486	Q8N1M1-2	318	2004	ENST00000553096.5	152	1838	++	169	Q8N1M1-2#17	318	486	ENST00000553096.5	152	320	+	168	318	0	5297
Q8N1M1-2#17	0	486	486	Q8N1M1-2	0	486	+	486	Q8N1M1-2	318	955	ENST00000552295.5	236	720	+	168	Q8N1M1-2#17	318	486	ENST00000552295.5	236	404	+	168	318	0	5298
Q8N1M1-2#17	0	486	486	Q8N1M1-2	0	486	+	486	Q8N1M1-2	318	480	ENST00000551160.5	357	519	++	167	Q8N1M1-2#17	318	480	ENST00000551160.5	357	519	+	162	318	6	5299
Q8N1M1-2#17	0	486	486	Q8N1M1-2	0	486	+	486	Q8N1M1-2	0	660	ENST00000548658.1	146	572	+	166	Q8N1M1-2#17	0	486	ENST00000548658.1	146	398	+	252	0	0	5300
Q8N1M1-2#17	0	486	486	Q8N1M1-2	0	486	+	486	Q8N1M1-2	384	982	ENST00000547208.5	209	641	+	165	Q8N1M1-2#17	384	486	ENST00000547208.5	209	311	+	102	384	0	5301
Q8N1M1-2#17	0	486	486	Q8N1M1-2	0	486	+	486	Q8N1M1-2	0	1134	ENST00000331471.8	172	1297	++	28	Q8N1M1-2#17	0	486	ENST00000331471.8	172	658	+	486	0	0	5302
Q8N1M1-2#17	0	486	486	Q8N1M1-2	0	486	+	486	Q8N1M1-2	0	2004	ENST00000330891.10	114	2118	++	27	Q8N1M1-2#17	0	486	ENST00000330891.10	114	600	+	486	0	0	5303
Q8N1M1-2#17	0	486	486	Q8N1M1-2	0	486	+	486	Q8N1M1-2	318	480	ENST00000266661.8	343	505	++	10	Q8N1M1-2#17	318	480	ENST00000266661.8	343	505	+	162	318	6	5304
Q8N1M1-2#18	0	318	318	Q8N1M1-2	0	318	+	318	Q8N1M1-2	0	660	ENST00000548658.1	146	572	+	166	Q8N1M1-2#18	0	247	ENST00000548658.1	146	393	+	247	0	71	5305
Q8N1M1-2#18	0	318	318	Q8N1M1-2	0	318	+	318	Q8N1M1-2	0	1134	ENST00000331471.8	172	1297	++	28	Q8N1M1-2#18	0	318	ENST00000331471.8	172	490	+	318	0	0	5306
Q8N1M1-2#18	0	318	318	Q8N1M1-2	0	318	+	318	Q8N1M1-2	0	2004	ENST00000330891.10	114	2118	++	27	Q8N1M1-2#18	0	318	ENST00000330891.10	114	432	+	318	0	0	5307
Q8N1M1-2#19	0	54	54	Q8N1M1-2	480	534	+	54	Q8N1M1-2	318	2004	ENST00000553096.5	152	1838	++	169	Q8N1M1-2#19	0	54	ENST00000553096.5	314	368	+	54	0	0	5308
Q8N1M1-2#19	0	54	54	Q8N1M1-2	480	534	+	54	Q8N1M1-2	318	955	ENST00000552295.5	236	720	+	168	Q8N1M1-2#19	0	54	ENST00000552295.5	398	452	+	54	0	0	5309
Q8N1M1-2#19	0	54	54	Q8N1M1-2	480	534	+	54	Q8N1M1-2	0	660	ENST00000548658.1	146	572	+	166	Q8N1M1-2#19	1	54	ENST00000548658.1	393	446	+	53	1	0	5310
Q8N1M1-2#19	0	54	54	Q8N1M1-2	480	534	+	54	Q8N1M1-2	384	982	ENST00000547208.5	209	641	+	165	Q8N1M1-2#19	0	54	ENST00000547208.5	305	359	+	54	0	0	5311
Q8N1M1-2#19	0	54	54	Q8N1M1-2	480	534	+	54	Q8N1M1-2	486	2004	ENST00000488961.5	212	1577	++	118	Q8N1M1-2#19	6	54	ENST00000488961.5	212	260	+	48	6	0	5312
Q8N1M1-2#19	0	54	54	Q8N1M1-2	480	534	+	54	Q8N1M1-2	486	1100	ENST00000476098.5	331	792	+	112	Q8N1M1-2#19	6	54	ENST00000476098.5	331	379	+	48	6	0	5313
Q8N1M1-2#19	0	54	54	Q8N1M1-2	480	534	+	54	Q8N1M1-2	0	1134	ENST00000331471.8	172	1297	++	28	Q8N1M1-2#19	0	54	ENST00000331471.8	652	706	+	54	0	0	5314
Q8N1M1-2#19	0	54	54	Q8N1M1-2	480	534	+	54	Q8N1M1-2	0	2004	ENST00000330891.10	114	2118	++	27	Q8N1M1-2#19	0	54	ENST00000330891.10	594	648	+	54	0	0	5315
Q8N1M1-2#20	0	1470	1470	Q8N1M1-2	534	2004	+	1470	Q8N1M1-2	318	2004	ENST00000553096.5	152	1838	++	169	Q8N1M1-2#20	0	1470	ENST00000553096.5	368	1838	+	1470	0	0	5316
Q8N1M1-2#20	0	1470	1470	Q8N1M1-2	534	2004	+	1470	Q8N1M1-2	318	955	ENST00000552295.5	236	720	+	168	Q8N1M1-2#20	0	421	ENST00000552295.5	452	720	+	268	0	1049	5317
Q8N1M1-2#20	0	1470	1470	Q8N1M1-2	534	2004	+	1470	Q8N1M1-2	0	660	ENST00000548658.1	146	572	+	166	Q8N1M1-2#20	0	126	ENST00000548658.1	446	572	+	126	0	1344	5318
Q8N1M1-2#20	0	1470	1470	Q8N1M1-2	534	2004	+	1470	Q8N1M1-2	384	982	ENST00000547208.5	209	641	+	165	Q8N1M1-2#20	0	448	ENST00000547208.5	359	641	+	282	0	1022	5319
Q8N1M1-2#20	0	1470	1470	Q8N1M1-2	534	2004	+	1470	Q8N1M1-2	486	2004	ENST00000488961.5	212	1577	++	118	Q8N1M1-2#20	0	1470	ENST00000488961.5	260	1577	+	1317	0	0	5320
Q8N1M1-2#20	0	1470	1470	Q8N1M1-2	534	2004	+	1470	Q8N1M1-2	486	1100	ENST00000476098.5	331	792	+	112	Q8N1M1-2#20	0	566	ENST00000476098.5	379	792	+	413	0	904	5321
Q8N1M1-2#20	0	1470	1470	Q8N1M1-2	534	2004	+	1470	Q8N1M1-2	0	1134	ENST00000331471.8	172	1297	++	28	Q8N1M1-2#20	0	600	ENST00000331471.8	706	1297	+	591	0	870	5322
Q8N1M1-2#20	0	1470	1470	Q8N1M1-2	534	2004	+	1470	Q8N1M1-2	0	2004	ENST00000330891.10	114	2118	++	27	Q8N1M1-2#20	0	1470	ENST00000330891.10	648	2118	+	1470	0	0	5323
Q8N1M1-2#21	0	153	153	Q8N1M1-2	714	867	+	153	Q8N1M1-2	318	2004	ENST00000553096.5	152	1838	++	169	Q8N1M1-2#21	0	153	ENST00000553096.5	548	701	+	153	0	0	5324
Q8N1M1-2#21	0	153	153	Q8N1M1-2	714	867	+	153	Q8N1M1-2	0	1134	ENST00000331471.8	172	1297	++	28	Q8N1M1-2#21	0	153	ENST00000331471.8	886	1039	+	153	0	0	5325
Q8N1M1-2#21	0	153	153	Q8N1M1-2	714	867	+	153	Q8N1M1-2	0	2004	ENST00000330891.10	114	2118	++	27	Q8N1M1-2#21	0	153	ENST00000330891.10	828	981	+	153	0	0	5326
Q8N1M1-2#22	0	93	93	Q8N1M1-2	1101	1194	+	93	Q8N1M1-2	318	2004	ENST00000553096.5	152	1838	++	169	Q8N1M1-2#22	0	93	ENST00000553096.5	935	1028	+	93	0	0	5327
Q8N1M1-2#22	0	93	93	Q8N1M1-2	1101	1194	+	93	Q8N1M1-2	486	2004	ENST00000488961.5	212	1577	++	118	Q8N1M1-2#22	0	93	ENST00000488961.5	674	767	+	93	0	0	5328
Q8N1M1-2#22	0	93	93	Q8N1M1-2	1101	1194	+	93	Q8N1M1-2	0	1134	ENST00000331471.8	172	1297	++	28	Q8N1M1-2#22	6	33	ENST00000331471.8	1270	1297	+	27	6	60	5329
Q8N1M1-2#22	0	93	93	Q8N1M1-2	1101	1194	+	93	Q8N1M1-2	0	2004	ENST00000330891.10	114	2118	++	27	Q8N1M1-2#22	0	93	ENST00000330891.10	1215	1308	+	93	0	0	5330
Q8N1M1-2#23	0	810	810	Q8N1M1-2	1194	2004	+	810	Q8N1M1-2	318	2004	ENST00000553096.5	152	1838	++	169	Q8N1M1-2#23	0	810	ENST00000553096.5	1028	1838	+	810	0	0	5331
Q8N1M1-2#23	0	810	810	Q8N1M1-2	1194	2004	+	810	Q8N1M1-2	486	2004	ENST00000488961.5	212	1577	++	118	Q8N1M1-2#23	0	810	ENST00000488961.5	767	1577	+	810	0	0	5332
Q8N1M1-2#23	0	810	810	Q8N1M1-2	1194	2004	+	810	Q8N1M1-2	0	2004	ENST00000330891.10	114	2118	++	27	Q8N1M1-2#23	0	810	ENST00000330891.10	1308	2118	+	810	0	0	5333
Q8N1M1-2#24	0	3	3	Q8N1M1-2	126	129	+	3	Q8N1M1-2	0	660	ENST00000548658.1	146	572	+	166	Q8N1M1-2#24	0	3	ENST00000548658.1	272	275	+	3	0	0	5334
Q8N1M1-2#24	0	3	3	Q8N1M1-2	126	129	+	3	Q8N1M1-2	0	1134	ENST00000331471.8	172	1297	++	28	Q8N1M1-2#24	0	3	ENST00000331471.8	298	301	+	3	0	0	5335
Q8N1M1-2#24	0	3	3	Q8N1M1-2	126	129	+	3	Q8N1M1-2	0	2004	ENST00000330891.10	114	2118	++	27	Q8N1M1-2#24	0	3	ENST00000330891.10	240	243	+	3	0	0	5336
Q8N1M1-2#25	0	3	3	Q8N1M1-2	1863	1866	+	3	Q8N1M1-2	318	2004	ENST00000553096.5	152	1838	++	169	Q8N1M1-2#25	0	3	ENST00000553096.5	1697	1700	+	3	0	0	5337
Q8N1M1-2#25	0	3	3	Q8N1M1-2	1863	1866	+	3	Q8N1M1-2	486	2004	ENST00000488961.5	212	1577	++	118	Q8N1M1-2#25	0	3	ENST00000488961.5	1436	1439	+	3	0	0	5338
Q8N1M1-2#25	0	3	3	Q8N1M1-2	1863	1866	+	3	Q8N1M1-2	0	2004	ENST00000330891.10	114	2118	++	27	Q8N1M1-2#25	0	3	ENST00000330891.10	1977	1980	+	3	0	0	5339
Q9BXI3#0	0	1104	1104	Q9BXI3	0	1104	+	1104	Q9BXI3	0	1104	ENST00000235628.2	69	1173	++	1	Q9BXI3#0	0	1104	ENST00000235628.2	69	1173	+	1104	0	0	5340
Q9BXI3#1	0	66	66	Q9BXI3	0	66	+	66	Q9BXI3	0	1104	ENST00000235628.2	69	1173	++	1	Q9BXI3#1	0	66	ENST00000235628.2	69	135	+	66	0	0	5341
Q9BXI3#2	0	3	3	Q9BXI3	630	633	+	3	Q9BXI3	0	1104	ENST00000235628.2	69	1173	++	1	Q9BXI3#2	0	3	ENST00000235628.2	699	702	+	3	0	0	5342
Q9BXI3#3	0	9	9	Q9BXI3	24	33	+	9	Q9BXI3	0	1104	ENST00000235628.2	69	1173	++	1	Q9BXI3#3	0	9	ENST00000235628.2	93	102	+	9	0	0	5343
Q96P26-1#0	0	1830	1830	Q96P26-1	0	1830	+	1830	Q96P26-1	1071	1830	ENST00000418427.1	34	793	+	79	Q96P26-1#0	1071	1830	ENST00000418427.1	34	793	+	759	1071	0	5344
Q96P26-1#0	0	1830	1830	Q96P26-1	0	1830	+	1830	Q96P26-1	0	566	ENST00000416783.1	68	685	+	77	Q96P26-1#0	0	566	ENST00000416783.1	68	685	+	566	0	1264	5345
Q96P26-1#0	0	1830	1830	Q96P26-1	0	1830	+	1830	Q96P26-1	0	859	ENST00000406971.6	104	716	+	69	Q96P26-1#0	0	859	ENST00000406971.6	104	716	+	606	0	971	5346
Q96P26-1#0	0	1830	1830	Q96P26-1	0	1830	+	1830	Q96P26-1	0	1830	ENST00000359846.6	78	1908	++	37	Q96P26-1#0	0	1830	ENST00000359846.6	78	1908	+	1830	0	0	5347
Q96P26-1#0	0	1830	1830	Q96P26-1	0	1830	+	1830	Q96P26-1	297	1830	ENST00000304081.9	218	1751	++	20	Q96P26-1#0	297	1830	ENST00000304081.9	218	1751	+	1533	297	0	5348
Q96P26-1#1	0	102	102	Q96P26-1	0	102	+	102	Q96P26-1	0	566	ENST00000416783.1	68	685	+	77	Q96P26-1#1	0	102	ENST00000416783.1	68	170	+	102	0	0	5349
Q96P26-1#1	0	102	102	Q96P26-1	0	102	+	102	Q96P26-1	0	859	ENST00000406971.6	104	716	+	69	Q96P26-1#1	0	102	ENST00000406971.6	104	206	+	102	0	0	5350
Q96P26-1#1	0	102	102	Q96P26-1	0	102	+	102	Q96P26-1	0	1830	ENST00000359846.6	78	1908	++	37	Q96P26-1#1	0	102	ENST00000359846.6	78	180	+	102	0	0	5351
Q96P26-1#2	0	531	531	Q96P26-1	300	831	+	531	Q96P26-1	0	566	ENST00000416783.1	68	685	+	77	Q96P26-1#2	0	266	ENST00000416783.1	419	685	+	266	0	265	5352
Q96P26-1#2	0	531	531	Q96P26-1	300	831	+	531	Q96P26-1	0	859	ENST00000406971.6	104	716	+	69	Q96P26-1#2	0	531	ENST00000406971.6	224	688	+	458	0	0	5353
Q96P26-1#2	0	531	531	Q96P26-1	300	831	+	531	Q96P26-1	0	1830	ENST00000359846.6	78	1908	++	37	Q96P26-1#2	0	531	ENST00000359846.6	378	909	+	531	0	0	5354
Q96P26-1#2	0	531	531	Q96P26-1	300	831	+	531	Q96P26-1	297	1830	ENST00000304081.9	218	1751	++	20	Q96P26-1#2	0	531	ENST00000304081.9	221	752	+	531	0	0	5355
Q96P26-1#3	0	69	69	Q96P26-1	33	102	+	69	Q96P26-1	0	566	ENST00000416783.1	68	685	+	77	Q96P26-1#3	0	69	ENST00000416783.1	101	170	+	69	0	0	5356
Q96P26-1#3	0	69	69	Q96P26-1	33	102	+	69	Q96P26-1	0	859	ENST00000406971.6	104	716	+	69	Q96P26-1#3	0	69	ENST00000406971.6	137	206	+	69	0	0	5357
Q96P26-1#3	0	69	69	Q96P26-1	33	102	+	69	Q96P26-1	0	1830	ENST00000359846.6	78	1908	++	37	Q96P26-1#3	0	69	ENST00000359846.6	111	180	+	69	0	0	5358
Q96P26-1#4	0	213	213	Q96P26-1	300	513	+	213	Q96P26-1	0	566	ENST00000416783.1	68	685	+	77	Q96P26-1#4	0	213	ENST00000416783.1	419	632	+	213	0	0	5359
Q96P26-1#4	0	213	213	Q96P26-1	300	513	+	213	Q96P26-1	0	859	ENST00000406971.6	104	716	+	69	Q96P26-1#4	0	148	ENST00000406971.6	224	378	+	148	0	65	5360
Q96P26-1#4	0	213	213	Q96P26-1	300	513	+	213	Q96P26-1	0	1830	ENST00000359846.6	78	1908	++	37	Q96P26-1#4	0	213	ENST00000359846.6	378	591	+	213	0	0	5361
Q96P26-1#4	0	213	213	Q96P26-1	300	513	+	213	Q96P26-1	297	1830	ENST00000304081.9	218	1751	++	20	Q96P26-1#4	0	213	ENST00000304081.9	221	434	+	213	0	0	5362
Q96P26-1#5	0	90	90	Q96P26-1	513	603	+	90	Q96P26-1	0	566	ENST00000416783.1	68	685	+	77	Q96P26-1#5	0	53	ENST00000416783.1	632	685	+	53	0	37	5363
Q96P26-1#5	0	90	90	Q96P26-1	513	603	+	90	Q96P26-1	0	859	ENST00000406971.6	104	716	+	69	Q96P26-1#5	8	90	ENST00000406971.6	378	460	+	82	8	0	5364
Q96P26-1#5	0	90	90	Q96P26-1	513	603	+	90	Q96P26-1	0	1830	ENST00000359846.6	78	1908	++	37	Q96P26-1#5	0	90	ENST00000359846.6	591	681	+	90	0	0	5365
Q96P26-1#5	0	90	90	Q96P26-1	513	603	+	90	Q96P26-1	297	1830	ENST00000304081.9	218	1751	++	20	Q96P26-1#5	0	90	ENST00000304081.9	434	524	+	90	0	0	5366
Q96P26-1#6	0	108	108	Q96P26-1	690	798	+	108	Q96P26-1	0	859	ENST00000406971.6	104	716	+	69	Q96P26-1#6	0	108	ENST00000406971.6	547	655	+	108	0	0	5367
Q96P26-1#6	0	108	108	Q96P26-1	690	798	+	108	Q96P26-1	0	1830	ENST00000359846.6	78	1908	++	37	Q96P26-1#6	0	108	ENST00000359846.6	768	876	+	108	0	0	5368
Q96P26-1#6	0	108	108	Q96P26-1	690	798	+	108	Q96P26-1	297	1830	ENST00000304081.9	218	1751	++	20	Q96P26-1#6	0	108	ENST00000304081.9	611	719	+	108	0	0	5369
Q96P26-1#7	0	3	3	Q96P26-1	1398	1401	+	3	Q96P26-1	1071	1830	ENST00000418427.1	34	793	+	79	Q96P26-1#7	0	3	ENST00000418427.1	361	364	+	3	0	0	5370
Q96P26-1#7	0	3	3	Q96P26-1	1398	1401	+	3	Q96P26-1	0	1830	ENST00000359846.6	78	1908	++	37	Q96P26-1#7	0	3	ENST00000359846.6	1476	1479	+	3	0	0	5371
Q96P26-1#7	0	3	3	Q96P26-1	1398	1401	+	3	Q96P26-1	297	1830	ENST00000304081.9	218	1751	++	20	Q96P26-1#7	0	3	ENST00000304081.9	1319	1322	+	3	0	0	5372
Q96P26-1#8	0	624	624	Q96P26-1	0	624	+	624	Q96P26-1	0	566	ENST00000416783.1	68	685	+	77	Q96P26-1#8	0	566	ENST00000416783.1	68	685	+	566	0	58	5373
Q96P26-1#8	0	624	624	Q96P26-1	0	624	+	624	Q96P26-1	0	859	ENST00000406971.6	104	716	+	69	Q96P26-1#8	0	624	ENST00000406971.6	104	481	+	371	0	0	5374
Q96P26-1#8	0	624	624	Q96P26-1	0	624	+	624	Q96P26-1	0	1830	ENST00000359846.6	78	1908	++	37	Q96P26-1#8	0	624	ENST00000359846.6	78	702	+	624	0	0	5375
Q96P26-1#8	0	624	624	Q96P26-1	0	624	+	624	Q96P26-1	297	1830	ENST00000304081.9	218	1751	++	20	Q96P26-1#8	297	624	ENST00000304081.9	218	545	+	327	297	0	5376
Q96P26-1#9	0	180	180	Q96P26-1	120	300	+	180	Q96P26-1	0	566	ENST00000416783.1	68	685	+	77	Q96P26-1#9	0	180	ENST00000416783.1	188	368	+	180	0	0	5377
Q96P26-1#9	0	180	180	Q96P26-1	120	300	+	180	Q96P26-1	0	1830	ENST00000359846.6	78	1908	++	37	Q96P26-1#9	0	180	ENST00000359846.6	198	378	+	180	0	0	5378
Q96P26-1#9	0	180	180	Q96P26-1	120	300	+	180	Q96P26-1	297	1830	ENST00000304081.9	218	1751	++	20	Q96P26-1#9	177	180	ENST00000304081.9	218	221	+	3	177	0	5379
Q96P26-1#10	0	45	45	Q96P26-1	1785	1830	+	45	Q96P26-1	1071	1830	ENST00000418427.1	34	793	+	79	Q96P26-1#10	0	45	ENST00000418427.1	748	793	+	45	0	0	5380
Q96P26-1#10	0	45	45	Q96P26-1	1785	1830	+	45	Q96P26-1	0	1830	ENST00000359846.6	78	1908	++	37	Q96P26-1#10	0	45	ENST00000359846.6	1863	1908	+	45	0	0	5381
Q96P26-1#10	0	45	45	Q96P26-1	1785	1830	+	45	Q96P26-1	297	1830	ENST00000304081.9	218	1751	++	20	Q96P26-1#10	0	45	ENST00000304081.9	1706	1751	+	45	0	0	5382
Q96P26-1#11	0	3	3	Q96P26-1	516	519	+	3	Q96P26-1	0	566	ENST00000416783.1	68	685	+	77	Q96P26-1#11	0	3	ENST00000416783.1	635	638	+	3	0	0	5383
Q96P26-1#11	0	3	3	Q96P26-1	516	519	+	3	Q96P26-1	0	1830	ENST00000359846.6	78	1908	++	37	Q96P26-1#11	0	3	ENST00000359846.6	594	597	+	3	0	0	5384
Q96P26-1#11	0	3	3	Q96P26-1	516	519	+	3	Q96P26-1	297	1830	ENST00000304081.9	218	1751	++	20	Q96P26-1#11	0	3	ENST00000304081.9	437	440	+	3	0	0	5385
Q96P26-1#12	0	3	3	Q96P26-1	858	861	+	3	Q96P26-1	0	859	ENST00000406971.6	104	716	+	69	Q96P26-1#12	0	1	ENST00000406971.6	715	716	+	1	0	2	5386
Q96P26-1#12	0	3	3	Q96P26-1	858	861	+	3	Q96P26-1	0	1830	ENST00000359846.6	78	1908	++	37	Q96P26-1#12	0	3	ENST00000359846.6	936	939	+	3	0	0	5387
Q96P26-1#12	0	3	3	Q96P26-1	858	861	+	3	Q96P26-1	297	1830	ENST00000304081.9	218	1751	++	20	Q96P26-1#12	0	3	ENST00000304081.9	779	782	+	3	0	0	5388
Q96P26-1#13	0	3	3	Q96P26-1	888	891	+	3	Q96P26-1	0	1830	ENST00000359846.6	78	1908	++	37	Q96P26-1#13	0	3	ENST00000359846.6	966	969	+	3	0	0	5389
Q96P26-1#13	0	3	3	Q96P26-1	888	891	+	3	Q96P26-1	297	1830	ENST00000304081.9	218	1751	++	20	Q96P26-1#13	0	3	ENST00000304081.9	809	812	+	3	0	0	5390
Q96P26-1#14	0	3	3	Q96P26-1	1050	1053	+	3	Q96P26-1	0	1830	ENST00000359846.6	78	1908	++	37	Q96P26-1#14	0	3	ENST00000359846.6	1128	1131	+	3	0	0	5391
Q96P26-1#14	0	3	3	Q96P26-1	1050	1053	+	3	Q96P26-1	297	1830	ENST00000304081.9	218	1751	++	20	Q96P26-1#14	0	3	ENST00000304081.9	971	974	+	3	0	0	5392
Q96P26-1#15	0	3	3	Q96P26-1	1083	1086	+	3	Q96P26-1	1071	1830	ENST00000418427.1	34	793	+	79	Q96P26-1#15	0	3	ENST00000418427.1	46	49	+	3	0	0	5393
Q96P26-1#15	0	3	3	Q96P26-1	1083	1086	+	3	Q96P26-1	0	1830	ENST00000359846.6	78	1908	++	37	Q96P26-1#15	0	3	ENST00000359846.6	1161	1164	+	3	0	0	5394
Q96P26-1#15	0	3	3	Q96P26-1	1083	1086	+	3	Q96P26-1	297	1830	ENST00000304081.9	218	1751	++	20	Q96P26-1#15	0	3	ENST00000304081.9	1004	1007	+	3	0	0	5395
Q96P26-1#16	0	3	3	Q96P26-1	1581	1584	+	3	Q96P26-1	1071	1830	ENST00000418427.1	34	793	+	79	Q96P26-1#16	0	3	ENST00000418427.1	544	547	+	3	0	0	5396
Q96P26-1#16	0	3	3	Q96P26-1	1581	1584	+	3	Q96P26-1	0	1830	ENST00000359846.6	78	1908	++	37	Q96P26-1#16	0	3	ENST00000359846.6	1659	1662	+	3	0	0	5397
Q96P26-1#16	0	3	3	Q96P26-1	1581	1584	+	3	Q96P26-1	297	1830	ENST00000304081.9	218	1751	++	20	Q96P26-1#16	0	3	ENST00000304081.9	1502	1505	+	3	0	0	5398
Q96P26-1#17	0	3	3	Q96P26-1	1653	1656	+	3	Q96P26-1	1071	1830	ENST00000418427.1	34	793	+	79	Q96P26-1#17	0	3	ENST00000418427.1	616	619	+	3	0	0	5399
Q96P26-1#17	0	3	3	Q96P26-1	1653	1656	+	3	Q96P26-1	0	1830	ENST00000359846.6	78	1908	++	37	Q96P26-1#17	0	3	ENST00000359846.6	1731	1734	+	3	0	0	5400
Q96P26-1#17	0	3	3	Q96P26-1	1653	1656	+	3	Q96P26-1	297	1830	ENST00000304081.9	218	1751	++	20	Q96P26-1#17	0	3	ENST00000304081.9	1574	1577	+	3	0	0	5401
Q9H0P0-4#0	0	1008	1008	Q9H0P0-4	0	1008	+	1008	Q9H0P0-4	144	1008	ENST00000643244.1	75	939	++	237	Q9H0P0-4#0	144	1008	ENST00000643244.1	75	939	+	864	144	0	5402
Q9H0P0-4#0	0	1008	1008	Q9H0P0-4	0	1008	+	1008	Q9H0P0-4	153	1008	ENST00000610140.7	209	1064	+	229	Q9H0P0-4#0	153	1008	ENST00000610140.7	209	1064	+	855	153	0	5403
Q9H0P0-4#0	0	1008	1008	Q9H0P0-4	0	1008	+	1008	Q9H0P0-4	153	280	ENST00000449201.5	179	306	+	99	Q9H0P0-4#0	153	280	ENST00000449201.5	179	306	+	127	153	728	5404
Q9H0P0-4#0	0	1008	1008	Q9H0P0-4	0	1008	+	1008	Q9H0P0-4	144	708	ENST00000409787.4	41	605	+	71	Q9H0P0-4#0	144	708	ENST00000409787.4	41	605	+	564	144	300	5405
Q9H0P0-4#0	0	1008	1008	Q9H0P0-4	0	1008	+	1008	Q9H0P0-4	153	1008	ENST00000409467.6	174	1029	++	70	Q9H0P0-4#0	153	1008	ENST00000409467.6	174	1029	+	855	153	0	5406
Q9H0P0-4#1	0	3	3	Q9H0P0-4	261	264	+	3	Q9H0P0-4	144	1008	ENST00000643244.1	75	939	++	237	Q9H0P0-4#1	0	3	ENST00000643244.1	192	195	+	3	0	0	5407
Q9H0P0-4#1	0	3	3	Q9H0P0-4	261	264	+	3	Q9H0P0-4	153	1008	ENST00000610140.7	209	1064	+	229	Q9H0P0-4#1	0	3	ENST00000610140.7	317	320	+	3	0	0	5408
Q9H0P0-4#1	0	3	3	Q9H0P0-4	261	264	+	3	Q9H0P0-4	153	280	ENST00000449201.5	179	306	+	99	Q9H0P0-4#1	0	3	ENST00000449201.5	287	290	+	3	0	0	5409
Q9H0P0-4#1	0	3	3	Q9H0P0-4	261	264	+	3	Q9H0P0-4	144	708	ENST00000409787.4	41	605	+	71	Q9H0P0-4#1	0	3	ENST00000409787.4	158	161	+	3	0	0	5410
Q9H0P0-4#1	0	3	3	Q9H0P0-4	261	264	+	3	Q9H0P0-4	153	1008	ENST00000409467.6	174	1029	++	70	Q9H0P0-4#1	0	3	ENST00000409467.6	282	285	+	3	0	0	5411
Q9H0P0-4#2	0	3	3	Q9H0P0-4	267	270	+	3	Q9H0P0-4	144	1008	ENST00000643244.1	75	939	++	237	Q9H0P0-4#2	0	3	ENST00000643244.1	198	201	+	3	0	0	5412
Q9H0P0-4#2	0	3	3	Q9H0P0-4	267	270	+	3	Q9H0P0-4	153	1008	ENST00000610140.7	209	1064	+	229	Q9H0P0-4#2	0	3	ENST00000610140.7	323	326	+	3	0	0	5413
Q9H0P0-4#2	0	3	3	Q9H0P0-4	267	270	+	3	Q9H0P0-4	153	280	ENST00000449201.5	179	306	+	99	Q9H0P0-4#2	0	3	ENST00000449201.5	293	296	+	3	0	0	5414
Q9H0P0-4#2	0	3	3	Q9H0P0-4	267	270	+	3	Q9H0P0-4	144	708	ENST00000409787.4	41	605	+	71	Q9H0P0-4#2	0	3	ENST00000409787.4	164	167	+	3	0	0	5415
Q9H0P0-4#2	0	3	3	Q9H0P0-4	267	270	+	3	Q9H0P0-4	153	1008	ENST00000409467.6	174	1029	++	70	Q9H0P0-4#2	0	3	ENST00000409467.6	288	291	+	3	0	0	5416
Q9H0P0-4#3	0	3	3	Q9H0P0-4	261	264	+	3	Q9H0P0-4	144	1008	ENST00000643244.1	75	939	++	237	Q9H0P0-4#3	0	3	ENST00000643244.1	192	195	+	3	0	0	5417
Q9H0P0-4#3	0	3	3	Q9H0P0-4	261	264	+	3	Q9H0P0-4	153	1008	ENST00000610140.7	209	1064	+	229	Q9H0P0-4#3	0	3	ENST00000610140.7	317	320	+	3	0	0	5418
Q9H0P0-4#3	0	3	3	Q9H0P0-4	261	264	+	3	Q9H0P0-4	153	280	ENST00000449201.5	179	306	+	99	Q9H0P0-4#3	0	3	ENST00000449201.5	287	290	+	3	0	0	5419
Q9H0P0-4#3	0	3	3	Q9H0P0-4	261	264	+	3	Q9H0P0-4	144	708	ENST00000409787.4	41	605	+	71	Q9H0P0-4#3	0	3	ENST00000409787.4	158	161	+	3	0	0	5420
Q9H0P0-4#3	0	3	3	Q9H0P0-4	261	264	+	3	Q9H0P0-4	153	1008	ENST00000409467.6	174	1029	++	70	Q9H0P0-4#3	0	3	ENST00000409467.6	282	285	+	3	0	0	5421
Q9H0P0-4#4	0	3	3	Q9H0P0-4	267	270	+	3	Q9H0P0-4	144	1008	ENST00000643244.1	75	939	++	237	Q9H0P0-4#4	0	3	ENST00000643244.1	198	201	+	3	0	0	5422
Q9H0P0-4#4	0	3	3	Q9H0P0-4	267	270	+	3	Q9H0P0-4	153	1008	ENST00000610140.7	209	1064	+	229	Q9H0P0-4#4	0	3	ENST00000610140.7	323	326	+	3	0	0	5423
Q9H0P0-4#4	0	3	3	Q9H0P0-4	267	270	+	3	Q9H0P0-4	153	280	ENST00000449201.5	179	306	+	99	Q9H0P0-4#4	0	3	ENST00000449201.5	293	296	+	3	0	0	5424
Q9H0P0-4#4	0	3	3	Q9H0P0-4	267	270	+	3	Q9H0P0-4	144	708	ENST00000409787.4	41	605	+	71	Q9H0P0-4#4	0	3	ENST00000409787.4	164	167	+	3	0	0	5425
Q9H0P0-4#4	0	3	3	Q9H0P0-4	267	270	+	3	Q9H0P0-4	153	1008	ENST00000409467.6	174	1029	++	70	Q9H0P0-4#4	0	3	ENST00000409467.6	288	291	+	3	0	0	5426
Q9H0P0-4#5	0	3	3	Q9H0P0-4	402	405	+	3	Q9H0P0-4	144	1008	ENST00000643244.1	75	939	++	237	Q9H0P0-4#5	0	3	ENST00000643244.1	333	336	+	3	0	0	5427
Q9H0P0-4#5	0	3	3	Q9H0P0-4	402	405	+	3	Q9H0P0-4	153	1008	ENST00000610140.7	209	1064	+	229	Q9H0P0-4#5	0	3	ENST00000610140.7	458	461	+	3	0	0	5428
Q9H0P0-4#5	0	3	3	Q9H0P0-4	402	405	+	3	Q9H0P0-4	144	708	ENST00000409787.4	41	605	+	71	Q9H0P0-4#5	0	3	ENST00000409787.4	299	302	+	3	0	0	5429
Q9H0P0-4#5	0	3	3	Q9H0P0-4	402	405	+	3	Q9H0P0-4	153	1008	ENST00000409467.6	174	1029	++	70	Q9H0P0-4#5	0	3	ENST00000409467.6	423	426	+	3	0	0	5430
Q9H0P0-4#6	0	3	3	Q9H0P0-4	402	405	+	3	Q9H0P0-4	144	1008	ENST00000643244.1	75	939	++	237	Q9H0P0-4#6	0	3	ENST00000643244.1	333	336	+	3	0	0	5431
Q9H0P0-4#6	0	3	3	Q9H0P0-4	402	405	+	3	Q9H0P0-4	153	1008	ENST00000610140.7	209	1064	+	229	Q9H0P0-4#6	0	3	ENST00000610140.7	458	461	+	3	0	0	5432
Q9H0P0-4#6	0	3	3	Q9H0P0-4	402	405	+	3	Q9H0P0-4	144	708	ENST00000409787.4	41	605	+	71	Q9H0P0-4#6	0	3	ENST00000409787.4	299	302	+	3	0	0	5433
Q9H0P0-4#6	0	3	3	Q9H0P0-4	402	405	+	3	Q9H0P0-4	153	1008	ENST00000409467.6	174	1029	++	70	Q9H0P0-4#6	0	3	ENST00000409467.6	423	426	+	3	0	0	5434
Q9H0P0-4#7	0	3	3	Q9H0P0-4	465	468	+	3	Q9H0P0-4	144	1008	ENST00000643244.1	75	939	++	237	Q9H0P0-4#7	0	3	ENST00000643244.1	396	399	+	3	0	0	5435
Q9H0P0-4#7	0	3	3	Q9H0P0-4	465	468	+	3	Q9H0P0-4	153	1008	ENST00000610140.7	209	1064	+	229	Q9H0P0-4#7	0	3	ENST00000610140.7	521	524	+	3	0	0	5436
Q9H0P0-4#7	0	3	3	Q9H0P0-4	465	468	+	3	Q9H0P0-4	144	708	ENST00000409787.4	41	605	+	71	Q9H0P0-4#7	0	3	ENST00000409787.4	362	365	+	3	0	0	5437
Q9H0P0-4#7	0	3	3	Q9H0P0-4	465	468	+	3	Q9H0P0-4	153	1008	ENST00000409467.6	174	1029	++	70	Q9H0P0-4#7	0	3	ENST00000409467.6	486	489	+	3	0	0	5438
Q9H0P0-4#8	0	6	6	Q9H0P0-4	606	612	+	6	Q9H0P0-4	144	1008	ENST00000643244.1	75	939	++	237	Q9H0P0-4#8	0	6	ENST00000643244.1	537	543	+	6	0	0	5439
Q9H0P0-4#8	0	6	6	Q9H0P0-4	606	612	+	6	Q9H0P0-4	153	1008	ENST00000610140.7	209	1064	+	229	Q9H0P0-4#8	0	6	ENST00000610140.7	662	668	+	6	0	0	5440
Q9H0P0-4#8	0	6	6	Q9H0P0-4	606	612	+	6	Q9H0P0-4	144	708	ENST00000409787.4	41	605	+	71	Q9H0P0-4#8	0	6	ENST00000409787.4	503	509	+	6	0	0	5441
Q9H0P0-4#8	0	6	6	Q9H0P0-4	606	612	+	6	Q9H0P0-4	153	1008	ENST00000409467.6	174	1029	++	70	Q9H0P0-4#8	0	6	ENST00000409467.6	627	633	+	6	0	0	5442
Q9H0P0-4#9	0	3	3	Q9H0P0-4	753	756	+	3	Q9H0P0-4	144	1008	ENST00000643244.1	75	939	++	237	Q9H0P0-4#9	0	3	ENST00000643244.1	684	687	+	3	0	0	5443
Q9H0P0-4#9	0	3	3	Q9H0P0-4	753	756	+	3	Q9H0P0-4	153	1008	ENST00000610140.7	209	1064	+	229	Q9H0P0-4#9	0	3	ENST00000610140.7	809	812	+	3	0	0	5444
Q9H0P0-4#9	0	3	3	Q9H0P0-4	753	756	+	3	Q9H0P0-4	153	1008	ENST00000409467.6	174	1029	++	70	Q9H0P0-4#9	0	3	ENST00000409467.6	774	777	+	3	0	0	5445
Q9H0P0-4#10	0	3	3	Q9H0P0-4	828	831	+	3	Q9H0P0-4	144	1008	ENST00000643244.1	75	939	++	237	Q9H0P0-4#10	0	3	ENST00000643244.1	759	762	+	3	0	0	5446
Q9H0P0-4#10	0	3	3	Q9H0P0-4	828	831	+	3	Q9H0P0-4	153	1008	ENST00000610140.7	209	1064	+	229	Q9H0P0-4#10	0	3	ENST00000610140.7	884	887	+	3	0	0	5447
Q9H0P0-4#10	0	3	3	Q9H0P0-4	828	831	+	3	Q9H0P0-4	153	1008	ENST00000409467.6	174	1029	++	70	Q9H0P0-4#10	0	3	ENST00000409467.6	849	852	+	3	0	0	5448
Q9H0P0-4#11	0	3	3	Q9H0P0-4	831	834	+	3	Q9H0P0-4	144	1008	ENST00000643244.1	75	939	++	237	Q9H0P0-4#11	0	3	ENST00000643244.1	762	765	+	3	0	0	5449
Q9H0P0-4#11	0	3	3	Q9H0P0-4	831	834	+	3	Q9H0P0-4	153	1008	ENST00000610140.7	209	1064	+	229	Q9H0P0-4#11	0	3	ENST00000610140.7	887	890	+	3	0	0	5450
Q9H0P0-4#11	0	3	3	Q9H0P0-4	831	834	+	3	Q9H0P0-4	153	1008	ENST00000409467.6	174	1029	++	70	Q9H0P0-4#11	0	3	ENST00000409467.6	852	855	+	3	0	0	5451
Q9H0P0-4#12	0	153	153	Q9H0P0-4	0	153	+	153	Q9H0P0-4	144	1008	ENST00000643244.1	75	939	++	237	Q9H0P0-4#12	144	153	ENST00000643244.1	75	84	+	9	144	0	5452
Q9H0P0-4#12	0	153	153	Q9H0P0-4	0	153	+	153	Q9H0P0-4	144	708	ENST00000409787.4	41	605	+	71	Q9H0P0-4#12	144	153	ENST00000409787.4	41	50	+	9	144	0	5453
Q9H0P0-4#13	0	150	150	Q9H0P0-4	0	150	+	150	Q9H0P0-4	144	1008	ENST00000643244.1	75	939	++	237	Q9H0P0-4#13	144	150	ENST00000643244.1	75	81	+	6	144	0	5454
Q9H0P0-4#13	0	150	150	Q9H0P0-4	0	150	+	150	Q9H0P0-4	144	708	ENST00000409787.4	41	605	+	71	Q9H0P0-4#13	144	150	ENST00000409787.4	41	47	+	6	144	0	5455
Q9H0P0-4#14	0	150	150	Q9H0P0-4	0	150	+	150	Q9H0P0-4	144	1008	ENST00000643244.1	75	939	++	237	Q9H0P0-4#14	144	150	ENST00000643244.1	75	81	+	6	144	0	5456
Q9H0P0-4#14	0	150	150	Q9H0P0-4	0	150	+	150	Q9H0P0-4	144	708	ENST00000409787.4	41	605	+	71	Q9H0P0-4#14	144	150	ENST00000409787.4	41	47	+	6	144	0	5457
Q9H0P0-4#15	0	3	3	Q9H0P0-4	282	285	+	3	Q9H0P0-4	144	1008	ENST00000643244.1	75	939	++	237	Q9H0P0-4#15	0	3	ENST00000643244.1	213	216	+	3	0	0	5458
Q9H0P0-4#15	0	3	3	Q9H0P0-4	282	285	+	3	Q9H0P0-4	153	1008	ENST00000610140.7	209	1064	+	229	Q9H0P0-4#15	0	3	ENST00000610140.7	338	341	+	3	0	0	5459
Q9H0P0-4#15	0	3	3	Q9H0P0-4	282	285	+	3	Q9H0P0-4	144	708	ENST00000409787.4	41	605	+	71	Q9H0P0-4#15	0	3	ENST00000409787.4	179	182	+	3	0	0	5460
Q9H0P0-4#15	0	3	3	Q9H0P0-4	282	285	+	3	Q9H0P0-4	153	1008	ENST00000409467.6	174	1029	++	70	Q9H0P0-4#15	0	3	ENST00000409467.6	303	306	+	3	0	0	5461
Q9H0P0-4#16	0	3	3	Q9H0P0-4	336	339	+	3	Q9H0P0-4	144	1008	ENST00000643244.1	75	939	++	237	Q9H0P0-4#16	0	3	ENST00000643244.1	267	270	+	3	0	0	5462
Q9H0P0-4#16	0	3	3	Q9H0P0-4	336	339	+	3	Q9H0P0-4	153	1008	ENST00000610140.7	209	1064	+	229	Q9H0P0-4#16	0	3	ENST00000610140.7	392	395	+	3	0	0	5463
Q9H0P0-4#16	0	3	3	Q9H0P0-4	336	339	+	3	Q9H0P0-4	144	708	ENST00000409787.4	41	605	+	71	Q9H0P0-4#16	0	3	ENST00000409787.4	233	236	+	3	0	0	5464
Q9H0P0-4#16	0	3	3	Q9H0P0-4	336	339	+	3	Q9H0P0-4	153	1008	ENST00000409467.6	174	1029	++	70	Q9H0P0-4#16	0	3	ENST00000409467.6	357	360	+	3	0	0	5465
Q9H0P0-4#17	0	3	3	Q9H0P0-4	408	411	+	3	Q9H0P0-4	144	1008	ENST00000643244.1	75	939	++	237	Q9H0P0-4#17	0	3	ENST00000643244.1	339	342	+	3	0	0	5466
Q9H0P0-4#17	0	3	3	Q9H0P0-4	408	411	+	3	Q9H0P0-4	153	1008	ENST00000610140.7	209	1064	+	229	Q9H0P0-4#17	0	3	ENST00000610140.7	464	467	+	3	0	0	5467
Q9H0P0-4#17	0	3	3	Q9H0P0-4	408	411	+	3	Q9H0P0-4	144	708	ENST00000409787.4	41	605	+	71	Q9H0P0-4#17	0	3	ENST00000409787.4	305	308	+	3	0	0	5468
Q9H0P0-4#17	0	3	3	Q9H0P0-4	408	411	+	3	Q9H0P0-4	153	1008	ENST00000409467.6	174	1029	++	70	Q9H0P0-4#17	0	3	ENST00000409467.6	429	432	+	3	0	0	5469
Q9H0P0-4#18	0	3	3	Q9H0P0-4	540	543	+	3	Q9H0P0-4	144	1008	ENST00000643244.1	75	939	++	237	Q9H0P0-4#18	0	3	ENST00000643244.1	471	474	+	3	0	0	5470
Q9H0P0-4#18	0	3	3	Q9H0P0-4	540	543	+	3	Q9H0P0-4	153	1008	ENST00000610140.7	209	1064	+	229	Q9H0P0-4#18	0	3	ENST00000610140.7	596	599	+	3	0	0	5471
Q9H0P0-4#18	0	3	3	Q9H0P0-4	540	543	+	3	Q9H0P0-4	144	708	ENST00000409787.4	41	605	+	71	Q9H0P0-4#18	0	3	ENST00000409787.4	437	440	+	3	0	0	5472
Q9H0P0-4#18	0	3	3	Q9H0P0-4	540	543	+	3	Q9H0P0-4	153	1008	ENST00000409467.6	174	1029	++	70	Q9H0P0-4#18	0	3	ENST00000409467.6	561	564	+	3	0	0	5473
Q9H0P0-4#19	0	3	3	Q9H0P0-4	618	621	+	3	Q9H0P0-4	144	1008	ENST00000643244.1	75	939	++	237	Q9H0P0-4#19	0	3	ENST00000643244.1	549	552	+	3	0	0	5474
Q9H0P0-4#19	0	3	3	Q9H0P0-4	618	621	+	3	Q9H0P0-4	153	1008	ENST00000610140.7	209	1064	+	229	Q9H0P0-4#19	0	3	ENST00000610140.7	674	677	+	3	0	0	5475
Q9H0P0-4#19	0	3	3	Q9H0P0-4	618	621	+	3	Q9H0P0-4	144	708	ENST00000409787.4	41	605	+	71	Q9H0P0-4#19	0	3	ENST00000409787.4	515	518	+	3	0	0	5476
Q9H0P0-4#19	0	3	3	Q9H0P0-4	618	621	+	3	Q9H0P0-4	153	1008	ENST00000409467.6	174	1029	++	70	Q9H0P0-4#19	0	3	ENST00000409467.6	639	642	+	3	0	0	5477
Q9H0P0-4#20	0	3	3	Q9H0P0-4	684	687	+	3	Q9H0P0-4	144	1008	ENST00000643244.1	75	939	++	237	Q9H0P0-4#20	0	3	ENST00000643244.1	615	618	+	3	0	0	5478
Q9H0P0-4#20	0	3	3	Q9H0P0-4	684	687	+	3	Q9H0P0-4	153	1008	ENST00000610140.7	209	1064	+	229	Q9H0P0-4#20	0	3	ENST00000610140.7	740	743	+	3	0	0	5479
Q9H0P0-4#20	0	3	3	Q9H0P0-4	684	687	+	3	Q9H0P0-4	144	708	ENST00000409787.4	41	605	+	71	Q9H0P0-4#20	0	3	ENST00000409787.4	581	584	+	3	0	0	5480
Q9H0P0-4#20	0	3	3	Q9H0P0-4	684	687	+	3	Q9H0P0-4	153	1008	ENST00000409467.6	174	1029	++	70	Q9H0P0-4#20	0	3	ENST00000409467.6	705	708	+	3	0	0	5481
Q9H0P0-4#21	0	3	3	Q9H0P0-4	837	840	+	3	Q9H0P0-4	144	1008	ENST00000643244.1	75	939	++	237	Q9H0P0-4#21	0	3	ENST00000643244.1	768	771	+	3	0	0	5482
Q9H0P0-4#21	0	3	3	Q9H0P0-4	837	840	+	3	Q9H0P0-4	153	1008	ENST00000610140.7	209	1064	+	229	Q9H0P0-4#21	0	3	ENST00000610140.7	893	896	+	3	0	0	5483
Q9H0P0-4#21	0	3	3	Q9H0P0-4	837	840	+	3	Q9H0P0-4	153	1008	ENST00000409467.6	174	1029	++	70	Q9H0P0-4#21	0	3	ENST00000409467.6	858	861	+	3	0	0	5484
Q9H0P0-4#22	0	3	3	Q9H0P0-4	888	891	+	3	Q9H0P0-4	144	1008	ENST00000643244.1	75	939	++	237	Q9H0P0-4#22	0	3	ENST00000643244.1	819	822	+	3	0	0	5485
Q9H0P0-4#22	0	3	3	Q9H0P0-4	888	891	+	3	Q9H0P0-4	153	1008	ENST00000610140.7	209	1064	+	229	Q9H0P0-4#22	0	3	ENST00000610140.7	944	947	+	3	0	0	5486
Q9H0P0-4#22	0	3	3	Q9H0P0-4	888	891	+	3	Q9H0P0-4	153	1008	ENST00000409467.6	174	1029	++	70	Q9H0P0-4#22	0	3	ENST00000409467.6	909	912	+	3	0	0	5487
Q9H0P0-4#23	0	3	3	Q9H0P0-4	261	264	+	3	Q9H0P0-4	144	1008	ENST00000643244.1	75	939	++	237	Q9H0P0-4#23	0	3	ENST00000643244.1	192	195	+	3	0	0	5488
Q9H0P0-4#23	0	3	3	Q9H0P0-4	261	264	+	3	Q9H0P0-4	153	1008	ENST00000610140.7	209	1064	+	229	Q9H0P0-4#23	0	3	ENST00000610140.7	317	320	+	3	0	0	5489
Q9H0P0-4#23	0	3	3	Q9H0P0-4	261	264	+	3	Q9H0P0-4	153	280	ENST00000449201.5	179	306	+	99	Q9H0P0-4#23	0	3	ENST00000449201.5	287	290	+	3	0	0	5490
Q9H0P0-4#23	0	3	3	Q9H0P0-4	261	264	+	3	Q9H0P0-4	144	708	ENST00000409787.4	41	605	+	71	Q9H0P0-4#23	0	3	ENST00000409787.4	158	161	+	3	0	0	5491
Q9H0P0-4#23	0	3	3	Q9H0P0-4	261	264	+	3	Q9H0P0-4	153	1008	ENST00000409467.6	174	1029	++	70	Q9H0P0-4#23	0	3	ENST00000409467.6	282	285	+	3	0	0	5492
Q9H0P0-4#24	0	3	3	Q9H0P0-4	264	267	+	3	Q9H0P0-4	144	1008	ENST00000643244.1	75	939	++	237	Q9H0P0-4#24	0	3	ENST00000643244.1	195	198	+	3	0	0	5493
Q9H0P0-4#24	0	3	3	Q9H0P0-4	264	267	+	3	Q9H0P0-4	153	1008	ENST00000610140.7	209	1064	+	229	Q9H0P0-4#24	0	3	ENST00000610140.7	320	323	+	3	0	0	5494
Q9H0P0-4#24	0	3	3	Q9H0P0-4	264	267	+	3	Q9H0P0-4	153	280	ENST00000449201.5	179	306	+	99	Q9H0P0-4#24	0	3	ENST00000449201.5	290	293	+	3	0	0	5495
Q9H0P0-4#24	0	3	3	Q9H0P0-4	264	267	+	3	Q9H0P0-4	144	708	ENST00000409787.4	41	605	+	71	Q9H0P0-4#24	0	3	ENST00000409787.4	161	164	+	3	0	0	5496
Q9H0P0-4#24	0	3	3	Q9H0P0-4	264	267	+	3	Q9H0P0-4	153	1008	ENST00000409467.6	174	1029	++	70	Q9H0P0-4#24	0	3	ENST00000409467.6	285	288	+	3	0	0	5497
Q9H0P0-4#25	0	3	3	Q9H0P0-4	267	270	+	3	Q9H0P0-4	144	1008	ENST00000643244.1	75	939	++	237	Q9H0P0-4#25	0	3	ENST00000643244.1	198	201	+	3	0	0	5498
Q9H0P0-4#25	0	3	3	Q9H0P0-4	267	270	+	3	Q9H0P0-4	153	1008	ENST00000610140.7	209	1064	+	229	Q9H0P0-4#25	0	3	ENST00000610140.7	323	326	+	3	0	0	5499
Q9H0P0-4#25	0	3	3	Q9H0P0-4	267	270	+	3	Q9H0P0-4	153	280	ENST00000449201.5	179	306	+	99	Q9H0P0-4#25	0	3	ENST00000449201.5	293	296	+	3	0	0	5500
Q9H0P0-4#25	0	3	3	Q9H0P0-4	267	270	+	3	Q9H0P0-4	144	708	ENST00000409787.4	41	605	+	71	Q9H0P0-4#25	0	3	ENST00000409787.4	164	167	+	3	0	0	5501
Q9H0P0-4#25	0	3	3	Q9H0P0-4	267	270	+	3	Q9H0P0-4	153	1008	ENST00000409467.6	174	1029	++	70	Q9H0P0-4#25	0	3	ENST00000409467.6	288	291	+	3	0	0	5502
Q9H0P0-4#26	0	3	3	Q9H0P0-4	402	405	+	3	Q9H0P0-4	144	1008	ENST00000643244.1	75	939	++	237	Q9H0P0-4#26	0	3	ENST00000643244.1	333	336	+	3	0	0	5503
Q9H0P0-4#26	0	3	3	Q9H0P0-4	402	405	+	3	Q9H0P0-4	153	1008	ENST00000610140.7	209	1064	+	229	Q9H0P0-4#26	0	3	ENST00000610140.7	458	461	+	3	0	0	5504
Q9H0P0-4#26	0	3	3	Q9H0P0-4	402	405	+	3	Q9H0P0-4	144	708	ENST00000409787.4	41	605	+	71	Q9H0P0-4#26	0	3	ENST00000409787.4	299	302	+	3	0	0	5505
Q9H0P0-4#26	0	3	3	Q9H0P0-4	402	405	+	3	Q9H0P0-4	153	1008	ENST00000409467.6	174	1029	++	70	Q9H0P0-4#26	0	3	ENST00000409467.6	423	426	+	3	0	0	5506
Q9H0P0-4#27	0	3	3	Q9H0P0-4	693	696	+	3	Q9H0P0-4	144	1008	ENST00000643244.1	75	939	++	237	Q9H0P0-4#27	0	3	ENST00000643244.1	624	627	+	3	0	0	5507
Q9H0P0-4#27	0	3	3	Q9H0P0-4	693	696	+	3	Q9H0P0-4	153	1008	ENST00000610140.7	209	1064	+	229	Q9H0P0-4#27	0	3	ENST00000610140.7	749	752	+	3	0	0	5508
Q9H0P0-4#27	0	3	3	Q9H0P0-4	693	696	+	3	Q9H0P0-4	144	708	ENST00000409787.4	41	605	+	71	Q9H0P0-4#27	0	3	ENST00000409787.4	590	593	+	3	0	0	5509
Q9H0P0-4#27	0	3	3	Q9H0P0-4	693	696	+	3	Q9H0P0-4	153	1008	ENST00000409467.6	174	1029	++	70	Q9H0P0-4#27	0	3	ENST00000409467.6	714	717	+	3	0	0	5510
Q9H0P0-4#28	0	3	3	Q9H0P0-4	696	699	+	3	Q9H0P0-4	144	1008	ENST00000643244.1	75	939	++	237	Q9H0P0-4#28	0	3	ENST00000643244.1	627	630	+	3	0	0	5511
Q9H0P0-4#28	0	3	3	Q9H0P0-4	696	699	+	3	Q9H0P0-4	153	1008	ENST00000610140.7	209	1064	+	229	Q9H0P0-4#28	0	3	ENST00000610140.7	752	755	+	3	0	0	5512
Q9H0P0-4#28	0	3	3	Q9H0P0-4	696	699	+	3	Q9H0P0-4	144	708	ENST00000409787.4	41	605	+	71	Q9H0P0-4#28	0	3	ENST00000409787.4	593	596	+	3	0	0	5513
Q9H0P0-4#28	0	3	3	Q9H0P0-4	696	699	+	3	Q9H0P0-4	153	1008	ENST00000409467.6	174	1029	++	70	Q9H0P0-4#28	0	3	ENST00000409467.6	717	720	+	3	0	0	5514
Q9H0P0-4#29	0	3	3	Q9H0P0-4	699	702	+	3	Q9H0P0-4	144	1008	ENST00000643244.1	75	939	++	237	Q9H0P0-4#29	0	3	ENST00000643244.1	630	633	+	3	0	0	5515
Q9H0P0-4#29	0	3	3	Q9H0P0-4	699	702	+	3	Q9H0P0-4	153	1008	ENST00000610140.7	209	1064	+	229	Q9H0P0-4#29	0	3	ENST00000610140.7	755	758	+	3	0	0	5516
Q9H0P0-4#29	0	3	3	Q9H0P0-4	699	702	+	3	Q9H0P0-4	144	708	ENST00000409787.4	41	605	+	71	Q9H0P0-4#29	0	3	ENST00000409787.4	596	599	+	3	0	0	5517
Q9H0P0-4#29	0	3	3	Q9H0P0-4	699	702	+	3	Q9H0P0-4	153	1008	ENST00000409467.6	174	1029	++	70	Q9H0P0-4#29	0	3	ENST00000409467.6	720	723	+	3	0	0	5518
Q9H0P0-4#30	0	3	3	Q9H0P0-4	282	285	+	3	Q9H0P0-4	144	1008	ENST00000643244.1	75	939	++	237	Q9H0P0-4#30	0	3	ENST00000643244.1	213	216	+	3	0	0	5519
Q9H0P0-4#30	0	3	3	Q9H0P0-4	282	285	+	3	Q9H0P0-4	153	1008	ENST00000610140.7	209	1064	+	229	Q9H0P0-4#30	0	3	ENST00000610140.7	338	341	+	3	0	0	5520
Q9H0P0-4#30	0	3	3	Q9H0P0-4	282	285	+	3	Q9H0P0-4	144	708	ENST00000409787.4	41	605	+	71	Q9H0P0-4#30	0	3	ENST00000409787.4	179	182	+	3	0	0	5521
Q9H0P0-4#30	0	3	3	Q9H0P0-4	282	285	+	3	Q9H0P0-4	153	1008	ENST00000409467.6	174	1029	++	70	Q9H0P0-4#30	0	3	ENST00000409467.6	303	306	+	3	0	0	5522
Q9H0P0-4#31	0	3	3	Q9H0P0-4	429	432	+	3	Q9H0P0-4	144	1008	ENST00000643244.1	75	939	++	237	Q9H0P0-4#31	0	3	ENST00000643244.1	360	363	+	3	0	0	5523
Q9H0P0-4#31	0	3	3	Q9H0P0-4	429	432	+	3	Q9H0P0-4	153	1008	ENST00000610140.7	209	1064	+	229	Q9H0P0-4#31	0	3	ENST00000610140.7	485	488	+	3	0	0	5524
Q9H0P0-4#31	0	3	3	Q9H0P0-4	429	432	+	3	Q9H0P0-4	144	708	ENST00000409787.4	41	605	+	71	Q9H0P0-4#31	0	3	ENST00000409787.4	326	329	+	3	0	0	5525
Q9H0P0-4#31	0	3	3	Q9H0P0-4	429	432	+	3	Q9H0P0-4	153	1008	ENST00000409467.6	174	1029	++	70	Q9H0P0-4#31	0	3	ENST00000409467.6	450	453	+	3	0	0	5526
Q9H0P0-4#32	0	3	3	Q9H0P0-4	984	987	+	3	Q9H0P0-4	144	1008	ENST00000643244.1	75	939	++	237	Q9H0P0-4#32	0	3	ENST00000643244.1	915	918	+	3	0	0	5527
Q9H0P0-4#32	0	3	3	Q9H0P0-4	984	987	+	3	Q9H0P0-4	153	1008	ENST00000610140.7	209	1064	+	229	Q9H0P0-4#32	0	3	ENST00000610140.7	1040	1043	+	3	0	0	5528
Q9H0P0-4#32	0	3	3	Q9H0P0-4	984	987	+	3	Q9H0P0-4	153	1008	ENST00000409467.6	174	1029	++	70	Q9H0P0-4#32	0	3	ENST00000409467.6	1005	1008	+	3	0	0	5529
Q9H0P0-4#33	0	42	42	Q9H0P0-4	192	234	+	42	Q9H0P0-4	144	1008	ENST00000643244.1	75	939	++	237	Q9H0P0-4#33	0	42	ENST00000643244.1	123	165	+	42	0	0	5530
Q9H0P0-4#33	0	42	42	Q9H0P0-4	192	234	+	42	Q9H0P0-4	153	1008	ENST00000610140.7	209	1064	+	229	Q9H0P0-4#33	0	42	ENST00000610140.7	248	290	+	42	0	0	5531
Q9H0P0-4#33	0	42	42	Q9H0P0-4	192	234	+	42	Q9H0P0-4	153	280	ENST00000449201.5	179	306	+	99	Q9H0P0-4#33	0	42	ENST00000449201.5	218	260	+	42	0	0	5532
Q9H0P0-4#33	0	42	42	Q9H0P0-4	192	234	+	42	Q9H0P0-4	144	708	ENST00000409787.4	41	605	+	71	Q9H0P0-4#33	0	42	ENST00000409787.4	89	131	+	42	0	0	5533
Q9H0P0-4#33	0	42	42	Q9H0P0-4	192	234	+	42	Q9H0P0-4	153	1008	ENST00000409467.6	174	1029	++	70	Q9H0P0-4#33	0	42	ENST00000409467.6	213	255	+	42	0	0	5534
Q9H0P0-4#34	0	9	9	Q9H0P0-4	237	246	+	9	Q9H0P0-4	144	1008	ENST00000643244.1	75	939	++	237	Q9H0P0-4#34	0	9	ENST00000643244.1	168	177	+	9	0	0	5535
Q9H0P0-4#34	0	9	9	Q9H0P0-4	237	246	+	9	Q9H0P0-4	153	1008	ENST00000610140.7	209	1064	+	229	Q9H0P0-4#34	0	9	ENST00000610140.7	293	302	+	9	0	0	5536
Q9H0P0-4#34	0	9	9	Q9H0P0-4	237	246	+	9	Q9H0P0-4	153	280	ENST00000449201.5	179	306	+	99	Q9H0P0-4#34	0	9	ENST00000449201.5	263	272	+	9	0	0	5537
Q9H0P0-4#34	0	9	9	Q9H0P0-4	237	246	+	9	Q9H0P0-4	144	708	ENST00000409787.4	41	605	+	71	Q9H0P0-4#34	0	9	ENST00000409787.4	134	143	+	9	0	0	5538
Q9H0P0-4#34	0	9	9	Q9H0P0-4	237	246	+	9	Q9H0P0-4	153	1008	ENST00000409467.6	174	1029	++	70	Q9H0P0-4#34	0	9	ENST00000409467.6	258	267	+	9	0	0	5539
Q9H0P0-4#35	0	15	15	Q9H0P0-4	246	261	+	15	Q9H0P0-4	144	1008	ENST00000643244.1	75	939	++	237	Q9H0P0-4#35	0	15	ENST00000643244.1	177	192	+	15	0	0	5540
Q9H0P0-4#35	0	15	15	Q9H0P0-4	246	261	+	15	Q9H0P0-4	153	1008	ENST00000610140.7	209	1064	+	229	Q9H0P0-4#35	0	15	ENST00000610140.7	302	317	+	15	0	0	5541
Q9H0P0-4#35	0	15	15	Q9H0P0-4	246	261	+	15	Q9H0P0-4	153	280	ENST00000449201.5	179	306	+	99	Q9H0P0-4#35	0	15	ENST00000449201.5	272	287	+	15	0	0	5542
Q9H0P0-4#35	0	15	15	Q9H0P0-4	246	261	+	15	Q9H0P0-4	144	708	ENST00000409787.4	41	605	+	71	Q9H0P0-4#35	0	15	ENST00000409787.4	143	158	+	15	0	0	5543
Q9H0P0-4#35	0	15	15	Q9H0P0-4	246	261	+	15	Q9H0P0-4	153	1008	ENST00000409467.6	174	1029	++	70	Q9H0P0-4#35	0	15	ENST00000409467.6	267	282	+	15	0	0	5544
Q9H0P0-4#36	0	9	9	Q9H0P0-4	267	276	+	9	Q9H0P0-4	144	1008	ENST00000643244.1	75	939	++	237	Q9H0P0-4#36	0	9	ENST00000643244.1	198	207	+	9	0	0	5545
Q9H0P0-4#36	0	9	9	Q9H0P0-4	267	276	+	9	Q9H0P0-4	153	1008	ENST00000610140.7	209	1064	+	229	Q9H0P0-4#36	0	9	ENST00000610140.7	323	332	+	9	0	0	5546
Q9H0P0-4#36	0	9	9	Q9H0P0-4	267	276	+	9	Q9H0P0-4	153	280	ENST00000449201.5	179	306	+	99	Q9H0P0-4#36	0	9	ENST00000449201.5	293	302	+	9	0	0	5547
Q9H0P0-4#36	0	9	9	Q9H0P0-4	267	276	+	9	Q9H0P0-4	144	708	ENST00000409787.4	41	605	+	71	Q9H0P0-4#36	0	9	ENST00000409787.4	164	173	+	9	0	0	5548
Q9H0P0-4#36	0	9	9	Q9H0P0-4	267	276	+	9	Q9H0P0-4	153	1008	ENST00000409467.6	174	1029	++	70	Q9H0P0-4#36	0	9	ENST00000409467.6	288	297	+	9	0	0	5549
Q9H0P0-4#37	0	9	9	Q9H0P0-4	285	294	+	9	Q9H0P0-4	144	1008	ENST00000643244.1	75	939	++	237	Q9H0P0-4#37	0	9	ENST00000643244.1	216	225	+	9	0	0	5550
Q9H0P0-4#37	0	9	9	Q9H0P0-4	285	294	+	9	Q9H0P0-4	153	1008	ENST00000610140.7	209	1064	+	229	Q9H0P0-4#37	0	9	ENST00000610140.7	341	350	+	9	0	0	5551
Q9H0P0-4#37	0	9	9	Q9H0P0-4	285	294	+	9	Q9H0P0-4	144	708	ENST00000409787.4	41	605	+	71	Q9H0P0-4#37	0	9	ENST00000409787.4	182	191	+	9	0	0	5552
Q9H0P0-4#37	0	9	9	Q9H0P0-4	285	294	+	9	Q9H0P0-4	153	1008	ENST00000409467.6	174	1029	++	70	Q9H0P0-4#37	0	9	ENST00000409467.6	306	315	+	9	0	0	5553
Q9H0P0-4#38	0	18	18	Q9H0P0-4	315	333	+	18	Q9H0P0-4	144	1008	ENST00000643244.1	75	939	++	237	Q9H0P0-4#38	0	18	ENST00000643244.1	246	264	+	18	0	0	5554
Q9H0P0-4#38	0	18	18	Q9H0P0-4	315	333	+	18	Q9H0P0-4	153	1008	ENST00000610140.7	209	1064	+	229	Q9H0P0-4#38	0	18	ENST00000610140.7	371	389	+	18	0	0	5555
Q9H0P0-4#38	0	18	18	Q9H0P0-4	315	333	+	18	Q9H0P0-4	144	708	ENST00000409787.4	41	605	+	71	Q9H0P0-4#38	0	18	ENST00000409787.4	212	230	+	18	0	0	5556
Q9H0P0-4#38	0	18	18	Q9H0P0-4	315	333	+	18	Q9H0P0-4	153	1008	ENST00000409467.6	174	1029	++	70	Q9H0P0-4#38	0	18	ENST00000409467.6	336	354	+	18	0	0	5557
Q9H0P0-4#39	0	54	54	Q9H0P0-4	351	405	+	54	Q9H0P0-4	144	1008	ENST00000643244.1	75	939	++	237	Q9H0P0-4#39	0	54	ENST00000643244.1	282	336	+	54	0	0	5558
Q9H0P0-4#39	0	54	54	Q9H0P0-4	351	405	+	54	Q9H0P0-4	153	1008	ENST00000610140.7	209	1064	+	229	Q9H0P0-4#39	0	54	ENST00000610140.7	407	461	+	54	0	0	5559
Q9H0P0-4#39	0	54	54	Q9H0P0-4	351	405	+	54	Q9H0P0-4	144	708	ENST00000409787.4	41	605	+	71	Q9H0P0-4#39	0	54	ENST00000409787.4	248	302	+	54	0	0	5560
Q9H0P0-4#39	0	54	54	Q9H0P0-4	351	405	+	54	Q9H0P0-4	153	1008	ENST00000409467.6	174	1029	++	70	Q9H0P0-4#39	0	54	ENST00000409467.6	372	426	+	54	0	0	5561
Q9H0P0-4#40	0	9	9	Q9H0P0-4	411	420	+	9	Q9H0P0-4	144	1008	ENST00000643244.1	75	939	++	237	Q9H0P0-4#40	0	9	ENST00000643244.1	342	351	+	9	0	0	5562
Q9H0P0-4#40	0	9	9	Q9H0P0-4	411	420	+	9	Q9H0P0-4	153	1008	ENST00000610140.7	209	1064	+	229	Q9H0P0-4#40	0	9	ENST00000610140.7	467	476	+	9	0	0	5563
Q9H0P0-4#40	0	9	9	Q9H0P0-4	411	420	+	9	Q9H0P0-4	144	708	ENST00000409787.4	41	605	+	71	Q9H0P0-4#40	0	9	ENST00000409787.4	308	317	+	9	0	0	5564
Q9H0P0-4#40	0	9	9	Q9H0P0-4	411	420	+	9	Q9H0P0-4	153	1008	ENST00000409467.6	174	1029	++	70	Q9H0P0-4#40	0	9	ENST00000409467.6	432	441	+	9	0	0	5565
Q9H0P0-4#41	0	66	66	Q9H0P0-4	423	489	+	66	Q9H0P0-4	144	1008	ENST00000643244.1	75	939	++	237	Q9H0P0-4#41	0	66	ENST00000643244.1	354	420	+	66	0	0	5566
Q9H0P0-4#41	0	66	66	Q9H0P0-4	423	489	+	66	Q9H0P0-4	153	1008	ENST00000610140.7	209	1064	+	229	Q9H0P0-4#41	0	66	ENST00000610140.7	479	545	+	66	0	0	5567
Q9H0P0-4#41	0	66	66	Q9H0P0-4	423	489	+	66	Q9H0P0-4	144	708	ENST00000409787.4	41	605	+	71	Q9H0P0-4#41	0	66	ENST00000409787.4	320	386	+	66	0	0	5568
Q9H0P0-4#41	0	66	66	Q9H0P0-4	423	489	+	66	Q9H0P0-4	153	1008	ENST00000409467.6	174	1029	++	70	Q9H0P0-4#41	0	66	ENST00000409467.6	444	510	+	66	0	0	5569
Q9H0P0-4#42	0	9	9	Q9H0P0-4	498	507	+	9	Q9H0P0-4	144	1008	ENST00000643244.1	75	939	++	237	Q9H0P0-4#42	0	9	ENST00000643244.1	429	438	+	9	0	0	5570
Q9H0P0-4#42	0	9	9	Q9H0P0-4	498	507	+	9	Q9H0P0-4	153	1008	ENST00000610140.7	209	1064	+	229	Q9H0P0-4#42	0	9	ENST00000610140.7	554	563	+	9	0	0	5571
Q9H0P0-4#42	0	9	9	Q9H0P0-4	498	507	+	9	Q9H0P0-4	144	708	ENST00000409787.4	41	605	+	71	Q9H0P0-4#42	0	9	ENST00000409787.4	395	404	+	9	0	0	5572
Q9H0P0-4#42	0	9	9	Q9H0P0-4	498	507	+	9	Q9H0P0-4	153	1008	ENST00000409467.6	174	1029	++	70	Q9H0P0-4#42	0	9	ENST00000409467.6	519	528	+	9	0	0	5573
Q9H0P0-4#43	0	18	18	Q9H0P0-4	507	525	+	18	Q9H0P0-4	144	1008	ENST00000643244.1	75	939	++	237	Q9H0P0-4#43	0	18	ENST00000643244.1	438	456	+	18	0	0	5574
Q9H0P0-4#43	0	18	18	Q9H0P0-4	507	525	+	18	Q9H0P0-4	153	1008	ENST00000610140.7	209	1064	+	229	Q9H0P0-4#43	0	18	ENST00000610140.7	563	581	+	18	0	0	5575
Q9H0P0-4#43	0	18	18	Q9H0P0-4	507	525	+	18	Q9H0P0-4	144	708	ENST00000409787.4	41	605	+	71	Q9H0P0-4#43	0	18	ENST00000409787.4	404	422	+	18	0	0	5576
Q9H0P0-4#43	0	18	18	Q9H0P0-4	507	525	+	18	Q9H0P0-4	153	1008	ENST00000409467.6	174	1029	++	70	Q9H0P0-4#43	0	18	ENST00000409467.6	528	546	+	18	0	0	5577
Q9H0P0-4#44	0	30	30	Q9H0P0-4	552	582	+	30	Q9H0P0-4	144	1008	ENST00000643244.1	75	939	++	237	Q9H0P0-4#44	0	30	ENST00000643244.1	483	513	+	30	0	0	5578
Q9H0P0-4#44	0	30	30	Q9H0P0-4	552	582	+	30	Q9H0P0-4	153	1008	ENST00000610140.7	209	1064	+	229	Q9H0P0-4#44	0	30	ENST00000610140.7	608	638	+	30	0	0	5579
Q9H0P0-4#44	0	30	30	Q9H0P0-4	552	582	+	30	Q9H0P0-4	144	708	ENST00000409787.4	41	605	+	71	Q9H0P0-4#44	0	30	ENST00000409787.4	449	479	+	30	0	0	5580
Q9H0P0-4#44	0	30	30	Q9H0P0-4	552	582	+	30	Q9H0P0-4	153	1008	ENST00000409467.6	174	1029	++	70	Q9H0P0-4#44	0	30	ENST00000409467.6	573	603	+	30	0	0	5581
Q9H0P0-4#45	0	24	24	Q9H0P0-4	594	618	+	24	Q9H0P0-4	144	1008	ENST00000643244.1	75	939	++	237	Q9H0P0-4#45	0	24	ENST00000643244.1	525	549	+	24	0	0	5582
Q9H0P0-4#45	0	24	24	Q9H0P0-4	594	618	+	24	Q9H0P0-4	153	1008	ENST00000610140.7	209	1064	+	229	Q9H0P0-4#45	0	24	ENST00000610140.7	650	674	+	24	0	0	5583
Q9H0P0-4#45	0	24	24	Q9H0P0-4	594	618	+	24	Q9H0P0-4	144	708	ENST00000409787.4	41	605	+	71	Q9H0P0-4#45	0	24	ENST00000409787.4	491	515	+	24	0	0	5584
Q9H0P0-4#45	0	24	24	Q9H0P0-4	594	618	+	24	Q9H0P0-4	153	1008	ENST00000409467.6	174	1029	++	70	Q9H0P0-4#45	0	24	ENST00000409467.6	615	639	+	24	0	0	5585
Q9H0P0-4#46	0	30	30	Q9H0P0-4	618	648	+	30	Q9H0P0-4	144	1008	ENST00000643244.1	75	939	++	237	Q9H0P0-4#46	0	30	ENST00000643244.1	549	579	+	30	0	0	5586
Q9H0P0-4#46	0	30	30	Q9H0P0-4	618	648	+	30	Q9H0P0-4	153	1008	ENST00000610140.7	209	1064	+	229	Q9H0P0-4#46	0	30	ENST00000610140.7	674	704	+	30	0	0	5587
Q9H0P0-4#46	0	30	30	Q9H0P0-4	618	648	+	30	Q9H0P0-4	144	708	ENST00000409787.4	41	605	+	71	Q9H0P0-4#46	0	30	ENST00000409787.4	515	545	+	30	0	0	5588
Q9H0P0-4#46	0	30	30	Q9H0P0-4	618	648	+	30	Q9H0P0-4	153	1008	ENST00000409467.6	174	1029	++	70	Q9H0P0-4#46	0	30	ENST00000409467.6	639	669	+	30	0	0	5589
Q9H0P0-4#47	0	18	18	Q9H0P0-4	669	687	+	18	Q9H0P0-4	144	1008	ENST00000643244.1	75	939	++	237	Q9H0P0-4#47	0	18	ENST00000643244.1	600	618	+	18	0	0	5590
Q9H0P0-4#47	0	18	18	Q9H0P0-4	669	687	+	18	Q9H0P0-4	153	1008	ENST00000610140.7	209	1064	+	229	Q9H0P0-4#47	0	18	ENST00000610140.7	725	743	+	18	0	0	5591
Q9H0P0-4#47	0	18	18	Q9H0P0-4	669	687	+	18	Q9H0P0-4	144	708	ENST00000409787.4	41	605	+	71	Q9H0P0-4#47	0	18	ENST00000409787.4	566	584	+	18	0	0	5592
Q9H0P0-4#47	0	18	18	Q9H0P0-4	669	687	+	18	Q9H0P0-4	153	1008	ENST00000409467.6	174	1029	++	70	Q9H0P0-4#47	0	18	ENST00000409467.6	690	708	+	18	0	0	5593
Q9H0P0-4#48	0	9	9	Q9H0P0-4	690	699	+	9	Q9H0P0-4	144	1008	ENST00000643244.1	75	939	++	237	Q9H0P0-4#48	0	9	ENST00000643244.1	621	630	+	9	0	0	5594
Q9H0P0-4#48	0	9	9	Q9H0P0-4	690	699	+	9	Q9H0P0-4	153	1008	ENST00000610140.7	209	1064	+	229	Q9H0P0-4#48	0	9	ENST00000610140.7	746	755	+	9	0	0	5595
Q9H0P0-4#48	0	9	9	Q9H0P0-4	690	699	+	9	Q9H0P0-4	144	708	ENST00000409787.4	41	605	+	71	Q9H0P0-4#48	0	9	ENST00000409787.4	587	596	+	9	0	0	5596
Q9H0P0-4#48	0	9	9	Q9H0P0-4	690	699	+	9	Q9H0P0-4	153	1008	ENST00000409467.6	174	1029	++	70	Q9H0P0-4#48	0	9	ENST00000409467.6	711	720	+	9	0	0	5597
Q9H0P0-4#49	0	18	18	Q9H0P0-4	708	726	+	18	Q9H0P0-4	144	1008	ENST00000643244.1	75	939	++	237	Q9H0P0-4#49	0	18	ENST00000643244.1	639	657	+	18	0	0	5598
Q9H0P0-4#49	0	18	18	Q9H0P0-4	708	726	+	18	Q9H0P0-4	153	1008	ENST00000610140.7	209	1064	+	229	Q9H0P0-4#49	0	18	ENST00000610140.7	764	782	+	18	0	0	5599
Q9H0P0-4#49	0	18	18	Q9H0P0-4	708	726	+	18	Q9H0P0-4	153	1008	ENST00000409467.6	174	1029	++	70	Q9H0P0-4#49	0	18	ENST00000409467.6	729	747	+	18	0	0	5600
Q9H0P0-4#50	0	21	21	Q9H0P0-4	753	774	+	21	Q9H0P0-4	144	1008	ENST00000643244.1	75	939	++	237	Q9H0P0-4#50	0	21	ENST00000643244.1	684	705	+	21	0	0	5601
Q9H0P0-4#50	0	21	21	Q9H0P0-4	753	774	+	21	Q9H0P0-4	153	1008	ENST00000610140.7	209	1064	+	229	Q9H0P0-4#50	0	21	ENST00000610140.7	809	830	+	21	0	0	5602
Q9H0P0-4#50	0	21	21	Q9H0P0-4	753	774	+	21	Q9H0P0-4	153	1008	ENST00000409467.6	174	1029	++	70	Q9H0P0-4#50	0	21	ENST00000409467.6	774	795	+	21	0	0	5603
Q9H0P0-4#51	0	15	15	Q9H0P0-4	777	792	+	15	Q9H0P0-4	144	1008	ENST00000643244.1	75	939	++	237	Q9H0P0-4#51	0	15	ENST00000643244.1	708	723	+	15	0	0	5604
Q9H0P0-4#51	0	15	15	Q9H0P0-4	777	792	+	15	Q9H0P0-4	153	1008	ENST00000610140.7	209	1064	+	229	Q9H0P0-4#51	0	15	ENST00000610140.7	833	848	+	15	0	0	5605
Q9H0P0-4#51	0	15	15	Q9H0P0-4	777	792	+	15	Q9H0P0-4	153	1008	ENST00000409467.6	174	1029	++	70	Q9H0P0-4#51	0	15	ENST00000409467.6	798	813	+	15	0	0	5606
Q9H0P0-4#52	0	12	12	Q9H0P0-4	792	804	+	12	Q9H0P0-4	144	1008	ENST00000643244.1	75	939	++	237	Q9H0P0-4#52	0	12	ENST00000643244.1	723	735	+	12	0	0	5607
Q9H0P0-4#52	0	12	12	Q9H0P0-4	792	804	+	12	Q9H0P0-4	153	1008	ENST00000610140.7	209	1064	+	229	Q9H0P0-4#52	0	12	ENST00000610140.7	848	860	+	12	0	0	5608
Q9H0P0-4#52	0	12	12	Q9H0P0-4	792	804	+	12	Q9H0P0-4	153	1008	ENST00000409467.6	174	1029	++	70	Q9H0P0-4#52	0	12	ENST00000409467.6	813	825	+	12	0	0	5609
Q9H0P0-4#53	0	27	27	Q9H0P0-4	810	837	+	27	Q9H0P0-4	144	1008	ENST00000643244.1	75	939	++	237	Q9H0P0-4#53	0	27	ENST00000643244.1	741	768	+	27	0	0	5610
Q9H0P0-4#53	0	27	27	Q9H0P0-4	810	837	+	27	Q9H0P0-4	153	1008	ENST00000610140.7	209	1064	+	229	Q9H0P0-4#53	0	27	ENST00000610140.7	866	893	+	27	0	0	5611
Q9H0P0-4#53	0	27	27	Q9H0P0-4	810	837	+	27	Q9H0P0-4	153	1008	ENST00000409467.6	174	1029	++	70	Q9H0P0-4#53	0	27	ENST00000409467.6	831	858	+	27	0	0	5612
Q9H0P0-4#54	0	12	12	Q9H0P0-4	837	849	+	12	Q9H0P0-4	144	1008	ENST00000643244.1	75	939	++	237	Q9H0P0-4#54	0	12	ENST00000643244.1	768	780	+	12	0	0	5613
Q9H0P0-4#54	0	12	12	Q9H0P0-4	837	849	+	12	Q9H0P0-4	153	1008	ENST00000610140.7	209	1064	+	229	Q9H0P0-4#54	0	12	ENST00000610140.7	893	905	+	12	0	0	5614
Q9H0P0-4#54	0	12	12	Q9H0P0-4	837	849	+	12	Q9H0P0-4	153	1008	ENST00000409467.6	174	1029	++	70	Q9H0P0-4#54	0	12	ENST00000409467.6	858	870	+	12	0	0	5615
Q9H0P0-4#55	0	12	12	Q9H0P0-4	849	861	+	12	Q9H0P0-4	144	1008	ENST00000643244.1	75	939	++	237	Q9H0P0-4#55	0	12	ENST00000643244.1	780	792	+	12	0	0	5616
Q9H0P0-4#55	0	12	12	Q9H0P0-4	849	861	+	12	Q9H0P0-4	153	1008	ENST00000610140.7	209	1064	+	229	Q9H0P0-4#55	0	12	ENST00000610140.7	905	917	+	12	0	0	5617
Q9H0P0-4#55	0	12	12	Q9H0P0-4	849	861	+	12	Q9H0P0-4	153	1008	ENST00000409467.6	174	1029	++	70	Q9H0P0-4#55	0	12	ENST00000409467.6	870	882	+	12	0	0	5618
Q9H0P0-4#56	0	27	27	Q9H0P0-4	873	900	+	27	Q9H0P0-4	144	1008	ENST00000643244.1	75	939	++	237	Q9H0P0-4#56	0	27	ENST00000643244.1	804	831	+	27	0	0	5619
Q9H0P0-4#56	0	27	27	Q9H0P0-4	873	900	+	27	Q9H0P0-4	153	1008	ENST00000610140.7	209	1064	+	229	Q9H0P0-4#56	0	27	ENST00000610140.7	929	956	+	27	0	0	5620
Q9H0P0-4#56	0	27	27	Q9H0P0-4	873	900	+	27	Q9H0P0-4	153	1008	ENST00000409467.6	174	1029	++	70	Q9H0P0-4#56	0	27	ENST00000409467.6	894	921	+	27	0	0	5621
Q9H0P0-4#57	0	27	27	Q9H0P0-4	909	936	+	27	Q9H0P0-4	144	1008	ENST00000643244.1	75	939	++	237	Q9H0P0-4#57	0	27	ENST00000643244.1	840	867	+	27	0	0	5622
Q9H0P0-4#57	0	27	27	Q9H0P0-4	909	936	+	27	Q9H0P0-4	153	1008	ENST00000610140.7	209	1064	+	229	Q9H0P0-4#57	0	27	ENST00000610140.7	965	992	+	27	0	0	5623
Q9H0P0-4#57	0	27	27	Q9H0P0-4	909	936	+	27	Q9H0P0-4	153	1008	ENST00000409467.6	174	1029	++	70	Q9H0P0-4#57	0	27	ENST00000409467.6	930	957	+	27	0	0	5624
Q9H0P0-4#58	0	18	18	Q9H0P0-4	942	960	+	18	Q9H0P0-4	144	1008	ENST00000643244.1	75	939	++	237	Q9H0P0-4#58	0	18	ENST00000643244.1	873	891	+	18	0	0	5625
Q9H0P0-4#58	0	18	18	Q9H0P0-4	942	960	+	18	Q9H0P0-4	153	1008	ENST00000610140.7	209	1064	+	229	Q9H0P0-4#58	0	18	ENST00000610140.7	998	1016	+	18	0	0	5626
Q9H0P0-4#58	0	18	18	Q9H0P0-4	942	960	+	18	Q9H0P0-4	153	1008	ENST00000409467.6	174	1029	++	70	Q9H0P0-4#58	0	18	ENST00000409467.6	963	981	+	18	0	0	5627
Q9H0P0-4#59	0	30	30	Q9H0P0-4	975	1005	+	30	Q9H0P0-4	144	1008	ENST00000643244.1	75	939	++	237	Q9H0P0-4#59	0	30	ENST00000643244.1	906	936	+	30	0	0	5628
Q9H0P0-4#59	0	30	30	Q9H0P0-4	975	1005	+	30	Q9H0P0-4	153	1008	ENST00000610140.7	209	1064	+	229	Q9H0P0-4#59	0	30	ENST00000610140.7	1031	1061	+	30	0	0	5629
Q9H0P0-4#59	0	30	30	Q9H0P0-4	975	1005	+	30	Q9H0P0-4	153	1008	ENST00000409467.6	174	1029	++	70	Q9H0P0-4#59	0	30	ENST00000409467.6	996	1026	+	30	0	0	5630
O95336#0	0	3	3	O95336	0	3	+	3	O95336	0	624	ENST00000600923.5	3	651	+	222	O95336#0	0	3	ENST00000600923.5	3	6	+	3	0	0	5631
O95336#0	0	3	3	O95336	0	3	+	3	O95336	0	436	ENST00000594761.5	37	577	+	207	O95336#0	0	3	ENST00000594761.5	37	40	+	3	0	0	5632
O95336#0	0	3	3	O95336	0	3	+	3	O95336	0	774	ENST00000252603.7	24	798	++	5	O95336#0	0	3	ENST00000252603.7	24	27	+	3	0	0	5633
O95336#1	0	771	771	O95336	3	774	+	771	O95336	0	624	ENST00000600923.5	3	651	+	222	O95336#1	0	621	ENST00000600923.5	6	651	+	621	0	150	5634
O95336#1	0	771	771	O95336	3	774	+	771	O95336	192	774	ENST00000595782.1	0	441	+	211	O95336#1	189	771	ENST00000595782.1	0	441	+	441	189	0	5635
O95336#1	0	771	771	O95336	3	774	+	771	O95336	0	436	ENST00000594761.5	37	577	+	207	O95336#1	0	433	ENST00000594761.5	40	577	+	433	0	338	5636
O95336#1	0	771	771	O95336	3	774	+	771	O95336	0	774	ENST00000252603.7	24	798	++	5	O95336#1	0	771	ENST00000252603.7	27	798	+	771	0	0	5637
O95336#2	0	3	3	O95336	3	6	+	3	O95336	0	624	ENST00000600923.5	3	651	+	222	O95336#2	0	3	ENST00000600923.5	6	9	+	3	0	0	5638
O95336#2	0	3	3	O95336	3	6	+	3	O95336	0	436	ENST00000594761.5	37	577	+	207	O95336#2	0	3	ENST00000594761.5	40	43	+	3	0	0	5639
O95336#2	0	3	3	O95336	3	6	+	3	O95336	0	774	ENST00000252603.7	24	798	++	5	O95336#2	0	3	ENST00000252603.7	27	30	+	3	0	0	5640
O95336#3	0	3	3	O95336	144	147	+	3	O95336	0	624	ENST00000600923.5	3	651	+	222	O95336#3	0	3	ENST00000600923.5	147	150	+	3	0	0	5641
O95336#3	0	3	3	O95336	144	147	+	3	O95336	0	436	ENST00000594761.5	37	577	+	207	O95336#3	0	3	ENST00000594761.5	181	184	+	3	0	0	5642
O95336#3	0	3	3	O95336	144	147	+	3	O95336	0	774	ENST00000252603.7	24	798	++	5	O95336#3	0	3	ENST00000252603.7	168	171	+	3	0	0	5643
O95336#4	0	3	3	O95336	537	540	+	3	O95336	0	624	ENST00000600923.5	3	651	+	222	O95336#4	0	3	ENST00000600923.5	564	567	+	3	0	0	5644
O95336#4	0	3	3	O95336	537	540	+	3	O95336	0	774	ENST00000252603.7	24	798	++	5	O95336#4	0	3	ENST00000252603.7	561	564	+	3	0	0	5645
Q969T7-1#0	0	900	900	Q969T7-1	0	900	+	900	Q969T7-1	0	900	ENST00000521789.5	67	667	+	137	Q969T7-1#0	0	900	ENST00000521789.5	67	667	+	600	0	0	5646
Q969T7-1#0	0	900	900	Q969T7-1	0	900	+	900	Q969T7-1	324	567	ENST00000486304.2	0	243	+	116	Q969T7-1#0	324	567	ENST00000486304.2	0	243	+	243	324	333	5647
Q969T7-1#0	0	900	900	Q969T7-1	0	900	+	900	Q969T7-1	0	111	ENST00000475053.5	53	164	+	110	Q969T7-1#0	0	111	ENST00000475053.5	53	164	+	111	0	789	5648
Q969T7-1#0	0	900	900	Q969T7-1	0	900	+	900	Q969T7-1	0	122	ENST00000445655.5	51	276	+	94	Q969T7-1#0	0	122	ENST00000445655.5	51	276	+	122	0	778	5649
Q969T7-1#0	0	900	900	Q969T7-1	0	900	+	900	Q969T7-1	0	900	ENST00000435506.7	39	939	++	85	Q969T7-1#0	0	900	ENST00000435506.7	39	939	+	900	0	0	5650
Q969T7-1#0	0	900	900	Q969T7-1	0	900	+	900	Q969T7-1	0	772	ENST00000415460.5	48	730	+	75	Q969T7-1#0	0	772	ENST00000415460.5	48	730	+	682	0	128	5651
Q969T7-1#1	0	3	3	Q969T7-1	120	123	+	3	Q969T7-1	0	900	ENST00000521789.5	67	667	+	137	Q969T7-1#1	0	3	ENST00000521789.5	88	91	+	3	0	0	5652
Q969T7-1#1	0	3	3	Q969T7-1	120	123	+	3	Q969T7-1	0	122	ENST00000445655.5	51	276	+	94	Q969T7-1#1	0	2	ENST00000445655.5	274	276	+	2	0	1	5653
Q969T7-1#1	0	3	3	Q969T7-1	120	123	+	3	Q969T7-1	0	900	ENST00000435506.7	39	939	++	85	Q969T7-1#1	0	3	ENST00000435506.7	159	162	+	3	0	0	5654
Q969T7-1#1	0	3	3	Q969T7-1	120	123	+	3	Q969T7-1	0	772	ENST00000415460.5	48	730	+	75	Q969T7-1#1	0	3	ENST00000415460.5	168	171	+	3	0	0	5655
Q969T7-1#2	0	3	3	Q969T7-1	126	129	+	3	Q969T7-1	0	900	ENST00000521789.5	67	667	+	137	Q969T7-1#2	0	3	ENST00000521789.5	94	97	+	3	0	0	5656
Q969T7-1#2	0	3	3	Q969T7-1	126	129	+	3	Q969T7-1	0	900	ENST00000435506.7	39	939	++	85	Q969T7-1#2	0	3	ENST00000435506.7	165	168	+	3	0	0	5657
Q969T7-1#2	0	3	3	Q969T7-1	126	129	+	3	Q969T7-1	0	772	ENST00000415460.5	48	730	+	75	Q969T7-1#2	0	3	ENST00000415460.5	174	177	+	3	0	0	5658
Q969T7-1#3	0	3	3	Q969T7-1	120	123	+	3	Q969T7-1	0	900	ENST00000521789.5	67	667	+	137	Q969T7-1#3	0	3	ENST00000521789.5	88	91	+	3	0	0	5659
Q969T7-1#3	0	3	3	Q969T7-1	120	123	+	3	Q969T7-1	0	122	ENST00000445655.5	51	276	+	94	Q969T7-1#3	0	2	ENST00000445655.5	274	276	+	2	0	1	5660
Q969T7-1#3	0	3	3	Q969T7-1	120	123	+	3	Q969T7-1	0	900	ENST00000435506.7	39	939	++	85	Q969T7-1#3	0	3	ENST00000435506.7	159	162	+	3	0	0	5661
Q969T7-1#3	0	3	3	Q969T7-1	120	123	+	3	Q969T7-1	0	772	ENST00000415460.5	48	730	+	75	Q969T7-1#3	0	3	ENST00000415460.5	168	171	+	3	0	0	5662
Q969T7-1#4	0	3	3	Q969T7-1	126	129	+	3	Q969T7-1	0	900	ENST00000521789.5	67	667	+	137	Q969T7-1#4	0	3	ENST00000521789.5	94	97	+	3	0	0	5663
Q969T7-1#4	0	3	3	Q969T7-1	126	129	+	3	Q969T7-1	0	900	ENST00000435506.7	39	939	++	85	Q969T7-1#4	0	3	ENST00000435506.7	165	168	+	3	0	0	5664
Q969T7-1#4	0	3	3	Q969T7-1	126	129	+	3	Q969T7-1	0	772	ENST00000415460.5	48	730	+	75	Q969T7-1#4	0	3	ENST00000415460.5	174	177	+	3	0	0	5665
Q969T7-1#5	0	3	3	Q969T7-1	261	264	+	3	Q969T7-1	0	900	ENST00000521789.5	67	667	+	137	Q969T7-1#5	0	3	ENST00000521789.5	229	232	+	3	0	0	5666
Q969T7-1#5	0	3	3	Q969T7-1	261	264	+	3	Q969T7-1	0	900	ENST00000435506.7	39	939	++	85	Q969T7-1#5	0	3	ENST00000435506.7	300	303	+	3	0	0	5667
Q969T7-1#5	0	3	3	Q969T7-1	261	264	+	3	Q969T7-1	0	772	ENST00000415460.5	48	730	+	75	Q969T7-1#5	0	3	ENST00000415460.5	309	312	+	3	0	0	5668
Q969T7-1#6	0	3	3	Q969T7-1	261	264	+	3	Q969T7-1	0	900	ENST00000521789.5	67	667	+	137	Q969T7-1#6	0	3	ENST00000521789.5	229	232	+	3	0	0	5669
Q969T7-1#6	0	3	3	Q969T7-1	261	264	+	3	Q969T7-1	0	900	ENST00000435506.7	39	939	++	85	Q969T7-1#6	0	3	ENST00000435506.7	300	303	+	3	0	0	5670
Q969T7-1#6	0	3	3	Q969T7-1	261	264	+	3	Q969T7-1	0	772	ENST00000415460.5	48	730	+	75	Q969T7-1#6	0	3	ENST00000415460.5	309	312	+	3	0	0	5671
Q969T7-1#7	0	6	6	Q969T7-1	465	471	+	6	Q969T7-1	0	900	ENST00000521789.5	67	667	+	137	Q969T7-1#7	0	6	ENST00000521789.5	433	439	+	6	0	0	5672
Q969T7-1#7	0	6	6	Q969T7-1	465	471	+	6	Q969T7-1	324	567	ENST00000486304.2	0	243	+	116	Q969T7-1#7	0	6	ENST00000486304.2	141	147	+	6	0	0	5673
Q969T7-1#7	0	6	6	Q969T7-1	465	471	+	6	Q969T7-1	0	900	ENST00000435506.7	39	939	++	85	Q969T7-1#7	0	6	ENST00000435506.7	504	510	+	6	0	0	5674
Q969T7-1#7	0	6	6	Q969T7-1	465	471	+	6	Q969T7-1	0	772	ENST00000415460.5	48	730	+	75	Q969T7-1#7	0	6	ENST00000415460.5	423	429	+	6	0	0	5675
Q969T7-1#8	0	3	3	Q969T7-1	612	615	+	3	Q969T7-1	0	900	ENST00000435506.7	39	939	++	85	Q969T7-1#8	0	3	ENST00000435506.7	651	654	+	3	0	0	5676
Q969T7-1#8	0	3	3	Q969T7-1	612	615	+	3	Q969T7-1	0	772	ENST00000415460.5	48	730	+	75	Q969T7-1#8	0	3	ENST00000415460.5	570	573	+	3	0	0	5677
Q969T7-1#9	0	3	3	Q969T7-1	687	690	+	3	Q969T7-1	0	900	ENST00000435506.7	39	939	++	85	Q969T7-1#9	0	3	ENST00000435506.7	726	729	+	3	0	0	5678
Q969T7-1#9	0	3	3	Q969T7-1	687	690	+	3	Q969T7-1	0	772	ENST00000415460.5	48	730	+	75	Q969T7-1#9	0	3	ENST00000415460.5	645	648	+	3	0	0	5679
Q969T7-1#10	0	3	3	Q969T7-1	765	768	+	3	Q969T7-1	0	900	ENST00000435506.7	39	939	++	85	Q969T7-1#10	0	3	ENST00000435506.7	804	807	+	3	0	0	5680
Q969T7-1#10	0	3	3	Q969T7-1	765	768	+	3	Q969T7-1	0	772	ENST00000415460.5	48	730	+	75	Q969T7-1#10	0	3	ENST00000415460.5	723	726	+	3	0	0	5681
Q969T7-1#11	0	24	24	Q969T7-1	0	24	+	24	Q969T7-1	0	900	ENST00000521789.5	67	667	+	137	Q969T7-1#11	0	12	ENST00000521789.5	67	79	+	12	0	12	5682
Q969T7-1#11	0	24	24	Q969T7-1	0	24	+	24	Q969T7-1	0	111	ENST00000475053.5	53	164	+	110	Q969T7-1#11	0	24	ENST00000475053.5	53	77	+	24	0	0	5683
Q969T7-1#11	0	24	24	Q969T7-1	0	24	+	24	Q969T7-1	0	122	ENST00000445655.5	51	276	+	94	Q969T7-1#11	0	24	ENST00000445655.5	51	178	+	24	0	0	5684
Q969T7-1#11	0	24	24	Q969T7-1	0	24	+	24	Q969T7-1	0	900	ENST00000435506.7	39	939	++	85	Q969T7-1#11	0	24	ENST00000435506.7	39	63	+	24	0	0	5685
Q969T7-1#11	0	24	24	Q969T7-1	0	24	+	24	Q969T7-1	0	772	ENST00000415460.5	48	730	+	75	Q969T7-1#11	0	24	ENST00000415460.5	48	72	+	24	0	0	5686
Q969T7-1#12	0	3	3	Q969T7-1	624	627	+	3	Q969T7-1	0	900	ENST00000435506.7	39	939	++	85	Q969T7-1#12	0	3	ENST00000435506.7	663	666	+	3	0	0	5687
Q969T7-1#12	0	3	3	Q969T7-1	624	627	+	3	Q969T7-1	0	772	ENST00000415460.5	48	730	+	75	Q969T7-1#12	0	3	ENST00000415460.5	582	585	+	3	0	0	5688
Q969T7-1#13	0	3	3	Q969T7-1	636	639	+	3	Q969T7-1	0	900	ENST00000435506.7	39	939	++	85	Q969T7-1#13	0	3	ENST00000435506.7	675	678	+	3	0	0	5689
Q969T7-1#13	0	3	3	Q969T7-1	636	639	+	3	Q969T7-1	0	772	ENST00000415460.5	48	730	+	75	Q969T7-1#13	0	3	ENST00000415460.5	594	597	+	3	0	0	5690
Q969T7-1#14	0	9	9	Q969T7-1	0	9	+	9	Q969T7-1	0	900	ENST00000521789.5	67	667	+	137	Q969T7-1#14	0	9	ENST00000521789.5	67	76	+	9	0	0	5691
Q969T7-1#14	0	9	9	Q969T7-1	0	9	+	9	Q969T7-1	0	111	ENST00000475053.5	53	164	+	110	Q969T7-1#14	0	9	ENST00000475053.5	53	62	+	9	0	0	5692
Q969T7-1#14	0	9	9	Q969T7-1	0	9	+	9	Q969T7-1	0	122	ENST00000445655.5	51	276	+	94	Q969T7-1#14	0	9	ENST00000445655.5	51	60	+	9	0	0	5693
Q969T7-1#14	0	9	9	Q969T7-1	0	9	+	9	Q969T7-1	0	900	ENST00000435506.7	39	939	++	85	Q969T7-1#14	0	9	ENST00000435506.7	39	48	+	9	0	0	5694
Q969T7-1#14	0	9	9	Q969T7-1	0	9	+	9	Q969T7-1	0	772	ENST00000415460.5	48	730	+	75	Q969T7-1#14	0	9	ENST00000415460.5	48	57	+	9	0	0	5695
Q969T7-1#15	0	9	9	Q969T7-1	18	27	+	9	Q969T7-1	0	111	ENST00000475053.5	53	164	+	110	Q969T7-1#15	0	9	ENST00000475053.5	71	80	+	9	0	0	5696
Q969T7-1#15	0	9	9	Q969T7-1	18	27	+	9	Q969T7-1	0	122	ENST00000445655.5	51	276	+	94	Q969T7-1#15	0	9	ENST00000445655.5	172	181	+	9	0	0	5697
Q969T7-1#15	0	9	9	Q969T7-1	18	27	+	9	Q969T7-1	0	900	ENST00000435506.7	39	939	++	85	Q969T7-1#15	0	9	ENST00000435506.7	57	66	+	9	0	0	5698
Q969T7-1#15	0	9	9	Q969T7-1	18	27	+	9	Q969T7-1	0	772	ENST00000415460.5	48	730	+	75	Q969T7-1#15	0	9	ENST00000415460.5	66	75	+	9	0	0	5699
Q969T7-1#16	0	42	42	Q969T7-1	51	93	+	42	Q969T7-1	0	111	ENST00000475053.5	53	164	+	110	Q969T7-1#16	0	42	ENST00000475053.5	104	146	+	42	0	0	5700
Q969T7-1#16	0	42	42	Q969T7-1	51	93	+	42	Q969T7-1	0	122	ENST00000445655.5	51	276	+	94	Q969T7-1#16	0	42	ENST00000445655.5	205	247	+	42	0	0	5701
Q969T7-1#16	0	42	42	Q969T7-1	51	93	+	42	Q969T7-1	0	900	ENST00000435506.7	39	939	++	85	Q969T7-1#16	0	42	ENST00000435506.7	90	132	+	42	0	0	5702
Q969T7-1#16	0	42	42	Q969T7-1	51	93	+	42	Q969T7-1	0	772	ENST00000415460.5	48	730	+	75	Q969T7-1#16	0	42	ENST00000415460.5	99	141	+	42	0	0	5703
Q969T7-1#17	0	9	9	Q969T7-1	96	105	+	9	Q969T7-1	0	111	ENST00000475053.5	53	164	+	110	Q969T7-1#17	0	9	ENST00000475053.5	149	158	+	9	0	0	5704
Q969T7-1#17	0	9	9	Q969T7-1	96	105	+	9	Q969T7-1	0	122	ENST00000445655.5	51	276	+	94	Q969T7-1#17	0	9	ENST00000445655.5	250	259	+	9	0	0	5705
Q969T7-1#17	0	9	9	Q969T7-1	96	105	+	9	Q969T7-1	0	900	ENST00000435506.7	39	939	++	85	Q969T7-1#17	0	9	ENST00000435506.7	135	144	+	9	0	0	5706
Q969T7-1#17	0	9	9	Q969T7-1	96	105	+	9	Q969T7-1	0	772	ENST00000415460.5	48	730	+	75	Q969T7-1#17	0	9	ENST00000415460.5	144	153	+	9	0	0	5707
Q969T7-1#18	0	18	18	Q969T7-1	105	123	+	18	Q969T7-1	0	900	ENST00000521789.5	67	667	+	137	Q969T7-1#18	6	18	ENST00000521789.5	79	91	+	12	6	0	5708
Q969T7-1#18	0	18	18	Q969T7-1	105	123	+	18	Q969T7-1	0	111	ENST00000475053.5	53	164	+	110	Q969T7-1#18	0	6	ENST00000475053.5	158	164	+	6	0	12	5709
Q969T7-1#18	0	18	18	Q969T7-1	105	123	+	18	Q969T7-1	0	122	ENST00000445655.5	51	276	+	94	Q969T7-1#18	0	17	ENST00000445655.5	259	276	+	17	0	1	5710
Q969T7-1#18	0	18	18	Q969T7-1	105	123	+	18	Q969T7-1	0	900	ENST00000435506.7	39	939	++	85	Q969T7-1#18	0	18	ENST00000435506.7	144	162	+	18	0	0	5711
Q969T7-1#18	0	18	18	Q969T7-1	105	123	+	18	Q969T7-1	0	772	ENST00000415460.5	48	730	+	75	Q969T7-1#18	0	18	ENST00000415460.5	153	171	+	18	0	0	5712
Q969T7-1#19	0	15	15	Q969T7-1	123	138	+	15	Q969T7-1	0	900	ENST00000521789.5	67	667	+	137	Q969T7-1#19	0	15	ENST00000521789.5	91	106	+	15	0	0	5713
Q969T7-1#19	0	15	15	Q969T7-1	123	138	+	15	Q969T7-1	0	900	ENST00000435506.7	39	939	++	85	Q969T7-1#19	0	15	ENST00000435506.7	162	177	+	15	0	0	5714
Q969T7-1#19	0	15	15	Q969T7-1	123	138	+	15	Q969T7-1	0	772	ENST00000415460.5	48	730	+	75	Q969T7-1#19	0	15	ENST00000415460.5	171	186	+	15	0	0	5715
Q969T7-1#20	0	9	9	Q969T7-1	144	153	+	9	Q969T7-1	0	900	ENST00000521789.5	67	667	+	137	Q969T7-1#20	0	9	ENST00000521789.5	112	121	+	9	0	0	5716
Q969T7-1#20	0	9	9	Q969T7-1	144	153	+	9	Q969T7-1	0	900	ENST00000435506.7	39	939	++	85	Q969T7-1#20	0	9	ENST00000435506.7	183	192	+	9	0	0	5717
Q969T7-1#20	0	9	9	Q969T7-1	144	153	+	9	Q969T7-1	0	772	ENST00000415460.5	48	730	+	75	Q969T7-1#20	0	9	ENST00000415460.5	192	201	+	9	0	0	5718
Q969T7-1#21	0	9	9	Q969T7-1	174	183	+	9	Q969T7-1	0	900	ENST00000521789.5	67	667	+	137	Q969T7-1#21	0	9	ENST00000521789.5	142	151	+	9	0	0	5719
Q969T7-1#21	0	9	9	Q969T7-1	174	183	+	9	Q969T7-1	0	900	ENST00000435506.7	39	939	++	85	Q969T7-1#21	0	9	ENST00000435506.7	213	222	+	9	0	0	5720
Q969T7-1#21	0	9	9	Q969T7-1	174	183	+	9	Q969T7-1	0	772	ENST00000415460.5	48	730	+	75	Q969T7-1#21	0	9	ENST00000415460.5	222	231	+	9	0	0	5721
Q969T7-1#22	0	12	12	Q969T7-1	183	195	+	12	Q969T7-1	0	900	ENST00000521789.5	67	667	+	137	Q969T7-1#22	0	12	ENST00000521789.5	151	163	+	12	0	0	5722
Q969T7-1#22	0	12	12	Q969T7-1	183	195	+	12	Q969T7-1	0	900	ENST00000435506.7	39	939	++	85	Q969T7-1#22	0	12	ENST00000435506.7	222	234	+	12	0	0	5723
Q969T7-1#22	0	12	12	Q969T7-1	183	195	+	12	Q969T7-1	0	772	ENST00000415460.5	48	730	+	75	Q969T7-1#22	0	12	ENST00000415460.5	231	243	+	12	0	0	5724
Q969T7-1#23	0	54	54	Q969T7-1	210	264	+	54	Q969T7-1	0	900	ENST00000521789.5	67	667	+	137	Q969T7-1#23	0	54	ENST00000521789.5	178	232	+	54	0	0	5725
Q969T7-1#23	0	54	54	Q969T7-1	210	264	+	54	Q969T7-1	0	900	ENST00000435506.7	39	939	++	85	Q969T7-1#23	0	54	ENST00000435506.7	249	303	+	54	0	0	5726
Q969T7-1#23	0	54	54	Q969T7-1	210	264	+	54	Q969T7-1	0	772	ENST00000415460.5	48	730	+	75	Q969T7-1#23	0	54	ENST00000415460.5	258	312	+	54	0	0	5727
Q969T7-1#24	0	60	60	Q969T7-1	282	342	+	60	Q969T7-1	0	900	ENST00000521789.5	67	667	+	137	Q969T7-1#24	0	60	ENST00000521789.5	250	310	+	60	0	0	5728
Q969T7-1#24	0	60	60	Q969T7-1	282	342	+	60	Q969T7-1	324	567	ENST00000486304.2	0	243	+	116	Q969T7-1#24	42	60	ENST00000486304.2	0	18	+	18	42	0	5729
Q969T7-1#24	0	60	60	Q969T7-1	282	342	+	60	Q969T7-1	0	900	ENST00000435506.7	39	939	++	85	Q969T7-1#24	0	60	ENST00000435506.7	321	381	+	60	0	0	5730
Q969T7-1#24	0	60	60	Q969T7-1	282	342	+	60	Q969T7-1	0	772	ENST00000415460.5	48	730	+	75	Q969T7-1#24	0	32	ENST00000415460.5	330	362	+	32	0	28	5731
Q969T7-1#25	0	27	27	Q969T7-1	360	387	+	27	Q969T7-1	0	900	ENST00000521789.5	67	667	+	137	Q969T7-1#25	0	27	ENST00000521789.5	328	355	+	27	0	0	5732
Q969T7-1#25	0	27	27	Q969T7-1	360	387	+	27	Q969T7-1	324	567	ENST00000486304.2	0	243	+	116	Q969T7-1#25	0	27	ENST00000486304.2	36	63	+	27	0	0	5733
Q969T7-1#25	0	27	27	Q969T7-1	360	387	+	27	Q969T7-1	0	900	ENST00000435506.7	39	939	++	85	Q969T7-1#25	0	27	ENST00000435506.7	399	426	+	27	0	0	5734
Q969T7-1#26	0	30	30	Q969T7-1	411	441	+	30	Q969T7-1	0	900	ENST00000521789.5	67	667	+	137	Q969T7-1#26	0	30	ENST00000521789.5	379	409	+	30	0	0	5735
Q969T7-1#26	0	30	30	Q969T7-1	411	441	+	30	Q969T7-1	324	567	ENST00000486304.2	0	243	+	116	Q969T7-1#26	0	30	ENST00000486304.2	87	117	+	30	0	0	5736
Q969T7-1#26	0	30	30	Q969T7-1	411	441	+	30	Q969T7-1	0	900	ENST00000435506.7	39	939	++	85	Q969T7-1#26	0	30	ENST00000435506.7	450	480	+	30	0	0	5737
Q969T7-1#26	0	30	30	Q969T7-1	411	441	+	30	Q969T7-1	0	772	ENST00000415460.5	48	730	+	75	Q969T7-1#26	0	30	ENST00000415460.5	369	399	+	30	0	0	5738
Q969T7-1#27	0	24	24	Q969T7-1	453	477	+	24	Q969T7-1	0	900	ENST00000521789.5	67	667	+	137	Q969T7-1#27	0	24	ENST00000521789.5	421	445	+	24	0	0	5739
Q969T7-1#27	0	24	24	Q969T7-1	453	477	+	24	Q969T7-1	324	567	ENST00000486304.2	0	243	+	116	Q969T7-1#27	0	24	ENST00000486304.2	129	153	+	24	0	0	5740
Q969T7-1#27	0	24	24	Q969T7-1	453	477	+	24	Q969T7-1	0	900	ENST00000435506.7	39	939	++	85	Q969T7-1#27	0	24	ENST00000435506.7	492	516	+	24	0	0	5741
Q969T7-1#27	0	24	24	Q969T7-1	453	477	+	24	Q969T7-1	0	772	ENST00000415460.5	48	730	+	75	Q969T7-1#27	0	24	ENST00000415460.5	411	435	+	24	0	0	5742
Q969T7-1#28	0	30	30	Q969T7-1	477	507	+	30	Q969T7-1	0	900	ENST00000521789.5	67	667	+	137	Q969T7-1#28	0	30	ENST00000521789.5	445	475	+	30	0	0	5743
Q969T7-1#28	0	30	30	Q969T7-1	477	507	+	30	Q969T7-1	324	567	ENST00000486304.2	0	243	+	116	Q969T7-1#28	0	30	ENST00000486304.2	153	183	+	30	0	0	5744
Q969T7-1#28	0	30	30	Q969T7-1	477	507	+	30	Q969T7-1	0	900	ENST00000435506.7	39	939	++	85	Q969T7-1#28	0	30	ENST00000435506.7	516	546	+	30	0	0	5745
Q969T7-1#28	0	30	30	Q969T7-1	477	507	+	30	Q969T7-1	0	772	ENST00000415460.5	48	730	+	75	Q969T7-1#28	0	30	ENST00000415460.5	435	465	+	30	0	0	5746
Q969T7-1#29	0	30	30	Q969T7-1	528	558	+	30	Q969T7-1	0	900	ENST00000521789.5	67	667	+	137	Q969T7-1#29	0	30	ENST00000521789.5	496	526	+	30	0	0	5747
Q969T7-1#29	0	30	30	Q969T7-1	528	558	+	30	Q969T7-1	324	567	ENST00000486304.2	0	243	+	116	Q969T7-1#29	0	30	ENST00000486304.2	204	234	+	30	0	0	5748
Q969T7-1#29	0	30	30	Q969T7-1	528	558	+	30	Q969T7-1	0	900	ENST00000435506.7	39	939	++	85	Q969T7-1#29	0	30	ENST00000435506.7	567	597	+	30	0	0	5749
Q969T7-1#29	0	30	30	Q969T7-1	528	558	+	30	Q969T7-1	0	772	ENST00000415460.5	48	730	+	75	Q969T7-1#29	0	30	ENST00000415460.5	486	516	+	30	0	0	5750
Q969T7-1#30	0	24	24	Q969T7-1	567	591	+	24	Q969T7-1	0	900	ENST00000435506.7	39	939	++	85	Q969T7-1#30	0	24	ENST00000435506.7	606	630	+	24	0	0	5751
Q969T7-1#30	0	24	24	Q969T7-1	567	591	+	24	Q969T7-1	0	772	ENST00000415460.5	48	730	+	75	Q969T7-1#30	0	24	ENST00000415460.5	525	549	+	24	0	0	5752
Q969T7-1#31	0	9	9	Q969T7-1	618	627	+	9	Q969T7-1	0	900	ENST00000435506.7	39	939	++	85	Q969T7-1#31	0	9	ENST00000435506.7	657	666	+	9	0	0	5753
Q969T7-1#31	0	9	9	Q969T7-1	618	627	+	9	Q969T7-1	0	772	ENST00000415460.5	48	730	+	75	Q969T7-1#31	0	9	ENST00000415460.5	576	585	+	9	0	0	5754
Q969T7-1#32	0	27	27	Q969T7-1	669	696	+	27	Q969T7-1	0	900	ENST00000435506.7	39	939	++	85	Q969T7-1#32	0	27	ENST00000435506.7	708	735	+	27	0	0	5755
Q969T7-1#32	0	27	27	Q969T7-1	669	696	+	27	Q969T7-1	0	772	ENST00000415460.5	48	730	+	75	Q969T7-1#32	0	27	ENST00000415460.5	627	654	+	27	0	0	5756
Q969T7-1#33	0	12	12	Q969T7-1	696	708	+	12	Q969T7-1	0	900	ENST00000435506.7	39	939	++	85	Q969T7-1#33	0	12	ENST00000435506.7	735	747	+	12	0	0	5757
Q969T7-1#33	0	12	12	Q969T7-1	696	708	+	12	Q969T7-1	0	772	ENST00000415460.5	48	730	+	75	Q969T7-1#33	0	12	ENST00000415460.5	654	666	+	12	0	0	5758
Q969T7-1#34	0	12	12	Q969T7-1	708	720	+	12	Q969T7-1	0	900	ENST00000435506.7	39	939	++	85	Q969T7-1#34	0	12	ENST00000435506.7	747	759	+	12	0	0	5759
Q969T7-1#34	0	12	12	Q969T7-1	708	720	+	12	Q969T7-1	0	772	ENST00000415460.5	48	730	+	75	Q969T7-1#34	0	12	ENST00000415460.5	666	678	+	12	0	0	5760
Q969T7-1#35	0	24	24	Q969T7-1	735	759	+	24	Q969T7-1	0	900	ENST00000435506.7	39	939	++	85	Q969T7-1#35	0	24	ENST00000435506.7	774	798	+	24	0	0	5761
Q969T7-1#35	0	24	24	Q969T7-1	735	759	+	24	Q969T7-1	0	772	ENST00000415460.5	48	730	+	75	Q969T7-1#35	0	24	ENST00000415460.5	693	717	+	24	0	0	5762
Q969T7-1#36	0	33	33	Q969T7-1	768	801	+	33	Q969T7-1	0	900	ENST00000521789.5	67	667	+	137	Q969T7-1#36	0	33	ENST00000521789.5	535	568	+	33	0	0	5763
Q969T7-1#36	0	33	33	Q969T7-1	768	801	+	33	Q969T7-1	0	900	ENST00000435506.7	39	939	++	85	Q969T7-1#36	0	33	ENST00000435506.7	807	840	+	33	0	0	5764
Q969T7-1#36	0	33	33	Q969T7-1	768	801	+	33	Q969T7-1	0	772	ENST00000415460.5	48	730	+	75	Q969T7-1#36	0	4	ENST00000415460.5	726	730	+	4	0	29	5765
Q969T7-1#37	0	18	18	Q969T7-1	804	822	+	18	Q969T7-1	0	900	ENST00000521789.5	67	667	+	137	Q969T7-1#37	0	18	ENST00000521789.5	571	589	+	18	0	0	5766
Q969T7-1#37	0	18	18	Q969T7-1	804	822	+	18	Q969T7-1	0	900	ENST00000435506.7	39	939	++	85	Q969T7-1#37	0	18	ENST00000435506.7	843	861	+	18	0	0	5767
Q969T7-1#38	0	33	33	Q969T7-1	834	867	+	33	Q969T7-1	0	900	ENST00000521789.5	67	667	+	137	Q969T7-1#38	0	33	ENST00000521789.5	601	634	+	33	0	0	5768
Q969T7-1#38	0	33	33	Q969T7-1	834	867	+	33	Q969T7-1	0	900	ENST00000435506.7	39	939	++	85	Q969T7-1#38	0	33	ENST00000435506.7	873	906	+	33	0	0	5769
A8K2U0-1#0	0	51	51	A8K2U0-1	0	51	+	51	A8K2U0-1	0	4362	ENST00000299698.12	31	4393	++	19	A8K2U0-1#0	0	51	ENST00000299698.12	31	82	+	51	0	0	5770
A8K2U0-1#1	0	4311	4311	A8K2U0-1	51	4362	+	4311	A8K2U0-1	1476	2015	ENST00000545692.1	31	570	+	164	A8K2U0-1#1	1425	1964	ENST00000545692.1	31	570	+	539	1425	2347	5771
A8K2U0-1#1	0	4311	4311	A8K2U0-1	51	4362	+	4311	A8K2U0-1	1350	4362	ENST00000541459.5	0	3012	+	160	A8K2U0-1#1	1299	4311	ENST00000541459.5	0	3012	+	3012	1299	0	5772
A8K2U0-1#1	0	4311	4311	A8K2U0-1	51	4362	+	4311	A8K2U0-1	1476	4362	ENST00000539547.5	171	3057	++	159	A8K2U0-1#1	1425	4311	ENST00000539547.5	171	3057	+	2886	1425	0	5773
A8K2U0-1#1	0	4311	4311	A8K2U0-1	51	4362	+	4311	A8K2U0-1	3818	4362	ENST00000537475.1	0	544	+	158	A8K2U0-1#1	3767	4311	ENST00000537475.1	0	544	+	544	3767	0	5774
A8K2U0-1#1	0	4311	4311	A8K2U0-1	51	4362	+	4311	A8K2U0-1	1476	1585	ENST00000536789.5	353	462	+	157	A8K2U0-1#1	1425	1534	ENST00000536789.5	353	462	+	109	1425	2777	5775
A8K2U0-1#1	0	4311	4311	A8K2U0-1	51	4362	+	4311	A8K2U0-1	0	4362	ENST00000299698.12	31	4393	++	19	A8K2U0-1#1	0	4311	ENST00000299698.12	82	4393	+	4311	0	0	5776
A8K2U0-1#2	0	96	96	A8K2U0-1	2082	2178	+	96	A8K2U0-1	1350	4362	ENST00000541459.5	0	3012	+	160	A8K2U0-1#2	0	96	ENST00000541459.5	732	828	+	96	0	0	5777
A8K2U0-1#2	0	96	96	A8K2U0-1	2082	2178	+	96	A8K2U0-1	1476	4362	ENST00000539547.5	171	3057	++	159	A8K2U0-1#2	0	96	ENST00000539547.5	777	873	+	96	0	0	5778
A8K2U0-1#2	0	96	96	A8K2U0-1	2082	2178	+	96	A8K2U0-1	0	4362	ENST00000299698.12	31	4393	++	19	A8K2U0-1#2	0	96	ENST00000299698.12	2113	2209	+	96	0	0	5779
A8K2U0-1#3	0	3	3	A8K2U0-1	357	360	+	3	A8K2U0-1	0	4362	ENST00000299698.12	31	4393	++	19	A8K2U0-1#3	0	3	ENST00000299698.12	388	391	+	3	0	0	5780
A8K2U0-1#4	0	3	3	A8K2U0-1	840	843	+	3	A8K2U0-1	0	4362	ENST00000299698.12	31	4393	++	19	A8K2U0-1#4	0	3	ENST00000299698.12	871	874	+	3	0	0	5781
A8K2U0-1#5	0	3	3	A8K2U0-1	1224	1227	+	3	A8K2U0-1	0	4362	ENST00000299698.12	31	4393	++	19	A8K2U0-1#5	0	3	ENST00000299698.12	1255	1258	+	3	0	0	5782
A8K2U0-1#6	0	3	3	A8K2U0-1	2568	2571	+	3	A8K2U0-1	1350	4362	ENST00000541459.5	0	3012	+	160	A8K2U0-1#6	0	3	ENST00000541459.5	1218	1221	+	3	0	0	5783
A8K2U0-1#6	0	3	3	A8K2U0-1	2568	2571	+	3	A8K2U0-1	1476	4362	ENST00000539547.5	171	3057	++	159	A8K2U0-1#6	0	3	ENST00000539547.5	1263	1266	+	3	0	0	5784
A8K2U0-1#6	0	3	3	A8K2U0-1	2568	2571	+	3	A8K2U0-1	0	4362	ENST00000299698.12	31	4393	++	19	A8K2U0-1#6	0	3	ENST00000299698.12	2599	2602	+	3	0	0	5785
A8K2U0-1#7	0	3	3	A8K2U0-1	3057	3060	+	3	A8K2U0-1	1350	4362	ENST00000541459.5	0	3012	+	160	A8K2U0-1#7	0	3	ENST00000541459.5	1707	1710	+	3	0	0	5786
A8K2U0-1#7	0	3	3	A8K2U0-1	3057	3060	+	3	A8K2U0-1	1476	4362	ENST00000539547.5	171	3057	++	159	A8K2U0-1#7	0	3	ENST00000539547.5	1752	1755	+	3	0	0	5787
A8K2U0-1#7	0	3	3	A8K2U0-1	3057	3060	+	3	A8K2U0-1	0	4362	ENST00000299698.12	31	4393	++	19	A8K2U0-1#7	0	3	ENST00000299698.12	3088	3091	+	3	0	0	5788
A8K2U0-1#8	0	117	117	A8K2U0-1	117	234	+	117	A8K2U0-1	0	4362	ENST00000299698.12	31	4393	++	19	A8K2U0-1#8	0	117	ENST00000299698.12	148	265	+	117	0	0	5789
A8K2U0-1#9	0	153	153	A8K2U0-1	720	873	+	153	A8K2U0-1	0	4362	ENST00000299698.12	31	4393	++	19	A8K2U0-1#9	0	153	ENST00000299698.12	751	904	+	153	0	0	5790
A8K2U0-1#10	0	63	63	A8K2U0-1	774	837	+	63	A8K2U0-1	0	4362	ENST00000299698.12	31	4393	++	19	A8K2U0-1#10	0	63	ENST00000299698.12	805	868	+	63	0	0	5791
A8K2U0-1#11	0	282	282	A8K2U0-1	1389	1671	+	282	A8K2U0-1	1476	2015	ENST00000545692.1	31	570	+	164	A8K2U0-1#11	87	282	ENST00000545692.1	31	226	+	195	87	0	5792
A8K2U0-1#11	0	282	282	A8K2U0-1	1389	1671	+	282	A8K2U0-1	1350	4362	ENST00000541459.5	0	3012	+	160	A8K2U0-1#11	0	282	ENST00000541459.5	39	321	+	282	0	0	5793
A8K2U0-1#11	0	282	282	A8K2U0-1	1389	1671	+	282	A8K2U0-1	1476	4362	ENST00000539547.5	171	3057	++	159	A8K2U0-1#11	87	282	ENST00000539547.5	171	366	+	195	87	0	5794
A8K2U0-1#11	0	282	282	A8K2U0-1	1389	1671	+	282	A8K2U0-1	1476	1585	ENST00000536789.5	353	462	+	157	A8K2U0-1#11	87	196	ENST00000536789.5	353	462	+	109	87	86	5795
A8K2U0-1#11	0	282	282	A8K2U0-1	1389	1671	+	282	A8K2U0-1	0	4362	ENST00000299698.12	31	4393	++	19	A8K2U0-1#11	0	282	ENST00000299698.12	1420	1702	+	282	0	0	5796
A8K2U0-1#12	0	543	543	A8K2U0-1	1764	2307	+	543	A8K2U0-1	1476	2015	ENST00000545692.1	31	570	+	164	A8K2U0-1#12	0	251	ENST00000545692.1	319	570	+	251	0	292	5797
A8K2U0-1#12	0	543	543	A8K2U0-1	1764	2307	+	543	A8K2U0-1	1350	4362	ENST00000541459.5	0	3012	+	160	A8K2U0-1#12	0	543	ENST00000541459.5	414	957	+	543	0	0	5798
A8K2U0-1#12	0	543	543	A8K2U0-1	1764	2307	+	543	A8K2U0-1	1476	4362	ENST00000539547.5	171	3057	++	159	A8K2U0-1#12	0	543	ENST00000539547.5	459	1002	+	543	0	0	5799
A8K2U0-1#12	0	543	543	A8K2U0-1	1764	2307	+	543	A8K2U0-1	0	4362	ENST00000299698.12	31	4393	++	19	A8K2U0-1#12	0	543	ENST00000299698.12	1795	2338	+	543	0	0	5800
A8K2U0-1#13	0	87	87	A8K2U0-1	2454	2541	+	87	A8K2U0-1	1350	4362	ENST00000541459.5	0	3012	+	160	A8K2U0-1#13	0	87	ENST00000541459.5	1104	1191	+	87	0	0	5801
A8K2U0-1#13	0	87	87	A8K2U0-1	2454	2541	+	87	A8K2U0-1	1476	4362	ENST00000539547.5	171	3057	++	159	A8K2U0-1#13	0	87	ENST00000539547.5	1149	1236	+	87	0	0	5802
A8K2U0-1#13	0	87	87	A8K2U0-1	2454	2541	+	87	A8K2U0-1	0	4362	ENST00000299698.12	31	4393	++	19	A8K2U0-1#13	0	87	ENST00000299698.12	2485	2572	+	87	0	0	5803
A8K2U0-1#14	0	111	111	A8K2U0-1	2532	2643	+	111	A8K2U0-1	1350	4362	ENST00000541459.5	0	3012	+	160	A8K2U0-1#14	0	111	ENST00000541459.5	1182	1293	+	111	0	0	5804
A8K2U0-1#14	0	111	111	A8K2U0-1	2532	2643	+	111	A8K2U0-1	1476	4362	ENST00000539547.5	171	3057	++	159	A8K2U0-1#14	0	111	ENST00000539547.5	1227	1338	+	111	0	0	5805
A8K2U0-1#14	0	111	111	A8K2U0-1	2532	2643	+	111	A8K2U0-1	0	4362	ENST00000299698.12	31	4393	++	19	A8K2U0-1#14	0	111	ENST00000299698.12	2563	2674	+	111	0	0	5806
A8K2U0-1#15	0	1167	1167	A8K2U0-1	2754	3921	+	1167	A8K2U0-1	1350	4362	ENST00000541459.5	0	3012	+	160	A8K2U0-1#15	0	1167	ENST00000541459.5	1404	2571	+	1167	0	0	5807
A8K2U0-1#15	0	1167	1167	A8K2U0-1	2754	3921	+	1167	A8K2U0-1	1476	4362	ENST00000539547.5	171	3057	++	159	A8K2U0-1#15	0	1167	ENST00000539547.5	1449	2616	+	1167	0	0	5808
A8K2U0-1#15	0	1167	1167	A8K2U0-1	2754	3921	+	1167	A8K2U0-1	3818	4362	ENST00000537475.1	0	544	+	158	A8K2U0-1#15	1064	1167	ENST00000537475.1	0	103	+	103	1064	0	5809
A8K2U0-1#15	0	1167	1167	A8K2U0-1	2754	3921	+	1167	A8K2U0-1	0	4362	ENST00000299698.12	31	4393	++	19	A8K2U0-1#15	0	1167	ENST00000299698.12	2785	3952	+	1167	0	0	5810
A8K2U0-1#16	0	147	147	A8K2U0-1	3222	3369	+	147	A8K2U0-1	1350	4362	ENST00000541459.5	0	3012	+	160	A8K2U0-1#16	0	147	ENST00000541459.5	1872	2019	+	147	0	0	5811
A8K2U0-1#16	0	147	147	A8K2U0-1	3222	3369	+	147	A8K2U0-1	1476	4362	ENST00000539547.5	171	3057	++	159	A8K2U0-1#16	0	147	ENST00000539547.5	1917	2064	+	147	0	0	5812
A8K2U0-1#16	0	147	147	A8K2U0-1	3222	3369	+	147	A8K2U0-1	0	4362	ENST00000299698.12	31	4393	++	19	A8K2U0-1#16	0	147	ENST00000299698.12	3253	3400	+	147	0	0	5813
A8K2U0-1#17	0	348	348	A8K2U0-1	4011	4359	+	348	A8K2U0-1	1350	4362	ENST00000541459.5	0	3012	+	160	A8K2U0-1#17	0	348	ENST00000541459.5	2661	3009	+	348	0	0	5814
A8K2U0-1#17	0	348	348	A8K2U0-1	4011	4359	+	348	A8K2U0-1	1476	4362	ENST00000539547.5	171	3057	++	159	A8K2U0-1#17	0	348	ENST00000539547.5	2706	3054	+	348	0	0	5815
A8K2U0-1#17	0	348	348	A8K2U0-1	4011	4359	+	348	A8K2U0-1	3818	4362	ENST00000537475.1	0	544	+	158	A8K2U0-1#17	0	348	ENST00000537475.1	193	541	+	348	0	0	5816
A8K2U0-1#17	0	348	348	A8K2U0-1	4011	4359	+	348	A8K2U0-1	0	4362	ENST00000299698.12	31	4393	++	19	A8K2U0-1#17	0	348	ENST00000299698.12	4042	4390	+	348	0	0	5817
A8K2U0-1#18	0	12	12	A8K2U0-1	2907	2919	+	12	A8K2U0-1	1350	4362	ENST00000541459.5	0	3012	+	160	A8K2U0-1#18	0	12	ENST00000541459.5	1557	1569	+	12	0	0	5818
A8K2U0-1#18	0	12	12	A8K2U0-1	2907	2919	+	12	A8K2U0-1	1476	4362	ENST00000539547.5	171	3057	++	159	A8K2U0-1#18	0	12	ENST00000539547.5	1602	1614	+	12	0	0	5819
A8K2U0-1#18	0	12	12	A8K2U0-1	2907	2919	+	12	A8K2U0-1	0	4362	ENST00000299698.12	31	4393	++	19	A8K2U0-1#18	0	12	ENST00000299698.12	2938	2950	+	12	0	0	5820
A8K2U0-1#19	0	1473	1473	A8K2U0-1	3	1476	+	1473	A8K2U0-1	1350	4362	ENST00000541459.5	0	3012	+	160	A8K2U0-1#19	1347	1473	ENST00000541459.5	0	126	+	126	1347	0	5821
A8K2U0-1#19	0	1473	1473	A8K2U0-1	3	1476	+	1473	A8K2U0-1	0	4362	ENST00000299698.12	31	4393	++	19	A8K2U0-1#19	0	1473	ENST00000299698.12	34	1507	+	1473	0	0	5822
A8K2U0-1#20	0	3	3	A8K2U0-1	618	621	+	3	A8K2U0-1	0	4362	ENST00000299698.12	31	4393	++	19	A8K2U0-1#20	0	3	ENST00000299698.12	649	652	+	3	0	0	5823
A8K2U0-1#21	0	3600	3600	A8K2U0-1	762	4362	+	3600	A8K2U0-1	1476	2015	ENST00000545692.1	31	570	+	164	A8K2U0-1#21	714	1253	ENST00000545692.1	31	570	+	539	714	2347	5824
A8K2U0-1#21	0	3600	3600	A8K2U0-1	762	4362	+	3600	A8K2U0-1	1350	4362	ENST00000541459.5	0	3012	+	160	A8K2U0-1#21	588	3600	ENST00000541459.5	0	3012	+	3012	588	0	5825
A8K2U0-1#21	0	3600	3600	A8K2U0-1	762	4362	+	3600	A8K2U0-1	1476	4362	ENST00000539547.5	171	3057	++	159	A8K2U0-1#21	714	3600	ENST00000539547.5	171	3057	+	2886	714	0	5826
A8K2U0-1#21	0	3600	3600	A8K2U0-1	762	4362	+	3600	A8K2U0-1	3818	4362	ENST00000537475.1	0	544	+	158	A8K2U0-1#21	3056	3600	ENST00000537475.1	0	544	+	544	3056	0	5827
A8K2U0-1#21	0	3600	3600	A8K2U0-1	762	4362	+	3600	A8K2U0-1	1476	1585	ENST00000536789.5	353	462	+	157	A8K2U0-1#21	714	823	ENST00000536789.5	353	462	+	109	714	2777	5828
A8K2U0-1#21	0	3600	3600	A8K2U0-1	762	4362	+	3600	A8K2U0-1	0	4362	ENST00000299698.12	31	4393	++	19	A8K2U0-1#21	0	3600	ENST00000299698.12	793	4393	+	3600	0	0	5829
A8K2U0-1#22	0	3	3	A8K2U0-1	885	888	+	3	A8K2U0-1	0	4362	ENST00000299698.12	31	4393	++	19	A8K2U0-1#22	0	3	ENST00000299698.12	916	919	+	3	0	0	5830
A8K2U0-1#23	0	3	3	A8K2U0-1	1065	1068	+	3	A8K2U0-1	0	4362	ENST00000299698.12	31	4393	++	19	A8K2U0-1#23	0	3	ENST00000299698.12	1096	1099	+	3	0	0	5831
A8K2U0-1#24	0	3	3	A8K2U0-1	2547	2550	+	3	A8K2U0-1	1350	4362	ENST00000541459.5	0	3012	+	160	A8K2U0-1#24	0	3	ENST00000541459.5	1197	1200	+	3	0	0	5832
A8K2U0-1#24	0	3	3	A8K2U0-1	2547	2550	+	3	A8K2U0-1	1476	4362	ENST00000539547.5	171	3057	++	159	A8K2U0-1#24	0	3	ENST00000539547.5	1242	1245	+	3	0	0	5833
A8K2U0-1#24	0	3	3	A8K2U0-1	2547	2550	+	3	A8K2U0-1	0	4362	ENST00000299698.12	31	4393	++	19	A8K2U0-1#24	0	3	ENST00000299698.12	2578	2581	+	3	0	0	5834
A8K2U0-1#25	0	1686	1686	A8K2U0-1	2676	4362	+	1686	A8K2U0-1	1350	4362	ENST00000541459.5	0	3012	+	160	A8K2U0-1#25	0	1686	ENST00000541459.5	1326	3012	+	1686	0	0	5835
A8K2U0-1#25	0	1686	1686	A8K2U0-1	2676	4362	+	1686	A8K2U0-1	1476	4362	ENST00000539547.5	171	3057	++	159	A8K2U0-1#25	0	1686	ENST00000539547.5	1371	3057	+	1686	0	0	5836
A8K2U0-1#25	0	1686	1686	A8K2U0-1	2676	4362	+	1686	A8K2U0-1	3818	4362	ENST00000537475.1	0	544	+	158	A8K2U0-1#25	1142	1686	ENST00000537475.1	0	544	+	544	1142	0	5837
A8K2U0-1#25	0	1686	1686	A8K2U0-1	2676	4362	+	1686	A8K2U0-1	0	4362	ENST00000299698.12	31	4393	++	19	A8K2U0-1#25	0	1686	ENST00000299698.12	2707	4393	+	1686	0	0	5838
A8K2U0-1#26	0	3	3	A8K2U0-1	2907	2910	+	3	A8K2U0-1	1350	4362	ENST00000541459.5	0	3012	+	160	A8K2U0-1#26	0	3	ENST00000541459.5	1557	1560	+	3	0	0	5839
A8K2U0-1#26	0	3	3	A8K2U0-1	2907	2910	+	3	A8K2U0-1	1476	4362	ENST00000539547.5	171	3057	++	159	A8K2U0-1#26	0	3	ENST00000539547.5	1602	1605	+	3	0	0	5840
A8K2U0-1#26	0	3	3	A8K2U0-1	2907	2910	+	3	A8K2U0-1	0	4362	ENST00000299698.12	31	4393	++	19	A8K2U0-1#26	0	3	ENST00000299698.12	2938	2941	+	3	0	0	5841
A8K2U0-1#27	0	1449	1449	A8K2U0-1	2913	4362	+	1449	A8K2U0-1	1350	4362	ENST00000541459.5	0	3012	+	160	A8K2U0-1#27	0	1449	ENST00000541459.5	1563	3012	+	1449	0	0	5842
A8K2U0-1#27	0	1449	1449	A8K2U0-1	2913	4362	+	1449	A8K2U0-1	1476	4362	ENST00000539547.5	171	3057	++	159	A8K2U0-1#27	0	1449	ENST00000539547.5	1608	3057	+	1449	0	0	5843
A8K2U0-1#27	0	1449	1449	A8K2U0-1	2913	4362	+	1449	A8K2U0-1	3818	4362	ENST00000537475.1	0	544	+	158	A8K2U0-1#27	905	1449	ENST00000537475.1	0	544	+	544	905	0	5844
A8K2U0-1#27	0	1449	1449	A8K2U0-1	2913	4362	+	1449	A8K2U0-1	0	4362	ENST00000299698.12	31	4393	++	19	A8K2U0-1#27	0	1449	ENST00000299698.12	2944	4393	+	1449	0	0	5845
A8K2U0-1#28	0	3	3	A8K2U0-1	3000	3003	+	3	A8K2U0-1	1350	4362	ENST00000541459.5	0	3012	+	160	A8K2U0-1#28	0	3	ENST00000541459.5	1650	1653	+	3	0	0	5846
A8K2U0-1#28	0	3	3	A8K2U0-1	3000	3003	+	3	A8K2U0-1	1476	4362	ENST00000539547.5	171	3057	++	159	A8K2U0-1#28	0	3	ENST00000539547.5	1695	1698	+	3	0	0	5847
A8K2U0-1#28	0	3	3	A8K2U0-1	3000	3003	+	3	A8K2U0-1	0	4362	ENST00000299698.12	31	4393	++	19	A8K2U0-1#28	0	3	ENST00000299698.12	3031	3034	+	3	0	0	5848
A8K2U0-1#29	0	3	3	A8K2U0-1	3363	3366	+	3	A8K2U0-1	1350	4362	ENST00000541459.5	0	3012	+	160	A8K2U0-1#29	0	3	ENST00000541459.5	2013	2016	+	3	0	0	5849
A8K2U0-1#29	0	3	3	A8K2U0-1	3363	3366	+	3	A8K2U0-1	1476	4362	ENST00000539547.5	171	3057	++	159	A8K2U0-1#29	0	3	ENST00000539547.5	2058	2061	+	3	0	0	5850
A8K2U0-1#29	0	3	3	A8K2U0-1	3363	3366	+	3	A8K2U0-1	0	4362	ENST00000299698.12	31	4393	++	19	A8K2U0-1#29	0	3	ENST00000299698.12	3394	3397	+	3	0	0	5851
A8K2U0-1#30	0	3	3	A8K2U0-1	3390	3393	+	3	A8K2U0-1	1350	4362	ENST00000541459.5	0	3012	+	160	A8K2U0-1#30	0	3	ENST00000541459.5	2040	2043	+	3	0	0	5852
A8K2U0-1#30	0	3	3	A8K2U0-1	3390	3393	+	3	A8K2U0-1	1476	4362	ENST00000539547.5	171	3057	++	159	A8K2U0-1#30	0	3	ENST00000539547.5	2085	2088	+	3	0	0	5853
A8K2U0-1#30	0	3	3	A8K2U0-1	3390	3393	+	3	A8K2U0-1	0	4362	ENST00000299698.12	31	4393	++	19	A8K2U0-1#30	0	3	ENST00000299698.12	3421	3424	+	3	0	0	5854
A8K2U0-1#31	0	3	3	A8K2U0-1	3684	3687	+	3	A8K2U0-1	1350	4362	ENST00000541459.5	0	3012	+	160	A8K2U0-1#31	0	3	ENST00000541459.5	2334	2337	+	3	0	0	5855
A8K2U0-1#31	0	3	3	A8K2U0-1	3684	3687	+	3	A8K2U0-1	1476	4362	ENST00000539547.5	171	3057	++	159	A8K2U0-1#31	0	3	ENST00000539547.5	2379	2382	+	3	0	0	5856
A8K2U0-1#31	0	3	3	A8K2U0-1	3684	3687	+	3	A8K2U0-1	0	4362	ENST00000299698.12	31	4393	++	19	A8K2U0-1#31	0	3	ENST00000299698.12	3715	3718	+	3	0	0	5857
A8K2U0-1#32	0	3	3	A8K2U0-1	3768	3771	+	3	A8K2U0-1	1350	4362	ENST00000541459.5	0	3012	+	160	A8K2U0-1#32	0	3	ENST00000541459.5	2418	2421	+	3	0	0	5858
A8K2U0-1#32	0	3	3	A8K2U0-1	3768	3771	+	3	A8K2U0-1	1476	4362	ENST00000539547.5	171	3057	++	159	A8K2U0-1#32	0	3	ENST00000539547.5	2463	2466	+	3	0	0	5859
A8K2U0-1#32	0	3	3	A8K2U0-1	3768	3771	+	3	A8K2U0-1	0	4362	ENST00000299698.12	31	4393	++	19	A8K2U0-1#32	0	3	ENST00000299698.12	3799	3802	+	3	0	0	5860
A8K2U0-1#33	0	3	3	A8K2U0-1	3933	3936	+	3	A8K2U0-1	1350	4362	ENST00000541459.5	0	3012	+	160	A8K2U0-1#33	0	3	ENST00000541459.5	2583	2586	+	3	0	0	5861
A8K2U0-1#33	0	3	3	A8K2U0-1	3933	3936	+	3	A8K2U0-1	1476	4362	ENST00000539547.5	171	3057	++	159	A8K2U0-1#33	0	3	ENST00000539547.5	2628	2631	+	3	0	0	5862
A8K2U0-1#33	0	3	3	A8K2U0-1	3933	3936	+	3	A8K2U0-1	3818	4362	ENST00000537475.1	0	544	+	158	A8K2U0-1#33	0	3	ENST00000537475.1	115	118	+	3	0	0	5863
A8K2U0-1#33	0	3	3	A8K2U0-1	3933	3936	+	3	A8K2U0-1	0	4362	ENST00000299698.12	31	4393	++	19	A8K2U0-1#33	0	3	ENST00000299698.12	3964	3967	+	3	0	0	5864
A8K2U0-1#34	0	3	3	A8K2U0-1	4233	4236	+	3	A8K2U0-1	1350	4362	ENST00000541459.5	0	3012	+	160	A8K2U0-1#34	0	3	ENST00000541459.5	2883	2886	+	3	0	0	5865
A8K2U0-1#34	0	3	3	A8K2U0-1	4233	4236	+	3	A8K2U0-1	1476	4362	ENST00000539547.5	171	3057	++	159	A8K2U0-1#34	0	3	ENST00000539547.5	2928	2931	+	3	0	0	5866
A8K2U0-1#34	0	3	3	A8K2U0-1	4233	4236	+	3	A8K2U0-1	3818	4362	ENST00000537475.1	0	544	+	158	A8K2U0-1#34	0	3	ENST00000537475.1	415	418	+	3	0	0	5867
A8K2U0-1#34	0	3	3	A8K2U0-1	4233	4236	+	3	A8K2U0-1	0	4362	ENST00000299698.12	31	4393	++	19	A8K2U0-1#34	0	3	ENST00000299698.12	4264	4267	+	3	0	0	5868
A8K2U0-1#35	0	3	3	A8K2U0-1	4290	4293	+	3	A8K2U0-1	1350	4362	ENST00000541459.5	0	3012	+	160	A8K2U0-1#35	0	3	ENST00000541459.5	2940	2943	+	3	0	0	5869
A8K2U0-1#35	0	3	3	A8K2U0-1	4290	4293	+	3	A8K2U0-1	1476	4362	ENST00000539547.5	171	3057	++	159	A8K2U0-1#35	0	3	ENST00000539547.5	2985	2988	+	3	0	0	5870
A8K2U0-1#35	0	3	3	A8K2U0-1	4290	4293	+	3	A8K2U0-1	3818	4362	ENST00000537475.1	0	544	+	158	A8K2U0-1#35	0	3	ENST00000537475.1	472	475	+	3	0	0	5871
A8K2U0-1#35	0	3	3	A8K2U0-1	4290	4293	+	3	A8K2U0-1	0	4362	ENST00000299698.12	31	4393	++	19	A8K2U0-1#35	0	3	ENST00000299698.12	4321	4324	+	3	0	0	5872
A8K2U0-1#36	0	3	3	A8K2U0-1	2196	2199	+	3	A8K2U0-1	1350	4362	ENST00000541459.5	0	3012	+	160	A8K2U0-1#36	0	3	ENST00000541459.5	846	849	+	3	0	0	5873
A8K2U0-1#36	0	3	3	A8K2U0-1	2196	2199	+	3	A8K2U0-1	1476	4362	ENST00000539547.5	171	3057	++	159	A8K2U0-1#36	0	3	ENST00000539547.5	891	894	+	3	0	0	5874
A8K2U0-1#36	0	3	3	A8K2U0-1	2196	2199	+	3	A8K2U0-1	0	4362	ENST00000299698.12	31	4393	++	19	A8K2U0-1#36	0	3	ENST00000299698.12	2227	2230	+	3	0	0	5875
A8K2U0-1#37	0	3	3	A8K2U0-1	2241	2244	+	3	A8K2U0-1	1350	4362	ENST00000541459.5	0	3012	+	160	A8K2U0-1#37	0	3	ENST00000541459.5	891	894	+	3	0	0	5876
A8K2U0-1#37	0	3	3	A8K2U0-1	2241	2244	+	3	A8K2U0-1	1476	4362	ENST00000539547.5	171	3057	++	159	A8K2U0-1#37	0	3	ENST00000539547.5	936	939	+	3	0	0	5877
A8K2U0-1#37	0	3	3	A8K2U0-1	2241	2244	+	3	A8K2U0-1	0	4362	ENST00000299698.12	31	4393	++	19	A8K2U0-1#37	0	3	ENST00000299698.12	2272	2275	+	3	0	0	5878
A8K2U0-1#38	0	3	3	A8K2U0-1	3447	3450	+	3	A8K2U0-1	1350	4362	ENST00000541459.5	0	3012	+	160	A8K2U0-1#38	0	3	ENST00000541459.5	2097	2100	+	3	0	0	5879
A8K2U0-1#38	0	3	3	A8K2U0-1	3447	3450	+	3	A8K2U0-1	1476	4362	ENST00000539547.5	171	3057	++	159	A8K2U0-1#38	0	3	ENST00000539547.5	2142	2145	+	3	0	0	5880
A8K2U0-1#38	0	3	3	A8K2U0-1	3447	3450	+	3	A8K2U0-1	0	4362	ENST00000299698.12	31	4393	++	19	A8K2U0-1#38	0	3	ENST00000299698.12	3478	3481	+	3	0	0	5881
A8K2U0-1#39	0	3	3	A8K2U0-1	3741	3744	+	3	A8K2U0-1	1350	4362	ENST00000541459.5	0	3012	+	160	A8K2U0-1#39	0	3	ENST00000541459.5	2391	2394	+	3	0	0	5882
A8K2U0-1#39	0	3	3	A8K2U0-1	3741	3744	+	3	A8K2U0-1	1476	4362	ENST00000539547.5	171	3057	++	159	A8K2U0-1#39	0	3	ENST00000539547.5	2436	2439	+	3	0	0	5883
A8K2U0-1#39	0	3	3	A8K2U0-1	3741	3744	+	3	A8K2U0-1	0	4362	ENST00000299698.12	31	4393	++	19	A8K2U0-1#39	0	3	ENST00000299698.12	3772	3775	+	3	0	0	5884
A8K2U0-1#40	0	3	3	A8K2U0-1	4353	4356	+	3	A8K2U0-1	1350	4362	ENST00000541459.5	0	3012	+	160	A8K2U0-1#40	0	3	ENST00000541459.5	3003	3006	+	3	0	0	5885
A8K2U0-1#40	0	3	3	A8K2U0-1	4353	4356	+	3	A8K2U0-1	1476	4362	ENST00000539547.5	171	3057	++	159	A8K2U0-1#40	0	3	ENST00000539547.5	3048	3051	+	3	0	0	5886
A8K2U0-1#40	0	3	3	A8K2U0-1	4353	4356	+	3	A8K2U0-1	3818	4362	ENST00000537475.1	0	544	+	158	A8K2U0-1#40	0	3	ENST00000537475.1	535	538	+	3	0	0	5887
A8K2U0-1#40	0	3	3	A8K2U0-1	4353	4356	+	3	A8K2U0-1	0	4362	ENST00000299698.12	31	4393	++	19	A8K2U0-1#40	0	3	ENST00000299698.12	4384	4387	+	3	0	0	5888
A8K2U0-1#41	0	27	27	A8K2U0-1	69	96	+	27	A8K2U0-1	0	4362	ENST00000299698.12	31	4393	++	19	A8K2U0-1#41	0	27	ENST00000299698.12	100	127	+	27	0	0	5889
A8K2U0-1#42	0	24	24	A8K2U0-1	102	126	+	24	A8K2U0-1	0	4362	ENST00000299698.12	31	4393	++	19	A8K2U0-1#42	0	24	ENST00000299698.12	133	157	+	24	0	0	5890
A8K2U0-1#43	0	21	21	A8K2U0-1	150	171	+	21	A8K2U0-1	0	4362	ENST00000299698.12	31	4393	++	19	A8K2U0-1#43	0	21	ENST00000299698.12	181	202	+	21	0	0	5891
A8K2U0-1#44	0	24	24	A8K2U0-1	183	207	+	24	A8K2U0-1	0	4362	ENST00000299698.12	31	4393	++	19	A8K2U0-1#44	0	24	ENST00000299698.12	214	238	+	24	0	0	5892
A8K2U0-1#45	0	21	21	A8K2U0-1	225	246	+	21	A8K2U0-1	0	4362	ENST00000299698.12	31	4393	++	19	A8K2U0-1#45	0	21	ENST00000299698.12	256	277	+	21	0	0	5893
A8K2U0-1#46	0	48	48	A8K2U0-1	258	306	+	48	A8K2U0-1	0	4362	ENST00000299698.12	31	4393	++	19	A8K2U0-1#46	0	48	ENST00000299698.12	289	337	+	48	0	0	5894
A8K2U0-1#47	0	36	36	A8K2U0-1	312	348	+	36	A8K2U0-1	0	4362	ENST00000299698.12	31	4393	++	19	A8K2U0-1#47	0	36	ENST00000299698.12	343	379	+	36	0	0	5895
A8K2U0-1#48	0	21	21	A8K2U0-1	360	381	+	21	A8K2U0-1	0	4362	ENST00000299698.12	31	4393	++	19	A8K2U0-1#48	0	21	ENST00000299698.12	391	412	+	21	0	0	5896
A8K2U0-1#49	0	9	9	A8K2U0-1	384	393	+	9	A8K2U0-1	0	4362	ENST00000299698.12	31	4393	++	19	A8K2U0-1#49	0	9	ENST00000299698.12	415	424	+	9	0	0	5897
A8K2U0-1#50	0	27	27	A8K2U0-1	405	432	+	27	A8K2U0-1	0	4362	ENST00000299698.12	31	4393	++	19	A8K2U0-1#50	0	27	ENST00000299698.12	436	463	+	27	0	0	5898
A8K2U0-1#51	0	21	21	A8K2U0-1	462	483	+	21	A8K2U0-1	0	4362	ENST00000299698.12	31	4393	++	19	A8K2U0-1#51	0	21	ENST00000299698.12	493	514	+	21	0	0	5899
A8K2U0-1#52	0	24	24	A8K2U0-1	498	522	+	24	A8K2U0-1	0	4362	ENST00000299698.12	31	4393	++	19	A8K2U0-1#52	0	24	ENST00000299698.12	529	553	+	24	0	0	5900
A8K2U0-1#53	0	21	21	A8K2U0-1	537	558	+	21	A8K2U0-1	0	4362	ENST00000299698.12	31	4393	++	19	A8K2U0-1#53	0	21	ENST00000299698.12	568	589	+	21	0	0	5901
A8K2U0-1#54	0	21	21	A8K2U0-1	579	600	+	21	A8K2U0-1	0	4362	ENST00000299698.12	31	4393	++	19	A8K2U0-1#54	0	21	ENST00000299698.12	610	631	+	21	0	0	5902
A8K2U0-1#55	0	12	12	A8K2U0-1	600	612	+	12	A8K2U0-1	0	4362	ENST00000299698.12	31	4393	++	19	A8K2U0-1#55	0	12	ENST00000299698.12	631	643	+	12	0	0	5903
A8K2U0-1#56	0	21	21	A8K2U0-1	612	633	+	21	A8K2U0-1	0	4362	ENST00000299698.12	31	4393	++	19	A8K2U0-1#56	0	21	ENST00000299698.12	643	664	+	21	0	0	5904
A8K2U0-1#57	0	15	15	A8K2U0-1	654	669	+	15	A8K2U0-1	0	4362	ENST00000299698.12	31	4393	++	19	A8K2U0-1#57	0	15	ENST00000299698.12	685	700	+	15	0	0	5905
A8K2U0-1#58	0	18	18	A8K2U0-1	678	696	+	18	A8K2U0-1	0	4362	ENST00000299698.12	31	4393	++	19	A8K2U0-1#58	0	18	ENST00000299698.12	709	727	+	18	0	0	5906
A8K2U0-1#59	0	33	33	A8K2U0-1	699	732	+	33	A8K2U0-1	0	4362	ENST00000299698.12	31	4393	++	19	A8K2U0-1#59	0	33	ENST00000299698.12	730	763	+	33	0	0	5907
A8K2U0-1#60	0	33	33	A8K2U0-1	753	786	+	33	A8K2U0-1	0	4362	ENST00000299698.12	31	4393	++	19	A8K2U0-1#60	0	33	ENST00000299698.12	784	817	+	33	0	0	5908
A8K2U0-1#61	0	9	9	A8K2U0-1	804	813	+	9	A8K2U0-1	0	4362	ENST00000299698.12	31	4393	++	19	A8K2U0-1#61	0	9	ENST00000299698.12	835	844	+	9	0	0	5909
A8K2U0-1#62	0	24	24	A8K2U0-1	831	855	+	24	A8K2U0-1	0	4362	ENST00000299698.12	31	4393	++	19	A8K2U0-1#62	0	24	ENST00000299698.12	862	886	+	24	0	0	5910
A8K2U0-1#63	0	21	21	A8K2U0-1	870	891	+	21	A8K2U0-1	0	4362	ENST00000299698.12	31	4393	++	19	A8K2U0-1#63	0	21	ENST00000299698.12	901	922	+	21	0	0	5911
A8K2U0-1#64	0	9	9	A8K2U0-1	891	900	+	9	A8K2U0-1	0	4362	ENST00000299698.12	31	4393	++	19	A8K2U0-1#64	0	9	ENST00000299698.12	922	931	+	9	0	0	5912
A8K2U0-1#65	0	45	45	A8K2U0-1	915	960	+	45	A8K2U0-1	0	4362	ENST00000299698.12	31	4393	++	19	A8K2U0-1#65	0	45	ENST00000299698.12	946	991	+	45	0	0	5913
A8K2U0-1#66	0	9	9	A8K2U0-1	960	969	+	9	A8K2U0-1	0	4362	ENST00000299698.12	31	4393	++	19	A8K2U0-1#66	0	9	ENST00000299698.12	991	1000	+	9	0	0	5914
A8K2U0-1#67	0	33	33	A8K2U0-1	975	1008	+	33	A8K2U0-1	0	4362	ENST00000299698.12	31	4393	++	19	A8K2U0-1#67	0	33	ENST00000299698.12	1006	1039	+	33	0	0	5915
A8K2U0-1#68	0	30	30	A8K2U0-1	1011	1041	+	30	A8K2U0-1	0	4362	ENST00000299698.12	31	4393	++	19	A8K2U0-1#68	0	30	ENST00000299698.12	1042	1072	+	30	0	0	5916
A8K2U0-1#69	0	9	9	A8K2U0-1	1044	1053	+	9	A8K2U0-1	0	4362	ENST00000299698.12	31	4393	++	19	A8K2U0-1#69	0	9	ENST00000299698.12	1075	1084	+	9	0	0	5917
A8K2U0-1#70	0	24	24	A8K2U0-1	1068	1092	+	24	A8K2U0-1	0	4362	ENST00000299698.12	31	4393	++	19	A8K2U0-1#70	0	24	ENST00000299698.12	1099	1123	+	24	0	0	5918
A8K2U0-1#71	0	9	9	A8K2U0-1	1095	1104	+	9	A8K2U0-1	0	4362	ENST00000299698.12	31	4393	++	19	A8K2U0-1#71	0	9	ENST00000299698.12	1126	1135	+	9	0	0	5919
A8K2U0-1#72	0	24	24	A8K2U0-1	1122	1146	+	24	A8K2U0-1	0	4362	ENST00000299698.12	31	4393	++	19	A8K2U0-1#72	0	24	ENST00000299698.12	1153	1177	+	24	0	0	5920
A8K2U0-1#73	0	15	15	A8K2U0-1	1161	1176	+	15	A8K2U0-1	0	4362	ENST00000299698.12	31	4393	++	19	A8K2U0-1#73	0	15	ENST00000299698.12	1192	1207	+	15	0	0	5921
A8K2U0-1#74	0	18	18	A8K2U0-1	1191	1209	+	18	A8K2U0-1	0	4362	ENST00000299698.12	31	4393	++	19	A8K2U0-1#74	0	18	ENST00000299698.12	1222	1240	+	18	0	0	5922
A8K2U0-1#75	0	9	9	A8K2U0-1	1215	1224	+	9	A8K2U0-1	0	4362	ENST00000299698.12	31	4393	++	19	A8K2U0-1#75	0	9	ENST00000299698.12	1246	1255	+	9	0	0	5923
A8K2U0-1#76	0	21	21	A8K2U0-1	1236	1257	+	21	A8K2U0-1	0	4362	ENST00000299698.12	31	4393	++	19	A8K2U0-1#76	0	21	ENST00000299698.12	1267	1288	+	21	0	0	5924
A8K2U0-1#77	0	9	9	A8K2U0-1	1281	1290	+	9	A8K2U0-1	0	4362	ENST00000299698.12	31	4393	++	19	A8K2U0-1#77	0	9	ENST00000299698.12	1312	1321	+	9	0	0	5925
A8K2U0-1#78	0	9	9	A8K2U0-1	1299	1308	+	9	A8K2U0-1	0	4362	ENST00000299698.12	31	4393	++	19	A8K2U0-1#78	0	9	ENST00000299698.12	1330	1339	+	9	0	0	5926
A8K2U0-1#79	0	21	21	A8K2U0-1	1311	1332	+	21	A8K2U0-1	0	4362	ENST00000299698.12	31	4393	++	19	A8K2U0-1#79	0	21	ENST00000299698.12	1342	1363	+	21	0	0	5927
A8K2U0-1#80	0	9	9	A8K2U0-1	1341	1350	+	9	A8K2U0-1	0	4362	ENST00000299698.12	31	4393	++	19	A8K2U0-1#80	0	9	ENST00000299698.12	1372	1381	+	9	0	0	5928
A8K2U0-1#81	0	12	12	A8K2U0-1	1353	1365	+	12	A8K2U0-1	1350	4362	ENST00000541459.5	0	3012	+	160	A8K2U0-1#81	0	12	ENST00000541459.5	3	15	+	12	0	0	5929
A8K2U0-1#81	0	12	12	A8K2U0-1	1353	1365	+	12	A8K2U0-1	0	4362	ENST00000299698.12	31	4393	++	19	A8K2U0-1#81	0	12	ENST00000299698.12	1384	1396	+	12	0	0	5930
A8K2U0-1#82	0	30	30	A8K2U0-1	1395	1425	+	30	A8K2U0-1	1350	4362	ENST00000541459.5	0	3012	+	160	A8K2U0-1#82	0	30	ENST00000541459.5	45	75	+	30	0	0	5931
A8K2U0-1#82	0	30	30	A8K2U0-1	1395	1425	+	30	A8K2U0-1	0	4362	ENST00000299698.12	31	4393	++	19	A8K2U0-1#82	0	30	ENST00000299698.12	1426	1456	+	30	0	0	5932
A8K2U0-1#83	0	9	9	A8K2U0-1	1434	1443	+	9	A8K2U0-1	1350	4362	ENST00000541459.5	0	3012	+	160	A8K2U0-1#83	0	9	ENST00000541459.5	84	93	+	9	0	0	5933
A8K2U0-1#83	0	9	9	A8K2U0-1	1434	1443	+	9	A8K2U0-1	0	4362	ENST00000299698.12	31	4393	++	19	A8K2U0-1#83	0	9	ENST00000299698.12	1465	1474	+	9	0	0	5934
A8K2U0-1#84	0	9	9	A8K2U0-1	1446	1455	+	9	A8K2U0-1	1350	4362	ENST00000541459.5	0	3012	+	160	A8K2U0-1#84	0	9	ENST00000541459.5	96	105	+	9	0	0	5935
A8K2U0-1#84	0	9	9	A8K2U0-1	1446	1455	+	9	A8K2U0-1	0	4362	ENST00000299698.12	31	4393	++	19	A8K2U0-1#84	0	9	ENST00000299698.12	1477	1486	+	9	0	0	5936
A8K2U0-1#85	0	27	27	A8K2U0-1	1458	1485	+	27	A8K2U0-1	1476	2015	ENST00000545692.1	31	570	+	164	A8K2U0-1#85	18	27	ENST00000545692.1	31	40	+	9	18	0	5937
A8K2U0-1#85	0	27	27	A8K2U0-1	1458	1485	+	27	A8K2U0-1	1350	4362	ENST00000541459.5	0	3012	+	160	A8K2U0-1#85	0	27	ENST00000541459.5	108	135	+	27	0	0	5938
A8K2U0-1#85	0	27	27	A8K2U0-1	1458	1485	+	27	A8K2U0-1	1476	4362	ENST00000539547.5	171	3057	++	159	A8K2U0-1#85	18	27	ENST00000539547.5	171	180	+	9	18	0	5939
A8K2U0-1#85	0	27	27	A8K2U0-1	1458	1485	+	27	A8K2U0-1	1476	1585	ENST00000536789.5	353	462	+	157	A8K2U0-1#85	18	27	ENST00000536789.5	353	362	+	9	18	0	5940
A8K2U0-1#85	0	27	27	A8K2U0-1	1458	1485	+	27	A8K2U0-1	0	4362	ENST00000299698.12	31	4393	++	19	A8K2U0-1#85	0	27	ENST00000299698.12	1489	1516	+	27	0	0	5941
A8K2U0-1#86	0	30	30	A8K2U0-1	1491	1521	+	30	A8K2U0-1	1476	2015	ENST00000545692.1	31	570	+	164	A8K2U0-1#86	0	30	ENST00000545692.1	46	76	+	30	0	0	5942
A8K2U0-1#86	0	30	30	A8K2U0-1	1491	1521	+	30	A8K2U0-1	1350	4362	ENST00000541459.5	0	3012	+	160	A8K2U0-1#86	0	30	ENST00000541459.5	141	171	+	30	0	0	5943
A8K2U0-1#86	0	30	30	A8K2U0-1	1491	1521	+	30	A8K2U0-1	1476	4362	ENST00000539547.5	171	3057	++	159	A8K2U0-1#86	0	30	ENST00000539547.5	186	216	+	30	0	0	5944
A8K2U0-1#86	0	30	30	A8K2U0-1	1491	1521	+	30	A8K2U0-1	1476	1585	ENST00000536789.5	353	462	+	157	A8K2U0-1#86	0	30	ENST00000536789.5	368	398	+	30	0	0	5945
A8K2U0-1#86	0	30	30	A8K2U0-1	1491	1521	+	30	A8K2U0-1	0	4362	ENST00000299698.12	31	4393	++	19	A8K2U0-1#86	0	30	ENST00000299698.12	1522	1552	+	30	0	0	5946
A8K2U0-1#87	0	9	9	A8K2U0-1	1524	1533	+	9	A8K2U0-1	1476	2015	ENST00000545692.1	31	570	+	164	A8K2U0-1#87	0	9	ENST00000545692.1	79	88	+	9	0	0	5947
A8K2U0-1#87	0	9	9	A8K2U0-1	1524	1533	+	9	A8K2U0-1	1350	4362	ENST00000541459.5	0	3012	+	160	A8K2U0-1#87	0	9	ENST00000541459.5	174	183	+	9	0	0	5948
A8K2U0-1#87	0	9	9	A8K2U0-1	1524	1533	+	9	A8K2U0-1	1476	4362	ENST00000539547.5	171	3057	++	159	A8K2U0-1#87	0	9	ENST00000539547.5	219	228	+	9	0	0	5949
A8K2U0-1#87	0	9	9	A8K2U0-1	1524	1533	+	9	A8K2U0-1	1476	1585	ENST00000536789.5	353	462	+	157	A8K2U0-1#87	0	9	ENST00000536789.5	401	410	+	9	0	0	5950
A8K2U0-1#87	0	9	9	A8K2U0-1	1524	1533	+	9	A8K2U0-1	0	4362	ENST00000299698.12	31	4393	++	19	A8K2U0-1#87	0	9	ENST00000299698.12	1555	1564	+	9	0	0	5951
A8K2U0-1#88	0	24	24	A8K2U0-1	1545	1569	+	24	A8K2U0-1	1476	2015	ENST00000545692.1	31	570	+	164	A8K2U0-1#88	0	24	ENST00000545692.1	100	124	+	24	0	0	5952
A8K2U0-1#88	0	24	24	A8K2U0-1	1545	1569	+	24	A8K2U0-1	1350	4362	ENST00000541459.5	0	3012	+	160	A8K2U0-1#88	0	24	ENST00000541459.5	195	219	+	24	0	0	5953
A8K2U0-1#88	0	24	24	A8K2U0-1	1545	1569	+	24	A8K2U0-1	1476	4362	ENST00000539547.5	171	3057	++	159	A8K2U0-1#88	0	24	ENST00000539547.5	240	264	+	24	0	0	5954
A8K2U0-1#88	0	24	24	A8K2U0-1	1545	1569	+	24	A8K2U0-1	1476	1585	ENST00000536789.5	353	462	+	157	A8K2U0-1#88	0	24	ENST00000536789.5	422	446	+	24	0	0	5955
A8K2U0-1#88	0	24	24	A8K2U0-1	1545	1569	+	24	A8K2U0-1	0	4362	ENST00000299698.12	31	4393	++	19	A8K2U0-1#88	0	24	ENST00000299698.12	1576	1600	+	24	0	0	5956
A8K2U0-1#89	0	9	9	A8K2U0-1	1575	1584	+	9	A8K2U0-1	1476	2015	ENST00000545692.1	31	570	+	164	A8K2U0-1#89	0	9	ENST00000545692.1	130	139	+	9	0	0	5957
A8K2U0-1#89	0	9	9	A8K2U0-1	1575	1584	+	9	A8K2U0-1	1350	4362	ENST00000541459.5	0	3012	+	160	A8K2U0-1#89	0	9	ENST00000541459.5	225	234	+	9	0	0	5958
A8K2U0-1#89	0	9	9	A8K2U0-1	1575	1584	+	9	A8K2U0-1	1476	4362	ENST00000539547.5	171	3057	++	159	A8K2U0-1#89	0	9	ENST00000539547.5	270	279	+	9	0	0	5959
A8K2U0-1#89	0	9	9	A8K2U0-1	1575	1584	+	9	A8K2U0-1	1476	1585	ENST00000536789.5	353	462	+	157	A8K2U0-1#89	0	9	ENST00000536789.5	452	461	+	9	0	0	5960
A8K2U0-1#89	0	9	9	A8K2U0-1	1575	1584	+	9	A8K2U0-1	0	4362	ENST00000299698.12	31	4393	++	19	A8K2U0-1#89	0	9	ENST00000299698.12	1606	1615	+	9	0	0	5961
A8K2U0-1#90	0	21	21	A8K2U0-1	1596	1617	+	21	A8K2U0-1	1476	2015	ENST00000545692.1	31	570	+	164	A8K2U0-1#90	0	21	ENST00000545692.1	151	172	+	21	0	0	5962
A8K2U0-1#90	0	21	21	A8K2U0-1	1596	1617	+	21	A8K2U0-1	1350	4362	ENST00000541459.5	0	3012	+	160	A8K2U0-1#90	0	21	ENST00000541459.5	246	267	+	21	0	0	5963
A8K2U0-1#90	0	21	21	A8K2U0-1	1596	1617	+	21	A8K2U0-1	1476	4362	ENST00000539547.5	171	3057	++	159	A8K2U0-1#90	0	21	ENST00000539547.5	291	312	+	21	0	0	5964
A8K2U0-1#90	0	21	21	A8K2U0-1	1596	1617	+	21	A8K2U0-1	0	4362	ENST00000299698.12	31	4393	++	19	A8K2U0-1#90	0	21	ENST00000299698.12	1627	1648	+	21	0	0	5965
A8K2U0-1#91	0	9	9	A8K2U0-1	1620	1629	+	9	A8K2U0-1	1476	2015	ENST00000545692.1	31	570	+	164	A8K2U0-1#91	0	9	ENST00000545692.1	175	184	+	9	0	0	5966
A8K2U0-1#91	0	9	9	A8K2U0-1	1620	1629	+	9	A8K2U0-1	1350	4362	ENST00000541459.5	0	3012	+	160	A8K2U0-1#91	0	9	ENST00000541459.5	270	279	+	9	0	0	5967
A8K2U0-1#91	0	9	9	A8K2U0-1	1620	1629	+	9	A8K2U0-1	1476	4362	ENST00000539547.5	171	3057	++	159	A8K2U0-1#91	0	9	ENST00000539547.5	315	324	+	9	0	0	5968
A8K2U0-1#91	0	9	9	A8K2U0-1	1620	1629	+	9	A8K2U0-1	0	4362	ENST00000299698.12	31	4393	++	19	A8K2U0-1#91	0	9	ENST00000299698.12	1651	1660	+	9	0	0	5969
A8K2U0-1#92	0	21	21	A8K2U0-1	1632	1653	+	21	A8K2U0-1	1476	2015	ENST00000545692.1	31	570	+	164	A8K2U0-1#92	0	21	ENST00000545692.1	187	208	+	21	0	0	5970
A8K2U0-1#92	0	21	21	A8K2U0-1	1632	1653	+	21	A8K2U0-1	1350	4362	ENST00000541459.5	0	3012	+	160	A8K2U0-1#92	0	21	ENST00000541459.5	282	303	+	21	0	0	5971
A8K2U0-1#92	0	21	21	A8K2U0-1	1632	1653	+	21	A8K2U0-1	1476	4362	ENST00000539547.5	171	3057	++	159	A8K2U0-1#92	0	21	ENST00000539547.5	327	348	+	21	0	0	5972
A8K2U0-1#92	0	21	21	A8K2U0-1	1632	1653	+	21	A8K2U0-1	0	4362	ENST00000299698.12	31	4393	++	19	A8K2U0-1#92	0	21	ENST00000299698.12	1663	1684	+	21	0	0	5973
A8K2U0-1#93	0	27	27	A8K2U0-1	1686	1713	+	27	A8K2U0-1	1476	2015	ENST00000545692.1	31	570	+	164	A8K2U0-1#93	0	27	ENST00000545692.1	241	268	+	27	0	0	5974
A8K2U0-1#93	0	27	27	A8K2U0-1	1686	1713	+	27	A8K2U0-1	1350	4362	ENST00000541459.5	0	3012	+	160	A8K2U0-1#93	0	27	ENST00000541459.5	336	363	+	27	0	0	5975
A8K2U0-1#93	0	27	27	A8K2U0-1	1686	1713	+	27	A8K2U0-1	1476	4362	ENST00000539547.5	171	3057	++	159	A8K2U0-1#93	0	27	ENST00000539547.5	381	408	+	27	0	0	5976
A8K2U0-1#93	0	27	27	A8K2U0-1	1686	1713	+	27	A8K2U0-1	0	4362	ENST00000299698.12	31	4393	++	19	A8K2U0-1#93	0	27	ENST00000299698.12	1717	1744	+	27	0	0	5977
A8K2U0-1#94	0	24	24	A8K2U0-1	1722	1746	+	24	A8K2U0-1	1476	2015	ENST00000545692.1	31	570	+	164	A8K2U0-1#94	0	24	ENST00000545692.1	277	301	+	24	0	0	5978
A8K2U0-1#94	0	24	24	A8K2U0-1	1722	1746	+	24	A8K2U0-1	1350	4362	ENST00000541459.5	0	3012	+	160	A8K2U0-1#94	0	24	ENST00000541459.5	372	396	+	24	0	0	5979
A8K2U0-1#94	0	24	24	A8K2U0-1	1722	1746	+	24	A8K2U0-1	1476	4362	ENST00000539547.5	171	3057	++	159	A8K2U0-1#94	0	24	ENST00000539547.5	417	441	+	24	0	0	5980
A8K2U0-1#94	0	24	24	A8K2U0-1	1722	1746	+	24	A8K2U0-1	0	4362	ENST00000299698.12	31	4393	++	19	A8K2U0-1#94	0	24	ENST00000299698.12	1753	1777	+	24	0	0	5981
A8K2U0-1#95	0	24	24	A8K2U0-1	1761	1785	+	24	A8K2U0-1	1476	2015	ENST00000545692.1	31	570	+	164	A8K2U0-1#95	0	24	ENST00000545692.1	316	340	+	24	0	0	5982
A8K2U0-1#95	0	24	24	A8K2U0-1	1761	1785	+	24	A8K2U0-1	1350	4362	ENST00000541459.5	0	3012	+	160	A8K2U0-1#95	0	24	ENST00000541459.5	411	435	+	24	0	0	5983
A8K2U0-1#95	0	24	24	A8K2U0-1	1761	1785	+	24	A8K2U0-1	1476	4362	ENST00000539547.5	171	3057	++	159	A8K2U0-1#95	0	24	ENST00000539547.5	456	480	+	24	0	0	5984
A8K2U0-1#95	0	24	24	A8K2U0-1	1761	1785	+	24	A8K2U0-1	0	4362	ENST00000299698.12	31	4393	++	19	A8K2U0-1#95	0	24	ENST00000299698.12	1792	1816	+	24	0	0	5985
A8K2U0-1#96	0	18	18	A8K2U0-1	1785	1803	+	18	A8K2U0-1	1476	2015	ENST00000545692.1	31	570	+	164	A8K2U0-1#96	0	18	ENST00000545692.1	340	358	+	18	0	0	5986
A8K2U0-1#96	0	18	18	A8K2U0-1	1785	1803	+	18	A8K2U0-1	1350	4362	ENST00000541459.5	0	3012	+	160	A8K2U0-1#96	0	18	ENST00000541459.5	435	453	+	18	0	0	5987
A8K2U0-1#96	0	18	18	A8K2U0-1	1785	1803	+	18	A8K2U0-1	1476	4362	ENST00000539547.5	171	3057	++	159	A8K2U0-1#96	0	18	ENST00000539547.5	480	498	+	18	0	0	5988
A8K2U0-1#96	0	18	18	A8K2U0-1	1785	1803	+	18	A8K2U0-1	0	4362	ENST00000299698.12	31	4393	++	19	A8K2U0-1#96	0	18	ENST00000299698.12	1816	1834	+	18	0	0	5989
A8K2U0-1#97	0	12	12	A8K2U0-1	1806	1818	+	12	A8K2U0-1	1476	2015	ENST00000545692.1	31	570	+	164	A8K2U0-1#97	0	12	ENST00000545692.1	361	373	+	12	0	0	5990
A8K2U0-1#97	0	12	12	A8K2U0-1	1806	1818	+	12	A8K2U0-1	1350	4362	ENST00000541459.5	0	3012	+	160	A8K2U0-1#97	0	12	ENST00000541459.5	456	468	+	12	0	0	5991
A8K2U0-1#97	0	12	12	A8K2U0-1	1806	1818	+	12	A8K2U0-1	1476	4362	ENST00000539547.5	171	3057	++	159	A8K2U0-1#97	0	12	ENST00000539547.5	501	513	+	12	0	0	5992
A8K2U0-1#97	0	12	12	A8K2U0-1	1806	1818	+	12	A8K2U0-1	0	4362	ENST00000299698.12	31	4393	++	19	A8K2U0-1#97	0	12	ENST00000299698.12	1837	1849	+	12	0	0	5993
A8K2U0-1#98	0	18	18	A8K2U0-1	1824	1842	+	18	A8K2U0-1	1476	2015	ENST00000545692.1	31	570	+	164	A8K2U0-1#98	0	18	ENST00000545692.1	379	397	+	18	0	0	5994
A8K2U0-1#98	0	18	18	A8K2U0-1	1824	1842	+	18	A8K2U0-1	1350	4362	ENST00000541459.5	0	3012	+	160	A8K2U0-1#98	0	18	ENST00000541459.5	474	492	+	18	0	0	5995
A8K2U0-1#98	0	18	18	A8K2U0-1	1824	1842	+	18	A8K2U0-1	1476	4362	ENST00000539547.5	171	3057	++	159	A8K2U0-1#98	0	18	ENST00000539547.5	519	537	+	18	0	0	5996
A8K2U0-1#98	0	18	18	A8K2U0-1	1824	1842	+	18	A8K2U0-1	0	4362	ENST00000299698.12	31	4393	++	19	A8K2U0-1#98	0	18	ENST00000299698.12	1855	1873	+	18	0	0	5997
A8K2U0-1#99	0	9	9	A8K2U0-1	1872	1881	+	9	A8K2U0-1	1476	2015	ENST00000545692.1	31	570	+	164	A8K2U0-1#99	0	9	ENST00000545692.1	427	436	+	9	0	0	5998
A8K2U0-1#99	0	9	9	A8K2U0-1	1872	1881	+	9	A8K2U0-1	1350	4362	ENST00000541459.5	0	3012	+	160	A8K2U0-1#99	0	9	ENST00000541459.5	522	531	+	9	0	0	5999
A8K2U0-1#99	0	9	9	A8K2U0-1	1872	1881	+	9	A8K2U0-1	1476	4362	ENST00000539547.5	171	3057	++	159	A8K2U0-1#99	0	9	ENST00000539547.5	567	576	+	9	0	0	6000
A8K2U0-1#99	0	9	9	A8K2U0-1	1872	1881	+	9	A8K2U0-1	0	4362	ENST00000299698.12	31	4393	++	19	A8K2U0-1#99	0	9	ENST00000299698.12	1903	1912	+	9	0	0	6001
A8K2U0-1#100	0	18	18	A8K2U0-1	2010	2028	+	18	A8K2U0-1	1476	2015	ENST00000545692.1	31	570	+	164	A8K2U0-1#100	0	5	ENST00000545692.1	565	570	+	5	0	13	6002
A8K2U0-1#100	0	18	18	A8K2U0-1	2010	2028	+	18	A8K2U0-1	1350	4362	ENST00000541459.5	0	3012	+	160	A8K2U0-1#100	0	18	ENST00000541459.5	660	678	+	18	0	0	6003
A8K2U0-1#100	0	18	18	A8K2U0-1	2010	2028	+	18	A8K2U0-1	1476	4362	ENST00000539547.5	171	3057	++	159	A8K2U0-1#100	0	18	ENST00000539547.5	705	723	+	18	0	0	6004
A8K2U0-1#100	0	18	18	A8K2U0-1	2010	2028	+	18	A8K2U0-1	0	4362	ENST00000299698.12	31	4393	++	19	A8K2U0-1#100	0	18	ENST00000299698.12	2041	2059	+	18	0	0	6005
A8K2U0-1#101	0	9	9	A8K2U0-1	2028	2037	+	9	A8K2U0-1	1350	4362	ENST00000541459.5	0	3012	+	160	A8K2U0-1#101	0	9	ENST00000541459.5	678	687	+	9	0	0	6006
A8K2U0-1#101	0	9	9	A8K2U0-1	2028	2037	+	9	A8K2U0-1	1476	4362	ENST00000539547.5	171	3057	++	159	A8K2U0-1#101	0	9	ENST00000539547.5	723	732	+	9	0	0	6007
A8K2U0-1#101	0	9	9	A8K2U0-1	2028	2037	+	9	A8K2U0-1	0	4362	ENST00000299698.12	31	4393	++	19	A8K2U0-1#101	0	9	ENST00000299698.12	2059	2068	+	9	0	0	6008
A8K2U0-1#102	0	24	24	A8K2U0-1	2037	2061	+	24	A8K2U0-1	1350	4362	ENST00000541459.5	0	3012	+	160	A8K2U0-1#102	0	24	ENST00000541459.5	687	711	+	24	0	0	6009
A8K2U0-1#102	0	24	24	A8K2U0-1	2037	2061	+	24	A8K2U0-1	1476	4362	ENST00000539547.5	171	3057	++	159	A8K2U0-1#102	0	24	ENST00000539547.5	732	756	+	24	0	0	6010
A8K2U0-1#102	0	24	24	A8K2U0-1	2037	2061	+	24	A8K2U0-1	0	4362	ENST00000299698.12	31	4393	++	19	A8K2U0-1#102	0	24	ENST00000299698.12	2068	2092	+	24	0	0	6011
A8K2U0-1#103	0	27	27	A8K2U0-1	2202	2229	+	27	A8K2U0-1	1350	4362	ENST00000541459.5	0	3012	+	160	A8K2U0-1#103	0	27	ENST00000541459.5	852	879	+	27	0	0	6012
A8K2U0-1#103	0	27	27	A8K2U0-1	2202	2229	+	27	A8K2U0-1	1476	4362	ENST00000539547.5	171	3057	++	159	A8K2U0-1#103	0	27	ENST00000539547.5	897	924	+	27	0	0	6013
A8K2U0-1#103	0	27	27	A8K2U0-1	2202	2229	+	27	A8K2U0-1	0	4362	ENST00000299698.12	31	4393	++	19	A8K2U0-1#103	0	27	ENST00000299698.12	2233	2260	+	27	0	0	6014
A8K2U0-1#104	0	24	24	A8K2U0-1	2241	2265	+	24	A8K2U0-1	1350	4362	ENST00000541459.5	0	3012	+	160	A8K2U0-1#104	0	24	ENST00000541459.5	891	915	+	24	0	0	6015
A8K2U0-1#104	0	24	24	A8K2U0-1	2241	2265	+	24	A8K2U0-1	1476	4362	ENST00000539547.5	171	3057	++	159	A8K2U0-1#104	0	24	ENST00000539547.5	936	960	+	24	0	0	6016
A8K2U0-1#104	0	24	24	A8K2U0-1	2241	2265	+	24	A8K2U0-1	0	4362	ENST00000299698.12	31	4393	++	19	A8K2U0-1#104	0	24	ENST00000299698.12	2272	2296	+	24	0	0	6017
A8K2U0-1#105	0	36	36	A8K2U0-1	2277	2313	+	36	A8K2U0-1	1350	4362	ENST00000541459.5	0	3012	+	160	A8K2U0-1#105	0	36	ENST00000541459.5	927	963	+	36	0	0	6018
A8K2U0-1#105	0	36	36	A8K2U0-1	2277	2313	+	36	A8K2U0-1	1476	4362	ENST00000539547.5	171	3057	++	159	A8K2U0-1#105	0	36	ENST00000539547.5	972	1008	+	36	0	0	6019
A8K2U0-1#105	0	36	36	A8K2U0-1	2277	2313	+	36	A8K2U0-1	0	4362	ENST00000299698.12	31	4393	++	19	A8K2U0-1#105	0	36	ENST00000299698.12	2308	2344	+	36	0	0	6020
A8K2U0-1#106	0	9	9	A8K2U0-1	2313	2322	+	9	A8K2U0-1	1350	4362	ENST00000541459.5	0	3012	+	160	A8K2U0-1#106	0	9	ENST00000541459.5	963	972	+	9	0	0	6021
A8K2U0-1#106	0	9	9	A8K2U0-1	2313	2322	+	9	A8K2U0-1	1476	4362	ENST00000539547.5	171	3057	++	159	A8K2U0-1#106	0	9	ENST00000539547.5	1008	1017	+	9	0	0	6022
A8K2U0-1#106	0	9	9	A8K2U0-1	2313	2322	+	9	A8K2U0-1	0	4362	ENST00000299698.12	31	4393	++	19	A8K2U0-1#106	0	9	ENST00000299698.12	2344	2353	+	9	0	0	6023
A8K2U0-1#107	0	12	12	A8K2U0-1	2322	2334	+	12	A8K2U0-1	1350	4362	ENST00000541459.5	0	3012	+	160	A8K2U0-1#107	0	12	ENST00000541459.5	972	984	+	12	0	0	6024
A8K2U0-1#107	0	12	12	A8K2U0-1	2322	2334	+	12	A8K2U0-1	1476	4362	ENST00000539547.5	171	3057	++	159	A8K2U0-1#107	0	12	ENST00000539547.5	1017	1029	+	12	0	0	6025
A8K2U0-1#107	0	12	12	A8K2U0-1	2322	2334	+	12	A8K2U0-1	0	4362	ENST00000299698.12	31	4393	++	19	A8K2U0-1#107	0	12	ENST00000299698.12	2353	2365	+	12	0	0	6026
A8K2U0-1#108	0	15	15	A8K2U0-1	2343	2358	+	15	A8K2U0-1	1350	4362	ENST00000541459.5	0	3012	+	160	A8K2U0-1#108	0	15	ENST00000541459.5	993	1008	+	15	0	0	6027
A8K2U0-1#108	0	15	15	A8K2U0-1	2343	2358	+	15	A8K2U0-1	1476	4362	ENST00000539547.5	171	3057	++	159	A8K2U0-1#108	0	15	ENST00000539547.5	1038	1053	+	15	0	0	6028
A8K2U0-1#108	0	15	15	A8K2U0-1	2343	2358	+	15	A8K2U0-1	0	4362	ENST00000299698.12	31	4393	++	19	A8K2U0-1#108	0	15	ENST00000299698.12	2374	2389	+	15	0	0	6029
A8K2U0-1#109	0	21	21	A8K2U0-1	2364	2385	+	21	A8K2U0-1	1350	4362	ENST00000541459.5	0	3012	+	160	A8K2U0-1#109	0	21	ENST00000541459.5	1014	1035	+	21	0	0	6030
A8K2U0-1#109	0	21	21	A8K2U0-1	2364	2385	+	21	A8K2U0-1	1476	4362	ENST00000539547.5	171	3057	++	159	A8K2U0-1#109	0	21	ENST00000539547.5	1059	1080	+	21	0	0	6031
A8K2U0-1#109	0	21	21	A8K2U0-1	2364	2385	+	21	A8K2U0-1	0	4362	ENST00000299698.12	31	4393	++	19	A8K2U0-1#109	0	21	ENST00000299698.12	2395	2416	+	21	0	0	6032
A8K2U0-1#110	0	12	12	A8K2U0-1	2391	2403	+	12	A8K2U0-1	1350	4362	ENST00000541459.5	0	3012	+	160	A8K2U0-1#110	0	12	ENST00000541459.5	1041	1053	+	12	0	0	6033
A8K2U0-1#110	0	12	12	A8K2U0-1	2391	2403	+	12	A8K2U0-1	1476	4362	ENST00000539547.5	171	3057	++	159	A8K2U0-1#110	0	12	ENST00000539547.5	1086	1098	+	12	0	0	6034
A8K2U0-1#110	0	12	12	A8K2U0-1	2391	2403	+	12	A8K2U0-1	0	4362	ENST00000299698.12	31	4393	++	19	A8K2U0-1#110	0	12	ENST00000299698.12	2422	2434	+	12	0	0	6035
A8K2U0-1#111	0	33	33	A8K2U0-1	2409	2442	+	33	A8K2U0-1	1350	4362	ENST00000541459.5	0	3012	+	160	A8K2U0-1#111	0	33	ENST00000541459.5	1059	1092	+	33	0	0	6036
A8K2U0-1#111	0	33	33	A8K2U0-1	2409	2442	+	33	A8K2U0-1	1476	4362	ENST00000539547.5	171	3057	++	159	A8K2U0-1#111	0	33	ENST00000539547.5	1104	1137	+	33	0	0	6037
A8K2U0-1#111	0	33	33	A8K2U0-1	2409	2442	+	33	A8K2U0-1	0	4362	ENST00000299698.12	31	4393	++	19	A8K2U0-1#111	0	33	ENST00000299698.12	2440	2473	+	33	0	0	6038
A8K2U0-1#112	0	9	9	A8K2U0-1	2445	2454	+	9	A8K2U0-1	1350	4362	ENST00000541459.5	0	3012	+	160	A8K2U0-1#112	0	9	ENST00000541459.5	1095	1104	+	9	0	0	6039
A8K2U0-1#112	0	9	9	A8K2U0-1	2445	2454	+	9	A8K2U0-1	1476	4362	ENST00000539547.5	171	3057	++	159	A8K2U0-1#112	0	9	ENST00000539547.5	1140	1149	+	9	0	0	6040
A8K2U0-1#112	0	9	9	A8K2U0-1	2445	2454	+	9	A8K2U0-1	0	4362	ENST00000299698.12	31	4393	++	19	A8K2U0-1#112	0	9	ENST00000299698.12	2476	2485	+	9	0	0	6041
A8K2U0-1#113	0	21	21	A8K2U0-1	2457	2478	+	21	A8K2U0-1	1350	4362	ENST00000541459.5	0	3012	+	160	A8K2U0-1#113	0	21	ENST00000541459.5	1107	1128	+	21	0	0	6042
A8K2U0-1#113	0	21	21	A8K2U0-1	2457	2478	+	21	A8K2U0-1	1476	4362	ENST00000539547.5	171	3057	++	159	A8K2U0-1#113	0	21	ENST00000539547.5	1152	1173	+	21	0	0	6043
A8K2U0-1#113	0	21	21	A8K2U0-1	2457	2478	+	21	A8K2U0-1	0	4362	ENST00000299698.12	31	4393	++	19	A8K2U0-1#113	0	21	ENST00000299698.12	2488	2509	+	21	0	0	6044
A8K2U0-1#114	0	9	9	A8K2U0-1	2493	2502	+	9	A8K2U0-1	1350	4362	ENST00000541459.5	0	3012	+	160	A8K2U0-1#114	0	9	ENST00000541459.5	1143	1152	+	9	0	0	6045
A8K2U0-1#114	0	9	9	A8K2U0-1	2493	2502	+	9	A8K2U0-1	1476	4362	ENST00000539547.5	171	3057	++	159	A8K2U0-1#114	0	9	ENST00000539547.5	1188	1197	+	9	0	0	6046
A8K2U0-1#114	0	9	9	A8K2U0-1	2493	2502	+	9	A8K2U0-1	0	4362	ENST00000299698.12	31	4393	++	19	A8K2U0-1#114	0	9	ENST00000299698.12	2524	2533	+	9	0	0	6047
A8K2U0-1#115	0	9	9	A8K2U0-1	2511	2520	+	9	A8K2U0-1	1350	4362	ENST00000541459.5	0	3012	+	160	A8K2U0-1#115	0	9	ENST00000541459.5	1161	1170	+	9	0	0	6048
A8K2U0-1#115	0	9	9	A8K2U0-1	2511	2520	+	9	A8K2U0-1	1476	4362	ENST00000539547.5	171	3057	++	159	A8K2U0-1#115	0	9	ENST00000539547.5	1206	1215	+	9	0	0	6049
A8K2U0-1#115	0	9	9	A8K2U0-1	2511	2520	+	9	A8K2U0-1	0	4362	ENST00000299698.12	31	4393	++	19	A8K2U0-1#115	0	9	ENST00000299698.12	2542	2551	+	9	0	0	6050
A8K2U0-1#116	0	18	18	A8K2U0-1	2520	2538	+	18	A8K2U0-1	1350	4362	ENST00000541459.5	0	3012	+	160	A8K2U0-1#116	0	18	ENST00000541459.5	1170	1188	+	18	0	0	6051
A8K2U0-1#116	0	18	18	A8K2U0-1	2520	2538	+	18	A8K2U0-1	1476	4362	ENST00000539547.5	171	3057	++	159	A8K2U0-1#116	0	18	ENST00000539547.5	1215	1233	+	18	0	0	6052
A8K2U0-1#116	0	18	18	A8K2U0-1	2520	2538	+	18	A8K2U0-1	0	4362	ENST00000299698.12	31	4393	++	19	A8K2U0-1#116	0	18	ENST00000299698.12	2551	2569	+	18	0	0	6053
A8K2U0-1#117	0	33	33	A8K2U0-1	2547	2580	+	33	A8K2U0-1	1350	4362	ENST00000541459.5	0	3012	+	160	A8K2U0-1#117	0	33	ENST00000541459.5	1197	1230	+	33	0	0	6054
A8K2U0-1#117	0	33	33	A8K2U0-1	2547	2580	+	33	A8K2U0-1	1476	4362	ENST00000539547.5	171	3057	++	159	A8K2U0-1#117	0	33	ENST00000539547.5	1242	1275	+	33	0	0	6055
A8K2U0-1#117	0	33	33	A8K2U0-1	2547	2580	+	33	A8K2U0-1	0	4362	ENST00000299698.12	31	4393	++	19	A8K2U0-1#117	0	33	ENST00000299698.12	2578	2611	+	33	0	0	6056
A8K2U0-1#118	0	33	33	A8K2U0-1	2589	2622	+	33	A8K2U0-1	1350	4362	ENST00000541459.5	0	3012	+	160	A8K2U0-1#118	0	33	ENST00000541459.5	1239	1272	+	33	0	0	6057
A8K2U0-1#118	0	33	33	A8K2U0-1	2589	2622	+	33	A8K2U0-1	1476	4362	ENST00000539547.5	171	3057	++	159	A8K2U0-1#118	0	33	ENST00000539547.5	1284	1317	+	33	0	0	6058
A8K2U0-1#118	0	33	33	A8K2U0-1	2589	2622	+	33	A8K2U0-1	0	4362	ENST00000299698.12	31	4393	++	19	A8K2U0-1#118	0	33	ENST00000299698.12	2620	2653	+	33	0	0	6059
A8K2U0-1#119	0	9	9	A8K2U0-1	2640	2649	+	9	A8K2U0-1	1350	4362	ENST00000541459.5	0	3012	+	160	A8K2U0-1#119	0	9	ENST00000541459.5	1290	1299	+	9	0	0	6060
A8K2U0-1#119	0	9	9	A8K2U0-1	2640	2649	+	9	A8K2U0-1	1476	4362	ENST00000539547.5	171	3057	++	159	A8K2U0-1#119	0	9	ENST00000539547.5	1335	1344	+	9	0	0	6061
A8K2U0-1#119	0	9	9	A8K2U0-1	2640	2649	+	9	A8K2U0-1	0	4362	ENST00000299698.12	31	4393	++	19	A8K2U0-1#119	0	9	ENST00000299698.12	2671	2680	+	9	0	0	6062
A8K2U0-1#120	0	9	9	A8K2U0-1	2667	2676	+	9	A8K2U0-1	1350	4362	ENST00000541459.5	0	3012	+	160	A8K2U0-1#120	0	9	ENST00000541459.5	1317	1326	+	9	0	0	6063
A8K2U0-1#120	0	9	9	A8K2U0-1	2667	2676	+	9	A8K2U0-1	1476	4362	ENST00000539547.5	171	3057	++	159	A8K2U0-1#120	0	9	ENST00000539547.5	1362	1371	+	9	0	0	6064
A8K2U0-1#120	0	9	9	A8K2U0-1	2667	2676	+	9	A8K2U0-1	0	4362	ENST00000299698.12	31	4393	++	19	A8K2U0-1#120	0	9	ENST00000299698.12	2698	2707	+	9	0	0	6065
A8K2U0-1#121	0	33	33	A8K2U0-1	2679	2712	+	33	A8K2U0-1	1350	4362	ENST00000541459.5	0	3012	+	160	A8K2U0-1#121	0	33	ENST00000541459.5	1329	1362	+	33	0	0	6066
A8K2U0-1#121	0	33	33	A8K2U0-1	2679	2712	+	33	A8K2U0-1	1476	4362	ENST00000539547.5	171	3057	++	159	A8K2U0-1#121	0	33	ENST00000539547.5	1374	1407	+	33	0	0	6067
A8K2U0-1#121	0	33	33	A8K2U0-1	2679	2712	+	33	A8K2U0-1	0	4362	ENST00000299698.12	31	4393	++	19	A8K2U0-1#121	0	33	ENST00000299698.12	2710	2743	+	33	0	0	6068
A8K2U0-1#122	0	39	39	A8K2U0-1	2715	2754	+	39	A8K2U0-1	1350	4362	ENST00000541459.5	0	3012	+	160	A8K2U0-1#122	0	39	ENST00000541459.5	1365	1404	+	39	0	0	6069
A8K2U0-1#122	0	39	39	A8K2U0-1	2715	2754	+	39	A8K2U0-1	1476	4362	ENST00000539547.5	171	3057	++	159	A8K2U0-1#122	0	39	ENST00000539547.5	1410	1449	+	39	0	0	6070
A8K2U0-1#122	0	39	39	A8K2U0-1	2715	2754	+	39	A8K2U0-1	0	4362	ENST00000299698.12	31	4393	++	19	A8K2U0-1#122	0	39	ENST00000299698.12	2746	2785	+	39	0	0	6071
A8K2U0-1#123	0	30	30	A8K2U0-1	2760	2790	+	30	A8K2U0-1	1350	4362	ENST00000541459.5	0	3012	+	160	A8K2U0-1#123	0	30	ENST00000541459.5	1410	1440	+	30	0	0	6072
A8K2U0-1#123	0	30	30	A8K2U0-1	2760	2790	+	30	A8K2U0-1	1476	4362	ENST00000539547.5	171	3057	++	159	A8K2U0-1#123	0	30	ENST00000539547.5	1455	1485	+	30	0	0	6073
A8K2U0-1#123	0	30	30	A8K2U0-1	2760	2790	+	30	A8K2U0-1	0	4362	ENST00000299698.12	31	4393	++	19	A8K2U0-1#123	0	30	ENST00000299698.12	2791	2821	+	30	0	0	6074
A8K2U0-1#124	0	33	33	A8K2U0-1	2826	2859	+	33	A8K2U0-1	1350	4362	ENST00000541459.5	0	3012	+	160	A8K2U0-1#124	0	33	ENST00000541459.5	1476	1509	+	33	0	0	6075
A8K2U0-1#124	0	33	33	A8K2U0-1	2826	2859	+	33	A8K2U0-1	1476	4362	ENST00000539547.5	171	3057	++	159	A8K2U0-1#124	0	33	ENST00000539547.5	1521	1554	+	33	0	0	6076
A8K2U0-1#124	0	33	33	A8K2U0-1	2826	2859	+	33	A8K2U0-1	0	4362	ENST00000299698.12	31	4393	++	19	A8K2U0-1#124	0	33	ENST00000299698.12	2857	2890	+	33	0	0	6077
A8K2U0-1#125	0	24	24	A8K2U0-1	2865	2889	+	24	A8K2U0-1	1350	4362	ENST00000541459.5	0	3012	+	160	A8K2U0-1#125	0	24	ENST00000541459.5	1515	1539	+	24	0	0	6078
A8K2U0-1#125	0	24	24	A8K2U0-1	2865	2889	+	24	A8K2U0-1	1476	4362	ENST00000539547.5	171	3057	++	159	A8K2U0-1#125	0	24	ENST00000539547.5	1560	1584	+	24	0	0	6079
A8K2U0-1#125	0	24	24	A8K2U0-1	2865	2889	+	24	A8K2U0-1	0	4362	ENST00000299698.12	31	4393	++	19	A8K2U0-1#125	0	24	ENST00000299698.12	2896	2920	+	24	0	0	6080
A8K2U0-1#126	0	9	9	A8K2U0-1	2910	2919	+	9	A8K2U0-1	1350	4362	ENST00000541459.5	0	3012	+	160	A8K2U0-1#126	0	9	ENST00000541459.5	1560	1569	+	9	0	0	6081
A8K2U0-1#126	0	9	9	A8K2U0-1	2910	2919	+	9	A8K2U0-1	1476	4362	ENST00000539547.5	171	3057	++	159	A8K2U0-1#126	0	9	ENST00000539547.5	1605	1614	+	9	0	0	6082
A8K2U0-1#126	0	9	9	A8K2U0-1	2910	2919	+	9	A8K2U0-1	0	4362	ENST00000299698.12	31	4393	++	19	A8K2U0-1#126	0	9	ENST00000299698.12	2941	2950	+	9	0	0	6083
A8K2U0-1#127	0	45	45	A8K2U0-1	2922	2967	+	45	A8K2U0-1	1350	4362	ENST00000541459.5	0	3012	+	160	A8K2U0-1#127	0	45	ENST00000541459.5	1572	1617	+	45	0	0	6084
A8K2U0-1#127	0	45	45	A8K2U0-1	2922	2967	+	45	A8K2U0-1	1476	4362	ENST00000539547.5	171	3057	++	159	A8K2U0-1#127	0	45	ENST00000539547.5	1617	1662	+	45	0	0	6085
A8K2U0-1#127	0	45	45	A8K2U0-1	2922	2967	+	45	A8K2U0-1	0	4362	ENST00000299698.12	31	4393	++	19	A8K2U0-1#127	0	45	ENST00000299698.12	2953	2998	+	45	0	0	6086
A8K2U0-1#128	0	9	9	A8K2U0-1	2967	2976	+	9	A8K2U0-1	1350	4362	ENST00000541459.5	0	3012	+	160	A8K2U0-1#128	0	9	ENST00000541459.5	1617	1626	+	9	0	0	6087
A8K2U0-1#128	0	9	9	A8K2U0-1	2967	2976	+	9	A8K2U0-1	1476	4362	ENST00000539547.5	171	3057	++	159	A8K2U0-1#128	0	9	ENST00000539547.5	1662	1671	+	9	0	0	6088
A8K2U0-1#128	0	9	9	A8K2U0-1	2967	2976	+	9	A8K2U0-1	0	4362	ENST00000299698.12	31	4393	++	19	A8K2U0-1#128	0	9	ENST00000299698.12	2998	3007	+	9	0	0	6089
A8K2U0-1#129	0	45	45	A8K2U0-1	2985	3030	+	45	A8K2U0-1	1350	4362	ENST00000541459.5	0	3012	+	160	A8K2U0-1#129	0	45	ENST00000541459.5	1635	1680	+	45	0	0	6090
A8K2U0-1#129	0	45	45	A8K2U0-1	2985	3030	+	45	A8K2U0-1	1476	4362	ENST00000539547.5	171	3057	++	159	A8K2U0-1#129	0	45	ENST00000539547.5	1680	1725	+	45	0	0	6091
A8K2U0-1#129	0	45	45	A8K2U0-1	2985	3030	+	45	A8K2U0-1	0	4362	ENST00000299698.12	31	4393	++	19	A8K2U0-1#129	0	45	ENST00000299698.12	3016	3061	+	45	0	0	6092
A8K2U0-1#130	0	9	9	A8K2U0-1	3030	3039	+	9	A8K2U0-1	1350	4362	ENST00000541459.5	0	3012	+	160	A8K2U0-1#130	0	9	ENST00000541459.5	1680	1689	+	9	0	0	6093
A8K2U0-1#130	0	9	9	A8K2U0-1	3030	3039	+	9	A8K2U0-1	1476	4362	ENST00000539547.5	171	3057	++	159	A8K2U0-1#130	0	9	ENST00000539547.5	1725	1734	+	9	0	0	6094
A8K2U0-1#130	0	9	9	A8K2U0-1	3030	3039	+	9	A8K2U0-1	0	4362	ENST00000299698.12	31	4393	++	19	A8K2U0-1#130	0	9	ENST00000299698.12	3061	3070	+	9	0	0	6095
A8K2U0-1#131	0	9	9	A8K2U0-1	3039	3048	+	9	A8K2U0-1	1350	4362	ENST00000541459.5	0	3012	+	160	A8K2U0-1#131	0	9	ENST00000541459.5	1689	1698	+	9	0	0	6096
A8K2U0-1#131	0	9	9	A8K2U0-1	3039	3048	+	9	A8K2U0-1	1476	4362	ENST00000539547.5	171	3057	++	159	A8K2U0-1#131	0	9	ENST00000539547.5	1734	1743	+	9	0	0	6097
A8K2U0-1#131	0	9	9	A8K2U0-1	3039	3048	+	9	A8K2U0-1	0	4362	ENST00000299698.12	31	4393	++	19	A8K2U0-1#131	0	9	ENST00000299698.12	3070	3079	+	9	0	0	6098
A8K2U0-1#132	0	9	9	A8K2U0-1	3060	3069	+	9	A8K2U0-1	1350	4362	ENST00000541459.5	0	3012	+	160	A8K2U0-1#132	0	9	ENST00000541459.5	1710	1719	+	9	0	0	6099
A8K2U0-1#132	0	9	9	A8K2U0-1	3060	3069	+	9	A8K2U0-1	1476	4362	ENST00000539547.5	171	3057	++	159	A8K2U0-1#132	0	9	ENST00000539547.5	1755	1764	+	9	0	0	6100
A8K2U0-1#132	0	9	9	A8K2U0-1	3060	3069	+	9	A8K2U0-1	0	4362	ENST00000299698.12	31	4393	++	19	A8K2U0-1#132	0	9	ENST00000299698.12	3091	3100	+	9	0	0	6101
A8K2U0-1#133	0	12	12	A8K2U0-1	3072	3084	+	12	A8K2U0-1	1350	4362	ENST00000541459.5	0	3012	+	160	A8K2U0-1#133	0	12	ENST00000541459.5	1722	1734	+	12	0	0	6102
A8K2U0-1#133	0	12	12	A8K2U0-1	3072	3084	+	12	A8K2U0-1	1476	4362	ENST00000539547.5	171	3057	++	159	A8K2U0-1#133	0	12	ENST00000539547.5	1767	1779	+	12	0	0	6103
A8K2U0-1#133	0	12	12	A8K2U0-1	3072	3084	+	12	A8K2U0-1	0	4362	ENST00000299698.12	31	4393	++	19	A8K2U0-1#133	0	12	ENST00000299698.12	3103	3115	+	12	0	0	6104
A8K2U0-1#134	0	9	9	A8K2U0-1	3087	3096	+	9	A8K2U0-1	1350	4362	ENST00000541459.5	0	3012	+	160	A8K2U0-1#134	0	9	ENST00000541459.5	1737	1746	+	9	0	0	6105
A8K2U0-1#134	0	9	9	A8K2U0-1	3087	3096	+	9	A8K2U0-1	1476	4362	ENST00000539547.5	171	3057	++	159	A8K2U0-1#134	0	9	ENST00000539547.5	1782	1791	+	9	0	0	6106
A8K2U0-1#134	0	9	9	A8K2U0-1	3087	3096	+	9	A8K2U0-1	0	4362	ENST00000299698.12	31	4393	++	19	A8K2U0-1#134	0	9	ENST00000299698.12	3118	3127	+	9	0	0	6107
A8K2U0-1#135	0	33	33	A8K2U0-1	3102	3135	+	33	A8K2U0-1	1350	4362	ENST00000541459.5	0	3012	+	160	A8K2U0-1#135	0	33	ENST00000541459.5	1752	1785	+	33	0	0	6108
A8K2U0-1#135	0	33	33	A8K2U0-1	3102	3135	+	33	A8K2U0-1	1476	4362	ENST00000539547.5	171	3057	++	159	A8K2U0-1#135	0	33	ENST00000539547.5	1797	1830	+	33	0	0	6109
A8K2U0-1#135	0	33	33	A8K2U0-1	3102	3135	+	33	A8K2U0-1	0	4362	ENST00000299698.12	31	4393	++	19	A8K2U0-1#135	0	33	ENST00000299698.12	3133	3166	+	33	0	0	6110
A8K2U0-1#136	0	9	9	A8K2U0-1	3141	3150	+	9	A8K2U0-1	1350	4362	ENST00000541459.5	0	3012	+	160	A8K2U0-1#136	0	9	ENST00000541459.5	1791	1800	+	9	0	0	6111
A8K2U0-1#136	0	9	9	A8K2U0-1	3141	3150	+	9	A8K2U0-1	1476	4362	ENST00000539547.5	171	3057	++	159	A8K2U0-1#136	0	9	ENST00000539547.5	1836	1845	+	9	0	0	6112
A8K2U0-1#136	0	9	9	A8K2U0-1	3141	3150	+	9	A8K2U0-1	0	4362	ENST00000299698.12	31	4393	++	19	A8K2U0-1#136	0	9	ENST00000299698.12	3172	3181	+	9	0	0	6113
A8K2U0-1#137	0	39	39	A8K2U0-1	3168	3207	+	39	A8K2U0-1	1350	4362	ENST00000541459.5	0	3012	+	160	A8K2U0-1#137	0	39	ENST00000541459.5	1818	1857	+	39	0	0	6114
A8K2U0-1#137	0	39	39	A8K2U0-1	3168	3207	+	39	A8K2U0-1	1476	4362	ENST00000539547.5	171	3057	++	159	A8K2U0-1#137	0	39	ENST00000539547.5	1863	1902	+	39	0	0	6115
A8K2U0-1#137	0	39	39	A8K2U0-1	3168	3207	+	39	A8K2U0-1	0	4362	ENST00000299698.12	31	4393	++	19	A8K2U0-1#137	0	39	ENST00000299698.12	3199	3238	+	39	0	0	6116
A8K2U0-1#138	0	12	12	A8K2U0-1	3213	3225	+	12	A8K2U0-1	1350	4362	ENST00000541459.5	0	3012	+	160	A8K2U0-1#138	0	12	ENST00000541459.5	1863	1875	+	12	0	0	6117
A8K2U0-1#138	0	12	12	A8K2U0-1	3213	3225	+	12	A8K2U0-1	1476	4362	ENST00000539547.5	171	3057	++	159	A8K2U0-1#138	0	12	ENST00000539547.5	1908	1920	+	12	0	0	6118
A8K2U0-1#138	0	12	12	A8K2U0-1	3213	3225	+	12	A8K2U0-1	0	4362	ENST00000299698.12	31	4393	++	19	A8K2U0-1#138	0	12	ENST00000299698.12	3244	3256	+	12	0	0	6119
A8K2U0-1#139	0	9	9	A8K2U0-1	3234	3243	+	9	A8K2U0-1	1350	4362	ENST00000541459.5	0	3012	+	160	A8K2U0-1#139	0	9	ENST00000541459.5	1884	1893	+	9	0	0	6120
A8K2U0-1#139	0	9	9	A8K2U0-1	3234	3243	+	9	A8K2U0-1	1476	4362	ENST00000539547.5	171	3057	++	159	A8K2U0-1#139	0	9	ENST00000539547.5	1929	1938	+	9	0	0	6121
A8K2U0-1#139	0	9	9	A8K2U0-1	3234	3243	+	9	A8K2U0-1	0	4362	ENST00000299698.12	31	4393	++	19	A8K2U0-1#139	0	9	ENST00000299698.12	3265	3274	+	9	0	0	6122
A8K2U0-1#140	0	12	12	A8K2U0-1	3246	3258	+	12	A8K2U0-1	1350	4362	ENST00000541459.5	0	3012	+	160	A8K2U0-1#140	0	12	ENST00000541459.5	1896	1908	+	12	0	0	6123
A8K2U0-1#140	0	12	12	A8K2U0-1	3246	3258	+	12	A8K2U0-1	1476	4362	ENST00000539547.5	171	3057	++	159	A8K2U0-1#140	0	12	ENST00000539547.5	1941	1953	+	12	0	0	6124
A8K2U0-1#140	0	12	12	A8K2U0-1	3246	3258	+	12	A8K2U0-1	0	4362	ENST00000299698.12	31	4393	++	19	A8K2U0-1#140	0	12	ENST00000299698.12	3277	3289	+	12	0	0	6125
A8K2U0-1#141	0	9	9	A8K2U0-1	3258	3267	+	9	A8K2U0-1	1350	4362	ENST00000541459.5	0	3012	+	160	A8K2U0-1#141	0	9	ENST00000541459.5	1908	1917	+	9	0	0	6126
A8K2U0-1#141	0	9	9	A8K2U0-1	3258	3267	+	9	A8K2U0-1	1476	4362	ENST00000539547.5	171	3057	++	159	A8K2U0-1#141	0	9	ENST00000539547.5	1953	1962	+	9	0	0	6127
A8K2U0-1#141	0	9	9	A8K2U0-1	3258	3267	+	9	A8K2U0-1	0	4362	ENST00000299698.12	31	4393	++	19	A8K2U0-1#141	0	9	ENST00000299698.12	3289	3298	+	9	0	0	6128
A8K2U0-1#142	0	36	36	A8K2U0-1	3279	3315	+	36	A8K2U0-1	1350	4362	ENST00000541459.5	0	3012	+	160	A8K2U0-1#142	0	36	ENST00000541459.5	1929	1965	+	36	0	0	6129
A8K2U0-1#142	0	36	36	A8K2U0-1	3279	3315	+	36	A8K2U0-1	1476	4362	ENST00000539547.5	171	3057	++	159	A8K2U0-1#142	0	36	ENST00000539547.5	1974	2010	+	36	0	0	6130
A8K2U0-1#142	0	36	36	A8K2U0-1	3279	3315	+	36	A8K2U0-1	0	4362	ENST00000299698.12	31	4393	++	19	A8K2U0-1#142	0	36	ENST00000299698.12	3310	3346	+	36	0	0	6131
A8K2U0-1#143	0	12	12	A8K2U0-1	3315	3327	+	12	A8K2U0-1	1350	4362	ENST00000541459.5	0	3012	+	160	A8K2U0-1#143	0	12	ENST00000541459.5	1965	1977	+	12	0	0	6132
A8K2U0-1#143	0	12	12	A8K2U0-1	3315	3327	+	12	A8K2U0-1	1476	4362	ENST00000539547.5	171	3057	++	159	A8K2U0-1#143	0	12	ENST00000539547.5	2010	2022	+	12	0	0	6133
A8K2U0-1#143	0	12	12	A8K2U0-1	3315	3327	+	12	A8K2U0-1	0	4362	ENST00000299698.12	31	4393	++	19	A8K2U0-1#143	0	12	ENST00000299698.12	3346	3358	+	12	0	0	6134
A8K2U0-1#144	0	30	30	A8K2U0-1	3342	3372	+	30	A8K2U0-1	1350	4362	ENST00000541459.5	0	3012	+	160	A8K2U0-1#144	0	30	ENST00000541459.5	1992	2022	+	30	0	0	6135
A8K2U0-1#144	0	30	30	A8K2U0-1	3342	3372	+	30	A8K2U0-1	1476	4362	ENST00000539547.5	171	3057	++	159	A8K2U0-1#144	0	30	ENST00000539547.5	2037	2067	+	30	0	0	6136
A8K2U0-1#144	0	30	30	A8K2U0-1	3342	3372	+	30	A8K2U0-1	0	4362	ENST00000299698.12	31	4393	++	19	A8K2U0-1#144	0	30	ENST00000299698.12	3373	3403	+	30	0	0	6137
A8K2U0-1#145	0	12	12	A8K2U0-1	3378	3390	+	12	A8K2U0-1	1350	4362	ENST00000541459.5	0	3012	+	160	A8K2U0-1#145	0	12	ENST00000541459.5	2028	2040	+	12	0	0	6138
A8K2U0-1#145	0	12	12	A8K2U0-1	3378	3390	+	12	A8K2U0-1	1476	4362	ENST00000539547.5	171	3057	++	159	A8K2U0-1#145	0	12	ENST00000539547.5	2073	2085	+	12	0	0	6139
A8K2U0-1#145	0	12	12	A8K2U0-1	3378	3390	+	12	A8K2U0-1	0	4362	ENST00000299698.12	31	4393	++	19	A8K2U0-1#145	0	12	ENST00000299698.12	3409	3421	+	12	0	0	6140
A8K2U0-1#146	0	27	27	A8K2U0-1	3402	3429	+	27	A8K2U0-1	1350	4362	ENST00000541459.5	0	3012	+	160	A8K2U0-1#146	0	27	ENST00000541459.5	2052	2079	+	27	0	0	6141
A8K2U0-1#146	0	27	27	A8K2U0-1	3402	3429	+	27	A8K2U0-1	1476	4362	ENST00000539547.5	171	3057	++	159	A8K2U0-1#146	0	27	ENST00000539547.5	2097	2124	+	27	0	0	6142
A8K2U0-1#146	0	27	27	A8K2U0-1	3402	3429	+	27	A8K2U0-1	0	4362	ENST00000299698.12	31	4393	++	19	A8K2U0-1#146	0	27	ENST00000299698.12	3433	3460	+	27	0	0	6143
A8K2U0-1#147	0	15	15	A8K2U0-1	3429	3444	+	15	A8K2U0-1	1350	4362	ENST00000541459.5	0	3012	+	160	A8K2U0-1#147	0	15	ENST00000541459.5	2079	2094	+	15	0	0	6144
A8K2U0-1#147	0	15	15	A8K2U0-1	3429	3444	+	15	A8K2U0-1	1476	4362	ENST00000539547.5	171	3057	++	159	A8K2U0-1#147	0	15	ENST00000539547.5	2124	2139	+	15	0	0	6145
A8K2U0-1#147	0	15	15	A8K2U0-1	3429	3444	+	15	A8K2U0-1	0	4362	ENST00000299698.12	31	4393	++	19	A8K2U0-1#147	0	15	ENST00000299698.12	3460	3475	+	15	0	0	6146
A8K2U0-1#148	0	15	15	A8K2U0-1	3447	3462	+	15	A8K2U0-1	1350	4362	ENST00000541459.5	0	3012	+	160	A8K2U0-1#148	0	15	ENST00000541459.5	2097	2112	+	15	0	0	6147
A8K2U0-1#148	0	15	15	A8K2U0-1	3447	3462	+	15	A8K2U0-1	1476	4362	ENST00000539547.5	171	3057	++	159	A8K2U0-1#148	0	15	ENST00000539547.5	2142	2157	+	15	0	0	6148
A8K2U0-1#148	0	15	15	A8K2U0-1	3447	3462	+	15	A8K2U0-1	0	4362	ENST00000299698.12	31	4393	++	19	A8K2U0-1#148	0	15	ENST00000299698.12	3478	3493	+	15	0	0	6149
A8K2U0-1#149	0	18	18	A8K2U0-1	3462	3480	+	18	A8K2U0-1	1350	4362	ENST00000541459.5	0	3012	+	160	A8K2U0-1#149	0	18	ENST00000541459.5	2112	2130	+	18	0	0	6150
A8K2U0-1#149	0	18	18	A8K2U0-1	3462	3480	+	18	A8K2U0-1	1476	4362	ENST00000539547.5	171	3057	++	159	A8K2U0-1#149	0	18	ENST00000539547.5	2157	2175	+	18	0	0	6151
A8K2U0-1#149	0	18	18	A8K2U0-1	3462	3480	+	18	A8K2U0-1	0	4362	ENST00000299698.12	31	4393	++	19	A8K2U0-1#149	0	18	ENST00000299698.12	3493	3511	+	18	0	0	6152
A8K2U0-1#150	0	15	15	A8K2U0-1	3486	3501	+	15	A8K2U0-1	1350	4362	ENST00000541459.5	0	3012	+	160	A8K2U0-1#150	0	15	ENST00000541459.5	2136	2151	+	15	0	0	6153
A8K2U0-1#150	0	15	15	A8K2U0-1	3486	3501	+	15	A8K2U0-1	1476	4362	ENST00000539547.5	171	3057	++	159	A8K2U0-1#150	0	15	ENST00000539547.5	2181	2196	+	15	0	0	6154
A8K2U0-1#150	0	15	15	A8K2U0-1	3486	3501	+	15	A8K2U0-1	0	4362	ENST00000299698.12	31	4393	++	19	A8K2U0-1#150	0	15	ENST00000299698.12	3517	3532	+	15	0	0	6155
A8K2U0-1#151	0	12	12	A8K2U0-1	3507	3519	+	12	A8K2U0-1	1350	4362	ENST00000541459.5	0	3012	+	160	A8K2U0-1#151	0	12	ENST00000541459.5	2157	2169	+	12	0	0	6156
A8K2U0-1#151	0	12	12	A8K2U0-1	3507	3519	+	12	A8K2U0-1	1476	4362	ENST00000539547.5	171	3057	++	159	A8K2U0-1#151	0	12	ENST00000539547.5	2202	2214	+	12	0	0	6157
A8K2U0-1#151	0	12	12	A8K2U0-1	3507	3519	+	12	A8K2U0-1	0	4362	ENST00000299698.12	31	4393	++	19	A8K2U0-1#151	0	12	ENST00000299698.12	3538	3550	+	12	0	0	6158
A8K2U0-1#152	0	39	39	A8K2U0-1	3573	3612	+	39	A8K2U0-1	1350	4362	ENST00000541459.5	0	3012	+	160	A8K2U0-1#152	0	39	ENST00000541459.5	2223	2262	+	39	0	0	6159
A8K2U0-1#152	0	39	39	A8K2U0-1	3573	3612	+	39	A8K2U0-1	1476	4362	ENST00000539547.5	171	3057	++	159	A8K2U0-1#152	0	39	ENST00000539547.5	2268	2307	+	39	0	0	6160
A8K2U0-1#152	0	39	39	A8K2U0-1	3573	3612	+	39	A8K2U0-1	0	4362	ENST00000299698.12	31	4393	++	19	A8K2U0-1#152	0	39	ENST00000299698.12	3604	3643	+	39	0	0	6161
A8K2U0-1#153	0	12	12	A8K2U0-1	3612	3624	+	12	A8K2U0-1	1350	4362	ENST00000541459.5	0	3012	+	160	A8K2U0-1#153	0	12	ENST00000541459.5	2262	2274	+	12	0	0	6162
A8K2U0-1#153	0	12	12	A8K2U0-1	3612	3624	+	12	A8K2U0-1	1476	4362	ENST00000539547.5	171	3057	++	159	A8K2U0-1#153	0	12	ENST00000539547.5	2307	2319	+	12	0	0	6163
A8K2U0-1#153	0	12	12	A8K2U0-1	3612	3624	+	12	A8K2U0-1	0	4362	ENST00000299698.12	31	4393	++	19	A8K2U0-1#153	0	12	ENST00000299698.12	3643	3655	+	12	0	0	6164
A8K2U0-1#154	0	42	42	A8K2U0-1	3633	3675	+	42	A8K2U0-1	1350	4362	ENST00000541459.5	0	3012	+	160	A8K2U0-1#154	0	42	ENST00000541459.5	2283	2325	+	42	0	0	6165
A8K2U0-1#154	0	42	42	A8K2U0-1	3633	3675	+	42	A8K2U0-1	1476	4362	ENST00000539547.5	171	3057	++	159	A8K2U0-1#154	0	42	ENST00000539547.5	2328	2370	+	42	0	0	6166
A8K2U0-1#154	0	42	42	A8K2U0-1	3633	3675	+	42	A8K2U0-1	0	4362	ENST00000299698.12	31	4393	++	19	A8K2U0-1#154	0	42	ENST00000299698.12	3664	3706	+	42	0	0	6167
A8K2U0-1#155	0	15	15	A8K2U0-1	3687	3702	+	15	A8K2U0-1	1350	4362	ENST00000541459.5	0	3012	+	160	A8K2U0-1#155	0	15	ENST00000541459.5	2337	2352	+	15	0	0	6168
A8K2U0-1#155	0	15	15	A8K2U0-1	3687	3702	+	15	A8K2U0-1	1476	4362	ENST00000539547.5	171	3057	++	159	A8K2U0-1#155	0	15	ENST00000539547.5	2382	2397	+	15	0	0	6169
A8K2U0-1#155	0	15	15	A8K2U0-1	3687	3702	+	15	A8K2U0-1	0	4362	ENST00000299698.12	31	4393	++	19	A8K2U0-1#155	0	15	ENST00000299698.12	3718	3733	+	15	0	0	6170
A8K2U0-1#156	0	12	12	A8K2U0-1	3705	3717	+	12	A8K2U0-1	1350	4362	ENST00000541459.5	0	3012	+	160	A8K2U0-1#156	0	12	ENST00000541459.5	2355	2367	+	12	0	0	6171
A8K2U0-1#156	0	12	12	A8K2U0-1	3705	3717	+	12	A8K2U0-1	1476	4362	ENST00000539547.5	171	3057	++	159	A8K2U0-1#156	0	12	ENST00000539547.5	2400	2412	+	12	0	0	6172
A8K2U0-1#156	0	12	12	A8K2U0-1	3705	3717	+	12	A8K2U0-1	0	4362	ENST00000299698.12	31	4393	++	19	A8K2U0-1#156	0	12	ENST00000299698.12	3736	3748	+	12	0	0	6173
A8K2U0-1#157	0	45	45	A8K2U0-1	3717	3762	+	45	A8K2U0-1	1350	4362	ENST00000541459.5	0	3012	+	160	A8K2U0-1#157	0	45	ENST00000541459.5	2367	2412	+	45	0	0	6174
A8K2U0-1#157	0	45	45	A8K2U0-1	3717	3762	+	45	A8K2U0-1	1476	4362	ENST00000539547.5	171	3057	++	159	A8K2U0-1#157	0	45	ENST00000539547.5	2412	2457	+	45	0	0	6175
A8K2U0-1#157	0	45	45	A8K2U0-1	3717	3762	+	45	A8K2U0-1	0	4362	ENST00000299698.12	31	4393	++	19	A8K2U0-1#157	0	45	ENST00000299698.12	3748	3793	+	45	0	0	6176
A8K2U0-1#158	0	27	27	A8K2U0-1	3777	3804	+	27	A8K2U0-1	1350	4362	ENST00000541459.5	0	3012	+	160	A8K2U0-1#158	0	27	ENST00000541459.5	2427	2454	+	27	0	0	6177
A8K2U0-1#158	0	27	27	A8K2U0-1	3777	3804	+	27	A8K2U0-1	1476	4362	ENST00000539547.5	171	3057	++	159	A8K2U0-1#158	0	27	ENST00000539547.5	2472	2499	+	27	0	0	6178
A8K2U0-1#158	0	27	27	A8K2U0-1	3777	3804	+	27	A8K2U0-1	0	4362	ENST00000299698.12	31	4393	++	19	A8K2U0-1#158	0	27	ENST00000299698.12	3808	3835	+	27	0	0	6179
A8K2U0-1#159	0	9	9	A8K2U0-1	3804	3813	+	9	A8K2U0-1	1350	4362	ENST00000541459.5	0	3012	+	160	A8K2U0-1#159	0	9	ENST00000541459.5	2454	2463	+	9	0	0	6180
A8K2U0-1#159	0	9	9	A8K2U0-1	3804	3813	+	9	A8K2U0-1	1476	4362	ENST00000539547.5	171	3057	++	159	A8K2U0-1#159	0	9	ENST00000539547.5	2499	2508	+	9	0	0	6181
A8K2U0-1#159	0	9	9	A8K2U0-1	3804	3813	+	9	A8K2U0-1	0	4362	ENST00000299698.12	31	4393	++	19	A8K2U0-1#159	0	9	ENST00000299698.12	3835	3844	+	9	0	0	6182
A8K2U0-1#160	0	15	15	A8K2U0-1	3819	3834	+	15	A8K2U0-1	1350	4362	ENST00000541459.5	0	3012	+	160	A8K2U0-1#160	0	15	ENST00000541459.5	2469	2484	+	15	0	0	6183
A8K2U0-1#160	0	15	15	A8K2U0-1	3819	3834	+	15	A8K2U0-1	1476	4362	ENST00000539547.5	171	3057	++	159	A8K2U0-1#160	0	15	ENST00000539547.5	2514	2529	+	15	0	0	6184
A8K2U0-1#160	0	15	15	A8K2U0-1	3819	3834	+	15	A8K2U0-1	3818	4362	ENST00000537475.1	0	544	+	158	A8K2U0-1#160	0	15	ENST00000537475.1	1	16	+	15	0	0	6185
A8K2U0-1#160	0	15	15	A8K2U0-1	3819	3834	+	15	A8K2U0-1	0	4362	ENST00000299698.12	31	4393	++	19	A8K2U0-1#160	0	15	ENST00000299698.12	3850	3865	+	15	0	0	6186
A8K2U0-1#161	0	9	9	A8K2U0-1	3837	3846	+	9	A8K2U0-1	1350	4362	ENST00000541459.5	0	3012	+	160	A8K2U0-1#161	0	9	ENST00000541459.5	2487	2496	+	9	0	0	6187
A8K2U0-1#161	0	9	9	A8K2U0-1	3837	3846	+	9	A8K2U0-1	1476	4362	ENST00000539547.5	171	3057	++	159	A8K2U0-1#161	0	9	ENST00000539547.5	2532	2541	+	9	0	0	6188
A8K2U0-1#161	0	9	9	A8K2U0-1	3837	3846	+	9	A8K2U0-1	3818	4362	ENST00000537475.1	0	544	+	158	A8K2U0-1#161	0	9	ENST00000537475.1	19	28	+	9	0	0	6189
A8K2U0-1#161	0	9	9	A8K2U0-1	3837	3846	+	9	A8K2U0-1	0	4362	ENST00000299698.12	31	4393	++	19	A8K2U0-1#161	0	9	ENST00000299698.12	3868	3877	+	9	0	0	6190
A8K2U0-1#162	0	12	12	A8K2U0-1	3858	3870	+	12	A8K2U0-1	1350	4362	ENST00000541459.5	0	3012	+	160	A8K2U0-1#162	0	12	ENST00000541459.5	2508	2520	+	12	0	0	6191
A8K2U0-1#162	0	12	12	A8K2U0-1	3858	3870	+	12	A8K2U0-1	1476	4362	ENST00000539547.5	171	3057	++	159	A8K2U0-1#162	0	12	ENST00000539547.5	2553	2565	+	12	0	0	6192
A8K2U0-1#162	0	12	12	A8K2U0-1	3858	3870	+	12	A8K2U0-1	3818	4362	ENST00000537475.1	0	544	+	158	A8K2U0-1#162	0	12	ENST00000537475.1	40	52	+	12	0	0	6193
A8K2U0-1#162	0	12	12	A8K2U0-1	3858	3870	+	12	A8K2U0-1	0	4362	ENST00000299698.12	31	4393	++	19	A8K2U0-1#162	0	12	ENST00000299698.12	3889	3901	+	12	0	0	6194
A8K2U0-1#163	0	36	36	A8K2U0-1	3882	3918	+	36	A8K2U0-1	1350	4362	ENST00000541459.5	0	3012	+	160	A8K2U0-1#163	0	36	ENST00000541459.5	2532	2568	+	36	0	0	6195
A8K2U0-1#163	0	36	36	A8K2U0-1	3882	3918	+	36	A8K2U0-1	1476	4362	ENST00000539547.5	171	3057	++	159	A8K2U0-1#163	0	36	ENST00000539547.5	2577	2613	+	36	0	0	6196
A8K2U0-1#163	0	36	36	A8K2U0-1	3882	3918	+	36	A8K2U0-1	3818	4362	ENST00000537475.1	0	544	+	158	A8K2U0-1#163	0	36	ENST00000537475.1	64	100	+	36	0	0	6197
A8K2U0-1#163	0	36	36	A8K2U0-1	3882	3918	+	36	A8K2U0-1	0	4362	ENST00000299698.12	31	4393	++	19	A8K2U0-1#163	0	36	ENST00000299698.12	3913	3949	+	36	0	0	6198
A8K2U0-1#164	0	33	33	A8K2U0-1	3921	3954	+	33	A8K2U0-1	1350	4362	ENST00000541459.5	0	3012	+	160	A8K2U0-1#164	0	33	ENST00000541459.5	2571	2604	+	33	0	0	6199
A8K2U0-1#164	0	33	33	A8K2U0-1	3921	3954	+	33	A8K2U0-1	1476	4362	ENST00000539547.5	171	3057	++	159	A8K2U0-1#164	0	33	ENST00000539547.5	2616	2649	+	33	0	0	6200
A8K2U0-1#164	0	33	33	A8K2U0-1	3921	3954	+	33	A8K2U0-1	3818	4362	ENST00000537475.1	0	544	+	158	A8K2U0-1#164	0	33	ENST00000537475.1	103	136	+	33	0	0	6201
A8K2U0-1#164	0	33	33	A8K2U0-1	3921	3954	+	33	A8K2U0-1	0	4362	ENST00000299698.12	31	4393	++	19	A8K2U0-1#164	0	33	ENST00000299698.12	3952	3985	+	33	0	0	6202
A8K2U0-1#165	0	24	24	A8K2U0-1	3972	3996	+	24	A8K2U0-1	1350	4362	ENST00000541459.5	0	3012	+	160	A8K2U0-1#165	0	24	ENST00000541459.5	2622	2646	+	24	0	0	6203
A8K2U0-1#165	0	24	24	A8K2U0-1	3972	3996	+	24	A8K2U0-1	1476	4362	ENST00000539547.5	171	3057	++	159	A8K2U0-1#165	0	24	ENST00000539547.5	2667	2691	+	24	0	0	6204
A8K2U0-1#165	0	24	24	A8K2U0-1	3972	3996	+	24	A8K2U0-1	3818	4362	ENST00000537475.1	0	544	+	158	A8K2U0-1#165	0	24	ENST00000537475.1	154	178	+	24	0	0	6205
A8K2U0-1#165	0	24	24	A8K2U0-1	3972	3996	+	24	A8K2U0-1	0	4362	ENST00000299698.12	31	4393	++	19	A8K2U0-1#165	0	24	ENST00000299698.12	4003	4027	+	24	0	0	6206
A8K2U0-1#166	0	9	9	A8K2U0-1	4011	4020	+	9	A8K2U0-1	1350	4362	ENST00000541459.5	0	3012	+	160	A8K2U0-1#166	0	9	ENST00000541459.5	2661	2670	+	9	0	0	6207
A8K2U0-1#166	0	9	9	A8K2U0-1	4011	4020	+	9	A8K2U0-1	1476	4362	ENST00000539547.5	171	3057	++	159	A8K2U0-1#166	0	9	ENST00000539547.5	2706	2715	+	9	0	0	6208
A8K2U0-1#166	0	9	9	A8K2U0-1	4011	4020	+	9	A8K2U0-1	3818	4362	ENST00000537475.1	0	544	+	158	A8K2U0-1#166	0	9	ENST00000537475.1	193	202	+	9	0	0	6209
A8K2U0-1#166	0	9	9	A8K2U0-1	4011	4020	+	9	A8K2U0-1	0	4362	ENST00000299698.12	31	4393	++	19	A8K2U0-1#166	0	9	ENST00000299698.12	4042	4051	+	9	0	0	6210
A8K2U0-1#167	0	27	27	A8K2U0-1	4038	4065	+	27	A8K2U0-1	1350	4362	ENST00000541459.5	0	3012	+	160	A8K2U0-1#167	0	27	ENST00000541459.5	2688	2715	+	27	0	0	6211
A8K2U0-1#167	0	27	27	A8K2U0-1	4038	4065	+	27	A8K2U0-1	1476	4362	ENST00000539547.5	171	3057	++	159	A8K2U0-1#167	0	27	ENST00000539547.5	2733	2760	+	27	0	0	6212
A8K2U0-1#167	0	27	27	A8K2U0-1	4038	4065	+	27	A8K2U0-1	3818	4362	ENST00000537475.1	0	544	+	158	A8K2U0-1#167	0	27	ENST00000537475.1	220	247	+	27	0	0	6213
A8K2U0-1#167	0	27	27	A8K2U0-1	4038	4065	+	27	A8K2U0-1	0	4362	ENST00000299698.12	31	4393	++	19	A8K2U0-1#167	0	27	ENST00000299698.12	4069	4096	+	27	0	0	6214
A8K2U0-1#168	0	15	15	A8K2U0-1	4068	4083	+	15	A8K2U0-1	1350	4362	ENST00000541459.5	0	3012	+	160	A8K2U0-1#168	0	15	ENST00000541459.5	2718	2733	+	15	0	0	6215
A8K2U0-1#168	0	15	15	A8K2U0-1	4068	4083	+	15	A8K2U0-1	1476	4362	ENST00000539547.5	171	3057	++	159	A8K2U0-1#168	0	15	ENST00000539547.5	2763	2778	+	15	0	0	6216
A8K2U0-1#168	0	15	15	A8K2U0-1	4068	4083	+	15	A8K2U0-1	3818	4362	ENST00000537475.1	0	544	+	158	A8K2U0-1#168	0	15	ENST00000537475.1	250	265	+	15	0	0	6217
A8K2U0-1#168	0	15	15	A8K2U0-1	4068	4083	+	15	A8K2U0-1	0	4362	ENST00000299698.12	31	4393	++	19	A8K2U0-1#168	0	15	ENST00000299698.12	4099	4114	+	15	0	0	6218
A8K2U0-1#169	0	18	18	A8K2U0-1	4092	4110	+	18	A8K2U0-1	1350	4362	ENST00000541459.5	0	3012	+	160	A8K2U0-1#169	0	18	ENST00000541459.5	2742	2760	+	18	0	0	6219
A8K2U0-1#169	0	18	18	A8K2U0-1	4092	4110	+	18	A8K2U0-1	1476	4362	ENST00000539547.5	171	3057	++	159	A8K2U0-1#169	0	18	ENST00000539547.5	2787	2805	+	18	0	0	6220
A8K2U0-1#169	0	18	18	A8K2U0-1	4092	4110	+	18	A8K2U0-1	3818	4362	ENST00000537475.1	0	544	+	158	A8K2U0-1#169	0	18	ENST00000537475.1	274	292	+	18	0	0	6221
A8K2U0-1#169	0	18	18	A8K2U0-1	4092	4110	+	18	A8K2U0-1	0	4362	ENST00000299698.12	31	4393	++	19	A8K2U0-1#169	0	18	ENST00000299698.12	4123	4141	+	18	0	0	6222
A8K2U0-1#170	0	9	9	A8K2U0-1	4131	4140	+	9	A8K2U0-1	1350	4362	ENST00000541459.5	0	3012	+	160	A8K2U0-1#170	0	9	ENST00000541459.5	2781	2790	+	9	0	0	6223
A8K2U0-1#170	0	9	9	A8K2U0-1	4131	4140	+	9	A8K2U0-1	1476	4362	ENST00000539547.5	171	3057	++	159	A8K2U0-1#170	0	9	ENST00000539547.5	2826	2835	+	9	0	0	6224
A8K2U0-1#170	0	9	9	A8K2U0-1	4131	4140	+	9	A8K2U0-1	3818	4362	ENST00000537475.1	0	544	+	158	A8K2U0-1#170	0	9	ENST00000537475.1	313	322	+	9	0	0	6225
A8K2U0-1#170	0	9	9	A8K2U0-1	4131	4140	+	9	A8K2U0-1	0	4362	ENST00000299698.12	31	4393	++	19	A8K2U0-1#170	0	9	ENST00000299698.12	4162	4171	+	9	0	0	6226
A8K2U0-1#171	0	18	18	A8K2U0-1	4140	4158	+	18	A8K2U0-1	1350	4362	ENST00000541459.5	0	3012	+	160	A8K2U0-1#171	0	18	ENST00000541459.5	2790	2808	+	18	0	0	6227
A8K2U0-1#171	0	18	18	A8K2U0-1	4140	4158	+	18	A8K2U0-1	1476	4362	ENST00000539547.5	171	3057	++	159	A8K2U0-1#171	0	18	ENST00000539547.5	2835	2853	+	18	0	0	6228
A8K2U0-1#171	0	18	18	A8K2U0-1	4140	4158	+	18	A8K2U0-1	3818	4362	ENST00000537475.1	0	544	+	158	A8K2U0-1#171	0	18	ENST00000537475.1	322	340	+	18	0	0	6229
A8K2U0-1#171	0	18	18	A8K2U0-1	4140	4158	+	18	A8K2U0-1	0	4362	ENST00000299698.12	31	4393	++	19	A8K2U0-1#171	0	18	ENST00000299698.12	4171	4189	+	18	0	0	6230
A8K2U0-1#172	0	12	12	A8K2U0-1	4176	4188	+	12	A8K2U0-1	1350	4362	ENST00000541459.5	0	3012	+	160	A8K2U0-1#172	0	12	ENST00000541459.5	2826	2838	+	12	0	0	6231
A8K2U0-1#172	0	12	12	A8K2U0-1	4176	4188	+	12	A8K2U0-1	1476	4362	ENST00000539547.5	171	3057	++	159	A8K2U0-1#172	0	12	ENST00000539547.5	2871	2883	+	12	0	0	6232
A8K2U0-1#172	0	12	12	A8K2U0-1	4176	4188	+	12	A8K2U0-1	3818	4362	ENST00000537475.1	0	544	+	158	A8K2U0-1#172	0	12	ENST00000537475.1	358	370	+	12	0	0	6233
A8K2U0-1#172	0	12	12	A8K2U0-1	4176	4188	+	12	A8K2U0-1	0	4362	ENST00000299698.12	31	4393	++	19	A8K2U0-1#172	0	12	ENST00000299698.12	4207	4219	+	12	0	0	6234
A8K2U0-1#173	0	27	27	A8K2U0-1	4191	4218	+	27	A8K2U0-1	1350	4362	ENST00000541459.5	0	3012	+	160	A8K2U0-1#173	0	27	ENST00000541459.5	2841	2868	+	27	0	0	6235
A8K2U0-1#173	0	27	27	A8K2U0-1	4191	4218	+	27	A8K2U0-1	1476	4362	ENST00000539547.5	171	3057	++	159	A8K2U0-1#173	0	27	ENST00000539547.5	2886	2913	+	27	0	0	6236
A8K2U0-1#173	0	27	27	A8K2U0-1	4191	4218	+	27	A8K2U0-1	3818	4362	ENST00000537475.1	0	544	+	158	A8K2U0-1#173	0	27	ENST00000537475.1	373	400	+	27	0	0	6237
A8K2U0-1#173	0	27	27	A8K2U0-1	4191	4218	+	27	A8K2U0-1	0	4362	ENST00000299698.12	31	4393	++	19	A8K2U0-1#173	0	27	ENST00000299698.12	4222	4249	+	27	0	0	6238
A8K2U0-1#174	0	33	33	A8K2U0-1	4236	4269	+	33	A8K2U0-1	1350	4362	ENST00000541459.5	0	3012	+	160	A8K2U0-1#174	0	33	ENST00000541459.5	2886	2919	+	33	0	0	6239
A8K2U0-1#174	0	33	33	A8K2U0-1	4236	4269	+	33	A8K2U0-1	1476	4362	ENST00000539547.5	171	3057	++	159	A8K2U0-1#174	0	33	ENST00000539547.5	2931	2964	+	33	0	0	6240
A8K2U0-1#174	0	33	33	A8K2U0-1	4236	4269	+	33	A8K2U0-1	3818	4362	ENST00000537475.1	0	544	+	158	A8K2U0-1#174	0	33	ENST00000537475.1	418	451	+	33	0	0	6241
A8K2U0-1#174	0	33	33	A8K2U0-1	4236	4269	+	33	A8K2U0-1	0	4362	ENST00000299698.12	31	4393	++	19	A8K2U0-1#174	0	33	ENST00000299698.12	4267	4300	+	33	0	0	6242
A8K2U0-1#175	0	9	9	A8K2U0-1	4272	4281	+	9	A8K2U0-1	1350	4362	ENST00000541459.5	0	3012	+	160	A8K2U0-1#175	0	9	ENST00000541459.5	2922	2931	+	9	0	0	6243
A8K2U0-1#175	0	9	9	A8K2U0-1	4272	4281	+	9	A8K2U0-1	1476	4362	ENST00000539547.5	171	3057	++	159	A8K2U0-1#175	0	9	ENST00000539547.5	2967	2976	+	9	0	0	6244
A8K2U0-1#175	0	9	9	A8K2U0-1	4272	4281	+	9	A8K2U0-1	3818	4362	ENST00000537475.1	0	544	+	158	A8K2U0-1#175	0	9	ENST00000537475.1	454	463	+	9	0	0	6245
A8K2U0-1#175	0	9	9	A8K2U0-1	4272	4281	+	9	A8K2U0-1	0	4362	ENST00000299698.12	31	4393	++	19	A8K2U0-1#175	0	9	ENST00000299698.12	4303	4312	+	9	0	0	6246
A8K2U0-1#176	0	27	27	A8K2U0-1	4290	4317	+	27	A8K2U0-1	1350	4362	ENST00000541459.5	0	3012	+	160	A8K2U0-1#176	0	27	ENST00000541459.5	2940	2967	+	27	0	0	6247
A8K2U0-1#176	0	27	27	A8K2U0-1	4290	4317	+	27	A8K2U0-1	1476	4362	ENST00000539547.5	171	3057	++	159	A8K2U0-1#176	0	27	ENST00000539547.5	2985	3012	+	27	0	0	6248
A8K2U0-1#176	0	27	27	A8K2U0-1	4290	4317	+	27	A8K2U0-1	3818	4362	ENST00000537475.1	0	544	+	158	A8K2U0-1#176	0	27	ENST00000537475.1	472	499	+	27	0	0	6249
A8K2U0-1#176	0	27	27	A8K2U0-1	4290	4317	+	27	A8K2U0-1	0	4362	ENST00000299698.12	31	4393	++	19	A8K2U0-1#176	0	27	ENST00000299698.12	4321	4348	+	27	0	0	6250
A8K2U0-1#177	0	21	21	A8K2U0-1	4326	4347	+	21	A8K2U0-1	1350	4362	ENST00000541459.5	0	3012	+	160	A8K2U0-1#177	0	21	ENST00000541459.5	2976	2997	+	21	0	0	6251
A8K2U0-1#177	0	21	21	A8K2U0-1	4326	4347	+	21	A8K2U0-1	1476	4362	ENST00000539547.5	171	3057	++	159	A8K2U0-1#177	0	21	ENST00000539547.5	3021	3042	+	21	0	0	6252
A8K2U0-1#177	0	21	21	A8K2U0-1	4326	4347	+	21	A8K2U0-1	3818	4362	ENST00000537475.1	0	544	+	158	A8K2U0-1#177	0	21	ENST00000537475.1	508	529	+	21	0	0	6253
A8K2U0-1#177	0	21	21	A8K2U0-1	4326	4347	+	21	A8K2U0-1	0	4362	ENST00000299698.12	31	4393	++	19	A8K2U0-1#177	0	21	ENST00000299698.12	4357	4378	+	21	0	0	6254
P11137-1#0	0	5481	5481	P11137-1	0	5481	+	5481	P11137-1	0	5481	ENST00000704357.1	451	6025	+	280	P11137-1#0	0	5481	ENST00000704357.1	451	6025	+	5481	0	0	6255
P11137-1#0	0	5481	5481	P11137-1	0	5481	+	5481	P11137-1	0	5481	ENST00000682079.1	451	5932	++	275	P11137-1#0	0	5481	ENST00000682079.1	451	5932	+	5481	0	0	6256
P11137-1#0	0	5481	5481	P11137-1	0	5481	+	5481	P11137-1	0	5481	ENST00000673860.1	318	6288	+	238	P11137-1#0	0	5481	ENST00000673860.1	318	6288	+	5481	0	0	6257
P11137-1#0	0	5481	5481	P11137-1	0	5481	+	5481	P11137-1	222	4695	ENST00000452717.1	0	624	+	101	P11137-1#0	222	4695	ENST00000452717.1	0	624	+	405	222	786	6258
P11137-1#0	0	5481	5481	P11137-1	0	5481	+	5481	P11137-1	0	5481	ENST00000447185.5	0	5469	++	97	P11137-1#0	0	5481	ENST00000447185.5	0	5469	+	5469	0	0	6259
P11137-1#0	0	5481	5481	P11137-1	0	5481	+	5481	P11137-1	0	1455	ENST00000445941.5	318	2019	+	96	P11137-1#0	0	1455	ENST00000445941.5	318	2019	+	1455	0	4026	6260
P11137-1#0	0	5481	5481	P11137-1	0	5481	+	5481	P11137-1	4521	5481	ENST00000392194.5	619	1579	++	61	P11137-1#0	4521	5481	ENST00000392194.5	619	1579	+	960	4521	0	6261
P11137-1#0	0	5481	5481	P11137-1	0	5481	+	5481	P11137-1	0	319	ENST00000392193.5	295	614	+	60	P11137-1#0	0	319	ENST00000392193.5	295	614	+	319	0	5162	6262
P11137-1#0	0	5481	5481	P11137-1	0	5481	+	5481	P11137-1	4521	5481	ENST00000361559.8	949	1909	++	40	P11137-1#0	4521	5481	ENST00000361559.8	949	1909	+	960	4521	0	6263
P11137-1#0	0	5481	5481	P11137-1	0	5481	+	5481	P11137-1	0	5481	ENST00000360351.8	506	5987	++	38	P11137-1#0	0	5481	ENST00000360351.8	506	5987	+	5481	0	0	6264
P11137-1#1	0	93	93	P11137-1	4980	5073	+	93	P11137-1	0	5481	ENST00000704357.1	451	6025	+	280	P11137-1#1	0	93	ENST00000704357.1	5431	5524	+	93	0	0	6265
P11137-1#1	0	93	93	P11137-1	4980	5073	+	93	P11137-1	0	5481	ENST00000682079.1	451	5932	++	275	P11137-1#1	0	93	ENST00000682079.1	5431	5524	+	93	0	0	6266
P11137-1#1	0	93	93	P11137-1	4980	5073	+	93	P11137-1	0	5481	ENST00000673860.1	318	6288	+	238	P11137-1#1	0	93	ENST00000673860.1	5787	5880	+	93	0	0	6267
P11137-1#1	0	93	93	P11137-1	4980	5073	+	93	P11137-1	0	5481	ENST00000447185.5	0	5469	++	97	P11137-1#1	0	93	ENST00000447185.5	4968	5061	+	93	0	0	6268
P11137-1#1	0	93	93	P11137-1	4980	5073	+	93	P11137-1	4521	5481	ENST00000392194.5	619	1579	++	61	P11137-1#1	0	93	ENST00000392194.5	1078	1171	+	93	0	0	6269
P11137-1#1	0	93	93	P11137-1	4980	5073	+	93	P11137-1	4521	5481	ENST00000361559.8	949	1909	++	40	P11137-1#1	0	93	ENST00000361559.8	1408	1501	+	93	0	0	6270
P11137-1#1	0	93	93	P11137-1	4980	5073	+	93	P11137-1	0	5481	ENST00000360351.8	506	5987	++	38	P11137-1#1	0	93	ENST00000360351.8	5486	5579	+	93	0	0	6271
P11137-1#2	0	93	93	P11137-1	5073	5166	+	93	P11137-1	0	5481	ENST00000704357.1	451	6025	+	280	P11137-1#2	0	93	ENST00000704357.1	5617	5710	+	93	0	0	6272
P11137-1#2	0	93	93	P11137-1	5073	5166	+	93	P11137-1	0	5481	ENST00000682079.1	451	5932	++	275	P11137-1#2	0	93	ENST00000682079.1	5524	5617	+	93	0	0	6273
P11137-1#2	0	93	93	P11137-1	5073	5166	+	93	P11137-1	0	5481	ENST00000673860.1	318	6288	+	238	P11137-1#2	0	93	ENST00000673860.1	5880	5973	+	93	0	0	6274
P11137-1#2	0	93	93	P11137-1	5073	5166	+	93	P11137-1	0	5481	ENST00000447185.5	0	5469	++	97	P11137-1#2	0	93	ENST00000447185.5	5061	5154	+	93	0	0	6275
P11137-1#2	0	93	93	P11137-1	5073	5166	+	93	P11137-1	4521	5481	ENST00000392194.5	619	1579	++	61	P11137-1#2	0	93	ENST00000392194.5	1171	1264	+	93	0	0	6276
P11137-1#2	0	93	93	P11137-1	5073	5166	+	93	P11137-1	4521	5481	ENST00000361559.8	949	1909	++	40	P11137-1#2	0	93	ENST00000361559.8	1501	1594	+	93	0	0	6277
P11137-1#2	0	93	93	P11137-1	5073	5166	+	93	P11137-1	0	5481	ENST00000360351.8	506	5987	++	38	P11137-1#2	0	93	ENST00000360351.8	5579	5672	+	93	0	0	6278
P11137-1#3	0	96	96	P11137-1	5166	5262	+	96	P11137-1	0	5481	ENST00000704357.1	451	6025	+	280	P11137-1#3	0	96	ENST00000704357.1	5710	5806	+	96	0	0	6279
P11137-1#3	0	96	96	P11137-1	5166	5262	+	96	P11137-1	0	5481	ENST00000682079.1	451	5932	++	275	P11137-1#3	0	96	ENST00000682079.1	5617	5713	+	96	0	0	6280
P11137-1#3	0	96	96	P11137-1	5166	5262	+	96	P11137-1	0	5481	ENST00000673860.1	318	6288	+	238	P11137-1#3	0	96	ENST00000673860.1	5973	6069	+	96	0	0	6281
P11137-1#3	0	96	96	P11137-1	5166	5262	+	96	P11137-1	0	5481	ENST00000447185.5	0	5469	++	97	P11137-1#3	0	96	ENST00000447185.5	5154	5250	+	96	0	0	6282
P11137-1#3	0	96	96	P11137-1	5166	5262	+	96	P11137-1	4521	5481	ENST00000392194.5	619	1579	++	61	P11137-1#3	0	96	ENST00000392194.5	1264	1360	+	96	0	0	6283
P11137-1#3	0	96	96	P11137-1	5166	5262	+	96	P11137-1	4521	5481	ENST00000361559.8	949	1909	++	40	P11137-1#3	0	96	ENST00000361559.8	1594	1690	+	96	0	0	6284
P11137-1#3	0	96	96	P11137-1	5166	5262	+	96	P11137-1	0	5481	ENST00000360351.8	506	5987	++	38	P11137-1#3	0	96	ENST00000360351.8	5672	5768	+	96	0	0	6285
P11137-1#4	0	264	264	P11137-1	0	264	+	264	P11137-1	0	5481	ENST00000704357.1	451	6025	+	280	P11137-1#4	0	264	ENST00000704357.1	451	715	+	264	0	0	6286
P11137-1#4	0	264	264	P11137-1	0	264	+	264	P11137-1	0	5481	ENST00000682079.1	451	5932	++	275	P11137-1#4	0	264	ENST00000682079.1	451	715	+	264	0	0	6287
P11137-1#4	0	264	264	P11137-1	0	264	+	264	P11137-1	0	5481	ENST00000673860.1	318	6288	+	238	P11137-1#4	0	264	ENST00000673860.1	318	582	+	264	0	0	6288
P11137-1#4	0	264	264	P11137-1	0	264	+	264	P11137-1	222	4695	ENST00000452717.1	0	624	+	101	P11137-1#4	222	264	ENST00000452717.1	0	42	+	42	222	0	6289
P11137-1#4	0	264	264	P11137-1	0	264	+	264	P11137-1	0	5481	ENST00000447185.5	0	5469	++	97	P11137-1#4	0	264	ENST00000447185.5	0	264	+	264	0	0	6290
P11137-1#4	0	264	264	P11137-1	0	264	+	264	P11137-1	0	1455	ENST00000445941.5	318	2019	+	96	P11137-1#4	0	264	ENST00000445941.5	318	582	+	264	0	0	6291
P11137-1#4	0	264	264	P11137-1	0	264	+	264	P11137-1	0	319	ENST00000392193.5	295	614	+	60	P11137-1#4	0	264	ENST00000392193.5	295	559	+	264	0	0	6292
P11137-1#4	0	264	264	P11137-1	0	264	+	264	P11137-1	0	5481	ENST00000360351.8	506	5987	++	38	P11137-1#4	0	264	ENST00000360351.8	506	770	+	264	0	0	6293
P11137-1#5	0	339	339	P11137-1	324	663	+	339	P11137-1	0	5481	ENST00000704357.1	451	6025	+	280	P11137-1#5	0	339	ENST00000704357.1	775	1114	+	339	0	0	6294
P11137-1#5	0	339	339	P11137-1	324	663	+	339	P11137-1	0	5481	ENST00000682079.1	451	5932	++	275	P11137-1#5	0	339	ENST00000682079.1	775	1114	+	339	0	0	6295
P11137-1#5	0	339	339	P11137-1	324	663	+	339	P11137-1	0	5481	ENST00000673860.1	318	6288	+	238	P11137-1#5	0	339	ENST00000673860.1	642	1470	+	339	0	0	6296
P11137-1#5	0	339	339	P11137-1	324	663	+	339	P11137-1	222	4695	ENST00000452717.1	0	624	+	101	P11137-1#5	0	130	ENST00000452717.1	102	232	+	130	0	209	6297
P11137-1#5	0	339	339	P11137-1	324	663	+	339	P11137-1	0	5481	ENST00000447185.5	0	5469	++	97	P11137-1#5	0	339	ENST00000447185.5	324	651	+	327	0	0	6298
P11137-1#5	0	339	339	P11137-1	324	663	+	339	P11137-1	0	1455	ENST00000445941.5	318	2019	+	96	P11137-1#5	0	339	ENST00000445941.5	642	1227	+	339	0	0	6299
P11137-1#5	0	339	339	P11137-1	324	663	+	339	P11137-1	0	5481	ENST00000360351.8	506	5987	++	38	P11137-1#5	0	339	ENST00000360351.8	830	1169	+	339	0	0	6300
P11137-1#6	0	474	474	P11137-1	1017	1491	+	474	P11137-1	0	5481	ENST00000704357.1	451	6025	+	280	P11137-1#6	0	474	ENST00000704357.1	1468	1942	+	474	0	0	6301
P11137-1#6	0	474	474	P11137-1	1017	1491	+	474	P11137-1	0	5481	ENST00000682079.1	451	5932	++	275	P11137-1#6	0	474	ENST00000682079.1	1468	1942	+	474	0	0	6302
P11137-1#6	0	474	474	P11137-1	1017	1491	+	474	P11137-1	0	5481	ENST00000673860.1	318	6288	+	238	P11137-1#6	0	474	ENST00000673860.1	1824	2298	+	474	0	0	6303
P11137-1#6	0	474	474	P11137-1	1017	1491	+	474	P11137-1	0	5481	ENST00000447185.5	0	5469	++	97	P11137-1#6	0	474	ENST00000447185.5	1005	1479	+	474	0	0	6304
P11137-1#6	0	474	474	P11137-1	1017	1491	+	474	P11137-1	0	1455	ENST00000445941.5	318	2019	+	96	P11137-1#6	0	438	ENST00000445941.5	1581	2019	+	438	0	36	6305
P11137-1#6	0	474	474	P11137-1	1017	1491	+	474	P11137-1	0	5481	ENST00000360351.8	506	5987	++	38	P11137-1#6	0	474	ENST00000360351.8	1523	1997	+	474	0	0	6306
P11137-1#7	0	246	246	P11137-1	1734	1980	+	246	P11137-1	0	5481	ENST00000704357.1	451	6025	+	280	P11137-1#7	0	246	ENST00000704357.1	2185	2431	+	246	0	0	6307
P11137-1#7	0	246	246	P11137-1	1734	1980	+	246	P11137-1	0	5481	ENST00000682079.1	451	5932	++	275	P11137-1#7	0	246	ENST00000682079.1	2185	2431	+	246	0	0	6308
P11137-1#7	0	246	246	P11137-1	1734	1980	+	246	P11137-1	0	5481	ENST00000673860.1	318	6288	+	238	P11137-1#7	0	246	ENST00000673860.1	2541	2787	+	246	0	0	6309
P11137-1#7	0	246	246	P11137-1	1734	1980	+	246	P11137-1	0	5481	ENST00000447185.5	0	5469	++	97	P11137-1#7	0	246	ENST00000447185.5	1722	1968	+	246	0	0	6310
P11137-1#7	0	246	246	P11137-1	1734	1980	+	246	P11137-1	0	5481	ENST00000360351.8	506	5987	++	38	P11137-1#7	0	246	ENST00000360351.8	2240	2486	+	246	0	0	6311
P11137-1#8	0	132	132	P11137-1	2100	2232	+	132	P11137-1	0	5481	ENST00000704357.1	451	6025	+	280	P11137-1#8	0	132	ENST00000704357.1	2551	2683	+	132	0	0	6312
P11137-1#8	0	132	132	P11137-1	2100	2232	+	132	P11137-1	0	5481	ENST00000682079.1	451	5932	++	275	P11137-1#8	0	132	ENST00000682079.1	2551	2683	+	132	0	0	6313
P11137-1#8	0	132	132	P11137-1	2100	2232	+	132	P11137-1	0	5481	ENST00000673860.1	318	6288	+	238	P11137-1#8	0	132	ENST00000673860.1	2907	3039	+	132	0	0	6314
P11137-1#8	0	132	132	P11137-1	2100	2232	+	132	P11137-1	0	5481	ENST00000447185.5	0	5469	++	97	P11137-1#8	0	132	ENST00000447185.5	2088	2220	+	132	0	0	6315
P11137-1#8	0	132	132	P11137-1	2100	2232	+	132	P11137-1	0	5481	ENST00000360351.8	506	5987	++	38	P11137-1#8	0	132	ENST00000360351.8	2606	2738	+	132	0	0	6316
P11137-1#9	0	174	174	P11137-1	2790	2964	+	174	P11137-1	0	5481	ENST00000704357.1	451	6025	+	280	P11137-1#9	0	174	ENST00000704357.1	3241	3415	+	174	0	0	6317
P11137-1#9	0	174	174	P11137-1	2790	2964	+	174	P11137-1	0	5481	ENST00000682079.1	451	5932	++	275	P11137-1#9	0	174	ENST00000682079.1	3241	3415	+	174	0	0	6318
P11137-1#9	0	174	174	P11137-1	2790	2964	+	174	P11137-1	0	5481	ENST00000673860.1	318	6288	+	238	P11137-1#9	0	174	ENST00000673860.1	3597	3771	+	174	0	0	6319
P11137-1#9	0	174	174	P11137-1	2790	2964	+	174	P11137-1	0	5481	ENST00000447185.5	0	5469	++	97	P11137-1#9	0	174	ENST00000447185.5	2778	2952	+	174	0	0	6320
P11137-1#9	0	174	174	P11137-1	2790	2964	+	174	P11137-1	0	5481	ENST00000360351.8	506	5987	++	38	P11137-1#9	0	174	ENST00000360351.8	3296	3470	+	174	0	0	6321
P11137-1#10	0	264	264	P11137-1	3216	3480	+	264	P11137-1	0	5481	ENST00000704357.1	451	6025	+	280	P11137-1#10	0	264	ENST00000704357.1	3667	3931	+	264	0	0	6322
P11137-1#10	0	264	264	P11137-1	3216	3480	+	264	P11137-1	0	5481	ENST00000682079.1	451	5932	++	275	P11137-1#10	0	264	ENST00000682079.1	3667	3931	+	264	0	0	6323
P11137-1#10	0	264	264	P11137-1	3216	3480	+	264	P11137-1	0	5481	ENST00000673860.1	318	6288	+	238	P11137-1#10	0	264	ENST00000673860.1	4023	4287	+	264	0	0	6324
P11137-1#10	0	264	264	P11137-1	3216	3480	+	264	P11137-1	0	5481	ENST00000447185.5	0	5469	++	97	P11137-1#10	0	264	ENST00000447185.5	3204	3468	+	264	0	0	6325
P11137-1#10	0	264	264	P11137-1	3216	3480	+	264	P11137-1	0	5481	ENST00000360351.8	506	5987	++	38	P11137-1#10	0	264	ENST00000360351.8	3722	3986	+	264	0	0	6326
P11137-1#11	0	60	60	P11137-1	3588	3648	+	60	P11137-1	0	5481	ENST00000704357.1	451	6025	+	280	P11137-1#11	0	60	ENST00000704357.1	4039	4099	+	60	0	0	6327
P11137-1#11	0	60	60	P11137-1	3588	3648	+	60	P11137-1	0	5481	ENST00000682079.1	451	5932	++	275	P11137-1#11	0	60	ENST00000682079.1	4039	4099	+	60	0	0	6328
P11137-1#11	0	60	60	P11137-1	3588	3648	+	60	P11137-1	0	5481	ENST00000673860.1	318	6288	+	238	P11137-1#11	0	60	ENST00000673860.1	4395	4455	+	60	0	0	6329
P11137-1#11	0	60	60	P11137-1	3588	3648	+	60	P11137-1	0	5481	ENST00000447185.5	0	5469	++	97	P11137-1#11	0	60	ENST00000447185.5	3576	3636	+	60	0	0	6330
P11137-1#11	0	60	60	P11137-1	3588	3648	+	60	P11137-1	0	5481	ENST00000360351.8	506	5987	++	38	P11137-1#11	0	60	ENST00000360351.8	4094	4154	+	60	0	0	6331
P11137-1#12	0	246	246	P11137-1	3888	4134	+	246	P11137-1	0	5481	ENST00000704357.1	451	6025	+	280	P11137-1#12	0	246	ENST00000704357.1	4339	4585	+	246	0	0	6332
P11137-1#12	0	246	246	P11137-1	3888	4134	+	246	P11137-1	0	5481	ENST00000682079.1	451	5932	++	275	P11137-1#12	0	246	ENST00000682079.1	4339	4585	+	246	0	0	6333
P11137-1#12	0	246	246	P11137-1	3888	4134	+	246	P11137-1	0	5481	ENST00000673860.1	318	6288	+	238	P11137-1#12	0	246	ENST00000673860.1	4695	4941	+	246	0	0	6334
P11137-1#12	0	246	246	P11137-1	3888	4134	+	246	P11137-1	0	5481	ENST00000447185.5	0	5469	++	97	P11137-1#12	0	246	ENST00000447185.5	3876	4122	+	246	0	0	6335
P11137-1#12	0	246	246	P11137-1	3888	4134	+	246	P11137-1	0	5481	ENST00000360351.8	506	5987	++	38	P11137-1#12	0	246	ENST00000360351.8	4394	4640	+	246	0	0	6336
P11137-1#13	0	174	174	P11137-1	4206	4380	+	174	P11137-1	0	5481	ENST00000704357.1	451	6025	+	280	P11137-1#13	0	174	ENST00000704357.1	4657	4831	+	174	0	0	6337
P11137-1#13	0	174	174	P11137-1	4206	4380	+	174	P11137-1	0	5481	ENST00000682079.1	451	5932	++	275	P11137-1#13	0	174	ENST00000682079.1	4657	4831	+	174	0	0	6338
P11137-1#13	0	174	174	P11137-1	4206	4380	+	174	P11137-1	0	5481	ENST00000673860.1	318	6288	+	238	P11137-1#13	0	174	ENST00000673860.1	5013	5187	+	174	0	0	6339
P11137-1#13	0	174	174	P11137-1	4206	4380	+	174	P11137-1	0	5481	ENST00000447185.5	0	5469	++	97	P11137-1#13	0	174	ENST00000447185.5	4194	4368	+	174	0	0	6340
P11137-1#13	0	174	174	P11137-1	4206	4380	+	174	P11137-1	0	5481	ENST00000360351.8	506	5987	++	38	P11137-1#13	0	174	ENST00000360351.8	4712	4886	+	174	0	0	6341
P11137-1#14	0	63	63	P11137-1	4338	4401	+	63	P11137-1	0	5481	ENST00000704357.1	451	6025	+	280	P11137-1#14	0	63	ENST00000704357.1	4789	4852	+	63	0	0	6342
P11137-1#14	0	63	63	P11137-1	4338	4401	+	63	P11137-1	0	5481	ENST00000682079.1	451	5932	++	275	P11137-1#14	0	63	ENST00000682079.1	4789	4852	+	63	0	0	6343
P11137-1#14	0	63	63	P11137-1	4338	4401	+	63	P11137-1	0	5481	ENST00000673860.1	318	6288	+	238	P11137-1#14	0	63	ENST00000673860.1	5145	5208	+	63	0	0	6344
P11137-1#14	0	63	63	P11137-1	4338	4401	+	63	P11137-1	0	5481	ENST00000447185.5	0	5469	++	97	P11137-1#14	0	63	ENST00000447185.5	4326	4389	+	63	0	0	6345
P11137-1#14	0	63	63	P11137-1	4338	4401	+	63	P11137-1	0	5481	ENST00000360351.8	506	5987	++	38	P11137-1#14	0	63	ENST00000360351.8	4844	4907	+	63	0	0	6346
P11137-1#15	0	60	60	P11137-1	4410	4470	+	60	P11137-1	0	5481	ENST00000704357.1	451	6025	+	280	P11137-1#15	0	60	ENST00000704357.1	4861	4921	+	60	0	0	6347
P11137-1#15	0	60	60	P11137-1	4410	4470	+	60	P11137-1	0	5481	ENST00000682079.1	451	5932	++	275	P11137-1#15	0	60	ENST00000682079.1	4861	4921	+	60	0	0	6348
P11137-1#15	0	60	60	P11137-1	4410	4470	+	60	P11137-1	0	5481	ENST00000673860.1	318	6288	+	238	P11137-1#15	0	60	ENST00000673860.1	5217	5277	+	60	0	0	6349
P11137-1#15	0	60	60	P11137-1	4410	4470	+	60	P11137-1	0	5481	ENST00000447185.5	0	5469	++	97	P11137-1#15	0	60	ENST00000447185.5	4398	4458	+	60	0	0	6350
P11137-1#15	0	60	60	P11137-1	4410	4470	+	60	P11137-1	0	5481	ENST00000360351.8	506	5987	++	38	P11137-1#15	0	60	ENST00000360351.8	4916	4976	+	60	0	0	6351
P11137-1#16	0	399	399	P11137-1	4515	4914	+	399	P11137-1	0	5481	ENST00000704357.1	451	6025	+	280	P11137-1#16	0	399	ENST00000704357.1	4966	5365	+	399	0	0	6352
P11137-1#16	0	399	399	P11137-1	4515	4914	+	399	P11137-1	0	5481	ENST00000682079.1	451	5932	++	275	P11137-1#16	0	399	ENST00000682079.1	4966	5365	+	399	0	0	6353
P11137-1#16	0	399	399	P11137-1	4515	4914	+	399	P11137-1	0	5481	ENST00000673860.1	318	6288	+	238	P11137-1#16	0	399	ENST00000673860.1	5322	5721	+	399	0	0	6354
P11137-1#16	0	399	399	P11137-1	4515	4914	+	399	P11137-1	222	4695	ENST00000452717.1	0	624	+	101	P11137-1#16	7	180	ENST00000452717.1	232	624	+	173	7	219	6355
P11137-1#16	0	399	399	P11137-1	4515	4914	+	399	P11137-1	0	5481	ENST00000447185.5	0	5469	++	97	P11137-1#16	0	399	ENST00000447185.5	4503	4902	+	399	0	0	6356
P11137-1#16	0	399	399	P11137-1	4515	4914	+	399	P11137-1	4521	5481	ENST00000392194.5	619	1579	++	61	P11137-1#16	6	399	ENST00000392194.5	619	1012	+	393	6	0	6357
P11137-1#16	0	399	399	P11137-1	4515	4914	+	399	P11137-1	4521	5481	ENST00000361559.8	949	1909	++	40	P11137-1#16	6	399	ENST00000361559.8	949	1342	+	393	6	0	6358
P11137-1#16	0	399	399	P11137-1	4515	4914	+	399	P11137-1	0	5481	ENST00000360351.8	506	5987	++	38	P11137-1#16	0	399	ENST00000360351.8	5021	5420	+	399	0	0	6359
P11137-1#17	0	69	69	P11137-1	5334	5403	+	69	P11137-1	0	5481	ENST00000704357.1	451	6025	+	280	P11137-1#17	0	69	ENST00000704357.1	5878	5947	+	69	0	0	6360
P11137-1#17	0	69	69	P11137-1	5334	5403	+	69	P11137-1	0	5481	ENST00000682079.1	451	5932	++	275	P11137-1#17	0	69	ENST00000682079.1	5785	5854	+	69	0	0	6361
P11137-1#17	0	69	69	P11137-1	5334	5403	+	69	P11137-1	0	5481	ENST00000673860.1	318	6288	+	238	P11137-1#17	0	69	ENST00000673860.1	6141	6210	+	69	0	0	6362
P11137-1#17	0	69	69	P11137-1	5334	5403	+	69	P11137-1	0	5481	ENST00000447185.5	0	5469	++	97	P11137-1#17	0	69	ENST00000447185.5	5322	5391	+	69	0	0	6363
P11137-1#17	0	69	69	P11137-1	5334	5403	+	69	P11137-1	4521	5481	ENST00000392194.5	619	1579	++	61	P11137-1#17	0	69	ENST00000392194.5	1432	1501	+	69	0	0	6364
P11137-1#17	0	69	69	P11137-1	5334	5403	+	69	P11137-1	4521	5481	ENST00000361559.8	949	1909	++	40	P11137-1#17	0	69	ENST00000361559.8	1762	1831	+	69	0	0	6365
P11137-1#17	0	69	69	P11137-1	5334	5403	+	69	P11137-1	0	5481	ENST00000360351.8	506	5987	++	38	P11137-1#17	0	69	ENST00000360351.8	5840	5909	+	69	0	0	6366
P11137-1#18	0	57	57	P11137-1	183	240	+	57	P11137-1	0	5481	ENST00000704357.1	451	6025	+	280	P11137-1#18	0	57	ENST00000704357.1	634	691	+	57	0	0	6367
P11137-1#18	0	57	57	P11137-1	183	240	+	57	P11137-1	0	5481	ENST00000682079.1	451	5932	++	275	P11137-1#18	0	57	ENST00000682079.1	634	691	+	57	0	0	6368
P11137-1#18	0	57	57	P11137-1	183	240	+	57	P11137-1	0	5481	ENST00000673860.1	318	6288	+	238	P11137-1#18	0	57	ENST00000673860.1	501	558	+	57	0	0	6369
P11137-1#18	0	57	57	P11137-1	183	240	+	57	P11137-1	222	4695	ENST00000452717.1	0	624	+	101	P11137-1#18	39	57	ENST00000452717.1	0	18	+	18	39	0	6370
P11137-1#18	0	57	57	P11137-1	183	240	+	57	P11137-1	0	5481	ENST00000447185.5	0	5469	++	97	P11137-1#18	0	57	ENST00000447185.5	183	240	+	57	0	0	6371
P11137-1#18	0	57	57	P11137-1	183	240	+	57	P11137-1	0	1455	ENST00000445941.5	318	2019	+	96	P11137-1#18	0	57	ENST00000445941.5	501	558	+	57	0	0	6372
P11137-1#18	0	57	57	P11137-1	183	240	+	57	P11137-1	0	319	ENST00000392193.5	295	614	+	60	P11137-1#18	0	57	ENST00000392193.5	478	535	+	57	0	0	6373
P11137-1#18	0	57	57	P11137-1	183	240	+	57	P11137-1	0	5481	ENST00000360351.8	506	5987	++	38	P11137-1#18	0	57	ENST00000360351.8	689	746	+	57	0	0	6374
P11137-1#19	0	57	57	P11137-1	516	573	+	57	P11137-1	0	5481	ENST00000704357.1	451	6025	+	280	P11137-1#19	0	57	ENST00000704357.1	967	1024	+	57	0	0	6375
P11137-1#19	0	57	57	P11137-1	516	573	+	57	P11137-1	0	5481	ENST00000682079.1	451	5932	++	275	P11137-1#19	0	57	ENST00000682079.1	967	1024	+	57	0	0	6376
P11137-1#19	0	57	57	P11137-1	516	573	+	57	P11137-1	0	5481	ENST00000673860.1	318	6288	+	238	P11137-1#19	0	57	ENST00000673860.1	1323	1380	+	57	0	0	6377
P11137-1#19	0	57	57	P11137-1	516	573	+	57	P11137-1	0	5481	ENST00000447185.5	0	5469	++	97	P11137-1#19	0	57	ENST00000447185.5	504	561	+	57	0	0	6378
P11137-1#19	0	57	57	P11137-1	516	573	+	57	P11137-1	0	1455	ENST00000445941.5	318	2019	+	96	P11137-1#19	0	57	ENST00000445941.5	1080	1137	+	57	0	0	6379
P11137-1#19	0	57	57	P11137-1	516	573	+	57	P11137-1	0	5481	ENST00000360351.8	506	5987	++	38	P11137-1#19	0	57	ENST00000360351.8	1022	1079	+	57	0	0	6380
P11137-1#20	0	48	48	P11137-1	1092	1140	+	48	P11137-1	0	5481	ENST00000704357.1	451	6025	+	280	P11137-1#20	0	48	ENST00000704357.1	1543	1591	+	48	0	0	6381
P11137-1#20	0	48	48	P11137-1	1092	1140	+	48	P11137-1	0	5481	ENST00000682079.1	451	5932	++	275	P11137-1#20	0	48	ENST00000682079.1	1543	1591	+	48	0	0	6382
P11137-1#20	0	48	48	P11137-1	1092	1140	+	48	P11137-1	0	5481	ENST00000673860.1	318	6288	+	238	P11137-1#20	0	48	ENST00000673860.1	1899	1947	+	48	0	0	6383
P11137-1#20	0	48	48	P11137-1	1092	1140	+	48	P11137-1	0	5481	ENST00000447185.5	0	5469	++	97	P11137-1#20	0	48	ENST00000447185.5	1080	1128	+	48	0	0	6384
P11137-1#20	0	48	48	P11137-1	1092	1140	+	48	P11137-1	0	1455	ENST00000445941.5	318	2019	+	96	P11137-1#20	0	48	ENST00000445941.5	1656	1704	+	48	0	0	6385
P11137-1#20	0	48	48	P11137-1	1092	1140	+	48	P11137-1	0	5481	ENST00000360351.8	506	5987	++	38	P11137-1#20	0	48	ENST00000360351.8	1598	1646	+	48	0	0	6386
P11137-1#21	0	72	72	P11137-1	1182	1254	+	72	P11137-1	0	5481	ENST00000704357.1	451	6025	+	280	P11137-1#21	0	72	ENST00000704357.1	1633	1705	+	72	0	0	6387
P11137-1#21	0	72	72	P11137-1	1182	1254	+	72	P11137-1	0	5481	ENST00000682079.1	451	5932	++	275	P11137-1#21	0	72	ENST00000682079.1	1633	1705	+	72	0	0	6388
P11137-1#21	0	72	72	P11137-1	1182	1254	+	72	P11137-1	0	5481	ENST00000673860.1	318	6288	+	238	P11137-1#21	0	72	ENST00000673860.1	1989	2061	+	72	0	0	6389
P11137-1#21	0	72	72	P11137-1	1182	1254	+	72	P11137-1	0	5481	ENST00000447185.5	0	5469	++	97	P11137-1#21	0	72	ENST00000447185.5	1170	1242	+	72	0	0	6390
P11137-1#21	0	72	72	P11137-1	1182	1254	+	72	P11137-1	0	1455	ENST00000445941.5	318	2019	+	96	P11137-1#21	0	72	ENST00000445941.5	1746	1818	+	72	0	0	6391
P11137-1#21	0	72	72	P11137-1	1182	1254	+	72	P11137-1	0	5481	ENST00000360351.8	506	5987	++	38	P11137-1#21	0	72	ENST00000360351.8	1688	1760	+	72	0	0	6392
P11137-1#22	0	48	48	P11137-1	1254	1302	+	48	P11137-1	0	5481	ENST00000704357.1	451	6025	+	280	P11137-1#22	0	48	ENST00000704357.1	1705	1753	+	48	0	0	6393
P11137-1#22	0	48	48	P11137-1	1254	1302	+	48	P11137-1	0	5481	ENST00000682079.1	451	5932	++	275	P11137-1#22	0	48	ENST00000682079.1	1705	1753	+	48	0	0	6394
P11137-1#22	0	48	48	P11137-1	1254	1302	+	48	P11137-1	0	5481	ENST00000673860.1	318	6288	+	238	P11137-1#22	0	48	ENST00000673860.1	2061	2109	+	48	0	0	6395
P11137-1#22	0	48	48	P11137-1	1254	1302	+	48	P11137-1	0	5481	ENST00000447185.5	0	5469	++	97	P11137-1#22	0	48	ENST00000447185.5	1242	1290	+	48	0	0	6396
P11137-1#22	0	48	48	P11137-1	1254	1302	+	48	P11137-1	0	1455	ENST00000445941.5	318	2019	+	96	P11137-1#22	0	48	ENST00000445941.5	1818	1866	+	48	0	0	6397
P11137-1#22	0	48	48	P11137-1	1254	1302	+	48	P11137-1	0	5481	ENST00000360351.8	506	5987	++	38	P11137-1#22	0	48	ENST00000360351.8	1760	1808	+	48	0	0	6398
P11137-1#23	0	93	93	P11137-1	1305	1398	+	93	P11137-1	0	5481	ENST00000704357.1	451	6025	+	280	P11137-1#23	0	93	ENST00000704357.1	1756	1849	+	93	0	0	6399
P11137-1#23	0	93	93	P11137-1	1305	1398	+	93	P11137-1	0	5481	ENST00000682079.1	451	5932	++	275	P11137-1#23	0	93	ENST00000682079.1	1756	1849	+	93	0	0	6400
P11137-1#23	0	93	93	P11137-1	1305	1398	+	93	P11137-1	0	5481	ENST00000673860.1	318	6288	+	238	P11137-1#23	0	93	ENST00000673860.1	2112	2205	+	93	0	0	6401
P11137-1#23	0	93	93	P11137-1	1305	1398	+	93	P11137-1	0	5481	ENST00000447185.5	0	5469	++	97	P11137-1#23	0	93	ENST00000447185.5	1293	1386	+	93	0	0	6402
P11137-1#23	0	93	93	P11137-1	1305	1398	+	93	P11137-1	0	1455	ENST00000445941.5	318	2019	+	96	P11137-1#23	0	93	ENST00000445941.5	1869	1962	+	93	0	0	6403
P11137-1#23	0	93	93	P11137-1	1305	1398	+	93	P11137-1	0	5481	ENST00000360351.8	506	5987	++	38	P11137-1#23	0	93	ENST00000360351.8	1811	1904	+	93	0	0	6404
P11137-1#24	0	129	129	P11137-1	1734	1863	+	129	P11137-1	0	5481	ENST00000704357.1	451	6025	+	280	P11137-1#24	0	129	ENST00000704357.1	2185	2314	+	129	0	0	6405
P11137-1#24	0	129	129	P11137-1	1734	1863	+	129	P11137-1	0	5481	ENST00000682079.1	451	5932	++	275	P11137-1#24	0	129	ENST00000682079.1	2185	2314	+	129	0	0	6406
P11137-1#24	0	129	129	P11137-1	1734	1863	+	129	P11137-1	0	5481	ENST00000673860.1	318	6288	+	238	P11137-1#24	0	129	ENST00000673860.1	2541	2670	+	129	0	0	6407
P11137-1#24	0	129	129	P11137-1	1734	1863	+	129	P11137-1	0	5481	ENST00000447185.5	0	5469	++	97	P11137-1#24	0	129	ENST00000447185.5	1722	1851	+	129	0	0	6408
P11137-1#24	0	129	129	P11137-1	1734	1863	+	129	P11137-1	0	5481	ENST00000360351.8	506	5987	++	38	P11137-1#24	0	129	ENST00000360351.8	2240	2369	+	129	0	0	6409
P11137-1#25	0	87	87	P11137-1	1863	1950	+	87	P11137-1	0	5481	ENST00000704357.1	451	6025	+	280	P11137-1#25	0	87	ENST00000704357.1	2314	2401	+	87	0	0	6410
P11137-1#25	0	87	87	P11137-1	1863	1950	+	87	P11137-1	0	5481	ENST00000682079.1	451	5932	++	275	P11137-1#25	0	87	ENST00000682079.1	2314	2401	+	87	0	0	6411
P11137-1#25	0	87	87	P11137-1	1863	1950	+	87	P11137-1	0	5481	ENST00000673860.1	318	6288	+	238	P11137-1#25	0	87	ENST00000673860.1	2670	2757	+	87	0	0	6412
P11137-1#25	0	87	87	P11137-1	1863	1950	+	87	P11137-1	0	5481	ENST00000447185.5	0	5469	++	97	P11137-1#25	0	87	ENST00000447185.5	1851	1938	+	87	0	0	6413
P11137-1#25	0	87	87	P11137-1	1863	1950	+	87	P11137-1	0	5481	ENST00000360351.8	506	5987	++	38	P11137-1#25	0	87	ENST00000360351.8	2369	2456	+	87	0	0	6414
P11137-1#26	0	168	168	P11137-1	2790	2958	+	168	P11137-1	0	5481	ENST00000704357.1	451	6025	+	280	P11137-1#26	0	168	ENST00000704357.1	3241	3409	+	168	0	0	6415
P11137-1#26	0	168	168	P11137-1	2790	2958	+	168	P11137-1	0	5481	ENST00000682079.1	451	5932	++	275	P11137-1#26	0	168	ENST00000682079.1	3241	3409	+	168	0	0	6416
P11137-1#26	0	168	168	P11137-1	2790	2958	+	168	P11137-1	0	5481	ENST00000673860.1	318	6288	+	238	P11137-1#26	0	168	ENST00000673860.1	3597	3765	+	168	0	0	6417
P11137-1#26	0	168	168	P11137-1	2790	2958	+	168	P11137-1	0	5481	ENST00000447185.5	0	5469	++	97	P11137-1#26	0	168	ENST00000447185.5	2778	2946	+	168	0	0	6418
P11137-1#26	0	168	168	P11137-1	2790	2958	+	168	P11137-1	0	5481	ENST00000360351.8	506	5987	++	38	P11137-1#26	0	168	ENST00000360351.8	3296	3464	+	168	0	0	6419
P11137-1#27	0	177	177	P11137-1	3297	3474	+	177	P11137-1	0	5481	ENST00000704357.1	451	6025	+	280	P11137-1#27	0	177	ENST00000704357.1	3748	3925	+	177	0	0	6420
P11137-1#27	0	177	177	P11137-1	3297	3474	+	177	P11137-1	0	5481	ENST00000682079.1	451	5932	++	275	P11137-1#27	0	177	ENST00000682079.1	3748	3925	+	177	0	0	6421
P11137-1#27	0	177	177	P11137-1	3297	3474	+	177	P11137-1	0	5481	ENST00000673860.1	318	6288	+	238	P11137-1#27	0	177	ENST00000673860.1	4104	4281	+	177	0	0	6422
P11137-1#27	0	177	177	P11137-1	3297	3474	+	177	P11137-1	0	5481	ENST00000447185.5	0	5469	++	97	P11137-1#27	0	177	ENST00000447185.5	3285	3462	+	177	0	0	6423
P11137-1#27	0	177	177	P11137-1	3297	3474	+	177	P11137-1	0	5481	ENST00000360351.8	506	5987	++	38	P11137-1#27	0	177	ENST00000360351.8	3803	3980	+	177	0	0	6424
P11137-1#28	0	48	48	P11137-1	3939	3987	+	48	P11137-1	0	5481	ENST00000704357.1	451	6025	+	280	P11137-1#28	0	48	ENST00000704357.1	4390	4438	+	48	0	0	6425
P11137-1#28	0	48	48	P11137-1	3939	3987	+	48	P11137-1	0	5481	ENST00000682079.1	451	5932	++	275	P11137-1#28	0	48	ENST00000682079.1	4390	4438	+	48	0	0	6426
P11137-1#28	0	48	48	P11137-1	3939	3987	+	48	P11137-1	0	5481	ENST00000673860.1	318	6288	+	238	P11137-1#28	0	48	ENST00000673860.1	4746	4794	+	48	0	0	6427
P11137-1#28	0	48	48	P11137-1	3939	3987	+	48	P11137-1	0	5481	ENST00000447185.5	0	5469	++	97	P11137-1#28	0	48	ENST00000447185.5	3927	3975	+	48	0	0	6428
P11137-1#28	0	48	48	P11137-1	3939	3987	+	48	P11137-1	0	5481	ENST00000360351.8	506	5987	++	38	P11137-1#28	0	48	ENST00000360351.8	4445	4493	+	48	0	0	6429
P11137-1#29	0	90	90	P11137-1	4044	4134	+	90	P11137-1	0	5481	ENST00000704357.1	451	6025	+	280	P11137-1#29	0	90	ENST00000704357.1	4495	4585	+	90	0	0	6430
P11137-1#29	0	90	90	P11137-1	4044	4134	+	90	P11137-1	0	5481	ENST00000682079.1	451	5932	++	275	P11137-1#29	0	90	ENST00000682079.1	4495	4585	+	90	0	0	6431
P11137-1#29	0	90	90	P11137-1	4044	4134	+	90	P11137-1	0	5481	ENST00000673860.1	318	6288	+	238	P11137-1#29	0	90	ENST00000673860.1	4851	4941	+	90	0	0	6432
P11137-1#29	0	90	90	P11137-1	4044	4134	+	90	P11137-1	0	5481	ENST00000447185.5	0	5469	++	97	P11137-1#29	0	90	ENST00000447185.5	4032	4122	+	90	0	0	6433
P11137-1#29	0	90	90	P11137-1	4044	4134	+	90	P11137-1	0	5481	ENST00000360351.8	506	5987	++	38	P11137-1#29	0	90	ENST00000360351.8	4550	4640	+	90	0	0	6434
P11137-1#30	0	54	54	P11137-1	4674	4728	+	54	P11137-1	0	5481	ENST00000704357.1	451	6025	+	280	P11137-1#30	0	54	ENST00000704357.1	5125	5179	+	54	0	0	6435
P11137-1#30	0	54	54	P11137-1	4674	4728	+	54	P11137-1	0	5481	ENST00000682079.1	451	5932	++	275	P11137-1#30	0	54	ENST00000682079.1	5125	5179	+	54	0	0	6436
P11137-1#30	0	54	54	P11137-1	4674	4728	+	54	P11137-1	0	5481	ENST00000673860.1	318	6288	+	238	P11137-1#30	0	54	ENST00000673860.1	5481	5535	+	54	0	0	6437
P11137-1#30	0	54	54	P11137-1	4674	4728	+	54	P11137-1	222	4695	ENST00000452717.1	0	624	+	101	P11137-1#30	0	21	ENST00000452717.1	603	624	+	21	0	33	6438
P11137-1#30	0	54	54	P11137-1	4674	4728	+	54	P11137-1	0	5481	ENST00000447185.5	0	5469	++	97	P11137-1#30	0	54	ENST00000447185.5	4662	4716	+	54	0	0	6439
P11137-1#30	0	54	54	P11137-1	4674	4728	+	54	P11137-1	4521	5481	ENST00000392194.5	619	1579	++	61	P11137-1#30	0	54	ENST00000392194.5	772	826	+	54	0	0	6440
P11137-1#30	0	54	54	P11137-1	4674	4728	+	54	P11137-1	4521	5481	ENST00000361559.8	949	1909	++	40	P11137-1#30	0	54	ENST00000361559.8	1102	1156	+	54	0	0	6441
P11137-1#30	0	54	54	P11137-1	4674	4728	+	54	P11137-1	0	5481	ENST00000360351.8	506	5987	++	38	P11137-1#30	0	54	ENST00000360351.8	5180	5234	+	54	0	0	6442
P11137-1#31	0	108	108	P11137-1	4746	4854	+	108	P11137-1	0	5481	ENST00000704357.1	451	6025	+	280	P11137-1#31	0	108	ENST00000704357.1	5197	5305	+	108	0	0	6443
P11137-1#31	0	108	108	P11137-1	4746	4854	+	108	P11137-1	0	5481	ENST00000682079.1	451	5932	++	275	P11137-1#31	0	108	ENST00000682079.1	5197	5305	+	108	0	0	6444
P11137-1#31	0	108	108	P11137-1	4746	4854	+	108	P11137-1	0	5481	ENST00000673860.1	318	6288	+	238	P11137-1#31	0	108	ENST00000673860.1	5553	5661	+	108	0	0	6445
P11137-1#31	0	108	108	P11137-1	4746	4854	+	108	P11137-1	0	5481	ENST00000447185.5	0	5469	++	97	P11137-1#31	0	108	ENST00000447185.5	4734	4842	+	108	0	0	6446
P11137-1#31	0	108	108	P11137-1	4746	4854	+	108	P11137-1	4521	5481	ENST00000392194.5	619	1579	++	61	P11137-1#31	0	108	ENST00000392194.5	844	952	+	108	0	0	6447
P11137-1#31	0	108	108	P11137-1	4746	4854	+	108	P11137-1	4521	5481	ENST00000361559.8	949	1909	++	40	P11137-1#31	0	108	ENST00000361559.8	1174	1282	+	108	0	0	6448
P11137-1#31	0	108	108	P11137-1	4746	4854	+	108	P11137-1	0	5481	ENST00000360351.8	506	5987	++	38	P11137-1#31	0	108	ENST00000360351.8	5252	5360	+	108	0	0	6449
P11137-1#32	0	66	66	P11137-1	5337	5403	+	66	P11137-1	0	5481	ENST00000704357.1	451	6025	+	280	P11137-1#32	0	66	ENST00000704357.1	5881	5947	+	66	0	0	6450
P11137-1#32	0	66	66	P11137-1	5337	5403	+	66	P11137-1	0	5481	ENST00000682079.1	451	5932	++	275	P11137-1#32	0	66	ENST00000682079.1	5788	5854	+	66	0	0	6451
P11137-1#32	0	66	66	P11137-1	5337	5403	+	66	P11137-1	0	5481	ENST00000673860.1	318	6288	+	238	P11137-1#32	0	66	ENST00000673860.1	6144	6210	+	66	0	0	6452
P11137-1#32	0	66	66	P11137-1	5337	5403	+	66	P11137-1	0	5481	ENST00000447185.5	0	5469	++	97	P11137-1#32	0	66	ENST00000447185.5	5325	5391	+	66	0	0	6453
P11137-1#32	0	66	66	P11137-1	5337	5403	+	66	P11137-1	4521	5481	ENST00000392194.5	619	1579	++	61	P11137-1#32	0	66	ENST00000392194.5	1435	1501	+	66	0	0	6454
P11137-1#32	0	66	66	P11137-1	5337	5403	+	66	P11137-1	4521	5481	ENST00000361559.8	949	1909	++	40	P11137-1#32	0	66	ENST00000361559.8	1765	1831	+	66	0	0	6455
P11137-1#32	0	66	66	P11137-1	5337	5403	+	66	P11137-1	0	5481	ENST00000360351.8	506	5987	++	38	P11137-1#32	0	66	ENST00000360351.8	5843	5909	+	66	0	0	6456
P11137-1#33	0	3	3	P11137-1	405	408	+	3	P11137-1	0	5481	ENST00000704357.1	451	6025	+	280	P11137-1#33	0	3	ENST00000704357.1	856	859	+	3	0	0	6457
P11137-1#33	0	3	3	P11137-1	405	408	+	3	P11137-1	0	5481	ENST00000682079.1	451	5932	++	275	P11137-1#33	0	3	ENST00000682079.1	856	859	+	3	0	0	6458
P11137-1#33	0	3	3	P11137-1	405	408	+	3	P11137-1	0	5481	ENST00000673860.1	318	6288	+	238	P11137-1#33	0	3	ENST00000673860.1	723	726	+	3	0	0	6459
P11137-1#33	0	3	3	P11137-1	405	408	+	3	P11137-1	222	4695	ENST00000452717.1	0	624	+	101	P11137-1#33	0	3	ENST00000452717.1	183	186	+	3	0	0	6460
P11137-1#33	0	3	3	P11137-1	405	408	+	3	P11137-1	0	5481	ENST00000447185.5	0	5469	++	97	P11137-1#33	0	3	ENST00000447185.5	405	408	+	3	0	0	6461
P11137-1#33	0	3	3	P11137-1	405	408	+	3	P11137-1	0	1455	ENST00000445941.5	318	2019	+	96	P11137-1#33	0	3	ENST00000445941.5	723	726	+	3	0	0	6462
P11137-1#33	0	3	3	P11137-1	405	408	+	3	P11137-1	0	5481	ENST00000360351.8	506	5987	++	38	P11137-1#33	0	3	ENST00000360351.8	911	914	+	3	0	0	6463
P11137-1#34	0	3	3	P11137-1	417	420	+	3	P11137-1	0	5481	ENST00000704357.1	451	6025	+	280	P11137-1#34	0	3	ENST00000704357.1	868	871	+	3	0	0	6464
P11137-1#34	0	3	3	P11137-1	417	420	+	3	P11137-1	0	5481	ENST00000682079.1	451	5932	++	275	P11137-1#34	0	3	ENST00000682079.1	868	871	+	3	0	0	6465
P11137-1#34	0	3	3	P11137-1	417	420	+	3	P11137-1	0	5481	ENST00000673860.1	318	6288	+	238	P11137-1#34	0	3	ENST00000673860.1	735	738	+	3	0	0	6466
P11137-1#34	0	3	3	P11137-1	417	420	+	3	P11137-1	222	4695	ENST00000452717.1	0	624	+	101	P11137-1#34	0	3	ENST00000452717.1	195	198	+	3	0	0	6467
P11137-1#34	0	3	3	P11137-1	417	420	+	3	P11137-1	0	5481	ENST00000447185.5	0	5469	++	97	P11137-1#34	0	3	ENST00000447185.5	417	420	+	3	0	0	6468
P11137-1#34	0	3	3	P11137-1	417	420	+	3	P11137-1	0	1455	ENST00000445941.5	318	2019	+	96	P11137-1#34	0	3	ENST00000445941.5	735	738	+	3	0	0	6469
P11137-1#34	0	3	3	P11137-1	417	420	+	3	P11137-1	0	5481	ENST00000360351.8	506	5987	++	38	P11137-1#34	0	3	ENST00000360351.8	923	926	+	3	0	0	6470
P11137-1#35	0	3	3	P11137-1	426	429	+	3	P11137-1	0	5481	ENST00000704357.1	451	6025	+	280	P11137-1#35	0	3	ENST00000704357.1	877	880	+	3	0	0	6471
P11137-1#35	0	3	3	P11137-1	426	429	+	3	P11137-1	0	5481	ENST00000682079.1	451	5932	++	275	P11137-1#35	0	3	ENST00000682079.1	877	880	+	3	0	0	6472
P11137-1#35	0	3	3	P11137-1	426	429	+	3	P11137-1	0	5481	ENST00000673860.1	318	6288	+	238	P11137-1#35	0	3	ENST00000673860.1	744	747	+	3	0	0	6473
P11137-1#35	0	3	3	P11137-1	426	429	+	3	P11137-1	222	4695	ENST00000452717.1	0	624	+	101	P11137-1#35	0	3	ENST00000452717.1	204	207	+	3	0	0	6474
P11137-1#35	0	3	3	P11137-1	426	429	+	3	P11137-1	0	5481	ENST00000447185.5	0	5469	++	97	P11137-1#35	0	3	ENST00000447185.5	426	429	+	3	0	0	6475
P11137-1#35	0	3	3	P11137-1	426	429	+	3	P11137-1	0	1455	ENST00000445941.5	318	2019	+	96	P11137-1#35	0	3	ENST00000445941.5	744	747	+	3	0	0	6476
P11137-1#35	0	3	3	P11137-1	426	429	+	3	P11137-1	0	5481	ENST00000360351.8	506	5987	++	38	P11137-1#35	0	3	ENST00000360351.8	932	935	+	3	0	0	6477
P11137-1#36	0	3	3	P11137-1	852	855	+	3	P11137-1	0	5481	ENST00000704357.1	451	6025	+	280	P11137-1#36	0	3	ENST00000704357.1	1303	1306	+	3	0	0	6478
P11137-1#36	0	3	3	P11137-1	852	855	+	3	P11137-1	0	5481	ENST00000682079.1	451	5932	++	275	P11137-1#36	0	3	ENST00000682079.1	1303	1306	+	3	0	0	6479
P11137-1#36	0	3	3	P11137-1	852	855	+	3	P11137-1	0	5481	ENST00000673860.1	318	6288	+	238	P11137-1#36	0	3	ENST00000673860.1	1659	1662	+	3	0	0	6480
P11137-1#36	0	3	3	P11137-1	852	855	+	3	P11137-1	0	5481	ENST00000447185.5	0	5469	++	97	P11137-1#36	0	3	ENST00000447185.5	840	843	+	3	0	0	6481
P11137-1#36	0	3	3	P11137-1	852	855	+	3	P11137-1	0	1455	ENST00000445941.5	318	2019	+	96	P11137-1#36	0	3	ENST00000445941.5	1416	1419	+	3	0	0	6482
P11137-1#36	0	3	3	P11137-1	852	855	+	3	P11137-1	0	5481	ENST00000360351.8	506	5987	++	38	P11137-1#36	0	3	ENST00000360351.8	1358	1361	+	3	0	0	6483
P11137-1#37	0	3	3	P11137-1	1491	1494	+	3	P11137-1	0	5481	ENST00000704357.1	451	6025	+	280	P11137-1#37	0	3	ENST00000704357.1	1942	1945	+	3	0	0	6484
P11137-1#37	0	3	3	P11137-1	1491	1494	+	3	P11137-1	0	5481	ENST00000682079.1	451	5932	++	275	P11137-1#37	0	3	ENST00000682079.1	1942	1945	+	3	0	0	6485
P11137-1#37	0	3	3	P11137-1	1491	1494	+	3	P11137-1	0	5481	ENST00000673860.1	318	6288	+	238	P11137-1#37	0	3	ENST00000673860.1	2298	2301	+	3	0	0	6486
P11137-1#37	0	3	3	P11137-1	1491	1494	+	3	P11137-1	0	5481	ENST00000447185.5	0	5469	++	97	P11137-1#37	0	3	ENST00000447185.5	1479	1482	+	3	0	0	6487
P11137-1#37	0	3	3	P11137-1	1491	1494	+	3	P11137-1	0	5481	ENST00000360351.8	506	5987	++	38	P11137-1#37	0	3	ENST00000360351.8	1997	2000	+	3	0	0	6488
P11137-1#38	0	3	3	P11137-1	1800	1803	+	3	P11137-1	0	5481	ENST00000704357.1	451	6025	+	280	P11137-1#38	0	3	ENST00000704357.1	2251	2254	+	3	0	0	6489
P11137-1#38	0	3	3	P11137-1	1800	1803	+	3	P11137-1	0	5481	ENST00000682079.1	451	5932	++	275	P11137-1#38	0	3	ENST00000682079.1	2251	2254	+	3	0	0	6490
P11137-1#38	0	3	3	P11137-1	1800	1803	+	3	P11137-1	0	5481	ENST00000673860.1	318	6288	+	238	P11137-1#38	0	3	ENST00000673860.1	2607	2610	+	3	0	0	6491
P11137-1#38	0	3	3	P11137-1	1800	1803	+	3	P11137-1	0	5481	ENST00000447185.5	0	5469	++	97	P11137-1#38	0	3	ENST00000447185.5	1788	1791	+	3	0	0	6492
P11137-1#38	0	3	3	P11137-1	1800	1803	+	3	P11137-1	0	5481	ENST00000360351.8	506	5987	++	38	P11137-1#38	0	3	ENST00000360351.8	2306	2309	+	3	0	0	6493
P11137-1#39	0	3	3	P11137-1	1812	1815	+	3	P11137-1	0	5481	ENST00000704357.1	451	6025	+	280	P11137-1#39	0	3	ENST00000704357.1	2263	2266	+	3	0	0	6494
P11137-1#39	0	3	3	P11137-1	1812	1815	+	3	P11137-1	0	5481	ENST00000682079.1	451	5932	++	275	P11137-1#39	0	3	ENST00000682079.1	2263	2266	+	3	0	0	6495
P11137-1#39	0	3	3	P11137-1	1812	1815	+	3	P11137-1	0	5481	ENST00000673860.1	318	6288	+	238	P11137-1#39	0	3	ENST00000673860.1	2619	2622	+	3	0	0	6496
P11137-1#39	0	3	3	P11137-1	1812	1815	+	3	P11137-1	0	5481	ENST00000447185.5	0	5469	++	97	P11137-1#39	0	3	ENST00000447185.5	1800	1803	+	3	0	0	6497
P11137-1#39	0	3	3	P11137-1	1812	1815	+	3	P11137-1	0	5481	ENST00000360351.8	506	5987	++	38	P11137-1#39	0	3	ENST00000360351.8	2318	2321	+	3	0	0	6498
P11137-1#40	0	3	3	P11137-1	1827	1830	+	3	P11137-1	0	5481	ENST00000704357.1	451	6025	+	280	P11137-1#40	0	3	ENST00000704357.1	2278	2281	+	3	0	0	6499
P11137-1#40	0	3	3	P11137-1	1827	1830	+	3	P11137-1	0	5481	ENST00000682079.1	451	5932	++	275	P11137-1#40	0	3	ENST00000682079.1	2278	2281	+	3	0	0	6500
P11137-1#40	0	3	3	P11137-1	1827	1830	+	3	P11137-1	0	5481	ENST00000673860.1	318	6288	+	238	P11137-1#40	0	3	ENST00000673860.1	2634	2637	+	3	0	0	6501
P11137-1#40	0	3	3	P11137-1	1827	1830	+	3	P11137-1	0	5481	ENST00000447185.5	0	5469	++	97	P11137-1#40	0	3	ENST00000447185.5	1815	1818	+	3	0	0	6502
P11137-1#40	0	3	3	P11137-1	1827	1830	+	3	P11137-1	0	5481	ENST00000360351.8	506	5987	++	38	P11137-1#40	0	3	ENST00000360351.8	2333	2336	+	3	0	0	6503
P11137-1#41	0	3	3	P11137-1	1884	1887	+	3	P11137-1	0	5481	ENST00000704357.1	451	6025	+	280	P11137-1#41	0	3	ENST00000704357.1	2335	2338	+	3	0	0	6504
P11137-1#41	0	3	3	P11137-1	1884	1887	+	3	P11137-1	0	5481	ENST00000682079.1	451	5932	++	275	P11137-1#41	0	3	ENST00000682079.1	2335	2338	+	3	0	0	6505
P11137-1#41	0	3	3	P11137-1	1884	1887	+	3	P11137-1	0	5481	ENST00000673860.1	318	6288	+	238	P11137-1#41	0	3	ENST00000673860.1	2691	2694	+	3	0	0	6506
P11137-1#41	0	3	3	P11137-1	1884	1887	+	3	P11137-1	0	5481	ENST00000447185.5	0	5469	++	97	P11137-1#41	0	3	ENST00000447185.5	1872	1875	+	3	0	0	6507
P11137-1#41	0	3	3	P11137-1	1884	1887	+	3	P11137-1	0	5481	ENST00000360351.8	506	5987	++	38	P11137-1#41	0	3	ENST00000360351.8	2390	2393	+	3	0	0	6508
P11137-1#42	0	3	3	P11137-1	2172	2175	+	3	P11137-1	0	5481	ENST00000704357.1	451	6025	+	280	P11137-1#42	0	3	ENST00000704357.1	2623	2626	+	3	0	0	6509
P11137-1#42	0	3	3	P11137-1	2172	2175	+	3	P11137-1	0	5481	ENST00000682079.1	451	5932	++	275	P11137-1#42	0	3	ENST00000682079.1	2623	2626	+	3	0	0	6510
P11137-1#42	0	3	3	P11137-1	2172	2175	+	3	P11137-1	0	5481	ENST00000673860.1	318	6288	+	238	P11137-1#42	0	3	ENST00000673860.1	2979	2982	+	3	0	0	6511
P11137-1#42	0	3	3	P11137-1	2172	2175	+	3	P11137-1	0	5481	ENST00000447185.5	0	5469	++	97	P11137-1#42	0	3	ENST00000447185.5	2160	2163	+	3	0	0	6512
P11137-1#42	0	3	3	P11137-1	2172	2175	+	3	P11137-1	0	5481	ENST00000360351.8	506	5987	++	38	P11137-1#42	0	3	ENST00000360351.8	2678	2681	+	3	0	0	6513
P11137-1#43	0	3	3	P11137-1	2184	2187	+	3	P11137-1	0	5481	ENST00000704357.1	451	6025	+	280	P11137-1#43	0	3	ENST00000704357.1	2635	2638	+	3	0	0	6514
P11137-1#43	0	3	3	P11137-1	2184	2187	+	3	P11137-1	0	5481	ENST00000682079.1	451	5932	++	275	P11137-1#43	0	3	ENST00000682079.1	2635	2638	+	3	0	0	6515
P11137-1#43	0	3	3	P11137-1	2184	2187	+	3	P11137-1	0	5481	ENST00000673860.1	318	6288	+	238	P11137-1#43	0	3	ENST00000673860.1	2991	2994	+	3	0	0	6516
P11137-1#43	0	3	3	P11137-1	2184	2187	+	3	P11137-1	0	5481	ENST00000447185.5	0	5469	++	97	P11137-1#43	0	3	ENST00000447185.5	2172	2175	+	3	0	0	6517
P11137-1#43	0	3	3	P11137-1	2184	2187	+	3	P11137-1	0	5481	ENST00000360351.8	506	5987	++	38	P11137-1#43	0	3	ENST00000360351.8	2690	2693	+	3	0	0	6518
P11137-1#44	0	3	3	P11137-1	2196	2199	+	3	P11137-1	0	5481	ENST00000704357.1	451	6025	+	280	P11137-1#44	0	3	ENST00000704357.1	2647	2650	+	3	0	0	6519
P11137-1#44	0	3	3	P11137-1	2196	2199	+	3	P11137-1	0	5481	ENST00000682079.1	451	5932	++	275	P11137-1#44	0	3	ENST00000682079.1	2647	2650	+	3	0	0	6520
P11137-1#44	0	3	3	P11137-1	2196	2199	+	3	P11137-1	0	5481	ENST00000673860.1	318	6288	+	238	P11137-1#44	0	3	ENST00000673860.1	3003	3006	+	3	0	0	6521
P11137-1#44	0	3	3	P11137-1	2196	2199	+	3	P11137-1	0	5481	ENST00000447185.5	0	5469	++	97	P11137-1#44	0	3	ENST00000447185.5	2184	2187	+	3	0	0	6522
P11137-1#44	0	3	3	P11137-1	2196	2199	+	3	P11137-1	0	5481	ENST00000360351.8	506	5987	++	38	P11137-1#44	0	3	ENST00000360351.8	2702	2705	+	3	0	0	6523
P11137-1#45	0	3	3	P11137-1	2205	2208	+	3	P11137-1	0	5481	ENST00000704357.1	451	6025	+	280	P11137-1#45	0	3	ENST00000704357.1	2656	2659	+	3	0	0	6524
P11137-1#45	0	3	3	P11137-1	2205	2208	+	3	P11137-1	0	5481	ENST00000682079.1	451	5932	++	275	P11137-1#45	0	3	ENST00000682079.1	2656	2659	+	3	0	0	6525
P11137-1#45	0	3	3	P11137-1	2205	2208	+	3	P11137-1	0	5481	ENST00000673860.1	318	6288	+	238	P11137-1#45	0	3	ENST00000673860.1	3012	3015	+	3	0	0	6526
P11137-1#45	0	3	3	P11137-1	2205	2208	+	3	P11137-1	0	5481	ENST00000447185.5	0	5469	++	97	P11137-1#45	0	3	ENST00000447185.5	2193	2196	+	3	0	0	6527
P11137-1#45	0	3	3	P11137-1	2205	2208	+	3	P11137-1	0	5481	ENST00000360351.8	506	5987	++	38	P11137-1#45	0	3	ENST00000360351.8	2711	2714	+	3	0	0	6528
P11137-1#46	0	3	3	P11137-1	2211	2214	+	3	P11137-1	0	5481	ENST00000704357.1	451	6025	+	280	P11137-1#46	0	3	ENST00000704357.1	2662	2665	+	3	0	0	6529
P11137-1#46	0	3	3	P11137-1	2211	2214	+	3	P11137-1	0	5481	ENST00000682079.1	451	5932	++	275	P11137-1#46	0	3	ENST00000682079.1	2662	2665	+	3	0	0	6530
P11137-1#46	0	3	3	P11137-1	2211	2214	+	3	P11137-1	0	5481	ENST00000673860.1	318	6288	+	238	P11137-1#46	0	3	ENST00000673860.1	3018	3021	+	3	0	0	6531
P11137-1#46	0	3	3	P11137-1	2211	2214	+	3	P11137-1	0	5481	ENST00000447185.5	0	5469	++	97	P11137-1#46	0	3	ENST00000447185.5	2199	2202	+	3	0	0	6532
P11137-1#46	0	3	3	P11137-1	2211	2214	+	3	P11137-1	0	5481	ENST00000360351.8	506	5987	++	38	P11137-1#46	0	3	ENST00000360351.8	2717	2720	+	3	0	0	6533
P11137-1#47	0	3	3	P11137-1	2232	2235	+	3	P11137-1	0	5481	ENST00000704357.1	451	6025	+	280	P11137-1#47	0	3	ENST00000704357.1	2683	2686	+	3	0	0	6534
P11137-1#47	0	3	3	P11137-1	2232	2235	+	3	P11137-1	0	5481	ENST00000682079.1	451	5932	++	275	P11137-1#47	0	3	ENST00000682079.1	2683	2686	+	3	0	0	6535
P11137-1#47	0	3	3	P11137-1	2232	2235	+	3	P11137-1	0	5481	ENST00000673860.1	318	6288	+	238	P11137-1#47	0	3	ENST00000673860.1	3039	3042	+	3	0	0	6536
P11137-1#47	0	3	3	P11137-1	2232	2235	+	3	P11137-1	0	5481	ENST00000447185.5	0	5469	++	97	P11137-1#47	0	3	ENST00000447185.5	2220	2223	+	3	0	0	6537
P11137-1#47	0	3	3	P11137-1	2232	2235	+	3	P11137-1	0	5481	ENST00000360351.8	506	5987	++	38	P11137-1#47	0	3	ENST00000360351.8	2738	2741	+	3	0	0	6538
P11137-1#48	0	3	3	P11137-1	2460	2463	+	3	P11137-1	0	5481	ENST00000704357.1	451	6025	+	280	P11137-1#48	0	3	ENST00000704357.1	2911	2914	+	3	0	0	6539
P11137-1#48	0	3	3	P11137-1	2460	2463	+	3	P11137-1	0	5481	ENST00000682079.1	451	5932	++	275	P11137-1#48	0	3	ENST00000682079.1	2911	2914	+	3	0	0	6540
P11137-1#48	0	3	3	P11137-1	2460	2463	+	3	P11137-1	0	5481	ENST00000673860.1	318	6288	+	238	P11137-1#48	0	3	ENST00000673860.1	3267	3270	+	3	0	0	6541
P11137-1#48	0	3	3	P11137-1	2460	2463	+	3	P11137-1	0	5481	ENST00000447185.5	0	5469	++	97	P11137-1#48	0	3	ENST00000447185.5	2448	2451	+	3	0	0	6542
P11137-1#48	0	3	3	P11137-1	2460	2463	+	3	P11137-1	0	5481	ENST00000360351.8	506	5987	++	38	P11137-1#48	0	3	ENST00000360351.8	2966	2969	+	3	0	0	6543
P11137-1#49	0	3	3	P11137-1	2640	2643	+	3	P11137-1	0	5481	ENST00000704357.1	451	6025	+	280	P11137-1#49	0	3	ENST00000704357.1	3091	3094	+	3	0	0	6544
P11137-1#49	0	3	3	P11137-1	2640	2643	+	3	P11137-1	0	5481	ENST00000682079.1	451	5932	++	275	P11137-1#49	0	3	ENST00000682079.1	3091	3094	+	3	0	0	6545
P11137-1#49	0	3	3	P11137-1	2640	2643	+	3	P11137-1	0	5481	ENST00000673860.1	318	6288	+	238	P11137-1#49	0	3	ENST00000673860.1	3447	3450	+	3	0	0	6546
P11137-1#49	0	3	3	P11137-1	2640	2643	+	3	P11137-1	0	5481	ENST00000447185.5	0	5469	++	97	P11137-1#49	0	3	ENST00000447185.5	2628	2631	+	3	0	0	6547
P11137-1#49	0	3	3	P11137-1	2640	2643	+	3	P11137-1	0	5481	ENST00000360351.8	506	5987	++	38	P11137-1#49	0	3	ENST00000360351.8	3146	3149	+	3	0	0	6548
P11137-1#50	0	3	3	P11137-1	2667	2670	+	3	P11137-1	0	5481	ENST00000704357.1	451	6025	+	280	P11137-1#50	0	3	ENST00000704357.1	3118	3121	+	3	0	0	6549
P11137-1#50	0	3	3	P11137-1	2667	2670	+	3	P11137-1	0	5481	ENST00000682079.1	451	5932	++	275	P11137-1#50	0	3	ENST00000682079.1	3118	3121	+	3	0	0	6550
P11137-1#50	0	3	3	P11137-1	2667	2670	+	3	P11137-1	0	5481	ENST00000673860.1	318	6288	+	238	P11137-1#50	0	3	ENST00000673860.1	3474	3477	+	3	0	0	6551
P11137-1#50	0	3	3	P11137-1	2667	2670	+	3	P11137-1	0	5481	ENST00000447185.5	0	5469	++	97	P11137-1#50	0	3	ENST00000447185.5	2655	2658	+	3	0	0	6552
P11137-1#50	0	3	3	P11137-1	2667	2670	+	3	P11137-1	0	5481	ENST00000360351.8	506	5987	++	38	P11137-1#50	0	3	ENST00000360351.8	3173	3176	+	3	0	0	6553
P11137-1#51	0	3	3	P11137-1	2805	2808	+	3	P11137-1	0	5481	ENST00000704357.1	451	6025	+	280	P11137-1#51	0	3	ENST00000704357.1	3256	3259	+	3	0	0	6554
P11137-1#51	0	3	3	P11137-1	2805	2808	+	3	P11137-1	0	5481	ENST00000682079.1	451	5932	++	275	P11137-1#51	0	3	ENST00000682079.1	3256	3259	+	3	0	0	6555
P11137-1#51	0	3	3	P11137-1	2805	2808	+	3	P11137-1	0	5481	ENST00000673860.1	318	6288	+	238	P11137-1#51	0	3	ENST00000673860.1	3612	3615	+	3	0	0	6556
P11137-1#51	0	3	3	P11137-1	2805	2808	+	3	P11137-1	0	5481	ENST00000447185.5	0	5469	++	97	P11137-1#51	0	3	ENST00000447185.5	2793	2796	+	3	0	0	6557
P11137-1#51	0	3	3	P11137-1	2805	2808	+	3	P11137-1	0	5481	ENST00000360351.8	506	5987	++	38	P11137-1#51	0	3	ENST00000360351.8	3311	3314	+	3	0	0	6558
P11137-1#52	0	3	3	P11137-1	3396	3399	+	3	P11137-1	0	5481	ENST00000704357.1	451	6025	+	280	P11137-1#52	0	3	ENST00000704357.1	3847	3850	+	3	0	0	6559
P11137-1#52	0	3	3	P11137-1	3396	3399	+	3	P11137-1	0	5481	ENST00000682079.1	451	5932	++	275	P11137-1#52	0	3	ENST00000682079.1	3847	3850	+	3	0	0	6560
P11137-1#52	0	3	3	P11137-1	3396	3399	+	3	P11137-1	0	5481	ENST00000673860.1	318	6288	+	238	P11137-1#52	0	3	ENST00000673860.1	4203	4206	+	3	0	0	6561
P11137-1#52	0	3	3	P11137-1	3396	3399	+	3	P11137-1	0	5481	ENST00000447185.5	0	5469	++	97	P11137-1#52	0	3	ENST00000447185.5	3384	3387	+	3	0	0	6562
P11137-1#52	0	3	3	P11137-1	3396	3399	+	3	P11137-1	0	5481	ENST00000360351.8	506	5987	++	38	P11137-1#52	0	3	ENST00000360351.8	3902	3905	+	3	0	0	6563
P11137-1#53	0	3	3	P11137-1	3399	3402	+	3	P11137-1	0	5481	ENST00000704357.1	451	6025	+	280	P11137-1#53	0	3	ENST00000704357.1	3850	3853	+	3	0	0	6564
P11137-1#53	0	3	3	P11137-1	3399	3402	+	3	P11137-1	0	5481	ENST00000682079.1	451	5932	++	275	P11137-1#53	0	3	ENST00000682079.1	3850	3853	+	3	0	0	6565
P11137-1#53	0	3	3	P11137-1	3399	3402	+	3	P11137-1	0	5481	ENST00000673860.1	318	6288	+	238	P11137-1#53	0	3	ENST00000673860.1	4206	4209	+	3	0	0	6566
P11137-1#53	0	3	3	P11137-1	3399	3402	+	3	P11137-1	0	5481	ENST00000447185.5	0	5469	++	97	P11137-1#53	0	3	ENST00000447185.5	3387	3390	+	3	0	0	6567
P11137-1#53	0	3	3	P11137-1	3399	3402	+	3	P11137-1	0	5481	ENST00000360351.8	506	5987	++	38	P11137-1#53	0	3	ENST00000360351.8	3905	3908	+	3	0	0	6568
P11137-1#54	0	3	3	P11137-1	3414	3417	+	3	P11137-1	0	5481	ENST00000704357.1	451	6025	+	280	P11137-1#54	0	3	ENST00000704357.1	3865	3868	+	3	0	0	6569
P11137-1#54	0	3	3	P11137-1	3414	3417	+	3	P11137-1	0	5481	ENST00000682079.1	451	5932	++	275	P11137-1#54	0	3	ENST00000682079.1	3865	3868	+	3	0	0	6570
P11137-1#54	0	3	3	P11137-1	3414	3417	+	3	P11137-1	0	5481	ENST00000673860.1	318	6288	+	238	P11137-1#54	0	3	ENST00000673860.1	4221	4224	+	3	0	0	6571
P11137-1#54	0	3	3	P11137-1	3414	3417	+	3	P11137-1	0	5481	ENST00000447185.5	0	5469	++	97	P11137-1#54	0	3	ENST00000447185.5	3402	3405	+	3	0	0	6572
P11137-1#54	0	3	3	P11137-1	3414	3417	+	3	P11137-1	0	5481	ENST00000360351.8	506	5987	++	38	P11137-1#54	0	3	ENST00000360351.8	3920	3923	+	3	0	0	6573
P11137-1#55	0	3	3	P11137-1	3459	3462	+	3	P11137-1	0	5481	ENST00000704357.1	451	6025	+	280	P11137-1#55	0	3	ENST00000704357.1	3910	3913	+	3	0	0	6574
P11137-1#55	0	3	3	P11137-1	3459	3462	+	3	P11137-1	0	5481	ENST00000682079.1	451	5932	++	275	P11137-1#55	0	3	ENST00000682079.1	3910	3913	+	3	0	0	6575
P11137-1#55	0	3	3	P11137-1	3459	3462	+	3	P11137-1	0	5481	ENST00000673860.1	318	6288	+	238	P11137-1#55	0	3	ENST00000673860.1	4266	4269	+	3	0	0	6576
P11137-1#55	0	3	3	P11137-1	3459	3462	+	3	P11137-1	0	5481	ENST00000447185.5	0	5469	++	97	P11137-1#55	0	3	ENST00000447185.5	3447	3450	+	3	0	0	6577
P11137-1#55	0	3	3	P11137-1	3459	3462	+	3	P11137-1	0	5481	ENST00000360351.8	506	5987	++	38	P11137-1#55	0	3	ENST00000360351.8	3965	3968	+	3	0	0	6578
P11137-1#56	0	3	3	P11137-1	3462	3465	+	3	P11137-1	0	5481	ENST00000704357.1	451	6025	+	280	P11137-1#56	0	3	ENST00000704357.1	3913	3916	+	3	0	0	6579
P11137-1#56	0	3	3	P11137-1	3462	3465	+	3	P11137-1	0	5481	ENST00000682079.1	451	5932	++	275	P11137-1#56	0	3	ENST00000682079.1	3913	3916	+	3	0	0	6580
P11137-1#56	0	3	3	P11137-1	3462	3465	+	3	P11137-1	0	5481	ENST00000673860.1	318	6288	+	238	P11137-1#56	0	3	ENST00000673860.1	4269	4272	+	3	0	0	6581
P11137-1#56	0	3	3	P11137-1	3462	3465	+	3	P11137-1	0	5481	ENST00000447185.5	0	5469	++	97	P11137-1#56	0	3	ENST00000447185.5	3450	3453	+	3	0	0	6582
P11137-1#56	0	3	3	P11137-1	3462	3465	+	3	P11137-1	0	5481	ENST00000360351.8	506	5987	++	38	P11137-1#56	0	3	ENST00000360351.8	3968	3971	+	3	0	0	6583
P11137-1#57	0	3	3	P11137-1	3474	3477	+	3	P11137-1	0	5481	ENST00000704357.1	451	6025	+	280	P11137-1#57	0	3	ENST00000704357.1	3925	3928	+	3	0	0	6584
P11137-1#57	0	3	3	P11137-1	3474	3477	+	3	P11137-1	0	5481	ENST00000682079.1	451	5932	++	275	P11137-1#57	0	3	ENST00000682079.1	3925	3928	+	3	0	0	6585
P11137-1#57	0	3	3	P11137-1	3474	3477	+	3	P11137-1	0	5481	ENST00000673860.1	318	6288	+	238	P11137-1#57	0	3	ENST00000673860.1	4281	4284	+	3	0	0	6586
P11137-1#57	0	3	3	P11137-1	3474	3477	+	3	P11137-1	0	5481	ENST00000447185.5	0	5469	++	97	P11137-1#57	0	3	ENST00000447185.5	3462	3465	+	3	0	0	6587
P11137-1#57	0	3	3	P11137-1	3474	3477	+	3	P11137-1	0	5481	ENST00000360351.8	506	5987	++	38	P11137-1#57	0	3	ENST00000360351.8	3980	3983	+	3	0	0	6588
P11137-1#58	0	3	3	P11137-1	4038	4041	+	3	P11137-1	0	5481	ENST00000704357.1	451	6025	+	280	P11137-1#58	0	3	ENST00000704357.1	4489	4492	+	3	0	0	6589
P11137-1#58	0	3	3	P11137-1	4038	4041	+	3	P11137-1	0	5481	ENST00000682079.1	451	5932	++	275	P11137-1#58	0	3	ENST00000682079.1	4489	4492	+	3	0	0	6590
P11137-1#58	0	3	3	P11137-1	4038	4041	+	3	P11137-1	0	5481	ENST00000673860.1	318	6288	+	238	P11137-1#58	0	3	ENST00000673860.1	4845	4848	+	3	0	0	6591
P11137-1#58	0	3	3	P11137-1	4038	4041	+	3	P11137-1	0	5481	ENST00000447185.5	0	5469	++	97	P11137-1#58	0	3	ENST00000447185.5	4026	4029	+	3	0	0	6592
P11137-1#58	0	3	3	P11137-1	4038	4041	+	3	P11137-1	0	5481	ENST00000360351.8	506	5987	++	38	P11137-1#58	0	3	ENST00000360351.8	4544	4547	+	3	0	0	6593
P11137-1#59	0	3	3	P11137-1	4056	4059	+	3	P11137-1	0	5481	ENST00000704357.1	451	6025	+	280	P11137-1#59	0	3	ENST00000704357.1	4507	4510	+	3	0	0	6594
P11137-1#59	0	3	3	P11137-1	4056	4059	+	3	P11137-1	0	5481	ENST00000682079.1	451	5932	++	275	P11137-1#59	0	3	ENST00000682079.1	4507	4510	+	3	0	0	6595
P11137-1#59	0	3	3	P11137-1	4056	4059	+	3	P11137-1	0	5481	ENST00000673860.1	318	6288	+	238	P11137-1#59	0	3	ENST00000673860.1	4863	4866	+	3	0	0	6596
P11137-1#59	0	3	3	P11137-1	4056	4059	+	3	P11137-1	0	5481	ENST00000447185.5	0	5469	++	97	P11137-1#59	0	3	ENST00000447185.5	4044	4047	+	3	0	0	6597
P11137-1#59	0	3	3	P11137-1	4056	4059	+	3	P11137-1	0	5481	ENST00000360351.8	506	5987	++	38	P11137-1#59	0	3	ENST00000360351.8	4562	4565	+	3	0	0	6598
P11137-1#60	0	3	3	P11137-1	4599	4602	+	3	P11137-1	0	5481	ENST00000704357.1	451	6025	+	280	P11137-1#60	0	3	ENST00000704357.1	5050	5053	+	3	0	0	6599
P11137-1#60	0	3	3	P11137-1	4599	4602	+	3	P11137-1	0	5481	ENST00000682079.1	451	5932	++	275	P11137-1#60	0	3	ENST00000682079.1	5050	5053	+	3	0	0	6600
P11137-1#60	0	3	3	P11137-1	4599	4602	+	3	P11137-1	0	5481	ENST00000673860.1	318	6288	+	238	P11137-1#60	0	3	ENST00000673860.1	5406	5409	+	3	0	0	6601
P11137-1#60	0	3	3	P11137-1	4599	4602	+	3	P11137-1	222	4695	ENST00000452717.1	0	624	+	101	P11137-1#60	0	3	ENST00000452717.1	528	531	+	3	0	0	6602
P11137-1#60	0	3	3	P11137-1	4599	4602	+	3	P11137-1	0	5481	ENST00000447185.5	0	5469	++	97	P11137-1#60	0	3	ENST00000447185.5	4587	4590	+	3	0	0	6603
P11137-1#60	0	3	3	P11137-1	4599	4602	+	3	P11137-1	4521	5481	ENST00000392194.5	619	1579	++	61	P11137-1#60	0	3	ENST00000392194.5	697	700	+	3	0	0	6604
P11137-1#60	0	3	3	P11137-1	4599	4602	+	3	P11137-1	4521	5481	ENST00000361559.8	949	1909	++	40	P11137-1#60	0	3	ENST00000361559.8	1027	1030	+	3	0	0	6605
P11137-1#60	0	3	3	P11137-1	4599	4602	+	3	P11137-1	0	5481	ENST00000360351.8	506	5987	++	38	P11137-1#60	0	3	ENST00000360351.8	5105	5108	+	3	0	0	6606
P11137-1#61	0	3	3	P11137-1	4662	4665	+	3	P11137-1	0	5481	ENST00000704357.1	451	6025	+	280	P11137-1#61	0	3	ENST00000704357.1	5113	5116	+	3	0	0	6607
P11137-1#61	0	3	3	P11137-1	4662	4665	+	3	P11137-1	0	5481	ENST00000682079.1	451	5932	++	275	P11137-1#61	0	3	ENST00000682079.1	5113	5116	+	3	0	0	6608
P11137-1#61	0	3	3	P11137-1	4662	4665	+	3	P11137-1	0	5481	ENST00000673860.1	318	6288	+	238	P11137-1#61	0	3	ENST00000673860.1	5469	5472	+	3	0	0	6609
P11137-1#61	0	3	3	P11137-1	4662	4665	+	3	P11137-1	222	4695	ENST00000452717.1	0	624	+	101	P11137-1#61	0	3	ENST00000452717.1	591	594	+	3	0	0	6610
P11137-1#61	0	3	3	P11137-1	4662	4665	+	3	P11137-1	0	5481	ENST00000447185.5	0	5469	++	97	P11137-1#61	0	3	ENST00000447185.5	4650	4653	+	3	0	0	6611
P11137-1#61	0	3	3	P11137-1	4662	4665	+	3	P11137-1	4521	5481	ENST00000392194.5	619	1579	++	61	P11137-1#61	0	3	ENST00000392194.5	760	763	+	3	0	0	6612
P11137-1#61	0	3	3	P11137-1	4662	4665	+	3	P11137-1	4521	5481	ENST00000361559.8	949	1909	++	40	P11137-1#61	0	3	ENST00000361559.8	1090	1093	+	3	0	0	6613
P11137-1#61	0	3	3	P11137-1	4662	4665	+	3	P11137-1	0	5481	ENST00000360351.8	506	5987	++	38	P11137-1#61	0	3	ENST00000360351.8	5168	5171	+	3	0	0	6614
P11137-1#62	0	3	3	P11137-1	4761	4764	+	3	P11137-1	0	5481	ENST00000704357.1	451	6025	+	280	P11137-1#62	0	3	ENST00000704357.1	5212	5215	+	3	0	0	6615
P11137-1#62	0	3	3	P11137-1	4761	4764	+	3	P11137-1	0	5481	ENST00000682079.1	451	5932	++	275	P11137-1#62	0	3	ENST00000682079.1	5212	5215	+	3	0	0	6616
P11137-1#62	0	3	3	P11137-1	4761	4764	+	3	P11137-1	0	5481	ENST00000673860.1	318	6288	+	238	P11137-1#62	0	3	ENST00000673860.1	5568	5571	+	3	0	0	6617
P11137-1#62	0	3	3	P11137-1	4761	4764	+	3	P11137-1	0	5481	ENST00000447185.5	0	5469	++	97	P11137-1#62	0	3	ENST00000447185.5	4749	4752	+	3	0	0	6618
P11137-1#62	0	3	3	P11137-1	4761	4764	+	3	P11137-1	4521	5481	ENST00000392194.5	619	1579	++	61	P11137-1#62	0	3	ENST00000392194.5	859	862	+	3	0	0	6619
P11137-1#62	0	3	3	P11137-1	4761	4764	+	3	P11137-1	4521	5481	ENST00000361559.8	949	1909	++	40	P11137-1#62	0	3	ENST00000361559.8	1189	1192	+	3	0	0	6620
P11137-1#62	0	3	3	P11137-1	4761	4764	+	3	P11137-1	0	5481	ENST00000360351.8	506	5987	++	38	P11137-1#62	0	3	ENST00000360351.8	5267	5270	+	3	0	0	6621
P11137-1#63	0	3	3	P11137-1	4803	4806	+	3	P11137-1	0	5481	ENST00000704357.1	451	6025	+	280	P11137-1#63	0	3	ENST00000704357.1	5254	5257	+	3	0	0	6622
P11137-1#63	0	3	3	P11137-1	4803	4806	+	3	P11137-1	0	5481	ENST00000682079.1	451	5932	++	275	P11137-1#63	0	3	ENST00000682079.1	5254	5257	+	3	0	0	6623
P11137-1#63	0	3	3	P11137-1	4803	4806	+	3	P11137-1	0	5481	ENST00000673860.1	318	6288	+	238	P11137-1#63	0	3	ENST00000673860.1	5610	5613	+	3	0	0	6624
P11137-1#63	0	3	3	P11137-1	4803	4806	+	3	P11137-1	0	5481	ENST00000447185.5	0	5469	++	97	P11137-1#63	0	3	ENST00000447185.5	4791	4794	+	3	0	0	6625
P11137-1#63	0	3	3	P11137-1	4803	4806	+	3	P11137-1	4521	5481	ENST00000392194.5	619	1579	++	61	P11137-1#63	0	3	ENST00000392194.5	901	904	+	3	0	0	6626
P11137-1#63	0	3	3	P11137-1	4803	4806	+	3	P11137-1	4521	5481	ENST00000361559.8	949	1909	++	40	P11137-1#63	0	3	ENST00000361559.8	1231	1234	+	3	0	0	6627
P11137-1#63	0	3	3	P11137-1	4803	4806	+	3	P11137-1	0	5481	ENST00000360351.8	506	5987	++	38	P11137-1#63	0	3	ENST00000360351.8	5309	5312	+	3	0	0	6628
P11137-1#64	0	3	3	P11137-1	4812	4815	+	3	P11137-1	0	5481	ENST00000704357.1	451	6025	+	280	P11137-1#64	0	3	ENST00000704357.1	5263	5266	+	3	0	0	6629
P11137-1#64	0	3	3	P11137-1	4812	4815	+	3	P11137-1	0	5481	ENST00000682079.1	451	5932	++	275	P11137-1#64	0	3	ENST00000682079.1	5263	5266	+	3	0	0	6630
P11137-1#64	0	3	3	P11137-1	4812	4815	+	3	P11137-1	0	5481	ENST00000673860.1	318	6288	+	238	P11137-1#64	0	3	ENST00000673860.1	5619	5622	+	3	0	0	6631
P11137-1#64	0	3	3	P11137-1	4812	4815	+	3	P11137-1	0	5481	ENST00000447185.5	0	5469	++	97	P11137-1#64	0	3	ENST00000447185.5	4800	4803	+	3	0	0	6632
P11137-1#64	0	3	3	P11137-1	4812	4815	+	3	P11137-1	4521	5481	ENST00000392194.5	619	1579	++	61	P11137-1#64	0	3	ENST00000392194.5	910	913	+	3	0	0	6633
P11137-1#64	0	3	3	P11137-1	4812	4815	+	3	P11137-1	4521	5481	ENST00000361559.8	949	1909	++	40	P11137-1#64	0	3	ENST00000361559.8	1240	1243	+	3	0	0	6634
P11137-1#64	0	3	3	P11137-1	4812	4815	+	3	P11137-1	0	5481	ENST00000360351.8	506	5987	++	38	P11137-1#64	0	3	ENST00000360351.8	5318	5321	+	3	0	0	6635
P11137-1#65	0	3	3	P11137-1	4845	4848	+	3	P11137-1	0	5481	ENST00000704357.1	451	6025	+	280	P11137-1#65	0	3	ENST00000704357.1	5296	5299	+	3	0	0	6636
P11137-1#65	0	3	3	P11137-1	4845	4848	+	3	P11137-1	0	5481	ENST00000682079.1	451	5932	++	275	P11137-1#65	0	3	ENST00000682079.1	5296	5299	+	3	0	0	6637
P11137-1#65	0	3	3	P11137-1	4845	4848	+	3	P11137-1	0	5481	ENST00000673860.1	318	6288	+	238	P11137-1#65	0	3	ENST00000673860.1	5652	5655	+	3	0	0	6638
P11137-1#65	0	3	3	P11137-1	4845	4848	+	3	P11137-1	0	5481	ENST00000447185.5	0	5469	++	97	P11137-1#65	0	3	ENST00000447185.5	4833	4836	+	3	0	0	6639
P11137-1#65	0	3	3	P11137-1	4845	4848	+	3	P11137-1	4521	5481	ENST00000392194.5	619	1579	++	61	P11137-1#65	0	3	ENST00000392194.5	943	946	+	3	0	0	6640
P11137-1#65	0	3	3	P11137-1	4845	4848	+	3	P11137-1	4521	5481	ENST00000361559.8	949	1909	++	40	P11137-1#65	0	3	ENST00000361559.8	1273	1276	+	3	0	0	6641
P11137-1#65	0	3	3	P11137-1	4845	4848	+	3	P11137-1	0	5481	ENST00000360351.8	506	5987	++	38	P11137-1#65	0	3	ENST00000360351.8	5351	5354	+	3	0	0	6642
P11137-1#66	0	3	3	P11137-1	4854	4857	+	3	P11137-1	0	5481	ENST00000704357.1	451	6025	+	280	P11137-1#66	0	3	ENST00000704357.1	5305	5308	+	3	0	0	6643
P11137-1#66	0	3	3	P11137-1	4854	4857	+	3	P11137-1	0	5481	ENST00000682079.1	451	5932	++	275	P11137-1#66	0	3	ENST00000682079.1	5305	5308	+	3	0	0	6644
P11137-1#66	0	3	3	P11137-1	4854	4857	+	3	P11137-1	0	5481	ENST00000673860.1	318	6288	+	238	P11137-1#66	0	3	ENST00000673860.1	5661	5664	+	3	0	0	6645
P11137-1#66	0	3	3	P11137-1	4854	4857	+	3	P11137-1	0	5481	ENST00000447185.5	0	5469	++	97	P11137-1#66	0	3	ENST00000447185.5	4842	4845	+	3	0	0	6646
P11137-1#66	0	3	3	P11137-1	4854	4857	+	3	P11137-1	4521	5481	ENST00000392194.5	619	1579	++	61	P11137-1#66	0	3	ENST00000392194.5	952	955	+	3	0	0	6647
P11137-1#66	0	3	3	P11137-1	4854	4857	+	3	P11137-1	4521	5481	ENST00000361559.8	949	1909	++	40	P11137-1#66	0	3	ENST00000361559.8	1282	1285	+	3	0	0	6648
P11137-1#66	0	3	3	P11137-1	4854	4857	+	3	P11137-1	0	5481	ENST00000360351.8	506	5987	++	38	P11137-1#66	0	3	ENST00000360351.8	5360	5363	+	3	0	0	6649
P11137-1#67	0	3	3	P11137-1	4944	4947	+	3	P11137-1	0	5481	ENST00000704357.1	451	6025	+	280	P11137-1#67	0	3	ENST00000704357.1	5395	5398	+	3	0	0	6650
P11137-1#67	0	3	3	P11137-1	4944	4947	+	3	P11137-1	0	5481	ENST00000682079.1	451	5932	++	275	P11137-1#67	0	3	ENST00000682079.1	5395	5398	+	3	0	0	6651
P11137-1#67	0	3	3	P11137-1	4944	4947	+	3	P11137-1	0	5481	ENST00000673860.1	318	6288	+	238	P11137-1#67	0	3	ENST00000673860.1	5751	5754	+	3	0	0	6652
P11137-1#67	0	3	3	P11137-1	4944	4947	+	3	P11137-1	0	5481	ENST00000447185.5	0	5469	++	97	P11137-1#67	0	3	ENST00000447185.5	4932	4935	+	3	0	0	6653
P11137-1#67	0	3	3	P11137-1	4944	4947	+	3	P11137-1	4521	5481	ENST00000392194.5	619	1579	++	61	P11137-1#67	0	3	ENST00000392194.5	1042	1045	+	3	0	0	6654
P11137-1#67	0	3	3	P11137-1	4944	4947	+	3	P11137-1	4521	5481	ENST00000361559.8	949	1909	++	40	P11137-1#67	0	3	ENST00000361559.8	1372	1375	+	3	0	0	6655
P11137-1#67	0	3	3	P11137-1	4944	4947	+	3	P11137-1	0	5481	ENST00000360351.8	506	5987	++	38	P11137-1#67	0	3	ENST00000360351.8	5450	5453	+	3	0	0	6656
P11137-1#68	0	3	3	P11137-1	4956	4959	+	3	P11137-1	0	5481	ENST00000704357.1	451	6025	+	280	P11137-1#68	0	3	ENST00000704357.1	5407	5410	+	3	0	0	6657
P11137-1#68	0	3	3	P11137-1	4956	4959	+	3	P11137-1	0	5481	ENST00000682079.1	451	5932	++	275	P11137-1#68	0	3	ENST00000682079.1	5407	5410	+	3	0	0	6658
P11137-1#68	0	3	3	P11137-1	4956	4959	+	3	P11137-1	0	5481	ENST00000673860.1	318	6288	+	238	P11137-1#68	0	3	ENST00000673860.1	5763	5766	+	3	0	0	6659
P11137-1#68	0	3	3	P11137-1	4956	4959	+	3	P11137-1	0	5481	ENST00000447185.5	0	5469	++	97	P11137-1#68	0	3	ENST00000447185.5	4944	4947	+	3	0	0	6660
P11137-1#68	0	3	3	P11137-1	4956	4959	+	3	P11137-1	4521	5481	ENST00000392194.5	619	1579	++	61	P11137-1#68	0	3	ENST00000392194.5	1054	1057	+	3	0	0	6661
P11137-1#68	0	3	3	P11137-1	4956	4959	+	3	P11137-1	4521	5481	ENST00000361559.8	949	1909	++	40	P11137-1#68	0	3	ENST00000361559.8	1384	1387	+	3	0	0	6662
P11137-1#68	0	3	3	P11137-1	4956	4959	+	3	P11137-1	0	5481	ENST00000360351.8	506	5987	++	38	P11137-1#68	0	3	ENST00000360351.8	5462	5465	+	3	0	0	6663
P11137-1#69	0	3	3	P11137-1	5034	5037	+	3	P11137-1	0	5481	ENST00000704357.1	451	6025	+	280	P11137-1#69	0	3	ENST00000704357.1	5485	5488	+	3	0	0	6664
P11137-1#69	0	3	3	P11137-1	5034	5037	+	3	P11137-1	0	5481	ENST00000682079.1	451	5932	++	275	P11137-1#69	0	3	ENST00000682079.1	5485	5488	+	3	0	0	6665
P11137-1#69	0	3	3	P11137-1	5034	5037	+	3	P11137-1	0	5481	ENST00000673860.1	318	6288	+	238	P11137-1#69	0	3	ENST00000673860.1	5841	5844	+	3	0	0	6666
P11137-1#69	0	3	3	P11137-1	5034	5037	+	3	P11137-1	0	5481	ENST00000447185.5	0	5469	++	97	P11137-1#69	0	3	ENST00000447185.5	5022	5025	+	3	0	0	6667
P11137-1#69	0	3	3	P11137-1	5034	5037	+	3	P11137-1	4521	5481	ENST00000392194.5	619	1579	++	61	P11137-1#69	0	3	ENST00000392194.5	1132	1135	+	3	0	0	6668
P11137-1#69	0	3	3	P11137-1	5034	5037	+	3	P11137-1	4521	5481	ENST00000361559.8	949	1909	++	40	P11137-1#69	0	3	ENST00000361559.8	1462	1465	+	3	0	0	6669
P11137-1#69	0	3	3	P11137-1	5034	5037	+	3	P11137-1	0	5481	ENST00000360351.8	506	5987	++	38	P11137-1#69	0	3	ENST00000360351.8	5540	5543	+	3	0	0	6670
P11137-1#70	0	3	3	P11137-1	5343	5346	+	3	P11137-1	0	5481	ENST00000704357.1	451	6025	+	280	P11137-1#70	0	3	ENST00000704357.1	5887	5890	+	3	0	0	6671
P11137-1#70	0	3	3	P11137-1	5343	5346	+	3	P11137-1	0	5481	ENST00000682079.1	451	5932	++	275	P11137-1#70	0	3	ENST00000682079.1	5794	5797	+	3	0	0	6672
P11137-1#70	0	3	3	P11137-1	5343	5346	+	3	P11137-1	0	5481	ENST00000673860.1	318	6288	+	238	P11137-1#70	0	3	ENST00000673860.1	6150	6153	+	3	0	0	6673
P11137-1#70	0	3	3	P11137-1	5343	5346	+	3	P11137-1	0	5481	ENST00000447185.5	0	5469	++	97	P11137-1#70	0	3	ENST00000447185.5	5331	5334	+	3	0	0	6674
P11137-1#70	0	3	3	P11137-1	5343	5346	+	3	P11137-1	4521	5481	ENST00000392194.5	619	1579	++	61	P11137-1#70	0	3	ENST00000392194.5	1441	1444	+	3	0	0	6675
P11137-1#70	0	3	3	P11137-1	5343	5346	+	3	P11137-1	4521	5481	ENST00000361559.8	949	1909	++	40	P11137-1#70	0	3	ENST00000361559.8	1771	1774	+	3	0	0	6676
P11137-1#70	0	3	3	P11137-1	5343	5346	+	3	P11137-1	0	5481	ENST00000360351.8	506	5987	++	38	P11137-1#70	0	3	ENST00000360351.8	5849	5852	+	3	0	0	6677
P11137-1#71	0	3	3	P11137-1	5358	5361	+	3	P11137-1	0	5481	ENST00000704357.1	451	6025	+	280	P11137-1#71	0	3	ENST00000704357.1	5902	5905	+	3	0	0	6678
P11137-1#71	0	3	3	P11137-1	5358	5361	+	3	P11137-1	0	5481	ENST00000682079.1	451	5932	++	275	P11137-1#71	0	3	ENST00000682079.1	5809	5812	+	3	0	0	6679
P11137-1#71	0	3	3	P11137-1	5358	5361	+	3	P11137-1	0	5481	ENST00000673860.1	318	6288	+	238	P11137-1#71	0	3	ENST00000673860.1	6165	6168	+	3	0	0	6680
P11137-1#71	0	3	3	P11137-1	5358	5361	+	3	P11137-1	0	5481	ENST00000447185.5	0	5469	++	97	P11137-1#71	0	3	ENST00000447185.5	5346	5349	+	3	0	0	6681
P11137-1#71	0	3	3	P11137-1	5358	5361	+	3	P11137-1	4521	5481	ENST00000392194.5	619	1579	++	61	P11137-1#71	0	3	ENST00000392194.5	1456	1459	+	3	0	0	6682
P11137-1#71	0	3	3	P11137-1	5358	5361	+	3	P11137-1	4521	5481	ENST00000361559.8	949	1909	++	40	P11137-1#71	0	3	ENST00000361559.8	1786	1789	+	3	0	0	6683
P11137-1#71	0	3	3	P11137-1	5358	5361	+	3	P11137-1	0	5481	ENST00000360351.8	506	5987	++	38	P11137-1#71	0	3	ENST00000360351.8	5864	5867	+	3	0	0	6684
P11137-1#72	0	3	3	P11137-1	5367	5370	+	3	P11137-1	0	5481	ENST00000704357.1	451	6025	+	280	P11137-1#72	0	3	ENST00000704357.1	5911	5914	+	3	0	0	6685
P11137-1#72	0	3	3	P11137-1	5367	5370	+	3	P11137-1	0	5481	ENST00000682079.1	451	5932	++	275	P11137-1#72	0	3	ENST00000682079.1	5818	5821	+	3	0	0	6686
P11137-1#72	0	3	3	P11137-1	5367	5370	+	3	P11137-1	0	5481	ENST00000673860.1	318	6288	+	238	P11137-1#72	0	3	ENST00000673860.1	6174	6177	+	3	0	0	6687
P11137-1#72	0	3	3	P11137-1	5367	5370	+	3	P11137-1	0	5481	ENST00000447185.5	0	5469	++	97	P11137-1#72	0	3	ENST00000447185.5	5355	5358	+	3	0	0	6688
P11137-1#72	0	3	3	P11137-1	5367	5370	+	3	P11137-1	4521	5481	ENST00000392194.5	619	1579	++	61	P11137-1#72	0	3	ENST00000392194.5	1465	1468	+	3	0	0	6689
P11137-1#72	0	3	3	P11137-1	5367	5370	+	3	P11137-1	4521	5481	ENST00000361559.8	949	1909	++	40	P11137-1#72	0	3	ENST00000361559.8	1795	1798	+	3	0	0	6690
P11137-1#72	0	3	3	P11137-1	5367	5370	+	3	P11137-1	0	5481	ENST00000360351.8	506	5987	++	38	P11137-1#72	0	3	ENST00000360351.8	5873	5876	+	3	0	0	6691
P11137-1#73	0	3	3	P11137-1	5382	5385	+	3	P11137-1	0	5481	ENST00000704357.1	451	6025	+	280	P11137-1#73	0	3	ENST00000704357.1	5926	5929	+	3	0	0	6692
P11137-1#73	0	3	3	P11137-1	5382	5385	+	3	P11137-1	0	5481	ENST00000682079.1	451	5932	++	275	P11137-1#73	0	3	ENST00000682079.1	5833	5836	+	3	0	0	6693
P11137-1#73	0	3	3	P11137-1	5382	5385	+	3	P11137-1	0	5481	ENST00000673860.1	318	6288	+	238	P11137-1#73	0	3	ENST00000673860.1	6189	6192	+	3	0	0	6694
P11137-1#73	0	3	3	P11137-1	5382	5385	+	3	P11137-1	0	5481	ENST00000447185.5	0	5469	++	97	P11137-1#73	0	3	ENST00000447185.5	5370	5373	+	3	0	0	6695
P11137-1#73	0	3	3	P11137-1	5382	5385	+	3	P11137-1	4521	5481	ENST00000392194.5	619	1579	++	61	P11137-1#73	0	3	ENST00000392194.5	1480	1483	+	3	0	0	6696
P11137-1#73	0	3	3	P11137-1	5382	5385	+	3	P11137-1	4521	5481	ENST00000361559.8	949	1909	++	40	P11137-1#73	0	3	ENST00000361559.8	1810	1813	+	3	0	0	6697
P11137-1#73	0	3	3	P11137-1	5382	5385	+	3	P11137-1	0	5481	ENST00000360351.8	506	5987	++	38	P11137-1#73	0	3	ENST00000360351.8	5888	5891	+	3	0	0	6698
P11137-1#74	0	3	3	P11137-1	5421	5424	+	3	P11137-1	0	5481	ENST00000704357.1	451	6025	+	280	P11137-1#74	0	3	ENST00000704357.1	5965	5968	+	3	0	0	6699
P11137-1#74	0	3	3	P11137-1	5421	5424	+	3	P11137-1	0	5481	ENST00000682079.1	451	5932	++	275	P11137-1#74	0	3	ENST00000682079.1	5872	5875	+	3	0	0	6700
P11137-1#74	0	3	3	P11137-1	5421	5424	+	3	P11137-1	0	5481	ENST00000673860.1	318	6288	+	238	P11137-1#74	0	3	ENST00000673860.1	6228	6231	+	3	0	0	6701
P11137-1#74	0	3	3	P11137-1	5421	5424	+	3	P11137-1	0	5481	ENST00000447185.5	0	5469	++	97	P11137-1#74	0	3	ENST00000447185.5	5409	5412	+	3	0	0	6702
P11137-1#74	0	3	3	P11137-1	5421	5424	+	3	P11137-1	4521	5481	ENST00000392194.5	619	1579	++	61	P11137-1#74	0	3	ENST00000392194.5	1519	1522	+	3	0	0	6703
P11137-1#74	0	3	3	P11137-1	5421	5424	+	3	P11137-1	4521	5481	ENST00000361559.8	949	1909	++	40	P11137-1#74	0	3	ENST00000361559.8	1849	1852	+	3	0	0	6704
P11137-1#74	0	3	3	P11137-1	5421	5424	+	3	P11137-1	0	5481	ENST00000360351.8	506	5987	++	38	P11137-1#74	0	3	ENST00000360351.8	5927	5930	+	3	0	0	6705
P11137-1#75	0	4068	4068	P11137-1	453	4521	+	4068	P11137-1	0	5481	ENST00000704357.1	451	6025	+	280	P11137-1#75	0	4068	ENST00000704357.1	904	4972	+	4068	0	0	6706
P11137-1#75	0	4068	4068	P11137-1	453	4521	+	4068	P11137-1	0	5481	ENST00000682079.1	451	5932	++	275	P11137-1#75	0	4068	ENST00000682079.1	904	4972	+	4068	0	0	6707
P11137-1#75	0	4068	4068	P11137-1	453	4521	+	4068	P11137-1	0	5481	ENST00000673860.1	318	6288	+	238	P11137-1#75	0	4068	ENST00000673860.1	771	5328	+	4068	0	0	6708
P11137-1#75	0	4068	4068	P11137-1	453	4521	+	4068	P11137-1	222	4695	ENST00000452717.1	0	624	+	101	P11137-1#75	0	1	ENST00000452717.1	231	232	+	1	0	4067	6709
P11137-1#75	0	4068	4068	P11137-1	453	4521	+	4068	P11137-1	0	5481	ENST00000447185.5	0	5469	++	97	P11137-1#75	12	4068	ENST00000447185.5	453	4509	+	4056	12	0	6710
P11137-1#75	0	4068	4068	P11137-1	453	4521	+	4068	P11137-1	0	1455	ENST00000445941.5	318	2019	+	96	P11137-1#75	0	1002	ENST00000445941.5	771	2019	+	1002	0	3066	6711
P11137-1#75	0	4068	4068	P11137-1	453	4521	+	4068	P11137-1	0	5481	ENST00000360351.8	506	5987	++	38	P11137-1#75	0	4068	ENST00000360351.8	959	5027	+	4068	0	0	6712
P11137-1#76	0	234	234	P11137-1	453	687	+	234	P11137-1	0	5481	ENST00000704357.1	451	6025	+	280	P11137-1#76	0	234	ENST00000704357.1	904	1138	+	234	0	0	6713
P11137-1#76	0	234	234	P11137-1	453	687	+	234	P11137-1	0	5481	ENST00000682079.1	451	5932	++	275	P11137-1#76	0	234	ENST00000682079.1	904	1138	+	234	0	0	6714
P11137-1#76	0	234	234	P11137-1	453	687	+	234	P11137-1	0	5481	ENST00000673860.1	318	6288	+	238	P11137-1#76	0	234	ENST00000673860.1	771	1494	+	234	0	0	6715
P11137-1#76	0	234	234	P11137-1	453	687	+	234	P11137-1	222	4695	ENST00000452717.1	0	624	+	101	P11137-1#76	0	1	ENST00000452717.1	231	232	+	1	0	233	6716
P11137-1#76	0	234	234	P11137-1	453	687	+	234	P11137-1	0	5481	ENST00000447185.5	0	5469	++	97	P11137-1#76	12	234	ENST00000447185.5	453	675	+	222	12	0	6717
P11137-1#76	0	234	234	P11137-1	453	687	+	234	P11137-1	0	1455	ENST00000445941.5	318	2019	+	96	P11137-1#76	0	234	ENST00000445941.5	771	1251	+	234	0	0	6718
P11137-1#76	0	234	234	P11137-1	453	687	+	234	P11137-1	0	5481	ENST00000360351.8	506	5987	++	38	P11137-1#76	0	234	ENST00000360351.8	959	1193	+	234	0	0	6719
P11137-1#77	0	12	12	P11137-1	453	465	+	12	P11137-1	0	5481	ENST00000704357.1	451	6025	+	280	P11137-1#77	0	12	ENST00000704357.1	904	916	+	12	0	0	6720
P11137-1#77	0	12	12	P11137-1	453	465	+	12	P11137-1	0	5481	ENST00000682079.1	451	5932	++	275	P11137-1#77	0	12	ENST00000682079.1	904	916	+	12	0	0	6721
P11137-1#77	0	12	12	P11137-1	453	465	+	12	P11137-1	0	5481	ENST00000673860.1	318	6288	+	238	P11137-1#77	0	12	ENST00000673860.1	771	1272	+	12	0	0	6722
P11137-1#77	0	12	12	P11137-1	453	465	+	12	P11137-1	222	4695	ENST00000452717.1	0	624	+	101	P11137-1#77	0	1	ENST00000452717.1	231	232	+	1	0	11	6723
P11137-1#77	0	12	12	P11137-1	453	465	+	12	P11137-1	0	1455	ENST00000445941.5	318	2019	+	96	P11137-1#77	0	12	ENST00000445941.5	771	1029	+	12	0	0	6724
P11137-1#77	0	12	12	P11137-1	453	465	+	12	P11137-1	0	5481	ENST00000360351.8	506	5987	++	38	P11137-1#77	0	12	ENST00000360351.8	959	971	+	12	0	0	6725
P11137-1#78	0	3897	3897	P11137-1	687	4584	+	3897	P11137-1	0	5481	ENST00000704357.1	451	6025	+	280	P11137-1#78	0	3897	ENST00000704357.1	1138	5035	+	3897	0	0	6726
P11137-1#78	0	3897	3897	P11137-1	687	4584	+	3897	P11137-1	0	5481	ENST00000682079.1	451	5932	++	275	P11137-1#78	0	3897	ENST00000682079.1	1138	5035	+	3897	0	0	6727
P11137-1#78	0	3897	3897	P11137-1	687	4584	+	3897	P11137-1	0	5481	ENST00000673860.1	318	6288	+	238	P11137-1#78	0	3897	ENST00000673860.1	1494	5391	+	3897	0	0	6728
P11137-1#78	0	3897	3897	P11137-1	687	4584	+	3897	P11137-1	222	4695	ENST00000452717.1	0	624	+	101	P11137-1#78	3835	3897	ENST00000452717.1	232	294	+	62	3835	0	6729
P11137-1#78	0	3897	3897	P11137-1	687	4584	+	3897	P11137-1	0	5481	ENST00000447185.5	0	5469	++	97	P11137-1#78	0	3897	ENST00000447185.5	675	4572	+	3897	0	0	6730
P11137-1#78	0	3897	3897	P11137-1	687	4584	+	3897	P11137-1	0	1455	ENST00000445941.5	318	2019	+	96	P11137-1#78	0	768	ENST00000445941.5	1251	2019	+	768	0	3129	6731
P11137-1#78	0	3897	3897	P11137-1	687	4584	+	3897	P11137-1	4521	5481	ENST00000392194.5	619	1579	++	61	P11137-1#78	3834	3897	ENST00000392194.5	619	682	+	63	3834	0	6732
P11137-1#78	0	3897	3897	P11137-1	687	4584	+	3897	P11137-1	4521	5481	ENST00000361559.8	949	1909	++	40	P11137-1#78	3834	3897	ENST00000361559.8	949	1012	+	63	3834	0	6733
P11137-1#78	0	3897	3897	P11137-1	687	4584	+	3897	P11137-1	0	5481	ENST00000360351.8	506	5987	++	38	P11137-1#78	0	3897	ENST00000360351.8	1193	5090	+	3897	0	0	6734
P11137-1#79	0	3	3	P11137-1	5070	5073	+	3	P11137-1	0	5481	ENST00000704357.1	451	6025	+	280	P11137-1#79	0	3	ENST00000704357.1	5521	5524	+	3	0	0	6735
P11137-1#79	0	3	3	P11137-1	5070	5073	+	3	P11137-1	0	5481	ENST00000682079.1	451	5932	++	275	P11137-1#79	0	3	ENST00000682079.1	5521	5524	+	3	0	0	6736
P11137-1#79	0	3	3	P11137-1	5070	5073	+	3	P11137-1	0	5481	ENST00000673860.1	318	6288	+	238	P11137-1#79	0	3	ENST00000673860.1	5877	5880	+	3	0	0	6737
P11137-1#79	0	3	3	P11137-1	5070	5073	+	3	P11137-1	0	5481	ENST00000447185.5	0	5469	++	97	P11137-1#79	0	3	ENST00000447185.5	5058	5061	+	3	0	0	6738
P11137-1#79	0	3	3	P11137-1	5070	5073	+	3	P11137-1	4521	5481	ENST00000392194.5	619	1579	++	61	P11137-1#79	0	3	ENST00000392194.5	1168	1171	+	3	0	0	6739
P11137-1#79	0	3	3	P11137-1	5070	5073	+	3	P11137-1	4521	5481	ENST00000361559.8	949	1909	++	40	P11137-1#79	0	3	ENST00000361559.8	1498	1501	+	3	0	0	6740
P11137-1#79	0	3	3	P11137-1	5070	5073	+	3	P11137-1	0	5481	ENST00000360351.8	506	5987	++	38	P11137-1#79	0	3	ENST00000360351.8	5576	5579	+	3	0	0	6741
P11137-1#80	0	3	3	P11137-1	243	246	+	3	P11137-1	0	5481	ENST00000704357.1	451	6025	+	280	P11137-1#80	0	3	ENST00000704357.1	694	697	+	3	0	0	6742
P11137-1#80	0	3	3	P11137-1	243	246	+	3	P11137-1	0	5481	ENST00000682079.1	451	5932	++	275	P11137-1#80	0	3	ENST00000682079.1	694	697	+	3	0	0	6743
P11137-1#80	0	3	3	P11137-1	243	246	+	3	P11137-1	0	5481	ENST00000673860.1	318	6288	+	238	P11137-1#80	0	3	ENST00000673860.1	561	564	+	3	0	0	6744
P11137-1#80	0	3	3	P11137-1	243	246	+	3	P11137-1	222	4695	ENST00000452717.1	0	624	+	101	P11137-1#80	0	3	ENST00000452717.1	21	24	+	3	0	0	6745
P11137-1#80	0	3	3	P11137-1	243	246	+	3	P11137-1	0	5481	ENST00000447185.5	0	5469	++	97	P11137-1#80	0	3	ENST00000447185.5	243	246	+	3	0	0	6746
P11137-1#80	0	3	3	P11137-1	243	246	+	3	P11137-1	0	1455	ENST00000445941.5	318	2019	+	96	P11137-1#80	0	3	ENST00000445941.5	561	564	+	3	0	0	6747
P11137-1#80	0	3	3	P11137-1	243	246	+	3	P11137-1	0	319	ENST00000392193.5	295	614	+	60	P11137-1#80	0	3	ENST00000392193.5	538	541	+	3	0	0	6748
P11137-1#80	0	3	3	P11137-1	243	246	+	3	P11137-1	0	5481	ENST00000360351.8	506	5987	++	38	P11137-1#80	0	3	ENST00000360351.8	749	752	+	3	0	0	6749
P11137-1#81	0	3	3	P11137-1	534	537	+	3	P11137-1	0	5481	ENST00000704357.1	451	6025	+	280	P11137-1#81	0	3	ENST00000704357.1	985	988	+	3	0	0	6750
P11137-1#81	0	3	3	P11137-1	534	537	+	3	P11137-1	0	5481	ENST00000682079.1	451	5932	++	275	P11137-1#81	0	3	ENST00000682079.1	985	988	+	3	0	0	6751
P11137-1#81	0	3	3	P11137-1	534	537	+	3	P11137-1	0	5481	ENST00000673860.1	318	6288	+	238	P11137-1#81	0	3	ENST00000673860.1	1341	1344	+	3	0	0	6752
P11137-1#81	0	3	3	P11137-1	534	537	+	3	P11137-1	0	5481	ENST00000447185.5	0	5469	++	97	P11137-1#81	0	3	ENST00000447185.5	522	525	+	3	0	0	6753
P11137-1#81	0	3	3	P11137-1	534	537	+	3	P11137-1	0	1455	ENST00000445941.5	318	2019	+	96	P11137-1#81	0	3	ENST00000445941.5	1098	1101	+	3	0	0	6754
P11137-1#81	0	3	3	P11137-1	534	537	+	3	P11137-1	0	5481	ENST00000360351.8	506	5987	++	38	P11137-1#81	0	3	ENST00000360351.8	1040	1043	+	3	0	0	6755
P11137-1#82	0	3	3	P11137-1	828	831	+	3	P11137-1	0	5481	ENST00000704357.1	451	6025	+	280	P11137-1#82	0	3	ENST00000704357.1	1279	1282	+	3	0	0	6756
P11137-1#82	0	3	3	P11137-1	828	831	+	3	P11137-1	0	5481	ENST00000682079.1	451	5932	++	275	P11137-1#82	0	3	ENST00000682079.1	1279	1282	+	3	0	0	6757
P11137-1#82	0	3	3	P11137-1	828	831	+	3	P11137-1	0	5481	ENST00000673860.1	318	6288	+	238	P11137-1#82	0	3	ENST00000673860.1	1635	1638	+	3	0	0	6758
P11137-1#82	0	3	3	P11137-1	828	831	+	3	P11137-1	0	5481	ENST00000447185.5	0	5469	++	97	P11137-1#82	0	3	ENST00000447185.5	816	819	+	3	0	0	6759
P11137-1#82	0	3	3	P11137-1	828	831	+	3	P11137-1	0	1455	ENST00000445941.5	318	2019	+	96	P11137-1#82	0	3	ENST00000445941.5	1392	1395	+	3	0	0	6760
P11137-1#82	0	3	3	P11137-1	828	831	+	3	P11137-1	0	5481	ENST00000360351.8	506	5987	++	38	P11137-1#82	0	3	ENST00000360351.8	1334	1337	+	3	0	0	6761
P11137-1#83	0	3	3	P11137-1	1266	1269	+	3	P11137-1	0	5481	ENST00000704357.1	451	6025	+	280	P11137-1#83	0	3	ENST00000704357.1	1717	1720	+	3	0	0	6762
P11137-1#83	0	3	3	P11137-1	1266	1269	+	3	P11137-1	0	5481	ENST00000682079.1	451	5932	++	275	P11137-1#83	0	3	ENST00000682079.1	1717	1720	+	3	0	0	6763
P11137-1#83	0	3	3	P11137-1	1266	1269	+	3	P11137-1	0	5481	ENST00000673860.1	318	6288	+	238	P11137-1#83	0	3	ENST00000673860.1	2073	2076	+	3	0	0	6764
P11137-1#83	0	3	3	P11137-1	1266	1269	+	3	P11137-1	0	5481	ENST00000447185.5	0	5469	++	97	P11137-1#83	0	3	ENST00000447185.5	1254	1257	+	3	0	0	6765
P11137-1#83	0	3	3	P11137-1	1266	1269	+	3	P11137-1	0	1455	ENST00000445941.5	318	2019	+	96	P11137-1#83	0	3	ENST00000445941.5	1830	1833	+	3	0	0	6766
P11137-1#83	0	3	3	P11137-1	1266	1269	+	3	P11137-1	0	5481	ENST00000360351.8	506	5987	++	38	P11137-1#83	0	3	ENST00000360351.8	1772	1775	+	3	0	0	6767
P11137-1#84	0	3	3	P11137-1	2112	2115	+	3	P11137-1	0	5481	ENST00000704357.1	451	6025	+	280	P11137-1#84	0	3	ENST00000704357.1	2563	2566	+	3	0	0	6768
P11137-1#84	0	3	3	P11137-1	2112	2115	+	3	P11137-1	0	5481	ENST00000682079.1	451	5932	++	275	P11137-1#84	0	3	ENST00000682079.1	2563	2566	+	3	0	0	6769
P11137-1#84	0	3	3	P11137-1	2112	2115	+	3	P11137-1	0	5481	ENST00000673860.1	318	6288	+	238	P11137-1#84	0	3	ENST00000673860.1	2919	2922	+	3	0	0	6770
P11137-1#84	0	3	3	P11137-1	2112	2115	+	3	P11137-1	0	5481	ENST00000447185.5	0	5469	++	97	P11137-1#84	0	3	ENST00000447185.5	2100	2103	+	3	0	0	6771
P11137-1#84	0	3	3	P11137-1	2112	2115	+	3	P11137-1	0	5481	ENST00000360351.8	506	5987	++	38	P11137-1#84	0	3	ENST00000360351.8	2618	2621	+	3	0	0	6772
P11137-1#85	0	3	3	P11137-1	2925	2928	+	3	P11137-1	0	5481	ENST00000704357.1	451	6025	+	280	P11137-1#85	0	3	ENST00000704357.1	3376	3379	+	3	0	0	6773
P11137-1#85	0	3	3	P11137-1	2925	2928	+	3	P11137-1	0	5481	ENST00000682079.1	451	5932	++	275	P11137-1#85	0	3	ENST00000682079.1	3376	3379	+	3	0	0	6774
P11137-1#85	0	3	3	P11137-1	2925	2928	+	3	P11137-1	0	5481	ENST00000673860.1	318	6288	+	238	P11137-1#85	0	3	ENST00000673860.1	3732	3735	+	3	0	0	6775
P11137-1#85	0	3	3	P11137-1	2925	2928	+	3	P11137-1	0	5481	ENST00000447185.5	0	5469	++	97	P11137-1#85	0	3	ENST00000447185.5	2913	2916	+	3	0	0	6776
P11137-1#85	0	3	3	P11137-1	2925	2928	+	3	P11137-1	0	5481	ENST00000360351.8	506	5987	++	38	P11137-1#85	0	3	ENST00000360351.8	3431	3434	+	3	0	0	6777
P11137-1#86	0	3	3	P11137-1	2970	2973	+	3	P11137-1	0	5481	ENST00000704357.1	451	6025	+	280	P11137-1#86	0	3	ENST00000704357.1	3421	3424	+	3	0	0	6778
P11137-1#86	0	3	3	P11137-1	2970	2973	+	3	P11137-1	0	5481	ENST00000682079.1	451	5932	++	275	P11137-1#86	0	3	ENST00000682079.1	3421	3424	+	3	0	0	6779
P11137-1#86	0	3	3	P11137-1	2970	2973	+	3	P11137-1	0	5481	ENST00000673860.1	318	6288	+	238	P11137-1#86	0	3	ENST00000673860.1	3777	3780	+	3	0	0	6780
P11137-1#86	0	3	3	P11137-1	2970	2973	+	3	P11137-1	0	5481	ENST00000447185.5	0	5469	++	97	P11137-1#86	0	3	ENST00000447185.5	2958	2961	+	3	0	0	6781
P11137-1#86	0	3	3	P11137-1	2970	2973	+	3	P11137-1	0	5481	ENST00000360351.8	506	5987	++	38	P11137-1#86	0	3	ENST00000360351.8	3476	3479	+	3	0	0	6782
P11137-1#87	0	3	3	P11137-1	3294	3297	+	3	P11137-1	0	5481	ENST00000704357.1	451	6025	+	280	P11137-1#87	0	3	ENST00000704357.1	3745	3748	+	3	0	0	6783
P11137-1#87	0	3	3	P11137-1	3294	3297	+	3	P11137-1	0	5481	ENST00000682079.1	451	5932	++	275	P11137-1#87	0	3	ENST00000682079.1	3745	3748	+	3	0	0	6784
P11137-1#87	0	3	3	P11137-1	3294	3297	+	3	P11137-1	0	5481	ENST00000673860.1	318	6288	+	238	P11137-1#87	0	3	ENST00000673860.1	4101	4104	+	3	0	0	6785
P11137-1#87	0	3	3	P11137-1	3294	3297	+	3	P11137-1	0	5481	ENST00000447185.5	0	5469	++	97	P11137-1#87	0	3	ENST00000447185.5	3282	3285	+	3	0	0	6786
P11137-1#87	0	3	3	P11137-1	3294	3297	+	3	P11137-1	0	5481	ENST00000360351.8	506	5987	++	38	P11137-1#87	0	3	ENST00000360351.8	3800	3803	+	3	0	0	6787
P11137-1#88	0	3	3	P11137-1	24	27	+	3	P11137-1	0	5481	ENST00000704357.1	451	6025	+	280	P11137-1#88	0	3	ENST00000704357.1	475	478	+	3	0	0	6788
P11137-1#88	0	3	3	P11137-1	24	27	+	3	P11137-1	0	5481	ENST00000682079.1	451	5932	++	275	P11137-1#88	0	3	ENST00000682079.1	475	478	+	3	0	0	6789
P11137-1#88	0	3	3	P11137-1	24	27	+	3	P11137-1	0	5481	ENST00000673860.1	318	6288	+	238	P11137-1#88	0	3	ENST00000673860.1	342	345	+	3	0	0	6790
P11137-1#88	0	3	3	P11137-1	24	27	+	3	P11137-1	0	5481	ENST00000447185.5	0	5469	++	97	P11137-1#88	0	3	ENST00000447185.5	24	27	+	3	0	0	6791
P11137-1#88	0	3	3	P11137-1	24	27	+	3	P11137-1	0	1455	ENST00000445941.5	318	2019	+	96	P11137-1#88	0	3	ENST00000445941.5	342	345	+	3	0	0	6792
P11137-1#88	0	3	3	P11137-1	24	27	+	3	P11137-1	0	319	ENST00000392193.5	295	614	+	60	P11137-1#88	0	3	ENST00000392193.5	319	322	+	3	0	0	6793
P11137-1#88	0	3	3	P11137-1	24	27	+	3	P11137-1	0	5481	ENST00000360351.8	506	5987	++	38	P11137-1#88	0	3	ENST00000360351.8	530	533	+	3	0	0	6794
P11137-1#89	0	3	3	P11137-1	108	111	+	3	P11137-1	0	5481	ENST00000704357.1	451	6025	+	280	P11137-1#89	0	3	ENST00000704357.1	559	562	+	3	0	0	6795
P11137-1#89	0	3	3	P11137-1	108	111	+	3	P11137-1	0	5481	ENST00000682079.1	451	5932	++	275	P11137-1#89	0	3	ENST00000682079.1	559	562	+	3	0	0	6796
P11137-1#89	0	3	3	P11137-1	108	111	+	3	P11137-1	0	5481	ENST00000673860.1	318	6288	+	238	P11137-1#89	0	3	ENST00000673860.1	426	429	+	3	0	0	6797
P11137-1#89	0	3	3	P11137-1	108	111	+	3	P11137-1	0	5481	ENST00000447185.5	0	5469	++	97	P11137-1#89	0	3	ENST00000447185.5	108	111	+	3	0	0	6798
P11137-1#89	0	3	3	P11137-1	108	111	+	3	P11137-1	0	1455	ENST00000445941.5	318	2019	+	96	P11137-1#89	0	3	ENST00000445941.5	426	429	+	3	0	0	6799
P11137-1#89	0	3	3	P11137-1	108	111	+	3	P11137-1	0	319	ENST00000392193.5	295	614	+	60	P11137-1#89	0	3	ENST00000392193.5	403	406	+	3	0	0	6800
P11137-1#89	0	3	3	P11137-1	108	111	+	3	P11137-1	0	5481	ENST00000360351.8	506	5987	++	38	P11137-1#89	0	3	ENST00000360351.8	614	617	+	3	0	0	6801
P11137-1#90	0	3	3	P11137-1	321	324	+	3	P11137-1	0	5481	ENST00000704357.1	451	6025	+	280	P11137-1#90	0	3	ENST00000704357.1	772	775	+	3	0	0	6802
P11137-1#90	0	3	3	P11137-1	321	324	+	3	P11137-1	0	5481	ENST00000682079.1	451	5932	++	275	P11137-1#90	0	3	ENST00000682079.1	772	775	+	3	0	0	6803
P11137-1#90	0	3	3	P11137-1	321	324	+	3	P11137-1	0	5481	ENST00000673860.1	318	6288	+	238	P11137-1#90	0	3	ENST00000673860.1	639	642	+	3	0	0	6804
P11137-1#90	0	3	3	P11137-1	321	324	+	3	P11137-1	222	4695	ENST00000452717.1	0	624	+	101	P11137-1#90	0	3	ENST00000452717.1	99	102	+	3	0	0	6805
P11137-1#90	0	3	3	P11137-1	321	324	+	3	P11137-1	0	5481	ENST00000447185.5	0	5469	++	97	P11137-1#90	0	3	ENST00000447185.5	321	324	+	3	0	0	6806
P11137-1#90	0	3	3	P11137-1	321	324	+	3	P11137-1	0	1455	ENST00000445941.5	318	2019	+	96	P11137-1#90	0	3	ENST00000445941.5	639	642	+	3	0	0	6807
P11137-1#90	0	3	3	P11137-1	321	324	+	3	P11137-1	0	5481	ENST00000360351.8	506	5987	++	38	P11137-1#90	0	3	ENST00000360351.8	827	830	+	3	0	0	6808
P11137-1#91	0	3	3	P11137-1	558	561	+	3	P11137-1	0	5481	ENST00000704357.1	451	6025	+	280	P11137-1#91	0	3	ENST00000704357.1	1009	1012	+	3	0	0	6809
P11137-1#91	0	3	3	P11137-1	558	561	+	3	P11137-1	0	5481	ENST00000682079.1	451	5932	++	275	P11137-1#91	0	3	ENST00000682079.1	1009	1012	+	3	0	0	6810
P11137-1#91	0	3	3	P11137-1	558	561	+	3	P11137-1	0	5481	ENST00000673860.1	318	6288	+	238	P11137-1#91	0	3	ENST00000673860.1	1365	1368	+	3	0	0	6811
P11137-1#91	0	3	3	P11137-1	558	561	+	3	P11137-1	0	5481	ENST00000447185.5	0	5469	++	97	P11137-1#91	0	3	ENST00000447185.5	546	549	+	3	0	0	6812
P11137-1#91	0	3	3	P11137-1	558	561	+	3	P11137-1	0	1455	ENST00000445941.5	318	2019	+	96	P11137-1#91	0	3	ENST00000445941.5	1122	1125	+	3	0	0	6813
P11137-1#91	0	3	3	P11137-1	558	561	+	3	P11137-1	0	5481	ENST00000360351.8	506	5987	++	38	P11137-1#91	0	3	ENST00000360351.8	1064	1067	+	3	0	0	6814
P11137-1#92	0	3	3	P11137-1	3333	3336	+	3	P11137-1	0	5481	ENST00000704357.1	451	6025	+	280	P11137-1#92	0	3	ENST00000704357.1	3784	3787	+	3	0	0	6815
P11137-1#92	0	3	3	P11137-1	3333	3336	+	3	P11137-1	0	5481	ENST00000682079.1	451	5932	++	275	P11137-1#92	0	3	ENST00000682079.1	3784	3787	+	3	0	0	6816
P11137-1#92	0	3	3	P11137-1	3333	3336	+	3	P11137-1	0	5481	ENST00000673860.1	318	6288	+	238	P11137-1#92	0	3	ENST00000673860.1	4140	4143	+	3	0	0	6817
P11137-1#92	0	3	3	P11137-1	3333	3336	+	3	P11137-1	0	5481	ENST00000447185.5	0	5469	++	97	P11137-1#92	0	3	ENST00000447185.5	3321	3324	+	3	0	0	6818
P11137-1#92	0	3	3	P11137-1	3333	3336	+	3	P11137-1	0	5481	ENST00000360351.8	506	5987	++	38	P11137-1#92	0	3	ENST00000360351.8	3839	3842	+	3	0	0	6819
P11137-1#93	0	3	3	P11137-1	4962	4965	+	3	P11137-1	0	5481	ENST00000704357.1	451	6025	+	280	P11137-1#93	0	3	ENST00000704357.1	5413	5416	+	3	0	0	6820
P11137-1#93	0	3	3	P11137-1	4962	4965	+	3	P11137-1	0	5481	ENST00000682079.1	451	5932	++	275	P11137-1#93	0	3	ENST00000682079.1	5413	5416	+	3	0	0	6821
P11137-1#93	0	3	3	P11137-1	4962	4965	+	3	P11137-1	0	5481	ENST00000673860.1	318	6288	+	238	P11137-1#93	0	3	ENST00000673860.1	5769	5772	+	3	0	0	6822
P11137-1#93	0	3	3	P11137-1	4962	4965	+	3	P11137-1	0	5481	ENST00000447185.5	0	5469	++	97	P11137-1#93	0	3	ENST00000447185.5	4950	4953	+	3	0	0	6823
P11137-1#93	0	3	3	P11137-1	4962	4965	+	3	P11137-1	4521	5481	ENST00000392194.5	619	1579	++	61	P11137-1#93	0	3	ENST00000392194.5	1060	1063	+	3	0	0	6824
P11137-1#93	0	3	3	P11137-1	4962	4965	+	3	P11137-1	4521	5481	ENST00000361559.8	949	1909	++	40	P11137-1#93	0	3	ENST00000361559.8	1390	1393	+	3	0	0	6825
P11137-1#93	0	3	3	P11137-1	4962	4965	+	3	P11137-1	0	5481	ENST00000360351.8	506	5987	++	38	P11137-1#93	0	3	ENST00000360351.8	5468	5471	+	3	0	0	6826
P11137-1#94	0	6	6	P11137-1	5142	5148	+	6	P11137-1	0	5481	ENST00000704357.1	451	6025	+	280	P11137-1#94	0	6	ENST00000704357.1	5686	5692	+	6	0	0	6827
P11137-1#94	0	6	6	P11137-1	5142	5148	+	6	P11137-1	0	5481	ENST00000682079.1	451	5932	++	275	P11137-1#94	0	6	ENST00000682079.1	5593	5599	+	6	0	0	6828
P11137-1#94	0	6	6	P11137-1	5142	5148	+	6	P11137-1	0	5481	ENST00000673860.1	318	6288	+	238	P11137-1#94	0	6	ENST00000673860.1	5949	5955	+	6	0	0	6829
P11137-1#94	0	6	6	P11137-1	5142	5148	+	6	P11137-1	0	5481	ENST00000447185.5	0	5469	++	97	P11137-1#94	0	6	ENST00000447185.5	5130	5136	+	6	0	0	6830
P11137-1#94	0	6	6	P11137-1	5142	5148	+	6	P11137-1	4521	5481	ENST00000392194.5	619	1579	++	61	P11137-1#94	0	6	ENST00000392194.5	1240	1246	+	6	0	0	6831
P11137-1#94	0	6	6	P11137-1	5142	5148	+	6	P11137-1	4521	5481	ENST00000361559.8	949	1909	++	40	P11137-1#94	0	6	ENST00000361559.8	1570	1576	+	6	0	0	6832
P11137-1#94	0	6	6	P11137-1	5142	5148	+	6	P11137-1	0	5481	ENST00000360351.8	506	5987	++	38	P11137-1#94	0	6	ENST00000360351.8	5648	5654	+	6	0	0	6833
P11137-1#95	0	3	3	P11137-1	5205	5208	+	3	P11137-1	0	5481	ENST00000704357.1	451	6025	+	280	P11137-1#95	0	3	ENST00000704357.1	5749	5752	+	3	0	0	6834
P11137-1#95	0	3	3	P11137-1	5205	5208	+	3	P11137-1	0	5481	ENST00000682079.1	451	5932	++	275	P11137-1#95	0	3	ENST00000682079.1	5656	5659	+	3	0	0	6835
P11137-1#95	0	3	3	P11137-1	5205	5208	+	3	P11137-1	0	5481	ENST00000673860.1	318	6288	+	238	P11137-1#95	0	3	ENST00000673860.1	6012	6015	+	3	0	0	6836
P11137-1#95	0	3	3	P11137-1	5205	5208	+	3	P11137-1	0	5481	ENST00000447185.5	0	5469	++	97	P11137-1#95	0	3	ENST00000447185.5	5193	5196	+	3	0	0	6837
P11137-1#95	0	3	3	P11137-1	5205	5208	+	3	P11137-1	4521	5481	ENST00000392194.5	619	1579	++	61	P11137-1#95	0	3	ENST00000392194.5	1303	1306	+	3	0	0	6838
P11137-1#95	0	3	3	P11137-1	5205	5208	+	3	P11137-1	4521	5481	ENST00000361559.8	949	1909	++	40	P11137-1#95	0	3	ENST00000361559.8	1633	1636	+	3	0	0	6839
P11137-1#95	0	3	3	P11137-1	5205	5208	+	3	P11137-1	0	5481	ENST00000360351.8	506	5987	++	38	P11137-1#95	0	3	ENST00000360351.8	5711	5714	+	3	0	0	6840
P11137-1#96	0	3	3	P11137-1	198	201	+	3	P11137-1	0	5481	ENST00000704357.1	451	6025	+	280	P11137-1#96	0	3	ENST00000704357.1	649	652	+	3	0	0	6841
P11137-1#96	0	3	3	P11137-1	198	201	+	3	P11137-1	0	5481	ENST00000682079.1	451	5932	++	275	P11137-1#96	0	3	ENST00000682079.1	649	652	+	3	0	0	6842
P11137-1#96	0	3	3	P11137-1	198	201	+	3	P11137-1	0	5481	ENST00000673860.1	318	6288	+	238	P11137-1#96	0	3	ENST00000673860.1	516	519	+	3	0	0	6843
P11137-1#96	0	3	3	P11137-1	198	201	+	3	P11137-1	0	5481	ENST00000447185.5	0	5469	++	97	P11137-1#96	0	3	ENST00000447185.5	198	201	+	3	0	0	6844
P11137-1#96	0	3	3	P11137-1	198	201	+	3	P11137-1	0	1455	ENST00000445941.5	318	2019	+	96	P11137-1#96	0	3	ENST00000445941.5	516	519	+	3	0	0	6845
P11137-1#96	0	3	3	P11137-1	198	201	+	3	P11137-1	0	319	ENST00000392193.5	295	614	+	60	P11137-1#96	0	3	ENST00000392193.5	493	496	+	3	0	0	6846
P11137-1#96	0	3	3	P11137-1	198	201	+	3	P11137-1	0	5481	ENST00000360351.8	506	5987	++	38	P11137-1#96	0	3	ENST00000360351.8	704	707	+	3	0	0	6847
P11137-1#97	0	3	3	P11137-1	966	969	+	3	P11137-1	0	5481	ENST00000704357.1	451	6025	+	280	P11137-1#97	0	3	ENST00000704357.1	1417	1420	+	3	0	0	6848
P11137-1#97	0	3	3	P11137-1	966	969	+	3	P11137-1	0	5481	ENST00000682079.1	451	5932	++	275	P11137-1#97	0	3	ENST00000682079.1	1417	1420	+	3	0	0	6849
P11137-1#97	0	3	3	P11137-1	966	969	+	3	P11137-1	0	5481	ENST00000673860.1	318	6288	+	238	P11137-1#97	0	3	ENST00000673860.1	1773	1776	+	3	0	0	6850
P11137-1#97	0	3	3	P11137-1	966	969	+	3	P11137-1	0	5481	ENST00000447185.5	0	5469	++	97	P11137-1#97	0	3	ENST00000447185.5	954	957	+	3	0	0	6851
P11137-1#97	0	3	3	P11137-1	966	969	+	3	P11137-1	0	1455	ENST00000445941.5	318	2019	+	96	P11137-1#97	0	3	ENST00000445941.5	1530	1533	+	3	0	0	6852
P11137-1#97	0	3	3	P11137-1	966	969	+	3	P11137-1	0	5481	ENST00000360351.8	506	5987	++	38	P11137-1#97	0	3	ENST00000360351.8	1472	1475	+	3	0	0	6853
P11137-1#98	0	3	3	P11137-1	1059	1062	+	3	P11137-1	0	5481	ENST00000704357.1	451	6025	+	280	P11137-1#98	0	3	ENST00000704357.1	1510	1513	+	3	0	0	6854
P11137-1#98	0	3	3	P11137-1	1059	1062	+	3	P11137-1	0	5481	ENST00000682079.1	451	5932	++	275	P11137-1#98	0	3	ENST00000682079.1	1510	1513	+	3	0	0	6855
P11137-1#98	0	3	3	P11137-1	1059	1062	+	3	P11137-1	0	5481	ENST00000673860.1	318	6288	+	238	P11137-1#98	0	3	ENST00000673860.1	1866	1869	+	3	0	0	6856
P11137-1#98	0	3	3	P11137-1	1059	1062	+	3	P11137-1	0	5481	ENST00000447185.5	0	5469	++	97	P11137-1#98	0	3	ENST00000447185.5	1047	1050	+	3	0	0	6857
P11137-1#98	0	3	3	P11137-1	1059	1062	+	3	P11137-1	0	1455	ENST00000445941.5	318	2019	+	96	P11137-1#98	0	3	ENST00000445941.5	1623	1626	+	3	0	0	6858
P11137-1#98	0	3	3	P11137-1	1059	1062	+	3	P11137-1	0	5481	ENST00000360351.8	506	5987	++	38	P11137-1#98	0	3	ENST00000360351.8	1565	1568	+	3	0	0	6859
P11137-1#99	0	3	3	P11137-1	1155	1158	+	3	P11137-1	0	5481	ENST00000704357.1	451	6025	+	280	P11137-1#99	0	3	ENST00000704357.1	1606	1609	+	3	0	0	6860
P11137-1#99	0	3	3	P11137-1	1155	1158	+	3	P11137-1	0	5481	ENST00000682079.1	451	5932	++	275	P11137-1#99	0	3	ENST00000682079.1	1606	1609	+	3	0	0	6861
P11137-1#99	0	3	3	P11137-1	1155	1158	+	3	P11137-1	0	5481	ENST00000673860.1	318	6288	+	238	P11137-1#99	0	3	ENST00000673860.1	1962	1965	+	3	0	0	6862
P11137-1#99	0	3	3	P11137-1	1155	1158	+	3	P11137-1	0	5481	ENST00000447185.5	0	5469	++	97	P11137-1#99	0	3	ENST00000447185.5	1143	1146	+	3	0	0	6863
P11137-1#99	0	3	3	P11137-1	1155	1158	+	3	P11137-1	0	1455	ENST00000445941.5	318	2019	+	96	P11137-1#99	0	3	ENST00000445941.5	1719	1722	+	3	0	0	6864
P11137-1#99	0	3	3	P11137-1	1155	1158	+	3	P11137-1	0	5481	ENST00000360351.8	506	5987	++	38	P11137-1#99	0	3	ENST00000360351.8	1661	1664	+	3	0	0	6865
P51809-1#0	0	3	3	P51809-1	0	3	+	3	P51809-1	0	238	ENST00000488344.6	98	278	+	117	P51809-1#0	0	3	ENST00000488344.6	98	101	+	3	0	0	6866
P51809-1#0	0	3	3	P51809-1	0	3	+	3	P51809-1	0	660	ENST00000460621.6	80	617	++	106	P51809-1#0	0	3	ENST00000460621.6	80	83	+	3	0	0	6867
P51809-1#0	0	3	3	P51809-1	0	3	+	3	P51809-1	0	660	ENST00000286448.12	113	773	++	15	P51809-1#0	0	3	ENST00000286448.12	113	116	+	3	0	0	6868
P51809-1#0	0	3	3	P51809-1	0	3	+	3	P51809-1	0	660	ENST00000262640.11	83	675	++	8	P51809-1#0	0	3	ENST00000262640.11	83	86	+	3	0	0	6869
P51809-1#1	0	657	657	P51809-1	3	660	+	657	P51809-1	0	238	ENST00000488344.6	98	278	+	117	P51809-1#1	0	235	ENST00000488344.6	101	278	+	177	0	422	6870
P51809-1#1	0	657	657	P51809-1	3	660	+	657	P51809-1	0	660	ENST00000460621.6	80	617	++	106	P51809-1#1	0	657	ENST00000460621.6	83	617	+	534	0	0	6871
P51809-1#1	0	657	657	P51809-1	3	660	+	657	P51809-1	0	660	ENST00000286448.12	113	773	++	15	P51809-1#1	0	657	ENST00000286448.12	116	773	+	657	0	0	6872
P51809-1#1	0	657	657	P51809-1	3	660	+	657	P51809-1	0	660	ENST00000262640.11	83	675	++	8	P51809-1#1	0	657	ENST00000262640.11	86	675	+	588	0	0	6873
P51809-1#2	0	561	561	P51809-1	3	564	+	561	P51809-1	0	238	ENST00000488344.6	98	278	+	117	P51809-1#2	0	235	ENST00000488344.6	101	278	+	177	0	326	6874
P51809-1#2	0	561	561	P51809-1	3	564	+	561	P51809-1	0	660	ENST00000460621.6	80	617	++	106	P51809-1#2	0	561	ENST00000460621.6	83	521	+	438	0	0	6875
P51809-1#2	0	561	561	P51809-1	3	564	+	561	P51809-1	0	660	ENST00000286448.12	113	773	++	15	P51809-1#2	0	561	ENST00000286448.12	116	677	+	561	0	0	6876
P51809-1#2	0	561	561	P51809-1	3	564	+	561	P51809-1	0	660	ENST00000262640.11	83	675	++	8	P51809-1#2	0	561	ENST00000262640.11	86	579	+	492	0	0	6877
P51809-1#3	0	63	63	P51809-1	564	627	+	63	P51809-1	0	660	ENST00000460621.6	80	617	++	106	P51809-1#3	0	63	ENST00000460621.6	521	584	+	63	0	0	6878
P51809-1#3	0	63	63	P51809-1	564	627	+	63	P51809-1	0	660	ENST00000286448.12	113	773	++	15	P51809-1#3	0	63	ENST00000286448.12	677	740	+	63	0	0	6879
P51809-1#3	0	63	63	P51809-1	564	627	+	63	P51809-1	0	660	ENST00000262640.11	83	675	++	8	P51809-1#3	0	63	ENST00000262640.11	579	642	+	63	0	0	6880
P51809-1#4	0	33	33	P51809-1	627	660	+	33	P51809-1	0	660	ENST00000460621.6	80	617	++	106	P51809-1#4	0	33	ENST00000460621.6	584	617	+	33	0	0	6881
P51809-1#4	0	33	33	P51809-1	627	660	+	33	P51809-1	0	660	ENST00000286448.12	113	773	++	15	P51809-1#4	0	33	ENST00000286448.12	740	773	+	33	0	0	6882
P51809-1#4	0	33	33	P51809-1	627	660	+	33	P51809-1	0	660	ENST00000262640.11	83	675	++	8	P51809-1#4	0	33	ENST00000262640.11	642	675	+	33	0	0	6883
P51809-1#5	0	312	312	P51809-1	18	330	+	312	P51809-1	0	238	ENST00000488344.6	98	278	+	117	P51809-1#5	0	220	ENST00000488344.6	116	278	+	162	0	92	6884
P51809-1#5	0	312	312	P51809-1	18	330	+	312	P51809-1	0	660	ENST00000460621.6	80	617	++	106	P51809-1#5	0	312	ENST00000460621.6	98	287	+	189	0	0	6885
P51809-1#5	0	312	312	P51809-1	18	330	+	312	P51809-1	0	660	ENST00000286448.12	113	773	++	15	P51809-1#5	0	312	ENST00000286448.12	131	443	+	312	0	0	6886
P51809-1#5	0	312	312	P51809-1	18	330	+	312	P51809-1	0	660	ENST00000262640.11	83	675	++	8	P51809-1#5	0	312	ENST00000262640.11	101	413	+	312	0	0	6887
P51809-1#6	0	183	183	P51809-1	372	555	+	183	P51809-1	0	660	ENST00000460621.6	80	617	++	106	P51809-1#6	0	183	ENST00000460621.6	329	512	+	183	0	0	6888
P51809-1#6	0	183	183	P51809-1	372	555	+	183	P51809-1	0	660	ENST00000286448.12	113	773	++	15	P51809-1#6	0	183	ENST00000286448.12	485	668	+	183	0	0	6889
P51809-1#6	0	183	183	P51809-1	372	555	+	183	P51809-1	0	660	ENST00000262640.11	83	675	++	8	P51809-1#6	0	183	ENST00000262640.11	455	570	+	114	0	0	6890
P51809-1#7	0	3	3	P51809-1	3	6	+	3	P51809-1	0	238	ENST00000488344.6	98	278	+	117	P51809-1#7	0	3	ENST00000488344.6	101	104	+	3	0	0	6891
P51809-1#7	0	3	3	P51809-1	3	6	+	3	P51809-1	0	660	ENST00000460621.6	80	617	++	106	P51809-1#7	0	3	ENST00000460621.6	83	86	+	3	0	0	6892
P51809-1#7	0	3	3	P51809-1	3	6	+	3	P51809-1	0	660	ENST00000286448.12	113	773	++	15	P51809-1#7	0	3	ENST00000286448.12	116	119	+	3	0	0	6893
P51809-1#7	0	3	3	P51809-1	3	6	+	3	P51809-1	0	660	ENST00000262640.11	83	675	++	8	P51809-1#7	0	3	ENST00000262640.11	86	89	+	3	0	0	6894
P51809-1#8	0	3	3	P51809-1	498	501	+	3	P51809-1	0	660	ENST00000460621.6	80	617	++	106	P51809-1#8	0	3	ENST00000460621.6	455	458	+	3	0	0	6895
P51809-1#8	0	3	3	P51809-1	498	501	+	3	P51809-1	0	660	ENST00000286448.12	113	773	++	15	P51809-1#8	0	3	ENST00000286448.12	611	614	+	3	0	0	6896
P51809-1#9	0	3	3	P51809-1	501	504	+	3	P51809-1	0	660	ENST00000460621.6	80	617	++	106	P51809-1#9	0	3	ENST00000460621.6	458	461	+	3	0	0	6897
P51809-1#9	0	3	3	P51809-1	501	504	+	3	P51809-1	0	660	ENST00000286448.12	113	773	++	15	P51809-1#9	0	3	ENST00000286448.12	614	617	+	3	0	0	6898
P51809-1#9	0	3	3	P51809-1	501	504	+	3	P51809-1	0	660	ENST00000262640.11	83	675	++	8	P51809-1#9	0	3	ENST00000262640.11	516	519	+	3	0	0	6899
P51809-1#10	0	123	123	P51809-1	81	204	+	123	P51809-1	0	238	ENST00000488344.6	98	278	+	117	P51809-1#10	0	65	ENST00000488344.6	179	244	+	65	0	58	6900
P51809-1#10	0	123	123	P51809-1	81	204	+	123	P51809-1	0	660	ENST00000286448.12	113	773	++	15	P51809-1#10	0	123	ENST00000286448.12	194	317	+	123	0	0	6901
P51809-1#10	0	123	123	P51809-1	81	204	+	123	P51809-1	0	660	ENST00000262640.11	83	675	++	8	P51809-1#10	0	123	ENST00000262640.11	164	287	+	123	0	0	6902
P51809-1#11	0	228	228	P51809-1	432	660	+	228	P51809-1	0	660	ENST00000460621.6	80	617	++	106	P51809-1#11	0	228	ENST00000460621.6	389	617	+	228	0	0	6903
P51809-1#11	0	228	228	P51809-1	432	660	+	228	P51809-1	0	660	ENST00000286448.12	113	773	++	15	P51809-1#11	0	228	ENST00000286448.12	545	773	+	228	0	0	6904
P51809-1#11	0	228	228	P51809-1	432	660	+	228	P51809-1	0	660	ENST00000262640.11	83	675	++	8	P51809-1#11	69	228	ENST00000262640.11	516	675	+	159	69	0	6905
P51809-1#12	0	3	3	P51809-1	291	294	+	3	P51809-1	0	660	ENST00000460621.6	80	617	++	106	P51809-1#12	0	3	ENST00000460621.6	248	251	+	3	0	0	6906
P51809-1#12	0	3	3	P51809-1	291	294	+	3	P51809-1	0	660	ENST00000286448.12	113	773	++	15	P51809-1#12	0	3	ENST00000286448.12	404	407	+	3	0	0	6907
P51809-1#12	0	3	3	P51809-1	291	294	+	3	P51809-1	0	660	ENST00000262640.11	83	675	++	8	P51809-1#12	0	3	ENST00000262640.11	374	377	+	3	0	0	6908
P51809-1#13	0	18	18	P51809-1	12	30	+	18	P51809-1	0	238	ENST00000488344.6	98	278	+	117	P51809-1#13	0	18	ENST00000488344.6	110	128	+	18	0	0	6909
P51809-1#13	0	18	18	P51809-1	12	30	+	18	P51809-1	0	660	ENST00000460621.6	80	617	++	106	P51809-1#13	0	18	ENST00000460621.6	92	110	+	18	0	0	6910
P51809-1#13	0	18	18	P51809-1	12	30	+	18	P51809-1	0	660	ENST00000286448.12	113	773	++	15	P51809-1#13	0	18	ENST00000286448.12	125	143	+	18	0	0	6911
P51809-1#13	0	18	18	P51809-1	12	30	+	18	P51809-1	0	660	ENST00000262640.11	83	675	++	8	P51809-1#13	0	18	ENST00000262640.11	95	113	+	18	0	0	6912
P51809-1#14	0	21	21	P51809-1	36	57	+	21	P51809-1	0	238	ENST00000488344.6	98	278	+	117	P51809-1#14	0	21	ENST00000488344.6	134	155	+	21	0	0	6913
P51809-1#14	0	21	21	P51809-1	36	57	+	21	P51809-1	0	660	ENST00000460621.6	80	617	++	106	P51809-1#14	0	21	ENST00000460621.6	116	137	+	21	0	0	6914
P51809-1#14	0	21	21	P51809-1	36	57	+	21	P51809-1	0	660	ENST00000286448.12	113	773	++	15	P51809-1#14	0	21	ENST00000286448.12	149	170	+	21	0	0	6915
P51809-1#14	0	21	21	P51809-1	36	57	+	21	P51809-1	0	660	ENST00000262640.11	83	675	++	8	P51809-1#14	0	21	ENST00000262640.11	119	140	+	21	0	0	6916
P51809-1#15	0	9	9	P51809-1	60	69	+	9	P51809-1	0	238	ENST00000488344.6	98	278	+	117	P51809-1#15	0	9	ENST00000488344.6	158	167	+	9	0	0	6917
P51809-1#15	0	9	9	P51809-1	60	69	+	9	P51809-1	0	660	ENST00000460621.6	80	617	++	106	P51809-1#15	0	9	ENST00000460621.6	140	149	+	9	0	0	6918
P51809-1#15	0	9	9	P51809-1	60	69	+	9	P51809-1	0	660	ENST00000286448.12	113	773	++	15	P51809-1#15	0	9	ENST00000286448.12	173	182	+	9	0	0	6919
P51809-1#15	0	9	9	P51809-1	60	69	+	9	P51809-1	0	660	ENST00000262640.11	83	675	++	8	P51809-1#15	0	9	ENST00000262640.11	143	152	+	9	0	0	6920
P51809-1#16	0	24	24	P51809-1	75	99	+	24	P51809-1	0	238	ENST00000488344.6	98	278	+	117	P51809-1#16	0	24	ENST00000488344.6	173	197	+	24	0	0	6921
P51809-1#16	0	24	24	P51809-1	75	99	+	24	P51809-1	0	660	ENST00000460621.6	80	617	++	106	P51809-1#16	0	6	ENST00000460621.6	155	161	+	6	0	18	6922
P51809-1#16	0	24	24	P51809-1	75	99	+	24	P51809-1	0	660	ENST00000286448.12	113	773	++	15	P51809-1#16	0	24	ENST00000286448.12	188	212	+	24	0	0	6923
P51809-1#16	0	24	24	P51809-1	75	99	+	24	P51809-1	0	660	ENST00000262640.11	83	675	++	8	P51809-1#16	0	24	ENST00000262640.11	158	182	+	24	0	0	6924
P51809-1#17	0	9	9	P51809-1	111	120	+	9	P51809-1	0	238	ENST00000488344.6	98	278	+	117	P51809-1#17	0	9	ENST00000488344.6	209	218	+	9	0	0	6925
P51809-1#17	0	9	9	P51809-1	111	120	+	9	P51809-1	0	660	ENST00000286448.12	113	773	++	15	P51809-1#17	0	9	ENST00000286448.12	224	233	+	9	0	0	6926
P51809-1#17	0	9	9	P51809-1	111	120	+	9	P51809-1	0	660	ENST00000262640.11	83	675	++	8	P51809-1#17	0	9	ENST00000262640.11	194	203	+	9	0	0	6927
P51809-1#18	0	18	18	P51809-1	123	141	+	18	P51809-1	0	238	ENST00000488344.6	98	278	+	117	P51809-1#18	0	18	ENST00000488344.6	221	239	+	18	0	0	6928
P51809-1#18	0	18	18	P51809-1	123	141	+	18	P51809-1	0	660	ENST00000286448.12	113	773	++	15	P51809-1#18	0	18	ENST00000286448.12	236	254	+	18	0	0	6929
P51809-1#18	0	18	18	P51809-1	123	141	+	18	P51809-1	0	660	ENST00000262640.11	83	675	++	8	P51809-1#18	0	18	ENST00000262640.11	206	224	+	18	0	0	6930
P51809-1#19	0	24	24	P51809-1	147	171	+	24	P51809-1	0	660	ENST00000286448.12	113	773	++	15	P51809-1#19	0	24	ENST00000286448.12	260	284	+	24	0	0	6931
P51809-1#19	0	24	24	P51809-1	147	171	+	24	P51809-1	0	660	ENST00000262640.11	83	675	++	8	P51809-1#19	0	24	ENST00000262640.11	230	254	+	24	0	0	6932
P51809-1#20	0	33	33	P51809-1	177	210	+	33	P51809-1	0	238	ENST00000488344.6	98	278	+	117	P51809-1#20	27	33	ENST00000488344.6	244	250	+	6	27	0	6933
P51809-1#20	0	33	33	P51809-1	177	210	+	33	P51809-1	0	660	ENST00000460621.6	80	617	++	106	P51809-1#20	27	33	ENST00000460621.6	161	167	+	6	27	0	6934
P51809-1#20	0	33	33	P51809-1	177	210	+	33	P51809-1	0	660	ENST00000286448.12	113	773	++	15	P51809-1#20	0	33	ENST00000286448.12	290	323	+	33	0	0	6935
P51809-1#20	0	33	33	P51809-1	177	210	+	33	P51809-1	0	660	ENST00000262640.11	83	675	++	8	P51809-1#20	0	33	ENST00000262640.11	260	293	+	33	0	0	6936
P51809-1#21	0	54	54	P51809-1	213	267	+	54	P51809-1	0	238	ENST00000488344.6	98	278	+	117	P51809-1#21	0	25	ENST00000488344.6	253	278	+	25	0	29	6937
P51809-1#21	0	54	54	P51809-1	213	267	+	54	P51809-1	0	660	ENST00000460621.6	80	617	++	106	P51809-1#21	0	54	ENST00000460621.6	170	224	+	54	0	0	6938
P51809-1#21	0	54	54	P51809-1	213	267	+	54	P51809-1	0	660	ENST00000286448.12	113	773	++	15	P51809-1#21	0	54	ENST00000286448.12	326	380	+	54	0	0	6939
P51809-1#21	0	54	54	P51809-1	213	267	+	54	P51809-1	0	660	ENST00000262640.11	83	675	++	8	P51809-1#21	0	54	ENST00000262640.11	296	350	+	54	0	0	6940
P51809-1#22	0	15	15	P51809-1	270	285	+	15	P51809-1	0	660	ENST00000460621.6	80	617	++	106	P51809-1#22	0	15	ENST00000460621.6	227	242	+	15	0	0	6941
P51809-1#22	0	15	15	P51809-1	270	285	+	15	P51809-1	0	660	ENST00000286448.12	113	773	++	15	P51809-1#22	0	15	ENST00000286448.12	383	398	+	15	0	0	6942
P51809-1#22	0	15	15	P51809-1	270	285	+	15	P51809-1	0	660	ENST00000262640.11	83	675	++	8	P51809-1#22	0	15	ENST00000262640.11	353	368	+	15	0	0	6943
P51809-1#23	0	45	45	P51809-1	306	351	+	45	P51809-1	0	660	ENST00000460621.6	80	617	++	106	P51809-1#23	0	45	ENST00000460621.6	263	308	+	45	0	0	6944
P51809-1#23	0	45	45	P51809-1	306	351	+	45	P51809-1	0	660	ENST00000286448.12	113	773	++	15	P51809-1#23	0	45	ENST00000286448.12	419	464	+	45	0	0	6945
P51809-1#23	0	45	45	P51809-1	306	351	+	45	P51809-1	0	660	ENST00000262640.11	83	675	++	8	P51809-1#23	0	45	ENST00000262640.11	389	434	+	45	0	0	6946
P29274#0	0	1236	1236	P29274	0	1236	+	1236	P29274	0	1236	ENST00000618076.3	524	1760	++	233	P29274#0	0	1236	ENST00000618076.3	524	1760	+	1236	0	0	6947
P29274#0	0	1236	1236	P29274	0	1236	+	1236	P29274	0	1236	ENST00000611543.4	306	1542	++	231	P29274#0	0	1236	ENST00000611543.4	306	1542	+	1236	0	0	6948
P29274#0	0	1236	1236	P29274	0	1236	+	1236	P29274	0	1236	ENST00000610595.4	630	1866	++	230	P29274#0	0	1236	ENST00000610595.4	630	1866	+	1236	0	0	6949
P29274#0	0	1236	1236	P29274	0	1236	+	1236	P29274	0	250	ENST00000496258.1	439	689	+	123	P29274#0	0	250	ENST00000496258.1	439	689	+	250	0	986	6950
P29274#0	0	1236	1236	P29274	0	1236	+	1236	P29274	0	325	ENST00000486108.1	601	926	+	115	P29274#0	0	325	ENST00000486108.1	601	926	+	325	0	911	6951
P29274#0	0	1236	1236	P29274	0	1236	+	1236	P29274	0	88	ENST00000472248.5	630	718	+	109	P29274#0	0	88	ENST00000472248.5	630	718	+	88	0	1148	6952
P29274#0	0	1236	1236	P29274	0	1236	+	1236	P29274	0	19	ENST00000464977.5	539	558	+	107	P29274#0	0	19	ENST00000464977.5	539	558	+	19	0	1217	6953
P29274#0	0	1236	1236	P29274	0	1236	+	1236	P29274	0	1095	ENST00000444262.6	422	1517	+	92	P29274#0	0	1095	ENST00000444262.6	422	1517	+	1095	0	141	6954
P29274#0	0	1236	1236	P29274	0	1236	+	1236	P29274	0	230	ENST00000439591.1	330	560	+	90	P29274#0	0	230	ENST00000439591.1	330	560	+	230	0	1006	6955
P29274#0	0	1236	1236	P29274	0	1236	+	1236	P29274	0	193	ENST00000436735.1	476	669	+	88	P29274#0	0	193	ENST00000436735.1	476	669	+	193	0	1043	6956
P29274#0	0	1236	1236	P29274	0	1236	+	1236	P29274	0	263	ENST00000424232.5	306	569	+	80	P29274#0	0	263	ENST00000424232.5	306	569	+	263	0	973	6957
P29274#0	0	1236	1236	P29274	0	1236	+	1236	P29274	0	1236	ENST00000337539.12	422	1658	++	30	P29274#0	0	1236	ENST00000337539.12	422	1658	+	1236	0	0	6958
P29274#1	0	21	21	P29274	0	21	+	21	P29274	0	1236	ENST00000618076.3	524	1760	++	233	P29274#1	0	21	ENST00000618076.3	524	545	+	21	0	0	6959
P29274#1	0	21	21	P29274	0	21	+	21	P29274	0	1236	ENST00000611543.4	306	1542	++	231	P29274#1	0	21	ENST00000611543.4	306	327	+	21	0	0	6960
P29274#1	0	21	21	P29274	0	21	+	21	P29274	0	1236	ENST00000610595.4	630	1866	++	230	P29274#1	0	21	ENST00000610595.4	630	651	+	21	0	0	6961
P29274#1	0	21	21	P29274	0	21	+	21	P29274	0	250	ENST00000496258.1	439	689	+	123	P29274#1	0	21	ENST00000496258.1	439	460	+	21	0	0	6962
P29274#1	0	21	21	P29274	0	21	+	21	P29274	0	325	ENST00000486108.1	601	926	+	115	P29274#1	0	21	ENST00000486108.1	601	622	+	21	0	0	6963
P29274#1	0	21	21	P29274	0	21	+	21	P29274	0	88	ENST00000472248.5	630	718	+	109	P29274#1	0	21	ENST00000472248.5	630	651	+	21	0	0	6964
P29274#1	0	21	21	P29274	0	21	+	21	P29274	0	19	ENST00000464977.5	539	558	+	107	P29274#1	0	19	ENST00000464977.5	539	558	+	19	0	2	6965
P29274#1	0	21	21	P29274	0	21	+	21	P29274	0	1095	ENST00000444262.6	422	1517	+	92	P29274#1	0	21	ENST00000444262.6	422	443	+	21	0	0	6966
P29274#1	0	21	21	P29274	0	21	+	21	P29274	0	230	ENST00000439591.1	330	560	+	90	P29274#1	0	21	ENST00000439591.1	330	351	+	21	0	0	6967
P29274#1	0	21	21	P29274	0	21	+	21	P29274	0	193	ENST00000436735.1	476	669	+	88	P29274#1	0	21	ENST00000436735.1	476	497	+	21	0	0	6968
P29274#1	0	21	21	P29274	0	21	+	21	P29274	0	263	ENST00000424232.5	306	569	+	80	P29274#1	0	21	ENST00000424232.5	306	327	+	21	0	0	6969
P29274#1	0	21	21	P29274	0	21	+	21	P29274	0	1236	ENST00000337539.12	422	1658	++	30	P29274#1	0	21	ENST00000337539.12	422	443	+	21	0	0	6970
P29274#2	0	75	75	P29274	21	96	+	75	P29274	0	1236	ENST00000618076.3	524	1760	++	233	P29274#2	0	75	ENST00000618076.3	545	620	+	75	0	0	6971
P29274#2	0	75	75	P29274	21	96	+	75	P29274	0	1236	ENST00000611543.4	306	1542	++	231	P29274#2	0	75	ENST00000611543.4	327	402	+	75	0	0	6972
P29274#2	0	75	75	P29274	21	96	+	75	P29274	0	1236	ENST00000610595.4	630	1866	++	230	P29274#2	0	75	ENST00000610595.4	651	726	+	75	0	0	6973
P29274#2	0	75	75	P29274	21	96	+	75	P29274	0	250	ENST00000496258.1	439	689	+	123	P29274#2	0	75	ENST00000496258.1	460	535	+	75	0	0	6974
P29274#2	0	75	75	P29274	21	96	+	75	P29274	0	325	ENST00000486108.1	601	926	+	115	P29274#2	0	75	ENST00000486108.1	622	697	+	75	0	0	6975
P29274#2	0	75	75	P29274	21	96	+	75	P29274	0	88	ENST00000472248.5	630	718	+	109	P29274#2	0	67	ENST00000472248.5	651	718	+	67	0	8	6976
P29274#2	0	75	75	P29274	21	96	+	75	P29274	0	1095	ENST00000444262.6	422	1517	+	92	P29274#2	0	75	ENST00000444262.6	443	518	+	75	0	0	6977
P29274#2	0	75	75	P29274	21	96	+	75	P29274	0	230	ENST00000439591.1	330	560	+	90	P29274#2	0	75	ENST00000439591.1	351	426	+	75	0	0	6978
P29274#2	0	75	75	P29274	21	96	+	75	P29274	0	193	ENST00000436735.1	476	669	+	88	P29274#2	0	75	ENST00000436735.1	497	572	+	75	0	0	6979
P29274#2	0	75	75	P29274	21	96	+	75	P29274	0	263	ENST00000424232.5	306	569	+	80	P29274#2	0	75	ENST00000424232.5	327	402	+	75	0	0	6980
P29274#2	0	75	75	P29274	21	96	+	75	P29274	0	1236	ENST00000337539.12	422	1658	++	30	P29274#2	0	75	ENST00000337539.12	443	518	+	75	0	0	6981
P29274#3	0	30	30	P29274	96	126	+	30	P29274	0	1236	ENST00000618076.3	524	1760	++	233	P29274#3	0	30	ENST00000618076.3	620	650	+	30	0	0	6982
P29274#3	0	30	30	P29274	96	126	+	30	P29274	0	1236	ENST00000611543.4	306	1542	++	231	P29274#3	0	30	ENST00000611543.4	402	432	+	30	0	0	6983
P29274#3	0	30	30	P29274	96	126	+	30	P29274	0	1236	ENST00000610595.4	630	1866	++	230	P29274#3	0	30	ENST00000610595.4	726	756	+	30	0	0	6984
P29274#3	0	30	30	P29274	96	126	+	30	P29274	0	250	ENST00000496258.1	439	689	+	123	P29274#3	0	30	ENST00000496258.1	535	565	+	30	0	0	6985
P29274#3	0	30	30	P29274	96	126	+	30	P29274	0	325	ENST00000486108.1	601	926	+	115	P29274#3	0	30	ENST00000486108.1	697	727	+	30	0	0	6986
P29274#3	0	30	30	P29274	96	126	+	30	P29274	0	1095	ENST00000444262.6	422	1517	+	92	P29274#3	0	30	ENST00000444262.6	518	548	+	30	0	0	6987
P29274#3	0	30	30	P29274	96	126	+	30	P29274	0	230	ENST00000439591.1	330	560	+	90	P29274#3	0	30	ENST00000439591.1	426	456	+	30	0	0	6988
P29274#3	0	30	30	P29274	96	126	+	30	P29274	0	193	ENST00000436735.1	476	669	+	88	P29274#3	0	30	ENST00000436735.1	572	602	+	30	0	0	6989
P29274#3	0	30	30	P29274	96	126	+	30	P29274	0	263	ENST00000424232.5	306	569	+	80	P29274#3	0	30	ENST00000424232.5	402	432	+	30	0	0	6990
P29274#3	0	30	30	P29274	96	126	+	30	P29274	0	1236	ENST00000337539.12	422	1658	++	30	P29274#3	0	30	ENST00000337539.12	518	548	+	30	0	0	6991
P29274#4	0	72	72	P29274	126	198	+	72	P29274	0	1236	ENST00000618076.3	524	1760	++	233	P29274#4	0	72	ENST00000618076.3	650	722	+	72	0	0	6992
P29274#4	0	72	72	P29274	126	198	+	72	P29274	0	1236	ENST00000611543.4	306	1542	++	231	P29274#4	0	72	ENST00000611543.4	432	504	+	72	0	0	6993
P29274#4	0	72	72	P29274	126	198	+	72	P29274	0	1236	ENST00000610595.4	630	1866	++	230	P29274#4	0	72	ENST00000610595.4	756	828	+	72	0	0	6994
P29274#4	0	72	72	P29274	126	198	+	72	P29274	0	250	ENST00000496258.1	439	689	+	123	P29274#4	0	72	ENST00000496258.1	565	637	+	72	0	0	6995
P29274#4	0	72	72	P29274	126	198	+	72	P29274	0	325	ENST00000486108.1	601	926	+	115	P29274#4	0	72	ENST00000486108.1	727	799	+	72	0	0	6996
P29274#4	0	72	72	P29274	126	198	+	72	P29274	0	1095	ENST00000444262.6	422	1517	+	92	P29274#4	0	72	ENST00000444262.6	548	620	+	72	0	0	6997
P29274#4	0	72	72	P29274	126	198	+	72	P29274	0	230	ENST00000439591.1	330	560	+	90	P29274#4	0	72	ENST00000439591.1	456	528	+	72	0	0	6998
P29274#4	0	72	72	P29274	126	198	+	72	P29274	0	193	ENST00000436735.1	476	669	+	88	P29274#4	0	67	ENST00000436735.1	602	669	+	67	0	5	6999
P29274#4	0	72	72	P29274	126	198	+	72	P29274	0	263	ENST00000424232.5	306	569	+	80	P29274#4	0	72	ENST00000424232.5	432	504	+	72	0	0	7000
P29274#4	0	72	72	P29274	126	198	+	72	P29274	0	1236	ENST00000337539.12	422	1658	++	30	P29274#4	0	72	ENST00000337539.12	548	620	+	72	0	0	7001
P29274#5	0	33	33	P29274	198	231	+	33	P29274	0	1236	ENST00000618076.3	524	1760	++	233	P29274#5	0	33	ENST00000618076.3	722	755	+	33	0	0	7002
P29274#5	0	33	33	P29274	198	231	+	33	P29274	0	1236	ENST00000611543.4	306	1542	++	231	P29274#5	0	33	ENST00000611543.4	504	537	+	33	0	0	7003
P29274#5	0	33	33	P29274	198	231	+	33	P29274	0	1236	ENST00000610595.4	630	1866	++	230	P29274#5	0	33	ENST00000610595.4	828	861	+	33	0	0	7004
P29274#5	0	33	33	P29274	198	231	+	33	P29274	0	250	ENST00000496258.1	439	689	+	123	P29274#5	0	33	ENST00000496258.1	637	670	+	33	0	0	7005
P29274#5	0	33	33	P29274	198	231	+	33	P29274	0	325	ENST00000486108.1	601	926	+	115	P29274#5	0	33	ENST00000486108.1	799	832	+	33	0	0	7006
P29274#5	0	33	33	P29274	198	231	+	33	P29274	0	1095	ENST00000444262.6	422	1517	+	92	P29274#5	0	33	ENST00000444262.6	620	653	+	33	0	0	7007
P29274#5	0	33	33	P29274	198	231	+	33	P29274	0	230	ENST00000439591.1	330	560	+	90	P29274#5	0	32	ENST00000439591.1	528	560	+	32	0	1	7008
P29274#5	0	33	33	P29274	198	231	+	33	P29274	0	263	ENST00000424232.5	306	569	+	80	P29274#5	0	33	ENST00000424232.5	504	537	+	33	0	0	7009
P29274#5	0	33	33	P29274	198	231	+	33	P29274	0	1236	ENST00000337539.12	422	1658	++	30	P29274#5	0	33	ENST00000337539.12	620	653	+	33	0	0	7010
P29274#6	0	69	69	P29274	231	300	+	69	P29274	0	1236	ENST00000618076.3	524	1760	++	233	P29274#6	0	69	ENST00000618076.3	755	824	+	69	0	0	7011
P29274#6	0	69	69	P29274	231	300	+	69	P29274	0	1236	ENST00000611543.4	306	1542	++	231	P29274#6	0	69	ENST00000611543.4	537	606	+	69	0	0	7012
P29274#6	0	69	69	P29274	231	300	+	69	P29274	0	1236	ENST00000610595.4	630	1866	++	230	P29274#6	0	69	ENST00000610595.4	861	930	+	69	0	0	7013
P29274#6	0	69	69	P29274	231	300	+	69	P29274	0	250	ENST00000496258.1	439	689	+	123	P29274#6	0	19	ENST00000496258.1	670	689	+	19	0	50	7014
P29274#6	0	69	69	P29274	231	300	+	69	P29274	0	325	ENST00000486108.1	601	926	+	115	P29274#6	0	69	ENST00000486108.1	832	901	+	69	0	0	7015
P29274#6	0	69	69	P29274	231	300	+	69	P29274	0	1095	ENST00000444262.6	422	1517	+	92	P29274#6	0	69	ENST00000444262.6	653	722	+	69	0	0	7016
P29274#6	0	69	69	P29274	231	300	+	69	P29274	0	263	ENST00000424232.5	306	569	+	80	P29274#6	0	32	ENST00000424232.5	537	569	+	32	0	37	7017
P29274#6	0	69	69	P29274	231	300	+	69	P29274	0	1236	ENST00000337539.12	422	1658	++	30	P29274#6	0	69	ENST00000337539.12	653	722	+	69	0	0	7018
P29274#7	0	60	60	P29274	300	360	+	60	P29274	0	1236	ENST00000618076.3	524	1760	++	233	P29274#7	0	60	ENST00000618076.3	824	884	+	60	0	0	7019
P29274#7	0	60	60	P29274	300	360	+	60	P29274	0	1236	ENST00000611543.4	306	1542	++	231	P29274#7	0	60	ENST00000611543.4	606	666	+	60	0	0	7020
P29274#7	0	60	60	P29274	300	360	+	60	P29274	0	1236	ENST00000610595.4	630	1866	++	230	P29274#7	0	60	ENST00000610595.4	930	990	+	60	0	0	7021
P29274#7	0	60	60	P29274	300	360	+	60	P29274	0	325	ENST00000486108.1	601	926	+	115	P29274#7	0	25	ENST00000486108.1	901	926	+	25	0	35	7022
P29274#7	0	60	60	P29274	300	360	+	60	P29274	0	1095	ENST00000444262.6	422	1517	+	92	P29274#7	0	60	ENST00000444262.6	722	782	+	60	0	0	7023
P29274#7	0	60	60	P29274	300	360	+	60	P29274	0	1236	ENST00000337539.12	422	1658	++	30	P29274#7	0	60	ENST00000337539.12	722	782	+	60	0	0	7024
P29274#8	0	69	69	P29274	360	429	+	69	P29274	0	1236	ENST00000618076.3	524	1760	++	233	P29274#8	0	69	ENST00000618076.3	884	953	+	69	0	0	7025
P29274#8	0	69	69	P29274	360	429	+	69	P29274	0	1236	ENST00000611543.4	306	1542	++	231	P29274#8	0	69	ENST00000611543.4	666	735	+	69	0	0	7026
P29274#8	0	69	69	P29274	360	429	+	69	P29274	0	1236	ENST00000610595.4	630	1866	++	230	P29274#8	0	69	ENST00000610595.4	990	1059	+	69	0	0	7027
P29274#8	0	69	69	P29274	360	429	+	69	P29274	0	1095	ENST00000444262.6	422	1517	+	92	P29274#8	0	69	ENST00000444262.6	782	851	+	69	0	0	7028
P29274#8	0	69	69	P29274	360	429	+	69	P29274	0	1236	ENST00000337539.12	422	1658	++	30	P29274#8	0	69	ENST00000337539.12	782	851	+	69	0	0	7029
P29274#9	0	90	90	P29274	429	519	+	90	P29274	0	1236	ENST00000618076.3	524	1760	++	233	P29274#9	0	90	ENST00000618076.3	953	1043	+	90	0	0	7030
P29274#9	0	90	90	P29274	429	519	+	90	P29274	0	1236	ENST00000611543.4	306	1542	++	231	P29274#9	0	90	ENST00000611543.4	735	825	+	90	0	0	7031
P29274#9	0	90	90	P29274	429	519	+	90	P29274	0	1236	ENST00000610595.4	630	1866	++	230	P29274#9	0	90	ENST00000610595.4	1059	1149	+	90	0	0	7032
P29274#9	0	90	90	P29274	429	519	+	90	P29274	0	1095	ENST00000444262.6	422	1517	+	92	P29274#9	0	90	ENST00000444262.6	851	941	+	90	0	0	7033
P29274#9	0	90	90	P29274	429	519	+	90	P29274	0	1236	ENST00000337539.12	422	1658	++	30	P29274#9	0	90	ENST00000337539.12	851	941	+	90	0	0	7034
P29274#10	0	75	75	P29274	519	594	+	75	P29274	0	1236	ENST00000618076.3	524	1760	++	233	P29274#10	0	75	ENST00000618076.3	1043	1118	+	75	0	0	7035
P29274#10	0	75	75	P29274	519	594	+	75	P29274	0	1236	ENST00000611543.4	306	1542	++	231	P29274#10	0	75	ENST00000611543.4	825	900	+	75	0	0	7036
P29274#10	0	75	75	P29274	519	594	+	75	P29274	0	1236	ENST00000610595.4	630	1866	++	230	P29274#10	0	75	ENST00000610595.4	1149	1224	+	75	0	0	7037
P29274#10	0	75	75	P29274	519	594	+	75	P29274	0	1095	ENST00000444262.6	422	1517	+	92	P29274#10	0	75	ENST00000444262.6	941	1016	+	75	0	0	7038
P29274#10	0	75	75	P29274	519	594	+	75	P29274	0	1236	ENST00000337539.12	422	1658	++	30	P29274#10	0	75	ENST00000337539.12	941	1016	+	75	0	0	7039
P29274#11	0	108	108	P29274	594	702	+	108	P29274	0	1236	ENST00000618076.3	524	1760	++	233	P29274#11	0	108	ENST00000618076.3	1118	1226	+	108	0	0	7040
P29274#11	0	108	108	P29274	594	702	+	108	P29274	0	1236	ENST00000611543.4	306	1542	++	231	P29274#11	0	108	ENST00000611543.4	900	1008	+	108	0	0	7041
P29274#11	0	108	108	P29274	594	702	+	108	P29274	0	1236	ENST00000610595.4	630	1866	++	230	P29274#11	0	108	ENST00000610595.4	1224	1332	+	108	0	0	7042
P29274#11	0	108	108	P29274	594	702	+	108	P29274	0	1095	ENST00000444262.6	422	1517	+	92	P29274#11	0	108	ENST00000444262.6	1016	1124	+	108	0	0	7043
P29274#11	0	108	108	P29274	594	702	+	108	P29274	0	1236	ENST00000337539.12	422	1658	++	30	P29274#11	0	108	ENST00000337539.12	1016	1124	+	108	0	0	7044
P29274#12	0	72	72	P29274	702	774	+	72	P29274	0	1236	ENST00000618076.3	524	1760	++	233	P29274#12	0	72	ENST00000618076.3	1226	1298	+	72	0	0	7045
P29274#12	0	72	72	P29274	702	774	+	72	P29274	0	1236	ENST00000611543.4	306	1542	++	231	P29274#12	0	72	ENST00000611543.4	1008	1080	+	72	0	0	7046
P29274#12	0	72	72	P29274	702	774	+	72	P29274	0	1236	ENST00000610595.4	630	1866	++	230	P29274#12	0	72	ENST00000610595.4	1332	1404	+	72	0	0	7047
P29274#12	0	72	72	P29274	702	774	+	72	P29274	0	1095	ENST00000444262.6	422	1517	+	92	P29274#12	0	72	ENST00000444262.6	1124	1196	+	72	0	0	7048
P29274#12	0	72	72	P29274	702	774	+	72	P29274	0	1236	ENST00000337539.12	422	1658	++	30	P29274#12	0	72	ENST00000337539.12	1124	1196	+	72	0	0	7049
P29274#13	0	24	24	P29274	774	798	+	24	P29274	0	1236	ENST00000618076.3	524	1760	++	233	P29274#13	0	24	ENST00000618076.3	1298	1322	+	24	0	0	7050
P29274#13	0	24	24	P29274	774	798	+	24	P29274	0	1236	ENST00000611543.4	306	1542	++	231	P29274#13	0	24	ENST00000611543.4	1080	1104	+	24	0	0	7051
P29274#13	0	24	24	P29274	774	798	+	24	P29274	0	1236	ENST00000610595.4	630	1866	++	230	P29274#13	0	24	ENST00000610595.4	1404	1428	+	24	0	0	7052
P29274#13	0	24	24	P29274	774	798	+	24	P29274	0	1095	ENST00000444262.6	422	1517	+	92	P29274#13	0	24	ENST00000444262.6	1196	1220	+	24	0	0	7053
P29274#13	0	24	24	P29274	774	798	+	24	P29274	0	1236	ENST00000337539.12	422	1658	++	30	P29274#13	0	24	ENST00000337539.12	1196	1220	+	24	0	0	7054
P29274#14	0	72	72	P29274	798	870	+	72	P29274	0	1236	ENST00000618076.3	524	1760	++	233	P29274#14	0	72	ENST00000618076.3	1322	1394	+	72	0	0	7055
P29274#14	0	72	72	P29274	798	870	+	72	P29274	0	1236	ENST00000611543.4	306	1542	++	231	P29274#14	0	72	ENST00000611543.4	1104	1176	+	72	0	0	7056
P29274#14	0	72	72	P29274	798	870	+	72	P29274	0	1236	ENST00000610595.4	630	1866	++	230	P29274#14	0	72	ENST00000610595.4	1428	1500	+	72	0	0	7057
P29274#14	0	72	72	P29274	798	870	+	72	P29274	0	1095	ENST00000444262.6	422	1517	+	92	P29274#14	0	72	ENST00000444262.6	1220	1292	+	72	0	0	7058
P29274#14	0	72	72	P29274	798	870	+	72	P29274	0	1236	ENST00000337539.12	422	1658	++	30	P29274#14	0	72	ENST00000337539.12	1220	1292	+	72	0	0	7059
P29274#15	0	366	366	P29274	870	1236	+	366	P29274	0	1236	ENST00000618076.3	524	1760	++	233	P29274#15	0	366	ENST00000618076.3	1394	1760	+	366	0	0	7060
P29274#15	0	366	366	P29274	870	1236	+	366	P29274	0	1236	ENST00000611543.4	306	1542	++	231	P29274#15	0	366	ENST00000611543.4	1176	1542	+	366	0	0	7061
P29274#15	0	366	366	P29274	870	1236	+	366	P29274	0	1236	ENST00000610595.4	630	1866	++	230	P29274#15	0	366	ENST00000610595.4	1500	1866	+	366	0	0	7062
P29274#15	0	366	366	P29274	870	1236	+	366	P29274	0	1095	ENST00000444262.6	422	1517	+	92	P29274#15	0	225	ENST00000444262.6	1292	1517	+	225	0	141	7063
P29274#15	0	366	366	P29274	870	1236	+	366	P29274	0	1236	ENST00000337539.12	422	1658	++	30	P29274#15	0	366	ENST00000337539.12	1292	1658	+	366	0	0	7064
P29274#16	0	66	66	P29274	1170	1236	+	66	P29274	0	1236	ENST00000618076.3	524	1760	++	233	P29274#16	0	66	ENST00000618076.3	1694	1760	+	66	0	0	7065
P29274#16	0	66	66	P29274	1170	1236	+	66	P29274	0	1236	ENST00000611543.4	306	1542	++	231	P29274#16	0	66	ENST00000611543.4	1476	1542	+	66	0	0	7066
P29274#16	0	66	66	P29274	1170	1236	+	66	P29274	0	1236	ENST00000610595.4	630	1866	++	230	P29274#16	0	66	ENST00000610595.4	1800	1866	+	66	0	0	7067
P29274#16	0	66	66	P29274	1170	1236	+	66	P29274	0	1236	ENST00000337539.12	422	1658	++	30	P29274#16	0	66	ENST00000337539.12	1592	1658	+	66	0	0	7068
P29274#17	0	3	3	P29274	504	507	+	3	P29274	0	1236	ENST00000618076.3	524	1760	++	233	P29274#17	0	3	ENST00000618076.3	1028	1031	+	3	0	0	7069
P29274#17	0	3	3	P29274	504	507	+	3	P29274	0	1236	ENST00000611543.4	306	1542	++	231	P29274#17	0	3	ENST00000611543.4	810	813	+	3	0	0	7070
P29274#17	0	3	3	P29274	504	507	+	3	P29274	0	1236	ENST00000610595.4	630	1866	++	230	P29274#17	0	3	ENST00000610595.4	1134	1137	+	3	0	0	7071
P29274#17	0	3	3	P29274	504	507	+	3	P29274	0	1095	ENST00000444262.6	422	1517	+	92	P29274#17	0	3	ENST00000444262.6	926	929	+	3	0	0	7072
P29274#17	0	3	3	P29274	504	507	+	3	P29274	0	1236	ENST00000337539.12	422	1658	++	30	P29274#17	0	3	ENST00000337539.12	926	929	+	3	0	0	7073
P29274#18	0	3	3	P29274	756	759	+	3	P29274	0	1236	ENST00000618076.3	524	1760	++	233	P29274#18	0	3	ENST00000618076.3	1280	1283	+	3	0	0	7074
P29274#18	0	3	3	P29274	756	759	+	3	P29274	0	1236	ENST00000611543.4	306	1542	++	231	P29274#18	0	3	ENST00000611543.4	1062	1065	+	3	0	0	7075
P29274#18	0	3	3	P29274	756	759	+	3	P29274	0	1236	ENST00000610595.4	630	1866	++	230	P29274#18	0	3	ENST00000610595.4	1386	1389	+	3	0	0	7076
P29274#18	0	3	3	P29274	756	759	+	3	P29274	0	1095	ENST00000444262.6	422	1517	+	92	P29274#18	0	3	ENST00000444262.6	1178	1181	+	3	0	0	7077
P29274#18	0	3	3	P29274	756	759	+	3	P29274	0	1236	ENST00000337539.12	422	1658	++	30	P29274#18	0	3	ENST00000337539.12	1178	1181	+	3	0	0	7078
P29274#19	0	3	3	P29274	828	831	+	3	P29274	0	1236	ENST00000618076.3	524	1760	++	233	P29274#19	0	3	ENST00000618076.3	1352	1355	+	3	0	0	7079
P29274#19	0	3	3	P29274	828	831	+	3	P29274	0	1236	ENST00000611543.4	306	1542	++	231	P29274#19	0	3	ENST00000611543.4	1134	1137	+	3	0	0	7080
P29274#19	0	3	3	P29274	828	831	+	3	P29274	0	1236	ENST00000610595.4	630	1866	++	230	P29274#19	0	3	ENST00000610595.4	1458	1461	+	3	0	0	7081
P29274#19	0	3	3	P29274	828	831	+	3	P29274	0	1095	ENST00000444262.6	422	1517	+	92	P29274#19	0	3	ENST00000444262.6	1250	1253	+	3	0	0	7082
P29274#19	0	3	3	P29274	828	831	+	3	P29274	0	1236	ENST00000337539.12	422	1658	++	30	P29274#19	0	3	ENST00000337539.12	1250	1253	+	3	0	0	7083
P29274#20	0	3	3	P29274	831	834	+	3	P29274	0	1236	ENST00000618076.3	524	1760	++	233	P29274#20	0	3	ENST00000618076.3	1355	1358	+	3	0	0	7084
P29274#20	0	3	3	P29274	831	834	+	3	P29274	0	1236	ENST00000611543.4	306	1542	++	231	P29274#20	0	3	ENST00000611543.4	1137	1140	+	3	0	0	7085
P29274#20	0	3	3	P29274	831	834	+	3	P29274	0	1236	ENST00000610595.4	630	1866	++	230	P29274#20	0	3	ENST00000610595.4	1461	1464	+	3	0	0	7086
P29274#20	0	3	3	P29274	831	834	+	3	P29274	0	1095	ENST00000444262.6	422	1517	+	92	P29274#20	0	3	ENST00000444262.6	1253	1256	+	3	0	0	7087
P29274#20	0	3	3	P29274	831	834	+	3	P29274	0	1236	ENST00000337539.12	422	1658	++	30	P29274#20	0	3	ENST00000337539.12	1253	1256	+	3	0	0	7088
P29274#21	0	3	3	P29274	459	462	+	3	P29274	0	1236	ENST00000618076.3	524	1760	++	233	P29274#21	0	3	ENST00000618076.3	983	986	+	3	0	0	7089
P29274#21	0	3	3	P29274	459	462	+	3	P29274	0	1236	ENST00000611543.4	306	1542	++	231	P29274#21	0	3	ENST00000611543.4	765	768	+	3	0	0	7090
P29274#21	0	3	3	P29274	459	462	+	3	P29274	0	1236	ENST00000610595.4	630	1866	++	230	P29274#21	0	3	ENST00000610595.4	1089	1092	+	3	0	0	7091
P29274#21	0	3	3	P29274	459	462	+	3	P29274	0	1095	ENST00000444262.6	422	1517	+	92	P29274#21	0	3	ENST00000444262.6	881	884	+	3	0	0	7092
P29274#21	0	3	3	P29274	459	462	+	3	P29274	0	1236	ENST00000337539.12	422	1658	++	30	P29274#21	0	3	ENST00000337539.12	881	884	+	3	0	0	7093
P29274#22	0	267	267	P29274	210	477	+	267	P29274	0	1236	ENST00000618076.3	524	1760	++	233	P29274#22	0	267	ENST00000618076.3	734	1001	+	267	0	0	7094
P29274#22	0	267	267	P29274	210	477	+	267	P29274	0	1236	ENST00000611543.4	306	1542	++	231	P29274#22	0	267	ENST00000611543.4	516	783	+	267	0	0	7095
P29274#22	0	267	267	P29274	210	477	+	267	P29274	0	1236	ENST00000610595.4	630	1866	++	230	P29274#22	0	267	ENST00000610595.4	840	1107	+	267	0	0	7096
P29274#22	0	267	267	P29274	210	477	+	267	P29274	0	250	ENST00000496258.1	439	689	+	123	P29274#22	0	40	ENST00000496258.1	649	689	+	40	0	227	7097
P29274#22	0	267	267	P29274	210	477	+	267	P29274	0	325	ENST00000486108.1	601	926	+	115	P29274#22	0	115	ENST00000486108.1	811	926	+	115	0	152	7098
P29274#22	0	267	267	P29274	210	477	+	267	P29274	0	1095	ENST00000444262.6	422	1517	+	92	P29274#22	0	267	ENST00000444262.6	632	899	+	267	0	0	7099
P29274#22	0	267	267	P29274	210	477	+	267	P29274	0	230	ENST00000439591.1	330	560	+	90	P29274#22	0	20	ENST00000439591.1	540	560	+	20	0	247	7100
P29274#22	0	267	267	P29274	210	477	+	267	P29274	0	263	ENST00000424232.5	306	569	+	80	P29274#22	0	53	ENST00000424232.5	516	569	+	53	0	214	7101
P29274#22	0	267	267	P29274	210	477	+	267	P29274	0	1236	ENST00000337539.12	422	1658	++	30	P29274#22	0	267	ENST00000337539.12	632	899	+	267	0	0	7102
P29274#23	0	219	219	P29274	219	438	+	219	P29274	0	1236	ENST00000618076.3	524	1760	++	233	P29274#23	0	219	ENST00000618076.3	743	962	+	219	0	0	7103
P29274#23	0	219	219	P29274	219	438	+	219	P29274	0	1236	ENST00000611543.4	306	1542	++	231	P29274#23	0	219	ENST00000611543.4	525	744	+	219	0	0	7104
P29274#23	0	219	219	P29274	219	438	+	219	P29274	0	1236	ENST00000610595.4	630	1866	++	230	P29274#23	0	219	ENST00000610595.4	849	1068	+	219	0	0	7105
P29274#23	0	219	219	P29274	219	438	+	219	P29274	0	250	ENST00000496258.1	439	689	+	123	P29274#23	0	31	ENST00000496258.1	658	689	+	31	0	188	7106
P29274#23	0	219	219	P29274	219	438	+	219	P29274	0	325	ENST00000486108.1	601	926	+	115	P29274#23	0	106	ENST00000486108.1	820	926	+	106	0	113	7107
P29274#23	0	219	219	P29274	219	438	+	219	P29274	0	1095	ENST00000444262.6	422	1517	+	92	P29274#23	0	219	ENST00000444262.6	641	860	+	219	0	0	7108
P29274#23	0	219	219	P29274	219	438	+	219	P29274	0	230	ENST00000439591.1	330	560	+	90	P29274#23	0	11	ENST00000439591.1	549	560	+	11	0	208	7109
P29274#23	0	219	219	P29274	219	438	+	219	P29274	0	263	ENST00000424232.5	306	569	+	80	P29274#23	0	44	ENST00000424232.5	525	569	+	44	0	175	7110
P29274#23	0	219	219	P29274	219	438	+	219	P29274	0	1236	ENST00000337539.12	422	1658	++	30	P29274#23	0	219	ENST00000337539.12	641	860	+	219	0	0	7111
P29274#24	0	270	270	P29274	228	498	+	270	P29274	0	1236	ENST00000618076.3	524	1760	++	233	P29274#24	0	270	ENST00000618076.3	752	1022	+	270	0	0	7112
P29274#24	0	270	270	P29274	228	498	+	270	P29274	0	1236	ENST00000611543.4	306	1542	++	231	P29274#24	0	270	ENST00000611543.4	534	804	+	270	0	0	7113
P29274#24	0	270	270	P29274	228	498	+	270	P29274	0	1236	ENST00000610595.4	630	1866	++	230	P29274#24	0	270	ENST00000610595.4	858	1128	+	270	0	0	7114
P29274#24	0	270	270	P29274	228	498	+	270	P29274	0	250	ENST00000496258.1	439	689	+	123	P29274#24	0	22	ENST00000496258.1	667	689	+	22	0	248	7115
P29274#24	0	270	270	P29274	228	498	+	270	P29274	0	325	ENST00000486108.1	601	926	+	115	P29274#24	0	97	ENST00000486108.1	829	926	+	97	0	173	7116
P29274#24	0	270	270	P29274	228	498	+	270	P29274	0	1095	ENST00000444262.6	422	1517	+	92	P29274#24	0	270	ENST00000444262.6	650	920	+	270	0	0	7117
P29274#24	0	270	270	P29274	228	498	+	270	P29274	0	230	ENST00000439591.1	330	560	+	90	P29274#24	0	2	ENST00000439591.1	558	560	+	2	0	268	7118
P29274#24	0	270	270	P29274	228	498	+	270	P29274	0	263	ENST00000424232.5	306	569	+	80	P29274#24	0	35	ENST00000424232.5	534	569	+	35	0	235	7119
P29274#24	0	270	270	P29274	228	498	+	270	P29274	0	1236	ENST00000337539.12	422	1658	++	30	P29274#24	0	270	ENST00000337539.12	650	920	+	270	0	0	7120
P29274#25	0	12	12	P29274	774	786	+	12	P29274	0	1236	ENST00000618076.3	524	1760	++	233	P29274#25	0	12	ENST00000618076.3	1298	1310	+	12	0	0	7121
P29274#25	0	12	12	P29274	774	786	+	12	P29274	0	1236	ENST00000611543.4	306	1542	++	231	P29274#25	0	12	ENST00000611543.4	1080	1092	+	12	0	0	7122
P29274#25	0	12	12	P29274	774	786	+	12	P29274	0	1236	ENST00000610595.4	630	1866	++	230	P29274#25	0	12	ENST00000610595.4	1404	1416	+	12	0	0	7123
P29274#25	0	12	12	P29274	774	786	+	12	P29274	0	1095	ENST00000444262.6	422	1517	+	92	P29274#25	0	12	ENST00000444262.6	1196	1208	+	12	0	0	7124
P29274#25	0	12	12	P29274	774	786	+	12	P29274	0	1236	ENST00000337539.12	422	1658	++	30	P29274#25	0	12	ENST00000337539.12	1196	1208	+	12	0	0	7125
P29274#26	0	3	3	P29274	147	150	+	3	P29274	0	1236	ENST00000618076.3	524	1760	++	233	P29274#26	0	3	ENST00000618076.3	671	674	+	3	0	0	7126
P29274#26	0	3	3	P29274	147	150	+	3	P29274	0	1236	ENST00000611543.4	306	1542	++	231	P29274#26	0	3	ENST00000611543.4	453	456	+	3	0	0	7127
P29274#26	0	3	3	P29274	147	150	+	3	P29274	0	1236	ENST00000610595.4	630	1866	++	230	P29274#26	0	3	ENST00000610595.4	777	780	+	3	0	0	7128
P29274#26	0	3	3	P29274	147	150	+	3	P29274	0	250	ENST00000496258.1	439	689	+	123	P29274#26	0	3	ENST00000496258.1	586	589	+	3	0	0	7129
P29274#26	0	3	3	P29274	147	150	+	3	P29274	0	325	ENST00000486108.1	601	926	+	115	P29274#26	0	3	ENST00000486108.1	748	751	+	3	0	0	7130
P29274#26	0	3	3	P29274	147	150	+	3	P29274	0	1095	ENST00000444262.6	422	1517	+	92	P29274#26	0	3	ENST00000444262.6	569	572	+	3	0	0	7131
P29274#26	0	3	3	P29274	147	150	+	3	P29274	0	230	ENST00000439591.1	330	560	+	90	P29274#26	0	3	ENST00000439591.1	477	480	+	3	0	0	7132
P29274#26	0	3	3	P29274	147	150	+	3	P29274	0	193	ENST00000436735.1	476	669	+	88	P29274#26	0	3	ENST00000436735.1	623	626	+	3	0	0	7133
P29274#26	0	3	3	P29274	147	150	+	3	P29274	0	263	ENST00000424232.5	306	569	+	80	P29274#26	0	3	ENST00000424232.5	453	456	+	3	0	0	7134
P29274#26	0	3	3	P29274	147	150	+	3	P29274	0	1236	ENST00000337539.12	422	1658	++	30	P29274#26	0	3	ENST00000337539.12	569	572	+	3	0	0	7135
P29274#27	0	3	3	P29274	897	900	+	3	P29274	0	1236	ENST00000618076.3	524	1760	++	233	P29274#27	0	3	ENST00000618076.3	1421	1424	+	3	0	0	7136
P29274#27	0	3	3	P29274	897	900	+	3	P29274	0	1236	ENST00000611543.4	306	1542	++	231	P29274#27	0	3	ENST00000611543.4	1203	1206	+	3	0	0	7137
P29274#27	0	3	3	P29274	897	900	+	3	P29274	0	1236	ENST00000610595.4	630	1866	++	230	P29274#27	0	3	ENST00000610595.4	1527	1530	+	3	0	0	7138
P29274#27	0	3	3	P29274	897	900	+	3	P29274	0	1095	ENST00000444262.6	422	1517	+	92	P29274#27	0	3	ENST00000444262.6	1319	1322	+	3	0	0	7139
P29274#27	0	3	3	P29274	897	900	+	3	P29274	0	1236	ENST00000337539.12	422	1658	++	30	P29274#27	0	3	ENST00000337539.12	1319	1322	+	3	0	0	7140
P29274#28	0	3	3	P29274	1173	1176	+	3	P29274	0	1236	ENST00000618076.3	524	1760	++	233	P29274#28	0	3	ENST00000618076.3	1697	1700	+	3	0	0	7141
P29274#28	0	3	3	P29274	1173	1176	+	3	P29274	0	1236	ENST00000611543.4	306	1542	++	231	P29274#28	0	3	ENST00000611543.4	1479	1482	+	3	0	0	7142
P29274#28	0	3	3	P29274	1173	1176	+	3	P29274	0	1236	ENST00000610595.4	630	1866	++	230	P29274#28	0	3	ENST00000610595.4	1803	1806	+	3	0	0	7143
P29274#28	0	3	3	P29274	1173	1176	+	3	P29274	0	1236	ENST00000337539.12	422	1658	++	30	P29274#28	0	3	ENST00000337539.12	1595	1598	+	3	0	0	7144
P29274#29	0	96	96	P29274	3	99	+	96	P29274	0	1236	ENST00000618076.3	524	1760	++	233	P29274#29	0	96	ENST00000618076.3	527	623	+	96	0	0	7145
P29274#29	0	96	96	P29274	3	99	+	96	P29274	0	1236	ENST00000611543.4	306	1542	++	231	P29274#29	0	96	ENST00000611543.4	309	405	+	96	0	0	7146
P29274#29	0	96	96	P29274	3	99	+	96	P29274	0	1236	ENST00000610595.4	630	1866	++	230	P29274#29	0	96	ENST00000610595.4	633	729	+	96	0	0	7147
P29274#29	0	96	96	P29274	3	99	+	96	P29274	0	250	ENST00000496258.1	439	689	+	123	P29274#29	0	96	ENST00000496258.1	442	538	+	96	0	0	7148
P29274#29	0	96	96	P29274	3	99	+	96	P29274	0	325	ENST00000486108.1	601	926	+	115	P29274#29	0	96	ENST00000486108.1	604	700	+	96	0	0	7149
P29274#29	0	96	96	P29274	3	99	+	96	P29274	0	88	ENST00000472248.5	630	718	+	109	P29274#29	0	85	ENST00000472248.5	633	718	+	85	0	11	7150
P29274#29	0	96	96	P29274	3	99	+	96	P29274	0	19	ENST00000464977.5	539	558	+	107	P29274#29	0	16	ENST00000464977.5	542	558	+	16	0	80	7151
P29274#29	0	96	96	P29274	3	99	+	96	P29274	0	1095	ENST00000444262.6	422	1517	+	92	P29274#29	0	96	ENST00000444262.6	425	521	+	96	0	0	7152
P29274#29	0	96	96	P29274	3	99	+	96	P29274	0	230	ENST00000439591.1	330	560	+	90	P29274#29	0	96	ENST00000439591.1	333	429	+	96	0	0	7153
P29274#29	0	96	96	P29274	3	99	+	96	P29274	0	193	ENST00000436735.1	476	669	+	88	P29274#29	0	96	ENST00000436735.1	479	575	+	96	0	0	7154
P29274#29	0	96	96	P29274	3	99	+	96	P29274	0	263	ENST00000424232.5	306	569	+	80	P29274#29	0	96	ENST00000424232.5	309	405	+	96	0	0	7155
P29274#29	0	96	96	P29274	3	99	+	96	P29274	0	1236	ENST00000337539.12	422	1658	++	30	P29274#29	0	96	ENST00000337539.12	425	521	+	96	0	0	7156
P29274#30	0	9	9	P29274	102	111	+	9	P29274	0	1236	ENST00000618076.3	524	1760	++	233	P29274#30	0	9	ENST00000618076.3	626	635	+	9	0	0	7157
P29274#30	0	9	9	P29274	102	111	+	9	P29274	0	1236	ENST00000611543.4	306	1542	++	231	P29274#30	0	9	ENST00000611543.4	408	417	+	9	0	0	7158
P29274#30	0	9	9	P29274	102	111	+	9	P29274	0	1236	ENST00000610595.4	630	1866	++	230	P29274#30	0	9	ENST00000610595.4	732	741	+	9	0	0	7159
P29274#30	0	9	9	P29274	102	111	+	9	P29274	0	250	ENST00000496258.1	439	689	+	123	P29274#30	0	9	ENST00000496258.1	541	550	+	9	0	0	7160
P29274#30	0	9	9	P29274	102	111	+	9	P29274	0	325	ENST00000486108.1	601	926	+	115	P29274#30	0	9	ENST00000486108.1	703	712	+	9	0	0	7161
P29274#30	0	9	9	P29274	102	111	+	9	P29274	0	1095	ENST00000444262.6	422	1517	+	92	P29274#30	0	9	ENST00000444262.6	524	533	+	9	0	0	7162
P29274#30	0	9	9	P29274	102	111	+	9	P29274	0	230	ENST00000439591.1	330	560	+	90	P29274#30	0	9	ENST00000439591.1	432	441	+	9	0	0	7163
P29274#30	0	9	9	P29274	102	111	+	9	P29274	0	193	ENST00000436735.1	476	669	+	88	P29274#30	0	9	ENST00000436735.1	578	587	+	9	0	0	7164
P29274#30	0	9	9	P29274	102	111	+	9	P29274	0	263	ENST00000424232.5	306	569	+	80	P29274#30	0	9	ENST00000424232.5	408	417	+	9	0	0	7165
P29274#30	0	9	9	P29274	102	111	+	9	P29274	0	1236	ENST00000337539.12	422	1658	++	30	P29274#30	0	9	ENST00000337539.12	524	533	+	9	0	0	7166
P29274#31	0	54	54	P29274	117	171	+	54	P29274	0	1236	ENST00000618076.3	524	1760	++	233	P29274#31	0	54	ENST00000618076.3	641	695	+	54	0	0	7167
P29274#31	0	54	54	P29274	117	171	+	54	P29274	0	1236	ENST00000611543.4	306	1542	++	231	P29274#31	0	54	ENST00000611543.4	423	477	+	54	0	0	7168
P29274#31	0	54	54	P29274	117	171	+	54	P29274	0	1236	ENST00000610595.4	630	1866	++	230	P29274#31	0	54	ENST00000610595.4	747	801	+	54	0	0	7169
P29274#31	0	54	54	P29274	117	171	+	54	P29274	0	250	ENST00000496258.1	439	689	+	123	P29274#31	0	54	ENST00000496258.1	556	610	+	54	0	0	7170
P29274#31	0	54	54	P29274	117	171	+	54	P29274	0	325	ENST00000486108.1	601	926	+	115	P29274#31	0	54	ENST00000486108.1	718	772	+	54	0	0	7171
P29274#31	0	54	54	P29274	117	171	+	54	P29274	0	1095	ENST00000444262.6	422	1517	+	92	P29274#31	0	54	ENST00000444262.6	539	593	+	54	0	0	7172
P29274#31	0	54	54	P29274	117	171	+	54	P29274	0	230	ENST00000439591.1	330	560	+	90	P29274#31	0	54	ENST00000439591.1	447	501	+	54	0	0	7173
P29274#31	0	54	54	P29274	117	171	+	54	P29274	0	193	ENST00000436735.1	476	669	+	88	P29274#31	0	54	ENST00000436735.1	593	647	+	54	0	0	7174
P29274#31	0	54	54	P29274	117	171	+	54	P29274	0	263	ENST00000424232.5	306	569	+	80	P29274#31	0	54	ENST00000424232.5	423	477	+	54	0	0	7175
P29274#31	0	54	54	P29274	117	171	+	54	P29274	0	1236	ENST00000337539.12	422	1658	++	30	P29274#31	0	54	ENST00000337539.12	539	593	+	54	0	0	7176
P29274#32	0	27	27	P29274	174	201	+	27	P29274	0	1236	ENST00000618076.3	524	1760	++	233	P29274#32	0	27	ENST00000618076.3	698	725	+	27	0	0	7177
P29274#32	0	27	27	P29274	174	201	+	27	P29274	0	1236	ENST00000611543.4	306	1542	++	231	P29274#32	0	27	ENST00000611543.4	480	507	+	27	0	0	7178
P29274#32	0	27	27	P29274	174	201	+	27	P29274	0	1236	ENST00000610595.4	630	1866	++	230	P29274#32	0	27	ENST00000610595.4	804	831	+	27	0	0	7179
P29274#32	0	27	27	P29274	174	201	+	27	P29274	0	250	ENST00000496258.1	439	689	+	123	P29274#32	0	27	ENST00000496258.1	613	640	+	27	0	0	7180
P29274#32	0	27	27	P29274	174	201	+	27	P29274	0	325	ENST00000486108.1	601	926	+	115	P29274#32	0	27	ENST00000486108.1	775	802	+	27	0	0	7181
P29274#32	0	27	27	P29274	174	201	+	27	P29274	0	1095	ENST00000444262.6	422	1517	+	92	P29274#32	0	27	ENST00000444262.6	596	623	+	27	0	0	7182
P29274#32	0	27	27	P29274	174	201	+	27	P29274	0	230	ENST00000439591.1	330	560	+	90	P29274#32	0	27	ENST00000439591.1	504	531	+	27	0	0	7183
P29274#32	0	27	27	P29274	174	201	+	27	P29274	0	193	ENST00000436735.1	476	669	+	88	P29274#32	0	19	ENST00000436735.1	650	669	+	19	0	8	7184
P29274#32	0	27	27	P29274	174	201	+	27	P29274	0	263	ENST00000424232.5	306	569	+	80	P29274#32	0	27	ENST00000424232.5	480	507	+	27	0	0	7185
P29274#32	0	27	27	P29274	174	201	+	27	P29274	0	1236	ENST00000337539.12	422	1658	++	30	P29274#32	0	27	ENST00000337539.12	596	623	+	27	0	0	7186
P29274#33	0	9	9	P29274	210	219	+	9	P29274	0	1236	ENST00000618076.3	524	1760	++	233	P29274#33	0	9	ENST00000618076.3	734	743	+	9	0	0	7187
P29274#33	0	9	9	P29274	210	219	+	9	P29274	0	1236	ENST00000611543.4	306	1542	++	231	P29274#33	0	9	ENST00000611543.4	516	525	+	9	0	0	7188
P29274#33	0	9	9	P29274	210	219	+	9	P29274	0	1236	ENST00000610595.4	630	1866	++	230	P29274#33	0	9	ENST00000610595.4	840	849	+	9	0	0	7189
P29274#33	0	9	9	P29274	210	219	+	9	P29274	0	250	ENST00000496258.1	439	689	+	123	P29274#33	0	9	ENST00000496258.1	649	658	+	9	0	0	7190
P29274#33	0	9	9	P29274	210	219	+	9	P29274	0	325	ENST00000486108.1	601	926	+	115	P29274#33	0	9	ENST00000486108.1	811	820	+	9	0	0	7191
P29274#33	0	9	9	P29274	210	219	+	9	P29274	0	1095	ENST00000444262.6	422	1517	+	92	P29274#33	0	9	ENST00000444262.6	632	641	+	9	0	0	7192
P29274#33	0	9	9	P29274	210	219	+	9	P29274	0	230	ENST00000439591.1	330	560	+	90	P29274#33	0	9	ENST00000439591.1	540	549	+	9	0	0	7193
P29274#33	0	9	9	P29274	210	219	+	9	P29274	0	263	ENST00000424232.5	306	569	+	80	P29274#33	0	9	ENST00000424232.5	516	525	+	9	0	0	7194
P29274#33	0	9	9	P29274	210	219	+	9	P29274	0	1236	ENST00000337539.12	422	1658	++	30	P29274#33	0	9	ENST00000337539.12	632	641	+	9	0	0	7195
P29274#34	0	102	102	P29274	219	321	+	102	P29274	0	1236	ENST00000618076.3	524	1760	++	233	P29274#34	0	102	ENST00000618076.3	743	845	+	102	0	0	7196
P29274#34	0	102	102	P29274	219	321	+	102	P29274	0	1236	ENST00000611543.4	306	1542	++	231	P29274#34	0	102	ENST00000611543.4	525	627	+	102	0	0	7197
P29274#34	0	102	102	P29274	219	321	+	102	P29274	0	1236	ENST00000610595.4	630	1866	++	230	P29274#34	0	102	ENST00000610595.4	849	951	+	102	0	0	7198
P29274#34	0	102	102	P29274	219	321	+	102	P29274	0	250	ENST00000496258.1	439	689	+	123	P29274#34	0	31	ENST00000496258.1	658	689	+	31	0	71	7199
P29274#34	0	102	102	P29274	219	321	+	102	P29274	0	325	ENST00000486108.1	601	926	+	115	P29274#34	0	102	ENST00000486108.1	820	922	+	102	0	0	7200
P29274#34	0	102	102	P29274	219	321	+	102	P29274	0	1095	ENST00000444262.6	422	1517	+	92	P29274#34	0	102	ENST00000444262.6	641	743	+	102	0	0	7201
P29274#34	0	102	102	P29274	219	321	+	102	P29274	0	230	ENST00000439591.1	330	560	+	90	P29274#34	0	11	ENST00000439591.1	549	560	+	11	0	91	7202
P29274#34	0	102	102	P29274	219	321	+	102	P29274	0	263	ENST00000424232.5	306	569	+	80	P29274#34	0	44	ENST00000424232.5	525	569	+	44	0	58	7203
P29274#34	0	102	102	P29274	219	321	+	102	P29274	0	1236	ENST00000337539.12	422	1658	++	30	P29274#34	0	102	ENST00000337539.12	641	743	+	102	0	0	7204
P29274#35	0	21	21	P29274	324	345	+	21	P29274	0	1236	ENST00000618076.3	524	1760	++	233	P29274#35	0	21	ENST00000618076.3	848	869	+	21	0	0	7205
P29274#35	0	21	21	P29274	324	345	+	21	P29274	0	1236	ENST00000611543.4	306	1542	++	231	P29274#35	0	21	ENST00000611543.4	630	651	+	21	0	0	7206
P29274#35	0	21	21	P29274	324	345	+	21	P29274	0	1236	ENST00000610595.4	630	1866	++	230	P29274#35	0	21	ENST00000610595.4	954	975	+	21	0	0	7207
P29274#35	0	21	21	P29274	324	345	+	21	P29274	0	325	ENST00000486108.1	601	926	+	115	P29274#35	0	1	ENST00000486108.1	925	926	+	1	0	20	7208
P29274#35	0	21	21	P29274	324	345	+	21	P29274	0	1095	ENST00000444262.6	422	1517	+	92	P29274#35	0	21	ENST00000444262.6	746	767	+	21	0	0	7209
P29274#35	0	21	21	P29274	324	345	+	21	P29274	0	1236	ENST00000337539.12	422	1658	++	30	P29274#35	0	21	ENST00000337539.12	746	767	+	21	0	0	7210
P29274#36	0	57	57	P29274	351	408	+	57	P29274	0	1236	ENST00000618076.3	524	1760	++	233	P29274#36	0	57	ENST00000618076.3	875	932	+	57	0	0	7211
P29274#36	0	57	57	P29274	351	408	+	57	P29274	0	1236	ENST00000611543.4	306	1542	++	231	P29274#36	0	57	ENST00000611543.4	657	714	+	57	0	0	7212
P29274#36	0	57	57	P29274	351	408	+	57	P29274	0	1236	ENST00000610595.4	630	1866	++	230	P29274#36	0	57	ENST00000610595.4	981	1038	+	57	0	0	7213
P29274#36	0	57	57	P29274	351	408	+	57	P29274	0	1095	ENST00000444262.6	422	1517	+	92	P29274#36	0	57	ENST00000444262.6	773	830	+	57	0	0	7214
P29274#36	0	57	57	P29274	351	408	+	57	P29274	0	1236	ENST00000337539.12	422	1658	++	30	P29274#36	0	57	ENST00000337539.12	773	830	+	57	0	0	7215
P29274#37	0	12	12	P29274	411	423	+	12	P29274	0	1236	ENST00000618076.3	524	1760	++	233	P29274#37	0	12	ENST00000618076.3	935	947	+	12	0	0	7216
P29274#37	0	12	12	P29274	411	423	+	12	P29274	0	1236	ENST00000611543.4	306	1542	++	231	P29274#37	0	12	ENST00000611543.4	717	729	+	12	0	0	7217
P29274#37	0	12	12	P29274	411	423	+	12	P29274	0	1236	ENST00000610595.4	630	1866	++	230	P29274#37	0	12	ENST00000610595.4	1041	1053	+	12	0	0	7218
P29274#37	0	12	12	P29274	411	423	+	12	P29274	0	1095	ENST00000444262.6	422	1517	+	92	P29274#37	0	12	ENST00000444262.6	833	845	+	12	0	0	7219
P29274#37	0	12	12	P29274	411	423	+	12	P29274	0	1236	ENST00000337539.12	422	1658	++	30	P29274#37	0	12	ENST00000337539.12	833	845	+	12	0	0	7220
P29274#38	0	15	15	P29274	429	444	+	15	P29274	0	1236	ENST00000618076.3	524	1760	++	233	P29274#38	0	15	ENST00000618076.3	953	968	+	15	0	0	7221
P29274#38	0	15	15	P29274	429	444	+	15	P29274	0	1236	ENST00000611543.4	306	1542	++	231	P29274#38	0	15	ENST00000611543.4	735	750	+	15	0	0	7222
P29274#38	0	15	15	P29274	429	444	+	15	P29274	0	1236	ENST00000610595.4	630	1866	++	230	P29274#38	0	15	ENST00000610595.4	1059	1074	+	15	0	0	7223
P29274#38	0	15	15	P29274	429	444	+	15	P29274	0	1095	ENST00000444262.6	422	1517	+	92	P29274#38	0	15	ENST00000444262.6	851	866	+	15	0	0	7224
P29274#38	0	15	15	P29274	429	444	+	15	P29274	0	1236	ENST00000337539.12	422	1658	++	30	P29274#38	0	15	ENST00000337539.12	851	866	+	15	0	0	7225
P29274#39	0	21	21	P29274	450	471	+	21	P29274	0	1236	ENST00000618076.3	524	1760	++	233	P29274#39	0	21	ENST00000618076.3	974	995	+	21	0	0	7226
P29274#39	0	21	21	P29274	450	471	+	21	P29274	0	1236	ENST00000611543.4	306	1542	++	231	P29274#39	0	21	ENST00000611543.4	756	777	+	21	0	0	7227
P29274#39	0	21	21	P29274	450	471	+	21	P29274	0	1236	ENST00000610595.4	630	1866	++	230	P29274#39	0	21	ENST00000610595.4	1080	1101	+	21	0	0	7228
P29274#39	0	21	21	P29274	450	471	+	21	P29274	0	1095	ENST00000444262.6	422	1517	+	92	P29274#39	0	21	ENST00000444262.6	872	893	+	21	0	0	7229
P29274#39	0	21	21	P29274	450	471	+	21	P29274	0	1236	ENST00000337539.12	422	1658	++	30	P29274#39	0	21	ENST00000337539.12	872	893	+	21	0	0	7230
P29274#40	0	9	9	P29274	486	495	+	9	P29274	0	1236	ENST00000618076.3	524	1760	++	233	P29274#40	0	9	ENST00000618076.3	1010	1019	+	9	0	0	7231
P29274#40	0	9	9	P29274	486	495	+	9	P29274	0	1236	ENST00000611543.4	306	1542	++	231	P29274#40	0	9	ENST00000611543.4	792	801	+	9	0	0	7232
P29274#40	0	9	9	P29274	486	495	+	9	P29274	0	1236	ENST00000610595.4	630	1866	++	230	P29274#40	0	9	ENST00000610595.4	1116	1125	+	9	0	0	7233
P29274#40	0	9	9	P29274	486	495	+	9	P29274	0	1095	ENST00000444262.6	422	1517	+	92	P29274#40	0	9	ENST00000444262.6	908	917	+	9	0	0	7234
P29274#40	0	9	9	P29274	486	495	+	9	P29274	0	1236	ENST00000337539.12	422	1658	++	30	P29274#40	0	9	ENST00000337539.12	908	917	+	9	0	0	7235
P29274#41	0	12	12	P29274	501	513	+	12	P29274	0	1236	ENST00000618076.3	524	1760	++	233	P29274#41	0	12	ENST00000618076.3	1025	1037	+	12	0	0	7236
P29274#41	0	12	12	P29274	501	513	+	12	P29274	0	1236	ENST00000611543.4	306	1542	++	231	P29274#41	0	12	ENST00000611543.4	807	819	+	12	0	0	7237
P29274#41	0	12	12	P29274	501	513	+	12	P29274	0	1236	ENST00000610595.4	630	1866	++	230	P29274#41	0	12	ENST00000610595.4	1131	1143	+	12	0	0	7238
P29274#41	0	12	12	P29274	501	513	+	12	P29274	0	1095	ENST00000444262.6	422	1517	+	92	P29274#41	0	12	ENST00000444262.6	923	935	+	12	0	0	7239
P29274#41	0	12	12	P29274	501	513	+	12	P29274	0	1236	ENST00000337539.12	422	1658	++	30	P29274#41	0	12	ENST00000337539.12	923	935	+	12	0	0	7240
P29274#42	0	18	18	P29274	519	537	+	18	P29274	0	1236	ENST00000618076.3	524	1760	++	233	P29274#42	0	18	ENST00000618076.3	1043	1061	+	18	0	0	7241
P29274#42	0	18	18	P29274	519	537	+	18	P29274	0	1236	ENST00000611543.4	306	1542	++	231	P29274#42	0	18	ENST00000611543.4	825	843	+	18	0	0	7242
P29274#42	0	18	18	P29274	519	537	+	18	P29274	0	1236	ENST00000610595.4	630	1866	++	230	P29274#42	0	18	ENST00000610595.4	1149	1167	+	18	0	0	7243
P29274#42	0	18	18	P29274	519	537	+	18	P29274	0	1095	ENST00000444262.6	422	1517	+	92	P29274#42	0	18	ENST00000444262.6	941	959	+	18	0	0	7244
P29274#42	0	18	18	P29274	519	537	+	18	P29274	0	1236	ENST00000337539.12	422	1658	++	30	P29274#42	0	18	ENST00000337539.12	941	959	+	18	0	0	7245
P29274#43	0	12	12	P29274	543	555	+	12	P29274	0	1236	ENST00000618076.3	524	1760	++	233	P29274#43	0	12	ENST00000618076.3	1067	1079	+	12	0	0	7246
P29274#43	0	12	12	P29274	543	555	+	12	P29274	0	1236	ENST00000611543.4	306	1542	++	231	P29274#43	0	12	ENST00000611543.4	849	861	+	12	0	0	7247
P29274#43	0	12	12	P29274	543	555	+	12	P29274	0	1236	ENST00000610595.4	630	1866	++	230	P29274#43	0	12	ENST00000610595.4	1173	1185	+	12	0	0	7248
P29274#43	0	12	12	P29274	543	555	+	12	P29274	0	1095	ENST00000444262.6	422	1517	+	92	P29274#43	0	12	ENST00000444262.6	965	977	+	12	0	0	7249
P29274#43	0	12	12	P29274	543	555	+	12	P29274	0	1236	ENST00000337539.12	422	1658	++	30	P29274#43	0	12	ENST00000337539.12	965	977	+	12	0	0	7250
P29274#44	0	66	66	P29274	558	624	+	66	P29274	0	1236	ENST00000618076.3	524	1760	++	233	P29274#44	0	66	ENST00000618076.3	1082	1148	+	66	0	0	7251
P29274#44	0	66	66	P29274	558	624	+	66	P29274	0	1236	ENST00000611543.4	306	1542	++	231	P29274#44	0	66	ENST00000611543.4	864	930	+	66	0	0	7252
P29274#44	0	66	66	P29274	558	624	+	66	P29274	0	1236	ENST00000610595.4	630	1866	++	230	P29274#44	0	66	ENST00000610595.4	1188	1254	+	66	0	0	7253
P29274#44	0	66	66	P29274	558	624	+	66	P29274	0	1095	ENST00000444262.6	422	1517	+	92	P29274#44	0	66	ENST00000444262.6	980	1046	+	66	0	0	7254
P29274#44	0	66	66	P29274	558	624	+	66	P29274	0	1236	ENST00000337539.12	422	1658	++	30	P29274#44	0	66	ENST00000337539.12	980	1046	+	66	0	0	7255
P29274#45	0	12	12	P29274	636	648	+	12	P29274	0	1236	ENST00000618076.3	524	1760	++	233	P29274#45	0	12	ENST00000618076.3	1160	1172	+	12	0	0	7256
P29274#45	0	12	12	P29274	636	648	+	12	P29274	0	1236	ENST00000611543.4	306	1542	++	231	P29274#45	0	12	ENST00000611543.4	942	954	+	12	0	0	7257
P29274#45	0	12	12	P29274	636	648	+	12	P29274	0	1236	ENST00000610595.4	630	1866	++	230	P29274#45	0	12	ENST00000610595.4	1266	1278	+	12	0	0	7258
P29274#45	0	12	12	P29274	636	648	+	12	P29274	0	1095	ENST00000444262.6	422	1517	+	92	P29274#45	0	12	ENST00000444262.6	1058	1070	+	12	0	0	7259
P29274#45	0	12	12	P29274	636	648	+	12	P29274	0	1236	ENST00000337539.12	422	1658	++	30	P29274#45	0	12	ENST00000337539.12	1058	1070	+	12	0	0	7260
P29274#46	0	120	120	P29274	654	774	+	120	P29274	0	1236	ENST00000618076.3	524	1760	++	233	P29274#46	0	120	ENST00000618076.3	1178	1298	+	120	0	0	7261
P29274#46	0	120	120	P29274	654	774	+	120	P29274	0	1236	ENST00000611543.4	306	1542	++	231	P29274#46	0	120	ENST00000611543.4	960	1080	+	120	0	0	7262
P29274#46	0	120	120	P29274	654	774	+	120	P29274	0	1236	ENST00000610595.4	630	1866	++	230	P29274#46	0	120	ENST00000610595.4	1284	1404	+	120	0	0	7263
P29274#46	0	120	120	P29274	654	774	+	120	P29274	0	1095	ENST00000444262.6	422	1517	+	92	P29274#46	0	120	ENST00000444262.6	1076	1196	+	120	0	0	7264
P29274#46	0	120	120	P29274	654	774	+	120	P29274	0	1236	ENST00000337539.12	422	1658	++	30	P29274#46	0	120	ENST00000337539.12	1076	1196	+	120	0	0	7265
P29274#47	0	9	9	P29274	777	786	+	9	P29274	0	1236	ENST00000618076.3	524	1760	++	233	P29274#47	0	9	ENST00000618076.3	1301	1310	+	9	0	0	7266
P29274#47	0	9	9	P29274	777	786	+	9	P29274	0	1236	ENST00000611543.4	306	1542	++	231	P29274#47	0	9	ENST00000611543.4	1083	1092	+	9	0	0	7267
P29274#47	0	9	9	P29274	777	786	+	9	P29274	0	1236	ENST00000610595.4	630	1866	++	230	P29274#47	0	9	ENST00000610595.4	1407	1416	+	9	0	0	7268
P29274#47	0	9	9	P29274	777	786	+	9	P29274	0	1095	ENST00000444262.6	422	1517	+	92	P29274#47	0	9	ENST00000444262.6	1199	1208	+	9	0	0	7269
P29274#47	0	9	9	P29274	777	786	+	9	P29274	0	1236	ENST00000337539.12	422	1658	++	30	P29274#47	0	9	ENST00000337539.12	1199	1208	+	9	0	0	7270
P29274#48	0	75	75	P29274	798	873	+	75	P29274	0	1236	ENST00000618076.3	524	1760	++	233	P29274#48	0	75	ENST00000618076.3	1322	1397	+	75	0	0	7271
P29274#48	0	75	75	P29274	798	873	+	75	P29274	0	1236	ENST00000611543.4	306	1542	++	231	P29274#48	0	75	ENST00000611543.4	1104	1179	+	75	0	0	7272
P29274#48	0	75	75	P29274	798	873	+	75	P29274	0	1236	ENST00000610595.4	630	1866	++	230	P29274#48	0	75	ENST00000610595.4	1428	1503	+	75	0	0	7273
P29274#48	0	75	75	P29274	798	873	+	75	P29274	0	1095	ENST00000444262.6	422	1517	+	92	P29274#48	0	75	ENST00000444262.6	1220	1295	+	75	0	0	7274
P29274#48	0	75	75	P29274	798	873	+	75	P29274	0	1236	ENST00000337539.12	422	1658	++	30	P29274#48	0	75	ENST00000337539.12	1220	1295	+	75	0	0	7275
P29274#49	0	33	33	P29274	876	909	+	33	P29274	0	1236	ENST00000618076.3	524	1760	++	233	P29274#49	0	33	ENST00000618076.3	1400	1433	+	33	0	0	7276
P29274#49	0	33	33	P29274	876	909	+	33	P29274	0	1236	ENST00000611543.4	306	1542	++	231	P29274#49	0	33	ENST00000611543.4	1182	1215	+	33	0	0	7277
P29274#49	0	33	33	P29274	876	909	+	33	P29274	0	1236	ENST00000610595.4	630	1866	++	230	P29274#49	0	33	ENST00000610595.4	1506	1539	+	33	0	0	7278
P29274#49	0	33	33	P29274	876	909	+	33	P29274	0	1095	ENST00000444262.6	422	1517	+	92	P29274#49	0	33	ENST00000444262.6	1298	1331	+	33	0	0	7279
P29274#49	0	33	33	P29274	876	909	+	33	P29274	0	1236	ENST00000337539.12	422	1658	++	30	P29274#49	0	33	ENST00000337539.12	1298	1331	+	33	0	0	7280
P29274#50	0	12	12	P29274	909	921	+	12	P29274	0	1236	ENST00000618076.3	524	1760	++	233	P29274#50	0	12	ENST00000618076.3	1433	1445	+	12	0	0	7281
P29274#50	0	12	12	P29274	909	921	+	12	P29274	0	1236	ENST00000611543.4	306	1542	++	231	P29274#50	0	12	ENST00000611543.4	1215	1227	+	12	0	0	7282
P29274#50	0	12	12	P29274	909	921	+	12	P29274	0	1236	ENST00000610595.4	630	1866	++	230	P29274#50	0	12	ENST00000610595.4	1539	1551	+	12	0	0	7283
P29274#50	0	12	12	P29274	909	921	+	12	P29274	0	1095	ENST00000444262.6	422	1517	+	92	P29274#50	0	12	ENST00000444262.6	1331	1343	+	12	0	0	7284
P29274#50	0	12	12	P29274	909	921	+	12	P29274	0	1236	ENST00000337539.12	422	1658	++	30	P29274#50	0	12	ENST00000337539.12	1331	1343	+	12	0	0	7285
P29274#51	0	9	9	P29274	921	930	+	9	P29274	0	1236	ENST00000618076.3	524	1760	++	233	P29274#51	0	9	ENST00000618076.3	1445	1454	+	9	0	0	7286
P29274#51	0	9	9	P29274	921	930	+	9	P29274	0	1236	ENST00000611543.4	306	1542	++	231	P29274#51	0	9	ENST00000611543.4	1227	1236	+	9	0	0	7287
P29274#51	0	9	9	P29274	921	930	+	9	P29274	0	1236	ENST00000610595.4	630	1866	++	230	P29274#51	0	9	ENST00000610595.4	1551	1560	+	9	0	0	7288
P29274#51	0	9	9	P29274	921	930	+	9	P29274	0	1095	ENST00000444262.6	422	1517	+	92	P29274#51	0	9	ENST00000444262.6	1343	1352	+	9	0	0	7289
P29274#51	0	9	9	P29274	921	930	+	9	P29274	0	1236	ENST00000337539.12	422	1658	++	30	P29274#51	0	9	ENST00000337539.12	1343	1352	+	9	0	0	7290
P29274#52	0	18	18	P29274	933	951	+	18	P29274	0	1236	ENST00000618076.3	524	1760	++	233	P29274#52	0	18	ENST00000618076.3	1457	1475	+	18	0	0	7291
P29274#52	0	18	18	P29274	933	951	+	18	P29274	0	1236	ENST00000611543.4	306	1542	++	231	P29274#52	0	18	ENST00000611543.4	1239	1257	+	18	0	0	7292
P29274#52	0	18	18	P29274	933	951	+	18	P29274	0	1236	ENST00000610595.4	630	1866	++	230	P29274#52	0	18	ENST00000610595.4	1563	1581	+	18	0	0	7293
P29274#52	0	18	18	P29274	933	951	+	18	P29274	0	1095	ENST00000444262.6	422	1517	+	92	P29274#52	0	18	ENST00000444262.6	1355	1373	+	18	0	0	7294
P29274#52	0	18	18	P29274	933	951	+	18	P29274	0	1236	ENST00000337539.12	422	1658	++	30	P29274#52	0	18	ENST00000337539.12	1355	1373	+	18	0	0	7295
P29275#0	0	996	996	P29275	0	996	+	996	P29275	0	996	ENST00000304222.3	119	1115	++	21	P29275#0	0	996	ENST00000304222.3	119	1115	+	996	0	0	7296
P29275#1	0	24	24	P29275	0	24	+	24	P29275	0	996	ENST00000304222.3	119	1115	++	21	P29275#1	0	24	ENST00000304222.3	119	143	+	24	0	0	7297
P29275#2	0	75	75	P29275	24	99	+	75	P29275	0	996	ENST00000304222.3	119	1115	++	21	P29275#2	0	75	ENST00000304222.3	143	218	+	75	0	0	7298
P29275#3	0	30	30	P29275	99	129	+	30	P29275	0	996	ENST00000304222.3	119	1115	++	21	P29275#3	0	30	ENST00000304222.3	218	248	+	30	0	0	7299
P29275#4	0	72	72	P29275	129	201	+	72	P29275	0	996	ENST00000304222.3	119	1115	++	21	P29275#4	0	72	ENST00000304222.3	248	320	+	72	0	0	7300
P29275#5	0	33	33	P29275	201	234	+	33	P29275	0	996	ENST00000304222.3	119	1115	++	21	P29275#5	0	33	ENST00000304222.3	320	353	+	33	0	0	7301
P29275#6	0	69	69	P29275	234	303	+	69	P29275	0	996	ENST00000304222.3	119	1115	++	21	P29275#6	0	69	ENST00000304222.3	353	422	+	69	0	0	7302
P29275#7	0	60	60	P29275	303	363	+	60	P29275	0	996	ENST00000304222.3	119	1115	++	21	P29275#7	0	60	ENST00000304222.3	422	482	+	60	0	0	7303
P29275#8	0	69	69	P29275	363	432	+	69	P29275	0	996	ENST00000304222.3	119	1115	++	21	P29275#8	0	69	ENST00000304222.3	482	551	+	69	0	0	7304
P29275#9	0	102	102	P29275	432	534	+	102	P29275	0	996	ENST00000304222.3	119	1115	++	21	P29275#9	0	102	ENST00000304222.3	551	653	+	102	0	0	7305
P29275#10	0	75	75	P29275	534	609	+	75	P29275	0	996	ENST00000304222.3	119	1115	++	21	P29275#10	0	75	ENST00000304222.3	653	728	+	75	0	0	7306
P29275#11	0	96	96	P29275	609	705	+	96	P29275	0	996	ENST00000304222.3	119	1115	++	21	P29275#11	0	96	ENST00000304222.3	728	824	+	96	0	0	7307
P29275#12	0	72	72	P29275	705	777	+	72	P29275	0	996	ENST00000304222.3	119	1115	++	21	P29275#12	0	72	ENST00000304222.3	824	896	+	72	0	0	7308
P29275#13	0	24	24	P29275	777	801	+	24	P29275	0	996	ENST00000304222.3	119	1115	++	21	P29275#13	0	24	ENST00000304222.3	896	920	+	24	0	0	7309
P29275#14	0	72	72	P29275	801	873	+	72	P29275	0	996	ENST00000304222.3	119	1115	++	21	P29275#14	0	72	ENST00000304222.3	920	992	+	72	0	0	7310
P29275#15	0	123	123	P29275	873	996	+	123	P29275	0	996	ENST00000304222.3	119	1115	++	21	P29275#15	0	123	ENST00000304222.3	992	1115	+	123	0	0	7311
P29275#16	0	3	3	P29275	519	522	+	3	P29275	0	996	ENST00000304222.3	119	1115	++	21	P29275#16	0	3	ENST00000304222.3	638	641	+	3	0	0	7312
P29275#17	0	3	3	P29275	759	762	+	3	P29275	0	996	ENST00000304222.3	119	1115	++	21	P29275#17	0	3	ENST00000304222.3	878	881	+	3	0	0	7313
P29275#18	0	3	3	P29275	834	837	+	3	P29275	0	996	ENST00000304222.3	119	1115	++	21	P29275#18	0	3	ENST00000304222.3	953	956	+	3	0	0	7314
P29275#19	0	3	3	P29275	837	840	+	3	P29275	0	996	ENST00000304222.3	119	1115	++	21	P29275#19	0	3	ENST00000304222.3	956	959	+	3	0	0	7315
P29275#20	0	3	3	P29275	930	933	+	3	P29275	0	996	ENST00000304222.3	119	1115	++	21	P29275#20	0	3	ENST00000304222.3	1049	1052	+	3	0	0	7316
P29275#21	0	3	3	P29275	456	459	+	3	P29275	0	996	ENST00000304222.3	119	1115	++	21	P29275#21	0	3	ENST00000304222.3	575	578	+	3	0	0	7317
P29275#22	0	3	3	P29275	486	489	+	3	P29275	0	996	ENST00000304222.3	119	1115	++	21	P29275#22	0	3	ENST00000304222.3	605	608	+	3	0	0	7318
P29275#23	0	282	282	P29275	231	513	+	282	P29275	0	996	ENST00000304222.3	119	1115	++	21	P29275#23	0	282	ENST00000304222.3	350	632	+	282	0	0	7319
P29275#24	0	87	87	P29275	12	99	+	87	P29275	0	996	ENST00000304222.3	119	1115	++	21	P29275#24	0	87	ENST00000304222.3	131	218	+	87	0	0	7320
P29275#25	0	87	87	P29275	120	207	+	87	P29275	0	996	ENST00000304222.3	119	1115	++	21	P29275#25	0	87	ENST00000304222.3	239	326	+	87	0	0	7321
P29275#26	0	102	102	P29275	222	324	+	102	P29275	0	996	ENST00000304222.3	119	1115	++	21	P29275#26	0	102	ENST00000304222.3	341	443	+	102	0	0	7322
P29275#27	0	12	12	P29275	336	348	+	12	P29275	0	996	ENST00000304222.3	119	1115	++	21	P29275#27	0	12	ENST00000304222.3	455	467	+	12	0	0	7323
P29275#28	0	57	57	P29275	354	411	+	57	P29275	0	996	ENST00000304222.3	119	1115	++	21	P29275#28	0	57	ENST00000304222.3	473	530	+	57	0	0	7324
P29275#29	0	9	9	P29275	417	426	+	9	P29275	0	996	ENST00000304222.3	119	1115	++	21	P29275#29	0	9	ENST00000304222.3	536	545	+	9	0	0	7325
P29275#30	0	9	9	P29275	438	447	+	9	P29275	0	996	ENST00000304222.3	119	1115	++	21	P29275#30	0	9	ENST00000304222.3	557	566	+	9	0	0	7326
P29275#31	0	9	9	P29275	516	525	+	9	P29275	0	996	ENST00000304222.3	119	1115	++	21	P29275#31	0	9	ENST00000304222.3	635	644	+	9	0	0	7327
P29275#32	0	18	18	P29275	534	552	+	18	P29275	0	996	ENST00000304222.3	119	1115	++	21	P29275#32	0	18	ENST00000304222.3	653	671	+	18	0	0	7328
P29275#33	0	15	15	P29275	555	570	+	15	P29275	0	996	ENST00000304222.3	119	1115	++	21	P29275#33	0	15	ENST00000304222.3	674	689	+	15	0	0	7329
P29275#34	0	78	78	P29275	573	651	+	78	P29275	0	996	ENST00000304222.3	119	1115	++	21	P29275#34	0	78	ENST00000304222.3	692	770	+	78	0	0	7330
P29275#35	0	108	108	P29275	669	777	+	108	P29275	0	996	ENST00000304222.3	119	1115	++	21	P29275#35	0	108	ENST00000304222.3	788	896	+	108	0	0	7331
P29275#36	0	12	12	P29275	783	795	+	12	P29275	0	996	ENST00000304222.3	119	1115	++	21	P29275#36	0	12	ENST00000304222.3	902	914	+	12	0	0	7332
P29275#37	0	63	63	P29275	807	870	+	63	P29275	0	996	ENST00000304222.3	119	1115	++	21	P29275#37	0	63	ENST00000304222.3	926	989	+	63	0	0	7333
P29275#38	0	9	9	P29275	870	879	+	9	P29275	0	996	ENST00000304222.3	119	1115	++	21	P29275#38	0	9	ENST00000304222.3	989	998	+	9	0	0	7334
P29275#39	0	39	39	P29275	882	921	+	39	P29275	0	996	ENST00000304222.3	119	1115	++	21	P29275#39	0	39	ENST00000304222.3	1001	1040	+	39	0	0	7335
O94911-3#0	0	4863	4863	O94911-3	0	4863	+	4863	O94911-3	0	4863	ENST00000586539.6	340	5203	++	201	O94911-3#0	0	4863	ENST00000586539.6	340	5203	+	4863	0	0	7336
O94911-3#0	0	4863	4863	O94911-3	0	4863	+	4863	O94911-3	0	346	ENST00000585531.1	163	509	+	199	O94911-3#0	0	346	ENST00000585531.1	163	509	+	346	0	4517	7337
O94911-3#0	0	4863	4863	O94911-3	0	4863	+	4863	O94911-3	0	4863	ENST00000430352.6	179	5027	+	81	O94911-3#0	0	4863	ENST00000430352.6	179	5027	+	4848	0	0	7338
O94911-3#0	0	4863	4863	O94911-3	0	4863	+	4863	O94911-3	0	4863	ENST00000269080.6	138	4881	++	11	O94911-3#0	0	4863	ENST00000269080.6	138	4881	+	4743	0	0	7339
O94911-3#1	0	63	63	O94911-3	87	150	+	63	O94911-3	0	4863	ENST00000586539.6	340	5203	++	201	O94911-3#1	0	63	ENST00000586539.6	427	490	+	63	0	0	7340
O94911-3#1	0	63	63	O94911-3	87	150	+	63	O94911-3	0	346	ENST00000585531.1	163	509	+	199	O94911-3#1	0	63	ENST00000585531.1	250	313	+	63	0	0	7341
O94911-3#1	0	63	63	O94911-3	87	150	+	63	O94911-3	0	4863	ENST00000430352.6	179	5027	+	81	O94911-3#1	0	63	ENST00000430352.6	266	329	+	63	0	0	7342
O94911-3#1	0	63	63	O94911-3	87	150	+	63	O94911-3	0	4863	ENST00000269080.6	138	4881	++	11	O94911-3#1	0	63	ENST00000269080.6	225	288	+	63	0	0	7343
O94911-3#2	0	63	63	O94911-3	657	720	+	63	O94911-3	0	4863	ENST00000586539.6	340	5203	++	201	O94911-3#2	0	63	ENST00000586539.6	997	1060	+	63	0	0	7344
O94911-3#2	0	63	63	O94911-3	657	720	+	63	O94911-3	0	4863	ENST00000430352.6	179	5027	+	81	O94911-3#2	0	63	ENST00000430352.6	836	899	+	63	0	0	7345
O94911-3#2	0	63	63	O94911-3	657	720	+	63	O94911-3	0	4863	ENST00000269080.6	138	4881	++	11	O94911-3#2	0	63	ENST00000269080.6	795	858	+	63	0	0	7346
O94911-3#3	0	63	63	O94911-3	801	864	+	63	O94911-3	0	4863	ENST00000586539.6	340	5203	++	201	O94911-3#3	0	63	ENST00000586539.6	1141	1204	+	63	0	0	7347
O94911-3#3	0	63	63	O94911-3	801	864	+	63	O94911-3	0	4863	ENST00000430352.6	179	5027	+	81	O94911-3#3	0	63	ENST00000430352.6	980	1043	+	63	0	0	7348
O94911-3#3	0	63	63	O94911-3	801	864	+	63	O94911-3	0	4863	ENST00000269080.6	138	4881	++	11	O94911-3#3	0	63	ENST00000269080.6	939	1002	+	63	0	0	7349
O94911-3#4	0	63	63	O94911-3	894	957	+	63	O94911-3	0	4863	ENST00000586539.6	340	5203	++	201	O94911-3#4	0	63	ENST00000586539.6	1234	1297	+	63	0	0	7350
O94911-3#4	0	63	63	O94911-3	894	957	+	63	O94911-3	0	4863	ENST00000430352.6	179	5027	+	81	O94911-3#4	0	63	ENST00000430352.6	1073	1136	+	63	0	0	7351
O94911-3#4	0	63	63	O94911-3	894	957	+	63	O94911-3	0	4863	ENST00000269080.6	138	4881	++	11	O94911-3#4	0	63	ENST00000269080.6	1032	1095	+	63	0	0	7352
O94911-3#5	0	63	63	O94911-3	978	1041	+	63	O94911-3	0	4863	ENST00000586539.6	340	5203	++	201	O94911-3#5	0	63	ENST00000586539.6	1318	1381	+	63	0	0	7353
O94911-3#5	0	63	63	O94911-3	978	1041	+	63	O94911-3	0	4863	ENST00000430352.6	179	5027	+	81	O94911-3#5	0	63	ENST00000430352.6	1157	1220	+	63	0	0	7354
O94911-3#5	0	63	63	O94911-3	978	1041	+	63	O94911-3	0	4863	ENST00000269080.6	138	4881	++	11	O94911-3#5	0	63	ENST00000269080.6	1116	1179	+	63	0	0	7355
O94911-3#6	0	63	63	O94911-3	1074	1137	+	63	O94911-3	0	4863	ENST00000586539.6	340	5203	++	201	O94911-3#6	0	63	ENST00000586539.6	1414	1477	+	63	0	0	7356
O94911-3#6	0	63	63	O94911-3	1074	1137	+	63	O94911-3	0	4863	ENST00000430352.6	179	5027	+	81	O94911-3#6	0	63	ENST00000430352.6	1253	1316	+	63	0	0	7357
O94911-3#6	0	63	63	O94911-3	1074	1137	+	63	O94911-3	0	4863	ENST00000269080.6	138	4881	++	11	O94911-3#6	0	63	ENST00000269080.6	1212	1275	+	63	0	0	7358
O94911-3#7	0	63	63	O94911-3	1188	1251	+	63	O94911-3	0	4863	ENST00000586539.6	340	5203	++	201	O94911-3#7	0	63	ENST00000586539.6	1528	1591	+	63	0	0	7359
O94911-3#7	0	63	63	O94911-3	1188	1251	+	63	O94911-3	0	4863	ENST00000430352.6	179	5027	+	81	O94911-3#7	0	63	ENST00000430352.6	1367	1430	+	63	0	0	7360
O94911-3#7	0	63	63	O94911-3	1188	1251	+	63	O94911-3	0	4863	ENST00000269080.6	138	4881	++	11	O94911-3#7	0	63	ENST00000269080.6	1326	1389	+	63	0	0	7361
O94911-3#8	0	63	63	O94911-3	2589	2652	+	63	O94911-3	0	4863	ENST00000586539.6	340	5203	++	201	O94911-3#8	0	63	ENST00000586539.6	2929	2992	+	63	0	0	7362
O94911-3#8	0	63	63	O94911-3	2589	2652	+	63	O94911-3	0	4863	ENST00000430352.6	179	5027	+	81	O94911-3#8	0	63	ENST00000430352.6	2768	2831	+	63	0	0	7363
O94911-3#8	0	63	63	O94911-3	2589	2652	+	63	O94911-3	0	4863	ENST00000269080.6	138	4881	++	11	O94911-3#8	0	63	ENST00000269080.6	2607	2670	+	63	0	0	7364
O94911-3#9	0	63	63	O94911-3	3054	3117	+	63	O94911-3	0	4863	ENST00000586539.6	340	5203	++	201	O94911-3#9	0	63	ENST00000586539.6	3394	3457	+	63	0	0	7365
O94911-3#9	0	63	63	O94911-3	3054	3117	+	63	O94911-3	0	4863	ENST00000430352.6	179	5027	+	81	O94911-3#9	0	63	ENST00000430352.6	3233	3296	+	63	0	0	7366
O94911-3#9	0	63	63	O94911-3	3054	3117	+	63	O94911-3	0	4863	ENST00000269080.6	138	4881	++	11	O94911-3#9	0	63	ENST00000269080.6	3072	3135	+	63	0	0	7367
O94911-3#10	0	63	63	O94911-3	3207	3270	+	63	O94911-3	0	4863	ENST00000586539.6	340	5203	++	201	O94911-3#10	0	63	ENST00000586539.6	3547	3610	+	63	0	0	7368
O94911-3#10	0	63	63	O94911-3	3207	3270	+	63	O94911-3	0	4863	ENST00000430352.6	179	5027	+	81	O94911-3#10	0	63	ENST00000430352.6	3386	3449	+	63	0	0	7369
O94911-3#10	0	63	63	O94911-3	3207	3270	+	63	O94911-3	0	4863	ENST00000269080.6	138	4881	++	11	O94911-3#10	0	63	ENST00000269080.6	3225	3288	+	63	0	0	7370
O94911-3#11	0	63	63	O94911-3	3315	3378	+	63	O94911-3	0	4863	ENST00000586539.6	340	5203	++	201	O94911-3#11	0	63	ENST00000586539.6	3655	3718	+	63	0	0	7371
O94911-3#11	0	63	63	O94911-3	3315	3378	+	63	O94911-3	0	4863	ENST00000430352.6	179	5027	+	81	O94911-3#11	0	63	ENST00000430352.6	3494	3557	+	63	0	0	7372
O94911-3#11	0	63	63	O94911-3	3315	3378	+	63	O94911-3	0	4863	ENST00000269080.6	138	4881	++	11	O94911-3#11	0	63	ENST00000269080.6	3333	3396	+	63	0	0	7373
O94911-3#12	0	63	63	O94911-3	3405	3468	+	63	O94911-3	0	4863	ENST00000586539.6	340	5203	++	201	O94911-3#12	0	63	ENST00000586539.6	3745	3808	+	63	0	0	7374
O94911-3#12	0	63	63	O94911-3	3405	3468	+	63	O94911-3	0	4863	ENST00000430352.6	179	5027	+	81	O94911-3#12	0	63	ENST00000430352.6	3584	3647	+	63	0	0	7375
O94911-3#12	0	63	63	O94911-3	3405	3468	+	63	O94911-3	0	4863	ENST00000269080.6	138	4881	++	11	O94911-3#12	0	63	ENST00000269080.6	3423	3486	+	63	0	0	7376
O94911-3#13	0	63	63	O94911-3	3480	3543	+	63	O94911-3	0	4863	ENST00000586539.6	340	5203	++	201	O94911-3#13	0	63	ENST00000586539.6	3820	3883	+	63	0	0	7377
O94911-3#13	0	63	63	O94911-3	3480	3543	+	63	O94911-3	0	4863	ENST00000430352.6	179	5027	+	81	O94911-3#13	0	63	ENST00000430352.6	3659	3722	+	63	0	0	7378
O94911-3#13	0	63	63	O94911-3	3480	3543	+	63	O94911-3	0	4863	ENST00000269080.6	138	4881	++	11	O94911-3#13	0	63	ENST00000269080.6	3498	3561	+	63	0	0	7379
O94911-3#14	0	63	63	O94911-3	3588	3651	+	63	O94911-3	0	4863	ENST00000586539.6	340	5203	++	201	O94911-3#14	0	63	ENST00000586539.6	3928	3991	+	63	0	0	7380
O94911-3#14	0	63	63	O94911-3	3588	3651	+	63	O94911-3	0	4863	ENST00000430352.6	179	5027	+	81	O94911-3#14	0	63	ENST00000430352.6	3767	3830	+	63	0	0	7381
O94911-3#14	0	63	63	O94911-3	3588	3651	+	63	O94911-3	0	4863	ENST00000269080.6	138	4881	++	11	O94911-3#14	0	63	ENST00000269080.6	3606	3669	+	63	0	0	7382
O94911-3#15	0	708	708	O94911-3	1437	2145	+	708	O94911-3	0	4863	ENST00000586539.6	340	5203	++	201	O94911-3#15	0	708	ENST00000586539.6	1777	2485	+	708	0	0	7383
O94911-3#15	0	708	708	O94911-3	1437	2145	+	708	O94911-3	0	4863	ENST00000430352.6	179	5027	+	81	O94911-3#15	0	708	ENST00000430352.6	1616	2324	+	708	0	0	7384
O94911-3#15	0	708	708	O94911-3	1437	2145	+	708	O94911-3	0	4863	ENST00000269080.6	138	4881	++	11	O94911-3#15	0	708	ENST00000269080.6	1575	2163	+	588	0	0	7385
O94911-3#16	0	702	702	O94911-3	3852	4554	+	702	O94911-3	0	4863	ENST00000586539.6	340	5203	++	201	O94911-3#16	0	702	ENST00000586539.6	4192	4894	+	702	0	0	7386
O94911-3#16	0	702	702	O94911-3	3852	4554	+	702	O94911-3	0	4863	ENST00000430352.6	179	5027	+	81	O94911-3#16	0	702	ENST00000430352.6	4016	4718	+	702	0	0	7387
O94911-3#16	0	702	702	O94911-3	3852	4554	+	702	O94911-3	0	4863	ENST00000269080.6	138	4881	++	11	O94911-3#16	0	702	ENST00000269080.6	3870	4572	+	702	0	0	7388
O94911-3#17	0	24	24	O94911-3	1545	1569	+	24	O94911-3	0	4863	ENST00000586539.6	340	5203	++	201	O94911-3#17	0	24	ENST00000586539.6	1885	1909	+	24	0	0	7389
O94911-3#17	0	24	24	O94911-3	1545	1569	+	24	O94911-3	0	4863	ENST00000430352.6	179	5027	+	81	O94911-3#17	0	24	ENST00000430352.6	1724	1748	+	24	0	0	7390
O94911-3#17	0	24	24	O94911-3	1545	1569	+	24	O94911-3	0	4863	ENST00000269080.6	138	4881	++	11	O94911-3#17	0	24	ENST00000269080.6	1683	1707	+	24	0	0	7391
O94911-3#18	0	24	24	O94911-3	3966	3990	+	24	O94911-3	0	4863	ENST00000586539.6	340	5203	++	201	O94911-3#18	0	24	ENST00000586539.6	4306	4330	+	24	0	0	7392
O94911-3#18	0	24	24	O94911-3	3966	3990	+	24	O94911-3	0	4863	ENST00000430352.6	179	5027	+	81	O94911-3#18	0	24	ENST00000430352.6	4130	4154	+	24	0	0	7393
O94911-3#18	0	24	24	O94911-3	3966	3990	+	24	O94911-3	0	4863	ENST00000269080.6	138	4881	++	11	O94911-3#18	0	24	ENST00000269080.6	3984	4008	+	24	0	0	7394
O94911-3#19	0	3	3	O94911-3	210	213	+	3	O94911-3	0	4863	ENST00000586539.6	340	5203	++	201	O94911-3#19	0	3	ENST00000586539.6	550	553	+	3	0	0	7395
O94911-3#19	0	3	3	O94911-3	210	213	+	3	O94911-3	0	346	ENST00000585531.1	163	509	+	199	O94911-3#19	0	3	ENST00000585531.1	373	376	+	3	0	0	7396
O94911-3#19	0	3	3	O94911-3	210	213	+	3	O94911-3	0	4863	ENST00000430352.6	179	5027	+	81	O94911-3#19	0	3	ENST00000430352.6	389	392	+	3	0	0	7397
O94911-3#19	0	3	3	O94911-3	210	213	+	3	O94911-3	0	4863	ENST00000269080.6	138	4881	++	11	O94911-3#19	0	3	ENST00000269080.6	348	351	+	3	0	0	7398
O94911-3#20	0	3	3	O94911-3	249	252	+	3	O94911-3	0	4863	ENST00000586539.6	340	5203	++	201	O94911-3#20	0	3	ENST00000586539.6	589	592	+	3	0	0	7399
O94911-3#20	0	3	3	O94911-3	249	252	+	3	O94911-3	0	346	ENST00000585531.1	163	509	+	199	O94911-3#20	0	3	ENST00000585531.1	412	415	+	3	0	0	7400
O94911-3#20	0	3	3	O94911-3	249	252	+	3	O94911-3	0	4863	ENST00000430352.6	179	5027	+	81	O94911-3#20	0	3	ENST00000430352.6	428	431	+	3	0	0	7401
O94911-3#20	0	3	3	O94911-3	249	252	+	3	O94911-3	0	4863	ENST00000269080.6	138	4881	++	11	O94911-3#20	0	3	ENST00000269080.6	387	390	+	3	0	0	7402
O94911-3#21	0	3	3	O94911-3	579	582	+	3	O94911-3	0	4863	ENST00000586539.6	340	5203	++	201	O94911-3#21	0	3	ENST00000586539.6	919	922	+	3	0	0	7403
O94911-3#21	0	3	3	O94911-3	579	582	+	3	O94911-3	0	4863	ENST00000430352.6	179	5027	+	81	O94911-3#21	0	3	ENST00000430352.6	758	761	+	3	0	0	7404
O94911-3#21	0	3	3	O94911-3	579	582	+	3	O94911-3	0	4863	ENST00000269080.6	138	4881	++	11	O94911-3#21	0	3	ENST00000269080.6	717	720	+	3	0	0	7405
O94911-3#22	0	3	3	O94911-3	726	729	+	3	O94911-3	0	4863	ENST00000586539.6	340	5203	++	201	O94911-3#22	0	3	ENST00000586539.6	1066	1069	+	3	0	0	7406
O94911-3#22	0	3	3	O94911-3	726	729	+	3	O94911-3	0	4863	ENST00000430352.6	179	5027	+	81	O94911-3#22	0	3	ENST00000430352.6	905	908	+	3	0	0	7407
O94911-3#22	0	3	3	O94911-3	726	729	+	3	O94911-3	0	4863	ENST00000269080.6	138	4881	++	11	O94911-3#22	0	3	ENST00000269080.6	864	867	+	3	0	0	7408
O94911-3#23	0	3	3	O94911-3	1449	1452	+	3	O94911-3	0	4863	ENST00000586539.6	340	5203	++	201	O94911-3#23	0	3	ENST00000586539.6	1789	1792	+	3	0	0	7409
O94911-3#23	0	3	3	O94911-3	1449	1452	+	3	O94911-3	0	4863	ENST00000430352.6	179	5027	+	81	O94911-3#23	0	3	ENST00000430352.6	1628	1631	+	3	0	0	7410
O94911-3#23	0	3	3	O94911-3	1449	1452	+	3	O94911-3	0	4863	ENST00000269080.6	138	4881	++	11	O94911-3#23	0	3	ENST00000269080.6	1587	1590	+	3	0	0	7411
O94911-3#24	0	3	3	O94911-3	1662	1665	+	3	O94911-3	0	4863	ENST00000586539.6	340	5203	++	201	O94911-3#24	0	3	ENST00000586539.6	2002	2005	+	3	0	0	7412
O94911-3#24	0	3	3	O94911-3	1662	1665	+	3	O94911-3	0	4863	ENST00000430352.6	179	5027	+	81	O94911-3#24	0	3	ENST00000430352.6	1841	1844	+	3	0	0	7413
O94911-3#24	0	3	3	O94911-3	1662	1665	+	3	O94911-3	0	4863	ENST00000269080.6	138	4881	++	11	O94911-3#24	0	3	ENST00000269080.6	1800	1803	+	3	0	0	7414
O94911-3#25	0	3	3	O94911-3	1845	1848	+	3	O94911-3	0	4863	ENST00000586539.6	340	5203	++	201	O94911-3#25	0	3	ENST00000586539.6	2185	2188	+	3	0	0	7415
O94911-3#25	0	3	3	O94911-3	1845	1848	+	3	O94911-3	0	4863	ENST00000430352.6	179	5027	+	81	O94911-3#25	0	3	ENST00000430352.6	2024	2027	+	3	0	0	7416
O94911-3#26	0	3	3	O94911-3	2169	2172	+	3	O94911-3	0	4863	ENST00000586539.6	340	5203	++	201	O94911-3#26	0	3	ENST00000586539.6	2509	2512	+	3	0	0	7417
O94911-3#26	0	3	3	O94911-3	2169	2172	+	3	O94911-3	0	4863	ENST00000430352.6	179	5027	+	81	O94911-3#26	0	3	ENST00000430352.6	2348	2351	+	3	0	0	7418
O94911-3#26	0	3	3	O94911-3	2169	2172	+	3	O94911-3	0	4863	ENST00000269080.6	138	4881	++	11	O94911-3#26	0	3	ENST00000269080.6	2187	2190	+	3	0	0	7419
O94911-3#27	0	3	3	O94911-3	2388	2391	+	3	O94911-3	0	4863	ENST00000586539.6	340	5203	++	201	O94911-3#27	0	3	ENST00000586539.6	2728	2731	+	3	0	0	7420
O94911-3#27	0	3	3	O94911-3	2388	2391	+	3	O94911-3	0	4863	ENST00000430352.6	179	5027	+	81	O94911-3#27	0	3	ENST00000430352.6	2567	2570	+	3	0	0	7421
O94911-3#27	0	3	3	O94911-3	2388	2391	+	3	O94911-3	0	4863	ENST00000269080.6	138	4881	++	11	O94911-3#27	0	3	ENST00000269080.6	2406	2409	+	3	0	0	7422
O94911-3#28	0	3	3	O94911-3	2754	2757	+	3	O94911-3	0	4863	ENST00000586539.6	340	5203	++	201	O94911-3#28	0	3	ENST00000586539.6	3094	3097	+	3	0	0	7423
O94911-3#28	0	3	3	O94911-3	2754	2757	+	3	O94911-3	0	4863	ENST00000430352.6	179	5027	+	81	O94911-3#28	0	3	ENST00000430352.6	2933	2936	+	3	0	0	7424
O94911-3#28	0	3	3	O94911-3	2754	2757	+	3	O94911-3	0	4863	ENST00000269080.6	138	4881	++	11	O94911-3#28	0	3	ENST00000269080.6	2772	2775	+	3	0	0	7425
O94911-3#29	0	3	3	O94911-3	2841	2844	+	3	O94911-3	0	4863	ENST00000586539.6	340	5203	++	201	O94911-3#29	0	3	ENST00000586539.6	3181	3184	+	3	0	0	7426
O94911-3#29	0	3	3	O94911-3	2841	2844	+	3	O94911-3	0	4863	ENST00000430352.6	179	5027	+	81	O94911-3#29	0	3	ENST00000430352.6	3020	3023	+	3	0	0	7427
O94911-3#29	0	3	3	O94911-3	2841	2844	+	3	O94911-3	0	4863	ENST00000269080.6	138	4881	++	11	O94911-3#29	0	3	ENST00000269080.6	2859	2862	+	3	0	0	7428
O94911-3#30	0	3	3	O94911-3	2898	2901	+	3	O94911-3	0	4863	ENST00000586539.6	340	5203	++	201	O94911-3#30	0	3	ENST00000586539.6	3238	3241	+	3	0	0	7429
O94911-3#30	0	3	3	O94911-3	2898	2901	+	3	O94911-3	0	4863	ENST00000430352.6	179	5027	+	81	O94911-3#30	0	3	ENST00000430352.6	3077	3080	+	3	0	0	7430
O94911-3#30	0	3	3	O94911-3	2898	2901	+	3	O94911-3	0	4863	ENST00000269080.6	138	4881	++	11	O94911-3#30	0	3	ENST00000269080.6	2916	2919	+	3	0	0	7431
O94911-3#31	0	3	3	O94911-3	3807	3810	+	3	O94911-3	0	4863	ENST00000586539.6	340	5203	++	201	O94911-3#31	0	3	ENST00000586539.6	4147	4150	+	3	0	0	7432
O94911-3#31	0	3	3	O94911-3	3807	3810	+	3	O94911-3	0	4863	ENST00000430352.6	179	5027	+	81	O94911-3#31	0	3	ENST00000430352.6	3971	3974	+	3	0	0	7433
O94911-3#31	0	3	3	O94911-3	3807	3810	+	3	O94911-3	0	4863	ENST00000269080.6	138	4881	++	11	O94911-3#31	0	3	ENST00000269080.6	3825	3828	+	3	0	0	7434
O94911-3#32	0	3	3	O94911-3	3921	3924	+	3	O94911-3	0	4863	ENST00000586539.6	340	5203	++	201	O94911-3#32	0	3	ENST00000586539.6	4261	4264	+	3	0	0	7435
O94911-3#32	0	3	3	O94911-3	3921	3924	+	3	O94911-3	0	4863	ENST00000430352.6	179	5027	+	81	O94911-3#32	0	3	ENST00000430352.6	4085	4088	+	3	0	0	7436
O94911-3#32	0	3	3	O94911-3	3921	3924	+	3	O94911-3	0	4863	ENST00000269080.6	138	4881	++	11	O94911-3#32	0	3	ENST00000269080.6	3939	3942	+	3	0	0	7437
O94911-3#33	0	3	3	O94911-3	4116	4119	+	3	O94911-3	0	4863	ENST00000586539.6	340	5203	++	201	O94911-3#33	0	3	ENST00000586539.6	4456	4459	+	3	0	0	7438
O94911-3#33	0	3	3	O94911-3	4116	4119	+	3	O94911-3	0	4863	ENST00000430352.6	179	5027	+	81	O94911-3#33	0	3	ENST00000430352.6	4280	4283	+	3	0	0	7439
O94911-3#33	0	3	3	O94911-3	4116	4119	+	3	O94911-3	0	4863	ENST00000269080.6	138	4881	++	11	O94911-3#33	0	3	ENST00000269080.6	4134	4137	+	3	0	0	7440
O94911-3#34	0	3	3	O94911-3	4302	4305	+	3	O94911-3	0	4863	ENST00000586539.6	340	5203	++	201	O94911-3#34	0	3	ENST00000586539.6	4642	4645	+	3	0	0	7441
O94911-3#34	0	3	3	O94911-3	4302	4305	+	3	O94911-3	0	4863	ENST00000430352.6	179	5027	+	81	O94911-3#34	0	3	ENST00000430352.6	4466	4469	+	3	0	0	7442
O94911-3#34	0	3	3	O94911-3	4302	4305	+	3	O94911-3	0	4863	ENST00000269080.6	138	4881	++	11	O94911-3#34	0	3	ENST00000269080.6	4320	4323	+	3	0	0	7443
O94911-3#35	0	4065	4065	O94911-3	798	4863	+	4065	O94911-3	0	4863	ENST00000586539.6	340	5203	++	201	O94911-3#35	0	4065	ENST00000586539.6	1138	5203	+	4065	0	0	7444
O94911-3#35	0	4065	4065	O94911-3	798	4863	+	4065	O94911-3	0	4863	ENST00000430352.6	179	5027	+	81	O94911-3#35	0	4065	ENST00000430352.6	977	5027	+	4050	0	0	7445
O94911-3#35	0	4065	4065	O94911-3	798	4863	+	4065	O94911-3	0	4863	ENST00000269080.6	138	4881	++	11	O94911-3#35	0	4065	ENST00000269080.6	936	4881	+	3945	0	0	7446
O94911-3#36	0	120	120	O94911-3	1791	1911	+	120	O94911-3	0	4863	ENST00000586539.6	340	5203	++	201	O94911-3#36	0	120	ENST00000586539.6	2131	2251	+	120	0	0	7447
O94911-3#36	0	120	120	O94911-3	1791	1911	+	120	O94911-3	0	4863	ENST00000430352.6	179	5027	+	81	O94911-3#36	0	120	ENST00000430352.6	1970	2090	+	120	0	0	7448
O94911-3#37	0	3	3	O94911-3	765	768	+	3	O94911-3	0	4863	ENST00000586539.6	340	5203	++	201	O94911-3#37	0	3	ENST00000586539.6	1105	1108	+	3	0	0	7449
O94911-3#37	0	3	3	O94911-3	765	768	+	3	O94911-3	0	4863	ENST00000430352.6	179	5027	+	81	O94911-3#37	0	3	ENST00000430352.6	944	947	+	3	0	0	7450
O94911-3#37	0	3	3	O94911-3	765	768	+	3	O94911-3	0	4863	ENST00000269080.6	138	4881	++	11	O94911-3#37	0	3	ENST00000269080.6	903	906	+	3	0	0	7451
O94911-3#38	0	3	3	O94911-3	990	993	+	3	O94911-3	0	4863	ENST00000586539.6	340	5203	++	201	O94911-3#38	0	3	ENST00000586539.6	1330	1333	+	3	0	0	7452
O94911-3#38	0	3	3	O94911-3	990	993	+	3	O94911-3	0	4863	ENST00000430352.6	179	5027	+	81	O94911-3#38	0	3	ENST00000430352.6	1169	1172	+	3	0	0	7453
O94911-3#38	0	3	3	O94911-3	990	993	+	3	O94911-3	0	4863	ENST00000269080.6	138	4881	++	11	O94911-3#38	0	3	ENST00000269080.6	1128	1131	+	3	0	0	7454
O94911-3#39	0	3	3	O94911-3	1245	1248	+	3	O94911-3	0	4863	ENST00000586539.6	340	5203	++	201	O94911-3#39	0	3	ENST00000586539.6	1585	1588	+	3	0	0	7455
O94911-3#39	0	3	3	O94911-3	1245	1248	+	3	O94911-3	0	4863	ENST00000430352.6	179	5027	+	81	O94911-3#39	0	3	ENST00000430352.6	1424	1427	+	3	0	0	7456
O94911-3#39	0	3	3	O94911-3	1245	1248	+	3	O94911-3	0	4863	ENST00000269080.6	138	4881	++	11	O94911-3#39	0	3	ENST00000269080.6	1383	1386	+	3	0	0	7457
O94911-3#40	0	3	3	O94911-3	1464	1467	+	3	O94911-3	0	4863	ENST00000586539.6	340	5203	++	201	O94911-3#40	0	3	ENST00000586539.6	1804	1807	+	3	0	0	7458
O94911-3#40	0	3	3	O94911-3	1464	1467	+	3	O94911-3	0	4863	ENST00000430352.6	179	5027	+	81	O94911-3#40	0	3	ENST00000430352.6	1643	1646	+	3	0	0	7459
O94911-3#40	0	3	3	O94911-3	1464	1467	+	3	O94911-3	0	4863	ENST00000269080.6	138	4881	++	11	O94911-3#40	0	3	ENST00000269080.6	1602	1605	+	3	0	0	7460
O94911-3#41	0	3	3	O94911-3	1944	1947	+	3	O94911-3	0	4863	ENST00000586539.6	340	5203	++	201	O94911-3#41	0	3	ENST00000586539.6	2284	2287	+	3	0	0	7461
O94911-3#41	0	3	3	O94911-3	1944	1947	+	3	O94911-3	0	4863	ENST00000430352.6	179	5027	+	81	O94911-3#41	0	3	ENST00000430352.6	2123	2126	+	3	0	0	7462
O94911-3#41	0	3	3	O94911-3	1944	1947	+	3	O94911-3	0	4863	ENST00000269080.6	138	4881	++	11	O94911-3#41	0	3	ENST00000269080.6	1962	1965	+	3	0	0	7463
O94911-3#42	0	3	3	O94911-3	1974	1977	+	3	O94911-3	0	4863	ENST00000586539.6	340	5203	++	201	O94911-3#42	0	3	ENST00000586539.6	2314	2317	+	3	0	0	7464
O94911-3#42	0	3	3	O94911-3	1974	1977	+	3	O94911-3	0	4863	ENST00000430352.6	179	5027	+	81	O94911-3#42	0	3	ENST00000430352.6	2153	2156	+	3	0	0	7465
O94911-3#42	0	3	3	O94911-3	1974	1977	+	3	O94911-3	0	4863	ENST00000269080.6	138	4881	++	11	O94911-3#42	0	3	ENST00000269080.6	1992	1995	+	3	0	0	7466
O94911-3#43	0	3	3	O94911-3	2157	2160	+	3	O94911-3	0	4863	ENST00000586539.6	340	5203	++	201	O94911-3#43	0	3	ENST00000586539.6	2497	2500	+	3	0	0	7467
O94911-3#43	0	3	3	O94911-3	2157	2160	+	3	O94911-3	0	4863	ENST00000430352.6	179	5027	+	81	O94911-3#43	0	3	ENST00000430352.6	2336	2339	+	3	0	0	7468
O94911-3#43	0	3	3	O94911-3	2157	2160	+	3	O94911-3	0	4863	ENST00000269080.6	138	4881	++	11	O94911-3#43	0	3	ENST00000269080.6	2175	2178	+	3	0	0	7469
O94911-3#44	0	2523	2523	O94911-3	2340	4863	+	2523	O94911-3	0	4863	ENST00000586539.6	340	5203	++	201	O94911-3#44	0	2523	ENST00000586539.6	2680	5203	+	2523	0	0	7470
O94911-3#44	0	2523	2523	O94911-3	2340	4863	+	2523	O94911-3	0	4863	ENST00000430352.6	179	5027	+	81	O94911-3#44	0	2523	ENST00000430352.6	2519	5027	+	2508	0	0	7471
O94911-3#44	0	2523	2523	O94911-3	2340	4863	+	2523	O94911-3	0	4863	ENST00000269080.6	138	4881	++	11	O94911-3#44	0	2523	ENST00000269080.6	2358	4881	+	2523	0	0	7472
O94911-3#45	0	3	3	O94911-3	4407	4410	+	3	O94911-3	0	4863	ENST00000586539.6	340	5203	++	201	O94911-3#45	0	3	ENST00000586539.6	4747	4750	+	3	0	0	7473
O94911-3#45	0	3	3	O94911-3	4407	4410	+	3	O94911-3	0	4863	ENST00000430352.6	179	5027	+	81	O94911-3#45	0	3	ENST00000430352.6	4571	4574	+	3	0	0	7474
O94911-3#45	0	3	3	O94911-3	4407	4410	+	3	O94911-3	0	4863	ENST00000269080.6	138	4881	++	11	O94911-3#45	0	3	ENST00000269080.6	4425	4428	+	3	0	0	7475
Q8IUA7-1#0	0	4872	4872	Q8IUA7-1	0	4872	+	4872	Q8IUA7-1	0	269	ENST00000585714.1	313	582	+	200	Q8IUA7-1#0	0	269	ENST00000585714.1	313	582	+	269	0	4603	7476
Q8IUA7-1#0	0	4872	4872	Q8IUA7-1	0	4872	+	4872	Q8IUA7-1	0	801	ENST00000495634.5	54	855	++	122	Q8IUA7-1#0	0	801	ENST00000495634.5	54	855	+	801	0	4071	7477
Q8IUA7-1#0	0	4872	4872	Q8IUA7-1	0	4872	+	4872	Q8IUA7-1	0	4872	ENST00000453985.6	72	4830	+	102	Q8IUA7-1#0	0	4872	ENST00000453985.6	72	4830	+	4758	0	0	7478
Q8IUA7-1#0	0	4872	4872	Q8IUA7-1	0	4872	+	4872	Q8IUA7-1	0	4872	ENST00000340001.9	75	4947	++	32	Q8IUA7-1#0	0	4872	ENST00000340001.9	75	4947	+	4872	0	0	7479
Q8IUA7-1#1	0	63	63	Q8IUA7-1	90	153	+	63	Q8IUA7-1	0	269	ENST00000585714.1	313	582	+	200	Q8IUA7-1#1	0	63	ENST00000585714.1	403	466	+	63	0	0	7480
Q8IUA7-1#1	0	63	63	Q8IUA7-1	90	153	+	63	Q8IUA7-1	0	801	ENST00000495634.5	54	855	++	122	Q8IUA7-1#1	0	63	ENST00000495634.5	144	207	+	63	0	0	7481
Q8IUA7-1#1	0	63	63	Q8IUA7-1	90	153	+	63	Q8IUA7-1	0	4872	ENST00000453985.6	72	4830	+	102	Q8IUA7-1#1	0	63	ENST00000453985.6	162	225	+	63	0	0	7482
Q8IUA7-1#1	0	63	63	Q8IUA7-1	90	153	+	63	Q8IUA7-1	0	4872	ENST00000340001.9	75	4947	++	32	Q8IUA7-1#1	0	63	ENST00000340001.9	165	228	+	63	0	0	7483
Q8IUA7-1#2	0	69	69	Q8IUA7-1	660	729	+	69	Q8IUA7-1	0	801	ENST00000495634.5	54	855	++	122	Q8IUA7-1#2	0	69	ENST00000495634.5	714	783	+	69	0	0	7484
Q8IUA7-1#2	0	69	69	Q8IUA7-1	660	729	+	69	Q8IUA7-1	0	4872	ENST00000453985.6	72	4830	+	102	Q8IUA7-1#2	0	69	ENST00000453985.6	732	801	+	69	0	0	7485
Q8IUA7-1#2	0	69	69	Q8IUA7-1	660	729	+	69	Q8IUA7-1	0	4872	ENST00000340001.9	75	4947	++	32	Q8IUA7-1#2	0	69	ENST00000340001.9	735	804	+	69	0	0	7486
Q8IUA7-1#3	0	63	63	Q8IUA7-1	804	867	+	63	Q8IUA7-1	0	4872	ENST00000453985.6	72	4830	+	102	Q8IUA7-1#3	0	63	ENST00000453985.6	876	939	+	63	0	0	7487
Q8IUA7-1#3	0	63	63	Q8IUA7-1	804	867	+	63	Q8IUA7-1	0	4872	ENST00000340001.9	75	4947	++	32	Q8IUA7-1#3	0	63	ENST00000340001.9	879	942	+	63	0	0	7488
Q8IUA7-1#4	0	63	63	Q8IUA7-1	897	960	+	63	Q8IUA7-1	0	4872	ENST00000453985.6	72	4830	+	102	Q8IUA7-1#4	0	63	ENST00000453985.6	969	1032	+	63	0	0	7489
Q8IUA7-1#4	0	63	63	Q8IUA7-1	897	960	+	63	Q8IUA7-1	0	4872	ENST00000340001.9	75	4947	++	32	Q8IUA7-1#4	0	63	ENST00000340001.9	972	1035	+	63	0	0	7490
Q8IUA7-1#5	0	63	63	Q8IUA7-1	984	1047	+	63	Q8IUA7-1	0	4872	ENST00000453985.6	72	4830	+	102	Q8IUA7-1#5	0	63	ENST00000453985.6	1056	1119	+	63	0	0	7491
Q8IUA7-1#5	0	63	63	Q8IUA7-1	984	1047	+	63	Q8IUA7-1	0	4872	ENST00000340001.9	75	4947	++	32	Q8IUA7-1#5	0	63	ENST00000340001.9	1059	1122	+	63	0	0	7492
Q8IUA7-1#6	0	63	63	Q8IUA7-1	1059	1122	+	63	Q8IUA7-1	0	4872	ENST00000453985.6	72	4830	+	102	Q8IUA7-1#6	0	63	ENST00000453985.6	1131	1194	+	63	0	0	7493
Q8IUA7-1#6	0	63	63	Q8IUA7-1	1059	1122	+	63	Q8IUA7-1	0	4872	ENST00000340001.9	75	4947	++	32	Q8IUA7-1#6	0	63	ENST00000340001.9	1134	1197	+	63	0	0	7494
Q8IUA7-1#7	0	63	63	Q8IUA7-1	1191	1254	+	63	Q8IUA7-1	0	4872	ENST00000453985.6	72	4830	+	102	Q8IUA7-1#7	0	63	ENST00000453985.6	1263	1326	+	63	0	0	7495
Q8IUA7-1#7	0	63	63	Q8IUA7-1	1191	1254	+	63	Q8IUA7-1	0	4872	ENST00000340001.9	75	4947	++	32	Q8IUA7-1#7	0	63	ENST00000340001.9	1266	1329	+	63	0	0	7496
Q8IUA7-1#8	0	63	63	Q8IUA7-1	2589	2652	+	63	Q8IUA7-1	0	4872	ENST00000453985.6	72	4830	+	102	Q8IUA7-1#8	0	63	ENST00000453985.6	2661	2724	+	63	0	0	7497
Q8IUA7-1#8	0	63	63	Q8IUA7-1	2589	2652	+	63	Q8IUA7-1	0	4872	ENST00000340001.9	75	4947	++	32	Q8IUA7-1#8	0	63	ENST00000340001.9	2664	2727	+	63	0	0	7498
Q8IUA7-1#9	0	63	63	Q8IUA7-1	3075	3138	+	63	Q8IUA7-1	0	4872	ENST00000453985.6	72	4830	+	102	Q8IUA7-1#9	0	63	ENST00000453985.6	3147	3210	+	63	0	0	7499
Q8IUA7-1#9	0	63	63	Q8IUA7-1	3075	3138	+	63	Q8IUA7-1	0	4872	ENST00000340001.9	75	4947	++	32	Q8IUA7-1#9	0	63	ENST00000340001.9	3150	3213	+	63	0	0	7500
Q8IUA7-1#10	0	63	63	Q8IUA7-1	3192	3255	+	63	Q8IUA7-1	0	4872	ENST00000453985.6	72	4830	+	102	Q8IUA7-1#10	0	63	ENST00000453985.6	3264	3327	+	63	0	0	7501
Q8IUA7-1#10	0	63	63	Q8IUA7-1	3192	3255	+	63	Q8IUA7-1	0	4872	ENST00000340001.9	75	4947	++	32	Q8IUA7-1#10	0	63	ENST00000340001.9	3267	3330	+	63	0	0	7502
Q8IUA7-1#11	0	63	63	Q8IUA7-1	3321	3384	+	63	Q8IUA7-1	0	4872	ENST00000340001.9	75	4947	++	32	Q8IUA7-1#11	0	63	ENST00000340001.9	3396	3459	+	63	0	0	7503
Q8IUA7-1#12	0	63	63	Q8IUA7-1	3405	3468	+	63	Q8IUA7-1	0	4872	ENST00000453985.6	72	4830	+	102	Q8IUA7-1#12	30	63	ENST00000453985.6	3393	3426	+	33	30	0	7504
Q8IUA7-1#12	0	63	63	Q8IUA7-1	3405	3468	+	63	Q8IUA7-1	0	4872	ENST00000340001.9	75	4947	++	32	Q8IUA7-1#12	0	63	ENST00000340001.9	3480	3543	+	63	0	0	7505
Q8IUA7-1#13	0	63	63	Q8IUA7-1	3486	3549	+	63	Q8IUA7-1	0	4872	ENST00000453985.6	72	4830	+	102	Q8IUA7-1#13	0	63	ENST00000453985.6	3444	3507	+	63	0	0	7506
Q8IUA7-1#13	0	63	63	Q8IUA7-1	3486	3549	+	63	Q8IUA7-1	0	4872	ENST00000340001.9	75	4947	++	32	Q8IUA7-1#13	0	63	ENST00000340001.9	3561	3624	+	63	0	0	7507
Q8IUA7-1#14	0	63	63	Q8IUA7-1	3597	3660	+	63	Q8IUA7-1	0	4872	ENST00000453985.6	72	4830	+	102	Q8IUA7-1#14	0	63	ENST00000453985.6	3555	3618	+	63	0	0	7508
Q8IUA7-1#14	0	63	63	Q8IUA7-1	3597	3660	+	63	Q8IUA7-1	0	4872	ENST00000340001.9	75	4947	++	32	Q8IUA7-1#14	0	63	ENST00000340001.9	3672	3735	+	63	0	0	7509
Q8IUA7-1#15	0	708	708	Q8IUA7-1	1440	2148	+	708	Q8IUA7-1	0	4872	ENST00000453985.6	72	4830	+	102	Q8IUA7-1#15	0	708	ENST00000453985.6	1512	2220	+	708	0	0	7510
Q8IUA7-1#15	0	708	708	Q8IUA7-1	1440	2148	+	708	Q8IUA7-1	0	4872	ENST00000340001.9	75	4947	++	32	Q8IUA7-1#15	0	708	ENST00000340001.9	1515	2223	+	708	0	0	7511
Q8IUA7-1#16	0	702	702	Q8IUA7-1	3861	4563	+	702	Q8IUA7-1	0	4872	ENST00000453985.6	72	4830	+	102	Q8IUA7-1#16	0	702	ENST00000453985.6	3819	4521	+	702	0	0	7512
Q8IUA7-1#16	0	702	702	Q8IUA7-1	3861	4563	+	702	Q8IUA7-1	0	4872	ENST00000340001.9	75	4947	++	32	Q8IUA7-1#16	0	702	ENST00000340001.9	3936	4638	+	702	0	0	7513
Q8IUA7-1#17	0	24	24	Q8IUA7-1	1548	1572	+	24	Q8IUA7-1	0	4872	ENST00000453985.6	72	4830	+	102	Q8IUA7-1#17	0	24	ENST00000453985.6	1620	1644	+	24	0	0	7514
Q8IUA7-1#17	0	24	24	Q8IUA7-1	1548	1572	+	24	Q8IUA7-1	0	4872	ENST00000340001.9	75	4947	++	32	Q8IUA7-1#17	0	24	ENST00000340001.9	1623	1647	+	24	0	0	7515
Q8IUA7-1#18	0	24	24	Q8IUA7-1	3975	3999	+	24	Q8IUA7-1	0	4872	ENST00000453985.6	72	4830	+	102	Q8IUA7-1#18	0	24	ENST00000453985.6	3933	3957	+	24	0	0	7516
Q8IUA7-1#18	0	24	24	Q8IUA7-1	3975	3999	+	24	Q8IUA7-1	0	4872	ENST00000340001.9	75	4947	++	32	Q8IUA7-1#18	0	24	ENST00000340001.9	4050	4074	+	24	0	0	7517
Q8IUA7-1#19	0	3	3	Q8IUA7-1	357	360	+	3	Q8IUA7-1	0	801	ENST00000495634.5	54	855	++	122	Q8IUA7-1#19	0	3	ENST00000495634.5	411	414	+	3	0	0	7518
Q8IUA7-1#19	0	3	3	Q8IUA7-1	357	360	+	3	Q8IUA7-1	0	4872	ENST00000453985.6	72	4830	+	102	Q8IUA7-1#19	0	3	ENST00000453985.6	429	432	+	3	0	0	7519
Q8IUA7-1#19	0	3	3	Q8IUA7-1	357	360	+	3	Q8IUA7-1	0	4872	ENST00000340001.9	75	4947	++	32	Q8IUA7-1#19	0	3	ENST00000340001.9	432	435	+	3	0	0	7520
Q8IUA7-1#20	0	3	3	Q8IUA7-1	582	585	+	3	Q8IUA7-1	0	801	ENST00000495634.5	54	855	++	122	Q8IUA7-1#20	0	3	ENST00000495634.5	636	639	+	3	0	0	7521
Q8IUA7-1#20	0	3	3	Q8IUA7-1	582	585	+	3	Q8IUA7-1	0	4872	ENST00000453985.6	72	4830	+	102	Q8IUA7-1#20	0	3	ENST00000453985.6	654	657	+	3	0	0	7522
Q8IUA7-1#20	0	3	3	Q8IUA7-1	582	585	+	3	Q8IUA7-1	0	4872	ENST00000340001.9	75	4947	++	32	Q8IUA7-1#20	0	3	ENST00000340001.9	657	660	+	3	0	0	7523
Q8IUA7-1#21	0	3	3	Q8IUA7-1	2844	2847	+	3	Q8IUA7-1	0	4872	ENST00000453985.6	72	4830	+	102	Q8IUA7-1#21	0	3	ENST00000453985.6	2916	2919	+	3	0	0	7524
Q8IUA7-1#21	0	3	3	Q8IUA7-1	2844	2847	+	3	Q8IUA7-1	0	4872	ENST00000340001.9	75	4947	++	32	Q8IUA7-1#21	0	3	ENST00000340001.9	2919	2922	+	3	0	0	7525
Q8IUA7-1#22	0	4074	4074	Q8IUA7-1	798	4872	+	4074	Q8IUA7-1	0	801	ENST00000495634.5	54	855	++	122	Q8IUA7-1#22	0	3	ENST00000495634.5	852	855	+	3	0	4071	7526
Q8IUA7-1#22	0	4074	4074	Q8IUA7-1	798	4872	+	4074	Q8IUA7-1	0	4872	ENST00000453985.6	72	4830	+	102	Q8IUA7-1#22	0	4074	ENST00000453985.6	870	4830	+	3960	0	0	7527
Q8IUA7-1#22	0	4074	4074	Q8IUA7-1	798	4872	+	4074	Q8IUA7-1	0	4872	ENST00000340001.9	75	4947	++	32	Q8IUA7-1#22	0	4074	ENST00000340001.9	873	4947	+	4074	0	0	7528
Q8IUA7-1#23	0	4071	4071	Q8IUA7-1	801	4872	+	4071	Q8IUA7-1	0	4872	ENST00000453985.6	72	4830	+	102	Q8IUA7-1#23	0	4071	ENST00000453985.6	873	4830	+	3957	0	0	7529
Q8IUA7-1#23	0	4071	4071	Q8IUA7-1	801	4872	+	4071	Q8IUA7-1	0	4872	ENST00000340001.9	75	4947	++	32	Q8IUA7-1#23	0	4071	ENST00000340001.9	876	4947	+	4071	0	0	7530
Q8IUA7-1#24	0	3	3	Q8IUA7-1	4284	4287	+	3	Q8IUA7-1	0	4872	ENST00000453985.6	72	4830	+	102	Q8IUA7-1#24	0	3	ENST00000453985.6	4242	4245	+	3	0	0	7531
Q8IUA7-1#24	0	3	3	Q8IUA7-1	4284	4287	+	3	Q8IUA7-1	0	4872	ENST00000340001.9	75	4947	++	32	Q8IUA7-1#24	0	3	ENST00000340001.9	4359	4362	+	3	0	0	7532
Q8IUA7-1#25	0	3	3	Q8IUA7-1	4284	4287	+	3	Q8IUA7-1	0	4872	ENST00000453985.6	72	4830	+	102	Q8IUA7-1#25	0	3	ENST00000453985.6	4242	4245	+	3	0	0	7533
Q8IUA7-1#25	0	3	3	Q8IUA7-1	4284	4287	+	3	Q8IUA7-1	0	4872	ENST00000340001.9	75	4947	++	32	Q8IUA7-1#25	0	3	ENST00000340001.9	4359	4362	+	3	0	0	7534
Q8IUA7-1#26	0	585	585	Q8IUA7-1	4287	4872	+	585	Q8IUA7-1	0	4872	ENST00000453985.6	72	4830	+	102	Q8IUA7-1#26	0	585	ENST00000453985.6	4245	4830	+	585	0	0	7535
Q8IUA7-1#26	0	585	585	Q8IUA7-1	4287	4872	+	585	Q8IUA7-1	0	4872	ENST00000340001.9	75	4947	++	32	Q8IUA7-1#26	0	585	ENST00000340001.9	4362	4947	+	585	0	0	7536
Q8IUA7-1#27	0	3	3	Q8IUA7-1	1056	1059	+	3	Q8IUA7-1	0	4872	ENST00000453985.6	72	4830	+	102	Q8IUA7-1#27	0	3	ENST00000453985.6	1128	1131	+	3	0	0	7537
Q8IUA7-1#27	0	3	3	Q8IUA7-1	1056	1059	+	3	Q8IUA7-1	0	4872	ENST00000340001.9	75	4947	++	32	Q8IUA7-1#27	0	3	ENST00000340001.9	1131	1134	+	3	0	0	7538
Q8IUA7-1#28	0	3	3	Q8IUA7-1	2352	2355	+	3	Q8IUA7-1	0	4872	ENST00000453985.6	72	4830	+	102	Q8IUA7-1#28	0	3	ENST00000453985.6	2424	2427	+	3	0	0	7539
Q8IUA7-1#28	0	3	3	Q8IUA7-1	2352	2355	+	3	Q8IUA7-1	0	4872	ENST00000340001.9	75	4947	++	32	Q8IUA7-1#28	0	3	ENST00000340001.9	2427	2430	+	3	0	0	7540
Q8IUA7-1#29	0	3	3	Q8IUA7-1	3915	3918	+	3	Q8IUA7-1	0	4872	ENST00000453985.6	72	4830	+	102	Q8IUA7-1#29	0	3	ENST00000453985.6	3873	3876	+	3	0	0	7541
Q8IUA7-1#29	0	3	3	Q8IUA7-1	3915	3918	+	3	Q8IUA7-1	0	4872	ENST00000340001.9	75	4947	++	32	Q8IUA7-1#29	0	3	ENST00000340001.9	3990	3993	+	3	0	0	7542
Q8IUA7-1#30	0	3	3	Q8IUA7-1	4065	4068	+	3	Q8IUA7-1	0	4872	ENST00000453985.6	72	4830	+	102	Q8IUA7-1#30	0	3	ENST00000453985.6	4023	4026	+	3	0	0	7543
Q8IUA7-1#30	0	3	3	Q8IUA7-1	4065	4068	+	3	Q8IUA7-1	0	4872	ENST00000340001.9	75	4947	++	32	Q8IUA7-1#30	0	3	ENST00000340001.9	4140	4143	+	3	0	0	7544
Q8IUA7-1#31	0	3	3	Q8IUA7-1	4287	4290	+	3	Q8IUA7-1	0	4872	ENST00000453985.6	72	4830	+	102	Q8IUA7-1#31	0	3	ENST00000453985.6	4245	4248	+	3	0	0	7545
Q8IUA7-1#31	0	3	3	Q8IUA7-1	4287	4290	+	3	Q8IUA7-1	0	4872	ENST00000340001.9	75	4947	++	32	Q8IUA7-1#31	0	3	ENST00000340001.9	4362	4365	+	3	0	0	7546
Q8WWZ4-1#0	0	4629	4629	Q8WWZ4-1	0	4629	+	4629	Q8WWZ4-1	0	4629	ENST00000690296.1	556	5185	++	276	Q8WWZ4-1#0	0	4629	ENST00000690296.1	556	5185	+	4629	0	0	7547
Q8WWZ4-1#0	0	4629	4629	Q8WWZ4-1	0	4629	+	4629	Q8WWZ4-1	118	530	ENST00000524273.1	0	412	+	142	Q8WWZ4-1#0	118	530	ENST00000524273.1	0	412	+	412	118	4099	7548
Q8WWZ4-1#0	0	4629	4629	Q8WWZ4-1	0	4629	+	4629	Q8WWZ4-1	0	204	ENST00000523512.5	409	613	++	141	Q8WWZ4-1#0	0	204	ENST00000523512.5	409	613	+	204	0	4425	7549
Q8WWZ4-1#0	0	4629	4629	Q8WWZ4-1	0	4629	+	4629	Q8WWZ4-1	0	4057	ENST00000523419.5	84	4065	+	140	Q8WWZ4-1#0	0	4057	ENST00000523419.5	84	4065	+	3981	0	572	7550
Q8WWZ4-1#0	0	4629	4629	Q8WWZ4-1	0	4629	+	4629	Q8WWZ4-1	4398	4533	ENST00000522787.5	0	135	+	139	Q8WWZ4-1#0	4398	4533	ENST00000522787.5	0	135	+	135	4398	96	7551
Q8WWZ4-1#0	0	4629	4629	Q8WWZ4-1	0	4629	+	4629	Q8WWZ4-1	0	1236	ENST00000522406.5	387	1623	++	138	Q8WWZ4-1#0	0	1236	ENST00000522406.5	387	1623	+	1236	0	3393	7552
Q8WWZ4-1#0	0	4629	4629	Q8WWZ4-1	0	4629	+	4629	Q8WWZ4-1	4397	4533	ENST00000521538.5	0	136	+	136	Q8WWZ4-1#0	4397	4533	ENST00000521538.5	0	136	+	136	4397	96	7553
Q8WWZ4-1#0	0	4629	4629	Q8WWZ4-1	0	4629	+	4629	Q8WWZ4-1	0	1192	ENST00000518929.5	84	1107	+	135	Q8WWZ4-1#0	0	1192	ENST00000518929.5	84	1107	+	1023	0	3437	7554
Q8WWZ4-1#0	0	4629	4629	Q8WWZ4-1	0	4629	+	4629	Q8WWZ4-1	0	4629	ENST00000269081.8	910	5539	++	12	Q8WWZ4-1#0	0	4629	ENST00000269081.8	910	5539	+	4629	0	0	7555
Q8WWZ4-1#1	0	63	63	Q8WWZ4-1	246	309	+	63	Q8WWZ4-1	0	4629	ENST00000690296.1	556	5185	++	276	Q8WWZ4-1#1	0	63	ENST00000690296.1	802	865	+	63	0	0	7556
Q8WWZ4-1#1	0	63	63	Q8WWZ4-1	246	309	+	63	Q8WWZ4-1	118	530	ENST00000524273.1	0	412	+	142	Q8WWZ4-1#1	0	63	ENST00000524273.1	128	191	+	63	0	0	7557
Q8WWZ4-1#1	0	63	63	Q8WWZ4-1	246	309	+	63	Q8WWZ4-1	0	4057	ENST00000523419.5	84	4065	+	140	Q8WWZ4-1#1	0	63	ENST00000523419.5	330	393	+	63	0	0	7558
Q8WWZ4-1#1	0	63	63	Q8WWZ4-1	246	309	+	63	Q8WWZ4-1	0	1236	ENST00000522406.5	387	1623	++	138	Q8WWZ4-1#1	0	63	ENST00000522406.5	633	696	+	63	0	0	7559
Q8WWZ4-1#1	0	63	63	Q8WWZ4-1	246	309	+	63	Q8WWZ4-1	0	1192	ENST00000518929.5	84	1107	+	135	Q8WWZ4-1#1	0	63	ENST00000518929.5	330	393	+	63	0	0	7560
Q8WWZ4-1#1	0	63	63	Q8WWZ4-1	246	309	+	63	Q8WWZ4-1	0	4629	ENST00000269081.8	910	5539	++	12	Q8WWZ4-1#1	0	63	ENST00000269081.8	1156	1219	+	63	0	0	7561
Q8WWZ4-1#2	0	63	63	Q8WWZ4-1	402	465	+	63	Q8WWZ4-1	0	4629	ENST00000690296.1	556	5185	++	276	Q8WWZ4-1#2	0	63	ENST00000690296.1	958	1021	+	63	0	0	7562
Q8WWZ4-1#2	0	63	63	Q8WWZ4-1	402	465	+	63	Q8WWZ4-1	118	530	ENST00000524273.1	0	412	+	142	Q8WWZ4-1#2	0	63	ENST00000524273.1	284	347	+	63	0	0	7563
Q8WWZ4-1#2	0	63	63	Q8WWZ4-1	402	465	+	63	Q8WWZ4-1	0	4057	ENST00000523419.5	84	4065	+	140	Q8WWZ4-1#2	0	63	ENST00000523419.5	486	549	+	63	0	0	7564
Q8WWZ4-1#2	0	63	63	Q8WWZ4-1	402	465	+	63	Q8WWZ4-1	0	1236	ENST00000522406.5	387	1623	++	138	Q8WWZ4-1#2	0	63	ENST00000522406.5	789	852	+	63	0	0	7565
Q8WWZ4-1#2	0	63	63	Q8WWZ4-1	402	465	+	63	Q8WWZ4-1	0	1192	ENST00000518929.5	84	1107	+	135	Q8WWZ4-1#2	0	63	ENST00000518929.5	486	549	+	63	0	0	7566
Q8WWZ4-1#2	0	63	63	Q8WWZ4-1	402	465	+	63	Q8WWZ4-1	0	4629	ENST00000269081.8	910	5539	++	12	Q8WWZ4-1#2	0	63	ENST00000269081.8	1312	1375	+	63	0	0	7567
Q8WWZ4-1#3	0	63	63	Q8WWZ4-1	552	615	+	63	Q8WWZ4-1	0	4629	ENST00000690296.1	556	5185	++	276	Q8WWZ4-1#3	0	63	ENST00000690296.1	1108	1171	+	63	0	0	7568
Q8WWZ4-1#3	0	63	63	Q8WWZ4-1	552	615	+	63	Q8WWZ4-1	0	4057	ENST00000523419.5	84	4065	+	140	Q8WWZ4-1#3	0	63	ENST00000523419.5	636	699	+	63	0	0	7569
Q8WWZ4-1#3	0	63	63	Q8WWZ4-1	552	615	+	63	Q8WWZ4-1	0	1236	ENST00000522406.5	387	1623	++	138	Q8WWZ4-1#3	0	63	ENST00000522406.5	939	1002	+	63	0	0	7570
Q8WWZ4-1#3	0	63	63	Q8WWZ4-1	552	615	+	63	Q8WWZ4-1	0	1192	ENST00000518929.5	84	1107	+	135	Q8WWZ4-1#3	0	63	ENST00000518929.5	636	699	+	63	0	0	7571
Q8WWZ4-1#3	0	63	63	Q8WWZ4-1	552	615	+	63	Q8WWZ4-1	0	4629	ENST00000269081.8	910	5539	++	12	Q8WWZ4-1#3	0	63	ENST00000269081.8	1462	1525	+	63	0	0	7572
Q8WWZ4-1#4	0	63	63	Q8WWZ4-1	627	690	+	63	Q8WWZ4-1	0	4629	ENST00000690296.1	556	5185	++	276	Q8WWZ4-1#4	0	63	ENST00000690296.1	1183	1246	+	63	0	0	7573
Q8WWZ4-1#4	0	63	63	Q8WWZ4-1	627	690	+	63	Q8WWZ4-1	0	4057	ENST00000523419.5	84	4065	+	140	Q8WWZ4-1#4	0	63	ENST00000523419.5	711	774	+	63	0	0	7574
Q8WWZ4-1#4	0	63	63	Q8WWZ4-1	627	690	+	63	Q8WWZ4-1	0	1236	ENST00000522406.5	387	1623	++	138	Q8WWZ4-1#4	0	63	ENST00000522406.5	1014	1077	+	63	0	0	7575
Q8WWZ4-1#4	0	63	63	Q8WWZ4-1	627	690	+	63	Q8WWZ4-1	0	1192	ENST00000518929.5	84	1107	+	135	Q8WWZ4-1#4	0	63	ENST00000518929.5	711	774	+	63	0	0	7576
Q8WWZ4-1#4	0	63	63	Q8WWZ4-1	627	690	+	63	Q8WWZ4-1	0	4629	ENST00000269081.8	910	5539	++	12	Q8WWZ4-1#4	0	63	ENST00000269081.8	1537	1600	+	63	0	0	7577
Q8WWZ4-1#5	0	63	63	Q8WWZ4-1	717	780	+	63	Q8WWZ4-1	0	4629	ENST00000690296.1	556	5185	++	276	Q8WWZ4-1#5	0	63	ENST00000690296.1	1273	1336	+	63	0	0	7578
Q8WWZ4-1#5	0	63	63	Q8WWZ4-1	717	780	+	63	Q8WWZ4-1	0	4057	ENST00000523419.5	84	4065	+	140	Q8WWZ4-1#5	0	63	ENST00000523419.5	801	864	+	63	0	0	7579
Q8WWZ4-1#5	0	63	63	Q8WWZ4-1	717	780	+	63	Q8WWZ4-1	0	1236	ENST00000522406.5	387	1623	++	138	Q8WWZ4-1#5	0	63	ENST00000522406.5	1104	1167	+	63	0	0	7580
Q8WWZ4-1#5	0	63	63	Q8WWZ4-1	717	780	+	63	Q8WWZ4-1	0	1192	ENST00000518929.5	84	1107	+	135	Q8WWZ4-1#5	0	63	ENST00000518929.5	801	864	+	63	0	0	7581
Q8WWZ4-1#5	0	63	63	Q8WWZ4-1	717	780	+	63	Q8WWZ4-1	0	4629	ENST00000269081.8	910	5539	++	12	Q8WWZ4-1#5	0	63	ENST00000269081.8	1627	1690	+	63	0	0	7582
Q8WWZ4-1#6	0	63	63	Q8WWZ4-1	789	852	+	63	Q8WWZ4-1	0	4629	ENST00000690296.1	556	5185	++	276	Q8WWZ4-1#6	0	63	ENST00000690296.1	1345	1408	+	63	0	0	7583
Q8WWZ4-1#6	0	63	63	Q8WWZ4-1	789	852	+	63	Q8WWZ4-1	0	4057	ENST00000523419.5	84	4065	+	140	Q8WWZ4-1#6	0	63	ENST00000523419.5	873	936	+	63	0	0	7584
Q8WWZ4-1#6	0	63	63	Q8WWZ4-1	789	852	+	63	Q8WWZ4-1	0	1236	ENST00000522406.5	387	1623	++	138	Q8WWZ4-1#6	0	63	ENST00000522406.5	1176	1239	+	63	0	0	7585
Q8WWZ4-1#6	0	63	63	Q8WWZ4-1	789	852	+	63	Q8WWZ4-1	0	1192	ENST00000518929.5	84	1107	+	135	Q8WWZ4-1#6	0	63	ENST00000518929.5	873	936	+	63	0	0	7586
Q8WWZ4-1#6	0	63	63	Q8WWZ4-1	789	852	+	63	Q8WWZ4-1	0	4629	ENST00000269081.8	910	5539	++	12	Q8WWZ4-1#6	0	63	ENST00000269081.8	1699	1762	+	63	0	0	7587
Q8WWZ4-1#7	0	63	63	Q8WWZ4-1	927	990	+	63	Q8WWZ4-1	0	4629	ENST00000690296.1	556	5185	++	276	Q8WWZ4-1#7	0	63	ENST00000690296.1	1483	1546	+	63	0	0	7588
Q8WWZ4-1#7	0	63	63	Q8WWZ4-1	927	990	+	63	Q8WWZ4-1	0	4057	ENST00000523419.5	84	4065	+	140	Q8WWZ4-1#7	0	63	ENST00000523419.5	1011	1074	+	63	0	0	7589
Q8WWZ4-1#7	0	63	63	Q8WWZ4-1	927	990	+	63	Q8WWZ4-1	0	1236	ENST00000522406.5	387	1623	++	138	Q8WWZ4-1#7	0	63	ENST00000522406.5	1314	1377	+	63	0	0	7590
Q8WWZ4-1#7	0	63	63	Q8WWZ4-1	927	990	+	63	Q8WWZ4-1	0	1192	ENST00000518929.5	84	1107	+	135	Q8WWZ4-1#7	0	63	ENST00000518929.5	1011	1074	+	63	0	0	7591
Q8WWZ4-1#7	0	63	63	Q8WWZ4-1	927	990	+	63	Q8WWZ4-1	0	4629	ENST00000269081.8	910	5539	++	12	Q8WWZ4-1#7	0	63	ENST00000269081.8	1837	1900	+	63	0	0	7592
Q8WWZ4-1#8	0	63	63	Q8WWZ4-1	2319	2382	+	63	Q8WWZ4-1	0	4629	ENST00000690296.1	556	5185	++	276	Q8WWZ4-1#8	0	63	ENST00000690296.1	2875	2938	+	63	0	0	7593
Q8WWZ4-1#8	0	63	63	Q8WWZ4-1	2319	2382	+	63	Q8WWZ4-1	0	4057	ENST00000523419.5	84	4065	+	140	Q8WWZ4-1#8	0	63	ENST00000523419.5	2403	2466	+	63	0	0	7594
Q8WWZ4-1#8	0	63	63	Q8WWZ4-1	2319	2382	+	63	Q8WWZ4-1	0	4629	ENST00000269081.8	910	5539	++	12	Q8WWZ4-1#8	0	63	ENST00000269081.8	3229	3292	+	63	0	0	7595
Q8WWZ4-1#9	0	63	63	Q8WWZ4-1	2667	2730	+	63	Q8WWZ4-1	0	4629	ENST00000690296.1	556	5185	++	276	Q8WWZ4-1#9	0	63	ENST00000690296.1	3223	3286	+	63	0	0	7596
Q8WWZ4-1#9	0	63	63	Q8WWZ4-1	2667	2730	+	63	Q8WWZ4-1	0	4057	ENST00000523419.5	84	4065	+	140	Q8WWZ4-1#9	0	63	ENST00000523419.5	2751	2814	+	63	0	0	7597
Q8WWZ4-1#9	0	63	63	Q8WWZ4-1	2667	2730	+	63	Q8WWZ4-1	0	4629	ENST00000269081.8	910	5539	++	12	Q8WWZ4-1#9	0	63	ENST00000269081.8	3577	3640	+	63	0	0	7598
Q8WWZ4-1#10	0	63	63	Q8WWZ4-1	2775	2838	+	63	Q8WWZ4-1	0	4629	ENST00000690296.1	556	5185	++	276	Q8WWZ4-1#10	0	63	ENST00000690296.1	3331	3394	+	63	0	0	7599
Q8WWZ4-1#10	0	63	63	Q8WWZ4-1	2775	2838	+	63	Q8WWZ4-1	0	4057	ENST00000523419.5	84	4065	+	140	Q8WWZ4-1#10	0	63	ENST00000523419.5	2859	2922	+	63	0	0	7600
Q8WWZ4-1#10	0	63	63	Q8WWZ4-1	2775	2838	+	63	Q8WWZ4-1	0	4629	ENST00000269081.8	910	5539	++	12	Q8WWZ4-1#10	0	63	ENST00000269081.8	3685	3748	+	63	0	0	7601
Q8WWZ4-1#11	0	63	63	Q8WWZ4-1	2952	3015	+	63	Q8WWZ4-1	0	4629	ENST00000690296.1	556	5185	++	276	Q8WWZ4-1#11	0	63	ENST00000690296.1	3508	3571	+	63	0	0	7602
Q8WWZ4-1#11	0	63	63	Q8WWZ4-1	2952	3015	+	63	Q8WWZ4-1	0	4057	ENST00000523419.5	84	4065	+	140	Q8WWZ4-1#11	0	63	ENST00000523419.5	3036	3099	+	63	0	0	7603
Q8WWZ4-1#11	0	63	63	Q8WWZ4-1	2952	3015	+	63	Q8WWZ4-1	0	4629	ENST00000269081.8	910	5539	++	12	Q8WWZ4-1#11	0	63	ENST00000269081.8	3862	3925	+	63	0	0	7604
Q8WWZ4-1#12	0	63	63	Q8WWZ4-1	3039	3102	+	63	Q8WWZ4-1	0	4629	ENST00000690296.1	556	5185	++	276	Q8WWZ4-1#12	0	63	ENST00000690296.1	3595	3658	+	63	0	0	7605
Q8WWZ4-1#12	0	63	63	Q8WWZ4-1	3039	3102	+	63	Q8WWZ4-1	0	4057	ENST00000523419.5	84	4065	+	140	Q8WWZ4-1#12	0	63	ENST00000523419.5	3123	3186	+	63	0	0	7606
Q8WWZ4-1#12	0	63	63	Q8WWZ4-1	3039	3102	+	63	Q8WWZ4-1	0	4629	ENST00000269081.8	910	5539	++	12	Q8WWZ4-1#12	0	63	ENST00000269081.8	3949	4012	+	63	0	0	7607
Q8WWZ4-1#13	0	63	63	Q8WWZ4-1	3135	3198	+	63	Q8WWZ4-1	0	4629	ENST00000690296.1	556	5185	++	276	Q8WWZ4-1#13	0	63	ENST00000690296.1	3691	3754	+	63	0	0	7608
Q8WWZ4-1#13	0	63	63	Q8WWZ4-1	3135	3198	+	63	Q8WWZ4-1	0	4057	ENST00000523419.5	84	4065	+	140	Q8WWZ4-1#13	0	63	ENST00000523419.5	3219	3282	+	63	0	0	7609
Q8WWZ4-1#13	0	63	63	Q8WWZ4-1	3135	3198	+	63	Q8WWZ4-1	0	4629	ENST00000269081.8	910	5539	++	12	Q8WWZ4-1#13	0	63	ENST00000269081.8	4045	4108	+	63	0	0	7610
Q8WWZ4-1#14	0	63	63	Q8WWZ4-1	3216	3279	+	63	Q8WWZ4-1	0	4629	ENST00000690296.1	556	5185	++	276	Q8WWZ4-1#14	0	63	ENST00000690296.1	3772	3835	+	63	0	0	7611
Q8WWZ4-1#14	0	63	63	Q8WWZ4-1	3216	3279	+	63	Q8WWZ4-1	0	4057	ENST00000523419.5	84	4065	+	140	Q8WWZ4-1#14	0	63	ENST00000523419.5	3300	3363	+	63	0	0	7612
Q8WWZ4-1#14	0	63	63	Q8WWZ4-1	3216	3279	+	63	Q8WWZ4-1	0	4629	ENST00000269081.8	910	5539	++	12	Q8WWZ4-1#14	0	63	ENST00000269081.8	4126	4189	+	63	0	0	7613
Q8WWZ4-1#15	0	63	63	Q8WWZ4-1	3336	3399	+	63	Q8WWZ4-1	0	4629	ENST00000690296.1	556	5185	++	276	Q8WWZ4-1#15	0	63	ENST00000690296.1	3892	3955	+	63	0	0	7614
Q8WWZ4-1#15	0	63	63	Q8WWZ4-1	3336	3399	+	63	Q8WWZ4-1	0	4057	ENST00000523419.5	84	4065	+	140	Q8WWZ4-1#15	0	63	ENST00000523419.5	3420	3483	+	63	0	0	7615
Q8WWZ4-1#15	0	63	63	Q8WWZ4-1	3336	3399	+	63	Q8WWZ4-1	0	4629	ENST00000269081.8	910	5539	++	12	Q8WWZ4-1#15	0	63	ENST00000269081.8	4246	4309	+	63	0	0	7616
Q8WWZ4-1#16	0	708	708	Q8WWZ4-1	1170	1878	+	708	Q8WWZ4-1	0	4629	ENST00000690296.1	556	5185	++	276	Q8WWZ4-1#16	0	708	ENST00000690296.1	1726	2434	+	708	0	0	7617
Q8WWZ4-1#16	0	708	708	Q8WWZ4-1	1170	1878	+	708	Q8WWZ4-1	0	4057	ENST00000523419.5	84	4065	+	140	Q8WWZ4-1#16	0	708	ENST00000523419.5	1254	1962	+	708	0	0	7618
Q8WWZ4-1#16	0	708	708	Q8WWZ4-1	1170	1878	+	708	Q8WWZ4-1	0	1236	ENST00000522406.5	387	1623	++	138	Q8WWZ4-1#16	0	66	ENST00000522406.5	1557	1623	+	66	0	642	7619
Q8WWZ4-1#16	0	708	708	Q8WWZ4-1	1170	1878	+	708	Q8WWZ4-1	0	1192	ENST00000518929.5	84	1107	+	135	Q8WWZ4-1#16	5	22	ENST00000518929.5	1090	1107	+	17	5	686	7620
Q8WWZ4-1#16	0	708	708	Q8WWZ4-1	1170	1878	+	708	Q8WWZ4-1	0	4629	ENST00000269081.8	910	5539	++	12	Q8WWZ4-1#16	0	708	ENST00000269081.8	2080	2788	+	708	0	0	7621
Q8WWZ4-1#17	0	705	705	Q8WWZ4-1	3615	4320	+	705	Q8WWZ4-1	0	4629	ENST00000690296.1	556	5185	++	276	Q8WWZ4-1#17	0	705	ENST00000690296.1	4171	4876	+	705	0	0	7622
Q8WWZ4-1#17	0	705	705	Q8WWZ4-1	3615	4320	+	705	Q8WWZ4-1	0	4057	ENST00000523419.5	84	4065	+	140	Q8WWZ4-1#17	0	442	ENST00000523419.5	3699	4065	+	366	0	263	7623
Q8WWZ4-1#17	0	705	705	Q8WWZ4-1	3615	4320	+	705	Q8WWZ4-1	0	4629	ENST00000269081.8	910	5539	++	12	Q8WWZ4-1#17	0	705	ENST00000269081.8	4525	5230	+	705	0	0	7624
Q8WWZ4-1#18	0	75	75	Q8WWZ4-1	3456	3531	+	75	Q8WWZ4-1	0	4629	ENST00000690296.1	556	5185	++	276	Q8WWZ4-1#18	0	75	ENST00000690296.1	4012	4087	+	75	0	0	7625
Q8WWZ4-1#18	0	75	75	Q8WWZ4-1	3456	3531	+	75	Q8WWZ4-1	0	4057	ENST00000523419.5	84	4065	+	140	Q8WWZ4-1#18	0	75	ENST00000523419.5	3540	3615	+	75	0	0	7626
Q8WWZ4-1#18	0	75	75	Q8WWZ4-1	3456	3531	+	75	Q8WWZ4-1	0	4629	ENST00000269081.8	910	5539	++	12	Q8WWZ4-1#18	0	75	ENST00000269081.8	4366	4441	+	75	0	0	7627
Q8WWZ4-1#19	0	24	24	Q8WWZ4-1	1278	1302	+	24	Q8WWZ4-1	0	4629	ENST00000690296.1	556	5185	++	276	Q8WWZ4-1#19	0	24	ENST00000690296.1	1834	1858	+	24	0	0	7628
Q8WWZ4-1#19	0	24	24	Q8WWZ4-1	1278	1302	+	24	Q8WWZ4-1	0	4057	ENST00000523419.5	84	4065	+	140	Q8WWZ4-1#19	0	24	ENST00000523419.5	1362	1386	+	24	0	0	7629
Q8WWZ4-1#19	0	24	24	Q8WWZ4-1	1278	1302	+	24	Q8WWZ4-1	0	4629	ENST00000269081.8	910	5539	++	12	Q8WWZ4-1#19	0	24	ENST00000269081.8	2188	2212	+	24	0	0	7630
Q8WWZ4-1#20	0	24	24	Q8WWZ4-1	3714	3738	+	24	Q8WWZ4-1	0	4629	ENST00000690296.1	556	5185	++	276	Q8WWZ4-1#20	0	24	ENST00000690296.1	4270	4294	+	24	0	0	7631
Q8WWZ4-1#20	0	24	24	Q8WWZ4-1	3714	3738	+	24	Q8WWZ4-1	0	4057	ENST00000523419.5	84	4065	+	140	Q8WWZ4-1#20	0	24	ENST00000523419.5	3798	3822	+	24	0	0	7632
Q8WWZ4-1#20	0	24	24	Q8WWZ4-1	3714	3738	+	24	Q8WWZ4-1	0	4629	ENST00000269081.8	910	5539	++	12	Q8WWZ4-1#20	0	24	ENST00000269081.8	4624	4648	+	24	0	0	7633
Q8WWZ4-1#21	0	69	69	Q8WWZ4-1	0	69	+	69	Q8WWZ4-1	0	4629	ENST00000690296.1	556	5185	++	276	Q8WWZ4-1#21	0	69	ENST00000690296.1	556	625	+	69	0	0	7634
Q8WWZ4-1#21	0	69	69	Q8WWZ4-1	0	69	+	69	Q8WWZ4-1	0	204	ENST00000523512.5	409	613	++	141	Q8WWZ4-1#21	0	69	ENST00000523512.5	409	478	+	69	0	0	7635
Q8WWZ4-1#21	0	69	69	Q8WWZ4-1	0	69	+	69	Q8WWZ4-1	0	4057	ENST00000523419.5	84	4065	+	140	Q8WWZ4-1#21	0	69	ENST00000523419.5	84	153	+	69	0	0	7636
Q8WWZ4-1#21	0	69	69	Q8WWZ4-1	0	69	+	69	Q8WWZ4-1	0	1236	ENST00000522406.5	387	1623	++	138	Q8WWZ4-1#21	0	69	ENST00000522406.5	387	456	+	69	0	0	7637
Q8WWZ4-1#21	0	69	69	Q8WWZ4-1	0	69	+	69	Q8WWZ4-1	0	1192	ENST00000518929.5	84	1107	+	135	Q8WWZ4-1#21	0	69	ENST00000518929.5	84	153	+	69	0	0	7638
Q8WWZ4-1#21	0	69	69	Q8WWZ4-1	0	69	+	69	Q8WWZ4-1	0	4629	ENST00000269081.8	910	5539	++	12	Q8WWZ4-1#21	0	69	ENST00000269081.8	910	979	+	69	0	0	7639
Q8WWZ4-1#22	0	3	3	Q8WWZ4-1	198	201	+	3	Q8WWZ4-1	0	4629	ENST00000690296.1	556	5185	++	276	Q8WWZ4-1#22	0	3	ENST00000690296.1	754	757	+	3	0	0	7640
Q8WWZ4-1#22	0	3	3	Q8WWZ4-1	198	201	+	3	Q8WWZ4-1	118	530	ENST00000524273.1	0	412	+	142	Q8WWZ4-1#22	0	3	ENST00000524273.1	80	83	+	3	0	0	7641
Q8WWZ4-1#22	0	3	3	Q8WWZ4-1	198	201	+	3	Q8WWZ4-1	0	204	ENST00000523512.5	409	613	++	141	Q8WWZ4-1#22	0	3	ENST00000523512.5	607	610	+	3	0	0	7642
Q8WWZ4-1#22	0	3	3	Q8WWZ4-1	198	201	+	3	Q8WWZ4-1	0	4057	ENST00000523419.5	84	4065	+	140	Q8WWZ4-1#22	0	3	ENST00000523419.5	282	285	+	3	0	0	7643
Q8WWZ4-1#22	0	3	3	Q8WWZ4-1	198	201	+	3	Q8WWZ4-1	0	1236	ENST00000522406.5	387	1623	++	138	Q8WWZ4-1#22	0	3	ENST00000522406.5	585	588	+	3	0	0	7644
Q8WWZ4-1#22	0	3	3	Q8WWZ4-1	198	201	+	3	Q8WWZ4-1	0	1192	ENST00000518929.5	84	1107	+	135	Q8WWZ4-1#22	0	3	ENST00000518929.5	282	285	+	3	0	0	7645
Q8WWZ4-1#22	0	3	3	Q8WWZ4-1	198	201	+	3	Q8WWZ4-1	0	4629	ENST00000269081.8	910	5539	++	12	Q8WWZ4-1#22	0	3	ENST00000269081.8	1108	1111	+	3	0	0	7646
Q8WWZ4-1#23	0	4428	4428	Q8WWZ4-1	201	4629	+	4428	Q8WWZ4-1	0	4629	ENST00000690296.1	556	5185	++	276	Q8WWZ4-1#23	0	4428	ENST00000690296.1	757	5185	+	4428	0	0	7647
Q8WWZ4-1#23	0	4428	4428	Q8WWZ4-1	201	4629	+	4428	Q8WWZ4-1	118	530	ENST00000524273.1	0	412	+	142	Q8WWZ4-1#23	0	329	ENST00000524273.1	83	412	+	329	0	4099	7648
Q8WWZ4-1#23	0	4428	4428	Q8WWZ4-1	201	4629	+	4428	Q8WWZ4-1	0	204	ENST00000523512.5	409	613	++	141	Q8WWZ4-1#23	0	3	ENST00000523512.5	610	613	+	3	0	4425	7649
Q8WWZ4-1#23	0	4428	4428	Q8WWZ4-1	201	4629	+	4428	Q8WWZ4-1	0	4057	ENST00000523419.5	84	4065	+	140	Q8WWZ4-1#23	0	3856	ENST00000523419.5	285	4065	+	3780	0	572	7650
Q8WWZ4-1#23	0	4428	4428	Q8WWZ4-1	201	4629	+	4428	Q8WWZ4-1	4398	4533	ENST00000522787.5	0	135	+	139	Q8WWZ4-1#23	4197	4332	ENST00000522787.5	0	135	+	135	4197	96	7651
Q8WWZ4-1#23	0	4428	4428	Q8WWZ4-1	201	4629	+	4428	Q8WWZ4-1	0	1236	ENST00000522406.5	387	1623	++	138	Q8WWZ4-1#23	0	1035	ENST00000522406.5	588	1623	+	1035	0	3393	7652
Q8WWZ4-1#23	0	4428	4428	Q8WWZ4-1	201	4629	+	4428	Q8WWZ4-1	4397	4533	ENST00000521538.5	0	136	+	136	Q8WWZ4-1#23	4196	4332	ENST00000521538.5	0	136	+	136	4196	96	7653
Q8WWZ4-1#23	0	4428	4428	Q8WWZ4-1	201	4629	+	4428	Q8WWZ4-1	0	1192	ENST00000518929.5	84	1107	+	135	Q8WWZ4-1#23	0	991	ENST00000518929.5	285	1107	+	822	0	3437	7654
Q8WWZ4-1#23	0	4428	4428	Q8WWZ4-1	201	4629	+	4428	Q8WWZ4-1	0	4629	ENST00000269081.8	910	5539	++	12	Q8WWZ4-1#23	0	4428	ENST00000269081.8	1111	5539	+	4428	0	0	7655
Q8WWZ4-1#24	0	120	120	Q8WWZ4-1	1236	1356	+	120	Q8WWZ4-1	0	4629	ENST00000690296.1	556	5185	++	276	Q8WWZ4-1#24	0	120	ENST00000690296.1	1792	1912	+	120	0	0	7656
Q8WWZ4-1#24	0	120	120	Q8WWZ4-1	1236	1356	+	120	Q8WWZ4-1	0	4057	ENST00000523419.5	84	4065	+	140	Q8WWZ4-1#24	0	120	ENST00000523419.5	1320	1440	+	120	0	0	7657
Q8WWZ4-1#24	0	120	120	Q8WWZ4-1	1236	1356	+	120	Q8WWZ4-1	0	4629	ENST00000269081.8	910	5539	++	12	Q8WWZ4-1#24	0	120	ENST00000269081.8	2146	2266	+	120	0	0	7658
Q8WWZ4-1#25	0	3	3	Q8WWZ4-1	1347	1350	+	3	Q8WWZ4-1	0	4629	ENST00000690296.1	556	5185	++	276	Q8WWZ4-1#25	0	3	ENST00000690296.1	1903	1906	+	3	0	0	7659
Q8WWZ4-1#25	0	3	3	Q8WWZ4-1	1347	1350	+	3	Q8WWZ4-1	0	4057	ENST00000523419.5	84	4065	+	140	Q8WWZ4-1#25	0	3	ENST00000523419.5	1431	1434	+	3	0	0	7660
Q8WWZ4-1#25	0	3	3	Q8WWZ4-1	1347	1350	+	3	Q8WWZ4-1	0	4629	ENST00000269081.8	910	5539	++	12	Q8WWZ4-1#25	0	3	ENST00000269081.8	2257	2260	+	3	0	0	7661
Q8WWZ4-1#26	0	3279	3279	Q8WWZ4-1	1350	4629	+	3279	Q8WWZ4-1	0	4629	ENST00000690296.1	556	5185	++	276	Q8WWZ4-1#26	0	3279	ENST00000690296.1	1906	5185	+	3279	0	0	7662
Q8WWZ4-1#26	0	3279	3279	Q8WWZ4-1	1350	4629	+	3279	Q8WWZ4-1	0	4057	ENST00000523419.5	84	4065	+	140	Q8WWZ4-1#26	0	2707	ENST00000523419.5	1434	4065	+	2631	0	572	7663
Q8WWZ4-1#26	0	3279	3279	Q8WWZ4-1	1350	4629	+	3279	Q8WWZ4-1	4398	4533	ENST00000522787.5	0	135	+	139	Q8WWZ4-1#26	3048	3183	ENST00000522787.5	0	135	+	135	3048	96	7664
Q8WWZ4-1#26	0	3279	3279	Q8WWZ4-1	1350	4629	+	3279	Q8WWZ4-1	4397	4533	ENST00000521538.5	0	136	+	136	Q8WWZ4-1#26	3047	3183	ENST00000521538.5	0	136	+	136	3047	96	7665
Q8WWZ4-1#26	0	3279	3279	Q8WWZ4-1	1350	4629	+	3279	Q8WWZ4-1	0	4629	ENST00000269081.8	910	5539	++	12	Q8WWZ4-1#26	0	3279	ENST00000269081.8	2260	5539	+	3279	0	0	7666
Q8WWZ4-1#27	0	3273	3273	Q8WWZ4-1	1356	4629	+	3273	Q8WWZ4-1	0	4629	ENST00000690296.1	556	5185	++	276	Q8WWZ4-1#27	0	3273	ENST00000690296.1	1912	5185	+	3273	0	0	7667
Q8WWZ4-1#27	0	3273	3273	Q8WWZ4-1	1356	4629	+	3273	Q8WWZ4-1	0	4057	ENST00000523419.5	84	4065	+	140	Q8WWZ4-1#27	0	2701	ENST00000523419.5	1440	4065	+	2625	0	572	7668
Q8WWZ4-1#27	0	3273	3273	Q8WWZ4-1	1356	4629	+	3273	Q8WWZ4-1	4398	4533	ENST00000522787.5	0	135	+	139	Q8WWZ4-1#27	3042	3177	ENST00000522787.5	0	135	+	135	3042	96	7669
Q8WWZ4-1#27	0	3273	3273	Q8WWZ4-1	1356	4629	+	3273	Q8WWZ4-1	4397	4533	ENST00000521538.5	0	136	+	136	Q8WWZ4-1#27	3041	3177	ENST00000521538.5	0	136	+	136	3041	96	7670
Q8WWZ4-1#27	0	3273	3273	Q8WWZ4-1	1356	4629	+	3273	Q8WWZ4-1	0	4629	ENST00000269081.8	910	5539	++	12	Q8WWZ4-1#27	0	3273	ENST00000269081.8	2266	5539	+	3273	0	0	7671
Q8WWZ4-1#28	0	3	3	Q8WWZ4-1	606	609	+	3	Q8WWZ4-1	0	4629	ENST00000690296.1	556	5185	++	276	Q8WWZ4-1#28	0	3	ENST00000690296.1	1162	1165	+	3	0	0	7672
Q8WWZ4-1#28	0	3	3	Q8WWZ4-1	606	609	+	3	Q8WWZ4-1	0	4057	ENST00000523419.5	84	4065	+	140	Q8WWZ4-1#28	0	3	ENST00000523419.5	690	693	+	3	0	0	7673
Q8WWZ4-1#28	0	3	3	Q8WWZ4-1	606	609	+	3	Q8WWZ4-1	0	1236	ENST00000522406.5	387	1623	++	138	Q8WWZ4-1#28	0	3	ENST00000522406.5	993	996	+	3	0	0	7674
Q8WWZ4-1#28	0	3	3	Q8WWZ4-1	606	609	+	3	Q8WWZ4-1	0	1192	ENST00000518929.5	84	1107	+	135	Q8WWZ4-1#28	0	3	ENST00000518929.5	690	693	+	3	0	0	7675
Q8WWZ4-1#28	0	3	3	Q8WWZ4-1	606	609	+	3	Q8WWZ4-1	0	4629	ENST00000269081.8	910	5539	++	12	Q8WWZ4-1#28	0	3	ENST00000269081.8	1516	1519	+	3	0	0	7676
Q8WWZ4-1#29	0	3	3	Q8WWZ4-1	858	861	+	3	Q8WWZ4-1	0	4629	ENST00000690296.1	556	5185	++	276	Q8WWZ4-1#29	0	3	ENST00000690296.1	1414	1417	+	3	0	0	7677
Q8WWZ4-1#29	0	3	3	Q8WWZ4-1	858	861	+	3	Q8WWZ4-1	0	4057	ENST00000523419.5	84	4065	+	140	Q8WWZ4-1#29	0	3	ENST00000523419.5	942	945	+	3	0	0	7678
Q8WWZ4-1#29	0	3	3	Q8WWZ4-1	858	861	+	3	Q8WWZ4-1	0	1236	ENST00000522406.5	387	1623	++	138	Q8WWZ4-1#29	0	3	ENST00000522406.5	1245	1248	+	3	0	0	7679
Q8WWZ4-1#29	0	3	3	Q8WWZ4-1	858	861	+	3	Q8WWZ4-1	0	1192	ENST00000518929.5	84	1107	+	135	Q8WWZ4-1#29	0	3	ENST00000518929.5	942	945	+	3	0	0	7680
Q8WWZ4-1#29	0	3	3	Q8WWZ4-1	858	861	+	3	Q8WWZ4-1	0	4629	ENST00000269081.8	910	5539	++	12	Q8WWZ4-1#29	0	3	ENST00000269081.8	1768	1771	+	3	0	0	7681
Q8WWZ4-1#30	0	3	3	Q8WWZ4-1	2745	2748	+	3	Q8WWZ4-1	0	4629	ENST00000690296.1	556	5185	++	276	Q8WWZ4-1#30	0	3	ENST00000690296.1	3301	3304	+	3	0	0	7682
Q8WWZ4-1#30	0	3	3	Q8WWZ4-1	2745	2748	+	3	Q8WWZ4-1	0	4057	ENST00000523419.5	84	4065	+	140	Q8WWZ4-1#30	0	3	ENST00000523419.5	2829	2832	+	3	0	0	7683
Q8WWZ4-1#30	0	3	3	Q8WWZ4-1	2745	2748	+	3	Q8WWZ4-1	0	4629	ENST00000269081.8	910	5539	++	12	Q8WWZ4-1#30	0	3	ENST00000269081.8	3655	3658	+	3	0	0	7684
Q8WWZ4-1#31	0	3	3	Q8WWZ4-1	3963	3966	+	3	Q8WWZ4-1	0	4629	ENST00000690296.1	556	5185	++	276	Q8WWZ4-1#31	0	3	ENST00000690296.1	4519	4522	+	3	0	0	7685
Q8WWZ4-1#31	0	3	3	Q8WWZ4-1	3963	3966	+	3	Q8WWZ4-1	0	4057	ENST00000523419.5	84	4065	+	140	Q8WWZ4-1#31	0	2	ENST00000523419.5	4047	4049	+	2	0	1	7686
Q8WWZ4-1#31	0	3	3	Q8WWZ4-1	3963	3966	+	3	Q8WWZ4-1	0	4629	ENST00000269081.8	910	5539	++	12	Q8WWZ4-1#31	0	3	ENST00000269081.8	4873	4876	+	3	0	0	7687
Q8WWZ4-1#32	0	3	3	Q8WWZ4-1	417	420	+	3	Q8WWZ4-1	0	4629	ENST00000690296.1	556	5185	++	276	Q8WWZ4-1#32	0	3	ENST00000690296.1	973	976	+	3	0	0	7688
Q8WWZ4-1#32	0	3	3	Q8WWZ4-1	417	420	+	3	Q8WWZ4-1	118	530	ENST00000524273.1	0	412	+	142	Q8WWZ4-1#32	0	3	ENST00000524273.1	299	302	+	3	0	0	7689
Q8WWZ4-1#32	0	3	3	Q8WWZ4-1	417	420	+	3	Q8WWZ4-1	0	4057	ENST00000523419.5	84	4065	+	140	Q8WWZ4-1#32	0	3	ENST00000523419.5	501	504	+	3	0	0	7690
Q8WWZ4-1#32	0	3	3	Q8WWZ4-1	417	420	+	3	Q8WWZ4-1	0	1236	ENST00000522406.5	387	1623	++	138	Q8WWZ4-1#32	0	3	ENST00000522406.5	804	807	+	3	0	0	7691
Q8WWZ4-1#32	0	3	3	Q8WWZ4-1	417	420	+	3	Q8WWZ4-1	0	1192	ENST00000518929.5	84	1107	+	135	Q8WWZ4-1#32	0	3	ENST00000518929.5	501	504	+	3	0	0	7692
Q8WWZ4-1#32	0	3	3	Q8WWZ4-1	417	420	+	3	Q8WWZ4-1	0	4629	ENST00000269081.8	910	5539	++	12	Q8WWZ4-1#32	0	3	ENST00000269081.8	1327	1330	+	3	0	0	7693
Q8WWZ4-1#33	0	3	3	Q8WWZ4-1	474	477	+	3	Q8WWZ4-1	0	4629	ENST00000690296.1	556	5185	++	276	Q8WWZ4-1#33	0	3	ENST00000690296.1	1030	1033	+	3	0	0	7694
Q8WWZ4-1#33	0	3	3	Q8WWZ4-1	474	477	+	3	Q8WWZ4-1	118	530	ENST00000524273.1	0	412	+	142	Q8WWZ4-1#33	0	3	ENST00000524273.1	356	359	+	3	0	0	7695
Q8WWZ4-1#33	0	3	3	Q8WWZ4-1	474	477	+	3	Q8WWZ4-1	0	4057	ENST00000523419.5	84	4065	+	140	Q8WWZ4-1#33	0	3	ENST00000523419.5	558	561	+	3	0	0	7696
Q8WWZ4-1#33	0	3	3	Q8WWZ4-1	474	477	+	3	Q8WWZ4-1	0	1236	ENST00000522406.5	387	1623	++	138	Q8WWZ4-1#33	0	3	ENST00000522406.5	861	864	+	3	0	0	7697
Q8WWZ4-1#33	0	3	3	Q8WWZ4-1	474	477	+	3	Q8WWZ4-1	0	1192	ENST00000518929.5	84	1107	+	135	Q8WWZ4-1#33	0	3	ENST00000518929.5	558	561	+	3	0	0	7698
Q8WWZ4-1#33	0	3	3	Q8WWZ4-1	474	477	+	3	Q8WWZ4-1	0	4629	ENST00000269081.8	910	5539	++	12	Q8WWZ4-1#33	0	3	ENST00000269081.8	1384	1387	+	3	0	0	7699
Q8WWZ4-1#34	0	3	3	Q8WWZ4-1	558	561	+	3	Q8WWZ4-1	0	4629	ENST00000690296.1	556	5185	++	276	Q8WWZ4-1#34	0	3	ENST00000690296.1	1114	1117	+	3	0	0	7700
Q8WWZ4-1#34	0	3	3	Q8WWZ4-1	558	561	+	3	Q8WWZ4-1	0	4057	ENST00000523419.5	84	4065	+	140	Q8WWZ4-1#34	0	3	ENST00000523419.5	642	645	+	3	0	0	7701
Q8WWZ4-1#34	0	3	3	Q8WWZ4-1	558	561	+	3	Q8WWZ4-1	0	1236	ENST00000522406.5	387	1623	++	138	Q8WWZ4-1#34	0	3	ENST00000522406.5	945	948	+	3	0	0	7702
Q8WWZ4-1#34	0	3	3	Q8WWZ4-1	558	561	+	3	Q8WWZ4-1	0	1192	ENST00000518929.5	84	1107	+	135	Q8WWZ4-1#34	0	3	ENST00000518929.5	642	645	+	3	0	0	7703
Q8WWZ4-1#34	0	3	3	Q8WWZ4-1	558	561	+	3	Q8WWZ4-1	0	4629	ENST00000269081.8	910	5539	++	12	Q8WWZ4-1#34	0	3	ENST00000269081.8	1468	1471	+	3	0	0	7704
Q8WWZ4-1#35	0	3	3	Q8WWZ4-1	969	972	+	3	Q8WWZ4-1	0	4629	ENST00000690296.1	556	5185	++	276	Q8WWZ4-1#35	0	3	ENST00000690296.1	1525	1528	+	3	0	0	7705
Q8WWZ4-1#35	0	3	3	Q8WWZ4-1	969	972	+	3	Q8WWZ4-1	0	4057	ENST00000523419.5	84	4065	+	140	Q8WWZ4-1#35	0	3	ENST00000523419.5	1053	1056	+	3	0	0	7706
Q8WWZ4-1#35	0	3	3	Q8WWZ4-1	969	972	+	3	Q8WWZ4-1	0	1236	ENST00000522406.5	387	1623	++	138	Q8WWZ4-1#35	0	3	ENST00000522406.5	1356	1359	+	3	0	0	7707
Q8WWZ4-1#35	0	3	3	Q8WWZ4-1	969	972	+	3	Q8WWZ4-1	0	1192	ENST00000518929.5	84	1107	+	135	Q8WWZ4-1#35	0	3	ENST00000518929.5	1053	1056	+	3	0	0	7708
Q8WWZ4-1#35	0	3	3	Q8WWZ4-1	969	972	+	3	Q8WWZ4-1	0	4629	ENST00000269081.8	910	5539	++	12	Q8WWZ4-1#35	0	3	ENST00000269081.8	1879	1882	+	3	0	0	7709
Q8WWZ4-1#36	0	3	3	Q8WWZ4-1	1089	1092	+	3	Q8WWZ4-1	0	4629	ENST00000690296.1	556	5185	++	276	Q8WWZ4-1#36	0	3	ENST00000690296.1	1645	1648	+	3	0	0	7710
Q8WWZ4-1#36	0	3	3	Q8WWZ4-1	1089	1092	+	3	Q8WWZ4-1	0	4057	ENST00000523419.5	84	4065	+	140	Q8WWZ4-1#36	0	3	ENST00000523419.5	1173	1176	+	3	0	0	7711
Q8WWZ4-1#36	0	3	3	Q8WWZ4-1	1089	1092	+	3	Q8WWZ4-1	0	1236	ENST00000522406.5	387	1623	++	138	Q8WWZ4-1#36	0	3	ENST00000522406.5	1476	1479	+	3	0	0	7712
Q8WWZ4-1#36	0	3	3	Q8WWZ4-1	1089	1092	+	3	Q8WWZ4-1	0	4629	ENST00000269081.8	910	5539	++	12	Q8WWZ4-1#36	0	3	ENST00000269081.8	1999	2002	+	3	0	0	7713
Q8WWZ4-1#37	0	3	3	Q8WWZ4-1	3645	3648	+	3	Q8WWZ4-1	0	4629	ENST00000690296.1	556	5185	++	276	Q8WWZ4-1#37	0	3	ENST00000690296.1	4201	4204	+	3	0	0	7714
Q8WWZ4-1#37	0	3	3	Q8WWZ4-1	3645	3648	+	3	Q8WWZ4-1	0	4057	ENST00000523419.5	84	4065	+	140	Q8WWZ4-1#37	0	3	ENST00000523419.5	3729	3732	+	3	0	0	7715
Q8WWZ4-1#37	0	3	3	Q8WWZ4-1	3645	3648	+	3	Q8WWZ4-1	0	4629	ENST00000269081.8	910	5539	++	12	Q8WWZ4-1#37	0	3	ENST00000269081.8	4555	4558	+	3	0	0	7716
Q86UK0-1#0	0	7785	7785	Q86UK0-1	0	7785	+	7785	Q86UK0-1	0	163	ENST00000412081.1	196	359	+	73	Q86UK0-1#0	0	163	ENST00000412081.1	196	359	+	163	0	7622	7717
Q86UK0-1#0	0	7785	7785	Q86UK0-1	0	7785	+	7785	Q86UK0-1	984	7785	ENST00000389661.4	189	6990	++	58	Q86UK0-1#0	984	7785	ENST00000389661.4	189	6990	+	6801	984	0	7718
Q86UK0-1#0	0	7785	7785	Q86UK0-1	0	7785	+	7785	Q86UK0-1	0	7785	ENST00000272895.12	418	8203	++	13	Q86UK0-1#0	0	7785	ENST00000272895.12	418	8203	+	7785	0	0	7719
Q86UK0-1#1	0	63	63	Q86UK0-1	66	129	+	63	Q86UK0-1	0	163	ENST00000412081.1	196	359	+	73	Q86UK0-1#1	0	63	ENST00000412081.1	262	325	+	63	0	0	7720
Q86UK0-1#1	0	63	63	Q86UK0-1	66	129	+	63	Q86UK0-1	0	7785	ENST00000272895.12	418	8203	++	13	Q86UK0-1#1	0	63	ENST00000272895.12	484	547	+	63	0	0	7721
Q86UK0-1#2	0	63	63	Q86UK0-1	3192	3255	+	63	Q86UK0-1	984	7785	ENST00000389661.4	189	6990	++	58	Q86UK0-1#2	0	63	ENST00000389661.4	2397	2460	+	63	0	0	7722
Q86UK0-1#2	0	63	63	Q86UK0-1	3192	3255	+	63	Q86UK0-1	0	7785	ENST00000272895.12	418	8203	++	13	Q86UK0-1#2	0	63	ENST00000272895.12	3610	3673	+	63	0	0	7723
Q86UK0-1#3	0	63	63	Q86UK0-1	3333	3396	+	63	Q86UK0-1	984	7785	ENST00000389661.4	189	6990	++	58	Q86UK0-1#3	0	63	ENST00000389661.4	2538	2601	+	63	0	0	7724
Q86UK0-1#3	0	63	63	Q86UK0-1	3333	3396	+	63	Q86UK0-1	0	7785	ENST00000272895.12	418	8203	++	13	Q86UK0-1#3	0	63	ENST00000272895.12	3751	3814	+	63	0	0	7725
Q86UK0-1#4	0	63	63	Q86UK0-1	3432	3495	+	63	Q86UK0-1	984	7785	ENST00000389661.4	189	6990	++	58	Q86UK0-1#4	0	63	ENST00000389661.4	2637	2700	+	63	0	0	7726
Q86UK0-1#4	0	63	63	Q86UK0-1	3432	3495	+	63	Q86UK0-1	0	7785	ENST00000272895.12	418	8203	++	13	Q86UK0-1#4	0	63	ENST00000272895.12	3850	3913	+	63	0	0	7727
Q86UK0-1#5	0	63	63	Q86UK0-1	3519	3582	+	63	Q86UK0-1	984	7785	ENST00000389661.4	189	6990	++	58	Q86UK0-1#5	0	63	ENST00000389661.4	2724	2787	+	63	0	0	7728
Q86UK0-1#5	0	63	63	Q86UK0-1	3519	3582	+	63	Q86UK0-1	0	7785	ENST00000272895.12	418	8203	++	13	Q86UK0-1#5	0	63	ENST00000272895.12	3937	4000	+	63	0	0	7729
Q86UK0-1#6	0	63	63	Q86UK0-1	3597	3660	+	63	Q86UK0-1	984	7785	ENST00000389661.4	189	6990	++	58	Q86UK0-1#6	0	63	ENST00000389661.4	2802	2865	+	63	0	0	7730
Q86UK0-1#6	0	63	63	Q86UK0-1	3597	3660	+	63	Q86UK0-1	0	7785	ENST00000272895.12	418	8203	++	13	Q86UK0-1#6	0	63	ENST00000272895.12	4015	4078	+	63	0	0	7731
Q86UK0-1#7	0	63	63	Q86UK0-1	3747	3810	+	63	Q86UK0-1	984	7785	ENST00000389661.4	189	6990	++	58	Q86UK0-1#7	0	63	ENST00000389661.4	2952	3015	+	63	0	0	7732
Q86UK0-1#7	0	63	63	Q86UK0-1	3747	3810	+	63	Q86UK0-1	0	7785	ENST00000272895.12	418	8203	++	13	Q86UK0-1#7	0	63	ENST00000272895.12	4165	4228	+	63	0	0	7733
Q86UK0-1#8	0	63	63	Q86UK0-1	5238	5301	+	63	Q86UK0-1	984	7785	ENST00000389661.4	189	6990	++	58	Q86UK0-1#8	0	63	ENST00000389661.4	4443	4506	+	63	0	0	7734
Q86UK0-1#8	0	63	63	Q86UK0-1	5238	5301	+	63	Q86UK0-1	0	7785	ENST00000272895.12	418	8203	++	13	Q86UK0-1#8	0	63	ENST00000272895.12	5656	5719	+	63	0	0	7735
Q86UK0-1#9	0	63	63	Q86UK0-1	5934	5997	+	63	Q86UK0-1	984	7785	ENST00000389661.4	189	6990	++	58	Q86UK0-1#9	0	63	ENST00000389661.4	5139	5202	+	63	0	0	7736
Q86UK0-1#9	0	63	63	Q86UK0-1	5934	5997	+	63	Q86UK0-1	0	7785	ENST00000272895.12	418	8203	++	13	Q86UK0-1#9	0	63	ENST00000272895.12	6352	6415	+	63	0	0	7737
Q86UK0-1#10	0	63	63	Q86UK0-1	6102	6165	+	63	Q86UK0-1	984	7785	ENST00000389661.4	189	6990	++	58	Q86UK0-1#10	0	63	ENST00000389661.4	5307	5370	+	63	0	0	7738
Q86UK0-1#10	0	63	63	Q86UK0-1	6102	6165	+	63	Q86UK0-1	0	7785	ENST00000272895.12	418	8203	++	13	Q86UK0-1#10	0	63	ENST00000272895.12	6520	6583	+	63	0	0	7739
Q86UK0-1#11	0	63	63	Q86UK0-1	6213	6276	+	63	Q86UK0-1	984	7785	ENST00000389661.4	189	6990	++	58	Q86UK0-1#11	0	63	ENST00000389661.4	5418	5481	+	63	0	0	7740
Q86UK0-1#11	0	63	63	Q86UK0-1	6213	6276	+	63	Q86UK0-1	0	7785	ENST00000272895.12	418	8203	++	13	Q86UK0-1#11	0	63	ENST00000272895.12	6631	6694	+	63	0	0	7741
Q86UK0-1#12	0	63	63	Q86UK0-1	6306	6369	+	63	Q86UK0-1	984	7785	ENST00000389661.4	189	6990	++	58	Q86UK0-1#12	0	63	ENST00000389661.4	5511	5574	+	63	0	0	7742
Q86UK0-1#12	0	63	63	Q86UK0-1	6306	6369	+	63	Q86UK0-1	0	7785	ENST00000272895.12	418	8203	++	13	Q86UK0-1#12	0	63	ENST00000272895.12	6724	6787	+	63	0	0	7743
Q86UK0-1#13	0	63	63	Q86UK0-1	6558	6621	+	63	Q86UK0-1	984	7785	ENST00000389661.4	189	6990	++	58	Q86UK0-1#13	0	63	ENST00000389661.4	5763	5826	+	63	0	0	7744
Q86UK0-1#13	0	63	63	Q86UK0-1	6558	6621	+	63	Q86UK0-1	0	7785	ENST00000272895.12	418	8203	++	13	Q86UK0-1#13	0	63	ENST00000272895.12	6976	7039	+	63	0	0	7745
Q86UK0-1#14	0	63	63	Q86UK0-1	6807	6870	+	63	Q86UK0-1	984	7785	ENST00000389661.4	189	6990	++	58	Q86UK0-1#14	0	63	ENST00000389661.4	6012	6075	+	63	0	0	7746
Q86UK0-1#14	0	63	63	Q86UK0-1	6807	6870	+	63	Q86UK0-1	0	7785	ENST00000272895.12	418	8203	++	13	Q86UK0-1#14	0	63	ENST00000272895.12	7225	7288	+	63	0	0	7747
Q86UK0-1#15	0	696	696	Q86UK0-1	4035	4731	+	696	Q86UK0-1	984	7785	ENST00000389661.4	189	6990	++	58	Q86UK0-1#15	0	696	ENST00000389661.4	3240	3936	+	696	0	0	7748
Q86UK0-1#15	0	696	696	Q86UK0-1	4035	4731	+	696	Q86UK0-1	0	7785	ENST00000272895.12	418	8203	++	13	Q86UK0-1#15	0	696	ENST00000272895.12	4453	5149	+	696	0	0	7749
Q86UK0-1#16	0	708	708	Q86UK0-1	6759	7467	+	708	Q86UK0-1	984	7785	ENST00000389661.4	189	6990	++	58	Q86UK0-1#16	0	708	ENST00000389661.4	5964	6672	+	708	0	0	7750
Q86UK0-1#16	0	708	708	Q86UK0-1	6759	7467	+	708	Q86UK0-1	0	7785	ENST00000272895.12	418	8203	++	13	Q86UK0-1#16	0	708	ENST00000272895.12	7177	7885	+	708	0	0	7751
Q86UK0-1#17	0	75	75	Q86UK0-1	7710	7785	+	75	Q86UK0-1	984	7785	ENST00000389661.4	189	6990	++	58	Q86UK0-1#17	0	75	ENST00000389661.4	6915	6990	+	75	0	0	7752
Q86UK0-1#17	0	75	75	Q86UK0-1	7710	7785	+	75	Q86UK0-1	0	7785	ENST00000272895.12	418	8203	++	13	Q86UK0-1#17	0	75	ENST00000272895.12	8128	8203	+	75	0	0	7753
Q86UK0-1#18	0	24	24	Q86UK0-1	4131	4155	+	24	Q86UK0-1	984	7785	ENST00000389661.4	189	6990	++	58	Q86UK0-1#18	0	24	ENST00000389661.4	3336	3360	+	24	0	0	7754
Q86UK0-1#18	0	24	24	Q86UK0-1	4131	4155	+	24	Q86UK0-1	0	7785	ENST00000272895.12	418	8203	++	13	Q86UK0-1#18	0	24	ENST00000272895.12	4549	4573	+	24	0	0	7755
Q86UK0-1#19	0	24	24	Q86UK0-1	6867	6891	+	24	Q86UK0-1	984	7785	ENST00000389661.4	189	6990	++	58	Q86UK0-1#19	0	24	ENST00000389661.4	6072	6096	+	24	0	0	7756
Q86UK0-1#19	0	24	24	Q86UK0-1	6867	6891	+	24	Q86UK0-1	0	7785	ENST00000272895.12	418	8203	++	13	Q86UK0-1#19	0	24	ENST00000272895.12	7285	7309	+	24	0	0	7757
Q86UK0-1#20	0	3	3	Q86UK0-1	465	468	+	3	Q86UK0-1	0	7785	ENST00000272895.12	418	8203	++	13	Q86UK0-1#20	0	3	ENST00000272895.12	883	886	+	3	0	0	7758
Q86UK0-1#21	0	3	3	Q86UK0-1	519	522	+	3	Q86UK0-1	0	7785	ENST00000272895.12	418	8203	++	13	Q86UK0-1#21	0	3	ENST00000272895.12	937	940	+	3	0	0	7759
Q86UK0-1#22	0	3	3	Q86UK0-1	639	642	+	3	Q86UK0-1	0	7785	ENST00000272895.12	418	8203	++	13	Q86UK0-1#22	0	3	ENST00000272895.12	1057	1060	+	3	0	0	7760
Q86UK0-1#23	0	3	3	Q86UK0-1	822	825	+	3	Q86UK0-1	0	7785	ENST00000272895.12	418	8203	++	13	Q86UK0-1#23	0	3	ENST00000272895.12	1240	1243	+	3	0	0	7761
Q86UK0-1#24	0	3	3	Q86UK0-1	996	999	+	3	Q86UK0-1	984	7785	ENST00000389661.4	189	6990	++	58	Q86UK0-1#24	0	3	ENST00000389661.4	201	204	+	3	0	0	7762
Q86UK0-1#24	0	3	3	Q86UK0-1	996	999	+	3	Q86UK0-1	0	7785	ENST00000272895.12	418	8203	++	13	Q86UK0-1#24	0	3	ENST00000272895.12	1414	1417	+	3	0	0	7763
Q86UK0-1#25	0	3	3	Q86UK0-1	1098	1101	+	3	Q86UK0-1	984	7785	ENST00000389661.4	189	6990	++	58	Q86UK0-1#25	0	3	ENST00000389661.4	303	306	+	3	0	0	7764
Q86UK0-1#25	0	3	3	Q86UK0-1	1098	1101	+	3	Q86UK0-1	0	7785	ENST00000272895.12	418	8203	++	13	Q86UK0-1#25	0	3	ENST00000272895.12	1516	1519	+	3	0	0	7765
Q86UK0-1#26	0	3	3	Q86UK0-1	1146	1149	+	3	Q86UK0-1	984	7785	ENST00000389661.4	189	6990	++	58	Q86UK0-1#26	0	3	ENST00000389661.4	351	354	+	3	0	0	7766
Q86UK0-1#26	0	3	3	Q86UK0-1	1146	1149	+	3	Q86UK0-1	0	7785	ENST00000272895.12	418	8203	++	13	Q86UK0-1#26	0	3	ENST00000272895.12	1564	1567	+	3	0	0	7767
Q86UK0-1#27	0	3	3	Q86UK0-1	1233	1236	+	3	Q86UK0-1	984	7785	ENST00000389661.4	189	6990	++	58	Q86UK0-1#27	0	3	ENST00000389661.4	438	441	+	3	0	0	7768
Q86UK0-1#27	0	3	3	Q86UK0-1	1233	1236	+	3	Q86UK0-1	0	7785	ENST00000272895.12	418	8203	++	13	Q86UK0-1#27	0	3	ENST00000272895.12	1651	1654	+	3	0	0	7769
Q86UK0-1#28	0	3	3	Q86UK0-1	1302	1305	+	3	Q86UK0-1	984	7785	ENST00000389661.4	189	6990	++	58	Q86UK0-1#28	0	3	ENST00000389661.4	507	510	+	3	0	0	7770
Q86UK0-1#28	0	3	3	Q86UK0-1	1302	1305	+	3	Q86UK0-1	0	7785	ENST00000272895.12	418	8203	++	13	Q86UK0-1#28	0	3	ENST00000272895.12	1720	1723	+	3	0	0	7771
Q86UK0-1#29	0	3	3	Q86UK0-1	1581	1584	+	3	Q86UK0-1	984	7785	ENST00000389661.4	189	6990	++	58	Q86UK0-1#29	0	3	ENST00000389661.4	786	789	+	3	0	0	7772
Q86UK0-1#29	0	3	3	Q86UK0-1	1581	1584	+	3	Q86UK0-1	0	7785	ENST00000272895.12	418	8203	++	13	Q86UK0-1#29	0	3	ENST00000272895.12	1999	2002	+	3	0	0	7773
Q86UK0-1#30	0	3	3	Q86UK0-1	1626	1629	+	3	Q86UK0-1	984	7785	ENST00000389661.4	189	6990	++	58	Q86UK0-1#30	0	3	ENST00000389661.4	831	834	+	3	0	0	7774
Q86UK0-1#30	0	3	3	Q86UK0-1	1626	1629	+	3	Q86UK0-1	0	7785	ENST00000272895.12	418	8203	++	13	Q86UK0-1#30	0	3	ENST00000272895.12	2044	2047	+	3	0	0	7775
Q86UK0-1#31	0	3	3	Q86UK0-1	1728	1731	+	3	Q86UK0-1	984	7785	ENST00000389661.4	189	6990	++	58	Q86UK0-1#31	0	3	ENST00000389661.4	933	936	+	3	0	0	7776
Q86UK0-1#31	0	3	3	Q86UK0-1	1728	1731	+	3	Q86UK0-1	0	7785	ENST00000272895.12	418	8203	++	13	Q86UK0-1#31	0	3	ENST00000272895.12	2146	2149	+	3	0	0	7777
Q86UK0-1#32	0	3	3	Q86UK0-1	1821	1824	+	3	Q86UK0-1	984	7785	ENST00000389661.4	189	6990	++	58	Q86UK0-1#32	0	3	ENST00000389661.4	1026	1029	+	3	0	0	7778
Q86UK0-1#32	0	3	3	Q86UK0-1	1821	1824	+	3	Q86UK0-1	0	7785	ENST00000272895.12	418	8203	++	13	Q86UK0-1#32	0	3	ENST00000272895.12	2239	2242	+	3	0	0	7779
Q86UK0-1#33	0	3	3	Q86UK0-1	1866	1869	+	3	Q86UK0-1	984	7785	ENST00000389661.4	189	6990	++	58	Q86UK0-1#33	0	3	ENST00000389661.4	1071	1074	+	3	0	0	7780
Q86UK0-1#33	0	3	3	Q86UK0-1	1866	1869	+	3	Q86UK0-1	0	7785	ENST00000272895.12	418	8203	++	13	Q86UK0-1#33	0	3	ENST00000272895.12	2284	2287	+	3	0	0	7781
Q86UK0-1#34	0	3	3	Q86UK0-1	1941	1944	+	3	Q86UK0-1	984	7785	ENST00000389661.4	189	6990	++	58	Q86UK0-1#34	0	3	ENST00000389661.4	1146	1149	+	3	0	0	7782
Q86UK0-1#34	0	3	3	Q86UK0-1	1941	1944	+	3	Q86UK0-1	0	7785	ENST00000272895.12	418	8203	++	13	Q86UK0-1#34	0	3	ENST00000272895.12	2359	2362	+	3	0	0	7783
Q86UK0-1#35	0	3	3	Q86UK0-1	2253	2256	+	3	Q86UK0-1	984	7785	ENST00000389661.4	189	6990	++	58	Q86UK0-1#35	0	3	ENST00000389661.4	1458	1461	+	3	0	0	7784
Q86UK0-1#35	0	3	3	Q86UK0-1	2253	2256	+	3	Q86UK0-1	0	7785	ENST00000272895.12	418	8203	++	13	Q86UK0-1#35	0	3	ENST00000272895.12	2671	2674	+	3	0	0	7785
Q86UK0-1#36	0	3	3	Q86UK0-1	2475	2478	+	3	Q86UK0-1	984	7785	ENST00000389661.4	189	6990	++	58	Q86UK0-1#36	0	3	ENST00000389661.4	1680	1683	+	3	0	0	7786
Q86UK0-1#36	0	3	3	Q86UK0-1	2475	2478	+	3	Q86UK0-1	0	7785	ENST00000272895.12	418	8203	++	13	Q86UK0-1#36	0	3	ENST00000272895.12	2893	2896	+	3	0	0	7787
Q86UK0-1#37	0	3	3	Q86UK0-1	2757	2760	+	3	Q86UK0-1	984	7785	ENST00000389661.4	189	6990	++	58	Q86UK0-1#37	0	3	ENST00000389661.4	1962	1965	+	3	0	0	7788
Q86UK0-1#37	0	3	3	Q86UK0-1	2757	2760	+	3	Q86UK0-1	0	7785	ENST00000272895.12	418	8203	++	13	Q86UK0-1#37	0	3	ENST00000272895.12	3175	3178	+	3	0	0	7789
Q86UK0-1#38	0	3	3	Q86UK0-1	2886	2889	+	3	Q86UK0-1	984	7785	ENST00000389661.4	189	6990	++	58	Q86UK0-1#38	0	3	ENST00000389661.4	2091	2094	+	3	0	0	7790
Q86UK0-1#38	0	3	3	Q86UK0-1	2886	2889	+	3	Q86UK0-1	0	7785	ENST00000272895.12	418	8203	++	13	Q86UK0-1#38	0	3	ENST00000272895.12	3304	3307	+	3	0	0	7791
Q86UK0-1#39	0	3	3	Q86UK0-1	3507	3510	+	3	Q86UK0-1	984	7785	ENST00000389661.4	189	6990	++	58	Q86UK0-1#39	0	3	ENST00000389661.4	2712	2715	+	3	0	0	7792
Q86UK0-1#39	0	3	3	Q86UK0-1	3507	3510	+	3	Q86UK0-1	0	7785	ENST00000272895.12	418	8203	++	13	Q86UK0-1#39	0	3	ENST00000272895.12	3925	3928	+	3	0	0	7793
Q86UK0-1#40	0	3	3	Q86UK0-1	4569	4572	+	3	Q86UK0-1	984	7785	ENST00000389661.4	189	6990	++	58	Q86UK0-1#40	0	3	ENST00000389661.4	3774	3777	+	3	0	0	7794
Q86UK0-1#40	0	3	3	Q86UK0-1	4569	4572	+	3	Q86UK0-1	0	7785	ENST00000272895.12	418	8203	++	13	Q86UK0-1#40	0	3	ENST00000272895.12	4987	4990	+	3	0	0	7795
Q86UK0-1#41	0	3	3	Q86UK0-1	4986	4989	+	3	Q86UK0-1	984	7785	ENST00000389661.4	189	6990	++	58	Q86UK0-1#41	0	3	ENST00000389661.4	4191	4194	+	3	0	0	7796
Q86UK0-1#41	0	3	3	Q86UK0-1	4986	4989	+	3	Q86UK0-1	0	7785	ENST00000272895.12	418	8203	++	13	Q86UK0-1#41	0	3	ENST00000272895.12	5404	5407	+	3	0	0	7797
Q86UK0-1#42	0	3	3	Q86UK0-1	5109	5112	+	3	Q86UK0-1	984	7785	ENST00000389661.4	189	6990	++	58	Q86UK0-1#42	0	3	ENST00000389661.4	4314	4317	+	3	0	0	7798
Q86UK0-1#42	0	3	3	Q86UK0-1	5109	5112	+	3	Q86UK0-1	0	7785	ENST00000272895.12	418	8203	++	13	Q86UK0-1#42	0	3	ENST00000272895.12	5527	5530	+	3	0	0	7799
Q86UK0-1#43	0	3	3	Q86UK0-1	5304	5307	+	3	Q86UK0-1	984	7785	ENST00000389661.4	189	6990	++	58	Q86UK0-1#43	0	3	ENST00000389661.4	4509	4512	+	3	0	0	7800
Q86UK0-1#43	0	3	3	Q86UK0-1	5304	5307	+	3	Q86UK0-1	0	7785	ENST00000272895.12	418	8203	++	13	Q86UK0-1#43	0	3	ENST00000272895.12	5722	5725	+	3	0	0	7801
Q86UK0-1#44	0	3	3	Q86UK0-1	5454	5457	+	3	Q86UK0-1	984	7785	ENST00000389661.4	189	6990	++	58	Q86UK0-1#44	0	3	ENST00000389661.4	4659	4662	+	3	0	0	7802
Q86UK0-1#44	0	3	3	Q86UK0-1	5454	5457	+	3	Q86UK0-1	0	7785	ENST00000272895.12	418	8203	++	13	Q86UK0-1#44	0	3	ENST00000272895.12	5872	5875	+	3	0	0	7803
Q86UK0-1#45	0	3	3	Q86UK0-1	5502	5505	+	3	Q86UK0-1	984	7785	ENST00000389661.4	189	6990	++	58	Q86UK0-1#45	0	3	ENST00000389661.4	4707	4710	+	3	0	0	7804
Q86UK0-1#45	0	3	3	Q86UK0-1	5502	5505	+	3	Q86UK0-1	0	7785	ENST00000272895.12	418	8203	++	13	Q86UK0-1#45	0	3	ENST00000272895.12	5920	5923	+	3	0	0	7805
Q86UK0-1#46	0	3	3	Q86UK0-1	5625	5628	+	3	Q86UK0-1	984	7785	ENST00000389661.4	189	6990	++	58	Q86UK0-1#46	0	3	ENST00000389661.4	4830	4833	+	3	0	0	7806
Q86UK0-1#46	0	3	3	Q86UK0-1	5625	5628	+	3	Q86UK0-1	0	7785	ENST00000272895.12	418	8203	++	13	Q86UK0-1#46	0	3	ENST00000272895.12	6043	6046	+	3	0	0	7807
Q86UK0-1#47	0	3	3	Q86UK0-1	5760	5763	+	3	Q86UK0-1	984	7785	ENST00000389661.4	189	6990	++	58	Q86UK0-1#47	0	3	ENST00000389661.4	4965	4968	+	3	0	0	7808
Q86UK0-1#47	0	3	3	Q86UK0-1	5760	5763	+	3	Q86UK0-1	0	7785	ENST00000272895.12	418	8203	++	13	Q86UK0-1#47	0	3	ENST00000272895.12	6178	6181	+	3	0	0	7809
Q86UK0-1#48	0	3	3	Q86UK0-1	5853	5856	+	3	Q86UK0-1	984	7785	ENST00000389661.4	189	6990	++	58	Q86UK0-1#48	0	3	ENST00000389661.4	5058	5061	+	3	0	0	7810
Q86UK0-1#48	0	3	3	Q86UK0-1	5853	5856	+	3	Q86UK0-1	0	7785	ENST00000272895.12	418	8203	++	13	Q86UK0-1#48	0	3	ENST00000272895.12	6271	6274	+	3	0	0	7811
Q86UK0-1#49	0	3	3	Q86UK0-1	6531	6534	+	3	Q86UK0-1	984	7785	ENST00000389661.4	189	6990	++	58	Q86UK0-1#49	0	3	ENST00000389661.4	5736	5739	+	3	0	0	7812
Q86UK0-1#49	0	3	3	Q86UK0-1	6531	6534	+	3	Q86UK0-1	0	7785	ENST00000272895.12	418	8203	++	13	Q86UK0-1#49	0	3	ENST00000272895.12	6949	6952	+	3	0	0	7813
Q86UK0-1#50	0	3	3	Q86UK0-1	6621	6624	+	3	Q86UK0-1	984	7785	ENST00000389661.4	189	6990	++	58	Q86UK0-1#50	0	3	ENST00000389661.4	5826	5829	+	3	0	0	7814
Q86UK0-1#50	0	3	3	Q86UK0-1	6621	6624	+	3	Q86UK0-1	0	7785	ENST00000272895.12	418	8203	++	13	Q86UK0-1#50	0	3	ENST00000272895.12	7039	7042	+	3	0	0	7815
Q86UK0-1#51	0	3	3	Q86UK0-1	6666	6669	+	3	Q86UK0-1	984	7785	ENST00000389661.4	189	6990	++	58	Q86UK0-1#51	0	3	ENST00000389661.4	5871	5874	+	3	0	0	7816
Q86UK0-1#51	0	3	3	Q86UK0-1	6666	6669	+	3	Q86UK0-1	0	7785	ENST00000272895.12	418	8203	++	13	Q86UK0-1#51	0	3	ENST00000272895.12	7084	7087	+	3	0	0	7817
Q86UK0-1#52	0	3	3	Q86UK0-1	6951	6954	+	3	Q86UK0-1	984	7785	ENST00000389661.4	189	6990	++	58	Q86UK0-1#52	0	3	ENST00000389661.4	6156	6159	+	3	0	0	7818
Q86UK0-1#52	0	3	3	Q86UK0-1	6951	6954	+	3	Q86UK0-1	0	7785	ENST00000272895.12	418	8203	++	13	Q86UK0-1#52	0	3	ENST00000272895.12	7369	7372	+	3	0	0	7819
Q86UK0-1#53	0	3	3	Q86UK0-1	7623	7626	+	3	Q86UK0-1	984	7785	ENST00000389661.4	189	6990	++	58	Q86UK0-1#53	0	3	ENST00000389661.4	6828	6831	+	3	0	0	7820
Q86UK0-1#53	0	3	3	Q86UK0-1	7623	7626	+	3	Q86UK0-1	0	7785	ENST00000272895.12	418	8203	++	13	Q86UK0-1#53	0	3	ENST00000272895.12	8041	8044	+	3	0	0	7821
Q86UK0-1#54	0	3	3	Q86UK0-1	7638	7641	+	3	Q86UK0-1	984	7785	ENST00000389661.4	189	6990	++	58	Q86UK0-1#54	0	3	ENST00000389661.4	6843	6846	+	3	0	0	7822
Q86UK0-1#54	0	3	3	Q86UK0-1	7638	7641	+	3	Q86UK0-1	0	7785	ENST00000272895.12	418	8203	++	13	Q86UK0-1#54	0	3	ENST00000272895.12	8056	8059	+	3	0	0	7823
Q86UK0-1#55	0	954	954	Q86UK0-1	0	954	+	954	Q86UK0-1	0	163	ENST00000412081.1	196	359	+	73	Q86UK0-1#55	0	163	ENST00000412081.1	196	359	+	163	0	791	7824
Q86UK0-1#55	0	954	954	Q86UK0-1	0	954	+	954	Q86UK0-1	0	7785	ENST00000272895.12	418	8203	++	13	Q86UK0-1#55	0	954	ENST00000272895.12	418	1372	+	954	0	0	7825
Q86UK0-1#56	0	30	30	Q86UK0-1	954	984	+	30	Q86UK0-1	0	7785	ENST00000272895.12	418	8203	++	13	Q86UK0-1#56	0	30	ENST00000272895.12	1372	1402	+	30	0	0	7826
Q86UK0-1#57	0	3	3	Q86UK0-1	594	597	+	3	Q86UK0-1	0	7785	ENST00000272895.12	418	8203	++	13	Q86UK0-1#57	0	3	ENST00000272895.12	1012	1015	+	3	0	0	7827
Q86UK0-1#58	0	3	3	Q86UK0-1	708	711	+	3	Q86UK0-1	0	7785	ENST00000272895.12	418	8203	++	13	Q86UK0-1#58	0	3	ENST00000272895.12	1126	1129	+	3	0	0	7828
Q86UK0-1#59	0	3	3	Q86UK0-1	819	822	+	3	Q86UK0-1	0	7785	ENST00000272895.12	418	8203	++	13	Q86UK0-1#59	0	3	ENST00000272895.12	1237	1240	+	3	0	0	7829
Q86UK0-1#60	0	3	3	Q86UK0-1	858	861	+	3	Q86UK0-1	0	7785	ENST00000272895.12	418	8203	++	13	Q86UK0-1#60	0	3	ENST00000272895.12	1276	1279	+	3	0	0	7830
Q86UK0-1#61	0	3	3	Q86UK0-1	1032	1035	+	3	Q86UK0-1	984	7785	ENST00000389661.4	189	6990	++	58	Q86UK0-1#61	0	3	ENST00000389661.4	237	240	+	3	0	0	7831
Q86UK0-1#61	0	3	3	Q86UK0-1	1032	1035	+	3	Q86UK0-1	0	7785	ENST00000272895.12	418	8203	++	13	Q86UK0-1#61	0	3	ENST00000272895.12	1450	1453	+	3	0	0	7832
Q86UK0-1#62	0	3	3	Q86UK0-1	1158	1161	+	3	Q86UK0-1	984	7785	ENST00000389661.4	189	6990	++	58	Q86UK0-1#62	0	3	ENST00000389661.4	363	366	+	3	0	0	7833
Q86UK0-1#62	0	3	3	Q86UK0-1	1158	1161	+	3	Q86UK0-1	0	7785	ENST00000272895.12	418	8203	++	13	Q86UK0-1#62	0	3	ENST00000272895.12	1576	1579	+	3	0	0	7834
Q86UK0-1#63	0	6486	6486	Q86UK0-1	1299	7785	+	6486	Q86UK0-1	984	7785	ENST00000389661.4	189	6990	++	58	Q86UK0-1#63	0	6486	ENST00000389661.4	504	6990	+	6486	0	0	7835
Q86UK0-1#63	0	6486	6486	Q86UK0-1	1299	7785	+	6486	Q86UK0-1	0	7785	ENST00000272895.12	418	8203	++	13	Q86UK0-1#63	0	6486	ENST00000272895.12	1717	8203	+	6486	0	0	7836
Q86UK0-1#64	0	3	3	Q86UK0-1	1374	1377	+	3	Q86UK0-1	984	7785	ENST00000389661.4	189	6990	++	58	Q86UK0-1#64	0	3	ENST00000389661.4	579	582	+	3	0	0	7837
Q86UK0-1#64	0	3	3	Q86UK0-1	1374	1377	+	3	Q86UK0-1	0	7785	ENST00000272895.12	418	8203	++	13	Q86UK0-1#64	0	3	ENST00000272895.12	1792	1795	+	3	0	0	7838
Q86UK0-1#65	0	3	3	Q86UK0-1	1425	1428	+	3	Q86UK0-1	984	7785	ENST00000389661.4	189	6990	++	58	Q86UK0-1#65	0	3	ENST00000389661.4	630	633	+	3	0	0	7839
Q86UK0-1#65	0	3	3	Q86UK0-1	1425	1428	+	3	Q86UK0-1	0	7785	ENST00000272895.12	418	8203	++	13	Q86UK0-1#65	0	3	ENST00000272895.12	1843	1846	+	3	0	0	7840
Q86UK0-1#66	0	3	3	Q86UK0-1	1647	1650	+	3	Q86UK0-1	984	7785	ENST00000389661.4	189	6990	++	58	Q86UK0-1#66	0	3	ENST00000389661.4	852	855	+	3	0	0	7841
Q86UK0-1#66	0	3	3	Q86UK0-1	1647	1650	+	3	Q86UK0-1	0	7785	ENST00000272895.12	418	8203	++	13	Q86UK0-1#66	0	3	ENST00000272895.12	2065	2068	+	3	0	0	7842
Q86UK0-1#67	0	3	3	Q86UK0-1	2328	2331	+	3	Q86UK0-1	984	7785	ENST00000389661.4	189	6990	++	58	Q86UK0-1#67	0	3	ENST00000389661.4	1533	1536	+	3	0	0	7843
Q86UK0-1#67	0	3	3	Q86UK0-1	2328	2331	+	3	Q86UK0-1	0	7785	ENST00000272895.12	418	8203	++	13	Q86UK0-1#67	0	3	ENST00000272895.12	2746	2749	+	3	0	0	7844
Q86UK0-1#68	0	3	3	Q86UK0-1	3405	3408	+	3	Q86UK0-1	984	7785	ENST00000389661.4	189	6990	++	58	Q86UK0-1#68	0	3	ENST00000389661.4	2610	2613	+	3	0	0	7845
Q86UK0-1#68	0	3	3	Q86UK0-1	3405	3408	+	3	Q86UK0-1	0	7785	ENST00000272895.12	418	8203	++	13	Q86UK0-1#68	0	3	ENST00000272895.12	3823	3826	+	3	0	0	7846
Q86UK0-1#69	0	3	3	Q86UK0-1	3534	3537	+	3	Q86UK0-1	984	7785	ENST00000389661.4	189	6990	++	58	Q86UK0-1#69	0	3	ENST00000389661.4	2739	2742	+	3	0	0	7847
Q86UK0-1#69	0	3	3	Q86UK0-1	3534	3537	+	3	Q86UK0-1	0	7785	ENST00000272895.12	418	8203	++	13	Q86UK0-1#69	0	3	ENST00000272895.12	3952	3955	+	3	0	0	7848
Q86UK0-1#70	0	3	3	Q86UK0-1	3702	3705	+	3	Q86UK0-1	984	7785	ENST00000389661.4	189	6990	++	58	Q86UK0-1#70	0	3	ENST00000389661.4	2907	2910	+	3	0	0	7849
Q86UK0-1#70	0	3	3	Q86UK0-1	3702	3705	+	3	Q86UK0-1	0	7785	ENST00000272895.12	418	8203	++	13	Q86UK0-1#70	0	3	ENST00000272895.12	4120	4123	+	3	0	0	7850
Q86UK0-1#71	0	3	3	Q86UK0-1	3750	3753	+	3	Q86UK0-1	984	7785	ENST00000389661.4	189	6990	++	58	Q86UK0-1#71	0	3	ENST00000389661.4	2955	2958	+	3	0	0	7851
Q86UK0-1#71	0	3	3	Q86UK0-1	3750	3753	+	3	Q86UK0-1	0	7785	ENST00000272895.12	418	8203	++	13	Q86UK0-1#71	0	3	ENST00000272895.12	4168	4171	+	3	0	0	7852
Q86UK0-1#72	0	3	3	Q86UK0-1	4137	4140	+	3	Q86UK0-1	984	7785	ENST00000389661.4	189	6990	++	58	Q86UK0-1#72	0	3	ENST00000389661.4	3342	3345	+	3	0	0	7853
Q86UK0-1#72	0	3	3	Q86UK0-1	4137	4140	+	3	Q86UK0-1	0	7785	ENST00000272895.12	418	8203	++	13	Q86UK0-1#72	0	3	ENST00000272895.12	4555	4558	+	3	0	0	7854
Q86UK0-1#73	0	3	3	Q86UK0-1	4140	4143	+	3	Q86UK0-1	984	7785	ENST00000389661.4	189	6990	++	58	Q86UK0-1#73	0	3	ENST00000389661.4	3345	3348	+	3	0	0	7855
Q86UK0-1#73	0	3	3	Q86UK0-1	4140	4143	+	3	Q86UK0-1	0	7785	ENST00000272895.12	418	8203	++	13	Q86UK0-1#73	0	3	ENST00000272895.12	4558	4561	+	3	0	0	7856
Q86UK0-1#74	0	3	3	Q86UK0-1	4152	4155	+	3	Q86UK0-1	984	7785	ENST00000389661.4	189	6990	++	58	Q86UK0-1#74	0	3	ENST00000389661.4	3357	3360	+	3	0	0	7857
Q86UK0-1#74	0	3	3	Q86UK0-1	4152	4155	+	3	Q86UK0-1	0	7785	ENST00000272895.12	418	8203	++	13	Q86UK0-1#74	0	3	ENST00000272895.12	4570	4573	+	3	0	0	7858
Q86UK0-1#75	0	3	3	Q86UK0-1	4479	4482	+	3	Q86UK0-1	984	7785	ENST00000389661.4	189	6990	++	58	Q86UK0-1#75	0	3	ENST00000389661.4	3684	3687	+	3	0	0	7859
Q86UK0-1#75	0	3	3	Q86UK0-1	4479	4482	+	3	Q86UK0-1	0	7785	ENST00000272895.12	418	8203	++	13	Q86UK0-1#75	0	3	ENST00000272895.12	4897	4900	+	3	0	0	7860
Q86UK0-1#76	0	3	3	Q86UK0-1	4539	4542	+	3	Q86UK0-1	984	7785	ENST00000389661.4	189	6990	++	58	Q86UK0-1#76	0	3	ENST00000389661.4	3744	3747	+	3	0	0	7861
Q86UK0-1#76	0	3	3	Q86UK0-1	4539	4542	+	3	Q86UK0-1	0	7785	ENST00000272895.12	418	8203	++	13	Q86UK0-1#76	0	3	ENST00000272895.12	4957	4960	+	3	0	0	7862
Q86UK0-1#77	0	3	3	Q86UK0-1	4614	4617	+	3	Q86UK0-1	984	7785	ENST00000389661.4	189	6990	++	58	Q86UK0-1#77	0	3	ENST00000389661.4	3819	3822	+	3	0	0	7863
Q86UK0-1#77	0	3	3	Q86UK0-1	4614	4617	+	3	Q86UK0-1	0	7785	ENST00000272895.12	418	8203	++	13	Q86UK0-1#77	0	3	ENST00000272895.12	5032	5035	+	3	0	0	7864
Q86UK0-1#78	0	3	3	Q86UK0-1	4635	4638	+	3	Q86UK0-1	984	7785	ENST00000389661.4	189	6990	++	58	Q86UK0-1#78	0	3	ENST00000389661.4	3840	3843	+	3	0	0	7865
Q86UK0-1#78	0	3	3	Q86UK0-1	4635	4638	+	3	Q86UK0-1	0	7785	ENST00000272895.12	418	8203	++	13	Q86UK0-1#78	0	3	ENST00000272895.12	5053	5056	+	3	0	0	7866
Q86UK0-1#79	0	3	3	Q86UK0-1	4674	4677	+	3	Q86UK0-1	984	7785	ENST00000389661.4	189	6990	++	58	Q86UK0-1#79	0	3	ENST00000389661.4	3879	3882	+	3	0	0	7867
Q86UK0-1#79	0	3	3	Q86UK0-1	4674	4677	+	3	Q86UK0-1	0	7785	ENST00000272895.12	418	8203	++	13	Q86UK0-1#79	0	3	ENST00000272895.12	5092	5095	+	3	0	0	7868
Q86UK0-1#80	0	3	3	Q86UK0-1	4950	4953	+	3	Q86UK0-1	984	7785	ENST00000389661.4	189	6990	++	58	Q86UK0-1#80	0	3	ENST00000389661.4	4155	4158	+	3	0	0	7869
Q86UK0-1#80	0	3	3	Q86UK0-1	4950	4953	+	3	Q86UK0-1	0	7785	ENST00000272895.12	418	8203	++	13	Q86UK0-1#80	0	3	ENST00000272895.12	5368	5371	+	3	0	0	7870
Q86UK0-1#81	0	3	3	Q86UK0-1	5391	5394	+	3	Q86UK0-1	984	7785	ENST00000389661.4	189	6990	++	58	Q86UK0-1#81	0	3	ENST00000389661.4	4596	4599	+	3	0	0	7871
Q86UK0-1#81	0	3	3	Q86UK0-1	5391	5394	+	3	Q86UK0-1	0	7785	ENST00000272895.12	418	8203	++	13	Q86UK0-1#81	0	3	ENST00000272895.12	5809	5812	+	3	0	0	7872
Q86UK0-1#82	0	1938	1938	Q86UK0-1	5847	7785	+	1938	Q86UK0-1	984	7785	ENST00000389661.4	189	6990	++	58	Q86UK0-1#82	0	1938	ENST00000389661.4	5052	6990	+	1938	0	0	7873
Q86UK0-1#82	0	1938	1938	Q86UK0-1	5847	7785	+	1938	Q86UK0-1	0	7785	ENST00000272895.12	418	8203	++	13	Q86UK0-1#82	0	1938	ENST00000272895.12	6265	8203	+	1938	0	0	7874
Q86UK0-1#83	0	3	3	Q86UK0-1	5937	5940	+	3	Q86UK0-1	984	7785	ENST00000389661.4	189	6990	++	58	Q86UK0-1#83	0	3	ENST00000389661.4	5142	5145	+	3	0	0	7875
Q86UK0-1#83	0	3	3	Q86UK0-1	5937	5940	+	3	Q86UK0-1	0	7785	ENST00000272895.12	418	8203	++	13	Q86UK0-1#83	0	3	ENST00000272895.12	6355	6358	+	3	0	0	7876
Q86UK0-1#84	0	3	3	Q86UK0-1	6189	6192	+	3	Q86UK0-1	984	7785	ENST00000389661.4	189	6990	++	58	Q86UK0-1#84	0	3	ENST00000389661.4	5394	5397	+	3	0	0	7877
Q86UK0-1#84	0	3	3	Q86UK0-1	6189	6192	+	3	Q86UK0-1	0	7785	ENST00000272895.12	418	8203	++	13	Q86UK0-1#84	0	3	ENST00000272895.12	6607	6610	+	3	0	0	7878
Q86UK0-1#85	0	3	3	Q86UK0-1	7092	7095	+	3	Q86UK0-1	984	7785	ENST00000389661.4	189	6990	++	58	Q86UK0-1#85	0	3	ENST00000389661.4	6297	6300	+	3	0	0	7879
Q86UK0-1#85	0	3	3	Q86UK0-1	7092	7095	+	3	Q86UK0-1	0	7785	ENST00000272895.12	418	8203	++	13	Q86UK0-1#85	0	3	ENST00000272895.12	7510	7513	+	3	0	0	7880
Q86UK0-1#86	0	3	3	Q86UK0-1	1950	1953	+	3	Q86UK0-1	984	7785	ENST00000389661.4	189	6990	++	58	Q86UK0-1#86	0	3	ENST00000389661.4	1155	1158	+	3	0	0	7881
Q86UK0-1#86	0	3	3	Q86UK0-1	1950	1953	+	3	Q86UK0-1	0	7785	ENST00000272895.12	418	8203	++	13	Q86UK0-1#86	0	3	ENST00000272895.12	2368	2371	+	3	0	0	7882
Q86UK0-1#87	0	3	3	Q86UK0-1	2430	2433	+	3	Q86UK0-1	984	7785	ENST00000389661.4	189	6990	++	58	Q86UK0-1#87	0	3	ENST00000389661.4	1635	1638	+	3	0	0	7883
Q86UK0-1#87	0	3	3	Q86UK0-1	2430	2433	+	3	Q86UK0-1	0	7785	ENST00000272895.12	418	8203	++	13	Q86UK0-1#87	0	3	ENST00000272895.12	2848	2851	+	3	0	0	7884
Q86UK0-1#88	0	3	3	Q86UK0-1	2475	2478	+	3	Q86UK0-1	984	7785	ENST00000389661.4	189	6990	++	58	Q86UK0-1#88	0	3	ENST00000389661.4	1680	1683	+	3	0	0	7885
Q86UK0-1#88	0	3	3	Q86UK0-1	2475	2478	+	3	Q86UK0-1	0	7785	ENST00000272895.12	418	8203	++	13	Q86UK0-1#88	0	3	ENST00000272895.12	2893	2896	+	3	0	0	7886
Q86UK0-1#89	0	3	3	Q86UK0-1	6234	6237	+	3	Q86UK0-1	984	7785	ENST00000389661.4	189	6990	++	58	Q86UK0-1#89	0	3	ENST00000389661.4	5439	5442	+	3	0	0	7887
Q86UK0-1#89	0	3	3	Q86UK0-1	6234	6237	+	3	Q86UK0-1	0	7785	ENST00000272895.12	418	8203	++	13	Q86UK0-1#89	0	3	ENST00000272895.12	6652	6655	+	3	0	0	7888
Q86UQ4-1#0	0	15174	15174	Q86UQ4-1	0	15174	+	15174	Q86UQ4-1	0	897	ENST00000435803.6	26	923	+	87	Q86UQ4-1#0	0	897	ENST00000435803.6	26	923	+	897	0	14277	7889
Q86UQ4-1#0	0	15174	15174	Q86UQ4-1	0	15174	+	15174	Q86UQ4-1	0	900	ENST00000417403.5	26	926	++	78	Q86UQ4-1#0	0	900	ENST00000417403.5	26	926	+	900	0	14274	7890
Q86UQ4-1#1	0	63	63	Q86UQ4-1	66	129	+	63	Q86UQ4-1	0	897	ENST00000435803.6	26	923	+	87	Q86UQ4-1#1	0	63	ENST00000435803.6	92	155	+	63	0	0	7891
Q86UQ4-1#1	0	63	63	Q86UQ4-1	66	129	+	63	Q86UQ4-1	0	900	ENST00000417403.5	26	926	++	78	Q86UQ4-1#1	0	63	ENST00000417403.5	92	155	+	63	0	0	7892
Q86UQ4-1#2	0	63	63	Q86UQ4-1	10701	10764	+	63																			
Q86UQ4-1#3	0	63	63	Q86UQ4-1	10818	10881	+	63																			
Q86UQ4-1#4	0	63	63	Q86UQ4-1	10941	11004	+	63																			
Q86UQ4-1#5	0	63	63	Q86UQ4-1	11034	11097	+	63																			
Q86UQ4-1#6	0	63	63	Q86UQ4-1	11124	11187	+	63																			
Q86UQ4-1#7	0	63	63	Q86UQ4-1	11253	11316	+	63																			
Q86UQ4-1#8	0	63	63	Q86UQ4-1	12675	12738	+	63																			
Q86UQ4-1#9	0	63	63	Q86UQ4-1	13371	13434	+	63																			
Q86UQ4-1#10	0	63	63	Q86UQ4-1	13509	13572	+	63																			
Q86UQ4-1#11	0	63	63	Q86UQ4-1	13605	13668	+	63																			
Q86UQ4-1#12	0	63	63	Q86UQ4-1	13701	13764	+	63																			
Q86UQ4-1#13	0	63	63	Q86UQ4-1	13818	13881	+	63																			
Q86UQ4-1#14	0	63	63	Q86UQ4-1	13950	14013	+	63																			
Q86UQ4-1#15	0	699	699	Q86UQ4-1	11523	12222	+	699																			
Q86UQ4-1#16	0	717	717	Q86UQ4-1	14151	14868	+	717																			
Q86UQ4-1#17	0	24	24	Q86UQ4-1	11622	11646	+	24																			
Q86UQ4-1#18	0	24	24	Q86UQ4-1	14259	14283	+	24																			
Q86UQ4-1#19	0	8208	8208	Q86UQ4-1	0	8208	+	8208	Q86UQ4-1	0	897	ENST00000435803.6	26	923	+	87	Q86UQ4-1#19	0	897	ENST00000435803.6	26	923	+	897	0	7311	7893
Q86UQ4-1#19	0	8208	8208	Q86UQ4-1	0	8208	+	8208	Q86UQ4-1	0	900	ENST00000417403.5	26	926	++	78	Q86UQ4-1#19	0	900	ENST00000417403.5	26	926	+	900	0	7308	7894
Q86UQ4-1#20	0	6894	6894	Q86UQ4-1	0	6894	+	6894	Q86UQ4-1	0	897	ENST00000435803.6	26	923	+	87	Q86UQ4-1#20	0	897	ENST00000435803.6	26	923	+	897	0	5997	7895
Q86UQ4-1#20	0	6894	6894	Q86UQ4-1	0	6894	+	6894	Q86UQ4-1	0	900	ENST00000417403.5	26	926	++	78	Q86UQ4-1#20	0	900	ENST00000417403.5	26	926	+	900	0	5994	7896
Q86UQ4-1#21	0	54	54	Q86UQ4-1	897	951	+	54	Q86UQ4-1	0	900	ENST00000417403.5	26	926	++	78	Q86UQ4-1#21	0	3	ENST00000417403.5	923	926	+	3	0	51	7897
Q86UQ4-1#22	0	14223	14223	Q86UQ4-1	951	15174	+	14223																			
Q86UQ4-1#23	0	3	3	Q86UQ4-1	12810	12813	+	3																			
Q86UQ4-1#24	0	93	93	Q86UQ4-1	13431	13524	+	93																			
Q86UQ4-1#25	0	336	336	Q86UQ4-1	14838	15174	+	336																			
Q86UQ4-1#26	0	3	3	Q86UQ4-1	1515	1518	+	3																			
Q86UQ4-1#27	0	3	3	Q86UQ4-1	1662	1665	+	3																			
Q86UQ4-1#28	0	3	3	Q86UQ4-1	2298	2301	+	3																			
Q86UQ4-1#29	0	3	3	Q86UQ4-1	2394	2397	+	3																			
Q86UQ4-1#30	0	3	3	Q86UQ4-1	4299	4302	+	3																			
Q86UQ4-1#31	0	3	3	Q86UQ4-1	4521	4524	+	3																			
Q86UQ4-1#32	0	3	3	Q86UQ4-1	4617	4620	+	3																			
Q86UQ4-1#33	0	3	3	Q86UQ4-1	5664	5667	+	3																			
Q86UQ4-1#34	0	3	3	Q86UQ4-1	6096	6099	+	3																			
Q86UQ4-1#35	0	3	3	Q86UQ4-1	6459	6462	+	3																			
Q86UQ4-1#36	0	3	3	Q86UQ4-1	6531	6534	+	3																			
Q86UQ4-1#37	0	3	3	Q86UQ4-1	6633	6636	+	3																			
Q86UQ4-1#38	0	3	3	Q86UQ4-1	7305	7308	+	3																			
Q86UQ4-1#39	0	3	3	Q86UQ4-1	7608	7611	+	3																			
Q86UQ4-1#40	0	3	3	Q86UQ4-1	8019	8022	+	3																			
Q86UQ4-1#41	0	3	3	Q86UQ4-1	9423	9426	+	3																			
Q86UQ4-1#42	0	3	3	Q86UQ4-1	11550	11553	+	3																			
Q86UQ4-1#43	0	3	3	Q86UQ4-1	12828	12831	+	3																			
Q86UQ4-1#44	0	3	3	Q86UQ4-1	12903	12906	+	3																			
Q86UQ4-1#45	0	3	3	Q86UQ4-1	13002	13005	+	3																			
Q86UQ4-1#46	0	3	3	Q86UQ4-1	4245	4248	+	3																			
Q86UQ4-1#47	0	3	3	Q86UQ4-1	8151	8154	+	3																			
Q86UQ4-1#48	0	3	3	Q86UQ4-1	8490	8493	+	3																			
Q86UQ4-1#49	0	3	3	Q86UQ4-1	8607	8610	+	3																			
Q86UQ4-1#50	0	3	3	Q86UQ4-1	9168	9171	+	3																			
Q86UQ4-1#51	0	3	3	Q86UQ4-1	13335	13338	+	3																			
Q86UQ4-1#52	0	3	3	Q86UQ4-1	13749	13752	+	3																			
P42771-1#0	0	468	468	P42771-1	0	468	+	468	P42771-1	147	354	ENST00000579755.2	251	458	++	198	P42771-1#0	147	354	ENST00000579755.2	251	458	+	207	147	114	7898
P42771-1#0	0	468	468	P42771-1	0	468	+	468	P42771-1	0	468	ENST00000579122.1	31	425	+	195	P42771-1#0	0	468	ENST00000579122.1	31	425	+	394	0	0	7899
P42771-1#0	0	468	468	P42771-1	0	468	+	468	P42771-1	153	468	ENST00000578845.2	127	442	++	193	P42771-1#0	153	468	ENST00000578845.2	127	442	+	315	153	0	7900
P42771-1#0	0	468	468	P42771-1	0	468	+	468	P42771-1	147	354	ENST00000530628.2	270	477	++	152	P42771-1#0	147	354	ENST00000530628.2	270	477	+	207	147	114	7901
P42771-1#0	0	468	468	P42771-1	0	468	+	468	P42771-1	153	468	ENST00000498628.6	484	799	++	128	P42771-1#0	153	468	ENST00000498628.6	484	799	+	315	153	0	7902
P42771-1#0	0	468	468	P42771-1	0	468	+	468	P42771-1	0	462	ENST00000498124.1	39	501	++	126	P42771-1#0	0	462	ENST00000498124.1	39	501	+	462	0	6	7903
P42771-1#0	0	468	468	P42771-1	0	468	+	468	P42771-1	153	457	ENST00000497750.1	75	379	+	125	P42771-1#0	153	457	ENST00000497750.1	75	379	+	304	153	11	7904
P42771-1#0	0	468	468	P42771-1	0	468	+	468	P42771-1	153	468	ENST00000494262.5	624	939	++	120	P42771-1#0	153	468	ENST00000494262.5	624	939	+	315	153	0	7905
P42771-1#0	0	468	468	P42771-1	0	468	+	468	P42771-1	153	457	ENST00000479692.2	15	319	+	114	P42771-1#0	153	457	ENST00000479692.2	15	319	+	304	153	11	7906
P42771-1#0	0	468	468	P42771-1	0	468	+	468	P42771-1	0	153	ENST00000380151.3	0	153	++	54	P42771-1#0	0	153	ENST00000380151.3	0	153	+	153	0	315	7907
P42771-1#0	0	468	468	P42771-1	0	468	+	468	P42771-1	0	468	ENST00000304494.10	30	498	++	22	P42771-1#0	0	468	ENST00000304494.10	30	498	+	468	0	0	7908
P42771-1#1	0	90	90	P42771-1	30	120	+	90	P42771-1	0	468	ENST00000579122.1	31	425	+	195	P42771-1#1	0	90	ENST00000579122.1	61	151	+	90	0	0	7909
P42771-1#1	0	90	90	P42771-1	30	120	+	90	P42771-1	0	462	ENST00000498124.1	39	501	++	126	P42771-1#1	0	90	ENST00000498124.1	69	159	+	90	0	0	7910
P42771-1#1	0	90	90	P42771-1	30	120	+	90	P42771-1	0	153	ENST00000380151.3	0	153	++	54	P42771-1#1	0	90	ENST00000380151.3	30	120	+	90	0	0	7911
P42771-1#1	0	90	90	P42771-1	30	120	+	90	P42771-1	0	468	ENST00000304494.10	30	498	++	22	P42771-1#1	0	90	ENST00000304494.10	60	150	+	90	0	0	7912
P42771-1#2	0	87	87	P42771-1	129	216	+	87	P42771-1	147	354	ENST00000579755.2	251	458	++	198	P42771-1#2	18	87	ENST00000579755.2	251	320	+	69	18	0	7913
P42771-1#2	0	87	87	P42771-1	129	216	+	87	P42771-1	0	468	ENST00000579122.1	31	425	+	195	P42771-1#2	0	87	ENST00000579122.1	160	247	+	87	0	0	7914
P42771-1#2	0	87	87	P42771-1	129	216	+	87	P42771-1	153	468	ENST00000578845.2	127	442	++	193	P42771-1#2	24	87	ENST00000578845.2	127	190	+	63	24	0	7915
P42771-1#2	0	87	87	P42771-1	129	216	+	87	P42771-1	147	354	ENST00000530628.2	270	477	++	152	P42771-1#2	18	87	ENST00000530628.2	270	339	+	69	18	0	7916
P42771-1#2	0	87	87	P42771-1	129	216	+	87	P42771-1	153	468	ENST00000498628.6	484	799	++	128	P42771-1#2	24	87	ENST00000498628.6	484	547	+	63	24	0	7917
P42771-1#2	0	87	87	P42771-1	129	216	+	87	P42771-1	0	462	ENST00000498124.1	39	501	++	126	P42771-1#2	0	87	ENST00000498124.1	168	255	+	87	0	0	7918
P42771-1#2	0	87	87	P42771-1	129	216	+	87	P42771-1	153	457	ENST00000497750.1	75	379	+	125	P42771-1#2	24	87	ENST00000497750.1	75	138	+	63	24	0	7919
P42771-1#2	0	87	87	P42771-1	129	216	+	87	P42771-1	153	468	ENST00000494262.5	624	939	++	120	P42771-1#2	24	87	ENST00000494262.5	624	687	+	63	24	0	7920
P42771-1#2	0	87	87	P42771-1	129	216	+	87	P42771-1	153	457	ENST00000479692.2	15	319	+	114	P42771-1#2	24	87	ENST00000479692.2	15	78	+	63	24	0	7921
P42771-1#2	0	87	87	P42771-1	129	216	+	87	P42771-1	0	153	ENST00000380151.3	0	153	++	54	P42771-1#2	0	24	ENST00000380151.3	129	153	+	24	0	63	7922
P42771-1#2	0	87	87	P42771-1	129	216	+	87	P42771-1	0	468	ENST00000304494.10	30	498	++	22	P42771-1#2	0	87	ENST00000304494.10	159	246	+	87	0	0	7923
P42771-1#3	0	90	90	P42771-1	228	318	+	90	P42771-1	147	354	ENST00000579755.2	251	458	++	198	P42771-1#3	0	90	ENST00000579755.2	332	422	+	90	0	0	7924
P42771-1#3	0	90	90	P42771-1	228	318	+	90	P42771-1	0	468	ENST00000579122.1	31	425	+	195	P42771-1#3	0	90	ENST00000579122.1	259	349	+	90	0	0	7925
P42771-1#3	0	90	90	P42771-1	228	318	+	90	P42771-1	153	468	ENST00000578845.2	127	442	++	193	P42771-1#3	0	90	ENST00000578845.2	202	292	+	90	0	0	7926
P42771-1#3	0	90	90	P42771-1	228	318	+	90	P42771-1	147	354	ENST00000530628.2	270	477	++	152	P42771-1#3	0	90	ENST00000530628.2	351	441	+	90	0	0	7927
P42771-1#3	0	90	90	P42771-1	228	318	+	90	P42771-1	153	468	ENST00000498628.6	484	799	++	128	P42771-1#3	0	90	ENST00000498628.6	559	649	+	90	0	0	7928
P42771-1#3	0	90	90	P42771-1	228	318	+	90	P42771-1	0	462	ENST00000498124.1	39	501	++	126	P42771-1#3	0	90	ENST00000498124.1	267	357	+	90	0	0	7929
P42771-1#3	0	90	90	P42771-1	228	318	+	90	P42771-1	153	457	ENST00000497750.1	75	379	+	125	P42771-1#3	0	90	ENST00000497750.1	150	240	+	90	0	0	7930
P42771-1#3	0	90	90	P42771-1	228	318	+	90	P42771-1	153	468	ENST00000494262.5	624	939	++	120	P42771-1#3	0	90	ENST00000494262.5	699	789	+	90	0	0	7931
P42771-1#3	0	90	90	P42771-1	228	318	+	90	P42771-1	153	457	ENST00000479692.2	15	319	+	114	P42771-1#3	0	90	ENST00000479692.2	90	180	+	90	0	0	7932
P42771-1#3	0	90	90	P42771-1	228	318	+	90	P42771-1	0	468	ENST00000304494.10	30	498	++	22	P42771-1#3	0	90	ENST00000304494.10	258	348	+	90	0	0	7933
P42771-1#4	0	90	90	P42771-1	327	417	+	90	P42771-1	147	354	ENST00000579755.2	251	458	++	198	P42771-1#4	0	27	ENST00000579755.2	431	458	+	27	0	63	7934
P42771-1#4	0	90	90	P42771-1	327	417	+	90	P42771-1	0	468	ENST00000579122.1	31	425	+	195	P42771-1#4	0	56	ENST00000579122.1	358	414	+	56	0	34	7935
P42771-1#4	0	90	90	P42771-1	327	417	+	90	P42771-1	153	468	ENST00000578845.2	127	442	++	193	P42771-1#4	0	90	ENST00000578845.2	301	391	+	90	0	0	7936
P42771-1#4	0	90	90	P42771-1	327	417	+	90	P42771-1	147	354	ENST00000530628.2	270	477	++	152	P42771-1#4	0	27	ENST00000530628.2	450	477	+	27	0	63	7937
P42771-1#4	0	90	90	P42771-1	327	417	+	90	P42771-1	153	468	ENST00000498628.6	484	799	++	128	P42771-1#4	0	90	ENST00000498628.6	658	748	+	90	0	0	7938
P42771-1#4	0	90	90	P42771-1	327	417	+	90	P42771-1	0	462	ENST00000498124.1	39	501	++	126	P42771-1#4	0	90	ENST00000498124.1	366	456	+	90	0	0	7939
P42771-1#4	0	90	90	P42771-1	327	417	+	90	P42771-1	153	457	ENST00000497750.1	75	379	+	125	P42771-1#4	0	90	ENST00000497750.1	249	339	+	90	0	0	7940
P42771-1#4	0	90	90	P42771-1	327	417	+	90	P42771-1	153	468	ENST00000494262.5	624	939	++	120	P42771-1#4	0	90	ENST00000494262.5	798	888	+	90	0	0	7941
P42771-1#4	0	90	90	P42771-1	327	417	+	90	P42771-1	153	457	ENST00000479692.2	15	319	+	114	P42771-1#4	0	90	ENST00000479692.2	189	279	+	90	0	0	7942
P42771-1#4	0	90	90	P42771-1	327	417	+	90	P42771-1	0	468	ENST00000304494.10	30	498	++	22	P42771-1#4	0	90	ENST00000304494.10	357	447	+	90	0	0	7943
P42771-1#5	0	3	3	P42771-1	0	3	+	3	P42771-1	0	468	ENST00000579122.1	31	425	+	195	P42771-1#5	0	3	ENST00000579122.1	31	34	+	3	0	0	7944
P42771-1#5	0	3	3	P42771-1	0	3	+	3	P42771-1	0	462	ENST00000498124.1	39	501	++	126	P42771-1#5	0	3	ENST00000498124.1	39	42	+	3	0	0	7945
P42771-1#5	0	3	3	P42771-1	0	3	+	3	P42771-1	0	153	ENST00000380151.3	0	153	++	54	P42771-1#5	0	3	ENST00000380151.3	0	3	+	3	0	0	7946
P42771-1#5	0	3	3	P42771-1	0	3	+	3	P42771-1	0	468	ENST00000304494.10	30	498	++	22	P42771-1#5	0	3	ENST00000304494.10	30	33	+	3	0	0	7947
P42771-1#6	0	3	3	P42771-1	18	21	+	3	P42771-1	0	468	ENST00000579122.1	31	425	+	195	P42771-1#6	0	3	ENST00000579122.1	49	52	+	3	0	0	7948
P42771-1#6	0	3	3	P42771-1	18	21	+	3	P42771-1	0	462	ENST00000498124.1	39	501	++	126	P42771-1#6	0	3	ENST00000498124.1	57	60	+	3	0	0	7949
P42771-1#6	0	3	3	P42771-1	18	21	+	3	P42771-1	0	153	ENST00000380151.3	0	153	++	54	P42771-1#6	0	3	ENST00000380151.3	18	21	+	3	0	0	7950
P42771-1#6	0	3	3	P42771-1	18	21	+	3	P42771-1	0	468	ENST00000304494.10	30	498	++	22	P42771-1#6	0	3	ENST00000304494.10	48	51	+	3	0	0	7951
P42771-1#7	0	3	3	P42771-1	21	24	+	3	P42771-1	0	468	ENST00000579122.1	31	425	+	195	P42771-1#7	0	3	ENST00000579122.1	52	55	+	3	0	0	7952
P42771-1#7	0	3	3	P42771-1	21	24	+	3	P42771-1	0	462	ENST00000498124.1	39	501	++	126	P42771-1#7	0	3	ENST00000498124.1	60	63	+	3	0	0	7953
P42771-1#7	0	3	3	P42771-1	21	24	+	3	P42771-1	0	153	ENST00000380151.3	0	153	++	54	P42771-1#7	0	3	ENST00000380151.3	21	24	+	3	0	0	7954
P42771-1#7	0	3	3	P42771-1	21	24	+	3	P42771-1	0	468	ENST00000304494.10	30	498	++	22	P42771-1#7	0	3	ENST00000304494.10	51	54	+	3	0	0	7955
P42771-1#8	0	3	3	P42771-1	417	420	+	3	P42771-1	153	468	ENST00000578845.2	127	442	++	193	P42771-1#8	0	3	ENST00000578845.2	391	394	+	3	0	0	7956
P42771-1#8	0	3	3	P42771-1	417	420	+	3	P42771-1	153	468	ENST00000498628.6	484	799	++	128	P42771-1#8	0	3	ENST00000498628.6	748	751	+	3	0	0	7957
P42771-1#8	0	3	3	P42771-1	417	420	+	3	P42771-1	0	462	ENST00000498124.1	39	501	++	126	P42771-1#8	0	3	ENST00000498124.1	456	459	+	3	0	0	7958
P42771-1#8	0	3	3	P42771-1	417	420	+	3	P42771-1	153	457	ENST00000497750.1	75	379	+	125	P42771-1#8	0	3	ENST00000497750.1	339	342	+	3	0	0	7959
P42771-1#8	0	3	3	P42771-1	417	420	+	3	P42771-1	153	468	ENST00000494262.5	624	939	++	120	P42771-1#8	0	3	ENST00000494262.5	888	891	+	3	0	0	7960
P42771-1#8	0	3	3	P42771-1	417	420	+	3	P42771-1	153	457	ENST00000479692.2	15	319	+	114	P42771-1#8	0	3	ENST00000479692.2	279	282	+	3	0	0	7961
P42771-1#8	0	3	3	P42771-1	417	420	+	3	P42771-1	0	468	ENST00000304494.10	30	498	++	22	P42771-1#8	0	3	ENST00000304494.10	447	450	+	3	0	0	7962
P42771-1#9	0	3	3	P42771-1	453	456	+	3	P42771-1	153	468	ENST00000578845.2	127	442	++	193	P42771-1#9	0	3	ENST00000578845.2	427	430	+	3	0	0	7963
P42771-1#9	0	3	3	P42771-1	453	456	+	3	P42771-1	153	468	ENST00000498628.6	484	799	++	128	P42771-1#9	0	3	ENST00000498628.6	784	787	+	3	0	0	7964
P42771-1#9	0	3	3	P42771-1	453	456	+	3	P42771-1	0	462	ENST00000498124.1	39	501	++	126	P42771-1#9	0	3	ENST00000498124.1	492	495	+	3	0	0	7965
P42771-1#9	0	3	3	P42771-1	453	456	+	3	P42771-1	153	457	ENST00000497750.1	75	379	+	125	P42771-1#9	0	3	ENST00000497750.1	375	378	+	3	0	0	7966
P42771-1#9	0	3	3	P42771-1	453	456	+	3	P42771-1	153	468	ENST00000494262.5	624	939	++	120	P42771-1#9	0	3	ENST00000494262.5	924	927	+	3	0	0	7967
P42771-1#9	0	3	3	P42771-1	453	456	+	3	P42771-1	153	457	ENST00000479692.2	15	319	+	114	P42771-1#9	0	3	ENST00000479692.2	315	318	+	3	0	0	7968
P42771-1#9	0	3	3	P42771-1	453	456	+	3	P42771-1	0	468	ENST00000304494.10	30	498	++	22	P42771-1#9	0	3	ENST00000304494.10	483	486	+	3	0	0	7969
P42771-1#10	0	153	153	P42771-1	0	153	+	153	P42771-1	147	354	ENST00000579755.2	251	458	++	198	P42771-1#10	147	153	ENST00000579755.2	251	257	+	6	147	0	7970
P42771-1#10	0	153	153	P42771-1	0	153	+	153	P42771-1	0	468	ENST00000579122.1	31	425	+	195	P42771-1#10	0	153	ENST00000579122.1	31	184	+	153	0	0	7971
P42771-1#10	0	153	153	P42771-1	0	153	+	153	P42771-1	147	354	ENST00000530628.2	270	477	++	152	P42771-1#10	147	153	ENST00000530628.2	270	276	+	6	147	0	7972
P42771-1#10	0	153	153	P42771-1	0	153	+	153	P42771-1	0	462	ENST00000498124.1	39	501	++	126	P42771-1#10	0	153	ENST00000498124.1	39	192	+	153	0	0	7973
P42771-1#10	0	153	153	P42771-1	0	153	+	153	P42771-1	0	153	ENST00000380151.3	0	153	++	54	P42771-1#10	0	153	ENST00000380151.3	0	153	+	153	0	0	7974
P42771-1#10	0	153	153	P42771-1	0	153	+	153	P42771-1	0	468	ENST00000304494.10	30	498	++	22	P42771-1#10	0	153	ENST00000304494.10	30	183	+	153	0	0	7975
P42771-1#11	0	195	195	P42771-1	153	348	+	195	P42771-1	147	354	ENST00000579755.2	251	458	++	198	P42771-1#11	0	195	ENST00000579755.2	257	452	+	195	0	0	7976
P42771-1#11	0	195	195	P42771-1	153	348	+	195	P42771-1	0	468	ENST00000579122.1	31	425	+	195	P42771-1#11	0	195	ENST00000579122.1	184	379	+	195	0	0	7977
P42771-1#11	0	195	195	P42771-1	153	348	+	195	P42771-1	153	468	ENST00000578845.2	127	442	++	193	P42771-1#11	0	195	ENST00000578845.2	127	322	+	195	0	0	7978
P42771-1#11	0	195	195	P42771-1	153	348	+	195	P42771-1	147	354	ENST00000530628.2	270	477	++	152	P42771-1#11	0	195	ENST00000530628.2	276	471	+	195	0	0	7979
P42771-1#11	0	195	195	P42771-1	153	348	+	195	P42771-1	153	468	ENST00000498628.6	484	799	++	128	P42771-1#11	0	195	ENST00000498628.6	484	679	+	195	0	0	7980
P42771-1#11	0	195	195	P42771-1	153	348	+	195	P42771-1	0	462	ENST00000498124.1	39	501	++	126	P42771-1#11	0	195	ENST00000498124.1	192	387	+	195	0	0	7981
P42771-1#11	0	195	195	P42771-1	153	348	+	195	P42771-1	153	457	ENST00000497750.1	75	379	+	125	P42771-1#11	0	195	ENST00000497750.1	75	270	+	195	0	0	7982
P42771-1#11	0	195	195	P42771-1	153	348	+	195	P42771-1	153	468	ENST00000494262.5	624	939	++	120	P42771-1#11	0	195	ENST00000494262.5	624	819	+	195	0	0	7983
P42771-1#11	0	195	195	P42771-1	153	348	+	195	P42771-1	153	457	ENST00000479692.2	15	319	+	114	P42771-1#11	0	195	ENST00000479692.2	15	210	+	195	0	0	7984
P42771-1#11	0	195	195	P42771-1	153	348	+	195	P42771-1	0	468	ENST00000304494.10	30	498	++	22	P42771-1#11	0	195	ENST00000304494.10	183	378	+	195	0	0	7985
P42771-1#12	0	120	120	P42771-1	348	468	+	120	P42771-1	147	354	ENST00000579755.2	251	458	++	198	P42771-1#12	0	6	ENST00000579755.2	452	458	+	6	0	114	7986
P42771-1#12	0	120	120	P42771-1	348	468	+	120	P42771-1	0	468	ENST00000579122.1	31	425	+	195	P42771-1#12	0	120	ENST00000579122.1	379	425	+	46	0	0	7987
P42771-1#12	0	120	120	P42771-1	348	468	+	120	P42771-1	153	468	ENST00000578845.2	127	442	++	193	P42771-1#12	0	120	ENST00000578845.2	322	442	+	120	0	0	7988
P42771-1#12	0	120	120	P42771-1	348	468	+	120	P42771-1	147	354	ENST00000530628.2	270	477	++	152	P42771-1#12	0	6	ENST00000530628.2	471	477	+	6	0	114	7989
P42771-1#12	0	120	120	P42771-1	348	468	+	120	P42771-1	153	468	ENST00000498628.6	484	799	++	128	P42771-1#12	0	120	ENST00000498628.6	679	799	+	120	0	0	7990
P42771-1#12	0	120	120	P42771-1	348	468	+	120	P42771-1	0	462	ENST00000498124.1	39	501	++	126	P42771-1#12	0	114	ENST00000498124.1	387	501	+	114	0	6	7991
P42771-1#12	0	120	120	P42771-1	348	468	+	120	P42771-1	153	457	ENST00000497750.1	75	379	+	125	P42771-1#12	0	109	ENST00000497750.1	270	379	+	109	0	11	7992
P42771-1#12	0	120	120	P42771-1	348	468	+	120	P42771-1	153	468	ENST00000494262.5	624	939	++	120	P42771-1#12	0	120	ENST00000494262.5	819	939	+	120	0	0	7993
P42771-1#12	0	120	120	P42771-1	348	468	+	120	P42771-1	153	457	ENST00000479692.2	15	319	+	114	P42771-1#12	0	109	ENST00000479692.2	210	319	+	109	0	11	7994
P42771-1#12	0	120	120	P42771-1	348	468	+	120	P42771-1	0	468	ENST00000304494.10	30	498	++	22	P42771-1#12	0	120	ENST00000304494.10	378	498	+	120	0	0	7995
P42771-1#13	0	12	12	P42771-1	456	468	+	12	P42771-1	0	468	ENST00000579122.1	31	425	+	195	P42771-1#13	1	12	ENST00000579122.1	414	425	+	11	1	0	7996
P42771-1#13	0	12	12	P42771-1	456	468	+	12	P42771-1	153	468	ENST00000578845.2	127	442	++	193	P42771-1#13	0	12	ENST00000578845.2	430	442	+	12	0	0	7997
P42771-1#13	0	12	12	P42771-1	456	468	+	12	P42771-1	153	468	ENST00000498628.6	484	799	++	128	P42771-1#13	0	12	ENST00000498628.6	787	799	+	12	0	0	7998
P42771-1#13	0	12	12	P42771-1	456	468	+	12	P42771-1	0	462	ENST00000498124.1	39	501	++	126	P42771-1#13	0	6	ENST00000498124.1	495	501	+	6	0	6	7999
P42771-1#13	0	12	12	P42771-1	456	468	+	12	P42771-1	153	457	ENST00000497750.1	75	379	+	125	P42771-1#13	0	1	ENST00000497750.1	378	379	+	1	0	11	8000
P42771-1#13	0	12	12	P42771-1	456	468	+	12	P42771-1	153	468	ENST00000494262.5	624	939	++	120	P42771-1#13	0	12	ENST00000494262.5	927	939	+	12	0	0	8001
P42771-1#13	0	12	12	P42771-1	456	468	+	12	P42771-1	153	457	ENST00000479692.2	15	319	+	114	P42771-1#13	0	1	ENST00000479692.2	318	319	+	1	0	11	8002
P42771-1#13	0	12	12	P42771-1	456	468	+	12	P42771-1	0	468	ENST00000304494.10	30	498	++	22	P42771-1#13	0	12	ENST00000304494.10	486	498	+	12	0	0	8003
P42771-1#14	0	3	3	P42771-1	39	42	+	3	P42771-1	0	468	ENST00000579122.1	31	425	+	195	P42771-1#14	0	3	ENST00000579122.1	70	73	+	3	0	0	8004
P42771-1#14	0	3	3	P42771-1	39	42	+	3	P42771-1	0	462	ENST00000498124.1	39	501	++	126	P42771-1#14	0	3	ENST00000498124.1	78	81	+	3	0	0	8005
P42771-1#14	0	3	3	P42771-1	39	42	+	3	P42771-1	0	153	ENST00000380151.3	0	153	++	54	P42771-1#14	0	3	ENST00000380151.3	39	42	+	3	0	0	8006
P42771-1#14	0	3	3	P42771-1	39	42	+	3	P42771-1	0	468	ENST00000304494.10	30	498	++	22	P42771-1#14	0	3	ENST00000304494.10	69	72	+	3	0	0	8007
P42771-1#15	0	3	3	P42771-1	45	48	+	3	P42771-1	0	468	ENST00000579122.1	31	425	+	195	P42771-1#15	0	3	ENST00000579122.1	76	79	+	3	0	0	8008
P42771-1#15	0	3	3	P42771-1	45	48	+	3	P42771-1	0	462	ENST00000498124.1	39	501	++	126	P42771-1#15	0	3	ENST00000498124.1	84	87	+	3	0	0	8009
P42771-1#15	0	3	3	P42771-1	45	48	+	3	P42771-1	0	153	ENST00000380151.3	0	153	++	54	P42771-1#15	0	3	ENST00000380151.3	45	48	+	3	0	0	8010
P42771-1#15	0	3	3	P42771-1	45	48	+	3	P42771-1	0	468	ENST00000304494.10	30	498	++	22	P42771-1#15	0	3	ENST00000304494.10	75	78	+	3	0	0	8011
P42771-1#16	0	3	3	P42771-1	54	57	+	3	P42771-1	0	468	ENST00000579122.1	31	425	+	195	P42771-1#16	0	3	ENST00000579122.1	85	88	+	3	0	0	8012
P42771-1#16	0	3	3	P42771-1	54	57	+	3	P42771-1	0	462	ENST00000498124.1	39	501	++	126	P42771-1#16	0	3	ENST00000498124.1	93	96	+	3	0	0	8013
P42771-1#16	0	3	3	P42771-1	54	57	+	3	P42771-1	0	153	ENST00000380151.3	0	153	++	54	P42771-1#16	0	3	ENST00000380151.3	54	57	+	3	0	0	8014
P42771-1#16	0	3	3	P42771-1	54	57	+	3	P42771-1	0	468	ENST00000304494.10	30	498	++	22	P42771-1#16	0	3	ENST00000304494.10	84	87	+	3	0	0	8015
P42771-1#17	0	3	3	P42771-1	57	60	+	3	P42771-1	0	468	ENST00000579122.1	31	425	+	195	P42771-1#17	0	3	ENST00000579122.1	88	91	+	3	0	0	8016
P42771-1#17	0	3	3	P42771-1	57	60	+	3	P42771-1	0	462	ENST00000498124.1	39	501	++	126	P42771-1#17	0	3	ENST00000498124.1	96	99	+	3	0	0	8017
P42771-1#17	0	3	3	P42771-1	57	60	+	3	P42771-1	0	153	ENST00000380151.3	0	153	++	54	P42771-1#17	0	3	ENST00000380151.3	57	60	+	3	0	0	8018
P42771-1#17	0	3	3	P42771-1	57	60	+	3	P42771-1	0	468	ENST00000304494.10	30	498	++	22	P42771-1#17	0	3	ENST00000304494.10	87	90	+	3	0	0	8019
P42771-1#18	0	3	3	P42771-1	57	60	+	3	P42771-1	0	468	ENST00000579122.1	31	425	+	195	P42771-1#18	0	3	ENST00000579122.1	88	91	+	3	0	0	8020
P42771-1#18	0	3	3	P42771-1	57	60	+	3	P42771-1	0	462	ENST00000498124.1	39	501	++	126	P42771-1#18	0	3	ENST00000498124.1	96	99	+	3	0	0	8021
P42771-1#18	0	3	3	P42771-1	57	60	+	3	P42771-1	0	153	ENST00000380151.3	0	153	++	54	P42771-1#18	0	3	ENST00000380151.3	57	60	+	3	0	0	8022
P42771-1#18	0	3	3	P42771-1	57	60	+	3	P42771-1	0	468	ENST00000304494.10	30	498	++	22	P42771-1#18	0	3	ENST00000304494.10	87	90	+	3	0	0	8023
P42771-1#19	0	3	3	P42771-1	66	69	+	3	P42771-1	0	468	ENST00000579122.1	31	425	+	195	P42771-1#19	0	3	ENST00000579122.1	97	100	+	3	0	0	8024
P42771-1#19	0	3	3	P42771-1	66	69	+	3	P42771-1	0	462	ENST00000498124.1	39	501	++	126	P42771-1#19	0	3	ENST00000498124.1	105	108	+	3	0	0	8025
P42771-1#19	0	3	3	P42771-1	66	69	+	3	P42771-1	0	153	ENST00000380151.3	0	153	++	54	P42771-1#19	0	3	ENST00000380151.3	66	69	+	3	0	0	8026
P42771-1#19	0	3	3	P42771-1	66	69	+	3	P42771-1	0	468	ENST00000304494.10	30	498	++	22	P42771-1#19	0	3	ENST00000304494.10	96	99	+	3	0	0	8027
P42771-1#20	0	3	3	P42771-1	69	72	+	3	P42771-1	0	468	ENST00000579122.1	31	425	+	195	P42771-1#20	0	3	ENST00000579122.1	100	103	+	3	0	0	8028
P42771-1#20	0	3	3	P42771-1	69	72	+	3	P42771-1	0	462	ENST00000498124.1	39	501	++	126	P42771-1#20	0	3	ENST00000498124.1	108	111	+	3	0	0	8029
P42771-1#20	0	3	3	P42771-1	69	72	+	3	P42771-1	0	153	ENST00000380151.3	0	153	++	54	P42771-1#20	0	3	ENST00000380151.3	69	72	+	3	0	0	8030
P42771-1#20	0	3	3	P42771-1	69	72	+	3	P42771-1	0	468	ENST00000304494.10	30	498	++	22	P42771-1#20	0	3	ENST00000304494.10	99	102	+	3	0	0	8031
P42771-1#21	0	3	3	P42771-1	69	72	+	3	P42771-1	0	468	ENST00000579122.1	31	425	+	195	P42771-1#21	0	3	ENST00000579122.1	100	103	+	3	0	0	8032
P42771-1#21	0	3	3	P42771-1	69	72	+	3	P42771-1	0	462	ENST00000498124.1	39	501	++	126	P42771-1#21	0	3	ENST00000498124.1	108	111	+	3	0	0	8033
P42771-1#21	0	3	3	P42771-1	69	72	+	3	P42771-1	0	153	ENST00000380151.3	0	153	++	54	P42771-1#21	0	3	ENST00000380151.3	69	72	+	3	0	0	8034
P42771-1#21	0	3	3	P42771-1	69	72	+	3	P42771-1	0	468	ENST00000304494.10	30	498	++	22	P42771-1#21	0	3	ENST00000304494.10	99	102	+	3	0	0	8035
P42771-1#22	0	3	3	P42771-1	69	72	+	3	P42771-1	0	468	ENST00000579122.1	31	425	+	195	P42771-1#22	0	3	ENST00000579122.1	100	103	+	3	0	0	8036
P42771-1#22	0	3	3	P42771-1	69	72	+	3	P42771-1	0	462	ENST00000498124.1	39	501	++	126	P42771-1#22	0	3	ENST00000498124.1	108	111	+	3	0	0	8037
P42771-1#22	0	3	3	P42771-1	69	72	+	3	P42771-1	0	153	ENST00000380151.3	0	153	++	54	P42771-1#22	0	3	ENST00000380151.3	69	72	+	3	0	0	8038
P42771-1#22	0	3	3	P42771-1	69	72	+	3	P42771-1	0	468	ENST00000304494.10	30	498	++	22	P42771-1#22	0	3	ENST00000304494.10	99	102	+	3	0	0	8039
P42771-1#23	0	3	3	P42771-1	75	78	+	3	P42771-1	0	468	ENST00000579122.1	31	425	+	195	P42771-1#23	0	3	ENST00000579122.1	106	109	+	3	0	0	8040
P42771-1#23	0	3	3	P42771-1	75	78	+	3	P42771-1	0	462	ENST00000498124.1	39	501	++	126	P42771-1#23	0	3	ENST00000498124.1	114	117	+	3	0	0	8041
P42771-1#23	0	3	3	P42771-1	75	78	+	3	P42771-1	0	153	ENST00000380151.3	0	153	++	54	P42771-1#23	0	3	ENST00000380151.3	75	78	+	3	0	0	8042
P42771-1#23	0	3	3	P42771-1	75	78	+	3	P42771-1	0	468	ENST00000304494.10	30	498	++	22	P42771-1#23	0	3	ENST00000304494.10	105	108	+	3	0	0	8043
P42771-1#24	0	3	3	P42771-1	93	96	+	3	P42771-1	0	468	ENST00000579122.1	31	425	+	195	P42771-1#24	0	3	ENST00000579122.1	124	127	+	3	0	0	8044
P42771-1#24	0	3	3	P42771-1	93	96	+	3	P42771-1	0	462	ENST00000498124.1	39	501	++	126	P42771-1#24	0	3	ENST00000498124.1	132	135	+	3	0	0	8045
P42771-1#24	0	3	3	P42771-1	93	96	+	3	P42771-1	0	153	ENST00000380151.3	0	153	++	54	P42771-1#24	0	3	ENST00000380151.3	93	96	+	3	0	0	8046
P42771-1#24	0	3	3	P42771-1	93	96	+	3	P42771-1	0	468	ENST00000304494.10	30	498	++	22	P42771-1#24	0	3	ENST00000304494.10	123	126	+	3	0	0	8047
P42771-1#25	0	3	3	P42771-1	96	99	+	3	P42771-1	0	468	ENST00000579122.1	31	425	+	195	P42771-1#25	0	3	ENST00000579122.1	127	130	+	3	0	0	8048
P42771-1#25	0	3	3	P42771-1	96	99	+	3	P42771-1	0	462	ENST00000498124.1	39	501	++	126	P42771-1#25	0	3	ENST00000498124.1	135	138	+	3	0	0	8049
P42771-1#25	0	3	3	P42771-1	96	99	+	3	P42771-1	0	153	ENST00000380151.3	0	153	++	54	P42771-1#25	0	3	ENST00000380151.3	96	99	+	3	0	0	8050
P42771-1#25	0	3	3	P42771-1	96	99	+	3	P42771-1	0	468	ENST00000304494.10	30	498	++	22	P42771-1#25	0	3	ENST00000304494.10	126	129	+	3	0	0	8051
P42771-1#26	0	3	3	P42771-1	102	105	+	3	P42771-1	0	468	ENST00000579122.1	31	425	+	195	P42771-1#26	0	3	ENST00000579122.1	133	136	+	3	0	0	8052
P42771-1#26	0	3	3	P42771-1	102	105	+	3	P42771-1	0	462	ENST00000498124.1	39	501	++	126	P42771-1#26	0	3	ENST00000498124.1	141	144	+	3	0	0	8053
P42771-1#26	0	3	3	P42771-1	102	105	+	3	P42771-1	0	153	ENST00000380151.3	0	153	++	54	P42771-1#26	0	3	ENST00000380151.3	102	105	+	3	0	0	8054
P42771-1#26	0	3	3	P42771-1	102	105	+	3	P42771-1	0	468	ENST00000304494.10	30	498	++	22	P42771-1#26	0	3	ENST00000304494.10	132	135	+	3	0	0	8055
P42771-1#27	0	3	3	P42771-1	102	105	+	3	P42771-1	0	468	ENST00000579122.1	31	425	+	195	P42771-1#27	0	3	ENST00000579122.1	133	136	+	3	0	0	8056
P42771-1#27	0	3	3	P42771-1	102	105	+	3	P42771-1	0	462	ENST00000498124.1	39	501	++	126	P42771-1#27	0	3	ENST00000498124.1	141	144	+	3	0	0	8057
P42771-1#27	0	3	3	P42771-1	102	105	+	3	P42771-1	0	153	ENST00000380151.3	0	153	++	54	P42771-1#27	0	3	ENST00000380151.3	102	105	+	3	0	0	8058
P42771-1#27	0	3	3	P42771-1	102	105	+	3	P42771-1	0	468	ENST00000304494.10	30	498	++	22	P42771-1#27	0	3	ENST00000304494.10	132	135	+	3	0	0	8059
P42771-1#28	0	3	3	P42771-1	102	105	+	3	P42771-1	0	468	ENST00000579122.1	31	425	+	195	P42771-1#28	0	3	ENST00000579122.1	133	136	+	3	0	0	8060
P42771-1#28	0	3	3	P42771-1	102	105	+	3	P42771-1	0	462	ENST00000498124.1	39	501	++	126	P42771-1#28	0	3	ENST00000498124.1	141	144	+	3	0	0	8061
P42771-1#28	0	3	3	P42771-1	102	105	+	3	P42771-1	0	153	ENST00000380151.3	0	153	++	54	P42771-1#28	0	3	ENST00000380151.3	102	105	+	3	0	0	8062
P42771-1#28	0	3	3	P42771-1	102	105	+	3	P42771-1	0	468	ENST00000304494.10	30	498	++	22	P42771-1#28	0	3	ENST00000304494.10	132	135	+	3	0	0	8063
P42771-1#29	0	3	3	P42771-1	141	144	+	3	P42771-1	0	468	ENST00000579122.1	31	425	+	195	P42771-1#29	0	3	ENST00000579122.1	172	175	+	3	0	0	8064
P42771-1#29	0	3	3	P42771-1	141	144	+	3	P42771-1	0	462	ENST00000498124.1	39	501	++	126	P42771-1#29	0	3	ENST00000498124.1	180	183	+	3	0	0	8065
P42771-1#29	0	3	3	P42771-1	141	144	+	3	P42771-1	0	153	ENST00000380151.3	0	153	++	54	P42771-1#29	0	3	ENST00000380151.3	141	144	+	3	0	0	8066
P42771-1#29	0	3	3	P42771-1	141	144	+	3	P42771-1	0	468	ENST00000304494.10	30	498	++	22	P42771-1#29	0	3	ENST00000304494.10	171	174	+	3	0	0	8067
P42771-1#30	0	3	3	P42771-1	144	147	+	3	P42771-1	0	468	ENST00000579122.1	31	425	+	195	P42771-1#30	0	3	ENST00000579122.1	175	178	+	3	0	0	8068
P42771-1#30	0	3	3	P42771-1	144	147	+	3	P42771-1	0	462	ENST00000498124.1	39	501	++	126	P42771-1#30	0	3	ENST00000498124.1	183	186	+	3	0	0	8069
P42771-1#30	0	3	3	P42771-1	144	147	+	3	P42771-1	0	153	ENST00000380151.3	0	153	++	54	P42771-1#30	0	3	ENST00000380151.3	144	147	+	3	0	0	8070
P42771-1#30	0	3	3	P42771-1	144	147	+	3	P42771-1	0	468	ENST00000304494.10	30	498	++	22	P42771-1#30	0	3	ENST00000304494.10	174	177	+	3	0	0	8071
P42771-1#31	0	3	3	P42771-1	144	147	+	3	P42771-1	0	468	ENST00000579122.1	31	425	+	195	P42771-1#31	0	3	ENST00000579122.1	175	178	+	3	0	0	8072
P42771-1#31	0	3	3	P42771-1	144	147	+	3	P42771-1	0	462	ENST00000498124.1	39	501	++	126	P42771-1#31	0	3	ENST00000498124.1	183	186	+	3	0	0	8073
P42771-1#31	0	3	3	P42771-1	144	147	+	3	P42771-1	0	153	ENST00000380151.3	0	153	++	54	P42771-1#31	0	3	ENST00000380151.3	144	147	+	3	0	0	8074
P42771-1#31	0	3	3	P42771-1	144	147	+	3	P42771-1	0	468	ENST00000304494.10	30	498	++	22	P42771-1#31	0	3	ENST00000304494.10	174	177	+	3	0	0	8075
P42771-1#32	0	3	3	P42771-1	147	150	+	3	P42771-1	147	354	ENST00000579755.2	251	458	++	198	P42771-1#32	0	3	ENST00000579755.2	251	254	+	3	0	0	8076
P42771-1#32	0	3	3	P42771-1	147	150	+	3	P42771-1	0	468	ENST00000579122.1	31	425	+	195	P42771-1#32	0	3	ENST00000579122.1	178	181	+	3	0	0	8077
P42771-1#32	0	3	3	P42771-1	147	150	+	3	P42771-1	147	354	ENST00000530628.2	270	477	++	152	P42771-1#32	0	3	ENST00000530628.2	270	273	+	3	0	0	8078
P42771-1#32	0	3	3	P42771-1	147	150	+	3	P42771-1	0	462	ENST00000498124.1	39	501	++	126	P42771-1#32	0	3	ENST00000498124.1	186	189	+	3	0	0	8079
P42771-1#32	0	3	3	P42771-1	147	150	+	3	P42771-1	0	153	ENST00000380151.3	0	153	++	54	P42771-1#32	0	3	ENST00000380151.3	147	150	+	3	0	0	8080
P42771-1#32	0	3	3	P42771-1	147	150	+	3	P42771-1	0	468	ENST00000304494.10	30	498	++	22	P42771-1#32	0	3	ENST00000304494.10	177	180	+	3	0	0	8081
P42771-1#33	0	3	3	P42771-1	156	159	+	3	P42771-1	147	354	ENST00000579755.2	251	458	++	198	P42771-1#33	0	3	ENST00000579755.2	260	263	+	3	0	0	8082
P42771-1#33	0	3	3	P42771-1	156	159	+	3	P42771-1	0	468	ENST00000579122.1	31	425	+	195	P42771-1#33	0	3	ENST00000579122.1	187	190	+	3	0	0	8083
P42771-1#33	0	3	3	P42771-1	156	159	+	3	P42771-1	153	468	ENST00000578845.2	127	442	++	193	P42771-1#33	0	3	ENST00000578845.2	130	133	+	3	0	0	8084
P42771-1#33	0	3	3	P42771-1	156	159	+	3	P42771-1	147	354	ENST00000530628.2	270	477	++	152	P42771-1#33	0	3	ENST00000530628.2	279	282	+	3	0	0	8085
P42771-1#33	0	3	3	P42771-1	156	159	+	3	P42771-1	153	468	ENST00000498628.6	484	799	++	128	P42771-1#33	0	3	ENST00000498628.6	487	490	+	3	0	0	8086
P42771-1#33	0	3	3	P42771-1	156	159	+	3	P42771-1	0	462	ENST00000498124.1	39	501	++	126	P42771-1#33	0	3	ENST00000498124.1	195	198	+	3	0	0	8087
P42771-1#33	0	3	3	P42771-1	156	159	+	3	P42771-1	153	457	ENST00000497750.1	75	379	+	125	P42771-1#33	0	3	ENST00000497750.1	78	81	+	3	0	0	8088
P42771-1#33	0	3	3	P42771-1	156	159	+	3	P42771-1	153	468	ENST00000494262.5	624	939	++	120	P42771-1#33	0	3	ENST00000494262.5	627	630	+	3	0	0	8089
P42771-1#33	0	3	3	P42771-1	156	159	+	3	P42771-1	153	457	ENST00000479692.2	15	319	+	114	P42771-1#33	0	3	ENST00000479692.2	18	21	+	3	0	0	8090
P42771-1#33	0	3	3	P42771-1	156	159	+	3	P42771-1	0	468	ENST00000304494.10	30	498	++	22	P42771-1#33	0	3	ENST00000304494.10	186	189	+	3	0	0	8091
P42771-1#34	0	3	3	P42771-1	165	168	+	3	P42771-1	147	354	ENST00000579755.2	251	458	++	198	P42771-1#34	0	3	ENST00000579755.2	269	272	+	3	0	0	8092
P42771-1#34	0	3	3	P42771-1	165	168	+	3	P42771-1	0	468	ENST00000579122.1	31	425	+	195	P42771-1#34	0	3	ENST00000579122.1	196	199	+	3	0	0	8093
P42771-1#34	0	3	3	P42771-1	165	168	+	3	P42771-1	153	468	ENST00000578845.2	127	442	++	193	P42771-1#34	0	3	ENST00000578845.2	139	142	+	3	0	0	8094
P42771-1#34	0	3	3	P42771-1	165	168	+	3	P42771-1	147	354	ENST00000530628.2	270	477	++	152	P42771-1#34	0	3	ENST00000530628.2	288	291	+	3	0	0	8095
P42771-1#34	0	3	3	P42771-1	165	168	+	3	P42771-1	153	468	ENST00000498628.6	484	799	++	128	P42771-1#34	0	3	ENST00000498628.6	496	499	+	3	0	0	8096
P42771-1#34	0	3	3	P42771-1	165	168	+	3	P42771-1	0	462	ENST00000498124.1	39	501	++	126	P42771-1#34	0	3	ENST00000498124.1	204	207	+	3	0	0	8097
P42771-1#34	0	3	3	P42771-1	165	168	+	3	P42771-1	153	457	ENST00000497750.1	75	379	+	125	P42771-1#34	0	3	ENST00000497750.1	87	90	+	3	0	0	8098
P42771-1#34	0	3	3	P42771-1	165	168	+	3	P42771-1	153	468	ENST00000494262.5	624	939	++	120	P42771-1#34	0	3	ENST00000494262.5	636	639	+	3	0	0	8099
P42771-1#34	0	3	3	P42771-1	165	168	+	3	P42771-1	153	457	ENST00000479692.2	15	319	+	114	P42771-1#34	0	3	ENST00000479692.2	27	30	+	3	0	0	8100
P42771-1#34	0	3	3	P42771-1	165	168	+	3	P42771-1	0	468	ENST00000304494.10	30	498	++	22	P42771-1#34	0	3	ENST00000304494.10	195	198	+	3	0	0	8101
P42771-1#35	0	3	3	P42771-1	168	171	+	3	P42771-1	147	354	ENST00000579755.2	251	458	++	198	P42771-1#35	0	3	ENST00000579755.2	272	275	+	3	0	0	8102
P42771-1#35	0	3	3	P42771-1	168	171	+	3	P42771-1	0	468	ENST00000579122.1	31	425	+	195	P42771-1#35	0	3	ENST00000579122.1	199	202	+	3	0	0	8103
P42771-1#35	0	3	3	P42771-1	168	171	+	3	P42771-1	153	468	ENST00000578845.2	127	442	++	193	P42771-1#35	0	3	ENST00000578845.2	142	145	+	3	0	0	8104
P42771-1#35	0	3	3	P42771-1	168	171	+	3	P42771-1	147	354	ENST00000530628.2	270	477	++	152	P42771-1#35	0	3	ENST00000530628.2	291	294	+	3	0	0	8105
P42771-1#35	0	3	3	P42771-1	168	171	+	3	P42771-1	153	468	ENST00000498628.6	484	799	++	128	P42771-1#35	0	3	ENST00000498628.6	499	502	+	3	0	0	8106
P42771-1#35	0	3	3	P42771-1	168	171	+	3	P42771-1	0	462	ENST00000498124.1	39	501	++	126	P42771-1#35	0	3	ENST00000498124.1	207	210	+	3	0	0	8107
P42771-1#35	0	3	3	P42771-1	168	171	+	3	P42771-1	153	457	ENST00000497750.1	75	379	+	125	P42771-1#35	0	3	ENST00000497750.1	90	93	+	3	0	0	8108
P42771-1#35	0	3	3	P42771-1	168	171	+	3	P42771-1	153	468	ENST00000494262.5	624	939	++	120	P42771-1#35	0	3	ENST00000494262.5	639	642	+	3	0	0	8109
P42771-1#35	0	3	3	P42771-1	168	171	+	3	P42771-1	153	457	ENST00000479692.2	15	319	+	114	P42771-1#35	0	3	ENST00000479692.2	30	33	+	3	0	0	8110
P42771-1#35	0	3	3	P42771-1	168	171	+	3	P42771-1	0	468	ENST00000304494.10	30	498	++	22	P42771-1#35	0	3	ENST00000304494.10	198	201	+	3	0	0	8111
P42771-1#36	0	3	3	P42771-1	174	177	+	3	P42771-1	147	354	ENST00000579755.2	251	458	++	198	P42771-1#36	0	3	ENST00000579755.2	278	281	+	3	0	0	8112
P42771-1#36	0	3	3	P42771-1	174	177	+	3	P42771-1	0	468	ENST00000579122.1	31	425	+	195	P42771-1#36	0	3	ENST00000579122.1	205	208	+	3	0	0	8113
P42771-1#36	0	3	3	P42771-1	174	177	+	3	P42771-1	153	468	ENST00000578845.2	127	442	++	193	P42771-1#36	0	3	ENST00000578845.2	148	151	+	3	0	0	8114
P42771-1#36	0	3	3	P42771-1	174	177	+	3	P42771-1	147	354	ENST00000530628.2	270	477	++	152	P42771-1#36	0	3	ENST00000530628.2	297	300	+	3	0	0	8115
P42771-1#36	0	3	3	P42771-1	174	177	+	3	P42771-1	153	468	ENST00000498628.6	484	799	++	128	P42771-1#36	0	3	ENST00000498628.6	505	508	+	3	0	0	8116
P42771-1#36	0	3	3	P42771-1	174	177	+	3	P42771-1	0	462	ENST00000498124.1	39	501	++	126	P42771-1#36	0	3	ENST00000498124.1	213	216	+	3	0	0	8117
P42771-1#36	0	3	3	P42771-1	174	177	+	3	P42771-1	153	457	ENST00000497750.1	75	379	+	125	P42771-1#36	0	3	ENST00000497750.1	96	99	+	3	0	0	8118
P42771-1#36	0	3	3	P42771-1	174	177	+	3	P42771-1	153	468	ENST00000494262.5	624	939	++	120	P42771-1#36	0	3	ENST00000494262.5	645	648	+	3	0	0	8119
P42771-1#36	0	3	3	P42771-1	174	177	+	3	P42771-1	153	457	ENST00000479692.2	15	319	+	114	P42771-1#36	0	3	ENST00000479692.2	36	39	+	3	0	0	8120
P42771-1#36	0	3	3	P42771-1	174	177	+	3	P42771-1	0	468	ENST00000304494.10	30	498	++	22	P42771-1#36	0	3	ENST00000304494.10	204	207	+	3	0	0	8121
P42771-1#37	0	3	3	P42771-1	177	180	+	3	P42771-1	147	354	ENST00000579755.2	251	458	++	198	P42771-1#37	0	3	ENST00000579755.2	281	284	+	3	0	0	8122
P42771-1#37	0	3	3	P42771-1	177	180	+	3	P42771-1	0	468	ENST00000579122.1	31	425	+	195	P42771-1#37	0	3	ENST00000579122.1	208	211	+	3	0	0	8123
P42771-1#37	0	3	3	P42771-1	177	180	+	3	P42771-1	153	468	ENST00000578845.2	127	442	++	193	P42771-1#37	0	3	ENST00000578845.2	151	154	+	3	0	0	8124
P42771-1#37	0	3	3	P42771-1	177	180	+	3	P42771-1	147	354	ENST00000530628.2	270	477	++	152	P42771-1#37	0	3	ENST00000530628.2	300	303	+	3	0	0	8125
P42771-1#37	0	3	3	P42771-1	177	180	+	3	P42771-1	153	468	ENST00000498628.6	484	799	++	128	P42771-1#37	0	3	ENST00000498628.6	508	511	+	3	0	0	8126
P42771-1#37	0	3	3	P42771-1	177	180	+	3	P42771-1	0	462	ENST00000498124.1	39	501	++	126	P42771-1#37	0	3	ENST00000498124.1	216	219	+	3	0	0	8127
P42771-1#37	0	3	3	P42771-1	177	180	+	3	P42771-1	153	457	ENST00000497750.1	75	379	+	125	P42771-1#37	0	3	ENST00000497750.1	99	102	+	3	0	0	8128
P42771-1#37	0	3	3	P42771-1	177	180	+	3	P42771-1	153	468	ENST00000494262.5	624	939	++	120	P42771-1#37	0	3	ENST00000494262.5	648	651	+	3	0	0	8129
P42771-1#37	0	3	3	P42771-1	177	180	+	3	P42771-1	153	457	ENST00000479692.2	15	319	+	114	P42771-1#37	0	3	ENST00000479692.2	39	42	+	3	0	0	8130
P42771-1#37	0	3	3	P42771-1	177	180	+	3	P42771-1	0	468	ENST00000304494.10	30	498	++	22	P42771-1#37	0	3	ENST00000304494.10	207	210	+	3	0	0	8131
P42771-1#38	0	3	3	P42771-1	177	180	+	3	P42771-1	147	354	ENST00000579755.2	251	458	++	198	P42771-1#38	0	3	ENST00000579755.2	281	284	+	3	0	0	8132
P42771-1#38	0	3	3	P42771-1	177	180	+	3	P42771-1	0	468	ENST00000579122.1	31	425	+	195	P42771-1#38	0	3	ENST00000579122.1	208	211	+	3	0	0	8133
P42771-1#38	0	3	3	P42771-1	177	180	+	3	P42771-1	153	468	ENST00000578845.2	127	442	++	193	P42771-1#38	0	3	ENST00000578845.2	151	154	+	3	0	0	8134
P42771-1#38	0	3	3	P42771-1	177	180	+	3	P42771-1	147	354	ENST00000530628.2	270	477	++	152	P42771-1#38	0	3	ENST00000530628.2	300	303	+	3	0	0	8135
P42771-1#38	0	3	3	P42771-1	177	180	+	3	P42771-1	153	468	ENST00000498628.6	484	799	++	128	P42771-1#38	0	3	ENST00000498628.6	508	511	+	3	0	0	8136
P42771-1#38	0	3	3	P42771-1	177	180	+	3	P42771-1	0	462	ENST00000498124.1	39	501	++	126	P42771-1#38	0	3	ENST00000498124.1	216	219	+	3	0	0	8137
P42771-1#38	0	3	3	P42771-1	177	180	+	3	P42771-1	153	457	ENST00000497750.1	75	379	+	125	P42771-1#38	0	3	ENST00000497750.1	99	102	+	3	0	0	8138
P42771-1#38	0	3	3	P42771-1	177	180	+	3	P42771-1	153	468	ENST00000494262.5	624	939	++	120	P42771-1#38	0	3	ENST00000494262.5	648	651	+	3	0	0	8139
P42771-1#38	0	3	3	P42771-1	177	180	+	3	P42771-1	153	457	ENST00000479692.2	15	319	+	114	P42771-1#38	0	3	ENST00000479692.2	39	42	+	3	0	0	8140
P42771-1#38	0	3	3	P42771-1	177	180	+	3	P42771-1	0	468	ENST00000304494.10	30	498	++	22	P42771-1#38	0	3	ENST00000304494.10	207	210	+	3	0	0	8141
P42771-1#39	0	6	6	P42771-1	180	186	+	6	P42771-1	147	354	ENST00000579755.2	251	458	++	198	P42771-1#39	0	6	ENST00000579755.2	284	290	+	6	0	0	8142
P42771-1#39	0	6	6	P42771-1	180	186	+	6	P42771-1	0	468	ENST00000579122.1	31	425	+	195	P42771-1#39	0	6	ENST00000579122.1	211	217	+	6	0	0	8143
P42771-1#39	0	6	6	P42771-1	180	186	+	6	P42771-1	153	468	ENST00000578845.2	127	442	++	193	P42771-1#39	0	6	ENST00000578845.2	154	160	+	6	0	0	8144
P42771-1#39	0	6	6	P42771-1	180	186	+	6	P42771-1	147	354	ENST00000530628.2	270	477	++	152	P42771-1#39	0	6	ENST00000530628.2	303	309	+	6	0	0	8145
P42771-1#39	0	6	6	P42771-1	180	186	+	6	P42771-1	153	468	ENST00000498628.6	484	799	++	128	P42771-1#39	0	6	ENST00000498628.6	511	517	+	6	0	0	8146
P42771-1#39	0	6	6	P42771-1	180	186	+	6	P42771-1	0	462	ENST00000498124.1	39	501	++	126	P42771-1#39	0	6	ENST00000498124.1	219	225	+	6	0	0	8147
P42771-1#39	0	6	6	P42771-1	180	186	+	6	P42771-1	153	457	ENST00000497750.1	75	379	+	125	P42771-1#39	0	6	ENST00000497750.1	102	108	+	6	0	0	8148
P42771-1#39	0	6	6	P42771-1	180	186	+	6	P42771-1	153	468	ENST00000494262.5	624	939	++	120	P42771-1#39	0	6	ENST00000494262.5	651	657	+	6	0	0	8149
P42771-1#39	0	6	6	P42771-1	180	186	+	6	P42771-1	153	457	ENST00000479692.2	15	319	+	114	P42771-1#39	0	6	ENST00000479692.2	42	48	+	6	0	0	8150
P42771-1#39	0	6	6	P42771-1	180	186	+	6	P42771-1	0	468	ENST00000304494.10	30	498	++	22	P42771-1#39	0	6	ENST00000304494.10	210	216	+	6	0	0	8151
P42771-1#40	0	3	3	P42771-1	183	186	+	3	P42771-1	147	354	ENST00000579755.2	251	458	++	198	P42771-1#40	0	3	ENST00000579755.2	287	290	+	3	0	0	8152
P42771-1#40	0	3	3	P42771-1	183	186	+	3	P42771-1	0	468	ENST00000579122.1	31	425	+	195	P42771-1#40	0	3	ENST00000579122.1	214	217	+	3	0	0	8153
P42771-1#40	0	3	3	P42771-1	183	186	+	3	P42771-1	153	468	ENST00000578845.2	127	442	++	193	P42771-1#40	0	3	ENST00000578845.2	157	160	+	3	0	0	8154
P42771-1#40	0	3	3	P42771-1	183	186	+	3	P42771-1	147	354	ENST00000530628.2	270	477	++	152	P42771-1#40	0	3	ENST00000530628.2	306	309	+	3	0	0	8155
P42771-1#40	0	3	3	P42771-1	183	186	+	3	P42771-1	153	468	ENST00000498628.6	484	799	++	128	P42771-1#40	0	3	ENST00000498628.6	514	517	+	3	0	0	8156
P42771-1#40	0	3	3	P42771-1	183	186	+	3	P42771-1	0	462	ENST00000498124.1	39	501	++	126	P42771-1#40	0	3	ENST00000498124.1	222	225	+	3	0	0	8157
P42771-1#40	0	3	3	P42771-1	183	186	+	3	P42771-1	153	457	ENST00000497750.1	75	379	+	125	P42771-1#40	0	3	ENST00000497750.1	105	108	+	3	0	0	8158
P42771-1#40	0	3	3	P42771-1	183	186	+	3	P42771-1	153	468	ENST00000494262.5	624	939	++	120	P42771-1#40	0	3	ENST00000494262.5	654	657	+	3	0	0	8159
P42771-1#40	0	3	3	P42771-1	183	186	+	3	P42771-1	153	457	ENST00000479692.2	15	319	+	114	P42771-1#40	0	3	ENST00000479692.2	45	48	+	3	0	0	8160
P42771-1#40	0	3	3	P42771-1	183	186	+	3	P42771-1	0	468	ENST00000304494.10	30	498	++	22	P42771-1#40	0	3	ENST00000304494.10	213	216	+	3	0	0	8161
P42771-1#41	0	3	3	P42771-1	195	198	+	3	P42771-1	147	354	ENST00000579755.2	251	458	++	198	P42771-1#41	0	3	ENST00000579755.2	299	302	+	3	0	0	8162
P42771-1#41	0	3	3	P42771-1	195	198	+	3	P42771-1	0	468	ENST00000579122.1	31	425	+	195	P42771-1#41	0	3	ENST00000579122.1	226	229	+	3	0	0	8163
P42771-1#41	0	3	3	P42771-1	195	198	+	3	P42771-1	153	468	ENST00000578845.2	127	442	++	193	P42771-1#41	0	3	ENST00000578845.2	169	172	+	3	0	0	8164
P42771-1#41	0	3	3	P42771-1	195	198	+	3	P42771-1	147	354	ENST00000530628.2	270	477	++	152	P42771-1#41	0	3	ENST00000530628.2	318	321	+	3	0	0	8165
P42771-1#41	0	3	3	P42771-1	195	198	+	3	P42771-1	153	468	ENST00000498628.6	484	799	++	128	P42771-1#41	0	3	ENST00000498628.6	526	529	+	3	0	0	8166
P42771-1#41	0	3	3	P42771-1	195	198	+	3	P42771-1	0	462	ENST00000498124.1	39	501	++	126	P42771-1#41	0	3	ENST00000498124.1	234	237	+	3	0	0	8167
P42771-1#41	0	3	3	P42771-1	195	198	+	3	P42771-1	153	457	ENST00000497750.1	75	379	+	125	P42771-1#41	0	3	ENST00000497750.1	117	120	+	3	0	0	8168
P42771-1#41	0	3	3	P42771-1	195	198	+	3	P42771-1	153	468	ENST00000494262.5	624	939	++	120	P42771-1#41	0	3	ENST00000494262.5	666	669	+	3	0	0	8169
P42771-1#41	0	3	3	P42771-1	195	198	+	3	P42771-1	153	457	ENST00000479692.2	15	319	+	114	P42771-1#41	0	3	ENST00000479692.2	57	60	+	3	0	0	8170
P42771-1#41	0	3	3	P42771-1	195	198	+	3	P42771-1	0	468	ENST00000304494.10	30	498	++	22	P42771-1#41	0	3	ENST00000304494.10	225	228	+	3	0	0	8171
P42771-1#42	0	15	15	P42771-1	198	213	+	15	P42771-1	147	354	ENST00000579755.2	251	458	++	198	P42771-1#42	0	15	ENST00000579755.2	302	317	+	15	0	0	8172
P42771-1#42	0	15	15	P42771-1	198	213	+	15	P42771-1	0	468	ENST00000579122.1	31	425	+	195	P42771-1#42	0	15	ENST00000579122.1	229	244	+	15	0	0	8173
P42771-1#42	0	15	15	P42771-1	198	213	+	15	P42771-1	153	468	ENST00000578845.2	127	442	++	193	P42771-1#42	0	15	ENST00000578845.2	172	187	+	15	0	0	8174
P42771-1#42	0	15	15	P42771-1	198	213	+	15	P42771-1	147	354	ENST00000530628.2	270	477	++	152	P42771-1#42	0	15	ENST00000530628.2	321	336	+	15	0	0	8175
P42771-1#42	0	15	15	P42771-1	198	213	+	15	P42771-1	153	468	ENST00000498628.6	484	799	++	128	P42771-1#42	0	15	ENST00000498628.6	529	544	+	15	0	0	8176
P42771-1#42	0	15	15	P42771-1	198	213	+	15	P42771-1	0	462	ENST00000498124.1	39	501	++	126	P42771-1#42	0	15	ENST00000498124.1	237	252	+	15	0	0	8177
P42771-1#42	0	15	15	P42771-1	198	213	+	15	P42771-1	153	457	ENST00000497750.1	75	379	+	125	P42771-1#42	0	15	ENST00000497750.1	120	135	+	15	0	0	8178
P42771-1#42	0	15	15	P42771-1	198	213	+	15	P42771-1	153	468	ENST00000494262.5	624	939	++	120	P42771-1#42	0	15	ENST00000494262.5	669	684	+	15	0	0	8179
P42771-1#42	0	15	15	P42771-1	198	213	+	15	P42771-1	153	457	ENST00000479692.2	15	319	+	114	P42771-1#42	0	15	ENST00000479692.2	60	75	+	15	0	0	8180
P42771-1#42	0	15	15	P42771-1	198	213	+	15	P42771-1	0	468	ENST00000304494.10	30	498	++	22	P42771-1#42	0	15	ENST00000304494.10	228	243	+	15	0	0	8181
P42771-1#43	0	3	3	P42771-1	198	201	+	3	P42771-1	147	354	ENST00000579755.2	251	458	++	198	P42771-1#43	0	3	ENST00000579755.2	302	305	+	3	0	0	8182
P42771-1#43	0	3	3	P42771-1	198	201	+	3	P42771-1	0	468	ENST00000579122.1	31	425	+	195	P42771-1#43	0	3	ENST00000579122.1	229	232	+	3	0	0	8183
P42771-1#43	0	3	3	P42771-1	198	201	+	3	P42771-1	153	468	ENST00000578845.2	127	442	++	193	P42771-1#43	0	3	ENST00000578845.2	172	175	+	3	0	0	8184
P42771-1#43	0	3	3	P42771-1	198	201	+	3	P42771-1	147	354	ENST00000530628.2	270	477	++	152	P42771-1#43	0	3	ENST00000530628.2	321	324	+	3	0	0	8185
P42771-1#43	0	3	3	P42771-1	198	201	+	3	P42771-1	153	468	ENST00000498628.6	484	799	++	128	P42771-1#43	0	3	ENST00000498628.6	529	532	+	3	0	0	8186
P42771-1#43	0	3	3	P42771-1	198	201	+	3	P42771-1	0	462	ENST00000498124.1	39	501	++	126	P42771-1#43	0	3	ENST00000498124.1	237	240	+	3	0	0	8187
P42771-1#43	0	3	3	P42771-1	198	201	+	3	P42771-1	153	457	ENST00000497750.1	75	379	+	125	P42771-1#43	0	3	ENST00000497750.1	120	123	+	3	0	0	8188
P42771-1#43	0	3	3	P42771-1	198	201	+	3	P42771-1	153	468	ENST00000494262.5	624	939	++	120	P42771-1#43	0	3	ENST00000494262.5	669	672	+	3	0	0	8189
P42771-1#43	0	3	3	P42771-1	198	201	+	3	P42771-1	153	457	ENST00000479692.2	15	319	+	114	P42771-1#43	0	3	ENST00000479692.2	60	63	+	3	0	0	8190
P42771-1#43	0	3	3	P42771-1	198	201	+	3	P42771-1	0	468	ENST00000304494.10	30	498	++	22	P42771-1#43	0	3	ENST00000304494.10	228	231	+	3	0	0	8191
P42771-1#44	0	3	3	P42771-1	201	204	+	3	P42771-1	147	354	ENST00000579755.2	251	458	++	198	P42771-1#44	0	3	ENST00000579755.2	305	308	+	3	0	0	8192
P42771-1#44	0	3	3	P42771-1	201	204	+	3	P42771-1	0	468	ENST00000579122.1	31	425	+	195	P42771-1#44	0	3	ENST00000579122.1	232	235	+	3	0	0	8193
P42771-1#44	0	3	3	P42771-1	201	204	+	3	P42771-1	153	468	ENST00000578845.2	127	442	++	193	P42771-1#44	0	3	ENST00000578845.2	175	178	+	3	0	0	8194
P42771-1#44	0	3	3	P42771-1	201	204	+	3	P42771-1	147	354	ENST00000530628.2	270	477	++	152	P42771-1#44	0	3	ENST00000530628.2	324	327	+	3	0	0	8195
P42771-1#44	0	3	3	P42771-1	201	204	+	3	P42771-1	153	468	ENST00000498628.6	484	799	++	128	P42771-1#44	0	3	ENST00000498628.6	532	535	+	3	0	0	8196
P42771-1#44	0	3	3	P42771-1	201	204	+	3	P42771-1	0	462	ENST00000498124.1	39	501	++	126	P42771-1#44	0	3	ENST00000498124.1	240	243	+	3	0	0	8197
P42771-1#44	0	3	3	P42771-1	201	204	+	3	P42771-1	153	457	ENST00000497750.1	75	379	+	125	P42771-1#44	0	3	ENST00000497750.1	123	126	+	3	0	0	8198
P42771-1#44	0	3	3	P42771-1	201	204	+	3	P42771-1	153	468	ENST00000494262.5	624	939	++	120	P42771-1#44	0	3	ENST00000494262.5	672	675	+	3	0	0	8199
P42771-1#44	0	3	3	P42771-1	201	204	+	3	P42771-1	153	457	ENST00000479692.2	15	319	+	114	P42771-1#44	0	3	ENST00000479692.2	63	66	+	3	0	0	8200
P42771-1#44	0	3	3	P42771-1	201	204	+	3	P42771-1	0	468	ENST00000304494.10	30	498	++	22	P42771-1#44	0	3	ENST00000304494.10	231	234	+	3	0	0	8201
P42771-1#45	0	3	3	P42771-1	201	204	+	3	P42771-1	147	354	ENST00000579755.2	251	458	++	198	P42771-1#45	0	3	ENST00000579755.2	305	308	+	3	0	0	8202
P42771-1#45	0	3	3	P42771-1	201	204	+	3	P42771-1	0	468	ENST00000579122.1	31	425	+	195	P42771-1#45	0	3	ENST00000579122.1	232	235	+	3	0	0	8203
P42771-1#45	0	3	3	P42771-1	201	204	+	3	P42771-1	153	468	ENST00000578845.2	127	442	++	193	P42771-1#45	0	3	ENST00000578845.2	175	178	+	3	0	0	8204
P42771-1#45	0	3	3	P42771-1	201	204	+	3	P42771-1	147	354	ENST00000530628.2	270	477	++	152	P42771-1#45	0	3	ENST00000530628.2	324	327	+	3	0	0	8205
P42771-1#45	0	3	3	P42771-1	201	204	+	3	P42771-1	153	468	ENST00000498628.6	484	799	++	128	P42771-1#45	0	3	ENST00000498628.6	532	535	+	3	0	0	8206
P42771-1#45	0	3	3	P42771-1	201	204	+	3	P42771-1	0	462	ENST00000498124.1	39	501	++	126	P42771-1#45	0	3	ENST00000498124.1	240	243	+	3	0	0	8207
P42771-1#45	0	3	3	P42771-1	201	204	+	3	P42771-1	153	457	ENST00000497750.1	75	379	+	125	P42771-1#45	0	3	ENST00000497750.1	123	126	+	3	0	0	8208
P42771-1#45	0	3	3	P42771-1	201	204	+	3	P42771-1	153	468	ENST00000494262.5	624	939	++	120	P42771-1#45	0	3	ENST00000494262.5	672	675	+	3	0	0	8209
P42771-1#45	0	3	3	P42771-1	201	204	+	3	P42771-1	153	457	ENST00000479692.2	15	319	+	114	P42771-1#45	0	3	ENST00000479692.2	63	66	+	3	0	0	8210
P42771-1#45	0	3	3	P42771-1	201	204	+	3	P42771-1	0	468	ENST00000304494.10	30	498	++	22	P42771-1#45	0	3	ENST00000304494.10	231	234	+	3	0	0	8211
P42771-1#46	0	3	3	P42771-1	201	204	+	3	P42771-1	147	354	ENST00000579755.2	251	458	++	198	P42771-1#46	0	3	ENST00000579755.2	305	308	+	3	0	0	8212
P42771-1#46	0	3	3	P42771-1	201	204	+	3	P42771-1	0	468	ENST00000579122.1	31	425	+	195	P42771-1#46	0	3	ENST00000579122.1	232	235	+	3	0	0	8213
P42771-1#46	0	3	3	P42771-1	201	204	+	3	P42771-1	153	468	ENST00000578845.2	127	442	++	193	P42771-1#46	0	3	ENST00000578845.2	175	178	+	3	0	0	8214
P42771-1#46	0	3	3	P42771-1	201	204	+	3	P42771-1	147	354	ENST00000530628.2	270	477	++	152	P42771-1#46	0	3	ENST00000530628.2	324	327	+	3	0	0	8215
P42771-1#46	0	3	3	P42771-1	201	204	+	3	P42771-1	153	468	ENST00000498628.6	484	799	++	128	P42771-1#46	0	3	ENST00000498628.6	532	535	+	3	0	0	8216
P42771-1#46	0	3	3	P42771-1	201	204	+	3	P42771-1	0	462	ENST00000498124.1	39	501	++	126	P42771-1#46	0	3	ENST00000498124.1	240	243	+	3	0	0	8217
P42771-1#46	0	3	3	P42771-1	201	204	+	3	P42771-1	153	457	ENST00000497750.1	75	379	+	125	P42771-1#46	0	3	ENST00000497750.1	123	126	+	3	0	0	8218
P42771-1#46	0	3	3	P42771-1	201	204	+	3	P42771-1	153	468	ENST00000494262.5	624	939	++	120	P42771-1#46	0	3	ENST00000494262.5	672	675	+	3	0	0	8219
P42771-1#46	0	3	3	P42771-1	201	204	+	3	P42771-1	153	457	ENST00000479692.2	15	319	+	114	P42771-1#46	0	3	ENST00000479692.2	63	66	+	3	0	0	8220
P42771-1#46	0	3	3	P42771-1	201	204	+	3	P42771-1	0	468	ENST00000304494.10	30	498	++	22	P42771-1#46	0	3	ENST00000304494.10	231	234	+	3	0	0	8221
P42771-1#47	0	3	3	P42771-1	204	207	+	3	P42771-1	147	354	ENST00000579755.2	251	458	++	198	P42771-1#47	0	3	ENST00000579755.2	308	311	+	3	0	0	8222
P42771-1#47	0	3	3	P42771-1	204	207	+	3	P42771-1	0	468	ENST00000579122.1	31	425	+	195	P42771-1#47	0	3	ENST00000579122.1	235	238	+	3	0	0	8223
P42771-1#47	0	3	3	P42771-1	204	207	+	3	P42771-1	153	468	ENST00000578845.2	127	442	++	193	P42771-1#47	0	3	ENST00000578845.2	178	181	+	3	0	0	8224
P42771-1#47	0	3	3	P42771-1	204	207	+	3	P42771-1	147	354	ENST00000530628.2	270	477	++	152	P42771-1#47	0	3	ENST00000530628.2	327	330	+	3	0	0	8225
P42771-1#47	0	3	3	P42771-1	204	207	+	3	P42771-1	153	468	ENST00000498628.6	484	799	++	128	P42771-1#47	0	3	ENST00000498628.6	535	538	+	3	0	0	8226
P42771-1#47	0	3	3	P42771-1	204	207	+	3	P42771-1	0	462	ENST00000498124.1	39	501	++	126	P42771-1#47	0	3	ENST00000498124.1	243	246	+	3	0	0	8227
P42771-1#47	0	3	3	P42771-1	204	207	+	3	P42771-1	153	457	ENST00000497750.1	75	379	+	125	P42771-1#47	0	3	ENST00000497750.1	126	129	+	3	0	0	8228
P42771-1#47	0	3	3	P42771-1	204	207	+	3	P42771-1	153	468	ENST00000494262.5	624	939	++	120	P42771-1#47	0	3	ENST00000494262.5	675	678	+	3	0	0	8229
P42771-1#47	0	3	3	P42771-1	204	207	+	3	P42771-1	153	457	ENST00000479692.2	15	319	+	114	P42771-1#47	0	3	ENST00000479692.2	66	69	+	3	0	0	8230
P42771-1#47	0	3	3	P42771-1	204	207	+	3	P42771-1	0	468	ENST00000304494.10	30	498	++	22	P42771-1#47	0	3	ENST00000304494.10	234	237	+	3	0	0	8231
P42771-1#48	0	3	3	P42771-1	204	207	+	3	P42771-1	147	354	ENST00000579755.2	251	458	++	198	P42771-1#48	0	3	ENST00000579755.2	308	311	+	3	0	0	8232
P42771-1#48	0	3	3	P42771-1	204	207	+	3	P42771-1	0	468	ENST00000579122.1	31	425	+	195	P42771-1#48	0	3	ENST00000579122.1	235	238	+	3	0	0	8233
P42771-1#48	0	3	3	P42771-1	204	207	+	3	P42771-1	153	468	ENST00000578845.2	127	442	++	193	P42771-1#48	0	3	ENST00000578845.2	178	181	+	3	0	0	8234
P42771-1#48	0	3	3	P42771-1	204	207	+	3	P42771-1	147	354	ENST00000530628.2	270	477	++	152	P42771-1#48	0	3	ENST00000530628.2	327	330	+	3	0	0	8235
P42771-1#48	0	3	3	P42771-1	204	207	+	3	P42771-1	153	468	ENST00000498628.6	484	799	++	128	P42771-1#48	0	3	ENST00000498628.6	535	538	+	3	0	0	8236
P42771-1#48	0	3	3	P42771-1	204	207	+	3	P42771-1	0	462	ENST00000498124.1	39	501	++	126	P42771-1#48	0	3	ENST00000498124.1	243	246	+	3	0	0	8237
P42771-1#48	0	3	3	P42771-1	204	207	+	3	P42771-1	153	457	ENST00000497750.1	75	379	+	125	P42771-1#48	0	3	ENST00000497750.1	126	129	+	3	0	0	8238
P42771-1#48	0	3	3	P42771-1	204	207	+	3	P42771-1	153	468	ENST00000494262.5	624	939	++	120	P42771-1#48	0	3	ENST00000494262.5	675	678	+	3	0	0	8239
P42771-1#48	0	3	3	P42771-1	204	207	+	3	P42771-1	153	457	ENST00000479692.2	15	319	+	114	P42771-1#48	0	3	ENST00000479692.2	66	69	+	3	0	0	8240
P42771-1#48	0	3	3	P42771-1	204	207	+	3	P42771-1	0	468	ENST00000304494.10	30	498	++	22	P42771-1#48	0	3	ENST00000304494.10	234	237	+	3	0	0	8241
P42771-1#49	0	3	3	P42771-1	204	207	+	3	P42771-1	147	354	ENST00000579755.2	251	458	++	198	P42771-1#49	0	3	ENST00000579755.2	308	311	+	3	0	0	8242
P42771-1#49	0	3	3	P42771-1	204	207	+	3	P42771-1	0	468	ENST00000579122.1	31	425	+	195	P42771-1#49	0	3	ENST00000579122.1	235	238	+	3	0	0	8243
P42771-1#49	0	3	3	P42771-1	204	207	+	3	P42771-1	153	468	ENST00000578845.2	127	442	++	193	P42771-1#49	0	3	ENST00000578845.2	178	181	+	3	0	0	8244
P42771-1#49	0	3	3	P42771-1	204	207	+	3	P42771-1	147	354	ENST00000530628.2	270	477	++	152	P42771-1#49	0	3	ENST00000530628.2	327	330	+	3	0	0	8245
P42771-1#49	0	3	3	P42771-1	204	207	+	3	P42771-1	153	468	ENST00000498628.6	484	799	++	128	P42771-1#49	0	3	ENST00000498628.6	535	538	+	3	0	0	8246
P42771-1#49	0	3	3	P42771-1	204	207	+	3	P42771-1	0	462	ENST00000498124.1	39	501	++	126	P42771-1#49	0	3	ENST00000498124.1	243	246	+	3	0	0	8247
P42771-1#49	0	3	3	P42771-1	204	207	+	3	P42771-1	153	457	ENST00000497750.1	75	379	+	125	P42771-1#49	0	3	ENST00000497750.1	126	129	+	3	0	0	8248
P42771-1#49	0	3	3	P42771-1	204	207	+	3	P42771-1	153	468	ENST00000494262.5	624	939	++	120	P42771-1#49	0	3	ENST00000494262.5	675	678	+	3	0	0	8249
P42771-1#49	0	3	3	P42771-1	204	207	+	3	P42771-1	153	457	ENST00000479692.2	15	319	+	114	P42771-1#49	0	3	ENST00000479692.2	66	69	+	3	0	0	8250
P42771-1#49	0	3	3	P42771-1	204	207	+	3	P42771-1	0	468	ENST00000304494.10	30	498	++	22	P42771-1#49	0	3	ENST00000304494.10	234	237	+	3	0	0	8251
P42771-1#50	0	3	3	P42771-1	210	213	+	3	P42771-1	147	354	ENST00000579755.2	251	458	++	198	P42771-1#50	0	3	ENST00000579755.2	314	317	+	3	0	0	8252
P42771-1#50	0	3	3	P42771-1	210	213	+	3	P42771-1	0	468	ENST00000579122.1	31	425	+	195	P42771-1#50	0	3	ENST00000579122.1	241	244	+	3	0	0	8253
P42771-1#50	0	3	3	P42771-1	210	213	+	3	P42771-1	153	468	ENST00000578845.2	127	442	++	193	P42771-1#50	0	3	ENST00000578845.2	184	187	+	3	0	0	8254
P42771-1#50	0	3	3	P42771-1	210	213	+	3	P42771-1	147	354	ENST00000530628.2	270	477	++	152	P42771-1#50	0	3	ENST00000530628.2	333	336	+	3	0	0	8255
P42771-1#50	0	3	3	P42771-1	210	213	+	3	P42771-1	153	468	ENST00000498628.6	484	799	++	128	P42771-1#50	0	3	ENST00000498628.6	541	544	+	3	0	0	8256
P42771-1#50	0	3	3	P42771-1	210	213	+	3	P42771-1	0	462	ENST00000498124.1	39	501	++	126	P42771-1#50	0	3	ENST00000498124.1	249	252	+	3	0	0	8257
P42771-1#50	0	3	3	P42771-1	210	213	+	3	P42771-1	153	457	ENST00000497750.1	75	379	+	125	P42771-1#50	0	3	ENST00000497750.1	132	135	+	3	0	0	8258
P42771-1#50	0	3	3	P42771-1	210	213	+	3	P42771-1	153	468	ENST00000494262.5	624	939	++	120	P42771-1#50	0	3	ENST00000494262.5	681	684	+	3	0	0	8259
P42771-1#50	0	3	3	P42771-1	210	213	+	3	P42771-1	153	457	ENST00000479692.2	15	319	+	114	P42771-1#50	0	3	ENST00000479692.2	72	75	+	3	0	0	8260
P42771-1#50	0	3	3	P42771-1	210	213	+	3	P42771-1	0	468	ENST00000304494.10	30	498	++	22	P42771-1#50	0	3	ENST00000304494.10	240	243	+	3	0	0	8261
P42771-1#51	0	3	3	P42771-1	210	213	+	3	P42771-1	147	354	ENST00000579755.2	251	458	++	198	P42771-1#51	0	3	ENST00000579755.2	314	317	+	3	0	0	8262
P42771-1#51	0	3	3	P42771-1	210	213	+	3	P42771-1	0	468	ENST00000579122.1	31	425	+	195	P42771-1#51	0	3	ENST00000579122.1	241	244	+	3	0	0	8263
P42771-1#51	0	3	3	P42771-1	210	213	+	3	P42771-1	153	468	ENST00000578845.2	127	442	++	193	P42771-1#51	0	3	ENST00000578845.2	184	187	+	3	0	0	8264
P42771-1#51	0	3	3	P42771-1	210	213	+	3	P42771-1	147	354	ENST00000530628.2	270	477	++	152	P42771-1#51	0	3	ENST00000530628.2	333	336	+	3	0	0	8265
P42771-1#51	0	3	3	P42771-1	210	213	+	3	P42771-1	153	468	ENST00000498628.6	484	799	++	128	P42771-1#51	0	3	ENST00000498628.6	541	544	+	3	0	0	8266
P42771-1#51	0	3	3	P42771-1	210	213	+	3	P42771-1	0	462	ENST00000498124.1	39	501	++	126	P42771-1#51	0	3	ENST00000498124.1	249	252	+	3	0	0	8267
P42771-1#51	0	3	3	P42771-1	210	213	+	3	P42771-1	153	457	ENST00000497750.1	75	379	+	125	P42771-1#51	0	3	ENST00000497750.1	132	135	+	3	0	0	8268
P42771-1#51	0	3	3	P42771-1	210	213	+	3	P42771-1	153	468	ENST00000494262.5	624	939	++	120	P42771-1#51	0	3	ENST00000494262.5	681	684	+	3	0	0	8269
P42771-1#51	0	3	3	P42771-1	210	213	+	3	P42771-1	153	457	ENST00000479692.2	15	319	+	114	P42771-1#51	0	3	ENST00000479692.2	72	75	+	3	0	0	8270
P42771-1#51	0	3	3	P42771-1	210	213	+	3	P42771-1	0	468	ENST00000304494.10	30	498	++	22	P42771-1#51	0	3	ENST00000304494.10	240	243	+	3	0	0	8271
P42771-1#52	0	3	3	P42771-1	213	216	+	3	P42771-1	147	354	ENST00000579755.2	251	458	++	198	P42771-1#52	0	3	ENST00000579755.2	317	320	+	3	0	0	8272
P42771-1#52	0	3	3	P42771-1	213	216	+	3	P42771-1	0	468	ENST00000579122.1	31	425	+	195	P42771-1#52	0	3	ENST00000579122.1	244	247	+	3	0	0	8273
P42771-1#52	0	3	3	P42771-1	213	216	+	3	P42771-1	153	468	ENST00000578845.2	127	442	++	193	P42771-1#52	0	3	ENST00000578845.2	187	190	+	3	0	0	8274
P42771-1#52	0	3	3	P42771-1	213	216	+	3	P42771-1	147	354	ENST00000530628.2	270	477	++	152	P42771-1#52	0	3	ENST00000530628.2	336	339	+	3	0	0	8275
P42771-1#52	0	3	3	P42771-1	213	216	+	3	P42771-1	153	468	ENST00000498628.6	484	799	++	128	P42771-1#52	0	3	ENST00000498628.6	544	547	+	3	0	0	8276
P42771-1#52	0	3	3	P42771-1	213	216	+	3	P42771-1	0	462	ENST00000498124.1	39	501	++	126	P42771-1#52	0	3	ENST00000498124.1	252	255	+	3	0	0	8277
P42771-1#52	0	3	3	P42771-1	213	216	+	3	P42771-1	153	457	ENST00000497750.1	75	379	+	125	P42771-1#52	0	3	ENST00000497750.1	135	138	+	3	0	0	8278
P42771-1#52	0	3	3	P42771-1	213	216	+	3	P42771-1	153	468	ENST00000494262.5	624	939	++	120	P42771-1#52	0	3	ENST00000494262.5	684	687	+	3	0	0	8279
P42771-1#52	0	3	3	P42771-1	213	216	+	3	P42771-1	153	457	ENST00000479692.2	15	319	+	114	P42771-1#52	0	3	ENST00000479692.2	75	78	+	3	0	0	8280
P42771-1#52	0	3	3	P42771-1	213	216	+	3	P42771-1	0	468	ENST00000304494.10	30	498	++	22	P42771-1#52	0	3	ENST00000304494.10	243	246	+	3	0	0	8281
P42771-1#53	0	3	3	P42771-1	219	222	+	3	P42771-1	147	354	ENST00000579755.2	251	458	++	198	P42771-1#53	0	3	ENST00000579755.2	323	326	+	3	0	0	8282
P42771-1#53	0	3	3	P42771-1	219	222	+	3	P42771-1	0	468	ENST00000579122.1	31	425	+	195	P42771-1#53	0	3	ENST00000579122.1	250	253	+	3	0	0	8283
P42771-1#53	0	3	3	P42771-1	219	222	+	3	P42771-1	153	468	ENST00000578845.2	127	442	++	193	P42771-1#53	0	3	ENST00000578845.2	193	196	+	3	0	0	8284
P42771-1#53	0	3	3	P42771-1	219	222	+	3	P42771-1	147	354	ENST00000530628.2	270	477	++	152	P42771-1#53	0	3	ENST00000530628.2	342	345	+	3	0	0	8285
P42771-1#53	0	3	3	P42771-1	219	222	+	3	P42771-1	153	468	ENST00000498628.6	484	799	++	128	P42771-1#53	0	3	ENST00000498628.6	550	553	+	3	0	0	8286
P42771-1#53	0	3	3	P42771-1	219	222	+	3	P42771-1	0	462	ENST00000498124.1	39	501	++	126	P42771-1#53	0	3	ENST00000498124.1	258	261	+	3	0	0	8287
P42771-1#53	0	3	3	P42771-1	219	222	+	3	P42771-1	153	457	ENST00000497750.1	75	379	+	125	P42771-1#53	0	3	ENST00000497750.1	141	144	+	3	0	0	8288
P42771-1#53	0	3	3	P42771-1	219	222	+	3	P42771-1	153	468	ENST00000494262.5	624	939	++	120	P42771-1#53	0	3	ENST00000494262.5	690	693	+	3	0	0	8289
P42771-1#53	0	3	3	P42771-1	219	222	+	3	P42771-1	153	457	ENST00000479692.2	15	319	+	114	P42771-1#53	0	3	ENST00000479692.2	81	84	+	3	0	0	8290
P42771-1#53	0	3	3	P42771-1	219	222	+	3	P42771-1	0	468	ENST00000304494.10	30	498	++	22	P42771-1#53	0	3	ENST00000304494.10	249	252	+	3	0	0	8291
P42771-1#54	0	3	3	P42771-1	219	222	+	3	P42771-1	147	354	ENST00000579755.2	251	458	++	198	P42771-1#54	0	3	ENST00000579755.2	323	326	+	3	0	0	8292
P42771-1#54	0	3	3	P42771-1	219	222	+	3	P42771-1	0	468	ENST00000579122.1	31	425	+	195	P42771-1#54	0	3	ENST00000579122.1	250	253	+	3	0	0	8293
P42771-1#54	0	3	3	P42771-1	219	222	+	3	P42771-1	153	468	ENST00000578845.2	127	442	++	193	P42771-1#54	0	3	ENST00000578845.2	193	196	+	3	0	0	8294
P42771-1#54	0	3	3	P42771-1	219	222	+	3	P42771-1	147	354	ENST00000530628.2	270	477	++	152	P42771-1#54	0	3	ENST00000530628.2	342	345	+	3	0	0	8295
P42771-1#54	0	3	3	P42771-1	219	222	+	3	P42771-1	153	468	ENST00000498628.6	484	799	++	128	P42771-1#54	0	3	ENST00000498628.6	550	553	+	3	0	0	8296
P42771-1#54	0	3	3	P42771-1	219	222	+	3	P42771-1	0	462	ENST00000498124.1	39	501	++	126	P42771-1#54	0	3	ENST00000498124.1	258	261	+	3	0	0	8297
P42771-1#54	0	3	3	P42771-1	219	222	+	3	P42771-1	153	457	ENST00000497750.1	75	379	+	125	P42771-1#54	0	3	ENST00000497750.1	141	144	+	3	0	0	8298
P42771-1#54	0	3	3	P42771-1	219	222	+	3	P42771-1	153	468	ENST00000494262.5	624	939	++	120	P42771-1#54	0	3	ENST00000494262.5	690	693	+	3	0	0	8299
P42771-1#54	0	3	3	P42771-1	219	222	+	3	P42771-1	153	457	ENST00000479692.2	15	319	+	114	P42771-1#54	0	3	ENST00000479692.2	81	84	+	3	0	0	8300
P42771-1#54	0	3	3	P42771-1	219	222	+	3	P42771-1	0	468	ENST00000304494.10	30	498	++	22	P42771-1#54	0	3	ENST00000304494.10	249	252	+	3	0	0	8301
P42771-1#55	0	3	3	P42771-1	219	222	+	3	P42771-1	147	354	ENST00000579755.2	251	458	++	198	P42771-1#55	0	3	ENST00000579755.2	323	326	+	3	0	0	8302
P42771-1#55	0	3	3	P42771-1	219	222	+	3	P42771-1	0	468	ENST00000579122.1	31	425	+	195	P42771-1#55	0	3	ENST00000579122.1	250	253	+	3	0	0	8303
P42771-1#55	0	3	3	P42771-1	219	222	+	3	P42771-1	153	468	ENST00000578845.2	127	442	++	193	P42771-1#55	0	3	ENST00000578845.2	193	196	+	3	0	0	8304
P42771-1#55	0	3	3	P42771-1	219	222	+	3	P42771-1	147	354	ENST00000530628.2	270	477	++	152	P42771-1#55	0	3	ENST00000530628.2	342	345	+	3	0	0	8305
P42771-1#55	0	3	3	P42771-1	219	222	+	3	P42771-1	153	468	ENST00000498628.6	484	799	++	128	P42771-1#55	0	3	ENST00000498628.6	550	553	+	3	0	0	8306
P42771-1#55	0	3	3	P42771-1	219	222	+	3	P42771-1	0	462	ENST00000498124.1	39	501	++	126	P42771-1#55	0	3	ENST00000498124.1	258	261	+	3	0	0	8307
P42771-1#55	0	3	3	P42771-1	219	222	+	3	P42771-1	153	457	ENST00000497750.1	75	379	+	125	P42771-1#55	0	3	ENST00000497750.1	141	144	+	3	0	0	8308
P42771-1#55	0	3	3	P42771-1	219	222	+	3	P42771-1	153	468	ENST00000494262.5	624	939	++	120	P42771-1#55	0	3	ENST00000494262.5	690	693	+	3	0	0	8309
P42771-1#55	0	3	3	P42771-1	219	222	+	3	P42771-1	153	457	ENST00000479692.2	15	319	+	114	P42771-1#55	0	3	ENST00000479692.2	81	84	+	3	0	0	8310
P42771-1#55	0	3	3	P42771-1	219	222	+	3	P42771-1	0	468	ENST00000304494.10	30	498	++	22	P42771-1#55	0	3	ENST00000304494.10	249	252	+	3	0	0	8311
P42771-1#56	0	3	3	P42771-1	228	231	+	3	P42771-1	147	354	ENST00000579755.2	251	458	++	198	P42771-1#56	0	3	ENST00000579755.2	332	335	+	3	0	0	8312
P42771-1#56	0	3	3	P42771-1	228	231	+	3	P42771-1	0	468	ENST00000579122.1	31	425	+	195	P42771-1#56	0	3	ENST00000579122.1	259	262	+	3	0	0	8313
P42771-1#56	0	3	3	P42771-1	228	231	+	3	P42771-1	153	468	ENST00000578845.2	127	442	++	193	P42771-1#56	0	3	ENST00000578845.2	202	205	+	3	0	0	8314
P42771-1#56	0	3	3	P42771-1	228	231	+	3	P42771-1	147	354	ENST00000530628.2	270	477	++	152	P42771-1#56	0	3	ENST00000530628.2	351	354	+	3	0	0	8315
P42771-1#56	0	3	3	P42771-1	228	231	+	3	P42771-1	153	468	ENST00000498628.6	484	799	++	128	P42771-1#56	0	3	ENST00000498628.6	559	562	+	3	0	0	8316
P42771-1#56	0	3	3	P42771-1	228	231	+	3	P42771-1	0	462	ENST00000498124.1	39	501	++	126	P42771-1#56	0	3	ENST00000498124.1	267	270	+	3	0	0	8317
P42771-1#56	0	3	3	P42771-1	228	231	+	3	P42771-1	153	457	ENST00000497750.1	75	379	+	125	P42771-1#56	0	3	ENST00000497750.1	150	153	+	3	0	0	8318
P42771-1#56	0	3	3	P42771-1	228	231	+	3	P42771-1	153	468	ENST00000494262.5	624	939	++	120	P42771-1#56	0	3	ENST00000494262.5	699	702	+	3	0	0	8319
P42771-1#56	0	3	3	P42771-1	228	231	+	3	P42771-1	153	457	ENST00000479692.2	15	319	+	114	P42771-1#56	0	3	ENST00000479692.2	90	93	+	3	0	0	8320
P42771-1#56	0	3	3	P42771-1	228	231	+	3	P42771-1	0	468	ENST00000304494.10	30	498	++	22	P42771-1#56	0	3	ENST00000304494.10	258	261	+	3	0	0	8321
P42771-1#57	0	3	3	P42771-1	237	240	+	3	P42771-1	147	354	ENST00000579755.2	251	458	++	198	P42771-1#57	0	3	ENST00000579755.2	341	344	+	3	0	0	8322
P42771-1#57	0	3	3	P42771-1	237	240	+	3	P42771-1	0	468	ENST00000579122.1	31	425	+	195	P42771-1#57	0	3	ENST00000579122.1	268	271	+	3	0	0	8323
P42771-1#57	0	3	3	P42771-1	237	240	+	3	P42771-1	153	468	ENST00000578845.2	127	442	++	193	P42771-1#57	0	3	ENST00000578845.2	211	214	+	3	0	0	8324
P42771-1#57	0	3	3	P42771-1	237	240	+	3	P42771-1	147	354	ENST00000530628.2	270	477	++	152	P42771-1#57	0	3	ENST00000530628.2	360	363	+	3	0	0	8325
P42771-1#57	0	3	3	P42771-1	237	240	+	3	P42771-1	153	468	ENST00000498628.6	484	799	++	128	P42771-1#57	0	3	ENST00000498628.6	568	571	+	3	0	0	8326
P42771-1#57	0	3	3	P42771-1	237	240	+	3	P42771-1	0	462	ENST00000498124.1	39	501	++	126	P42771-1#57	0	3	ENST00000498124.1	276	279	+	3	0	0	8327
P42771-1#57	0	3	3	P42771-1	237	240	+	3	P42771-1	153	457	ENST00000497750.1	75	379	+	125	P42771-1#57	0	3	ENST00000497750.1	159	162	+	3	0	0	8328
P42771-1#57	0	3	3	P42771-1	237	240	+	3	P42771-1	153	468	ENST00000494262.5	624	939	++	120	P42771-1#57	0	3	ENST00000494262.5	708	711	+	3	0	0	8329
P42771-1#57	0	3	3	P42771-1	237	240	+	3	P42771-1	153	457	ENST00000479692.2	15	319	+	114	P42771-1#57	0	3	ENST00000479692.2	99	102	+	3	0	0	8330
P42771-1#57	0	3	3	P42771-1	237	240	+	3	P42771-1	0	468	ENST00000304494.10	30	498	++	22	P42771-1#57	0	3	ENST00000304494.10	267	270	+	3	0	0	8331
P42771-1#58	0	3	3	P42771-1	237	240	+	3	P42771-1	147	354	ENST00000579755.2	251	458	++	198	P42771-1#58	0	3	ENST00000579755.2	341	344	+	3	0	0	8332
P42771-1#58	0	3	3	P42771-1	237	240	+	3	P42771-1	0	468	ENST00000579122.1	31	425	+	195	P42771-1#58	0	3	ENST00000579122.1	268	271	+	3	0	0	8333
P42771-1#58	0	3	3	P42771-1	237	240	+	3	P42771-1	153	468	ENST00000578845.2	127	442	++	193	P42771-1#58	0	3	ENST00000578845.2	211	214	+	3	0	0	8334
P42771-1#58	0	3	3	P42771-1	237	240	+	3	P42771-1	147	354	ENST00000530628.2	270	477	++	152	P42771-1#58	0	3	ENST00000530628.2	360	363	+	3	0	0	8335
P42771-1#58	0	3	3	P42771-1	237	240	+	3	P42771-1	153	468	ENST00000498628.6	484	799	++	128	P42771-1#58	0	3	ENST00000498628.6	568	571	+	3	0	0	8336
P42771-1#58	0	3	3	P42771-1	237	240	+	3	P42771-1	0	462	ENST00000498124.1	39	501	++	126	P42771-1#58	0	3	ENST00000498124.1	276	279	+	3	0	0	8337
P42771-1#58	0	3	3	P42771-1	237	240	+	3	P42771-1	153	457	ENST00000497750.1	75	379	+	125	P42771-1#58	0	3	ENST00000497750.1	159	162	+	3	0	0	8338
P42771-1#58	0	3	3	P42771-1	237	240	+	3	P42771-1	153	468	ENST00000494262.5	624	939	++	120	P42771-1#58	0	3	ENST00000494262.5	708	711	+	3	0	0	8339
P42771-1#58	0	3	3	P42771-1	237	240	+	3	P42771-1	153	457	ENST00000479692.2	15	319	+	114	P42771-1#58	0	3	ENST00000479692.2	99	102	+	3	0	0	8340
P42771-1#58	0	3	3	P42771-1	237	240	+	3	P42771-1	0	468	ENST00000304494.10	30	498	++	22	P42771-1#58	0	3	ENST00000304494.10	267	270	+	3	0	0	8341
P42771-1#59	0	3	3	P42771-1	240	243	+	3	P42771-1	147	354	ENST00000579755.2	251	458	++	198	P42771-1#59	0	3	ENST00000579755.2	344	347	+	3	0	0	8342
P42771-1#59	0	3	3	P42771-1	240	243	+	3	P42771-1	0	468	ENST00000579122.1	31	425	+	195	P42771-1#59	0	3	ENST00000579122.1	271	274	+	3	0	0	8343
P42771-1#59	0	3	3	P42771-1	240	243	+	3	P42771-1	153	468	ENST00000578845.2	127	442	++	193	P42771-1#59	0	3	ENST00000578845.2	214	217	+	3	0	0	8344
P42771-1#59	0	3	3	P42771-1	240	243	+	3	P42771-1	147	354	ENST00000530628.2	270	477	++	152	P42771-1#59	0	3	ENST00000530628.2	363	366	+	3	0	0	8345
P42771-1#59	0	3	3	P42771-1	240	243	+	3	P42771-1	153	468	ENST00000498628.6	484	799	++	128	P42771-1#59	0	3	ENST00000498628.6	571	574	+	3	0	0	8346
P42771-1#59	0	3	3	P42771-1	240	243	+	3	P42771-1	0	462	ENST00000498124.1	39	501	++	126	P42771-1#59	0	3	ENST00000498124.1	279	282	+	3	0	0	8347
P42771-1#59	0	3	3	P42771-1	240	243	+	3	P42771-1	153	457	ENST00000497750.1	75	379	+	125	P42771-1#59	0	3	ENST00000497750.1	162	165	+	3	0	0	8348
P42771-1#59	0	3	3	P42771-1	240	243	+	3	P42771-1	153	468	ENST00000494262.5	624	939	++	120	P42771-1#59	0	3	ENST00000494262.5	711	714	+	3	0	0	8349
P42771-1#59	0	3	3	P42771-1	240	243	+	3	P42771-1	153	457	ENST00000479692.2	15	319	+	114	P42771-1#59	0	3	ENST00000479692.2	102	105	+	3	0	0	8350
P42771-1#59	0	3	3	P42771-1	240	243	+	3	P42771-1	0	468	ENST00000304494.10	30	498	++	22	P42771-1#59	0	3	ENST00000304494.10	270	273	+	3	0	0	8351
P42771-1#60	0	3	3	P42771-1	240	243	+	3	P42771-1	147	354	ENST00000579755.2	251	458	++	198	P42771-1#60	0	3	ENST00000579755.2	344	347	+	3	0	0	8352
P42771-1#60	0	3	3	P42771-1	240	243	+	3	P42771-1	0	468	ENST00000579122.1	31	425	+	195	P42771-1#60	0	3	ENST00000579122.1	271	274	+	3	0	0	8353
P42771-1#60	0	3	3	P42771-1	240	243	+	3	P42771-1	153	468	ENST00000578845.2	127	442	++	193	P42771-1#60	0	3	ENST00000578845.2	214	217	+	3	0	0	8354
P42771-1#60	0	3	3	P42771-1	240	243	+	3	P42771-1	147	354	ENST00000530628.2	270	477	++	152	P42771-1#60	0	3	ENST00000530628.2	363	366	+	3	0	0	8355
P42771-1#60	0	3	3	P42771-1	240	243	+	3	P42771-1	153	468	ENST00000498628.6	484	799	++	128	P42771-1#60	0	3	ENST00000498628.6	571	574	+	3	0	0	8356
P42771-1#60	0	3	3	P42771-1	240	243	+	3	P42771-1	0	462	ENST00000498124.1	39	501	++	126	P42771-1#60	0	3	ENST00000498124.1	279	282	+	3	0	0	8357
P42771-1#60	0	3	3	P42771-1	240	243	+	3	P42771-1	153	457	ENST00000497750.1	75	379	+	125	P42771-1#60	0	3	ENST00000497750.1	162	165	+	3	0	0	8358
P42771-1#60	0	3	3	P42771-1	240	243	+	3	P42771-1	153	468	ENST00000494262.5	624	939	++	120	P42771-1#60	0	3	ENST00000494262.5	711	714	+	3	0	0	8359
P42771-1#60	0	3	3	P42771-1	240	243	+	3	P42771-1	153	457	ENST00000479692.2	15	319	+	114	P42771-1#60	0	3	ENST00000479692.2	102	105	+	3	0	0	8360
P42771-1#60	0	3	3	P42771-1	240	243	+	3	P42771-1	0	468	ENST00000304494.10	30	498	++	22	P42771-1#60	0	3	ENST00000304494.10	270	273	+	3	0	0	8361
P42771-1#61	0	3	3	P42771-1	246	249	+	3	P42771-1	147	354	ENST00000579755.2	251	458	++	198	P42771-1#61	0	3	ENST00000579755.2	350	353	+	3	0	0	8362
P42771-1#61	0	3	3	P42771-1	246	249	+	3	P42771-1	0	468	ENST00000579122.1	31	425	+	195	P42771-1#61	0	3	ENST00000579122.1	277	280	+	3	0	0	8363
P42771-1#61	0	3	3	P42771-1	246	249	+	3	P42771-1	153	468	ENST00000578845.2	127	442	++	193	P42771-1#61	0	3	ENST00000578845.2	220	223	+	3	0	0	8364
P42771-1#61	0	3	3	P42771-1	246	249	+	3	P42771-1	147	354	ENST00000530628.2	270	477	++	152	P42771-1#61	0	3	ENST00000530628.2	369	372	+	3	0	0	8365
P42771-1#61	0	3	3	P42771-1	246	249	+	3	P42771-1	153	468	ENST00000498628.6	484	799	++	128	P42771-1#61	0	3	ENST00000498628.6	577	580	+	3	0	0	8366
P42771-1#61	0	3	3	P42771-1	246	249	+	3	P42771-1	0	462	ENST00000498124.1	39	501	++	126	P42771-1#61	0	3	ENST00000498124.1	285	288	+	3	0	0	8367
P42771-1#61	0	3	3	P42771-1	246	249	+	3	P42771-1	153	457	ENST00000497750.1	75	379	+	125	P42771-1#61	0	3	ENST00000497750.1	168	171	+	3	0	0	8368
P42771-1#61	0	3	3	P42771-1	246	249	+	3	P42771-1	153	468	ENST00000494262.5	624	939	++	120	P42771-1#61	0	3	ENST00000494262.5	717	720	+	3	0	0	8369
P42771-1#61	0	3	3	P42771-1	246	249	+	3	P42771-1	153	457	ENST00000479692.2	15	319	+	114	P42771-1#61	0	3	ENST00000479692.2	108	111	+	3	0	0	8370
P42771-1#61	0	3	3	P42771-1	246	249	+	3	P42771-1	0	468	ENST00000304494.10	30	498	++	22	P42771-1#61	0	3	ENST00000304494.10	276	279	+	3	0	0	8371
P42771-1#62	0	3	3	P42771-1	246	249	+	3	P42771-1	147	354	ENST00000579755.2	251	458	++	198	P42771-1#62	0	3	ENST00000579755.2	350	353	+	3	0	0	8372
P42771-1#62	0	3	3	P42771-1	246	249	+	3	P42771-1	0	468	ENST00000579122.1	31	425	+	195	P42771-1#62	0	3	ENST00000579122.1	277	280	+	3	0	0	8373
P42771-1#62	0	3	3	P42771-1	246	249	+	3	P42771-1	153	468	ENST00000578845.2	127	442	++	193	P42771-1#62	0	3	ENST00000578845.2	220	223	+	3	0	0	8374
P42771-1#62	0	3	3	P42771-1	246	249	+	3	P42771-1	147	354	ENST00000530628.2	270	477	++	152	P42771-1#62	0	3	ENST00000530628.2	369	372	+	3	0	0	8375
P42771-1#62	0	3	3	P42771-1	246	249	+	3	P42771-1	153	468	ENST00000498628.6	484	799	++	128	P42771-1#62	0	3	ENST00000498628.6	577	580	+	3	0	0	8376
P42771-1#62	0	3	3	P42771-1	246	249	+	3	P42771-1	0	462	ENST00000498124.1	39	501	++	126	P42771-1#62	0	3	ENST00000498124.1	285	288	+	3	0	0	8377
P42771-1#62	0	3	3	P42771-1	246	249	+	3	P42771-1	153	457	ENST00000497750.1	75	379	+	125	P42771-1#62	0	3	ENST00000497750.1	168	171	+	3	0	0	8378
P42771-1#62	0	3	3	P42771-1	246	249	+	3	P42771-1	153	468	ENST00000494262.5	624	939	++	120	P42771-1#62	0	3	ENST00000494262.5	717	720	+	3	0	0	8379
P42771-1#62	0	3	3	P42771-1	246	249	+	3	P42771-1	153	457	ENST00000479692.2	15	319	+	114	P42771-1#62	0	3	ENST00000479692.2	108	111	+	3	0	0	8380
P42771-1#62	0	3	3	P42771-1	246	249	+	3	P42771-1	0	468	ENST00000304494.10	30	498	++	22	P42771-1#62	0	3	ENST00000304494.10	276	279	+	3	0	0	8381
P42771-1#63	0	3	3	P42771-1	246	249	+	3	P42771-1	147	354	ENST00000579755.2	251	458	++	198	P42771-1#63	0	3	ENST00000579755.2	350	353	+	3	0	0	8382
P42771-1#63	0	3	3	P42771-1	246	249	+	3	P42771-1	0	468	ENST00000579122.1	31	425	+	195	P42771-1#63	0	3	ENST00000579122.1	277	280	+	3	0	0	8383
P42771-1#63	0	3	3	P42771-1	246	249	+	3	P42771-1	153	468	ENST00000578845.2	127	442	++	193	P42771-1#63	0	3	ENST00000578845.2	220	223	+	3	0	0	8384
P42771-1#63	0	3	3	P42771-1	246	249	+	3	P42771-1	147	354	ENST00000530628.2	270	477	++	152	P42771-1#63	0	3	ENST00000530628.2	369	372	+	3	0	0	8385
P42771-1#63	0	3	3	P42771-1	246	249	+	3	P42771-1	153	468	ENST00000498628.6	484	799	++	128	P42771-1#63	0	3	ENST00000498628.6	577	580	+	3	0	0	8386
P42771-1#63	0	3	3	P42771-1	246	249	+	3	P42771-1	0	462	ENST00000498124.1	39	501	++	126	P42771-1#63	0	3	ENST00000498124.1	285	288	+	3	0	0	8387
P42771-1#63	0	3	3	P42771-1	246	249	+	3	P42771-1	153	457	ENST00000497750.1	75	379	+	125	P42771-1#63	0	3	ENST00000497750.1	168	171	+	3	0	0	8388
P42771-1#63	0	3	3	P42771-1	246	249	+	3	P42771-1	153	468	ENST00000494262.5	624	939	++	120	P42771-1#63	0	3	ENST00000494262.5	717	720	+	3	0	0	8389
P42771-1#63	0	3	3	P42771-1	246	249	+	3	P42771-1	153	457	ENST00000479692.2	15	319	+	114	P42771-1#63	0	3	ENST00000479692.2	108	111	+	3	0	0	8390
P42771-1#63	0	3	3	P42771-1	246	249	+	3	P42771-1	0	468	ENST00000304494.10	30	498	++	22	P42771-1#63	0	3	ENST00000304494.10	276	279	+	3	0	0	8391
P42771-1#64	0	3	3	P42771-1	249	252	+	3	P42771-1	147	354	ENST00000579755.2	251	458	++	198	P42771-1#64	0	3	ENST00000579755.2	353	356	+	3	0	0	8392
P42771-1#64	0	3	3	P42771-1	249	252	+	3	P42771-1	0	468	ENST00000579122.1	31	425	+	195	P42771-1#64	0	3	ENST00000579122.1	280	283	+	3	0	0	8393
P42771-1#64	0	3	3	P42771-1	249	252	+	3	P42771-1	153	468	ENST00000578845.2	127	442	++	193	P42771-1#64	0	3	ENST00000578845.2	223	226	+	3	0	0	8394
P42771-1#64	0	3	3	P42771-1	249	252	+	3	P42771-1	147	354	ENST00000530628.2	270	477	++	152	P42771-1#64	0	3	ENST00000530628.2	372	375	+	3	0	0	8395
P42771-1#64	0	3	3	P42771-1	249	252	+	3	P42771-1	153	468	ENST00000498628.6	484	799	++	128	P42771-1#64	0	3	ENST00000498628.6	580	583	+	3	0	0	8396
P42771-1#64	0	3	3	P42771-1	249	252	+	3	P42771-1	0	462	ENST00000498124.1	39	501	++	126	P42771-1#64	0	3	ENST00000498124.1	288	291	+	3	0	0	8397
P42771-1#64	0	3	3	P42771-1	249	252	+	3	P42771-1	153	457	ENST00000497750.1	75	379	+	125	P42771-1#64	0	3	ENST00000497750.1	171	174	+	3	0	0	8398
P42771-1#64	0	3	3	P42771-1	249	252	+	3	P42771-1	153	468	ENST00000494262.5	624	939	++	120	P42771-1#64	0	3	ENST00000494262.5	720	723	+	3	0	0	8399
P42771-1#64	0	3	3	P42771-1	249	252	+	3	P42771-1	153	457	ENST00000479692.2	15	319	+	114	P42771-1#64	0	3	ENST00000479692.2	111	114	+	3	0	0	8400
P42771-1#64	0	3	3	P42771-1	249	252	+	3	P42771-1	0	468	ENST00000304494.10	30	498	++	22	P42771-1#64	0	3	ENST00000304494.10	279	282	+	3	0	0	8401
P42771-1#65	0	3	3	P42771-1	249	252	+	3	P42771-1	147	354	ENST00000579755.2	251	458	++	198	P42771-1#65	0	3	ENST00000579755.2	353	356	+	3	0	0	8402
P42771-1#65	0	3	3	P42771-1	249	252	+	3	P42771-1	0	468	ENST00000579122.1	31	425	+	195	P42771-1#65	0	3	ENST00000579122.1	280	283	+	3	0	0	8403
P42771-1#65	0	3	3	P42771-1	249	252	+	3	P42771-1	153	468	ENST00000578845.2	127	442	++	193	P42771-1#65	0	3	ENST00000578845.2	223	226	+	3	0	0	8404
P42771-1#65	0	3	3	P42771-1	249	252	+	3	P42771-1	147	354	ENST00000530628.2	270	477	++	152	P42771-1#65	0	3	ENST00000530628.2	372	375	+	3	0	0	8405
P42771-1#65	0	3	3	P42771-1	249	252	+	3	P42771-1	153	468	ENST00000498628.6	484	799	++	128	P42771-1#65	0	3	ENST00000498628.6	580	583	+	3	0	0	8406
P42771-1#65	0	3	3	P42771-1	249	252	+	3	P42771-1	0	462	ENST00000498124.1	39	501	++	126	P42771-1#65	0	3	ENST00000498124.1	288	291	+	3	0	0	8407
P42771-1#65	0	3	3	P42771-1	249	252	+	3	P42771-1	153	457	ENST00000497750.1	75	379	+	125	P42771-1#65	0	3	ENST00000497750.1	171	174	+	3	0	0	8408
P42771-1#65	0	3	3	P42771-1	249	252	+	3	P42771-1	153	468	ENST00000494262.5	624	939	++	120	P42771-1#65	0	3	ENST00000494262.5	720	723	+	3	0	0	8409
P42771-1#65	0	3	3	P42771-1	249	252	+	3	P42771-1	153	457	ENST00000479692.2	15	319	+	114	P42771-1#65	0	3	ENST00000479692.2	111	114	+	3	0	0	8410
P42771-1#65	0	3	3	P42771-1	249	252	+	3	P42771-1	0	468	ENST00000304494.10	30	498	++	22	P42771-1#65	0	3	ENST00000304494.10	279	282	+	3	0	0	8411
P42771-1#66	0	3	3	P42771-1	249	252	+	3	P42771-1	147	354	ENST00000579755.2	251	458	++	198	P42771-1#66	0	3	ENST00000579755.2	353	356	+	3	0	0	8412
P42771-1#66	0	3	3	P42771-1	249	252	+	3	P42771-1	0	468	ENST00000579122.1	31	425	+	195	P42771-1#66	0	3	ENST00000579122.1	280	283	+	3	0	0	8413
P42771-1#66	0	3	3	P42771-1	249	252	+	3	P42771-1	153	468	ENST00000578845.2	127	442	++	193	P42771-1#66	0	3	ENST00000578845.2	223	226	+	3	0	0	8414
P42771-1#66	0	3	3	P42771-1	249	252	+	3	P42771-1	147	354	ENST00000530628.2	270	477	++	152	P42771-1#66	0	3	ENST00000530628.2	372	375	+	3	0	0	8415
P42771-1#66	0	3	3	P42771-1	249	252	+	3	P42771-1	153	468	ENST00000498628.6	484	799	++	128	P42771-1#66	0	3	ENST00000498628.6	580	583	+	3	0	0	8416
P42771-1#66	0	3	3	P42771-1	249	252	+	3	P42771-1	0	462	ENST00000498124.1	39	501	++	126	P42771-1#66	0	3	ENST00000498124.1	288	291	+	3	0	0	8417
P42771-1#66	0	3	3	P42771-1	249	252	+	3	P42771-1	153	457	ENST00000497750.1	75	379	+	125	P42771-1#66	0	3	ENST00000497750.1	171	174	+	3	0	0	8418
P42771-1#66	0	3	3	P42771-1	249	252	+	3	P42771-1	153	468	ENST00000494262.5	624	939	++	120	P42771-1#66	0	3	ENST00000494262.5	720	723	+	3	0	0	8419
P42771-1#66	0	3	3	P42771-1	249	252	+	3	P42771-1	153	457	ENST00000479692.2	15	319	+	114	P42771-1#66	0	3	ENST00000479692.2	111	114	+	3	0	0	8420
P42771-1#66	0	3	3	P42771-1	249	252	+	3	P42771-1	0	468	ENST00000304494.10	30	498	++	22	P42771-1#66	0	3	ENST00000304494.10	279	282	+	3	0	0	8421
P42771-1#67	0	3	3	P42771-1	249	252	+	3	P42771-1	147	354	ENST00000579755.2	251	458	++	198	P42771-1#67	0	3	ENST00000579755.2	353	356	+	3	0	0	8422
P42771-1#67	0	3	3	P42771-1	249	252	+	3	P42771-1	0	468	ENST00000579122.1	31	425	+	195	P42771-1#67	0	3	ENST00000579122.1	280	283	+	3	0	0	8423
P42771-1#67	0	3	3	P42771-1	249	252	+	3	P42771-1	153	468	ENST00000578845.2	127	442	++	193	P42771-1#67	0	3	ENST00000578845.2	223	226	+	3	0	0	8424
P42771-1#67	0	3	3	P42771-1	249	252	+	3	P42771-1	147	354	ENST00000530628.2	270	477	++	152	P42771-1#67	0	3	ENST00000530628.2	372	375	+	3	0	0	8425
P42771-1#67	0	3	3	P42771-1	249	252	+	3	P42771-1	153	468	ENST00000498628.6	484	799	++	128	P42771-1#67	0	3	ENST00000498628.6	580	583	+	3	0	0	8426
P42771-1#67	0	3	3	P42771-1	249	252	+	3	P42771-1	0	462	ENST00000498124.1	39	501	++	126	P42771-1#67	0	3	ENST00000498124.1	288	291	+	3	0	0	8427
P42771-1#67	0	3	3	P42771-1	249	252	+	3	P42771-1	153	457	ENST00000497750.1	75	379	+	125	P42771-1#67	0	3	ENST00000497750.1	171	174	+	3	0	0	8428
P42771-1#67	0	3	3	P42771-1	249	252	+	3	P42771-1	153	468	ENST00000494262.5	624	939	++	120	P42771-1#67	0	3	ENST00000494262.5	720	723	+	3	0	0	8429
P42771-1#67	0	3	3	P42771-1	249	252	+	3	P42771-1	153	457	ENST00000479692.2	15	319	+	114	P42771-1#67	0	3	ENST00000479692.2	111	114	+	3	0	0	8430
P42771-1#67	0	3	3	P42771-1	249	252	+	3	P42771-1	0	468	ENST00000304494.10	30	498	++	22	P42771-1#67	0	3	ENST00000304494.10	279	282	+	3	0	0	8431
P42771-1#68	0	3	3	P42771-1	252	255	+	3	P42771-1	147	354	ENST00000579755.2	251	458	++	198	P42771-1#68	0	3	ENST00000579755.2	356	359	+	3	0	0	8432
P42771-1#68	0	3	3	P42771-1	252	255	+	3	P42771-1	0	468	ENST00000579122.1	31	425	+	195	P42771-1#68	0	3	ENST00000579122.1	283	286	+	3	0	0	8433
P42771-1#68	0	3	3	P42771-1	252	255	+	3	P42771-1	153	468	ENST00000578845.2	127	442	++	193	P42771-1#68	0	3	ENST00000578845.2	226	229	+	3	0	0	8434
P42771-1#68	0	3	3	P42771-1	252	255	+	3	P42771-1	147	354	ENST00000530628.2	270	477	++	152	P42771-1#68	0	3	ENST00000530628.2	375	378	+	3	0	0	8435
P42771-1#68	0	3	3	P42771-1	252	255	+	3	P42771-1	153	468	ENST00000498628.6	484	799	++	128	P42771-1#68	0	3	ENST00000498628.6	583	586	+	3	0	0	8436
P42771-1#68	0	3	3	P42771-1	252	255	+	3	P42771-1	0	462	ENST00000498124.1	39	501	++	126	P42771-1#68	0	3	ENST00000498124.1	291	294	+	3	0	0	8437
P42771-1#68	0	3	3	P42771-1	252	255	+	3	P42771-1	153	457	ENST00000497750.1	75	379	+	125	P42771-1#68	0	3	ENST00000497750.1	174	177	+	3	0	0	8438
P42771-1#68	0	3	3	P42771-1	252	255	+	3	P42771-1	153	468	ENST00000494262.5	624	939	++	120	P42771-1#68	0	3	ENST00000494262.5	723	726	+	3	0	0	8439
P42771-1#68	0	3	3	P42771-1	252	255	+	3	P42771-1	153	457	ENST00000479692.2	15	319	+	114	P42771-1#68	0	3	ENST00000479692.2	114	117	+	3	0	0	8440
P42771-1#68	0	3	3	P42771-1	252	255	+	3	P42771-1	0	468	ENST00000304494.10	30	498	++	22	P42771-1#68	0	3	ENST00000304494.10	282	285	+	3	0	0	8441
P42771-1#69	0	3	3	P42771-1	258	261	+	3	P42771-1	147	354	ENST00000579755.2	251	458	++	198	P42771-1#69	0	3	ENST00000579755.2	362	365	+	3	0	0	8442
P42771-1#69	0	3	3	P42771-1	258	261	+	3	P42771-1	0	468	ENST00000579122.1	31	425	+	195	P42771-1#69	0	3	ENST00000579122.1	289	292	+	3	0	0	8443
P42771-1#69	0	3	3	P42771-1	258	261	+	3	P42771-1	153	468	ENST00000578845.2	127	442	++	193	P42771-1#69	0	3	ENST00000578845.2	232	235	+	3	0	0	8444
P42771-1#69	0	3	3	P42771-1	258	261	+	3	P42771-1	147	354	ENST00000530628.2	270	477	++	152	P42771-1#69	0	3	ENST00000530628.2	381	384	+	3	0	0	8445
P42771-1#69	0	3	3	P42771-1	258	261	+	3	P42771-1	153	468	ENST00000498628.6	484	799	++	128	P42771-1#69	0	3	ENST00000498628.6	589	592	+	3	0	0	8446
P42771-1#69	0	3	3	P42771-1	258	261	+	3	P42771-1	0	462	ENST00000498124.1	39	501	++	126	P42771-1#69	0	3	ENST00000498124.1	297	300	+	3	0	0	8447
P42771-1#69	0	3	3	P42771-1	258	261	+	3	P42771-1	153	457	ENST00000497750.1	75	379	+	125	P42771-1#69	0	3	ENST00000497750.1	180	183	+	3	0	0	8448
P42771-1#69	0	3	3	P42771-1	258	261	+	3	P42771-1	153	468	ENST00000494262.5	624	939	++	120	P42771-1#69	0	3	ENST00000494262.5	729	732	+	3	0	0	8449
P42771-1#69	0	3	3	P42771-1	258	261	+	3	P42771-1	153	457	ENST00000479692.2	15	319	+	114	P42771-1#69	0	3	ENST00000479692.2	120	123	+	3	0	0	8450
P42771-1#69	0	3	3	P42771-1	258	261	+	3	P42771-1	0	468	ENST00000304494.10	30	498	++	22	P42771-1#69	0	3	ENST00000304494.10	288	291	+	3	0	0	8451
P42771-1#70	0	3	3	P42771-1	258	261	+	3	P42771-1	147	354	ENST00000579755.2	251	458	++	198	P42771-1#70	0	3	ENST00000579755.2	362	365	+	3	0	0	8452
P42771-1#70	0	3	3	P42771-1	258	261	+	3	P42771-1	0	468	ENST00000579122.1	31	425	+	195	P42771-1#70	0	3	ENST00000579122.1	289	292	+	3	0	0	8453
P42771-1#70	0	3	3	P42771-1	258	261	+	3	P42771-1	153	468	ENST00000578845.2	127	442	++	193	P42771-1#70	0	3	ENST00000578845.2	232	235	+	3	0	0	8454
P42771-1#70	0	3	3	P42771-1	258	261	+	3	P42771-1	147	354	ENST00000530628.2	270	477	++	152	P42771-1#70	0	3	ENST00000530628.2	381	384	+	3	0	0	8455
P42771-1#70	0	3	3	P42771-1	258	261	+	3	P42771-1	153	468	ENST00000498628.6	484	799	++	128	P42771-1#70	0	3	ENST00000498628.6	589	592	+	3	0	0	8456
P42771-1#70	0	3	3	P42771-1	258	261	+	3	P42771-1	0	462	ENST00000498124.1	39	501	++	126	P42771-1#70	0	3	ENST00000498124.1	297	300	+	3	0	0	8457
P42771-1#70	0	3	3	P42771-1	258	261	+	3	P42771-1	153	457	ENST00000497750.1	75	379	+	125	P42771-1#70	0	3	ENST00000497750.1	180	183	+	3	0	0	8458
P42771-1#70	0	3	3	P42771-1	258	261	+	3	P42771-1	153	468	ENST00000494262.5	624	939	++	120	P42771-1#70	0	3	ENST00000494262.5	729	732	+	3	0	0	8459
P42771-1#70	0	3	3	P42771-1	258	261	+	3	P42771-1	153	457	ENST00000479692.2	15	319	+	114	P42771-1#70	0	3	ENST00000479692.2	120	123	+	3	0	0	8460
P42771-1#70	0	3	3	P42771-1	258	261	+	3	P42771-1	0	468	ENST00000304494.10	30	498	++	22	P42771-1#70	0	3	ENST00000304494.10	288	291	+	3	0	0	8461
P42771-1#71	0	3	3	P42771-1	261	264	+	3	P42771-1	147	354	ENST00000579755.2	251	458	++	198	P42771-1#71	0	3	ENST00000579755.2	365	368	+	3	0	0	8462
P42771-1#71	0	3	3	P42771-1	261	264	+	3	P42771-1	0	468	ENST00000579122.1	31	425	+	195	P42771-1#71	0	3	ENST00000579122.1	292	295	+	3	0	0	8463
P42771-1#71	0	3	3	P42771-1	261	264	+	3	P42771-1	153	468	ENST00000578845.2	127	442	++	193	P42771-1#71	0	3	ENST00000578845.2	235	238	+	3	0	0	8464
P42771-1#71	0	3	3	P42771-1	261	264	+	3	P42771-1	147	354	ENST00000530628.2	270	477	++	152	P42771-1#71	0	3	ENST00000530628.2	384	387	+	3	0	0	8465
P42771-1#71	0	3	3	P42771-1	261	264	+	3	P42771-1	153	468	ENST00000498628.6	484	799	++	128	P42771-1#71	0	3	ENST00000498628.6	592	595	+	3	0	0	8466
P42771-1#71	0	3	3	P42771-1	261	264	+	3	P42771-1	0	462	ENST00000498124.1	39	501	++	126	P42771-1#71	0	3	ENST00000498124.1	300	303	+	3	0	0	8467
P42771-1#71	0	3	3	P42771-1	261	264	+	3	P42771-1	153	457	ENST00000497750.1	75	379	+	125	P42771-1#71	0	3	ENST00000497750.1	183	186	+	3	0	0	8468
P42771-1#71	0	3	3	P42771-1	261	264	+	3	P42771-1	153	468	ENST00000494262.5	624	939	++	120	P42771-1#71	0	3	ENST00000494262.5	732	735	+	3	0	0	8469
P42771-1#71	0	3	3	P42771-1	261	264	+	3	P42771-1	153	457	ENST00000479692.2	15	319	+	114	P42771-1#71	0	3	ENST00000479692.2	123	126	+	3	0	0	8470
P42771-1#71	0	3	3	P42771-1	261	264	+	3	P42771-1	0	468	ENST00000304494.10	30	498	++	22	P42771-1#71	0	3	ENST00000304494.10	291	294	+	3	0	0	8471
P42771-1#72	0	3	3	P42771-1	264	267	+	3	P42771-1	147	354	ENST00000579755.2	251	458	++	198	P42771-1#72	0	3	ENST00000579755.2	368	371	+	3	0	0	8472
P42771-1#72	0	3	3	P42771-1	264	267	+	3	P42771-1	0	468	ENST00000579122.1	31	425	+	195	P42771-1#72	0	3	ENST00000579122.1	295	298	+	3	0	0	8473
P42771-1#72	0	3	3	P42771-1	264	267	+	3	P42771-1	153	468	ENST00000578845.2	127	442	++	193	P42771-1#72	0	3	ENST00000578845.2	238	241	+	3	0	0	8474
P42771-1#72	0	3	3	P42771-1	264	267	+	3	P42771-1	147	354	ENST00000530628.2	270	477	++	152	P42771-1#72	0	3	ENST00000530628.2	387	390	+	3	0	0	8475
P42771-1#72	0	3	3	P42771-1	264	267	+	3	P42771-1	153	468	ENST00000498628.6	484	799	++	128	P42771-1#72	0	3	ENST00000498628.6	595	598	+	3	0	0	8476
P42771-1#72	0	3	3	P42771-1	264	267	+	3	P42771-1	0	462	ENST00000498124.1	39	501	++	126	P42771-1#72	0	3	ENST00000498124.1	303	306	+	3	0	0	8477
P42771-1#72	0	3	3	P42771-1	264	267	+	3	P42771-1	153	457	ENST00000497750.1	75	379	+	125	P42771-1#72	0	3	ENST00000497750.1	186	189	+	3	0	0	8478
P42771-1#72	0	3	3	P42771-1	264	267	+	3	P42771-1	153	468	ENST00000494262.5	624	939	++	120	P42771-1#72	0	3	ENST00000494262.5	735	738	+	3	0	0	8479
P42771-1#72	0	3	3	P42771-1	264	267	+	3	P42771-1	153	457	ENST00000479692.2	15	319	+	114	P42771-1#72	0	3	ENST00000479692.2	126	129	+	3	0	0	8480
P42771-1#72	0	3	3	P42771-1	264	267	+	3	P42771-1	0	468	ENST00000304494.10	30	498	++	22	P42771-1#72	0	3	ENST00000304494.10	294	297	+	3	0	0	8481
P42771-1#73	0	3	3	P42771-1	264	267	+	3	P42771-1	147	354	ENST00000579755.2	251	458	++	198	P42771-1#73	0	3	ENST00000579755.2	368	371	+	3	0	0	8482
P42771-1#73	0	3	3	P42771-1	264	267	+	3	P42771-1	0	468	ENST00000579122.1	31	425	+	195	P42771-1#73	0	3	ENST00000579122.1	295	298	+	3	0	0	8483
P42771-1#73	0	3	3	P42771-1	264	267	+	3	P42771-1	153	468	ENST00000578845.2	127	442	++	193	P42771-1#73	0	3	ENST00000578845.2	238	241	+	3	0	0	8484
P42771-1#73	0	3	3	P42771-1	264	267	+	3	P42771-1	147	354	ENST00000530628.2	270	477	++	152	P42771-1#73	0	3	ENST00000530628.2	387	390	+	3	0	0	8485
P42771-1#73	0	3	3	P42771-1	264	267	+	3	P42771-1	153	468	ENST00000498628.6	484	799	++	128	P42771-1#73	0	3	ENST00000498628.6	595	598	+	3	0	0	8486
P42771-1#73	0	3	3	P42771-1	264	267	+	3	P42771-1	0	462	ENST00000498124.1	39	501	++	126	P42771-1#73	0	3	ENST00000498124.1	303	306	+	3	0	0	8487
P42771-1#73	0	3	3	P42771-1	264	267	+	3	P42771-1	153	457	ENST00000497750.1	75	379	+	125	P42771-1#73	0	3	ENST00000497750.1	186	189	+	3	0	0	8488
P42771-1#73	0	3	3	P42771-1	264	267	+	3	P42771-1	153	468	ENST00000494262.5	624	939	++	120	P42771-1#73	0	3	ENST00000494262.5	735	738	+	3	0	0	8489
P42771-1#73	0	3	3	P42771-1	264	267	+	3	P42771-1	153	457	ENST00000479692.2	15	319	+	114	P42771-1#73	0	3	ENST00000479692.2	126	129	+	3	0	0	8490
P42771-1#73	0	3	3	P42771-1	264	267	+	3	P42771-1	0	468	ENST00000304494.10	30	498	++	22	P42771-1#73	0	3	ENST00000304494.10	294	297	+	3	0	0	8491
P42771-1#74	0	3	3	P42771-1	276	279	+	3	P42771-1	147	354	ENST00000579755.2	251	458	++	198	P42771-1#74	0	3	ENST00000579755.2	380	383	+	3	0	0	8492
P42771-1#74	0	3	3	P42771-1	276	279	+	3	P42771-1	0	468	ENST00000579122.1	31	425	+	195	P42771-1#74	0	3	ENST00000579122.1	307	310	+	3	0	0	8493
P42771-1#74	0	3	3	P42771-1	276	279	+	3	P42771-1	153	468	ENST00000578845.2	127	442	++	193	P42771-1#74	0	3	ENST00000578845.2	250	253	+	3	0	0	8494
P42771-1#74	0	3	3	P42771-1	276	279	+	3	P42771-1	147	354	ENST00000530628.2	270	477	++	152	P42771-1#74	0	3	ENST00000530628.2	399	402	+	3	0	0	8495
P42771-1#74	0	3	3	P42771-1	276	279	+	3	P42771-1	153	468	ENST00000498628.6	484	799	++	128	P42771-1#74	0	3	ENST00000498628.6	607	610	+	3	0	0	8496
P42771-1#74	0	3	3	P42771-1	276	279	+	3	P42771-1	0	462	ENST00000498124.1	39	501	++	126	P42771-1#74	0	3	ENST00000498124.1	315	318	+	3	0	0	8497
P42771-1#74	0	3	3	P42771-1	276	279	+	3	P42771-1	153	457	ENST00000497750.1	75	379	+	125	P42771-1#74	0	3	ENST00000497750.1	198	201	+	3	0	0	8498
P42771-1#74	0	3	3	P42771-1	276	279	+	3	P42771-1	153	468	ENST00000494262.5	624	939	++	120	P42771-1#74	0	3	ENST00000494262.5	747	750	+	3	0	0	8499
P42771-1#74	0	3	3	P42771-1	276	279	+	3	P42771-1	153	457	ENST00000479692.2	15	319	+	114	P42771-1#74	0	3	ENST00000479692.2	138	141	+	3	0	0	8500
P42771-1#74	0	3	3	P42771-1	276	279	+	3	P42771-1	0	468	ENST00000304494.10	30	498	++	22	P42771-1#74	0	3	ENST00000304494.10	306	309	+	3	0	0	8501
P42771-1#75	0	3	3	P42771-1	279	282	+	3	P42771-1	147	354	ENST00000579755.2	251	458	++	198	P42771-1#75	0	3	ENST00000579755.2	383	386	+	3	0	0	8502
P42771-1#75	0	3	3	P42771-1	279	282	+	3	P42771-1	0	468	ENST00000579122.1	31	425	+	195	P42771-1#75	0	3	ENST00000579122.1	310	313	+	3	0	0	8503
P42771-1#75	0	3	3	P42771-1	279	282	+	3	P42771-1	153	468	ENST00000578845.2	127	442	++	193	P42771-1#75	0	3	ENST00000578845.2	253	256	+	3	0	0	8504
P42771-1#75	0	3	3	P42771-1	279	282	+	3	P42771-1	147	354	ENST00000530628.2	270	477	++	152	P42771-1#75	0	3	ENST00000530628.2	402	405	+	3	0	0	8505
P42771-1#75	0	3	3	P42771-1	279	282	+	3	P42771-1	153	468	ENST00000498628.6	484	799	++	128	P42771-1#75	0	3	ENST00000498628.6	610	613	+	3	0	0	8506
P42771-1#75	0	3	3	P42771-1	279	282	+	3	P42771-1	0	462	ENST00000498124.1	39	501	++	126	P42771-1#75	0	3	ENST00000498124.1	318	321	+	3	0	0	8507
P42771-1#75	0	3	3	P42771-1	279	282	+	3	P42771-1	153	457	ENST00000497750.1	75	379	+	125	P42771-1#75	0	3	ENST00000497750.1	201	204	+	3	0	0	8508
P42771-1#75	0	3	3	P42771-1	279	282	+	3	P42771-1	153	468	ENST00000494262.5	624	939	++	120	P42771-1#75	0	3	ENST00000494262.5	750	753	+	3	0	0	8509
P42771-1#75	0	3	3	P42771-1	279	282	+	3	P42771-1	153	457	ENST00000479692.2	15	319	+	114	P42771-1#75	0	3	ENST00000479692.2	141	144	+	3	0	0	8510
P42771-1#75	0	3	3	P42771-1	279	282	+	3	P42771-1	0	468	ENST00000304494.10	30	498	++	22	P42771-1#75	0	3	ENST00000304494.10	309	312	+	3	0	0	8511
P42771-1#76	0	3	3	P42771-1	282	285	+	3	P42771-1	147	354	ENST00000579755.2	251	458	++	198	P42771-1#76	0	3	ENST00000579755.2	386	389	+	3	0	0	8512
P42771-1#76	0	3	3	P42771-1	282	285	+	3	P42771-1	0	468	ENST00000579122.1	31	425	+	195	P42771-1#76	0	3	ENST00000579122.1	313	316	+	3	0	0	8513
P42771-1#76	0	3	3	P42771-1	282	285	+	3	P42771-1	153	468	ENST00000578845.2	127	442	++	193	P42771-1#76	0	3	ENST00000578845.2	256	259	+	3	0	0	8514
P42771-1#76	0	3	3	P42771-1	282	285	+	3	P42771-1	147	354	ENST00000530628.2	270	477	++	152	P42771-1#76	0	3	ENST00000530628.2	405	408	+	3	0	0	8515
P42771-1#76	0	3	3	P42771-1	282	285	+	3	P42771-1	153	468	ENST00000498628.6	484	799	++	128	P42771-1#76	0	3	ENST00000498628.6	613	616	+	3	0	0	8516
P42771-1#76	0	3	3	P42771-1	282	285	+	3	P42771-1	0	462	ENST00000498124.1	39	501	++	126	P42771-1#76	0	3	ENST00000498124.1	321	324	+	3	0	0	8517
P42771-1#76	0	3	3	P42771-1	282	285	+	3	P42771-1	153	457	ENST00000497750.1	75	379	+	125	P42771-1#76	0	3	ENST00000497750.1	204	207	+	3	0	0	8518
P42771-1#76	0	3	3	P42771-1	282	285	+	3	P42771-1	153	468	ENST00000494262.5	624	939	++	120	P42771-1#76	0	3	ENST00000494262.5	753	756	+	3	0	0	8519
P42771-1#76	0	3	3	P42771-1	282	285	+	3	P42771-1	153	457	ENST00000479692.2	15	319	+	114	P42771-1#76	0	3	ENST00000479692.2	144	147	+	3	0	0	8520
P42771-1#76	0	3	3	P42771-1	282	285	+	3	P42771-1	0	468	ENST00000304494.10	30	498	++	22	P42771-1#76	0	3	ENST00000304494.10	312	315	+	3	0	0	8521
P42771-1#77	0	3	3	P42771-1	288	291	+	3	P42771-1	147	354	ENST00000579755.2	251	458	++	198	P42771-1#77	0	3	ENST00000579755.2	392	395	+	3	0	0	8522
P42771-1#77	0	3	3	P42771-1	288	291	+	3	P42771-1	0	468	ENST00000579122.1	31	425	+	195	P42771-1#77	0	3	ENST00000579122.1	319	322	+	3	0	0	8523
P42771-1#77	0	3	3	P42771-1	288	291	+	3	P42771-1	153	468	ENST00000578845.2	127	442	++	193	P42771-1#77	0	3	ENST00000578845.2	262	265	+	3	0	0	8524
P42771-1#77	0	3	3	P42771-1	288	291	+	3	P42771-1	147	354	ENST00000530628.2	270	477	++	152	P42771-1#77	0	3	ENST00000530628.2	411	414	+	3	0	0	8525
P42771-1#77	0	3	3	P42771-1	288	291	+	3	P42771-1	153	468	ENST00000498628.6	484	799	++	128	P42771-1#77	0	3	ENST00000498628.6	619	622	+	3	0	0	8526
P42771-1#77	0	3	3	P42771-1	288	291	+	3	P42771-1	0	462	ENST00000498124.1	39	501	++	126	P42771-1#77	0	3	ENST00000498124.1	327	330	+	3	0	0	8527
P42771-1#77	0	3	3	P42771-1	288	291	+	3	P42771-1	153	457	ENST00000497750.1	75	379	+	125	P42771-1#77	0	3	ENST00000497750.1	210	213	+	3	0	0	8528
P42771-1#77	0	3	3	P42771-1	288	291	+	3	P42771-1	153	468	ENST00000494262.5	624	939	++	120	P42771-1#77	0	3	ENST00000494262.5	759	762	+	3	0	0	8529
P42771-1#77	0	3	3	P42771-1	288	291	+	3	P42771-1	153	457	ENST00000479692.2	15	319	+	114	P42771-1#77	0	3	ENST00000479692.2	150	153	+	3	0	0	8530
P42771-1#77	0	3	3	P42771-1	288	291	+	3	P42771-1	0	468	ENST00000304494.10	30	498	++	22	P42771-1#77	0	3	ENST00000304494.10	318	321	+	3	0	0	8531
P42771-1#78	0	3	3	P42771-1	291	294	+	3	P42771-1	147	354	ENST00000579755.2	251	458	++	198	P42771-1#78	0	3	ENST00000579755.2	395	398	+	3	0	0	8532
P42771-1#78	0	3	3	P42771-1	291	294	+	3	P42771-1	0	468	ENST00000579122.1	31	425	+	195	P42771-1#78	0	3	ENST00000579122.1	322	325	+	3	0	0	8533
P42771-1#78	0	3	3	P42771-1	291	294	+	3	P42771-1	153	468	ENST00000578845.2	127	442	++	193	P42771-1#78	0	3	ENST00000578845.2	265	268	+	3	0	0	8534
P42771-1#78	0	3	3	P42771-1	291	294	+	3	P42771-1	147	354	ENST00000530628.2	270	477	++	152	P42771-1#78	0	3	ENST00000530628.2	414	417	+	3	0	0	8535
P42771-1#78	0	3	3	P42771-1	291	294	+	3	P42771-1	153	468	ENST00000498628.6	484	799	++	128	P42771-1#78	0	3	ENST00000498628.6	622	625	+	3	0	0	8536
P42771-1#78	0	3	3	P42771-1	291	294	+	3	P42771-1	0	462	ENST00000498124.1	39	501	++	126	P42771-1#78	0	3	ENST00000498124.1	330	333	+	3	0	0	8537
P42771-1#78	0	3	3	P42771-1	291	294	+	3	P42771-1	153	457	ENST00000497750.1	75	379	+	125	P42771-1#78	0	3	ENST00000497750.1	213	216	+	3	0	0	8538
P42771-1#78	0	3	3	P42771-1	291	294	+	3	P42771-1	153	468	ENST00000494262.5	624	939	++	120	P42771-1#78	0	3	ENST00000494262.5	762	765	+	3	0	0	8539
P42771-1#78	0	3	3	P42771-1	291	294	+	3	P42771-1	153	457	ENST00000479692.2	15	319	+	114	P42771-1#78	0	3	ENST00000479692.2	153	156	+	3	0	0	8540
P42771-1#78	0	3	3	P42771-1	291	294	+	3	P42771-1	0	468	ENST00000304494.10	30	498	++	22	P42771-1#78	0	3	ENST00000304494.10	321	324	+	3	0	0	8541
P42771-1#79	0	3	3	P42771-1	291	294	+	3	P42771-1	147	354	ENST00000579755.2	251	458	++	198	P42771-1#79	0	3	ENST00000579755.2	395	398	+	3	0	0	8542
P42771-1#79	0	3	3	P42771-1	291	294	+	3	P42771-1	0	468	ENST00000579122.1	31	425	+	195	P42771-1#79	0	3	ENST00000579122.1	322	325	+	3	0	0	8543
P42771-1#79	0	3	3	P42771-1	291	294	+	3	P42771-1	153	468	ENST00000578845.2	127	442	++	193	P42771-1#79	0	3	ENST00000578845.2	265	268	+	3	0	0	8544
P42771-1#79	0	3	3	P42771-1	291	294	+	3	P42771-1	147	354	ENST00000530628.2	270	477	++	152	P42771-1#79	0	3	ENST00000530628.2	414	417	+	3	0	0	8545
P42771-1#79	0	3	3	P42771-1	291	294	+	3	P42771-1	153	468	ENST00000498628.6	484	799	++	128	P42771-1#79	0	3	ENST00000498628.6	622	625	+	3	0	0	8546
P42771-1#79	0	3	3	P42771-1	291	294	+	3	P42771-1	0	462	ENST00000498124.1	39	501	++	126	P42771-1#79	0	3	ENST00000498124.1	330	333	+	3	0	0	8547
P42771-1#79	0	3	3	P42771-1	291	294	+	3	P42771-1	153	457	ENST00000497750.1	75	379	+	125	P42771-1#79	0	3	ENST00000497750.1	213	216	+	3	0	0	8548
P42771-1#79	0	3	3	P42771-1	291	294	+	3	P42771-1	153	468	ENST00000494262.5	624	939	++	120	P42771-1#79	0	3	ENST00000494262.5	762	765	+	3	0	0	8549
P42771-1#79	0	3	3	P42771-1	291	294	+	3	P42771-1	153	457	ENST00000479692.2	15	319	+	114	P42771-1#79	0	3	ENST00000479692.2	153	156	+	3	0	0	8550
P42771-1#79	0	3	3	P42771-1	291	294	+	3	P42771-1	0	468	ENST00000304494.10	30	498	++	22	P42771-1#79	0	3	ENST00000304494.10	321	324	+	3	0	0	8551
P42771-1#80	0	3	3	P42771-1	294	297	+	3	P42771-1	147	354	ENST00000579755.2	251	458	++	198	P42771-1#80	0	3	ENST00000579755.2	398	401	+	3	0	0	8552
P42771-1#80	0	3	3	P42771-1	294	297	+	3	P42771-1	0	468	ENST00000579122.1	31	425	+	195	P42771-1#80	0	3	ENST00000579122.1	325	328	+	3	0	0	8553
P42771-1#80	0	3	3	P42771-1	294	297	+	3	P42771-1	153	468	ENST00000578845.2	127	442	++	193	P42771-1#80	0	3	ENST00000578845.2	268	271	+	3	0	0	8554
P42771-1#80	0	3	3	P42771-1	294	297	+	3	P42771-1	147	354	ENST00000530628.2	270	477	++	152	P42771-1#80	0	3	ENST00000530628.2	417	420	+	3	0	0	8555
P42771-1#80	0	3	3	P42771-1	294	297	+	3	P42771-1	153	468	ENST00000498628.6	484	799	++	128	P42771-1#80	0	3	ENST00000498628.6	625	628	+	3	0	0	8556
P42771-1#80	0	3	3	P42771-1	294	297	+	3	P42771-1	0	462	ENST00000498124.1	39	501	++	126	P42771-1#80	0	3	ENST00000498124.1	333	336	+	3	0	0	8557
P42771-1#80	0	3	3	P42771-1	294	297	+	3	P42771-1	153	457	ENST00000497750.1	75	379	+	125	P42771-1#80	0	3	ENST00000497750.1	216	219	+	3	0	0	8558
P42771-1#80	0	3	3	P42771-1	294	297	+	3	P42771-1	153	468	ENST00000494262.5	624	939	++	120	P42771-1#80	0	3	ENST00000494262.5	765	768	+	3	0	0	8559
P42771-1#80	0	3	3	P42771-1	294	297	+	3	P42771-1	153	457	ENST00000479692.2	15	319	+	114	P42771-1#80	0	3	ENST00000479692.2	156	159	+	3	0	0	8560
P42771-1#80	0	3	3	P42771-1	294	297	+	3	P42771-1	0	468	ENST00000304494.10	30	498	++	22	P42771-1#80	0	3	ENST00000304494.10	324	327	+	3	0	0	8561
P42771-1#81	0	3	3	P42771-1	294	297	+	3	P42771-1	147	354	ENST00000579755.2	251	458	++	198	P42771-1#81	0	3	ENST00000579755.2	398	401	+	3	0	0	8562
P42771-1#81	0	3	3	P42771-1	294	297	+	3	P42771-1	0	468	ENST00000579122.1	31	425	+	195	P42771-1#81	0	3	ENST00000579122.1	325	328	+	3	0	0	8563
P42771-1#81	0	3	3	P42771-1	294	297	+	3	P42771-1	153	468	ENST00000578845.2	127	442	++	193	P42771-1#81	0	3	ENST00000578845.2	268	271	+	3	0	0	8564
P42771-1#81	0	3	3	P42771-1	294	297	+	3	P42771-1	147	354	ENST00000530628.2	270	477	++	152	P42771-1#81	0	3	ENST00000530628.2	417	420	+	3	0	0	8565
P42771-1#81	0	3	3	P42771-1	294	297	+	3	P42771-1	153	468	ENST00000498628.6	484	799	++	128	P42771-1#81	0	3	ENST00000498628.6	625	628	+	3	0	0	8566
P42771-1#81	0	3	3	P42771-1	294	297	+	3	P42771-1	0	462	ENST00000498124.1	39	501	++	126	P42771-1#81	0	3	ENST00000498124.1	333	336	+	3	0	0	8567
P42771-1#81	0	3	3	P42771-1	294	297	+	3	P42771-1	153	457	ENST00000497750.1	75	379	+	125	P42771-1#81	0	3	ENST00000497750.1	216	219	+	3	0	0	8568
P42771-1#81	0	3	3	P42771-1	294	297	+	3	P42771-1	153	468	ENST00000494262.5	624	939	++	120	P42771-1#81	0	3	ENST00000494262.5	765	768	+	3	0	0	8569
P42771-1#81	0	3	3	P42771-1	294	297	+	3	P42771-1	153	457	ENST00000479692.2	15	319	+	114	P42771-1#81	0	3	ENST00000479692.2	156	159	+	3	0	0	8570
P42771-1#81	0	3	3	P42771-1	294	297	+	3	P42771-1	0	468	ENST00000304494.10	30	498	++	22	P42771-1#81	0	3	ENST00000304494.10	324	327	+	3	0	0	8571
P42771-1#82	0	3	3	P42771-1	294	297	+	3	P42771-1	147	354	ENST00000579755.2	251	458	++	198	P42771-1#82	0	3	ENST00000579755.2	398	401	+	3	0	0	8572
P42771-1#82	0	3	3	P42771-1	294	297	+	3	P42771-1	0	468	ENST00000579122.1	31	425	+	195	P42771-1#82	0	3	ENST00000579122.1	325	328	+	3	0	0	8573
P42771-1#82	0	3	3	P42771-1	294	297	+	3	P42771-1	153	468	ENST00000578845.2	127	442	++	193	P42771-1#82	0	3	ENST00000578845.2	268	271	+	3	0	0	8574
P42771-1#82	0	3	3	P42771-1	294	297	+	3	P42771-1	147	354	ENST00000530628.2	270	477	++	152	P42771-1#82	0	3	ENST00000530628.2	417	420	+	3	0	0	8575
P42771-1#82	0	3	3	P42771-1	294	297	+	3	P42771-1	153	468	ENST00000498628.6	484	799	++	128	P42771-1#82	0	3	ENST00000498628.6	625	628	+	3	0	0	8576
P42771-1#82	0	3	3	P42771-1	294	297	+	3	P42771-1	0	462	ENST00000498124.1	39	501	++	126	P42771-1#82	0	3	ENST00000498124.1	333	336	+	3	0	0	8577
P42771-1#82	0	3	3	P42771-1	294	297	+	3	P42771-1	153	457	ENST00000497750.1	75	379	+	125	P42771-1#82	0	3	ENST00000497750.1	216	219	+	3	0	0	8578
P42771-1#82	0	3	3	P42771-1	294	297	+	3	P42771-1	153	468	ENST00000494262.5	624	939	++	120	P42771-1#82	0	3	ENST00000494262.5	765	768	+	3	0	0	8579
P42771-1#82	0	3	3	P42771-1	294	297	+	3	P42771-1	153	457	ENST00000479692.2	15	319	+	114	P42771-1#82	0	3	ENST00000479692.2	156	159	+	3	0	0	8580
P42771-1#82	0	3	3	P42771-1	294	297	+	3	P42771-1	0	468	ENST00000304494.10	30	498	++	22	P42771-1#82	0	3	ENST00000304494.10	324	327	+	3	0	0	8581
P42771-1#83	0	3	3	P42771-1	297	300	+	3	P42771-1	147	354	ENST00000579755.2	251	458	++	198	P42771-1#83	0	3	ENST00000579755.2	401	404	+	3	0	0	8582
P42771-1#83	0	3	3	P42771-1	297	300	+	3	P42771-1	0	468	ENST00000579122.1	31	425	+	195	P42771-1#83	0	3	ENST00000579122.1	328	331	+	3	0	0	8583
P42771-1#83	0	3	3	P42771-1	297	300	+	3	P42771-1	153	468	ENST00000578845.2	127	442	++	193	P42771-1#83	0	3	ENST00000578845.2	271	274	+	3	0	0	8584
P42771-1#83	0	3	3	P42771-1	297	300	+	3	P42771-1	147	354	ENST00000530628.2	270	477	++	152	P42771-1#83	0	3	ENST00000530628.2	420	423	+	3	0	0	8585
P42771-1#83	0	3	3	P42771-1	297	300	+	3	P42771-1	153	468	ENST00000498628.6	484	799	++	128	P42771-1#83	0	3	ENST00000498628.6	628	631	+	3	0	0	8586
P42771-1#83	0	3	3	P42771-1	297	300	+	3	P42771-1	0	462	ENST00000498124.1	39	501	++	126	P42771-1#83	0	3	ENST00000498124.1	336	339	+	3	0	0	8587
P42771-1#83	0	3	3	P42771-1	297	300	+	3	P42771-1	153	457	ENST00000497750.1	75	379	+	125	P42771-1#83	0	3	ENST00000497750.1	219	222	+	3	0	0	8588
P42771-1#83	0	3	3	P42771-1	297	300	+	3	P42771-1	153	468	ENST00000494262.5	624	939	++	120	P42771-1#83	0	3	ENST00000494262.5	768	771	+	3	0	0	8589
P42771-1#83	0	3	3	P42771-1	297	300	+	3	P42771-1	153	457	ENST00000479692.2	15	319	+	114	P42771-1#83	0	3	ENST00000479692.2	159	162	+	3	0	0	8590
P42771-1#83	0	3	3	P42771-1	297	300	+	3	P42771-1	0	468	ENST00000304494.10	30	498	++	22	P42771-1#83	0	3	ENST00000304494.10	327	330	+	3	0	0	8591
P42771-1#84	0	3	3	P42771-1	297	300	+	3	P42771-1	147	354	ENST00000579755.2	251	458	++	198	P42771-1#84	0	3	ENST00000579755.2	401	404	+	3	0	0	8592
P42771-1#84	0	3	3	P42771-1	297	300	+	3	P42771-1	0	468	ENST00000579122.1	31	425	+	195	P42771-1#84	0	3	ENST00000579122.1	328	331	+	3	0	0	8593
P42771-1#84	0	3	3	P42771-1	297	300	+	3	P42771-1	153	468	ENST00000578845.2	127	442	++	193	P42771-1#84	0	3	ENST00000578845.2	271	274	+	3	0	0	8594
P42771-1#84	0	3	3	P42771-1	297	300	+	3	P42771-1	147	354	ENST00000530628.2	270	477	++	152	P42771-1#84	0	3	ENST00000530628.2	420	423	+	3	0	0	8595
P42771-1#84	0	3	3	P42771-1	297	300	+	3	P42771-1	153	468	ENST00000498628.6	484	799	++	128	P42771-1#84	0	3	ENST00000498628.6	628	631	+	3	0	0	8596
P42771-1#84	0	3	3	P42771-1	297	300	+	3	P42771-1	0	462	ENST00000498124.1	39	501	++	126	P42771-1#84	0	3	ENST00000498124.1	336	339	+	3	0	0	8597
P42771-1#84	0	3	3	P42771-1	297	300	+	3	P42771-1	153	457	ENST00000497750.1	75	379	+	125	P42771-1#84	0	3	ENST00000497750.1	219	222	+	3	0	0	8598
P42771-1#84	0	3	3	P42771-1	297	300	+	3	P42771-1	153	468	ENST00000494262.5	624	939	++	120	P42771-1#84	0	3	ENST00000494262.5	768	771	+	3	0	0	8599
P42771-1#84	0	3	3	P42771-1	297	300	+	3	P42771-1	153	457	ENST00000479692.2	15	319	+	114	P42771-1#84	0	3	ENST00000479692.2	159	162	+	3	0	0	8600
P42771-1#84	0	3	3	P42771-1	297	300	+	3	P42771-1	0	468	ENST00000304494.10	30	498	++	22	P42771-1#84	0	3	ENST00000304494.10	327	330	+	3	0	0	8601
P42771-1#85	0	3	3	P42771-1	300	303	+	3	P42771-1	147	354	ENST00000579755.2	251	458	++	198	P42771-1#85	0	3	ENST00000579755.2	404	407	+	3	0	0	8602
P42771-1#85	0	3	3	P42771-1	300	303	+	3	P42771-1	0	468	ENST00000579122.1	31	425	+	195	P42771-1#85	0	3	ENST00000579122.1	331	334	+	3	0	0	8603
P42771-1#85	0	3	3	P42771-1	300	303	+	3	P42771-1	153	468	ENST00000578845.2	127	442	++	193	P42771-1#85	0	3	ENST00000578845.2	274	277	+	3	0	0	8604
P42771-1#85	0	3	3	P42771-1	300	303	+	3	P42771-1	147	354	ENST00000530628.2	270	477	++	152	P42771-1#85	0	3	ENST00000530628.2	423	426	+	3	0	0	8605
P42771-1#85	0	3	3	P42771-1	300	303	+	3	P42771-1	153	468	ENST00000498628.6	484	799	++	128	P42771-1#85	0	3	ENST00000498628.6	631	634	+	3	0	0	8606
P42771-1#85	0	3	3	P42771-1	300	303	+	3	P42771-1	0	462	ENST00000498124.1	39	501	++	126	P42771-1#85	0	3	ENST00000498124.1	339	342	+	3	0	0	8607
P42771-1#85	0	3	3	P42771-1	300	303	+	3	P42771-1	153	457	ENST00000497750.1	75	379	+	125	P42771-1#85	0	3	ENST00000497750.1	222	225	+	3	0	0	8608
P42771-1#85	0	3	3	P42771-1	300	303	+	3	P42771-1	153	468	ENST00000494262.5	624	939	++	120	P42771-1#85	0	3	ENST00000494262.5	771	774	+	3	0	0	8609
P42771-1#85	0	3	3	P42771-1	300	303	+	3	P42771-1	153	457	ENST00000479692.2	15	319	+	114	P42771-1#85	0	3	ENST00000479692.2	162	165	+	3	0	0	8610
P42771-1#85	0	3	3	P42771-1	300	303	+	3	P42771-1	0	468	ENST00000304494.10	30	498	++	22	P42771-1#85	0	3	ENST00000304494.10	330	333	+	3	0	0	8611
P42771-1#86	0	3	3	P42771-1	303	306	+	3	P42771-1	147	354	ENST00000579755.2	251	458	++	198	P42771-1#86	0	3	ENST00000579755.2	407	410	+	3	0	0	8612
P42771-1#86	0	3	3	P42771-1	303	306	+	3	P42771-1	0	468	ENST00000579122.1	31	425	+	195	P42771-1#86	0	3	ENST00000579122.1	334	337	+	3	0	0	8613
P42771-1#86	0	3	3	P42771-1	303	306	+	3	P42771-1	153	468	ENST00000578845.2	127	442	++	193	P42771-1#86	0	3	ENST00000578845.2	277	280	+	3	0	0	8614
P42771-1#86	0	3	3	P42771-1	303	306	+	3	P42771-1	147	354	ENST00000530628.2	270	477	++	152	P42771-1#86	0	3	ENST00000530628.2	426	429	+	3	0	0	8615
P42771-1#86	0	3	3	P42771-1	303	306	+	3	P42771-1	153	468	ENST00000498628.6	484	799	++	128	P42771-1#86	0	3	ENST00000498628.6	634	637	+	3	0	0	8616
P42771-1#86	0	3	3	P42771-1	303	306	+	3	P42771-1	0	462	ENST00000498124.1	39	501	++	126	P42771-1#86	0	3	ENST00000498124.1	342	345	+	3	0	0	8617
P42771-1#86	0	3	3	P42771-1	303	306	+	3	P42771-1	153	457	ENST00000497750.1	75	379	+	125	P42771-1#86	0	3	ENST00000497750.1	225	228	+	3	0	0	8618
P42771-1#86	0	3	3	P42771-1	303	306	+	3	P42771-1	153	468	ENST00000494262.5	624	939	++	120	P42771-1#86	0	3	ENST00000494262.5	774	777	+	3	0	0	8619
P42771-1#86	0	3	3	P42771-1	303	306	+	3	P42771-1	153	457	ENST00000479692.2	15	319	+	114	P42771-1#86	0	3	ENST00000479692.2	165	168	+	3	0	0	8620
P42771-1#86	0	3	3	P42771-1	303	306	+	3	P42771-1	0	468	ENST00000304494.10	30	498	++	22	P42771-1#86	0	3	ENST00000304494.10	333	336	+	3	0	0	8621
P42771-1#87	0	3	3	P42771-1	303	306	+	3	P42771-1	147	354	ENST00000579755.2	251	458	++	198	P42771-1#87	0	3	ENST00000579755.2	407	410	+	3	0	0	8622
P42771-1#87	0	3	3	P42771-1	303	306	+	3	P42771-1	0	468	ENST00000579122.1	31	425	+	195	P42771-1#87	0	3	ENST00000579122.1	334	337	+	3	0	0	8623
P42771-1#87	0	3	3	P42771-1	303	306	+	3	P42771-1	153	468	ENST00000578845.2	127	442	++	193	P42771-1#87	0	3	ENST00000578845.2	277	280	+	3	0	0	8624
P42771-1#87	0	3	3	P42771-1	303	306	+	3	P42771-1	147	354	ENST00000530628.2	270	477	++	152	P42771-1#87	0	3	ENST00000530628.2	426	429	+	3	0	0	8625
P42771-1#87	0	3	3	P42771-1	303	306	+	3	P42771-1	153	468	ENST00000498628.6	484	799	++	128	P42771-1#87	0	3	ENST00000498628.6	634	637	+	3	0	0	8626
P42771-1#87	0	3	3	P42771-1	303	306	+	3	P42771-1	0	462	ENST00000498124.1	39	501	++	126	P42771-1#87	0	3	ENST00000498124.1	342	345	+	3	0	0	8627
P42771-1#87	0	3	3	P42771-1	303	306	+	3	P42771-1	153	457	ENST00000497750.1	75	379	+	125	P42771-1#87	0	3	ENST00000497750.1	225	228	+	3	0	0	8628
P42771-1#87	0	3	3	P42771-1	303	306	+	3	P42771-1	153	468	ENST00000494262.5	624	939	++	120	P42771-1#87	0	3	ENST00000494262.5	774	777	+	3	0	0	8629
P42771-1#87	0	3	3	P42771-1	303	306	+	3	P42771-1	153	457	ENST00000479692.2	15	319	+	114	P42771-1#87	0	3	ENST00000479692.2	165	168	+	3	0	0	8630
P42771-1#87	0	3	3	P42771-1	303	306	+	3	P42771-1	0	468	ENST00000304494.10	30	498	++	22	P42771-1#87	0	3	ENST00000304494.10	333	336	+	3	0	0	8631
P42771-1#88	0	6	6	P42771-1	309	315	+	6	P42771-1	147	354	ENST00000579755.2	251	458	++	198	P42771-1#88	0	6	ENST00000579755.2	413	419	+	6	0	0	8632
P42771-1#88	0	6	6	P42771-1	309	315	+	6	P42771-1	0	468	ENST00000579122.1	31	425	+	195	P42771-1#88	0	6	ENST00000579122.1	340	346	+	6	0	0	8633
P42771-1#88	0	6	6	P42771-1	309	315	+	6	P42771-1	153	468	ENST00000578845.2	127	442	++	193	P42771-1#88	0	6	ENST00000578845.2	283	289	+	6	0	0	8634
P42771-1#88	0	6	6	P42771-1	309	315	+	6	P42771-1	147	354	ENST00000530628.2	270	477	++	152	P42771-1#88	0	6	ENST00000530628.2	432	438	+	6	0	0	8635
P42771-1#88	0	6	6	P42771-1	309	315	+	6	P42771-1	153	468	ENST00000498628.6	484	799	++	128	P42771-1#88	0	6	ENST00000498628.6	640	646	+	6	0	0	8636
P42771-1#88	0	6	6	P42771-1	309	315	+	6	P42771-1	0	462	ENST00000498124.1	39	501	++	126	P42771-1#88	0	6	ENST00000498124.1	348	354	+	6	0	0	8637
P42771-1#88	0	6	6	P42771-1	309	315	+	6	P42771-1	153	457	ENST00000497750.1	75	379	+	125	P42771-1#88	0	6	ENST00000497750.1	231	237	+	6	0	0	8638
P42771-1#88	0	6	6	P42771-1	309	315	+	6	P42771-1	153	468	ENST00000494262.5	624	939	++	120	P42771-1#88	0	6	ENST00000494262.5	780	786	+	6	0	0	8639
P42771-1#88	0	6	6	P42771-1	309	315	+	6	P42771-1	153	457	ENST00000479692.2	15	319	+	114	P42771-1#88	0	6	ENST00000479692.2	171	177	+	6	0	0	8640
P42771-1#88	0	6	6	P42771-1	309	315	+	6	P42771-1	0	468	ENST00000304494.10	30	498	++	22	P42771-1#88	0	6	ENST00000304494.10	339	345	+	6	0	0	8641
P42771-1#89	0	3	3	P42771-1	318	321	+	3	P42771-1	147	354	ENST00000579755.2	251	458	++	198	P42771-1#89	0	3	ENST00000579755.2	422	425	+	3	0	0	8642
P42771-1#89	0	3	3	P42771-1	318	321	+	3	P42771-1	0	468	ENST00000579122.1	31	425	+	195	P42771-1#89	0	3	ENST00000579122.1	349	352	+	3	0	0	8643
P42771-1#89	0	3	3	P42771-1	318	321	+	3	P42771-1	153	468	ENST00000578845.2	127	442	++	193	P42771-1#89	0	3	ENST00000578845.2	292	295	+	3	0	0	8644
P42771-1#89	0	3	3	P42771-1	318	321	+	3	P42771-1	147	354	ENST00000530628.2	270	477	++	152	P42771-1#89	0	3	ENST00000530628.2	441	444	+	3	0	0	8645
P42771-1#89	0	3	3	P42771-1	318	321	+	3	P42771-1	153	468	ENST00000498628.6	484	799	++	128	P42771-1#89	0	3	ENST00000498628.6	649	652	+	3	0	0	8646
P42771-1#89	0	3	3	P42771-1	318	321	+	3	P42771-1	0	462	ENST00000498124.1	39	501	++	126	P42771-1#89	0	3	ENST00000498124.1	357	360	+	3	0	0	8647
P42771-1#89	0	3	3	P42771-1	318	321	+	3	P42771-1	153	457	ENST00000497750.1	75	379	+	125	P42771-1#89	0	3	ENST00000497750.1	240	243	+	3	0	0	8648
P42771-1#89	0	3	3	P42771-1	318	321	+	3	P42771-1	153	468	ENST00000494262.5	624	939	++	120	P42771-1#89	0	3	ENST00000494262.5	789	792	+	3	0	0	8649
P42771-1#89	0	3	3	P42771-1	318	321	+	3	P42771-1	153	457	ENST00000479692.2	15	319	+	114	P42771-1#89	0	3	ENST00000479692.2	180	183	+	3	0	0	8650
P42771-1#89	0	3	3	P42771-1	318	321	+	3	P42771-1	0	468	ENST00000304494.10	30	498	++	22	P42771-1#89	0	3	ENST00000304494.10	348	351	+	3	0	0	8651
P42771-1#90	0	3	3	P42771-1	318	321	+	3	P42771-1	147	354	ENST00000579755.2	251	458	++	198	P42771-1#90	0	3	ENST00000579755.2	422	425	+	3	0	0	8652
P42771-1#90	0	3	3	P42771-1	318	321	+	3	P42771-1	0	468	ENST00000579122.1	31	425	+	195	P42771-1#90	0	3	ENST00000579122.1	349	352	+	3	0	0	8653
P42771-1#90	0	3	3	P42771-1	318	321	+	3	P42771-1	153	468	ENST00000578845.2	127	442	++	193	P42771-1#90	0	3	ENST00000578845.2	292	295	+	3	0	0	8654
P42771-1#90	0	3	3	P42771-1	318	321	+	3	P42771-1	147	354	ENST00000530628.2	270	477	++	152	P42771-1#90	0	3	ENST00000530628.2	441	444	+	3	0	0	8655
P42771-1#90	0	3	3	P42771-1	318	321	+	3	P42771-1	153	468	ENST00000498628.6	484	799	++	128	P42771-1#90	0	3	ENST00000498628.6	649	652	+	3	0	0	8656
P42771-1#90	0	3	3	P42771-1	318	321	+	3	P42771-1	0	462	ENST00000498124.1	39	501	++	126	P42771-1#90	0	3	ENST00000498124.1	357	360	+	3	0	0	8657
P42771-1#90	0	3	3	P42771-1	318	321	+	3	P42771-1	153	457	ENST00000497750.1	75	379	+	125	P42771-1#90	0	3	ENST00000497750.1	240	243	+	3	0	0	8658
P42771-1#90	0	3	3	P42771-1	318	321	+	3	P42771-1	153	468	ENST00000494262.5	624	939	++	120	P42771-1#90	0	3	ENST00000494262.5	789	792	+	3	0	0	8659
P42771-1#90	0	3	3	P42771-1	318	321	+	3	P42771-1	153	457	ENST00000479692.2	15	319	+	114	P42771-1#90	0	3	ENST00000479692.2	180	183	+	3	0	0	8660
P42771-1#90	0	3	3	P42771-1	318	321	+	3	P42771-1	0	468	ENST00000304494.10	30	498	++	22	P42771-1#90	0	3	ENST00000304494.10	348	351	+	3	0	0	8661
P42771-1#91	0	3	3	P42771-1	321	324	+	3	P42771-1	147	354	ENST00000579755.2	251	458	++	198	P42771-1#91	0	3	ENST00000579755.2	425	428	+	3	0	0	8662
P42771-1#91	0	3	3	P42771-1	321	324	+	3	P42771-1	0	468	ENST00000579122.1	31	425	+	195	P42771-1#91	0	3	ENST00000579122.1	352	355	+	3	0	0	8663
P42771-1#91	0	3	3	P42771-1	321	324	+	3	P42771-1	153	468	ENST00000578845.2	127	442	++	193	P42771-1#91	0	3	ENST00000578845.2	295	298	+	3	0	0	8664
P42771-1#91	0	3	3	P42771-1	321	324	+	3	P42771-1	147	354	ENST00000530628.2	270	477	++	152	P42771-1#91	0	3	ENST00000530628.2	444	447	+	3	0	0	8665
P42771-1#91	0	3	3	P42771-1	321	324	+	3	P42771-1	153	468	ENST00000498628.6	484	799	++	128	P42771-1#91	0	3	ENST00000498628.6	652	655	+	3	0	0	8666
P42771-1#91	0	3	3	P42771-1	321	324	+	3	P42771-1	0	462	ENST00000498124.1	39	501	++	126	P42771-1#91	0	3	ENST00000498124.1	360	363	+	3	0	0	8667
P42771-1#91	0	3	3	P42771-1	321	324	+	3	P42771-1	153	457	ENST00000497750.1	75	379	+	125	P42771-1#91	0	3	ENST00000497750.1	243	246	+	3	0	0	8668
P42771-1#91	0	3	3	P42771-1	321	324	+	3	P42771-1	153	468	ENST00000494262.5	624	939	++	120	P42771-1#91	0	3	ENST00000494262.5	792	795	+	3	0	0	8669
P42771-1#91	0	3	3	P42771-1	321	324	+	3	P42771-1	153	457	ENST00000479692.2	15	319	+	114	P42771-1#91	0	3	ENST00000479692.2	183	186	+	3	0	0	8670
P42771-1#91	0	3	3	P42771-1	321	324	+	3	P42771-1	0	468	ENST00000304494.10	30	498	++	22	P42771-1#91	0	3	ENST00000304494.10	351	354	+	3	0	0	8671
P42771-1#92	0	3	3	P42771-1	321	324	+	3	P42771-1	147	354	ENST00000579755.2	251	458	++	198	P42771-1#92	0	3	ENST00000579755.2	425	428	+	3	0	0	8672
P42771-1#92	0	3	3	P42771-1	321	324	+	3	P42771-1	0	468	ENST00000579122.1	31	425	+	195	P42771-1#92	0	3	ENST00000579122.1	352	355	+	3	0	0	8673
P42771-1#92	0	3	3	P42771-1	321	324	+	3	P42771-1	153	468	ENST00000578845.2	127	442	++	193	P42771-1#92	0	3	ENST00000578845.2	295	298	+	3	0	0	8674
P42771-1#92	0	3	3	P42771-1	321	324	+	3	P42771-1	147	354	ENST00000530628.2	270	477	++	152	P42771-1#92	0	3	ENST00000530628.2	444	447	+	3	0	0	8675
P42771-1#92	0	3	3	P42771-1	321	324	+	3	P42771-1	153	468	ENST00000498628.6	484	799	++	128	P42771-1#92	0	3	ENST00000498628.6	652	655	+	3	0	0	8676
P42771-1#92	0	3	3	P42771-1	321	324	+	3	P42771-1	0	462	ENST00000498124.1	39	501	++	126	P42771-1#92	0	3	ENST00000498124.1	360	363	+	3	0	0	8677
P42771-1#92	0	3	3	P42771-1	321	324	+	3	P42771-1	153	457	ENST00000497750.1	75	379	+	125	P42771-1#92	0	3	ENST00000497750.1	243	246	+	3	0	0	8678
P42771-1#92	0	3	3	P42771-1	321	324	+	3	P42771-1	153	468	ENST00000494262.5	624	939	++	120	P42771-1#92	0	3	ENST00000494262.5	792	795	+	3	0	0	8679
P42771-1#92	0	3	3	P42771-1	321	324	+	3	P42771-1	153	457	ENST00000479692.2	15	319	+	114	P42771-1#92	0	3	ENST00000479692.2	183	186	+	3	0	0	8680
P42771-1#92	0	3	3	P42771-1	321	324	+	3	P42771-1	0	468	ENST00000304494.10	30	498	++	22	P42771-1#92	0	3	ENST00000304494.10	351	354	+	3	0	0	8681
P42771-1#93	0	3	3	P42771-1	333	336	+	3	P42771-1	147	354	ENST00000579755.2	251	458	++	198	P42771-1#93	0	3	ENST00000579755.2	437	440	+	3	0	0	8682
P42771-1#93	0	3	3	P42771-1	333	336	+	3	P42771-1	0	468	ENST00000579122.1	31	425	+	195	P42771-1#93	0	3	ENST00000579122.1	364	367	+	3	0	0	8683
P42771-1#93	0	3	3	P42771-1	333	336	+	3	P42771-1	153	468	ENST00000578845.2	127	442	++	193	P42771-1#93	0	3	ENST00000578845.2	307	310	+	3	0	0	8684
P42771-1#93	0	3	3	P42771-1	333	336	+	3	P42771-1	147	354	ENST00000530628.2	270	477	++	152	P42771-1#93	0	3	ENST00000530628.2	456	459	+	3	0	0	8685
P42771-1#93	0	3	3	P42771-1	333	336	+	3	P42771-1	153	468	ENST00000498628.6	484	799	++	128	P42771-1#93	0	3	ENST00000498628.6	664	667	+	3	0	0	8686
P42771-1#93	0	3	3	P42771-1	333	336	+	3	P42771-1	0	462	ENST00000498124.1	39	501	++	126	P42771-1#93	0	3	ENST00000498124.1	372	375	+	3	0	0	8687
P42771-1#93	0	3	3	P42771-1	333	336	+	3	P42771-1	153	457	ENST00000497750.1	75	379	+	125	P42771-1#93	0	3	ENST00000497750.1	255	258	+	3	0	0	8688
P42771-1#93	0	3	3	P42771-1	333	336	+	3	P42771-1	153	468	ENST00000494262.5	624	939	++	120	P42771-1#93	0	3	ENST00000494262.5	804	807	+	3	0	0	8689
P42771-1#93	0	3	3	P42771-1	333	336	+	3	P42771-1	153	457	ENST00000479692.2	15	319	+	114	P42771-1#93	0	3	ENST00000479692.2	195	198	+	3	0	0	8690
P42771-1#93	0	3	3	P42771-1	333	336	+	3	P42771-1	0	468	ENST00000304494.10	30	498	++	22	P42771-1#93	0	3	ENST00000304494.10	363	366	+	3	0	0	8691
P42771-1#94	0	3	3	P42771-1	339	342	+	3	P42771-1	147	354	ENST00000579755.2	251	458	++	198	P42771-1#94	0	3	ENST00000579755.2	443	446	+	3	0	0	8692
P42771-1#94	0	3	3	P42771-1	339	342	+	3	P42771-1	0	468	ENST00000579122.1	31	425	+	195	P42771-1#94	0	3	ENST00000579122.1	370	373	+	3	0	0	8693
P42771-1#94	0	3	3	P42771-1	339	342	+	3	P42771-1	153	468	ENST00000578845.2	127	442	++	193	P42771-1#94	0	3	ENST00000578845.2	313	316	+	3	0	0	8694
P42771-1#94	0	3	3	P42771-1	339	342	+	3	P42771-1	147	354	ENST00000530628.2	270	477	++	152	P42771-1#94	0	3	ENST00000530628.2	462	465	+	3	0	0	8695
P42771-1#94	0	3	3	P42771-1	339	342	+	3	P42771-1	153	468	ENST00000498628.6	484	799	++	128	P42771-1#94	0	3	ENST00000498628.6	670	673	+	3	0	0	8696
P42771-1#94	0	3	3	P42771-1	339	342	+	3	P42771-1	0	462	ENST00000498124.1	39	501	++	126	P42771-1#94	0	3	ENST00000498124.1	378	381	+	3	0	0	8697
P42771-1#94	0	3	3	P42771-1	339	342	+	3	P42771-1	153	457	ENST00000497750.1	75	379	+	125	P42771-1#94	0	3	ENST00000497750.1	261	264	+	3	0	0	8698
P42771-1#94	0	3	3	P42771-1	339	342	+	3	P42771-1	153	468	ENST00000494262.5	624	939	++	120	P42771-1#94	0	3	ENST00000494262.5	810	813	+	3	0	0	8699
P42771-1#94	0	3	3	P42771-1	339	342	+	3	P42771-1	153	457	ENST00000479692.2	15	319	+	114	P42771-1#94	0	3	ENST00000479692.2	201	204	+	3	0	0	8700
P42771-1#94	0	3	3	P42771-1	339	342	+	3	P42771-1	0	468	ENST00000304494.10	30	498	++	22	P42771-1#94	0	3	ENST00000304494.10	369	372	+	3	0	0	8701
P42771-1#95	0	3	3	P42771-1	339	342	+	3	P42771-1	147	354	ENST00000579755.2	251	458	++	198	P42771-1#95	0	3	ENST00000579755.2	443	446	+	3	0	0	8702
P42771-1#95	0	3	3	P42771-1	339	342	+	3	P42771-1	0	468	ENST00000579122.1	31	425	+	195	P42771-1#95	0	3	ENST00000579122.1	370	373	+	3	0	0	8703
P42771-1#95	0	3	3	P42771-1	339	342	+	3	P42771-1	153	468	ENST00000578845.2	127	442	++	193	P42771-1#95	0	3	ENST00000578845.2	313	316	+	3	0	0	8704
P42771-1#95	0	3	3	P42771-1	339	342	+	3	P42771-1	147	354	ENST00000530628.2	270	477	++	152	P42771-1#95	0	3	ENST00000530628.2	462	465	+	3	0	0	8705
P42771-1#95	0	3	3	P42771-1	339	342	+	3	P42771-1	153	468	ENST00000498628.6	484	799	++	128	P42771-1#95	0	3	ENST00000498628.6	670	673	+	3	0	0	8706
P42771-1#95	0	3	3	P42771-1	339	342	+	3	P42771-1	0	462	ENST00000498124.1	39	501	++	126	P42771-1#95	0	3	ENST00000498124.1	378	381	+	3	0	0	8707
P42771-1#95	0	3	3	P42771-1	339	342	+	3	P42771-1	153	457	ENST00000497750.1	75	379	+	125	P42771-1#95	0	3	ENST00000497750.1	261	264	+	3	0	0	8708
P42771-1#95	0	3	3	P42771-1	339	342	+	3	P42771-1	153	468	ENST00000494262.5	624	939	++	120	P42771-1#95	0	3	ENST00000494262.5	810	813	+	3	0	0	8709
P42771-1#95	0	3	3	P42771-1	339	342	+	3	P42771-1	153	457	ENST00000479692.2	15	319	+	114	P42771-1#95	0	3	ENST00000479692.2	201	204	+	3	0	0	8710
P42771-1#95	0	3	3	P42771-1	339	342	+	3	P42771-1	0	468	ENST00000304494.10	30	498	++	22	P42771-1#95	0	3	ENST00000304494.10	369	372	+	3	0	0	8711
P42771-1#96	0	3	3	P42771-1	348	351	+	3	P42771-1	147	354	ENST00000579755.2	251	458	++	198	P42771-1#96	0	3	ENST00000579755.2	452	455	+	3	0	0	8712
P42771-1#96	0	3	3	P42771-1	348	351	+	3	P42771-1	0	468	ENST00000579122.1	31	425	+	195	P42771-1#96	0	3	ENST00000579122.1	379	382	+	3	0	0	8713
P42771-1#96	0	3	3	P42771-1	348	351	+	3	P42771-1	153	468	ENST00000578845.2	127	442	++	193	P42771-1#96	0	3	ENST00000578845.2	322	325	+	3	0	0	8714
P42771-1#96	0	3	3	P42771-1	348	351	+	3	P42771-1	147	354	ENST00000530628.2	270	477	++	152	P42771-1#96	0	3	ENST00000530628.2	471	474	+	3	0	0	8715
P42771-1#96	0	3	3	P42771-1	348	351	+	3	P42771-1	153	468	ENST00000498628.6	484	799	++	128	P42771-1#96	0	3	ENST00000498628.6	679	682	+	3	0	0	8716
P42771-1#96	0	3	3	P42771-1	348	351	+	3	P42771-1	0	462	ENST00000498124.1	39	501	++	126	P42771-1#96	0	3	ENST00000498124.1	387	390	+	3	0	0	8717
P42771-1#96	0	3	3	P42771-1	348	351	+	3	P42771-1	153	457	ENST00000497750.1	75	379	+	125	P42771-1#96	0	3	ENST00000497750.1	270	273	+	3	0	0	8718
P42771-1#96	0	3	3	P42771-1	348	351	+	3	P42771-1	153	468	ENST00000494262.5	624	939	++	120	P42771-1#96	0	3	ENST00000494262.5	819	822	+	3	0	0	8719
P42771-1#96	0	3	3	P42771-1	348	351	+	3	P42771-1	153	457	ENST00000479692.2	15	319	+	114	P42771-1#96	0	3	ENST00000479692.2	210	213	+	3	0	0	8720
P42771-1#96	0	3	3	P42771-1	348	351	+	3	P42771-1	0	468	ENST00000304494.10	30	498	++	22	P42771-1#96	0	3	ENST00000304494.10	378	381	+	3	0	0	8721
P42771-1#97	0	3	3	P42771-1	351	354	+	3	P42771-1	147	354	ENST00000579755.2	251	458	++	198	P42771-1#97	0	3	ENST00000579755.2	455	458	+	3	0	0	8722
P42771-1#97	0	3	3	P42771-1	351	354	+	3	P42771-1	0	468	ENST00000579122.1	31	425	+	195	P42771-1#97	0	3	ENST00000579122.1	382	385	+	3	0	0	8723
P42771-1#97	0	3	3	P42771-1	351	354	+	3	P42771-1	153	468	ENST00000578845.2	127	442	++	193	P42771-1#97	0	3	ENST00000578845.2	325	328	+	3	0	0	8724
P42771-1#97	0	3	3	P42771-1	351	354	+	3	P42771-1	147	354	ENST00000530628.2	270	477	++	152	P42771-1#97	0	3	ENST00000530628.2	474	477	+	3	0	0	8725
P42771-1#97	0	3	3	P42771-1	351	354	+	3	P42771-1	153	468	ENST00000498628.6	484	799	++	128	P42771-1#97	0	3	ENST00000498628.6	682	685	+	3	0	0	8726
P42771-1#97	0	3	3	P42771-1	351	354	+	3	P42771-1	0	462	ENST00000498124.1	39	501	++	126	P42771-1#97	0	3	ENST00000498124.1	390	393	+	3	0	0	8727
P42771-1#97	0	3	3	P42771-1	351	354	+	3	P42771-1	153	457	ENST00000497750.1	75	379	+	125	P42771-1#97	0	3	ENST00000497750.1	273	276	+	3	0	0	8728
P42771-1#97	0	3	3	P42771-1	351	354	+	3	P42771-1	153	468	ENST00000494262.5	624	939	++	120	P42771-1#97	0	3	ENST00000494262.5	822	825	+	3	0	0	8729
P42771-1#97	0	3	3	P42771-1	351	354	+	3	P42771-1	153	457	ENST00000479692.2	15	319	+	114	P42771-1#97	0	3	ENST00000479692.2	213	216	+	3	0	0	8730
P42771-1#97	0	3	3	P42771-1	351	354	+	3	P42771-1	0	468	ENST00000304494.10	30	498	++	22	P42771-1#97	0	3	ENST00000304494.10	381	384	+	3	0	0	8731
P42771-1#98	0	3	3	P42771-1	354	357	+	3	P42771-1	0	468	ENST00000579122.1	31	425	+	195	P42771-1#98	0	3	ENST00000579122.1	385	388	+	3	0	0	8732
P42771-1#98	0	3	3	P42771-1	354	357	+	3	P42771-1	153	468	ENST00000578845.2	127	442	++	193	P42771-1#98	0	3	ENST00000578845.2	328	331	+	3	0	0	8733
P42771-1#98	0	3	3	P42771-1	354	357	+	3	P42771-1	153	468	ENST00000498628.6	484	799	++	128	P42771-1#98	0	3	ENST00000498628.6	685	688	+	3	0	0	8734
P42771-1#98	0	3	3	P42771-1	354	357	+	3	P42771-1	0	462	ENST00000498124.1	39	501	++	126	P42771-1#98	0	3	ENST00000498124.1	393	396	+	3	0	0	8735
P42771-1#98	0	3	3	P42771-1	354	357	+	3	P42771-1	153	457	ENST00000497750.1	75	379	+	125	P42771-1#98	0	3	ENST00000497750.1	276	279	+	3	0	0	8736
P42771-1#98	0	3	3	P42771-1	354	357	+	3	P42771-1	153	468	ENST00000494262.5	624	939	++	120	P42771-1#98	0	3	ENST00000494262.5	825	828	+	3	0	0	8737
P42771-1#98	0	3	3	P42771-1	354	357	+	3	P42771-1	153	457	ENST00000479692.2	15	319	+	114	P42771-1#98	0	3	ENST00000479692.2	216	219	+	3	0	0	8738
P42771-1#98	0	3	3	P42771-1	354	357	+	3	P42771-1	0	468	ENST00000304494.10	30	498	++	22	P42771-1#98	0	3	ENST00000304494.10	384	387	+	3	0	0	8739
P42771-1#99	0	3	3	P42771-1	357	360	+	3	P42771-1	0	468	ENST00000579122.1	31	425	+	195	P42771-1#99	0	3	ENST00000579122.1	388	391	+	3	0	0	8740
P42771-1#99	0	3	3	P42771-1	357	360	+	3	P42771-1	153	468	ENST00000578845.2	127	442	++	193	P42771-1#99	0	3	ENST00000578845.2	331	334	+	3	0	0	8741
P42771-1#99	0	3	3	P42771-1	357	360	+	3	P42771-1	153	468	ENST00000498628.6	484	799	++	128	P42771-1#99	0	3	ENST00000498628.6	688	691	+	3	0	0	8742
P42771-1#99	0	3	3	P42771-1	357	360	+	3	P42771-1	0	462	ENST00000498124.1	39	501	++	126	P42771-1#99	0	3	ENST00000498124.1	396	399	+	3	0	0	8743
P42771-1#99	0	3	3	P42771-1	357	360	+	3	P42771-1	153	457	ENST00000497750.1	75	379	+	125	P42771-1#99	0	3	ENST00000497750.1	279	282	+	3	0	0	8744
P42771-1#99	0	3	3	P42771-1	357	360	+	3	P42771-1	153	468	ENST00000494262.5	624	939	++	120	P42771-1#99	0	3	ENST00000494262.5	828	831	+	3	0	0	8745
P42771-1#99	0	3	3	P42771-1	357	360	+	3	P42771-1	153	457	ENST00000479692.2	15	319	+	114	P42771-1#99	0	3	ENST00000479692.2	219	222	+	3	0	0	8746
P42771-1#99	0	3	3	P42771-1	357	360	+	3	P42771-1	0	468	ENST00000304494.10	30	498	++	22	P42771-1#99	0	3	ENST00000304494.10	387	390	+	3	0	0	8747
P42771-1#100	0	3	3	P42771-1	357	360	+	3	P42771-1	0	468	ENST00000579122.1	31	425	+	195	P42771-1#100	0	3	ENST00000579122.1	388	391	+	3	0	0	8748
P42771-1#100	0	3	3	P42771-1	357	360	+	3	P42771-1	153	468	ENST00000578845.2	127	442	++	193	P42771-1#100	0	3	ENST00000578845.2	331	334	+	3	0	0	8749
P42771-1#100	0	3	3	P42771-1	357	360	+	3	P42771-1	153	468	ENST00000498628.6	484	799	++	128	P42771-1#100	0	3	ENST00000498628.6	688	691	+	3	0	0	8750
P42771-1#100	0	3	3	P42771-1	357	360	+	3	P42771-1	0	462	ENST00000498124.1	39	501	++	126	P42771-1#100	0	3	ENST00000498124.1	396	399	+	3	0	0	8751
P42771-1#100	0	3	3	P42771-1	357	360	+	3	P42771-1	153	457	ENST00000497750.1	75	379	+	125	P42771-1#100	0	3	ENST00000497750.1	279	282	+	3	0	0	8752
P42771-1#100	0	3	3	P42771-1	357	360	+	3	P42771-1	153	468	ENST00000494262.5	624	939	++	120	P42771-1#100	0	3	ENST00000494262.5	828	831	+	3	0	0	8753
P42771-1#100	0	3	3	P42771-1	357	360	+	3	P42771-1	153	457	ENST00000479692.2	15	319	+	114	P42771-1#100	0	3	ENST00000479692.2	219	222	+	3	0	0	8754
P42771-1#100	0	3	3	P42771-1	357	360	+	3	P42771-1	0	468	ENST00000304494.10	30	498	++	22	P42771-1#100	0	3	ENST00000304494.10	387	390	+	3	0	0	8755
P42771-1#101	0	3	3	P42771-1	363	366	+	3	P42771-1	0	468	ENST00000579122.1	31	425	+	195	P42771-1#101	0	3	ENST00000579122.1	394	397	+	3	0	0	8756
P42771-1#101	0	3	3	P42771-1	363	366	+	3	P42771-1	153	468	ENST00000578845.2	127	442	++	193	P42771-1#101	0	3	ENST00000578845.2	337	340	+	3	0	0	8757
P42771-1#101	0	3	3	P42771-1	363	366	+	3	P42771-1	153	468	ENST00000498628.6	484	799	++	128	P42771-1#101	0	3	ENST00000498628.6	694	697	+	3	0	0	8758
P42771-1#101	0	3	3	P42771-1	363	366	+	3	P42771-1	0	462	ENST00000498124.1	39	501	++	126	P42771-1#101	0	3	ENST00000498124.1	402	405	+	3	0	0	8759
P42771-1#101	0	3	3	P42771-1	363	366	+	3	P42771-1	153	457	ENST00000497750.1	75	379	+	125	P42771-1#101	0	3	ENST00000497750.1	285	288	+	3	0	0	8760
P42771-1#101	0	3	3	P42771-1	363	366	+	3	P42771-1	153	468	ENST00000494262.5	624	939	++	120	P42771-1#101	0	3	ENST00000494262.5	834	837	+	3	0	0	8761
P42771-1#101	0	3	3	P42771-1	363	366	+	3	P42771-1	153	457	ENST00000479692.2	15	319	+	114	P42771-1#101	0	3	ENST00000479692.2	225	228	+	3	0	0	8762
P42771-1#101	0	3	3	P42771-1	363	366	+	3	P42771-1	0	468	ENST00000304494.10	30	498	++	22	P42771-1#101	0	3	ENST00000304494.10	393	396	+	3	0	0	8763
P42771-1#102	0	3	3	P42771-1	363	366	+	3	P42771-1	0	468	ENST00000579122.1	31	425	+	195	P42771-1#102	0	3	ENST00000579122.1	394	397	+	3	0	0	8764
P42771-1#102	0	3	3	P42771-1	363	366	+	3	P42771-1	153	468	ENST00000578845.2	127	442	++	193	P42771-1#102	0	3	ENST00000578845.2	337	340	+	3	0	0	8765
P42771-1#102	0	3	3	P42771-1	363	366	+	3	P42771-1	153	468	ENST00000498628.6	484	799	++	128	P42771-1#102	0	3	ENST00000498628.6	694	697	+	3	0	0	8766
P42771-1#102	0	3	3	P42771-1	363	366	+	3	P42771-1	0	462	ENST00000498124.1	39	501	++	126	P42771-1#102	0	3	ENST00000498124.1	402	405	+	3	0	0	8767
P42771-1#102	0	3	3	P42771-1	363	366	+	3	P42771-1	153	457	ENST00000497750.1	75	379	+	125	P42771-1#102	0	3	ENST00000497750.1	285	288	+	3	0	0	8768
P42771-1#102	0	3	3	P42771-1	363	366	+	3	P42771-1	153	468	ENST00000494262.5	624	939	++	120	P42771-1#102	0	3	ENST00000494262.5	834	837	+	3	0	0	8769
P42771-1#102	0	3	3	P42771-1	363	366	+	3	P42771-1	153	457	ENST00000479692.2	15	319	+	114	P42771-1#102	0	3	ENST00000479692.2	225	228	+	3	0	0	8770
P42771-1#102	0	3	3	P42771-1	363	366	+	3	P42771-1	0	468	ENST00000304494.10	30	498	++	22	P42771-1#102	0	3	ENST00000304494.10	393	396	+	3	0	0	8771
P42771-1#103	0	3	3	P42771-1	366	369	+	3	P42771-1	0	468	ENST00000579122.1	31	425	+	195	P42771-1#103	0	3	ENST00000579122.1	397	400	+	3	0	0	8772
P42771-1#103	0	3	3	P42771-1	366	369	+	3	P42771-1	153	468	ENST00000578845.2	127	442	++	193	P42771-1#103	0	3	ENST00000578845.2	340	343	+	3	0	0	8773
P42771-1#103	0	3	3	P42771-1	366	369	+	3	P42771-1	153	468	ENST00000498628.6	484	799	++	128	P42771-1#103	0	3	ENST00000498628.6	697	700	+	3	0	0	8774
P42771-1#103	0	3	3	P42771-1	366	369	+	3	P42771-1	0	462	ENST00000498124.1	39	501	++	126	P42771-1#103	0	3	ENST00000498124.1	405	408	+	3	0	0	8775
P42771-1#103	0	3	3	P42771-1	366	369	+	3	P42771-1	153	457	ENST00000497750.1	75	379	+	125	P42771-1#103	0	3	ENST00000497750.1	288	291	+	3	0	0	8776
P42771-1#103	0	3	3	P42771-1	366	369	+	3	P42771-1	153	468	ENST00000494262.5	624	939	++	120	P42771-1#103	0	3	ENST00000494262.5	837	840	+	3	0	0	8777
P42771-1#103	0	3	3	P42771-1	366	369	+	3	P42771-1	153	457	ENST00000479692.2	15	319	+	114	P42771-1#103	0	3	ENST00000479692.2	228	231	+	3	0	0	8778
P42771-1#103	0	3	3	P42771-1	366	369	+	3	P42771-1	0	468	ENST00000304494.10	30	498	++	22	P42771-1#103	0	3	ENST00000304494.10	396	399	+	3	0	0	8779
P42771-1#104	0	3	3	P42771-1	369	372	+	3	P42771-1	0	468	ENST00000579122.1	31	425	+	195	P42771-1#104	0	3	ENST00000579122.1	400	403	+	3	0	0	8780
P42771-1#104	0	3	3	P42771-1	369	372	+	3	P42771-1	153	468	ENST00000578845.2	127	442	++	193	P42771-1#104	0	3	ENST00000578845.2	343	346	+	3	0	0	8781
P42771-1#104	0	3	3	P42771-1	369	372	+	3	P42771-1	153	468	ENST00000498628.6	484	799	++	128	P42771-1#104	0	3	ENST00000498628.6	700	703	+	3	0	0	8782
P42771-1#104	0	3	3	P42771-1	369	372	+	3	P42771-1	0	462	ENST00000498124.1	39	501	++	126	P42771-1#104	0	3	ENST00000498124.1	408	411	+	3	0	0	8783
P42771-1#104	0	3	3	P42771-1	369	372	+	3	P42771-1	153	457	ENST00000497750.1	75	379	+	125	P42771-1#104	0	3	ENST00000497750.1	291	294	+	3	0	0	8784
P42771-1#104	0	3	3	P42771-1	369	372	+	3	P42771-1	153	468	ENST00000494262.5	624	939	++	120	P42771-1#104	0	3	ENST00000494262.5	840	843	+	3	0	0	8785
P42771-1#104	0	3	3	P42771-1	369	372	+	3	P42771-1	153	457	ENST00000479692.2	15	319	+	114	P42771-1#104	0	3	ENST00000479692.2	231	234	+	3	0	0	8786
P42771-1#104	0	3	3	P42771-1	369	372	+	3	P42771-1	0	468	ENST00000304494.10	30	498	++	22	P42771-1#104	0	3	ENST00000304494.10	399	402	+	3	0	0	8787
P42771-1#105	0	3	3	P42771-1	369	372	+	3	P42771-1	0	468	ENST00000579122.1	31	425	+	195	P42771-1#105	0	3	ENST00000579122.1	400	403	+	3	0	0	8788
P42771-1#105	0	3	3	P42771-1	369	372	+	3	P42771-1	153	468	ENST00000578845.2	127	442	++	193	P42771-1#105	0	3	ENST00000578845.2	343	346	+	3	0	0	8789
P42771-1#105	0	3	3	P42771-1	369	372	+	3	P42771-1	153	468	ENST00000498628.6	484	799	++	128	P42771-1#105	0	3	ENST00000498628.6	700	703	+	3	0	0	8790
P42771-1#105	0	3	3	P42771-1	369	372	+	3	P42771-1	0	462	ENST00000498124.1	39	501	++	126	P42771-1#105	0	3	ENST00000498124.1	408	411	+	3	0	0	8791
P42771-1#105	0	3	3	P42771-1	369	372	+	3	P42771-1	153	457	ENST00000497750.1	75	379	+	125	P42771-1#105	0	3	ENST00000497750.1	291	294	+	3	0	0	8792
P42771-1#105	0	3	3	P42771-1	369	372	+	3	P42771-1	153	468	ENST00000494262.5	624	939	++	120	P42771-1#105	0	3	ENST00000494262.5	840	843	+	3	0	0	8793
P42771-1#105	0	3	3	P42771-1	369	372	+	3	P42771-1	153	457	ENST00000479692.2	15	319	+	114	P42771-1#105	0	3	ENST00000479692.2	231	234	+	3	0	0	8794
P42771-1#105	0	3	3	P42771-1	369	372	+	3	P42771-1	0	468	ENST00000304494.10	30	498	++	22	P42771-1#105	0	3	ENST00000304494.10	399	402	+	3	0	0	8795
P42771-1#106	0	3	3	P42771-1	375	378	+	3	P42771-1	0	468	ENST00000579122.1	31	425	+	195	P42771-1#106	0	3	ENST00000579122.1	406	409	+	3	0	0	8796
P42771-1#106	0	3	3	P42771-1	375	378	+	3	P42771-1	153	468	ENST00000578845.2	127	442	++	193	P42771-1#106	0	3	ENST00000578845.2	349	352	+	3	0	0	8797
P42771-1#106	0	3	3	P42771-1	375	378	+	3	P42771-1	153	468	ENST00000498628.6	484	799	++	128	P42771-1#106	0	3	ENST00000498628.6	706	709	+	3	0	0	8798
P42771-1#106	0	3	3	P42771-1	375	378	+	3	P42771-1	0	462	ENST00000498124.1	39	501	++	126	P42771-1#106	0	3	ENST00000498124.1	414	417	+	3	0	0	8799
P42771-1#106	0	3	3	P42771-1	375	378	+	3	P42771-1	153	457	ENST00000497750.1	75	379	+	125	P42771-1#106	0	3	ENST00000497750.1	297	300	+	3	0	0	8800
P42771-1#106	0	3	3	P42771-1	375	378	+	3	P42771-1	153	468	ENST00000494262.5	624	939	++	120	P42771-1#106	0	3	ENST00000494262.5	846	849	+	3	0	0	8801
P42771-1#106	0	3	3	P42771-1	375	378	+	3	P42771-1	153	457	ENST00000479692.2	15	319	+	114	P42771-1#106	0	3	ENST00000479692.2	237	240	+	3	0	0	8802
P42771-1#106	0	3	3	P42771-1	375	378	+	3	P42771-1	0	468	ENST00000304494.10	30	498	++	22	P42771-1#106	0	3	ENST00000304494.10	405	408	+	3	0	0	8803
P42771-1#107	0	3	3	P42771-1	378	381	+	3	P42771-1	0	468	ENST00000579122.1	31	425	+	195	P42771-1#107	0	3	ENST00000579122.1	409	412	+	3	0	0	8804
P42771-1#107	0	3	3	P42771-1	378	381	+	3	P42771-1	153	468	ENST00000578845.2	127	442	++	193	P42771-1#107	0	3	ENST00000578845.2	352	355	+	3	0	0	8805
P42771-1#107	0	3	3	P42771-1	378	381	+	3	P42771-1	153	468	ENST00000498628.6	484	799	++	128	P42771-1#107	0	3	ENST00000498628.6	709	712	+	3	0	0	8806
P42771-1#107	0	3	3	P42771-1	378	381	+	3	P42771-1	0	462	ENST00000498124.1	39	501	++	126	P42771-1#107	0	3	ENST00000498124.1	417	420	+	3	0	0	8807
P42771-1#107	0	3	3	P42771-1	378	381	+	3	P42771-1	153	457	ENST00000497750.1	75	379	+	125	P42771-1#107	0	3	ENST00000497750.1	300	303	+	3	0	0	8808
P42771-1#107	0	3	3	P42771-1	378	381	+	3	P42771-1	153	468	ENST00000494262.5	624	939	++	120	P42771-1#107	0	3	ENST00000494262.5	849	852	+	3	0	0	8809
P42771-1#107	0	3	3	P42771-1	378	381	+	3	P42771-1	153	457	ENST00000479692.2	15	319	+	114	P42771-1#107	0	3	ENST00000479692.2	240	243	+	3	0	0	8810
P42771-1#107	0	3	3	P42771-1	378	381	+	3	P42771-1	0	468	ENST00000304494.10	30	498	++	22	P42771-1#107	0	3	ENST00000304494.10	408	411	+	3	0	0	8811
P42771-1#108	0	3	3	P42771-1	393	396	+	3	P42771-1	153	468	ENST00000578845.2	127	442	++	193	P42771-1#108	0	3	ENST00000578845.2	367	370	+	3	0	0	8812
P42771-1#108	0	3	3	P42771-1	393	396	+	3	P42771-1	153	468	ENST00000498628.6	484	799	++	128	P42771-1#108	0	3	ENST00000498628.6	724	727	+	3	0	0	8813
P42771-1#108	0	3	3	P42771-1	393	396	+	3	P42771-1	0	462	ENST00000498124.1	39	501	++	126	P42771-1#108	0	3	ENST00000498124.1	432	435	+	3	0	0	8814
P42771-1#108	0	3	3	P42771-1	393	396	+	3	P42771-1	153	457	ENST00000497750.1	75	379	+	125	P42771-1#108	0	3	ENST00000497750.1	315	318	+	3	0	0	8815
P42771-1#108	0	3	3	P42771-1	393	396	+	3	P42771-1	153	468	ENST00000494262.5	624	939	++	120	P42771-1#108	0	3	ENST00000494262.5	864	867	+	3	0	0	8816
P42771-1#108	0	3	3	P42771-1	393	396	+	3	P42771-1	153	457	ENST00000479692.2	15	319	+	114	P42771-1#108	0	3	ENST00000479692.2	255	258	+	3	0	0	8817
P42771-1#108	0	3	3	P42771-1	393	396	+	3	P42771-1	0	468	ENST00000304494.10	30	498	++	22	P42771-1#108	0	3	ENST00000304494.10	423	426	+	3	0	0	8818
P42771-1#109	0	3	3	P42771-1	399	402	+	3	P42771-1	153	468	ENST00000578845.2	127	442	++	193	P42771-1#109	0	3	ENST00000578845.2	373	376	+	3	0	0	8819
P42771-1#109	0	3	3	P42771-1	399	402	+	3	P42771-1	153	468	ENST00000498628.6	484	799	++	128	P42771-1#109	0	3	ENST00000498628.6	730	733	+	3	0	0	8820
P42771-1#109	0	3	3	P42771-1	399	402	+	3	P42771-1	0	462	ENST00000498124.1	39	501	++	126	P42771-1#109	0	3	ENST00000498124.1	438	441	+	3	0	0	8821
P42771-1#109	0	3	3	P42771-1	399	402	+	3	P42771-1	153	457	ENST00000497750.1	75	379	+	125	P42771-1#109	0	3	ENST00000497750.1	321	324	+	3	0	0	8822
P42771-1#109	0	3	3	P42771-1	399	402	+	3	P42771-1	153	468	ENST00000494262.5	624	939	++	120	P42771-1#109	0	3	ENST00000494262.5	870	873	+	3	0	0	8823
P42771-1#109	0	3	3	P42771-1	399	402	+	3	P42771-1	153	457	ENST00000479692.2	15	319	+	114	P42771-1#109	0	3	ENST00000479692.2	261	264	+	3	0	0	8824
P42771-1#109	0	3	3	P42771-1	399	402	+	3	P42771-1	0	468	ENST00000304494.10	30	498	++	22	P42771-1#109	0	3	ENST00000304494.10	429	432	+	3	0	0	8825
P42771-1#110	0	3	3	P42771-1	423	426	+	3	P42771-1	153	468	ENST00000578845.2	127	442	++	193	P42771-1#110	0	3	ENST00000578845.2	397	400	+	3	0	0	8826
P42771-1#110	0	3	3	P42771-1	423	426	+	3	P42771-1	153	468	ENST00000498628.6	484	799	++	128	P42771-1#110	0	3	ENST00000498628.6	754	757	+	3	0	0	8827
P42771-1#110	0	3	3	P42771-1	423	426	+	3	P42771-1	0	462	ENST00000498124.1	39	501	++	126	P42771-1#110	0	3	ENST00000498124.1	462	465	+	3	0	0	8828
P42771-1#110	0	3	3	P42771-1	423	426	+	3	P42771-1	153	457	ENST00000497750.1	75	379	+	125	P42771-1#110	0	3	ENST00000497750.1	345	348	+	3	0	0	8829
P42771-1#110	0	3	3	P42771-1	423	426	+	3	P42771-1	153	468	ENST00000494262.5	624	939	++	120	P42771-1#110	0	3	ENST00000494262.5	894	897	+	3	0	0	8830
P42771-1#110	0	3	3	P42771-1	423	426	+	3	P42771-1	153	457	ENST00000479692.2	15	319	+	114	P42771-1#110	0	3	ENST00000479692.2	285	288	+	3	0	0	8831
P42771-1#110	0	3	3	P42771-1	423	426	+	3	P42771-1	0	468	ENST00000304494.10	30	498	++	22	P42771-1#110	0	3	ENST00000304494.10	453	456	+	3	0	0	8832
P42771-1#111	0	3	3	P42771-1	429	432	+	3	P42771-1	153	468	ENST00000578845.2	127	442	++	193	P42771-1#111	0	3	ENST00000578845.2	403	406	+	3	0	0	8833
P42771-1#111	0	3	3	P42771-1	429	432	+	3	P42771-1	153	468	ENST00000498628.6	484	799	++	128	P42771-1#111	0	3	ENST00000498628.6	760	763	+	3	0	0	8834
P42771-1#111	0	3	3	P42771-1	429	432	+	3	P42771-1	0	462	ENST00000498124.1	39	501	++	126	P42771-1#111	0	3	ENST00000498124.1	468	471	+	3	0	0	8835
P42771-1#111	0	3	3	P42771-1	429	432	+	3	P42771-1	153	457	ENST00000497750.1	75	379	+	125	P42771-1#111	0	3	ENST00000497750.1	351	354	+	3	0	0	8836
P42771-1#111	0	3	3	P42771-1	429	432	+	3	P42771-1	153	468	ENST00000494262.5	624	939	++	120	P42771-1#111	0	3	ENST00000494262.5	900	903	+	3	0	0	8837
P42771-1#111	0	3	3	P42771-1	429	432	+	3	P42771-1	153	457	ENST00000479692.2	15	319	+	114	P42771-1#111	0	3	ENST00000479692.2	291	294	+	3	0	0	8838
P42771-1#111	0	3	3	P42771-1	429	432	+	3	P42771-1	0	468	ENST00000304494.10	30	498	++	22	P42771-1#111	0	3	ENST00000304494.10	459	462	+	3	0	0	8839
P42771-1#112	0	3	3	P42771-1	441	444	+	3	P42771-1	153	468	ENST00000578845.2	127	442	++	193	P42771-1#112	0	3	ENST00000578845.2	415	418	+	3	0	0	8840
P42771-1#112	0	3	3	P42771-1	441	444	+	3	P42771-1	153	468	ENST00000498628.6	484	799	++	128	P42771-1#112	0	3	ENST00000498628.6	772	775	+	3	0	0	8841
P42771-1#112	0	3	3	P42771-1	441	444	+	3	P42771-1	0	462	ENST00000498124.1	39	501	++	126	P42771-1#112	0	3	ENST00000498124.1	480	483	+	3	0	0	8842
P42771-1#112	0	3	3	P42771-1	441	444	+	3	P42771-1	153	457	ENST00000497750.1	75	379	+	125	P42771-1#112	0	3	ENST00000497750.1	363	366	+	3	0	0	8843
P42771-1#112	0	3	3	P42771-1	441	444	+	3	P42771-1	153	468	ENST00000494262.5	624	939	++	120	P42771-1#112	0	3	ENST00000494262.5	912	915	+	3	0	0	8844
P42771-1#112	0	3	3	P42771-1	441	444	+	3	P42771-1	153	457	ENST00000479692.2	15	319	+	114	P42771-1#112	0	3	ENST00000479692.2	303	306	+	3	0	0	8845
P42771-1#112	0	3	3	P42771-1	441	444	+	3	P42771-1	0	468	ENST00000304494.10	30	498	++	22	P42771-1#112	0	3	ENST00000304494.10	471	474	+	3	0	0	8846
P42771-1#113	0	3	3	P42771-1	447	450	+	3	P42771-1	153	468	ENST00000578845.2	127	442	++	193	P42771-1#113	0	3	ENST00000578845.2	421	424	+	3	0	0	8847
P42771-1#113	0	3	3	P42771-1	447	450	+	3	P42771-1	153	468	ENST00000498628.6	484	799	++	128	P42771-1#113	0	3	ENST00000498628.6	778	781	+	3	0	0	8848
P42771-1#113	0	3	3	P42771-1	447	450	+	3	P42771-1	0	462	ENST00000498124.1	39	501	++	126	P42771-1#113	0	3	ENST00000498124.1	486	489	+	3	0	0	8849
P42771-1#113	0	3	3	P42771-1	447	450	+	3	P42771-1	153	457	ENST00000497750.1	75	379	+	125	P42771-1#113	0	3	ENST00000497750.1	369	372	+	3	0	0	8850
P42771-1#113	0	3	3	P42771-1	447	450	+	3	P42771-1	153	468	ENST00000494262.5	624	939	++	120	P42771-1#113	0	3	ENST00000494262.5	918	921	+	3	0	0	8851
P42771-1#113	0	3	3	P42771-1	447	450	+	3	P42771-1	153	457	ENST00000479692.2	15	319	+	114	P42771-1#113	0	3	ENST00000479692.2	309	312	+	3	0	0	8852
P42771-1#113	0	3	3	P42771-1	447	450	+	3	P42771-1	0	468	ENST00000304494.10	30	498	++	22	P42771-1#113	0	3	ENST00000304494.10	477	480	+	3	0	0	8853
P42771-1#114	0	9	9	P42771-1	9	18	+	9	P42771-1	0	468	ENST00000579122.1	31	425	+	195	P42771-1#114	0	9	ENST00000579122.1	40	49	+	9	0	0	8854
P42771-1#114	0	9	9	P42771-1	9	18	+	9	P42771-1	0	462	ENST00000498124.1	39	501	++	126	P42771-1#114	0	9	ENST00000498124.1	48	57	+	9	0	0	8855
P42771-1#114	0	9	9	P42771-1	9	18	+	9	P42771-1	0	153	ENST00000380151.3	0	153	++	54	P42771-1#114	0	9	ENST00000380151.3	9	18	+	9	0	0	8856
P42771-1#114	0	9	9	P42771-1	9	18	+	9	P42771-1	0	468	ENST00000304494.10	30	498	++	22	P42771-1#114	0	9	ENST00000304494.10	39	48	+	9	0	0	8857
P42771-1#115	0	24	24	P42771-1	42	66	+	24	P42771-1	0	468	ENST00000579122.1	31	425	+	195	P42771-1#115	0	24	ENST00000579122.1	73	97	+	24	0	0	8858
P42771-1#115	0	24	24	P42771-1	42	66	+	24	P42771-1	0	462	ENST00000498124.1	39	501	++	126	P42771-1#115	0	24	ENST00000498124.1	81	105	+	24	0	0	8859
P42771-1#115	0	24	24	P42771-1	42	66	+	24	P42771-1	0	153	ENST00000380151.3	0	153	++	54	P42771-1#115	0	24	ENST00000380151.3	42	66	+	24	0	0	8860
P42771-1#115	0	24	24	P42771-1	42	66	+	24	P42771-1	0	468	ENST00000304494.10	30	498	++	22	P42771-1#115	0	24	ENST00000304494.10	72	96	+	24	0	0	8861
P42771-1#116	0	24	24	P42771-1	72	96	+	24	P42771-1	0	468	ENST00000579122.1	31	425	+	195	P42771-1#116	0	24	ENST00000579122.1	103	127	+	24	0	0	8862
P42771-1#116	0	24	24	P42771-1	72	96	+	24	P42771-1	0	462	ENST00000498124.1	39	501	++	126	P42771-1#116	0	24	ENST00000498124.1	111	135	+	24	0	0	8863
P42771-1#116	0	24	24	P42771-1	72	96	+	24	P42771-1	0	153	ENST00000380151.3	0	153	++	54	P42771-1#116	0	24	ENST00000380151.3	72	96	+	24	0	0	8864
P42771-1#116	0	24	24	P42771-1	72	96	+	24	P42771-1	0	468	ENST00000304494.10	30	498	++	22	P42771-1#116	0	24	ENST00000304494.10	102	126	+	24	0	0	8865
P42771-1#117	0	9	9	P42771-1	96	105	+	9	P42771-1	0	468	ENST00000579122.1	31	425	+	195	P42771-1#117	0	9	ENST00000579122.1	127	136	+	9	0	0	8866
P42771-1#117	0	9	9	P42771-1	96	105	+	9	P42771-1	0	462	ENST00000498124.1	39	501	++	126	P42771-1#117	0	9	ENST00000498124.1	135	144	+	9	0	0	8867
P42771-1#117	0	9	9	P42771-1	96	105	+	9	P42771-1	0	153	ENST00000380151.3	0	153	++	54	P42771-1#117	0	9	ENST00000380151.3	96	105	+	9	0	0	8868
P42771-1#117	0	9	9	P42771-1	96	105	+	9	P42771-1	0	468	ENST00000304494.10	30	498	++	22	P42771-1#117	0	9	ENST00000304494.10	126	135	+	9	0	0	8869
P42771-1#118	0	9	9	P42771-1	126	135	+	9	P42771-1	0	468	ENST00000579122.1	31	425	+	195	P42771-1#118	0	9	ENST00000579122.1	157	166	+	9	0	0	8870
P42771-1#118	0	9	9	P42771-1	126	135	+	9	P42771-1	0	462	ENST00000498124.1	39	501	++	126	P42771-1#118	0	9	ENST00000498124.1	165	174	+	9	0	0	8871
P42771-1#118	0	9	9	P42771-1	126	135	+	9	P42771-1	0	153	ENST00000380151.3	0	153	++	54	P42771-1#118	0	9	ENST00000380151.3	126	135	+	9	0	0	8872
P42771-1#118	0	9	9	P42771-1	126	135	+	9	P42771-1	0	468	ENST00000304494.10	30	498	++	22	P42771-1#118	0	9	ENST00000304494.10	156	165	+	9	0	0	8873
P42771-1#119	0	9	9	P42771-1	141	150	+	9	P42771-1	147	354	ENST00000579755.2	251	458	++	198	P42771-1#119	6	9	ENST00000579755.2	251	254	+	3	6	0	8874
P42771-1#119	0	9	9	P42771-1	141	150	+	9	P42771-1	0	468	ENST00000579122.1	31	425	+	195	P42771-1#119	0	9	ENST00000579122.1	172	181	+	9	0	0	8875
P42771-1#119	0	9	9	P42771-1	141	150	+	9	P42771-1	147	354	ENST00000530628.2	270	477	++	152	P42771-1#119	6	9	ENST00000530628.2	270	273	+	3	6	0	8876
P42771-1#119	0	9	9	P42771-1	141	150	+	9	P42771-1	0	462	ENST00000498124.1	39	501	++	126	P42771-1#119	0	9	ENST00000498124.1	180	189	+	9	0	0	8877
P42771-1#119	0	9	9	P42771-1	141	150	+	9	P42771-1	0	153	ENST00000380151.3	0	153	++	54	P42771-1#119	0	9	ENST00000380151.3	141	150	+	9	0	0	8878
P42771-1#119	0	9	9	P42771-1	141	150	+	9	P42771-1	0	468	ENST00000304494.10	30	498	++	22	P42771-1#119	0	9	ENST00000304494.10	171	180	+	9	0	0	8879
P42771-1#120	0	24	24	P42771-1	168	192	+	24	P42771-1	147	354	ENST00000579755.2	251	458	++	198	P42771-1#120	0	24	ENST00000579755.2	272	296	+	24	0	0	8880
P42771-1#120	0	24	24	P42771-1	168	192	+	24	P42771-1	0	468	ENST00000579122.1	31	425	+	195	P42771-1#120	0	24	ENST00000579122.1	199	223	+	24	0	0	8881
P42771-1#120	0	24	24	P42771-1	168	192	+	24	P42771-1	153	468	ENST00000578845.2	127	442	++	193	P42771-1#120	0	24	ENST00000578845.2	142	166	+	24	0	0	8882
P42771-1#120	0	24	24	P42771-1	168	192	+	24	P42771-1	147	354	ENST00000530628.2	270	477	++	152	P42771-1#120	0	24	ENST00000530628.2	291	315	+	24	0	0	8883
P42771-1#120	0	24	24	P42771-1	168	192	+	24	P42771-1	153	468	ENST00000498628.6	484	799	++	128	P42771-1#120	0	24	ENST00000498628.6	499	523	+	24	0	0	8884
P42771-1#120	0	24	24	P42771-1	168	192	+	24	P42771-1	0	462	ENST00000498124.1	39	501	++	126	P42771-1#120	0	24	ENST00000498124.1	207	231	+	24	0	0	8885
P42771-1#120	0	24	24	P42771-1	168	192	+	24	P42771-1	153	457	ENST00000497750.1	75	379	+	125	P42771-1#120	0	24	ENST00000497750.1	90	114	+	24	0	0	8886
P42771-1#120	0	24	24	P42771-1	168	192	+	24	P42771-1	153	468	ENST00000494262.5	624	939	++	120	P42771-1#120	0	24	ENST00000494262.5	639	663	+	24	0	0	8887
P42771-1#120	0	24	24	P42771-1	168	192	+	24	P42771-1	153	457	ENST00000479692.2	15	319	+	114	P42771-1#120	0	24	ENST00000479692.2	30	54	+	24	0	0	8888
P42771-1#120	0	24	24	P42771-1	168	192	+	24	P42771-1	0	468	ENST00000304494.10	30	498	++	22	P42771-1#120	0	24	ENST00000304494.10	198	222	+	24	0	0	8889
P42771-1#121	0	9	9	P42771-1	192	201	+	9	P42771-1	147	354	ENST00000579755.2	251	458	++	198	P42771-1#121	0	9	ENST00000579755.2	296	305	+	9	0	0	8890
P42771-1#121	0	9	9	P42771-1	192	201	+	9	P42771-1	0	468	ENST00000579122.1	31	425	+	195	P42771-1#121	0	9	ENST00000579122.1	223	232	+	9	0	0	8891
P42771-1#121	0	9	9	P42771-1	192	201	+	9	P42771-1	153	468	ENST00000578845.2	127	442	++	193	P42771-1#121	0	9	ENST00000578845.2	166	175	+	9	0	0	8892
P42771-1#121	0	9	9	P42771-1	192	201	+	9	P42771-1	147	354	ENST00000530628.2	270	477	++	152	P42771-1#121	0	9	ENST00000530628.2	315	324	+	9	0	0	8893
P42771-1#121	0	9	9	P42771-1	192	201	+	9	P42771-1	153	468	ENST00000498628.6	484	799	++	128	P42771-1#121	0	9	ENST00000498628.6	523	532	+	9	0	0	8894
P42771-1#121	0	9	9	P42771-1	192	201	+	9	P42771-1	0	462	ENST00000498124.1	39	501	++	126	P42771-1#121	0	9	ENST00000498124.1	231	240	+	9	0	0	8895
P42771-1#121	0	9	9	P42771-1	192	201	+	9	P42771-1	153	457	ENST00000497750.1	75	379	+	125	P42771-1#121	0	9	ENST00000497750.1	114	123	+	9	0	0	8896
P42771-1#121	0	9	9	P42771-1	192	201	+	9	P42771-1	153	468	ENST00000494262.5	624	939	++	120	P42771-1#121	0	9	ENST00000494262.5	663	672	+	9	0	0	8897
P42771-1#121	0	9	9	P42771-1	192	201	+	9	P42771-1	153	457	ENST00000479692.2	15	319	+	114	P42771-1#121	0	9	ENST00000479692.2	54	63	+	9	0	0	8898
P42771-1#121	0	9	9	P42771-1	192	201	+	9	P42771-1	0	468	ENST00000304494.10	30	498	++	22	P42771-1#121	0	9	ENST00000304494.10	222	231	+	9	0	0	8899
P42771-1#122	0	9	9	P42771-1	222	231	+	9	P42771-1	147	354	ENST00000579755.2	251	458	++	198	P42771-1#122	0	9	ENST00000579755.2	326	335	+	9	0	0	8900
P42771-1#122	0	9	9	P42771-1	222	231	+	9	P42771-1	0	468	ENST00000579122.1	31	425	+	195	P42771-1#122	0	9	ENST00000579122.1	253	262	+	9	0	0	8901
P42771-1#122	0	9	9	P42771-1	222	231	+	9	P42771-1	153	468	ENST00000578845.2	127	442	++	193	P42771-1#122	0	9	ENST00000578845.2	196	205	+	9	0	0	8902
P42771-1#122	0	9	9	P42771-1	222	231	+	9	P42771-1	147	354	ENST00000530628.2	270	477	++	152	P42771-1#122	0	9	ENST00000530628.2	345	354	+	9	0	0	8903
P42771-1#122	0	9	9	P42771-1	222	231	+	9	P42771-1	153	468	ENST00000498628.6	484	799	++	128	P42771-1#122	0	9	ENST00000498628.6	553	562	+	9	0	0	8904
P42771-1#122	0	9	9	P42771-1	222	231	+	9	P42771-1	0	462	ENST00000498124.1	39	501	++	126	P42771-1#122	0	9	ENST00000498124.1	261	270	+	9	0	0	8905
P42771-1#122	0	9	9	P42771-1	222	231	+	9	P42771-1	153	457	ENST00000497750.1	75	379	+	125	P42771-1#122	0	9	ENST00000497750.1	144	153	+	9	0	0	8906
P42771-1#122	0	9	9	P42771-1	222	231	+	9	P42771-1	153	468	ENST00000494262.5	624	939	++	120	P42771-1#122	0	9	ENST00000494262.5	693	702	+	9	0	0	8907
P42771-1#122	0	9	9	P42771-1	222	231	+	9	P42771-1	153	457	ENST00000479692.2	15	319	+	114	P42771-1#122	0	9	ENST00000479692.2	84	93	+	9	0	0	8908
P42771-1#122	0	9	9	P42771-1	222	231	+	9	P42771-1	0	468	ENST00000304494.10	30	498	++	22	P42771-1#122	0	9	ENST00000304494.10	252	261	+	9	0	0	8909
P42771-1#123	0	24	24	P42771-1	240	264	+	24	P42771-1	147	354	ENST00000579755.2	251	458	++	198	P42771-1#123	0	24	ENST00000579755.2	344	368	+	24	0	0	8910
P42771-1#123	0	24	24	P42771-1	240	264	+	24	P42771-1	0	468	ENST00000579122.1	31	425	+	195	P42771-1#123	0	24	ENST00000579122.1	271	295	+	24	0	0	8911
P42771-1#123	0	24	24	P42771-1	240	264	+	24	P42771-1	153	468	ENST00000578845.2	127	442	++	193	P42771-1#123	0	24	ENST00000578845.2	214	238	+	24	0	0	8912
P42771-1#123	0	24	24	P42771-1	240	264	+	24	P42771-1	147	354	ENST00000530628.2	270	477	++	152	P42771-1#123	0	24	ENST00000530628.2	363	387	+	24	0	0	8913
P42771-1#123	0	24	24	P42771-1	240	264	+	24	P42771-1	153	468	ENST00000498628.6	484	799	++	128	P42771-1#123	0	24	ENST00000498628.6	571	595	+	24	0	0	8914
P42771-1#123	0	24	24	P42771-1	240	264	+	24	P42771-1	0	462	ENST00000498124.1	39	501	++	126	P42771-1#123	0	24	ENST00000498124.1	279	303	+	24	0	0	8915
P42771-1#123	0	24	24	P42771-1	240	264	+	24	P42771-1	153	457	ENST00000497750.1	75	379	+	125	P42771-1#123	0	24	ENST00000497750.1	162	186	+	24	0	0	8916
P42771-1#123	0	24	24	P42771-1	240	264	+	24	P42771-1	153	468	ENST00000494262.5	624	939	++	120	P42771-1#123	0	24	ENST00000494262.5	711	735	+	24	0	0	8917
P42771-1#123	0	24	24	P42771-1	240	264	+	24	P42771-1	153	457	ENST00000479692.2	15	319	+	114	P42771-1#123	0	24	ENST00000479692.2	102	126	+	24	0	0	8918
P42771-1#123	0	24	24	P42771-1	240	264	+	24	P42771-1	0	468	ENST00000304494.10	30	498	++	22	P42771-1#123	0	24	ENST00000304494.10	270	294	+	24	0	0	8919
P42771-1#124	0	30	30	P42771-1	270	300	+	30	P42771-1	147	354	ENST00000579755.2	251	458	++	198	P42771-1#124	0	30	ENST00000579755.2	374	404	+	30	0	0	8920
P42771-1#124	0	30	30	P42771-1	270	300	+	30	P42771-1	0	468	ENST00000579122.1	31	425	+	195	P42771-1#124	0	30	ENST00000579122.1	301	331	+	30	0	0	8921
P42771-1#124	0	30	30	P42771-1	270	300	+	30	P42771-1	153	468	ENST00000578845.2	127	442	++	193	P42771-1#124	0	30	ENST00000578845.2	244	274	+	30	0	0	8922
P42771-1#124	0	30	30	P42771-1	270	300	+	30	P42771-1	147	354	ENST00000530628.2	270	477	++	152	P42771-1#124	0	30	ENST00000530628.2	393	423	+	30	0	0	8923
P42771-1#124	0	30	30	P42771-1	270	300	+	30	P42771-1	153	468	ENST00000498628.6	484	799	++	128	P42771-1#124	0	30	ENST00000498628.6	601	631	+	30	0	0	8924
P42771-1#124	0	30	30	P42771-1	270	300	+	30	P42771-1	0	462	ENST00000498124.1	39	501	++	126	P42771-1#124	0	30	ENST00000498124.1	309	339	+	30	0	0	8925
P42771-1#124	0	30	30	P42771-1	270	300	+	30	P42771-1	153	457	ENST00000497750.1	75	379	+	125	P42771-1#124	0	30	ENST00000497750.1	192	222	+	30	0	0	8926
P42771-1#124	0	30	30	P42771-1	270	300	+	30	P42771-1	153	468	ENST00000494262.5	624	939	++	120	P42771-1#124	0	30	ENST00000494262.5	741	771	+	30	0	0	8927
P42771-1#124	0	30	30	P42771-1	270	300	+	30	P42771-1	153	457	ENST00000479692.2	15	319	+	114	P42771-1#124	0	30	ENST00000479692.2	132	162	+	30	0	0	8928
P42771-1#124	0	30	30	P42771-1	270	300	+	30	P42771-1	0	468	ENST00000304494.10	30	498	++	22	P42771-1#124	0	30	ENST00000304494.10	300	330	+	30	0	0	8929
P42771-1#125	0	9	9	P42771-1	324	333	+	9	P42771-1	147	354	ENST00000579755.2	251	458	++	198	P42771-1#125	0	9	ENST00000579755.2	428	437	+	9	0	0	8930
P42771-1#125	0	9	9	P42771-1	324	333	+	9	P42771-1	0	468	ENST00000579122.1	31	425	+	195	P42771-1#125	0	9	ENST00000579122.1	355	364	+	9	0	0	8931
P42771-1#125	0	9	9	P42771-1	324	333	+	9	P42771-1	153	468	ENST00000578845.2	127	442	++	193	P42771-1#125	0	9	ENST00000578845.2	298	307	+	9	0	0	8932
P42771-1#125	0	9	9	P42771-1	324	333	+	9	P42771-1	147	354	ENST00000530628.2	270	477	++	152	P42771-1#125	0	9	ENST00000530628.2	447	456	+	9	0	0	8933
P42771-1#125	0	9	9	P42771-1	324	333	+	9	P42771-1	153	468	ENST00000498628.6	484	799	++	128	P42771-1#125	0	9	ENST00000498628.6	655	664	+	9	0	0	8934
P42771-1#125	0	9	9	P42771-1	324	333	+	9	P42771-1	0	462	ENST00000498124.1	39	501	++	126	P42771-1#125	0	9	ENST00000498124.1	363	372	+	9	0	0	8935
P42771-1#125	0	9	9	P42771-1	324	333	+	9	P42771-1	153	457	ENST00000497750.1	75	379	+	125	P42771-1#125	0	9	ENST00000497750.1	246	255	+	9	0	0	8936
P42771-1#125	0	9	9	P42771-1	324	333	+	9	P42771-1	153	468	ENST00000494262.5	624	939	++	120	P42771-1#125	0	9	ENST00000494262.5	795	804	+	9	0	0	8937
P42771-1#125	0	9	9	P42771-1	324	333	+	9	P42771-1	153	457	ENST00000479692.2	15	319	+	114	P42771-1#125	0	9	ENST00000479692.2	186	195	+	9	0	0	8938
P42771-1#125	0	9	9	P42771-1	324	333	+	9	P42771-1	0	468	ENST00000304494.10	30	498	++	22	P42771-1#125	0	9	ENST00000304494.10	354	363	+	9	0	0	8939
P42771-1#126	0	24	24	P42771-1	339	363	+	24	P42771-1	147	354	ENST00000579755.2	251	458	++	198	P42771-1#126	0	15	ENST00000579755.2	443	458	+	15	0	9	8940
P42771-1#126	0	24	24	P42771-1	339	363	+	24	P42771-1	0	468	ENST00000579122.1	31	425	+	195	P42771-1#126	0	24	ENST00000579122.1	370	394	+	24	0	0	8941
P42771-1#126	0	24	24	P42771-1	339	363	+	24	P42771-1	153	468	ENST00000578845.2	127	442	++	193	P42771-1#126	0	24	ENST00000578845.2	313	337	+	24	0	0	8942
P42771-1#126	0	24	24	P42771-1	339	363	+	24	P42771-1	147	354	ENST00000530628.2	270	477	++	152	P42771-1#126	0	15	ENST00000530628.2	462	477	+	15	0	9	8943
P42771-1#126	0	24	24	P42771-1	339	363	+	24	P42771-1	153	468	ENST00000498628.6	484	799	++	128	P42771-1#126	0	24	ENST00000498628.6	670	694	+	24	0	0	8944
P42771-1#126	0	24	24	P42771-1	339	363	+	24	P42771-1	0	462	ENST00000498124.1	39	501	++	126	P42771-1#126	0	24	ENST00000498124.1	378	402	+	24	0	0	8945
P42771-1#126	0	24	24	P42771-1	339	363	+	24	P42771-1	153	457	ENST00000497750.1	75	379	+	125	P42771-1#126	0	24	ENST00000497750.1	261	285	+	24	0	0	8946
P42771-1#126	0	24	24	P42771-1	339	363	+	24	P42771-1	153	468	ENST00000494262.5	624	939	++	120	P42771-1#126	0	24	ENST00000494262.5	810	834	+	24	0	0	8947
P42771-1#126	0	24	24	P42771-1	339	363	+	24	P42771-1	153	457	ENST00000479692.2	15	319	+	114	P42771-1#126	0	24	ENST00000479692.2	201	225	+	24	0	0	8948
P42771-1#126	0	24	24	P42771-1	339	363	+	24	P42771-1	0	468	ENST00000304494.10	30	498	++	22	P42771-1#126	0	24	ENST00000304494.10	369	393	+	24	0	0	8949
P42771-1#127	0	21	21	P42771-1	369	390	+	21	P42771-1	0	468	ENST00000579122.1	31	425	+	195	P42771-1#127	0	14	ENST00000579122.1	400	414	+	14	0	7	8950
P42771-1#127	0	21	21	P42771-1	369	390	+	21	P42771-1	153	468	ENST00000578845.2	127	442	++	193	P42771-1#127	0	21	ENST00000578845.2	343	364	+	21	0	0	8951
P42771-1#127	0	21	21	P42771-1	369	390	+	21	P42771-1	153	468	ENST00000498628.6	484	799	++	128	P42771-1#127	0	21	ENST00000498628.6	700	721	+	21	0	0	8952
P42771-1#127	0	21	21	P42771-1	369	390	+	21	P42771-1	0	462	ENST00000498124.1	39	501	++	126	P42771-1#127	0	21	ENST00000498124.1	408	429	+	21	0	0	8953
P42771-1#127	0	21	21	P42771-1	369	390	+	21	P42771-1	153	457	ENST00000497750.1	75	379	+	125	P42771-1#127	0	21	ENST00000497750.1	291	312	+	21	0	0	8954
P42771-1#127	0	21	21	P42771-1	369	390	+	21	P42771-1	153	468	ENST00000494262.5	624	939	++	120	P42771-1#127	0	21	ENST00000494262.5	840	861	+	21	0	0	8955
P42771-1#127	0	21	21	P42771-1	369	390	+	21	P42771-1	153	457	ENST00000479692.2	15	319	+	114	P42771-1#127	0	21	ENST00000479692.2	231	252	+	21	0	0	8956
P42771-1#127	0	21	21	P42771-1	369	390	+	21	P42771-1	0	468	ENST00000304494.10	30	498	++	22	P42771-1#127	0	21	ENST00000304494.10	399	420	+	21	0	0	8957
P42771-1#128	0	9	9	P42771-1	396	405	+	9	P42771-1	153	468	ENST00000578845.2	127	442	++	193	P42771-1#128	0	9	ENST00000578845.2	370	379	+	9	0	0	8958
P42771-1#128	0	9	9	P42771-1	396	405	+	9	P42771-1	153	468	ENST00000498628.6	484	799	++	128	P42771-1#128	0	9	ENST00000498628.6	727	736	+	9	0	0	8959
P42771-1#128	0	9	9	P42771-1	396	405	+	9	P42771-1	0	462	ENST00000498124.1	39	501	++	126	P42771-1#128	0	9	ENST00000498124.1	435	444	+	9	0	0	8960
P42771-1#128	0	9	9	P42771-1	396	405	+	9	P42771-1	153	457	ENST00000497750.1	75	379	+	125	P42771-1#128	0	9	ENST00000497750.1	318	327	+	9	0	0	8961
P42771-1#128	0	9	9	P42771-1	396	405	+	9	P42771-1	153	468	ENST00000494262.5	624	939	++	120	P42771-1#128	0	9	ENST00000494262.5	867	876	+	9	0	0	8962
P42771-1#128	0	9	9	P42771-1	396	405	+	9	P42771-1	153	457	ENST00000479692.2	15	319	+	114	P42771-1#128	0	9	ENST00000479692.2	258	267	+	9	0	0	8963
P42771-1#128	0	9	9	P42771-1	396	405	+	9	P42771-1	0	468	ENST00000304494.10	30	498	++	22	P42771-1#128	0	9	ENST00000304494.10	426	435	+	9	0	0	8964
P42771-1#129	0	9	9	P42771-1	420	429	+	9	P42771-1	153	468	ENST00000578845.2	127	442	++	193	P42771-1#129	0	9	ENST00000578845.2	394	403	+	9	0	0	8965
P42771-1#129	0	9	9	P42771-1	420	429	+	9	P42771-1	153	468	ENST00000498628.6	484	799	++	128	P42771-1#129	0	9	ENST00000498628.6	751	760	+	9	0	0	8966
P42771-1#129	0	9	9	P42771-1	420	429	+	9	P42771-1	0	462	ENST00000498124.1	39	501	++	126	P42771-1#129	0	9	ENST00000498124.1	459	468	+	9	0	0	8967
P42771-1#129	0	9	9	P42771-1	420	429	+	9	P42771-1	153	457	ENST00000497750.1	75	379	+	125	P42771-1#129	0	9	ENST00000497750.1	342	351	+	9	0	0	8968
P42771-1#129	0	9	9	P42771-1	420	429	+	9	P42771-1	153	468	ENST00000494262.5	624	939	++	120	P42771-1#129	0	9	ENST00000494262.5	891	900	+	9	0	0	8969
P42771-1#129	0	9	9	P42771-1	420	429	+	9	P42771-1	153	457	ENST00000479692.2	15	319	+	114	P42771-1#129	0	9	ENST00000479692.2	282	291	+	9	0	0	8970
P42771-1#129	0	9	9	P42771-1	420	429	+	9	P42771-1	0	468	ENST00000304494.10	30	498	++	22	P42771-1#129	0	9	ENST00000304494.10	450	459	+	9	0	0	8971
P42771-1#130	0	9	9	P42771-1	432	441	+	9	P42771-1	153	468	ENST00000578845.2	127	442	++	193	P42771-1#130	0	9	ENST00000578845.2	406	415	+	9	0	0	8972
P42771-1#130	0	9	9	P42771-1	432	441	+	9	P42771-1	153	468	ENST00000498628.6	484	799	++	128	P42771-1#130	0	9	ENST00000498628.6	763	772	+	9	0	0	8973
P42771-1#130	0	9	9	P42771-1	432	441	+	9	P42771-1	0	462	ENST00000498124.1	39	501	++	126	P42771-1#130	0	9	ENST00000498124.1	471	480	+	9	0	0	8974
P42771-1#130	0	9	9	P42771-1	432	441	+	9	P42771-1	153	457	ENST00000497750.1	75	379	+	125	P42771-1#130	0	9	ENST00000497750.1	354	363	+	9	0	0	8975
P42771-1#130	0	9	9	P42771-1	432	441	+	9	P42771-1	153	468	ENST00000494262.5	624	939	++	120	P42771-1#130	0	9	ENST00000494262.5	903	912	+	9	0	0	8976
P42771-1#130	0	9	9	P42771-1	432	441	+	9	P42771-1	153	457	ENST00000479692.2	15	319	+	114	P42771-1#130	0	9	ENST00000479692.2	294	303	+	9	0	0	8977
P42771-1#130	0	9	9	P42771-1	432	441	+	9	P42771-1	0	468	ENST00000304494.10	30	498	++	22	P42771-1#130	0	9	ENST00000304494.10	462	471	+	9	0	0	8978
P42771-1#131	0	12	12	P42771-1	447	459	+	12	P42771-1	0	468	ENST00000579122.1	31	425	+	195	P42771-1#131	10	12	ENST00000579122.1	414	416	+	2	10	0	8979
P42771-1#131	0	12	12	P42771-1	447	459	+	12	P42771-1	153	468	ENST00000578845.2	127	442	++	193	P42771-1#131	0	12	ENST00000578845.2	421	433	+	12	0	0	8980
P42771-1#131	0	12	12	P42771-1	447	459	+	12	P42771-1	153	468	ENST00000498628.6	484	799	++	128	P42771-1#131	0	12	ENST00000498628.6	778	790	+	12	0	0	8981
P42771-1#131	0	12	12	P42771-1	447	459	+	12	P42771-1	0	462	ENST00000498124.1	39	501	++	126	P42771-1#131	0	12	ENST00000498124.1	486	498	+	12	0	0	8982
P42771-1#131	0	12	12	P42771-1	447	459	+	12	P42771-1	153	457	ENST00000497750.1	75	379	+	125	P42771-1#131	0	10	ENST00000497750.1	369	379	+	10	0	2	8983
P42771-1#131	0	12	12	P42771-1	447	459	+	12	P42771-1	153	468	ENST00000494262.5	624	939	++	120	P42771-1#131	0	12	ENST00000494262.5	918	930	+	12	0	0	8984
P42771-1#131	0	12	12	P42771-1	447	459	+	12	P42771-1	153	457	ENST00000479692.2	15	319	+	114	P42771-1#131	0	10	ENST00000479692.2	309	319	+	10	0	2	8985
P42771-1#131	0	12	12	P42771-1	447	459	+	12	P42771-1	0	468	ENST00000304494.10	30	498	++	22	P42771-1#131	0	12	ENST00000304494.10	477	489	+	12	0	0	8986
P42771-1#132	0	3	3	P42771-1	159	162	+	3	P42771-1	147	354	ENST00000579755.2	251	458	++	198	P42771-1#132	0	3	ENST00000579755.2	263	266	+	3	0	0	8987
P42771-1#132	0	3	3	P42771-1	159	162	+	3	P42771-1	0	468	ENST00000579122.1	31	425	+	195	P42771-1#132	0	3	ENST00000579122.1	190	193	+	3	0	0	8988
P42771-1#132	0	3	3	P42771-1	159	162	+	3	P42771-1	153	468	ENST00000578845.2	127	442	++	193	P42771-1#132	0	3	ENST00000578845.2	133	136	+	3	0	0	8989
P42771-1#132	0	3	3	P42771-1	159	162	+	3	P42771-1	147	354	ENST00000530628.2	270	477	++	152	P42771-1#132	0	3	ENST00000530628.2	282	285	+	3	0	0	8990
P42771-1#132	0	3	3	P42771-1	159	162	+	3	P42771-1	153	468	ENST00000498628.6	484	799	++	128	P42771-1#132	0	3	ENST00000498628.6	490	493	+	3	0	0	8991
P42771-1#132	0	3	3	P42771-1	159	162	+	3	P42771-1	0	462	ENST00000498124.1	39	501	++	126	P42771-1#132	0	3	ENST00000498124.1	198	201	+	3	0	0	8992
P42771-1#132	0	3	3	P42771-1	159	162	+	3	P42771-1	153	457	ENST00000497750.1	75	379	+	125	P42771-1#132	0	3	ENST00000497750.1	81	84	+	3	0	0	8993
P42771-1#132	0	3	3	P42771-1	159	162	+	3	P42771-1	153	468	ENST00000494262.5	624	939	++	120	P42771-1#132	0	3	ENST00000494262.5	630	633	+	3	0	0	8994
P42771-1#132	0	3	3	P42771-1	159	162	+	3	P42771-1	153	457	ENST00000479692.2	15	319	+	114	P42771-1#132	0	3	ENST00000479692.2	21	24	+	3	0	0	8995
P42771-1#132	0	3	3	P42771-1	159	162	+	3	P42771-1	0	468	ENST00000304494.10	30	498	++	22	P42771-1#132	0	3	ENST00000304494.10	189	192	+	3	0	0	8996
P42771-1#133	0	3	3	P42771-1	333	336	+	3	P42771-1	147	354	ENST00000579755.2	251	458	++	198	P42771-1#133	0	3	ENST00000579755.2	437	440	+	3	0	0	8997
P42771-1#133	0	3	3	P42771-1	333	336	+	3	P42771-1	0	468	ENST00000579122.1	31	425	+	195	P42771-1#133	0	3	ENST00000579122.1	364	367	+	3	0	0	8998
P42771-1#133	0	3	3	P42771-1	333	336	+	3	P42771-1	153	468	ENST00000578845.2	127	442	++	193	P42771-1#133	0	3	ENST00000578845.2	307	310	+	3	0	0	8999
P42771-1#133	0	3	3	P42771-1	333	336	+	3	P42771-1	147	354	ENST00000530628.2	270	477	++	152	P42771-1#133	0	3	ENST00000530628.2	456	459	+	3	0	0	9000
P42771-1#133	0	3	3	P42771-1	333	336	+	3	P42771-1	153	468	ENST00000498628.6	484	799	++	128	P42771-1#133	0	3	ENST00000498628.6	664	667	+	3	0	0	9001
P42771-1#133	0	3	3	P42771-1	333	336	+	3	P42771-1	0	462	ENST00000498124.1	39	501	++	126	P42771-1#133	0	3	ENST00000498124.1	372	375	+	3	0	0	9002
P42771-1#133	0	3	3	P42771-1	333	336	+	3	P42771-1	153	457	ENST00000497750.1	75	379	+	125	P42771-1#133	0	3	ENST00000497750.1	255	258	+	3	0	0	9003
P42771-1#133	0	3	3	P42771-1	333	336	+	3	P42771-1	153	468	ENST00000494262.5	624	939	++	120	P42771-1#133	0	3	ENST00000494262.5	804	807	+	3	0	0	9004
P42771-1#133	0	3	3	P42771-1	333	336	+	3	P42771-1	153	457	ENST00000479692.2	15	319	+	114	P42771-1#133	0	3	ENST00000479692.2	195	198	+	3	0	0	9005
P42771-1#133	0	3	3	P42771-1	333	336	+	3	P42771-1	0	468	ENST00000304494.10	30	498	++	22	P42771-1#133	0	3	ENST00000304494.10	363	366	+	3	0	0	9006
P30511-1#0	0	63	63	P30511-1	0	63	+	63	P30511-1	0	612	ENST00000434407.6	0	612	++	84	P30511-1#0	0	63	ENST00000434407.6	0	63	+	63	0	0	9007
P30511-1#0	0	63	63	P30511-1	0	63	+	63	P30511-1	0	1038	ENST00000376861.5	384	1422	++	53	P30511-1#0	0	63	ENST00000376861.5	384	447	+	63	0	0	9008
P30511-1#0	0	63	63	P30511-1	0	63	+	63	P30511-1	0	1038	ENST00000334668.8	124	1162	++	29	P30511-1#0	0	63	ENST00000334668.8	124	187	+	63	0	0	9009
P30511-1#0	0	63	63	P30511-1	0	63	+	63	P30511-1	0	1035	ENST00000259951.12	30	1065	++	6	P30511-1#0	0	63	ENST00000259951.12	30	93	+	63	0	0	9010
P30511-1#1	0	975	975	P30511-1	63	1038	+	975	P30511-1	893	1003	ENST00000475996.1	0	110	+	111	P30511-1#1	830	940	ENST00000475996.1	0	110	+	110	830	35	9011
P30511-1#1	0	975	975	P30511-1	63	1038	+	975	P30511-1	633	1036	ENST00000465459.2	0	403	+	108	P30511-1#1	570	973	ENST00000465459.2	0	403	+	403	570	2	9012
P30511-1#1	0	975	975	P30511-1	63	1038	+	975	P30511-1	973	1036	ENST00000444621.1	0	81	+	93	P30511-1#1	910	973	ENST00000444621.1	0	81	+	63	910	2	9013
P30511-1#1	0	975	975	P30511-1	63	1038	+	975	P30511-1	0	612	ENST00000434407.6	0	612	++	84	P30511-1#1	0	549	ENST00000434407.6	63	612	+	549	0	426	9014
P30511-1#1	0	975	975	P30511-1	63	1038	+	975	P30511-1	0	1038	ENST00000376861.5	384	1422	++	53	P30511-1#1	0	975	ENST00000376861.5	447	1422	+	975	0	0	9015
P30511-1#1	0	975	975	P30511-1	63	1038	+	975	P30511-1	0	1038	ENST00000334668.8	124	1162	++	29	P30511-1#1	0	975	ENST00000334668.8	187	1162	+	975	0	0	9016
P30511-1#1	0	975	975	P30511-1	63	1038	+	975	P30511-1	0	1035	ENST00000259951.12	30	1065	++	6	P30511-1#1	0	972	ENST00000259951.12	93	1065	+	972	0	3	9017
P30511-1#2	0	852	852	P30511-1	63	915	+	852	P30511-1	893	1003	ENST00000475996.1	0	110	+	111	P30511-1#2	830	852	ENST00000475996.1	0	22	+	22	830	0	9018
P30511-1#2	0	852	852	P30511-1	63	915	+	852	P30511-1	633	1036	ENST00000465459.2	0	403	+	108	P30511-1#2	570	852	ENST00000465459.2	0	282	+	282	570	0	9019
P30511-1#2	0	852	852	P30511-1	63	915	+	852	P30511-1	0	612	ENST00000434407.6	0	612	++	84	P30511-1#2	0	549	ENST00000434407.6	63	612	+	549	0	303	9020
P30511-1#2	0	852	852	P30511-1	63	915	+	852	P30511-1	0	1038	ENST00000376861.5	384	1422	++	53	P30511-1#2	0	852	ENST00000376861.5	447	1299	+	852	0	0	9021
P30511-1#2	0	852	852	P30511-1	63	915	+	852	P30511-1	0	1038	ENST00000334668.8	124	1162	++	29	P30511-1#2	0	852	ENST00000334668.8	187	1039	+	852	0	0	9022
P30511-1#2	0	852	852	P30511-1	63	915	+	852	P30511-1	0	1035	ENST00000259951.12	30	1065	++	6	P30511-1#2	0	852	ENST00000259951.12	93	945	+	852	0	0	9023
P30511-1#3	0	72	72	P30511-1	915	987	+	72	P30511-1	893	1003	ENST00000475996.1	0	110	+	111	P30511-1#3	0	72	ENST00000475996.1	22	94	+	72	0	0	9024
P30511-1#3	0	72	72	P30511-1	915	987	+	72	P30511-1	633	1036	ENST00000465459.2	0	403	+	108	P30511-1#3	0	72	ENST00000465459.2	282	354	+	72	0	0	9025
P30511-1#3	0	72	72	P30511-1	915	987	+	72	P30511-1	973	1036	ENST00000444621.1	0	81	+	93	P30511-1#3	58	72	ENST00000444621.1	0	14	+	14	58	0	9026
P30511-1#3	0	72	72	P30511-1	915	987	+	72	P30511-1	0	1038	ENST00000376861.5	384	1422	++	53	P30511-1#3	0	72	ENST00000376861.5	1299	1371	+	72	0	0	9027
P30511-1#3	0	72	72	P30511-1	915	987	+	72	P30511-1	0	1038	ENST00000334668.8	124	1162	++	29	P30511-1#3	0	72	ENST00000334668.8	1039	1111	+	72	0	0	9028
P30511-1#3	0	72	72	P30511-1	915	987	+	72	P30511-1	0	1035	ENST00000259951.12	30	1065	++	6	P30511-1#3	0	72	ENST00000259951.12	945	1017	+	72	0	0	9029
P30511-1#4	0	51	51	P30511-1	987	1038	+	51	P30511-1	893	1003	ENST00000475996.1	0	110	+	111	P30511-1#4	0	16	ENST00000475996.1	94	110	+	16	0	35	9030
P30511-1#4	0	51	51	P30511-1	987	1038	+	51	P30511-1	633	1036	ENST00000465459.2	0	403	+	108	P30511-1#4	0	49	ENST00000465459.2	354	403	+	49	0	2	9031
P30511-1#4	0	51	51	P30511-1	987	1038	+	51	P30511-1	973	1036	ENST00000444621.1	0	81	+	93	P30511-1#4	0	49	ENST00000444621.1	14	81	+	49	0	2	9032
P30511-1#4	0	51	51	P30511-1	987	1038	+	51	P30511-1	0	1038	ENST00000376861.5	384	1422	++	53	P30511-1#4	0	51	ENST00000376861.5	1371	1422	+	51	0	0	9033
P30511-1#4	0	51	51	P30511-1	987	1038	+	51	P30511-1	0	1038	ENST00000334668.8	124	1162	++	29	P30511-1#4	0	51	ENST00000334668.8	1111	1162	+	51	0	0	9034
P30511-1#4	0	51	51	P30511-1	987	1038	+	51	P30511-1	0	1035	ENST00000259951.12	30	1065	++	6	P30511-1#4	0	48	ENST00000259951.12	1017	1065	+	48	0	3	9035
P30511-1#5	0	273	273	P30511-1	615	888	+	273	P30511-1	633	1036	ENST00000465459.2	0	403	+	108	P30511-1#5	18	273	ENST00000465459.2	0	255	+	255	18	0	9036
P30511-1#5	0	273	273	P30511-1	615	888	+	273	P30511-1	0	1038	ENST00000376861.5	384	1422	++	53	P30511-1#5	0	273	ENST00000376861.5	999	1272	+	273	0	0	9037
P30511-1#5	0	273	273	P30511-1	615	888	+	273	P30511-1	0	1038	ENST00000334668.8	124	1162	++	29	P30511-1#5	0	273	ENST00000334668.8	739	1012	+	273	0	0	9038
P30511-1#5	0	273	273	P30511-1	615	888	+	273	P30511-1	0	1035	ENST00000259951.12	30	1065	++	6	P30511-1#5	0	273	ENST00000259951.12	645	918	+	273	0	0	9039
P30511-1#6	0	270	270	P30511-1	63	333	+	270	P30511-1	0	612	ENST00000434407.6	0	612	++	84	P30511-1#6	0	270	ENST00000434407.6	63	333	+	270	0	0	9040
P30511-1#6	0	270	270	P30511-1	63	333	+	270	P30511-1	0	1038	ENST00000376861.5	384	1422	++	53	P30511-1#6	0	270	ENST00000376861.5	447	717	+	270	0	0	9041
P30511-1#6	0	270	270	P30511-1	63	333	+	270	P30511-1	0	1038	ENST00000334668.8	124	1162	++	29	P30511-1#6	0	270	ENST00000334668.8	187	457	+	270	0	0	9042
P30511-1#6	0	270	270	P30511-1	63	333	+	270	P30511-1	0	1035	ENST00000259951.12	30	1065	++	6	P30511-1#6	0	270	ENST00000259951.12	93	363	+	270	0	0	9043
P30511-1#7	0	276	276	P30511-1	333	609	+	276	P30511-1	0	612	ENST00000434407.6	0	612	++	84	P30511-1#7	0	276	ENST00000434407.6	333	609	+	276	0	0	9044
P30511-1#7	0	276	276	P30511-1	333	609	+	276	P30511-1	0	1038	ENST00000376861.5	384	1422	++	53	P30511-1#7	0	276	ENST00000376861.5	717	993	+	276	0	0	9045
P30511-1#7	0	276	276	P30511-1	333	609	+	276	P30511-1	0	1038	ENST00000334668.8	124	1162	++	29	P30511-1#7	0	276	ENST00000334668.8	457	733	+	276	0	0	9046
P30511-1#7	0	276	276	P30511-1	333	609	+	276	P30511-1	0	1035	ENST00000259951.12	30	1065	++	6	P30511-1#7	0	276	ENST00000259951.12	363	639	+	276	0	0	9047
P30511-1#8	0	276	276	P30511-1	609	885	+	276	P30511-1	633	1036	ENST00000465459.2	0	403	+	108	P30511-1#8	24	276	ENST00000465459.2	0	252	+	252	24	0	9048
P30511-1#8	0	276	276	P30511-1	609	885	+	276	P30511-1	0	612	ENST00000434407.6	0	612	++	84	P30511-1#8	0	3	ENST00000434407.6	609	612	+	3	0	273	9049
P30511-1#8	0	276	276	P30511-1	609	885	+	276	P30511-1	0	1038	ENST00000376861.5	384	1422	++	53	P30511-1#8	0	276	ENST00000376861.5	993	1269	+	276	0	0	9050
P30511-1#8	0	276	276	P30511-1	609	885	+	276	P30511-1	0	1038	ENST00000334668.8	124	1162	++	29	P30511-1#8	0	276	ENST00000334668.8	733	1009	+	276	0	0	9051
P30511-1#8	0	276	276	P30511-1	609	885	+	276	P30511-1	0	1035	ENST00000259951.12	30	1065	++	6	P30511-1#8	0	276	ENST00000259951.12	639	915	+	276	0	0	9052
P30511-1#9	0	30	30	P30511-1	885	915	+	30	P30511-1	893	1003	ENST00000475996.1	0	110	+	111	P30511-1#9	8	30	ENST00000475996.1	0	22	+	22	8	0	9053
P30511-1#9	0	30	30	P30511-1	885	915	+	30	P30511-1	633	1036	ENST00000465459.2	0	403	+	108	P30511-1#9	0	30	ENST00000465459.2	252	282	+	30	0	0	9054
P30511-1#9	0	30	30	P30511-1	885	915	+	30	P30511-1	0	1038	ENST00000376861.5	384	1422	++	53	P30511-1#9	0	30	ENST00000376861.5	1269	1299	+	30	0	0	9055
P30511-1#9	0	30	30	P30511-1	885	915	+	30	P30511-1	0	1038	ENST00000334668.8	124	1162	++	29	P30511-1#9	0	30	ENST00000334668.8	1009	1039	+	30	0	0	9056
P30511-1#9	0	30	30	P30511-1	885	915	+	30	P30511-1	0	1035	ENST00000259951.12	30	1065	++	6	P30511-1#9	0	30	ENST00000259951.12	915	945	+	30	0	0	9057
P30511-1#10	0	9	9	P30511-1	1005	1014	+	9	P30511-1	633	1036	ENST00000465459.2	0	403	+	108	P30511-1#10	0	9	ENST00000465459.2	372	381	+	9	0	0	9058
P30511-1#10	0	9	9	P30511-1	1005	1014	+	9	P30511-1	973	1036	ENST00000444621.1	0	81	+	93	P30511-1#10	0	9	ENST00000444621.1	50	59	+	9	0	0	9059
P30511-1#10	0	9	9	P30511-1	1005	1014	+	9	P30511-1	0	1038	ENST00000376861.5	384	1422	++	53	P30511-1#10	0	9	ENST00000376861.5	1389	1398	+	9	0	0	9060
P30511-1#10	0	9	9	P30511-1	1005	1014	+	9	P30511-1	0	1038	ENST00000334668.8	124	1162	++	29	P30511-1#10	0	9	ENST00000334668.8	1129	1138	+	9	0	0	9061
P30511-1#10	0	9	9	P30511-1	1005	1014	+	9	P30511-1	0	1035	ENST00000259951.12	30	1065	++	6	P30511-1#10	0	9	ENST00000259951.12	1035	1044	+	9	0	0	9062
P30511-1#11	0	3	3	P30511-1	270	273	+	3	P30511-1	0	612	ENST00000434407.6	0	612	++	84	P30511-1#11	0	3	ENST00000434407.6	270	273	+	3	0	0	9063
P30511-1#11	0	3	3	P30511-1	270	273	+	3	P30511-1	0	1038	ENST00000376861.5	384	1422	++	53	P30511-1#11	0	3	ENST00000376861.5	654	657	+	3	0	0	9064
P30511-1#11	0	3	3	P30511-1	270	273	+	3	P30511-1	0	1038	ENST00000334668.8	124	1162	++	29	P30511-1#11	0	3	ENST00000334668.8	394	397	+	3	0	0	9065
P30511-1#11	0	3	3	P30511-1	270	273	+	3	P30511-1	0	1035	ENST00000259951.12	30	1065	++	6	P30511-1#11	0	3	ENST00000259951.12	300	303	+	3	0	0	9066
P30511-1#12	0	3	3	P30511-1	312	315	+	3	P30511-1	0	612	ENST00000434407.6	0	612	++	84	P30511-1#12	0	3	ENST00000434407.6	312	315	+	3	0	0	9067
P30511-1#12	0	3	3	P30511-1	312	315	+	3	P30511-1	0	1038	ENST00000376861.5	384	1422	++	53	P30511-1#12	0	3	ENST00000376861.5	696	699	+	3	0	0	9068
P30511-1#12	0	3	3	P30511-1	312	315	+	3	P30511-1	0	1038	ENST00000334668.8	124	1162	++	29	P30511-1#12	0	3	ENST00000334668.8	436	439	+	3	0	0	9069
P30511-1#12	0	3	3	P30511-1	312	315	+	3	P30511-1	0	1035	ENST00000259951.12	30	1065	++	6	P30511-1#12	0	3	ENST00000259951.12	342	345	+	3	0	0	9070
P30511-1#13	0	3	3	P30511-1	489	492	+	3	P30511-1	0	612	ENST00000434407.6	0	612	++	84	P30511-1#13	0	3	ENST00000434407.6	489	492	+	3	0	0	9071
P30511-1#13	0	3	3	P30511-1	489	492	+	3	P30511-1	0	1038	ENST00000376861.5	384	1422	++	53	P30511-1#13	0	3	ENST00000376861.5	873	876	+	3	0	0	9072
P30511-1#13	0	3	3	P30511-1	489	492	+	3	P30511-1	0	1038	ENST00000334668.8	124	1162	++	29	P30511-1#13	0	3	ENST00000334668.8	613	616	+	3	0	0	9073
P30511-1#13	0	3	3	P30511-1	489	492	+	3	P30511-1	0	1035	ENST00000259951.12	30	1065	++	6	P30511-1#13	0	3	ENST00000259951.12	519	522	+	3	0	0	9074
P30511-1#14	0	3	3	P30511-1	501	504	+	3	P30511-1	0	612	ENST00000434407.6	0	612	++	84	P30511-1#14	0	3	ENST00000434407.6	501	504	+	3	0	0	9075
P30511-1#14	0	3	3	P30511-1	501	504	+	3	P30511-1	0	1038	ENST00000376861.5	384	1422	++	53	P30511-1#14	0	3	ENST00000376861.5	885	888	+	3	0	0	9076
P30511-1#14	0	3	3	P30511-1	501	504	+	3	P30511-1	0	1038	ENST00000334668.8	124	1162	++	29	P30511-1#14	0	3	ENST00000334668.8	625	628	+	3	0	0	9077
P30511-1#14	0	3	3	P30511-1	501	504	+	3	P30511-1	0	1035	ENST00000259951.12	30	1065	++	6	P30511-1#14	0	3	ENST00000259951.12	531	534	+	3	0	0	9078
P30511-1#15	0	3	3	P30511-1	525	528	+	3	P30511-1	0	612	ENST00000434407.6	0	612	++	84	P30511-1#15	0	3	ENST00000434407.6	525	528	+	3	0	0	9079
P30511-1#15	0	3	3	P30511-1	525	528	+	3	P30511-1	0	1038	ENST00000376861.5	384	1422	++	53	P30511-1#15	0	3	ENST00000376861.5	909	912	+	3	0	0	9080
P30511-1#15	0	3	3	P30511-1	525	528	+	3	P30511-1	0	1038	ENST00000334668.8	124	1162	++	29	P30511-1#15	0	3	ENST00000334668.8	649	652	+	3	0	0	9081
P30511-1#15	0	3	3	P30511-1	525	528	+	3	P30511-1	0	1035	ENST00000259951.12	30	1065	++	6	P30511-1#15	0	3	ENST00000259951.12	555	558	+	3	0	0	9082
P30511-1#16	0	3	3	P30511-1	318	321	+	3	P30511-1	0	612	ENST00000434407.6	0	612	++	84	P30511-1#16	0	3	ENST00000434407.6	318	321	+	3	0	0	9083
P30511-1#16	0	3	3	P30511-1	318	321	+	3	P30511-1	0	1038	ENST00000376861.5	384	1422	++	53	P30511-1#16	0	3	ENST00000376861.5	702	705	+	3	0	0	9084
P30511-1#16	0	3	3	P30511-1	318	321	+	3	P30511-1	0	1038	ENST00000334668.8	124	1162	++	29	P30511-1#16	0	3	ENST00000334668.8	442	445	+	3	0	0	9085
P30511-1#16	0	3	3	P30511-1	318	321	+	3	P30511-1	0	1035	ENST00000259951.12	30	1065	++	6	P30511-1#16	0	3	ENST00000259951.12	348	351	+	3	0	0	9086
P30511-1#17	0	192	192	P30511-1	363	555	+	192	P30511-1	0	612	ENST00000434407.6	0	612	++	84	P30511-1#17	0	192	ENST00000434407.6	363	555	+	192	0	0	9087
P30511-1#17	0	192	192	P30511-1	363	555	+	192	P30511-1	0	1038	ENST00000376861.5	384	1422	++	53	P30511-1#17	0	192	ENST00000376861.5	747	939	+	192	0	0	9088
P30511-1#17	0	192	192	P30511-1	363	555	+	192	P30511-1	0	1038	ENST00000334668.8	124	1162	++	29	P30511-1#17	0	192	ENST00000334668.8	487	679	+	192	0	0	9089
P30511-1#17	0	192	192	P30511-1	363	555	+	192	P30511-1	0	1035	ENST00000259951.12	30	1065	++	6	P30511-1#17	0	192	ENST00000259951.12	393	585	+	192	0	0	9090
P30511-1#18	0	171	171	P30511-1	669	840	+	171	P30511-1	633	1036	ENST00000465459.2	0	403	+	108	P30511-1#18	0	171	ENST00000465459.2	36	207	+	171	0	0	9091
P30511-1#18	0	171	171	P30511-1	669	840	+	171	P30511-1	0	1038	ENST00000376861.5	384	1422	++	53	P30511-1#18	0	171	ENST00000376861.5	1053	1224	+	171	0	0	9092
P30511-1#18	0	171	171	P30511-1	669	840	+	171	P30511-1	0	1038	ENST00000334668.8	124	1162	++	29	P30511-1#18	0	171	ENST00000334668.8	793	964	+	171	0	0	9093
P30511-1#18	0	171	171	P30511-1	669	840	+	171	P30511-1	0	1035	ENST00000259951.12	30	1065	++	6	P30511-1#18	0	171	ENST00000259951.12	699	870	+	171	0	0	9094
P30511-1#19	0	276	276	P30511-1	609	885	+	276	P30511-1	633	1036	ENST00000465459.2	0	403	+	108	P30511-1#19	24	276	ENST00000465459.2	0	252	+	252	24	0	9095
P30511-1#19	0	276	276	P30511-1	609	885	+	276	P30511-1	0	612	ENST00000434407.6	0	612	++	84	P30511-1#19	0	3	ENST00000434407.6	609	612	+	3	0	273	9096
P30511-1#19	0	276	276	P30511-1	609	885	+	276	P30511-1	0	1038	ENST00000376861.5	384	1422	++	53	P30511-1#19	0	276	ENST00000376861.5	993	1269	+	276	0	0	9097
P30511-1#19	0	276	276	P30511-1	609	885	+	276	P30511-1	0	1038	ENST00000334668.8	124	1162	++	29	P30511-1#19	0	276	ENST00000334668.8	733	1009	+	276	0	0	9098
P30511-1#19	0	276	276	P30511-1	609	885	+	276	P30511-1	0	1035	ENST00000259951.12	30	1065	++	6	P30511-1#19	0	276	ENST00000259951.12	639	915	+	276	0	0	9099
P30511-1#20	0	3	3	P30511-1	1035	1038	+	3	P30511-1	633	1036	ENST00000465459.2	0	403	+	108	P30511-1#20	0	1	ENST00000465459.2	402	403	+	1	0	2	9100
P30511-1#20	0	3	3	P30511-1	1035	1038	+	3	P30511-1	973	1036	ENST00000444621.1	0	81	+	93	P30511-1#20	0	1	ENST00000444621.1	80	81	+	1	0	2	9101
P30511-1#20	0	3	3	P30511-1	1035	1038	+	3	P30511-1	0	1038	ENST00000376861.5	384	1422	++	53	P30511-1#20	0	3	ENST00000376861.5	1419	1422	+	3	0	0	9102
P30511-1#20	0	3	3	P30511-1	1035	1038	+	3	P30511-1	0	1038	ENST00000334668.8	124	1162	++	29	P30511-1#20	0	3	ENST00000334668.8	1159	1162	+	3	0	0	9103
P30511-1#21	0	3	3	P30511-1	36	39	+	3	P30511-1	0	612	ENST00000434407.6	0	612	++	84	P30511-1#21	0	3	ENST00000434407.6	36	39	+	3	0	0	9104
P30511-1#21	0	3	3	P30511-1	36	39	+	3	P30511-1	0	1038	ENST00000376861.5	384	1422	++	53	P30511-1#21	0	3	ENST00000376861.5	420	423	+	3	0	0	9105
P30511-1#21	0	3	3	P30511-1	36	39	+	3	P30511-1	0	1038	ENST00000334668.8	124	1162	++	29	P30511-1#21	0	3	ENST00000334668.8	160	163	+	3	0	0	9106
P30511-1#21	0	3	3	P30511-1	36	39	+	3	P30511-1	0	1035	ENST00000259951.12	30	1065	++	6	P30511-1#21	0	3	ENST00000259951.12	66	69	+	3	0	0	9107
P30511-1#22	0	3	3	P30511-1	210	213	+	3	P30511-1	0	612	ENST00000434407.6	0	612	++	84	P30511-1#22	0	3	ENST00000434407.6	210	213	+	3	0	0	9108
P30511-1#22	0	3	3	P30511-1	210	213	+	3	P30511-1	0	1038	ENST00000376861.5	384	1422	++	53	P30511-1#22	0	3	ENST00000376861.5	594	597	+	3	0	0	9109
P30511-1#22	0	3	3	P30511-1	210	213	+	3	P30511-1	0	1038	ENST00000334668.8	124	1162	++	29	P30511-1#22	0	3	ENST00000334668.8	334	337	+	3	0	0	9110
P30511-1#22	0	3	3	P30511-1	210	213	+	3	P30511-1	0	1035	ENST00000259951.12	30	1065	++	6	P30511-1#22	0	3	ENST00000259951.12	240	243	+	3	0	0	9111
P30511-1#23	0	3	3	P30511-1	813	816	+	3	P30511-1	633	1036	ENST00000465459.2	0	403	+	108	P30511-1#23	0	3	ENST00000465459.2	180	183	+	3	0	0	9112
P30511-1#23	0	3	3	P30511-1	813	816	+	3	P30511-1	0	1038	ENST00000376861.5	384	1422	++	53	P30511-1#23	0	3	ENST00000376861.5	1197	1200	+	3	0	0	9113
P30511-1#23	0	3	3	P30511-1	813	816	+	3	P30511-1	0	1038	ENST00000334668.8	124	1162	++	29	P30511-1#23	0	3	ENST00000334668.8	937	940	+	3	0	0	9114
P30511-1#23	0	3	3	P30511-1	813	816	+	3	P30511-1	0	1035	ENST00000259951.12	30	1065	++	6	P30511-1#23	0	3	ENST00000259951.12	843	846	+	3	0	0	9115
P30511-1#24	0	3	3	P30511-1	246	249	+	3	P30511-1	0	612	ENST00000434407.6	0	612	++	84	P30511-1#24	0	3	ENST00000434407.6	246	249	+	3	0	0	9116
P30511-1#24	0	3	3	P30511-1	246	249	+	3	P30511-1	0	1038	ENST00000376861.5	384	1422	++	53	P30511-1#24	0	3	ENST00000376861.5	630	633	+	3	0	0	9117
P30511-1#24	0	3	3	P30511-1	246	249	+	3	P30511-1	0	1038	ENST00000334668.8	124	1162	++	29	P30511-1#24	0	3	ENST00000334668.8	370	373	+	3	0	0	9118
P30511-1#24	0	3	3	P30511-1	246	249	+	3	P30511-1	0	1035	ENST00000259951.12	30	1065	++	6	P30511-1#24	0	3	ENST00000259951.12	276	279	+	3	0	0	9119
P30511-1#25	0	9	9	P30511-1	1005	1014	+	9	P30511-1	633	1036	ENST00000465459.2	0	403	+	108	P30511-1#25	0	9	ENST00000465459.2	372	381	+	9	0	0	9120
P30511-1#25	0	9	9	P30511-1	1005	1014	+	9	P30511-1	973	1036	ENST00000444621.1	0	81	+	93	P30511-1#25	0	9	ENST00000444621.1	50	59	+	9	0	0	9121
P30511-1#25	0	9	9	P30511-1	1005	1014	+	9	P30511-1	0	1038	ENST00000376861.5	384	1422	++	53	P30511-1#25	0	9	ENST00000376861.5	1389	1398	+	9	0	0	9122
P30511-1#25	0	9	9	P30511-1	1005	1014	+	9	P30511-1	0	1038	ENST00000334668.8	124	1162	++	29	P30511-1#25	0	9	ENST00000334668.8	1129	1138	+	9	0	0	9123
P30511-1#25	0	9	9	P30511-1	1005	1014	+	9	P30511-1	0	1035	ENST00000259951.12	30	1065	++	6	P30511-1#25	0	9	ENST00000259951.12	1035	1044	+	9	0	0	9124
P30511-1#26	0	9	9	P30511-1	1005	1014	+	9	P30511-1	633	1036	ENST00000465459.2	0	403	+	108	P30511-1#26	0	9	ENST00000465459.2	372	381	+	9	0	0	9125
P30511-1#26	0	9	9	P30511-1	1005	1014	+	9	P30511-1	973	1036	ENST00000444621.1	0	81	+	93	P30511-1#26	0	9	ENST00000444621.1	50	59	+	9	0	0	9126
P30511-1#26	0	9	9	P30511-1	1005	1014	+	9	P30511-1	0	1038	ENST00000376861.5	384	1422	++	53	P30511-1#26	0	9	ENST00000376861.5	1389	1398	+	9	0	0	9127
P30511-1#26	0	9	9	P30511-1	1005	1014	+	9	P30511-1	0	1038	ENST00000334668.8	124	1162	++	29	P30511-1#26	0	9	ENST00000334668.8	1129	1138	+	9	0	0	9128
P30511-1#26	0	9	9	P30511-1	1005	1014	+	9	P30511-1	0	1035	ENST00000259951.12	30	1065	++	6	P30511-1#26	0	9	ENST00000259951.12	1035	1044	+	9	0	0	9129
P30511-1#27	0	3	3	P30511-1	1035	1038	+	3	P30511-1	633	1036	ENST00000465459.2	0	403	+	108	P30511-1#27	0	1	ENST00000465459.2	402	403	+	1	0	2	9130
P30511-1#27	0	3	3	P30511-1	1035	1038	+	3	P30511-1	973	1036	ENST00000444621.1	0	81	+	93	P30511-1#27	0	1	ENST00000444621.1	80	81	+	1	0	2	9131
P30511-1#27	0	3	3	P30511-1	1035	1038	+	3	P30511-1	0	1038	ENST00000376861.5	384	1422	++	53	P30511-1#27	0	3	ENST00000376861.5	1419	1422	+	3	0	0	9132
P30511-1#27	0	3	3	P30511-1	1035	1038	+	3	P30511-1	0	1038	ENST00000334668.8	124	1162	++	29	P30511-1#27	0	3	ENST00000334668.8	1159	1162	+	3	0	0	9133
P30511-1#28	0	3	3	P30511-1	1035	1038	+	3	P30511-1	633	1036	ENST00000465459.2	0	403	+	108	P30511-1#28	0	1	ENST00000465459.2	402	403	+	1	0	2	9134
P30511-1#28	0	3	3	P30511-1	1035	1038	+	3	P30511-1	973	1036	ENST00000444621.1	0	81	+	93	P30511-1#28	0	1	ENST00000444621.1	80	81	+	1	0	2	9135
P30511-1#28	0	3	3	P30511-1	1035	1038	+	3	P30511-1	0	1038	ENST00000376861.5	384	1422	++	53	P30511-1#28	0	3	ENST00000376861.5	1419	1422	+	3	0	0	9136
P30511-1#28	0	3	3	P30511-1	1035	1038	+	3	P30511-1	0	1038	ENST00000334668.8	124	1162	++	29	P30511-1#28	0	3	ENST00000334668.8	1159	1162	+	3	0	0	9137
P30511-1#29	0	36	36	P30511-1	69	105	+	36	P30511-1	0	612	ENST00000434407.6	0	612	++	84	P30511-1#29	0	36	ENST00000434407.6	69	105	+	36	0	0	9138
P30511-1#29	0	36	36	P30511-1	69	105	+	36	P30511-1	0	1038	ENST00000376861.5	384	1422	++	53	P30511-1#29	0	36	ENST00000376861.5	453	489	+	36	0	0	9139
P30511-1#29	0	36	36	P30511-1	69	105	+	36	P30511-1	0	1038	ENST00000334668.8	124	1162	++	29	P30511-1#29	0	36	ENST00000334668.8	193	229	+	36	0	0	9140
P30511-1#29	0	36	36	P30511-1	69	105	+	36	P30511-1	0	1035	ENST00000259951.12	30	1065	++	6	P30511-1#29	0	36	ENST00000259951.12	99	135	+	36	0	0	9141
P30511-1#30	0	9	9	P30511-1	105	114	+	9	P30511-1	0	612	ENST00000434407.6	0	612	++	84	P30511-1#30	0	9	ENST00000434407.6	105	114	+	9	0	0	9142
P30511-1#30	0	9	9	P30511-1	105	114	+	9	P30511-1	0	1038	ENST00000376861.5	384	1422	++	53	P30511-1#30	0	9	ENST00000376861.5	489	498	+	9	0	0	9143
P30511-1#30	0	9	9	P30511-1	105	114	+	9	P30511-1	0	1038	ENST00000334668.8	124	1162	++	29	P30511-1#30	0	9	ENST00000334668.8	229	238	+	9	0	0	9144
P30511-1#30	0	9	9	P30511-1	105	114	+	9	P30511-1	0	1035	ENST00000259951.12	30	1065	++	6	P30511-1#30	0	9	ENST00000259951.12	135	144	+	9	0	0	9145
P30511-1#31	0	33	33	P30511-1	114	147	+	33	P30511-1	0	612	ENST00000434407.6	0	612	++	84	P30511-1#31	0	33	ENST00000434407.6	114	147	+	33	0	0	9146
P30511-1#31	0	33	33	P30511-1	114	147	+	33	P30511-1	0	1038	ENST00000376861.5	384	1422	++	53	P30511-1#31	0	33	ENST00000376861.5	498	531	+	33	0	0	9147
P30511-1#31	0	33	33	P30511-1	114	147	+	33	P30511-1	0	1038	ENST00000334668.8	124	1162	++	29	P30511-1#31	0	33	ENST00000334668.8	238	271	+	33	0	0	9148
P30511-1#31	0	33	33	P30511-1	114	147	+	33	P30511-1	0	1035	ENST00000259951.12	30	1065	++	6	P30511-1#31	0	33	ENST00000259951.12	144	177	+	33	0	0	9149
P30511-1#32	0	21	21	P30511-1	153	174	+	21	P30511-1	0	612	ENST00000434407.6	0	612	++	84	P30511-1#32	0	21	ENST00000434407.6	153	174	+	21	0	0	9150
P30511-1#32	0	21	21	P30511-1	153	174	+	21	P30511-1	0	1038	ENST00000376861.5	384	1422	++	53	P30511-1#32	0	21	ENST00000376861.5	537	558	+	21	0	0	9151
P30511-1#32	0	21	21	P30511-1	153	174	+	21	P30511-1	0	1038	ENST00000334668.8	124	1162	++	29	P30511-1#32	0	21	ENST00000334668.8	277	298	+	21	0	0	9152
P30511-1#32	0	21	21	P30511-1	153	174	+	21	P30511-1	0	1035	ENST00000259951.12	30	1065	++	6	P30511-1#32	0	21	ENST00000259951.12	183	204	+	21	0	0	9153
P30511-1#33	0	9	9	P30511-1	180	189	+	9	P30511-1	0	612	ENST00000434407.6	0	612	++	84	P30511-1#33	0	9	ENST00000434407.6	180	189	+	9	0	0	9154
P30511-1#33	0	9	9	P30511-1	180	189	+	9	P30511-1	0	1038	ENST00000376861.5	384	1422	++	53	P30511-1#33	0	9	ENST00000376861.5	564	573	+	9	0	0	9155
P30511-1#33	0	9	9	P30511-1	180	189	+	9	P30511-1	0	1038	ENST00000334668.8	124	1162	++	29	P30511-1#33	0	9	ENST00000334668.8	304	313	+	9	0	0	9156
P30511-1#33	0	9	9	P30511-1	180	189	+	9	P30511-1	0	1035	ENST00000259951.12	30	1065	++	6	P30511-1#33	0	9	ENST00000259951.12	210	219	+	9	0	0	9157
P30511-1#34	0	12	12	P30511-1	198	210	+	12	P30511-1	0	612	ENST00000434407.6	0	612	++	84	P30511-1#34	0	12	ENST00000434407.6	198	210	+	12	0	0	9158
P30511-1#34	0	12	12	P30511-1	198	210	+	12	P30511-1	0	1038	ENST00000376861.5	384	1422	++	53	P30511-1#34	0	12	ENST00000376861.5	582	594	+	12	0	0	9159
P30511-1#34	0	12	12	P30511-1	198	210	+	12	P30511-1	0	1038	ENST00000334668.8	124	1162	++	29	P30511-1#34	0	12	ENST00000334668.8	322	334	+	12	0	0	9160
P30511-1#34	0	12	12	P30511-1	198	210	+	12	P30511-1	0	1035	ENST00000259951.12	30	1065	++	6	P30511-1#34	0	12	ENST00000259951.12	228	240	+	12	0	0	9161
P30511-1#35	0	9	9	P30511-1	210	219	+	9	P30511-1	0	612	ENST00000434407.6	0	612	++	84	P30511-1#35	0	9	ENST00000434407.6	210	219	+	9	0	0	9162
P30511-1#35	0	9	9	P30511-1	210	219	+	9	P30511-1	0	1038	ENST00000376861.5	384	1422	++	53	P30511-1#35	0	9	ENST00000376861.5	594	603	+	9	0	0	9163
P30511-1#35	0	9	9	P30511-1	210	219	+	9	P30511-1	0	1038	ENST00000334668.8	124	1162	++	29	P30511-1#35	0	9	ENST00000334668.8	334	343	+	9	0	0	9164
P30511-1#35	0	9	9	P30511-1	210	219	+	9	P30511-1	0	1035	ENST00000259951.12	30	1065	++	6	P30511-1#35	0	9	ENST00000259951.12	240	249	+	9	0	0	9165
P30511-1#36	0	84	84	P30511-1	231	315	+	84	P30511-1	0	612	ENST00000434407.6	0	612	++	84	P30511-1#36	0	84	ENST00000434407.6	231	315	+	84	0	0	9166
P30511-1#36	0	84	84	P30511-1	231	315	+	84	P30511-1	0	1038	ENST00000376861.5	384	1422	++	53	P30511-1#36	0	84	ENST00000376861.5	615	699	+	84	0	0	9167
P30511-1#36	0	84	84	P30511-1	231	315	+	84	P30511-1	0	1038	ENST00000334668.8	124	1162	++	29	P30511-1#36	0	84	ENST00000334668.8	355	439	+	84	0	0	9168
P30511-1#36	0	84	84	P30511-1	231	315	+	84	P30511-1	0	1035	ENST00000259951.12	30	1065	++	6	P30511-1#36	0	84	ENST00000259951.12	261	345	+	84	0	0	9169
P30511-1#37	0	30	30	P30511-1	342	372	+	30	P30511-1	0	612	ENST00000434407.6	0	612	++	84	P30511-1#37	0	30	ENST00000434407.6	342	372	+	30	0	0	9170
P30511-1#37	0	30	30	P30511-1	342	372	+	30	P30511-1	0	1038	ENST00000376861.5	384	1422	++	53	P30511-1#37	0	30	ENST00000376861.5	726	756	+	30	0	0	9171
P30511-1#37	0	30	30	P30511-1	342	372	+	30	P30511-1	0	1038	ENST00000334668.8	124	1162	++	29	P30511-1#37	0	30	ENST00000334668.8	466	496	+	30	0	0	9172
P30511-1#37	0	30	30	P30511-1	342	372	+	30	P30511-1	0	1035	ENST00000259951.12	30	1065	++	6	P30511-1#37	0	30	ENST00000259951.12	372	402	+	30	0	0	9173
P30511-1#38	0	36	36	P30511-1	381	417	+	36	P30511-1	0	612	ENST00000434407.6	0	612	++	84	P30511-1#38	0	36	ENST00000434407.6	381	417	+	36	0	0	9174
P30511-1#38	0	36	36	P30511-1	381	417	+	36	P30511-1	0	1038	ENST00000376861.5	384	1422	++	53	P30511-1#38	0	36	ENST00000376861.5	765	801	+	36	0	0	9175
P30511-1#38	0	36	36	P30511-1	381	417	+	36	P30511-1	0	1038	ENST00000334668.8	124	1162	++	29	P30511-1#38	0	36	ENST00000334668.8	505	541	+	36	0	0	9176
P30511-1#38	0	36	36	P30511-1	381	417	+	36	P30511-1	0	1035	ENST00000259951.12	30	1065	++	6	P30511-1#38	0	36	ENST00000259951.12	411	447	+	36	0	0	9177
P30511-1#39	0	18	18	P30511-1	423	441	+	18	P30511-1	0	612	ENST00000434407.6	0	612	++	84	P30511-1#39	0	18	ENST00000434407.6	423	441	+	18	0	0	9178
P30511-1#39	0	18	18	P30511-1	423	441	+	18	P30511-1	0	1038	ENST00000376861.5	384	1422	++	53	P30511-1#39	0	18	ENST00000376861.5	807	825	+	18	0	0	9179
P30511-1#39	0	18	18	P30511-1	423	441	+	18	P30511-1	0	1038	ENST00000334668.8	124	1162	++	29	P30511-1#39	0	18	ENST00000334668.8	547	565	+	18	0	0	9180
P30511-1#39	0	18	18	P30511-1	423	441	+	18	P30511-1	0	1035	ENST00000259951.12	30	1065	++	6	P30511-1#39	0	18	ENST00000259951.12	453	471	+	18	0	0	9181
P30511-1#40	0	15	15	P30511-1	459	474	+	15	P30511-1	0	612	ENST00000434407.6	0	612	++	84	P30511-1#40	0	15	ENST00000434407.6	459	474	+	15	0	0	9182
P30511-1#40	0	15	15	P30511-1	459	474	+	15	P30511-1	0	1038	ENST00000376861.5	384	1422	++	53	P30511-1#40	0	15	ENST00000376861.5	843	858	+	15	0	0	9183
P30511-1#40	0	15	15	P30511-1	459	474	+	15	P30511-1	0	1038	ENST00000334668.8	124	1162	++	29	P30511-1#40	0	15	ENST00000334668.8	583	598	+	15	0	0	9184
P30511-1#40	0	15	15	P30511-1	459	474	+	15	P30511-1	0	1035	ENST00000259951.12	30	1065	++	6	P30511-1#40	0	15	ENST00000259951.12	489	504	+	15	0	0	9185
P30511-1#41	0	30	30	P30511-1	480	510	+	30	P30511-1	0	612	ENST00000434407.6	0	612	++	84	P30511-1#41	0	30	ENST00000434407.6	480	510	+	30	0	0	9186
P30511-1#41	0	30	30	P30511-1	480	510	+	30	P30511-1	0	1038	ENST00000376861.5	384	1422	++	53	P30511-1#41	0	30	ENST00000376861.5	864	894	+	30	0	0	9187
P30511-1#41	0	30	30	P30511-1	480	510	+	30	P30511-1	0	1038	ENST00000334668.8	124	1162	++	29	P30511-1#41	0	30	ENST00000334668.8	604	634	+	30	0	0	9188
P30511-1#41	0	30	30	P30511-1	480	510	+	30	P30511-1	0	1035	ENST00000259951.12	30	1065	++	6	P30511-1#41	0	30	ENST00000259951.12	510	540	+	30	0	0	9189
P30511-1#42	0	30	30	P30511-1	516	546	+	30	P30511-1	0	612	ENST00000434407.6	0	612	++	84	P30511-1#42	0	30	ENST00000434407.6	516	546	+	30	0	0	9190
P30511-1#42	0	30	30	P30511-1	516	546	+	30	P30511-1	0	1038	ENST00000376861.5	384	1422	++	53	P30511-1#42	0	30	ENST00000376861.5	900	930	+	30	0	0	9191
P30511-1#42	0	30	30	P30511-1	516	546	+	30	P30511-1	0	1038	ENST00000334668.8	124	1162	++	29	P30511-1#42	0	30	ENST00000334668.8	640	670	+	30	0	0	9192
P30511-1#42	0	30	30	P30511-1	516	546	+	30	P30511-1	0	1035	ENST00000259951.12	30	1065	++	6	P30511-1#42	0	30	ENST00000259951.12	546	576	+	30	0	0	9193
P30511-1#43	0	36	36	P30511-1	549	585	+	36	P30511-1	0	612	ENST00000434407.6	0	612	++	84	P30511-1#43	0	36	ENST00000434407.6	549	585	+	36	0	0	9194
P30511-1#43	0	36	36	P30511-1	549	585	+	36	P30511-1	0	1038	ENST00000376861.5	384	1422	++	53	P30511-1#43	0	36	ENST00000376861.5	933	969	+	36	0	0	9195
P30511-1#43	0	36	36	P30511-1	549	585	+	36	P30511-1	0	1038	ENST00000334668.8	124	1162	++	29	P30511-1#43	0	36	ENST00000334668.8	673	709	+	36	0	0	9196
P30511-1#43	0	36	36	P30511-1	549	585	+	36	P30511-1	0	1035	ENST00000259951.12	30	1065	++	6	P30511-1#43	0	36	ENST00000259951.12	579	615	+	36	0	0	9197
P30511-1#44	0	12	12	P30511-1	588	600	+	12	P30511-1	0	612	ENST00000434407.6	0	612	++	84	P30511-1#44	0	12	ENST00000434407.6	588	600	+	12	0	0	9198
P30511-1#44	0	12	12	P30511-1	588	600	+	12	P30511-1	0	1038	ENST00000376861.5	384	1422	++	53	P30511-1#44	0	12	ENST00000376861.5	972	984	+	12	0	0	9199
P30511-1#44	0	12	12	P30511-1	588	600	+	12	P30511-1	0	1038	ENST00000334668.8	124	1162	++	29	P30511-1#44	0	12	ENST00000334668.8	712	724	+	12	0	0	9200
P30511-1#44	0	12	12	P30511-1	588	600	+	12	P30511-1	0	1035	ENST00000259951.12	30	1065	++	6	P30511-1#44	0	12	ENST00000259951.12	618	630	+	12	0	0	9201
P30511-1#45	0	24	24	P30511-1	618	642	+	24	P30511-1	633	1036	ENST00000465459.2	0	403	+	108	P30511-1#45	15	24	ENST00000465459.2	0	9	+	9	15	0	9202
P30511-1#45	0	24	24	P30511-1	618	642	+	24	P30511-1	0	1038	ENST00000376861.5	384	1422	++	53	P30511-1#45	0	24	ENST00000376861.5	1002	1026	+	24	0	0	9203
P30511-1#45	0	24	24	P30511-1	618	642	+	24	P30511-1	0	1038	ENST00000334668.8	124	1162	++	29	P30511-1#45	0	24	ENST00000334668.8	742	766	+	24	0	0	9204
P30511-1#45	0	24	24	P30511-1	618	642	+	24	P30511-1	0	1035	ENST00000259951.12	30	1065	++	6	P30511-1#45	0	24	ENST00000259951.12	648	672	+	24	0	0	9205
P30511-1#46	0	51	51	P30511-1	645	696	+	51	P30511-1	633	1036	ENST00000465459.2	0	403	+	108	P30511-1#46	0	51	ENST00000465459.2	12	63	+	51	0	0	9206
P30511-1#46	0	51	51	P30511-1	645	696	+	51	P30511-1	0	1038	ENST00000376861.5	384	1422	++	53	P30511-1#46	0	51	ENST00000376861.5	1029	1080	+	51	0	0	9207
P30511-1#46	0	51	51	P30511-1	645	696	+	51	P30511-1	0	1038	ENST00000334668.8	124	1162	++	29	P30511-1#46	0	51	ENST00000334668.8	769	820	+	51	0	0	9208
P30511-1#46	0	51	51	P30511-1	645	696	+	51	P30511-1	0	1035	ENST00000259951.12	30	1065	++	6	P30511-1#46	0	51	ENST00000259951.12	675	726	+	51	0	0	9209
P30511-1#47	0	18	18	P30511-1	702	720	+	18	P30511-1	633	1036	ENST00000465459.2	0	403	+	108	P30511-1#47	0	18	ENST00000465459.2	69	87	+	18	0	0	9210
P30511-1#47	0	18	18	P30511-1	702	720	+	18	P30511-1	0	1038	ENST00000376861.5	384	1422	++	53	P30511-1#47	0	18	ENST00000376861.5	1086	1104	+	18	0	0	9211
P30511-1#47	0	18	18	P30511-1	702	720	+	18	P30511-1	0	1038	ENST00000334668.8	124	1162	++	29	P30511-1#47	0	18	ENST00000334668.8	826	844	+	18	0	0	9212
P30511-1#47	0	18	18	P30511-1	702	720	+	18	P30511-1	0	1035	ENST00000259951.12	30	1065	++	6	P30511-1#47	0	18	ENST00000259951.12	732	750	+	18	0	0	9213
P30511-1#48	0	9	9	P30511-1	735	744	+	9	P30511-1	633	1036	ENST00000465459.2	0	403	+	108	P30511-1#48	0	9	ENST00000465459.2	102	111	+	9	0	0	9214
P30511-1#48	0	9	9	P30511-1	735	744	+	9	P30511-1	0	1038	ENST00000376861.5	384	1422	++	53	P30511-1#48	0	9	ENST00000376861.5	1119	1128	+	9	0	0	9215
P30511-1#48	0	9	9	P30511-1	735	744	+	9	P30511-1	0	1038	ENST00000334668.8	124	1162	++	29	P30511-1#48	0	9	ENST00000334668.8	859	868	+	9	0	0	9216
P30511-1#48	0	9	9	P30511-1	735	744	+	9	P30511-1	0	1035	ENST00000259951.12	30	1065	++	6	P30511-1#48	0	9	ENST00000259951.12	765	774	+	9	0	0	9217
P30511-1#49	0	9	9	P30511-1	744	753	+	9	P30511-1	633	1036	ENST00000465459.2	0	403	+	108	P30511-1#49	0	9	ENST00000465459.2	111	120	+	9	0	0	9218
P30511-1#49	0	9	9	P30511-1	744	753	+	9	P30511-1	0	1038	ENST00000376861.5	384	1422	++	53	P30511-1#49	0	9	ENST00000376861.5	1128	1137	+	9	0	0	9219
P30511-1#49	0	9	9	P30511-1	744	753	+	9	P30511-1	0	1038	ENST00000334668.8	124	1162	++	29	P30511-1#49	0	9	ENST00000334668.8	868	877	+	9	0	0	9220
P30511-1#49	0	9	9	P30511-1	744	753	+	9	P30511-1	0	1035	ENST00000259951.12	30	1065	++	6	P30511-1#49	0	9	ENST00000259951.12	774	783	+	9	0	0	9221
P30511-1#50	0	9	9	P30511-1	771	780	+	9	P30511-1	633	1036	ENST00000465459.2	0	403	+	108	P30511-1#50	0	9	ENST00000465459.2	138	147	+	9	0	0	9222
P30511-1#50	0	9	9	P30511-1	771	780	+	9	P30511-1	0	1038	ENST00000376861.5	384	1422	++	53	P30511-1#50	0	9	ENST00000376861.5	1155	1164	+	9	0	0	9223
P30511-1#50	0	9	9	P30511-1	771	780	+	9	P30511-1	0	1038	ENST00000334668.8	124	1162	++	29	P30511-1#50	0	9	ENST00000334668.8	895	904	+	9	0	0	9224
P30511-1#50	0	9	9	P30511-1	771	780	+	9	P30511-1	0	1035	ENST00000259951.12	30	1065	++	6	P30511-1#50	0	9	ENST00000259951.12	801	810	+	9	0	0	9225
P30511-1#51	0	30	30	P30511-1	783	813	+	30	P30511-1	633	1036	ENST00000465459.2	0	403	+	108	P30511-1#51	0	30	ENST00000465459.2	150	180	+	30	0	0	9226
P30511-1#51	0	30	30	P30511-1	783	813	+	30	P30511-1	0	1038	ENST00000376861.5	384	1422	++	53	P30511-1#51	0	30	ENST00000376861.5	1167	1197	+	30	0	0	9227
P30511-1#51	0	30	30	P30511-1	783	813	+	30	P30511-1	0	1038	ENST00000334668.8	124	1162	++	29	P30511-1#51	0	30	ENST00000334668.8	907	937	+	30	0	0	9228
P30511-1#51	0	30	30	P30511-1	783	813	+	30	P30511-1	0	1035	ENST00000259951.12	30	1065	++	6	P30511-1#51	0	30	ENST00000259951.12	813	843	+	30	0	0	9229
P30511-1#52	0	9	9	P30511-1	822	831	+	9	P30511-1	633	1036	ENST00000465459.2	0	403	+	108	P30511-1#52	0	9	ENST00000465459.2	189	198	+	9	0	0	9230
P30511-1#52	0	9	9	P30511-1	822	831	+	9	P30511-1	0	1038	ENST00000376861.5	384	1422	++	53	P30511-1#52	0	9	ENST00000376861.5	1206	1215	+	9	0	0	9231
P30511-1#52	0	9	9	P30511-1	822	831	+	9	P30511-1	0	1038	ENST00000334668.8	124	1162	++	29	P30511-1#52	0	9	ENST00000334668.8	946	955	+	9	0	0	9232
P30511-1#52	0	9	9	P30511-1	822	831	+	9	P30511-1	0	1035	ENST00000259951.12	30	1065	++	6	P30511-1#52	0	9	ENST00000259951.12	852	861	+	9	0	0	9233
P30511-1#53	0	18	18	P30511-1	831	849	+	18	P30511-1	633	1036	ENST00000465459.2	0	403	+	108	P30511-1#53	0	18	ENST00000465459.2	198	216	+	18	0	0	9234
P30511-1#53	0	18	18	P30511-1	831	849	+	18	P30511-1	0	1038	ENST00000376861.5	384	1422	++	53	P30511-1#53	0	18	ENST00000376861.5	1215	1233	+	18	0	0	9235
P30511-1#53	0	18	18	P30511-1	831	849	+	18	P30511-1	0	1038	ENST00000334668.8	124	1162	++	29	P30511-1#53	0	18	ENST00000334668.8	955	973	+	18	0	0	9236
P30511-1#53	0	18	18	P30511-1	831	849	+	18	P30511-1	0	1035	ENST00000259951.12	30	1065	++	6	P30511-1#53	0	18	ENST00000259951.12	861	879	+	18	0	0	9237
P30511-1#54	0	9	9	P30511-1	858	867	+	9	P30511-1	633	1036	ENST00000465459.2	0	403	+	108	P30511-1#54	0	9	ENST00000465459.2	225	234	+	9	0	0	9238
P30511-1#54	0	9	9	P30511-1	858	867	+	9	P30511-1	0	1038	ENST00000376861.5	384	1422	++	53	P30511-1#54	0	9	ENST00000376861.5	1242	1251	+	9	0	0	9239
P30511-1#54	0	9	9	P30511-1	858	867	+	9	P30511-1	0	1038	ENST00000334668.8	124	1162	++	29	P30511-1#54	0	9	ENST00000334668.8	982	991	+	9	0	0	9240
P30511-1#54	0	9	9	P30511-1	858	867	+	9	P30511-1	0	1035	ENST00000259951.12	30	1065	++	6	P30511-1#54	0	9	ENST00000259951.12	888	897	+	9	0	0	9241
P30511-1#55	0	9	9	P30511-1	870	879	+	9	P30511-1	633	1036	ENST00000465459.2	0	403	+	108	P30511-1#55	0	9	ENST00000465459.2	237	246	+	9	0	0	9242
P30511-1#55	0	9	9	P30511-1	870	879	+	9	P30511-1	0	1038	ENST00000376861.5	384	1422	++	53	P30511-1#55	0	9	ENST00000376861.5	1254	1263	+	9	0	0	9243
P30511-1#55	0	9	9	P30511-1	870	879	+	9	P30511-1	0	1038	ENST00000334668.8	124	1162	++	29	P30511-1#55	0	9	ENST00000334668.8	994	1003	+	9	0	0	9244
P30511-1#55	0	9	9	P30511-1	870	879	+	9	P30511-1	0	1035	ENST00000259951.12	30	1065	++	6	P30511-1#55	0	9	ENST00000259951.12	900	909	+	9	0	0	9245
P0DMS8-1#0	0	954	954	P0DMS8-1	0	954	+	954	P0DMS8-1	0	350	ENST00000632535.1	58	408	+	235	P0DMS8-1#0	0	350	ENST00000632535.1	58	408	+	350	0	604	9246
P0DMS8-1#0	0	954	954	P0DMS8-1	0	954	+	954	P0DMS8-1	0	954	ENST00000241356.5	279	1233	++	2	P0DMS8-1#0	0	954	ENST00000241356.5	279	1233	+	954	0	0	9247
P0DMS8-1#1	0	42	42	P0DMS8-1	0	42	+	42	P0DMS8-1	0	350	ENST00000632535.1	58	408	+	235	P0DMS8-1#1	0	42	ENST00000632535.1	58	100	+	42	0	0	9248
P0DMS8-1#1	0	42	42	P0DMS8-1	0	42	+	42	P0DMS8-1	0	954	ENST00000241356.5	279	1233	++	2	P0DMS8-1#1	0	42	ENST00000241356.5	279	321	+	42	0	0	9249
P0DMS8-1#2	0	69	69	P0DMS8-1	42	111	+	69	P0DMS8-1	0	350	ENST00000632535.1	58	408	+	235	P0DMS8-1#2	0	69	ENST00000632535.1	100	169	+	69	0	0	9250
P0DMS8-1#2	0	69	69	P0DMS8-1	42	111	+	69	P0DMS8-1	0	954	ENST00000241356.5	279	1233	++	2	P0DMS8-1#2	0	69	ENST00000241356.5	321	390	+	69	0	0	9251
P0DMS8-1#3	0	33	33	P0DMS8-1	111	144	+	33	P0DMS8-1	0	350	ENST00000632535.1	58	408	+	235	P0DMS8-1#3	0	33	ENST00000632535.1	169	202	+	33	0	0	9252
P0DMS8-1#3	0	33	33	P0DMS8-1	111	144	+	33	P0DMS8-1	0	954	ENST00000241356.5	279	1233	++	2	P0DMS8-1#3	0	33	ENST00000241356.5	390	423	+	33	0	0	9253
P0DMS8-1#4	0	72	72	P0DMS8-1	144	216	+	72	P0DMS8-1	0	350	ENST00000632535.1	58	408	+	235	P0DMS8-1#4	0	72	ENST00000632535.1	202	274	+	72	0	0	9254
P0DMS8-1#4	0	72	72	P0DMS8-1	144	216	+	72	P0DMS8-1	0	954	ENST00000241356.5	279	1233	++	2	P0DMS8-1#4	0	72	ENST00000241356.5	423	495	+	72	0	0	9255
P0DMS8-1#5	0	36	36	P0DMS8-1	216	252	+	36	P0DMS8-1	0	350	ENST00000632535.1	58	408	+	235	P0DMS8-1#5	0	36	ENST00000632535.1	274	310	+	36	0	0	9256
P0DMS8-1#5	0	36	36	P0DMS8-1	216	252	+	36	P0DMS8-1	0	954	ENST00000241356.5	279	1233	++	2	P0DMS8-1#5	0	36	ENST00000241356.5	495	531	+	36	0	0	9257
P0DMS8-1#6	0	66	66	P0DMS8-1	252	318	+	66	P0DMS8-1	0	350	ENST00000632535.1	58	408	+	235	P0DMS8-1#6	0	66	ENST00000632535.1	310	376	+	66	0	0	9258
P0DMS8-1#6	0	66	66	P0DMS8-1	252	318	+	66	P0DMS8-1	0	954	ENST00000241356.5	279	1233	++	2	P0DMS8-1#6	0	66	ENST00000241356.5	531	597	+	66	0	0	9259
P0DMS8-1#7	0	60	60	P0DMS8-1	318	378	+	60	P0DMS8-1	0	350	ENST00000632535.1	58	408	+	235	P0DMS8-1#7	0	32	ENST00000632535.1	376	408	+	32	0	28	9260
P0DMS8-1#7	0	60	60	P0DMS8-1	318	378	+	60	P0DMS8-1	0	954	ENST00000241356.5	279	1233	++	2	P0DMS8-1#7	0	60	ENST00000241356.5	597	657	+	60	0	0	9261
P0DMS8-1#8	0	66	66	P0DMS8-1	378	444	+	66	P0DMS8-1	0	954	ENST00000241356.5	279	1233	++	2	P0DMS8-1#8	0	66	ENST00000241356.5	657	723	+	66	0	0	9262
P0DMS8-1#9	0	87	87	P0DMS8-1	444	531	+	87	P0DMS8-1	0	954	ENST00000241356.5	279	1233	++	2	P0DMS8-1#9	0	87	ENST00000241356.5	723	810	+	87	0	0	9263
P0DMS8-1#10	0	63	63	P0DMS8-1	531	594	+	63	P0DMS8-1	0	954	ENST00000241356.5	279	1233	++	2	P0DMS8-1#10	0	63	ENST00000241356.5	810	873	+	63	0	0	9264
P0DMS8-1#11	0	99	99	P0DMS8-1	594	693	+	99	P0DMS8-1	0	954	ENST00000241356.5	279	1233	++	2	P0DMS8-1#11	0	99	ENST00000241356.5	873	972	+	99	0	0	9265
P0DMS8-1#12	0	72	72	P0DMS8-1	693	765	+	72	P0DMS8-1	0	954	ENST00000241356.5	279	1233	++	2	P0DMS8-1#12	0	72	ENST00000241356.5	972	1044	+	72	0	0	9266
P0DMS8-1#13	0	18	18	P0DMS8-1	765	783	+	18	P0DMS8-1	0	954	ENST00000241356.5	279	1233	++	2	P0DMS8-1#13	0	18	ENST00000241356.5	1044	1062	+	18	0	0	9267
P0DMS8-1#14	0	69	69	P0DMS8-1	783	852	+	69	P0DMS8-1	0	954	ENST00000241356.5	279	1233	++	2	P0DMS8-1#14	0	69	ENST00000241356.5	1062	1131	+	69	0	0	9268
P0DMS8-1#15	0	102	102	P0DMS8-1	852	954	+	102	P0DMS8-1	0	954	ENST00000241356.5	279	1233	++	2	P0DMS8-1#15	0	102	ENST00000241356.5	1131	1233	+	102	0	0	9269
P0DMS8-1#16	0	3	3	P0DMS8-1	906	909	+	3	P0DMS8-1	0	954	ENST00000241356.5	279	1233	++	2	P0DMS8-1#16	0	3	ENST00000241356.5	1185	1188	+	3	0	0	9270
P0DMS8-1#17	0	3	3	P0DMS8-1	6	9	+	3	P0DMS8-1	0	350	ENST00000632535.1	58	408	+	235	P0DMS8-1#17	0	3	ENST00000632535.1	64	67	+	3	0	0	9271
P0DMS8-1#17	0	3	3	P0DMS8-1	6	9	+	3	P0DMS8-1	0	954	ENST00000241356.5	279	1233	++	2	P0DMS8-1#17	0	3	ENST00000241356.5	285	288	+	3	0	0	9272
P0DMS8-1#18	0	3	3	P0DMS8-1	9	12	+	3	P0DMS8-1	0	350	ENST00000632535.1	58	408	+	235	P0DMS8-1#18	0	3	ENST00000632535.1	67	70	+	3	0	0	9273
P0DMS8-1#18	0	3	3	P0DMS8-1	9	12	+	3	P0DMS8-1	0	954	ENST00000241356.5	279	1233	++	2	P0DMS8-1#18	0	3	ENST00000241356.5	288	291	+	3	0	0	9274
P0DMS8-1#19	0	3	3	P0DMS8-1	33	36	+	3	P0DMS8-1	0	350	ENST00000632535.1	58	408	+	235	P0DMS8-1#19	0	3	ENST00000632535.1	91	94	+	3	0	0	9275
P0DMS8-1#19	0	3	3	P0DMS8-1	33	36	+	3	P0DMS8-1	0	954	ENST00000241356.5	279	1233	++	2	P0DMS8-1#19	0	3	ENST00000241356.5	312	315	+	3	0	0	9276
P0DMS8-1#20	0	252	252	P0DMS8-1	246	498	+	252	P0DMS8-1	0	350	ENST00000632535.1	58	408	+	235	P0DMS8-1#20	0	104	ENST00000632535.1	304	408	+	104	0	148	9277
P0DMS8-1#20	0	252	252	P0DMS8-1	246	498	+	252	P0DMS8-1	0	954	ENST00000241356.5	279	1233	++	2	P0DMS8-1#20	0	252	ENST00000241356.5	525	777	+	252	0	0	9278
P0DMS8-1#21	0	3	3	P0DMS8-1	312	315	+	3	P0DMS8-1	0	350	ENST00000632535.1	58	408	+	235	P0DMS8-1#21	0	3	ENST00000632535.1	370	373	+	3	0	0	9279
P0DMS8-1#21	0	3	3	P0DMS8-1	312	315	+	3	P0DMS8-1	0	954	ENST00000241356.5	279	1233	++	2	P0DMS8-1#21	0	3	ENST00000241356.5	591	594	+	3	0	0	9280
P0DMS8-1#22	0	3	3	P0DMS8-1	741	744	+	3	P0DMS8-1	0	954	ENST00000241356.5	279	1233	++	2	P0DMS8-1#22	0	3	ENST00000241356.5	1020	1023	+	3	0	0	9281
P0DMS8-1#23	0	3	3	P0DMS8-1	795	798	+	3	P0DMS8-1	0	954	ENST00000241356.5	279	1233	++	2	P0DMS8-1#23	0	3	ENST00000241356.5	1074	1077	+	3	0	0	9282
P0DMS8-1#24	0	3	3	P0DMS8-1	18	21	+	3	P0DMS8-1	0	350	ENST00000632535.1	58	408	+	235	P0DMS8-1#24	0	3	ENST00000632535.1	76	79	+	3	0	0	9283
P0DMS8-1#24	0	3	3	P0DMS8-1	18	21	+	3	P0DMS8-1	0	954	ENST00000241356.5	279	1233	++	2	P0DMS8-1#24	0	3	ENST00000241356.5	297	300	+	3	0	0	9284
P0DMS8-1#25	0	3	3	P0DMS8-1	522	525	+	3	P0DMS8-1	0	954	ENST00000241356.5	279	1233	++	2	P0DMS8-1#25	0	3	ENST00000241356.5	801	804	+	3	0	0	9285
P42684-1#0	0	3	3	P42684-1	0	3	+	3	P42684-1	0	2061	ENST00000511413.5	0	2061	++	133	P42684-1#0	0	3	ENST00000511413.5	0	3	+	3	0	0	9286
P42684-1#0	0	3	3	P42684-1	0	3	+	3	P42684-1	0	2061	ENST00000507173.5	0	1998	++	132	P42684-1#0	0	3	ENST00000507173.5	0	3	+	3	0	0	9287
P42684-1#0	0	3	3	P42684-1	0	3	+	3	P42684-1	0	3546	ENST00000502732.6	280	3826	++	130	P42684-1#0	0	3	ENST00000502732.6	280	283	+	3	0	0	9288
P42684-1#0	0	3	3	P42684-1	0	3	+	3	P42684-1	0	3546	ENST00000367623.8	0	3483	++	41	P42684-1#0	0	3	ENST00000367623.8	0	3	+	3	0	0	9289
P42684-1#1	0	3543	3543	P42684-1	3	3546	+	3543	P42684-1	156	3546	ENST00000512653.5	123	3513	++	134	P42684-1#1	153	3543	ENST00000512653.5	123	3513	+	3390	153	0	9290
P42684-1#1	0	3543	3543	P42684-1	3	3546	+	3543	P42684-1	0	2061	ENST00000511413.5	0	2061	++	133	P42684-1#1	0	2058	ENST00000511413.5	3	2061	+	2058	0	1485	9291
P42684-1#1	0	3543	3543	P42684-1	3	3546	+	3543	P42684-1	0	2061	ENST00000507173.5	0	1998	++	132	P42684-1#1	0	2058	ENST00000507173.5	3	1998	+	1995	0	1485	9292
P42684-1#1	0	3543	3543	P42684-1	3	3546	+	3543	P42684-1	219	2061	ENST00000504405.5	111	1953	++	131	P42684-1#1	216	2058	ENST00000504405.5	111	1953	+	1842	216	1485	9293
P42684-1#1	0	3543	3543	P42684-1	3	3546	+	3543	P42684-1	0	3546	ENST00000502732.6	280	3826	++	130	P42684-1#1	0	3543	ENST00000502732.6	283	3826	+	3543	0	0	9294
P42684-1#1	0	3543	3543	P42684-1	3	3546	+	3543	P42684-1	0	3546	ENST00000367623.8	0	3483	++	41	P42684-1#1	0	3543	ENST00000367623.8	3	3483	+	3480	0	0	9295
P42684-1#1	0	3543	3543	P42684-1	3	3546	+	3543	P42684-1	156	2061	ENST00000344730.8	143	2048	++	33	P42684-1#1	153	2058	ENST00000344730.8	143	2048	+	1905	153	1485	9296
P42684-1#2	0	183	183	P42684-1	318	501	+	183	P42684-1	156	3546	ENST00000512653.5	123	3513	++	134	P42684-1#2	0	183	ENST00000512653.5	285	468	+	183	0	0	9297
P42684-1#2	0	183	183	P42684-1	318	501	+	183	P42684-1	0	2061	ENST00000511413.5	0	2061	++	133	P42684-1#2	0	183	ENST00000511413.5	318	501	+	183	0	0	9298
P42684-1#2	0	183	183	P42684-1	318	501	+	183	P42684-1	0	2061	ENST00000507173.5	0	1998	++	132	P42684-1#2	0	183	ENST00000507173.5	255	438	+	183	0	0	9299
P42684-1#2	0	183	183	P42684-1	318	501	+	183	P42684-1	219	2061	ENST00000504405.5	111	1953	++	131	P42684-1#2	0	183	ENST00000504405.5	210	393	+	183	0	0	9300
P42684-1#2	0	183	183	P42684-1	318	501	+	183	P42684-1	0	3546	ENST00000502732.6	280	3826	++	130	P42684-1#2	0	183	ENST00000502732.6	598	781	+	183	0	0	9301
P42684-1#2	0	183	183	P42684-1	318	501	+	183	P42684-1	0	3546	ENST00000367623.8	0	3483	++	41	P42684-1#2	0	183	ENST00000367623.8	255	438	+	183	0	0	9302
P42684-1#2	0	183	183	P42684-1	318	501	+	183	P42684-1	156	2061	ENST00000344730.8	143	2048	++	33	P42684-1#2	0	183	ENST00000344730.8	305	488	+	183	0	0	9303
P42684-1#3	0	273	273	P42684-1	516	789	+	273	P42684-1	156	3546	ENST00000512653.5	123	3513	++	134	P42684-1#3	0	273	ENST00000512653.5	483	756	+	273	0	0	9304
P42684-1#3	0	273	273	P42684-1	516	789	+	273	P42684-1	0	2061	ENST00000511413.5	0	2061	++	133	P42684-1#3	0	273	ENST00000511413.5	516	789	+	273	0	0	9305
P42684-1#3	0	273	273	P42684-1	516	789	+	273	P42684-1	0	2061	ENST00000507173.5	0	1998	++	132	P42684-1#3	0	273	ENST00000507173.5	453	726	+	273	0	0	9306
P42684-1#3	0	273	273	P42684-1	516	789	+	273	P42684-1	219	2061	ENST00000504405.5	111	1953	++	131	P42684-1#3	0	273	ENST00000504405.5	408	681	+	273	0	0	9307
P42684-1#3	0	273	273	P42684-1	516	789	+	273	P42684-1	0	3546	ENST00000502732.6	280	3826	++	130	P42684-1#3	0	273	ENST00000502732.6	796	1069	+	273	0	0	9308
P42684-1#3	0	273	273	P42684-1	516	789	+	273	P42684-1	0	3546	ENST00000367623.8	0	3483	++	41	P42684-1#3	0	273	ENST00000367623.8	453	726	+	273	0	0	9309
P42684-1#3	0	273	273	P42684-1	516	789	+	273	P42684-1	156	2061	ENST00000344730.8	143	2048	++	33	P42684-1#3	0	273	ENST00000344730.8	503	776	+	273	0	0	9310
P42684-1#4	0	756	756	P42684-1	861	1617	+	756	P42684-1	156	3546	ENST00000512653.5	123	3513	++	134	P42684-1#4	0	756	ENST00000512653.5	828	1584	+	756	0	0	9311
P42684-1#4	0	756	756	P42684-1	861	1617	+	756	P42684-1	0	2061	ENST00000511413.5	0	2061	++	133	P42684-1#4	0	756	ENST00000511413.5	861	1617	+	756	0	0	9312
P42684-1#4	0	756	756	P42684-1	861	1617	+	756	P42684-1	0	2061	ENST00000507173.5	0	1998	++	132	P42684-1#4	0	756	ENST00000507173.5	798	1554	+	756	0	0	9313
P42684-1#4	0	756	756	P42684-1	861	1617	+	756	P42684-1	219	2061	ENST00000504405.5	111	1953	++	131	P42684-1#4	0	756	ENST00000504405.5	753	1509	+	756	0	0	9314
P42684-1#4	0	756	756	P42684-1	861	1617	+	756	P42684-1	0	3546	ENST00000502732.6	280	3826	++	130	P42684-1#4	0	756	ENST00000502732.6	1141	1897	+	756	0	0	9315
P42684-1#4	0	756	756	P42684-1	861	1617	+	756	P42684-1	0	3546	ENST00000367623.8	0	3483	++	41	P42684-1#4	0	756	ENST00000367623.8	798	1554	+	756	0	0	9316
P42684-1#4	0	756	756	P42684-1	861	1617	+	756	P42684-1	156	2061	ENST00000344730.8	143	2048	++	33	P42684-1#4	0	756	ENST00000344730.8	848	1604	+	756	0	0	9317
P42684-1#5	0	141	141	P42684-1	0	141	+	141	P42684-1	0	2061	ENST00000511413.5	0	2061	++	133	P42684-1#5	0	141	ENST00000511413.5	0	141	+	141	0	0	9318
P42684-1#5	0	141	141	P42684-1	0	141	+	141	P42684-1	0	2061	ENST00000507173.5	0	1998	++	132	P42684-1#5	0	141	ENST00000507173.5	0	141	+	141	0	0	9319
P42684-1#5	0	141	141	P42684-1	0	141	+	141	P42684-1	0	3546	ENST00000502732.6	280	3826	++	130	P42684-1#5	0	141	ENST00000502732.6	280	421	+	141	0	0	9320
P42684-1#5	0	141	141	P42684-1	0	141	+	141	P42684-1	0	3546	ENST00000367623.8	0	3483	++	41	P42684-1#5	0	141	ENST00000367623.8	0	141	+	141	0	0	9321
P42684-1#6	0	315	315	P42684-1	3	318	+	315	P42684-1	156	3546	ENST00000512653.5	123	3513	++	134	P42684-1#6	153	315	ENST00000512653.5	123	285	+	162	153	0	9322
P42684-1#6	0	315	315	P42684-1	3	318	+	315	P42684-1	0	2061	ENST00000511413.5	0	2061	++	133	P42684-1#6	0	315	ENST00000511413.5	3	318	+	315	0	0	9323
P42684-1#6	0	315	315	P42684-1	3	318	+	315	P42684-1	0	2061	ENST00000507173.5	0	1998	++	132	P42684-1#6	0	315	ENST00000507173.5	3	255	+	252	0	0	9324
P42684-1#6	0	315	315	P42684-1	3	318	+	315	P42684-1	219	2061	ENST00000504405.5	111	1953	++	131	P42684-1#6	216	315	ENST00000504405.5	111	210	+	99	216	0	9325
P42684-1#6	0	315	315	P42684-1	3	318	+	315	P42684-1	0	3546	ENST00000502732.6	280	3826	++	130	P42684-1#6	0	315	ENST00000502732.6	283	598	+	315	0	0	9326
P42684-1#6	0	315	315	P42684-1	3	318	+	315	P42684-1	0	3546	ENST00000367623.8	0	3483	++	41	P42684-1#6	0	315	ENST00000367623.8	3	255	+	252	0	0	9327
P42684-1#6	0	315	315	P42684-1	3	318	+	315	P42684-1	156	2061	ENST00000344730.8	143	2048	++	33	P42684-1#6	153	315	ENST00000344730.8	143	305	+	162	153	0	9328
P42684-1#7	0	63	63	P42684-1	177	240	+	63	P42684-1	156	3546	ENST00000512653.5	123	3513	++	134	P42684-1#7	0	63	ENST00000512653.5	144	207	+	63	0	0	9329
P42684-1#7	0	63	63	P42684-1	177	240	+	63	P42684-1	0	2061	ENST00000511413.5	0	2061	++	133	P42684-1#7	0	63	ENST00000511413.5	177	240	+	63	0	0	9330
P42684-1#7	0	63	63	P42684-1	177	240	+	63	P42684-1	0	2061	ENST00000507173.5	0	1998	++	132	P42684-1#7	42	63	ENST00000507173.5	156	177	+	21	42	0	9331
P42684-1#7	0	63	63	P42684-1	177	240	+	63	P42684-1	219	2061	ENST00000504405.5	111	1953	++	131	P42684-1#7	42	63	ENST00000504405.5	111	132	+	21	42	0	9332
P42684-1#7	0	63	63	P42684-1	177	240	+	63	P42684-1	0	3546	ENST00000502732.6	280	3826	++	130	P42684-1#7	0	63	ENST00000502732.6	457	520	+	63	0	0	9333
P42684-1#7	0	63	63	P42684-1	177	240	+	63	P42684-1	0	3546	ENST00000367623.8	0	3483	++	41	P42684-1#7	42	63	ENST00000367623.8	156	177	+	21	42	0	9334
P42684-1#7	0	63	63	P42684-1	177	240	+	63	P42684-1	156	2061	ENST00000344730.8	143	2048	++	33	P42684-1#7	0	63	ENST00000344730.8	164	227	+	63	0	0	9335
P42684-1#8	0	93	93	P42684-1	1830	1923	+	93	P42684-1	156	3546	ENST00000512653.5	123	3513	++	134	P42684-1#8	0	93	ENST00000512653.5	1797	1890	+	93	0	0	9336
P42684-1#8	0	93	93	P42684-1	1830	1923	+	93	P42684-1	0	2061	ENST00000511413.5	0	2061	++	133	P42684-1#8	0	93	ENST00000511413.5	1830	1923	+	93	0	0	9337
P42684-1#8	0	93	93	P42684-1	1830	1923	+	93	P42684-1	0	2061	ENST00000507173.5	0	1998	++	132	P42684-1#8	0	93	ENST00000507173.5	1767	1860	+	93	0	0	9338
P42684-1#8	0	93	93	P42684-1	1830	1923	+	93	P42684-1	219	2061	ENST00000504405.5	111	1953	++	131	P42684-1#8	0	93	ENST00000504405.5	1722	1815	+	93	0	0	9339
P42684-1#8	0	93	93	P42684-1	1830	1923	+	93	P42684-1	0	3546	ENST00000502732.6	280	3826	++	130	P42684-1#8	0	93	ENST00000502732.6	2110	2203	+	93	0	0	9340
P42684-1#8	0	93	93	P42684-1	1830	1923	+	93	P42684-1	0	3546	ENST00000367623.8	0	3483	++	41	P42684-1#8	0	93	ENST00000367623.8	1767	1860	+	93	0	0	9341
P42684-1#8	0	93	93	P42684-1	1830	1923	+	93	P42684-1	156	2061	ENST00000344730.8	143	2048	++	33	P42684-1#8	0	93	ENST00000344730.8	1817	1910	+	93	0	0	9342
P42684-1#9	0	63	63	P42684-1	1959	2022	+	63	P42684-1	156	3546	ENST00000512653.5	123	3513	++	134	P42684-1#9	0	63	ENST00000512653.5	1926	1989	+	63	0	0	9343
P42684-1#9	0	63	63	P42684-1	1959	2022	+	63	P42684-1	0	2061	ENST00000511413.5	0	2061	++	133	P42684-1#9	0	63	ENST00000511413.5	1959	2022	+	63	0	0	9344
P42684-1#9	0	63	63	P42684-1	1959	2022	+	63	P42684-1	0	2061	ENST00000507173.5	0	1998	++	132	P42684-1#9	0	63	ENST00000507173.5	1896	1959	+	63	0	0	9345
P42684-1#9	0	63	63	P42684-1	1959	2022	+	63	P42684-1	219	2061	ENST00000504405.5	111	1953	++	131	P42684-1#9	0	63	ENST00000504405.5	1851	1914	+	63	0	0	9346
P42684-1#9	0	63	63	P42684-1	1959	2022	+	63	P42684-1	0	3546	ENST00000502732.6	280	3826	++	130	P42684-1#9	0	63	ENST00000502732.6	2239	2302	+	63	0	0	9347
P42684-1#9	0	63	63	P42684-1	1959	2022	+	63	P42684-1	0	3546	ENST00000367623.8	0	3483	++	41	P42684-1#9	0	63	ENST00000367623.8	1896	1959	+	63	0	0	9348
P42684-1#9	0	63	63	P42684-1	1959	2022	+	63	P42684-1	156	2061	ENST00000344730.8	143	2048	++	33	P42684-1#9	0	63	ENST00000344730.8	1946	2009	+	63	0	0	9349
P42684-1#10	0	711	711	P42684-1	2079	2790	+	711	P42684-1	156	3546	ENST00000512653.5	123	3513	++	134	P42684-1#10	0	711	ENST00000512653.5	2046	2757	+	711	0	0	9350
P42684-1#10	0	711	711	P42684-1	2079	2790	+	711	P42684-1	0	3546	ENST00000502732.6	280	3826	++	130	P42684-1#10	0	711	ENST00000502732.6	2359	3070	+	711	0	0	9351
P42684-1#10	0	711	711	P42684-1	2079	2790	+	711	P42684-1	0	3546	ENST00000367623.8	0	3483	++	41	P42684-1#10	0	711	ENST00000367623.8	2016	2727	+	711	0	0	9352
P42684-1#11	0	96	96	P42684-1	2286	2382	+	96	P42684-1	156	3546	ENST00000512653.5	123	3513	++	134	P42684-1#11	0	96	ENST00000512653.5	2253	2349	+	96	0	0	9353
P42684-1#11	0	96	96	P42684-1	2286	2382	+	96	P42684-1	0	3546	ENST00000502732.6	280	3826	++	130	P42684-1#11	0	96	ENST00000502732.6	2566	2662	+	96	0	0	9354
P42684-1#11	0	96	96	P42684-1	2286	2382	+	96	P42684-1	0	3546	ENST00000367623.8	0	3483	++	41	P42684-1#11	0	96	ENST00000367623.8	2223	2319	+	96	0	0	9355
P42684-1#12	0	135	135	P42684-1	2418	2553	+	135	P42684-1	156	3546	ENST00000512653.5	123	3513	++	134	P42684-1#12	0	135	ENST00000512653.5	2385	2520	+	135	0	0	9356
P42684-1#12	0	135	135	P42684-1	2418	2553	+	135	P42684-1	0	3546	ENST00000502732.6	280	3826	++	130	P42684-1#12	0	135	ENST00000502732.6	2698	2833	+	135	0	0	9357
P42684-1#12	0	135	135	P42684-1	2418	2553	+	135	P42684-1	0	3546	ENST00000367623.8	0	3483	++	41	P42684-1#12	0	135	ENST00000367623.8	2355	2490	+	135	0	0	9358
P42684-1#13	0	183	183	P42684-1	2889	3072	+	183	P42684-1	156	3546	ENST00000512653.5	123	3513	++	134	P42684-1#13	0	183	ENST00000512653.5	2856	3039	+	183	0	0	9359
P42684-1#13	0	183	183	P42684-1	2889	3072	+	183	P42684-1	0	3546	ENST00000502732.6	280	3826	++	130	P42684-1#13	0	183	ENST00000502732.6	3169	3352	+	183	0	0	9360
P42684-1#13	0	183	183	P42684-1	2889	3072	+	183	P42684-1	0	3546	ENST00000367623.8	0	3483	++	41	P42684-1#13	0	183	ENST00000367623.8	2826	3009	+	183	0	0	9361
P42684-1#14	0	489	489	P42684-1	3057	3546	+	489	P42684-1	156	3546	ENST00000512653.5	123	3513	++	134	P42684-1#14	0	489	ENST00000512653.5	3024	3513	+	489	0	0	9362
P42684-1#14	0	489	489	P42684-1	3057	3546	+	489	P42684-1	0	3546	ENST00000502732.6	280	3826	++	130	P42684-1#14	0	489	ENST00000502732.6	3337	3826	+	489	0	0	9363
P42684-1#14	0	489	489	P42684-1	3057	3546	+	489	P42684-1	0	3546	ENST00000367623.8	0	3483	++	41	P42684-1#14	0	489	ENST00000367623.8	2994	3483	+	489	0	0	9364
P42684-1#15	0	75	75	P42684-1	1278	1353	+	75	P42684-1	156	3546	ENST00000512653.5	123	3513	++	134	P42684-1#15	0	75	ENST00000512653.5	1245	1320	+	75	0	0	9365
P42684-1#15	0	75	75	P42684-1	1278	1353	+	75	P42684-1	0	2061	ENST00000511413.5	0	2061	++	133	P42684-1#15	0	75	ENST00000511413.5	1278	1353	+	75	0	0	9366
P42684-1#15	0	75	75	P42684-1	1278	1353	+	75	P42684-1	0	2061	ENST00000507173.5	0	1998	++	132	P42684-1#15	0	75	ENST00000507173.5	1215	1290	+	75	0	0	9367
P42684-1#15	0	75	75	P42684-1	1278	1353	+	75	P42684-1	219	2061	ENST00000504405.5	111	1953	++	131	P42684-1#15	0	75	ENST00000504405.5	1170	1245	+	75	0	0	9368
P42684-1#15	0	75	75	P42684-1	1278	1353	+	75	P42684-1	0	3546	ENST00000502732.6	280	3826	++	130	P42684-1#15	0	75	ENST00000502732.6	1558	1633	+	75	0	0	9369
P42684-1#15	0	75	75	P42684-1	1278	1353	+	75	P42684-1	0	3546	ENST00000367623.8	0	3483	++	41	P42684-1#15	0	75	ENST00000367623.8	1215	1290	+	75	0	0	9370
P42684-1#15	0	75	75	P42684-1	1278	1353	+	75	P42684-1	156	2061	ENST00000344730.8	143	2048	++	33	P42684-1#15	0	75	ENST00000344730.8	1265	1340	+	75	0	0	9371
P42684-1#16	0	9	9	P42684-1	1971	1980	+	9	P42684-1	156	3546	ENST00000512653.5	123	3513	++	134	P42684-1#16	0	9	ENST00000512653.5	1938	1947	+	9	0	0	9372
P42684-1#16	0	9	9	P42684-1	1971	1980	+	9	P42684-1	0	2061	ENST00000511413.5	0	2061	++	133	P42684-1#16	0	9	ENST00000511413.5	1971	1980	+	9	0	0	9373
P42684-1#16	0	9	9	P42684-1	1971	1980	+	9	P42684-1	0	2061	ENST00000507173.5	0	1998	++	132	P42684-1#16	0	9	ENST00000507173.5	1908	1917	+	9	0	0	9374
P42684-1#16	0	9	9	P42684-1	1971	1980	+	9	P42684-1	219	2061	ENST00000504405.5	111	1953	++	131	P42684-1#16	0	9	ENST00000504405.5	1863	1872	+	9	0	0	9375
P42684-1#16	0	9	9	P42684-1	1971	1980	+	9	P42684-1	0	3546	ENST00000502732.6	280	3826	++	130	P42684-1#16	0	9	ENST00000502732.6	2251	2260	+	9	0	0	9376
P42684-1#16	0	9	9	P42684-1	1971	1980	+	9	P42684-1	0	3546	ENST00000367623.8	0	3483	++	41	P42684-1#16	0	9	ENST00000367623.8	1908	1917	+	9	0	0	9377
P42684-1#16	0	9	9	P42684-1	1971	1980	+	9	P42684-1	156	2061	ENST00000344730.8	143	2048	++	33	P42684-1#16	0	9	ENST00000344730.8	1958	1967	+	9	0	0	9378
P42684-1#17	0	60	60	P42684-1	2319	2379	+	60	P42684-1	156	3546	ENST00000512653.5	123	3513	++	134	P42684-1#17	0	60	ENST00000512653.5	2286	2346	+	60	0	0	9379
P42684-1#17	0	60	60	P42684-1	2319	2379	+	60	P42684-1	0	3546	ENST00000502732.6	280	3826	++	130	P42684-1#17	0	60	ENST00000502732.6	2599	2659	+	60	0	0	9380
P42684-1#17	0	60	60	P42684-1	2319	2379	+	60	P42684-1	0	3546	ENST00000367623.8	0	3483	++	41	P42684-1#17	0	60	ENST00000367623.8	2256	2316	+	60	0	0	9381
P42684-1#18	0	60	60	P42684-1	2418	2478	+	60	P42684-1	156	3546	ENST00000512653.5	123	3513	++	134	P42684-1#18	0	60	ENST00000512653.5	2385	2445	+	60	0	0	9382
P42684-1#18	0	60	60	P42684-1	2418	2478	+	60	P42684-1	0	3546	ENST00000502732.6	280	3826	++	130	P42684-1#18	0	60	ENST00000502732.6	2698	2758	+	60	0	0	9383
P42684-1#18	0	60	60	P42684-1	2418	2478	+	60	P42684-1	0	3546	ENST00000367623.8	0	3483	++	41	P42684-1#18	0	60	ENST00000367623.8	2355	2415	+	60	0	0	9384
P42684-1#19	0	72	72	P42684-1	2481	2553	+	72	P42684-1	156	3546	ENST00000512653.5	123	3513	++	134	P42684-1#19	0	72	ENST00000512653.5	2448	2520	+	72	0	0	9385
P42684-1#19	0	72	72	P42684-1	2481	2553	+	72	P42684-1	0	3546	ENST00000502732.6	280	3826	++	130	P42684-1#19	0	72	ENST00000502732.6	2761	2833	+	72	0	0	9386
P42684-1#19	0	72	72	P42684-1	2481	2553	+	72	P42684-1	0	3546	ENST00000367623.8	0	3483	++	41	P42684-1#19	0	72	ENST00000367623.8	2418	2490	+	72	0	0	9387
P42684-1#20	0	45	45	P42684-1	2895	2940	+	45	P42684-1	156	3546	ENST00000512653.5	123	3513	++	134	P42684-1#20	0	45	ENST00000512653.5	2862	2907	+	45	0	0	9388
P42684-1#20	0	45	45	P42684-1	2895	2940	+	45	P42684-1	0	3546	ENST00000502732.6	280	3826	++	130	P42684-1#20	0	45	ENST00000502732.6	3175	3220	+	45	0	0	9389
P42684-1#20	0	45	45	P42684-1	2895	2940	+	45	P42684-1	0	3546	ENST00000367623.8	0	3483	++	41	P42684-1#20	0	45	ENST00000367623.8	2832	2877	+	45	0	0	9390
P42684-1#21	0	66	66	P42684-1	2997	3063	+	66	P42684-1	156	3546	ENST00000512653.5	123	3513	++	134	P42684-1#21	0	66	ENST00000512653.5	2964	3030	+	66	0	0	9391
P42684-1#21	0	66	66	P42684-1	2997	3063	+	66	P42684-1	0	3546	ENST00000502732.6	280	3826	++	130	P42684-1#21	0	66	ENST00000502732.6	3277	3343	+	66	0	0	9392
P42684-1#21	0	66	66	P42684-1	2997	3063	+	66	P42684-1	0	3546	ENST00000367623.8	0	3483	++	41	P42684-1#21	0	66	ENST00000367623.8	2934	3000	+	66	0	0	9393
P42684-1#22	0	3	3	P42684-1	1224	1227	+	3	P42684-1	156	3546	ENST00000512653.5	123	3513	++	134	P42684-1#22	0	3	ENST00000512653.5	1191	1194	+	3	0	0	9394
P42684-1#22	0	3	3	P42684-1	1224	1227	+	3	P42684-1	0	2061	ENST00000511413.5	0	2061	++	133	P42684-1#22	0	3	ENST00000511413.5	1224	1227	+	3	0	0	9395
P42684-1#22	0	3	3	P42684-1	1224	1227	+	3	P42684-1	0	2061	ENST00000507173.5	0	1998	++	132	P42684-1#22	0	3	ENST00000507173.5	1161	1164	+	3	0	0	9396
P42684-1#22	0	3	3	P42684-1	1224	1227	+	3	P42684-1	219	2061	ENST00000504405.5	111	1953	++	131	P42684-1#22	0	3	ENST00000504405.5	1116	1119	+	3	0	0	9397
P42684-1#22	0	3	3	P42684-1	1224	1227	+	3	P42684-1	0	3546	ENST00000502732.6	280	3826	++	130	P42684-1#22	0	3	ENST00000502732.6	1504	1507	+	3	0	0	9398
P42684-1#22	0	3	3	P42684-1	1224	1227	+	3	P42684-1	0	3546	ENST00000367623.8	0	3483	++	41	P42684-1#22	0	3	ENST00000367623.8	1161	1164	+	3	0	0	9399
P42684-1#22	0	3	3	P42684-1	1224	1227	+	3	P42684-1	156	2061	ENST00000344730.8	143	2048	++	33	P42684-1#22	0	3	ENST00000344730.8	1211	1214	+	3	0	0	9400
P42684-1#23	0	27	27	P42684-1	879	906	+	27	P42684-1	156	3546	ENST00000512653.5	123	3513	++	134	P42684-1#23	0	27	ENST00000512653.5	846	873	+	27	0	0	9401
P42684-1#23	0	27	27	P42684-1	879	906	+	27	P42684-1	0	2061	ENST00000511413.5	0	2061	++	133	P42684-1#23	0	27	ENST00000511413.5	879	906	+	27	0	0	9402
P42684-1#23	0	27	27	P42684-1	879	906	+	27	P42684-1	0	2061	ENST00000507173.5	0	1998	++	132	P42684-1#23	0	27	ENST00000507173.5	816	843	+	27	0	0	9403
P42684-1#23	0	27	27	P42684-1	879	906	+	27	P42684-1	219	2061	ENST00000504405.5	111	1953	++	131	P42684-1#23	0	27	ENST00000504405.5	771	798	+	27	0	0	9404
P42684-1#23	0	27	27	P42684-1	879	906	+	27	P42684-1	0	3546	ENST00000502732.6	280	3826	++	130	P42684-1#23	0	27	ENST00000502732.6	1159	1186	+	27	0	0	9405
P42684-1#23	0	27	27	P42684-1	879	906	+	27	P42684-1	0	3546	ENST00000367623.8	0	3483	++	41	P42684-1#23	0	27	ENST00000367623.8	816	843	+	27	0	0	9406
P42684-1#23	0	27	27	P42684-1	879	906	+	27	P42684-1	156	2061	ENST00000344730.8	143	2048	++	33	P42684-1#23	0	27	ENST00000344730.8	866	893	+	27	0	0	9407
P42684-1#24	0	3	3	P42684-1	948	951	+	3	P42684-1	156	3546	ENST00000512653.5	123	3513	++	134	P42684-1#24	0	3	ENST00000512653.5	915	918	+	3	0	0	9408
P42684-1#24	0	3	3	P42684-1	948	951	+	3	P42684-1	0	2061	ENST00000511413.5	0	2061	++	133	P42684-1#24	0	3	ENST00000511413.5	948	951	+	3	0	0	9409
P42684-1#24	0	3	3	P42684-1	948	951	+	3	P42684-1	0	2061	ENST00000507173.5	0	1998	++	132	P42684-1#24	0	3	ENST00000507173.5	885	888	+	3	0	0	9410
P42684-1#24	0	3	3	P42684-1	948	951	+	3	P42684-1	219	2061	ENST00000504405.5	111	1953	++	131	P42684-1#24	0	3	ENST00000504405.5	840	843	+	3	0	0	9411
P42684-1#24	0	3	3	P42684-1	948	951	+	3	P42684-1	0	3546	ENST00000502732.6	280	3826	++	130	P42684-1#24	0	3	ENST00000502732.6	1228	1231	+	3	0	0	9412
P42684-1#24	0	3	3	P42684-1	948	951	+	3	P42684-1	0	3546	ENST00000367623.8	0	3483	++	41	P42684-1#24	0	3	ENST00000367623.8	885	888	+	3	0	0	9413
P42684-1#24	0	3	3	P42684-1	948	951	+	3	P42684-1	156	2061	ENST00000344730.8	143	2048	++	33	P42684-1#24	0	3	ENST00000344730.8	935	938	+	3	0	0	9414
P42684-1#25	0	21	21	P42684-1	1083	1104	+	21	P42684-1	156	3546	ENST00000512653.5	123	3513	++	134	P42684-1#25	0	21	ENST00000512653.5	1050	1071	+	21	0	0	9415
P42684-1#25	0	21	21	P42684-1	1083	1104	+	21	P42684-1	0	2061	ENST00000511413.5	0	2061	++	133	P42684-1#25	0	21	ENST00000511413.5	1083	1104	+	21	0	0	9416
P42684-1#25	0	21	21	P42684-1	1083	1104	+	21	P42684-1	0	2061	ENST00000507173.5	0	1998	++	132	P42684-1#25	0	21	ENST00000507173.5	1020	1041	+	21	0	0	9417
P42684-1#25	0	21	21	P42684-1	1083	1104	+	21	P42684-1	219	2061	ENST00000504405.5	111	1953	++	131	P42684-1#25	0	21	ENST00000504405.5	975	996	+	21	0	0	9418
P42684-1#25	0	21	21	P42684-1	1083	1104	+	21	P42684-1	0	3546	ENST00000502732.6	280	3826	++	130	P42684-1#25	0	21	ENST00000502732.6	1363	1384	+	21	0	0	9419
P42684-1#25	0	21	21	P42684-1	1083	1104	+	21	P42684-1	0	3546	ENST00000367623.8	0	3483	++	41	P42684-1#25	0	21	ENST00000367623.8	1020	1041	+	21	0	0	9420
P42684-1#25	0	21	21	P42684-1	1083	1104	+	21	P42684-1	156	2061	ENST00000344730.8	143	2048	++	33	P42684-1#25	0	21	ENST00000344730.8	1070	1091	+	21	0	0	9421
P42684-1#26	0	3	3	P42684-1	288	291	+	3	P42684-1	156	3546	ENST00000512653.5	123	3513	++	134	P42684-1#26	0	3	ENST00000512653.5	255	258	+	3	0	0	9422
P42684-1#26	0	3	3	P42684-1	288	291	+	3	P42684-1	0	2061	ENST00000511413.5	0	2061	++	133	P42684-1#26	0	3	ENST00000511413.5	288	291	+	3	0	0	9423
P42684-1#26	0	3	3	P42684-1	288	291	+	3	P42684-1	0	2061	ENST00000507173.5	0	1998	++	132	P42684-1#26	0	3	ENST00000507173.5	225	228	+	3	0	0	9424
P42684-1#26	0	3	3	P42684-1	288	291	+	3	P42684-1	219	2061	ENST00000504405.5	111	1953	++	131	P42684-1#26	0	3	ENST00000504405.5	180	183	+	3	0	0	9425
P42684-1#26	0	3	3	P42684-1	288	291	+	3	P42684-1	0	3546	ENST00000502732.6	280	3826	++	130	P42684-1#26	0	3	ENST00000502732.6	568	571	+	3	0	0	9426
P42684-1#26	0	3	3	P42684-1	288	291	+	3	P42684-1	0	3546	ENST00000367623.8	0	3483	++	41	P42684-1#26	0	3	ENST00000367623.8	225	228	+	3	0	0	9427
P42684-1#26	0	3	3	P42684-1	288	291	+	3	P42684-1	156	2061	ENST00000344730.8	143	2048	++	33	P42684-1#26	0	3	ENST00000344730.8	275	278	+	3	0	0	9428
P42684-1#27	0	3	3	P42684-1	345	348	+	3	P42684-1	156	3546	ENST00000512653.5	123	3513	++	134	P42684-1#27	0	3	ENST00000512653.5	312	315	+	3	0	0	9429
P42684-1#27	0	3	3	P42684-1	345	348	+	3	P42684-1	0	2061	ENST00000511413.5	0	2061	++	133	P42684-1#27	0	3	ENST00000511413.5	345	348	+	3	0	0	9430
P42684-1#27	0	3	3	P42684-1	345	348	+	3	P42684-1	0	2061	ENST00000507173.5	0	1998	++	132	P42684-1#27	0	3	ENST00000507173.5	282	285	+	3	0	0	9431
P42684-1#27	0	3	3	P42684-1	345	348	+	3	P42684-1	219	2061	ENST00000504405.5	111	1953	++	131	P42684-1#27	0	3	ENST00000504405.5	237	240	+	3	0	0	9432
P42684-1#27	0	3	3	P42684-1	345	348	+	3	P42684-1	0	3546	ENST00000502732.6	280	3826	++	130	P42684-1#27	0	3	ENST00000502732.6	625	628	+	3	0	0	9433
P42684-1#27	0	3	3	P42684-1	345	348	+	3	P42684-1	0	3546	ENST00000367623.8	0	3483	++	41	P42684-1#27	0	3	ENST00000367623.8	282	285	+	3	0	0	9434
P42684-1#27	0	3	3	P42684-1	345	348	+	3	P42684-1	156	2061	ENST00000344730.8	143	2048	++	33	P42684-1#27	0	3	ENST00000344730.8	332	335	+	3	0	0	9435
P42684-1#28	0	3	3	P42684-1	480	483	+	3	P42684-1	156	3546	ENST00000512653.5	123	3513	++	134	P42684-1#28	0	3	ENST00000512653.5	447	450	+	3	0	0	9436
P42684-1#28	0	3	3	P42684-1	480	483	+	3	P42684-1	0	2061	ENST00000511413.5	0	2061	++	133	P42684-1#28	0	3	ENST00000511413.5	480	483	+	3	0	0	9437
P42684-1#28	0	3	3	P42684-1	480	483	+	3	P42684-1	0	2061	ENST00000507173.5	0	1998	++	132	P42684-1#28	0	3	ENST00000507173.5	417	420	+	3	0	0	9438
P42684-1#28	0	3	3	P42684-1	480	483	+	3	P42684-1	219	2061	ENST00000504405.5	111	1953	++	131	P42684-1#28	0	3	ENST00000504405.5	372	375	+	3	0	0	9439
P42684-1#28	0	3	3	P42684-1	480	483	+	3	P42684-1	0	3546	ENST00000502732.6	280	3826	++	130	P42684-1#28	0	3	ENST00000502732.6	760	763	+	3	0	0	9440
P42684-1#28	0	3	3	P42684-1	480	483	+	3	P42684-1	0	3546	ENST00000367623.8	0	3483	++	41	P42684-1#28	0	3	ENST00000367623.8	417	420	+	3	0	0	9441
P42684-1#28	0	3	3	P42684-1	480	483	+	3	P42684-1	156	2061	ENST00000344730.8	143	2048	++	33	P42684-1#28	0	3	ENST00000344730.8	467	470	+	3	0	0	9442
P42684-1#29	0	3	3	P42684-1	519	522	+	3	P42684-1	156	3546	ENST00000512653.5	123	3513	++	134	P42684-1#29	0	3	ENST00000512653.5	486	489	+	3	0	0	9443
P42684-1#29	0	3	3	P42684-1	519	522	+	3	P42684-1	0	2061	ENST00000511413.5	0	2061	++	133	P42684-1#29	0	3	ENST00000511413.5	519	522	+	3	0	0	9444
P42684-1#29	0	3	3	P42684-1	519	522	+	3	P42684-1	0	2061	ENST00000507173.5	0	1998	++	132	P42684-1#29	0	3	ENST00000507173.5	456	459	+	3	0	0	9445
P42684-1#29	0	3	3	P42684-1	519	522	+	3	P42684-1	219	2061	ENST00000504405.5	111	1953	++	131	P42684-1#29	0	3	ENST00000504405.5	411	414	+	3	0	0	9446
P42684-1#29	0	3	3	P42684-1	519	522	+	3	P42684-1	0	3546	ENST00000502732.6	280	3826	++	130	P42684-1#29	0	3	ENST00000502732.6	799	802	+	3	0	0	9447
P42684-1#29	0	3	3	P42684-1	519	522	+	3	P42684-1	0	3546	ENST00000367623.8	0	3483	++	41	P42684-1#29	0	3	ENST00000367623.8	456	459	+	3	0	0	9448
P42684-1#29	0	3	3	P42684-1	519	522	+	3	P42684-1	156	2061	ENST00000344730.8	143	2048	++	33	P42684-1#29	0	3	ENST00000344730.8	506	509	+	3	0	0	9449
P42684-1#30	0	3	3	P42684-1	552	555	+	3	P42684-1	156	3546	ENST00000512653.5	123	3513	++	134	P42684-1#30	0	3	ENST00000512653.5	519	522	+	3	0	0	9450
P42684-1#30	0	3	3	P42684-1	552	555	+	3	P42684-1	0	2061	ENST00000511413.5	0	2061	++	133	P42684-1#30	0	3	ENST00000511413.5	552	555	+	3	0	0	9451
P42684-1#30	0	3	3	P42684-1	552	555	+	3	P42684-1	0	2061	ENST00000507173.5	0	1998	++	132	P42684-1#30	0	3	ENST00000507173.5	489	492	+	3	0	0	9452
P42684-1#30	0	3	3	P42684-1	552	555	+	3	P42684-1	219	2061	ENST00000504405.5	111	1953	++	131	P42684-1#30	0	3	ENST00000504405.5	444	447	+	3	0	0	9453
P42684-1#30	0	3	3	P42684-1	552	555	+	3	P42684-1	0	3546	ENST00000502732.6	280	3826	++	130	P42684-1#30	0	3	ENST00000502732.6	832	835	+	3	0	0	9454
P42684-1#30	0	3	3	P42684-1	552	555	+	3	P42684-1	0	3546	ENST00000367623.8	0	3483	++	41	P42684-1#30	0	3	ENST00000367623.8	489	492	+	3	0	0	9455
P42684-1#30	0	3	3	P42684-1	552	555	+	3	P42684-1	156	2061	ENST00000344730.8	143	2048	++	33	P42684-1#30	0	3	ENST00000344730.8	539	542	+	3	0	0	9456
P42684-1#31	0	3	3	P42684-1	651	654	+	3	P42684-1	156	3546	ENST00000512653.5	123	3513	++	134	P42684-1#31	0	3	ENST00000512653.5	618	621	+	3	0	0	9457
P42684-1#31	0	3	3	P42684-1	651	654	+	3	P42684-1	0	2061	ENST00000511413.5	0	2061	++	133	P42684-1#31	0	3	ENST00000511413.5	651	654	+	3	0	0	9458
P42684-1#31	0	3	3	P42684-1	651	654	+	3	P42684-1	0	2061	ENST00000507173.5	0	1998	++	132	P42684-1#31	0	3	ENST00000507173.5	588	591	+	3	0	0	9459
P42684-1#31	0	3	3	P42684-1	651	654	+	3	P42684-1	219	2061	ENST00000504405.5	111	1953	++	131	P42684-1#31	0	3	ENST00000504405.5	543	546	+	3	0	0	9460
P42684-1#31	0	3	3	P42684-1	651	654	+	3	P42684-1	0	3546	ENST00000502732.6	280	3826	++	130	P42684-1#31	0	3	ENST00000502732.6	931	934	+	3	0	0	9461
P42684-1#31	0	3	3	P42684-1	651	654	+	3	P42684-1	0	3546	ENST00000367623.8	0	3483	++	41	P42684-1#31	0	3	ENST00000367623.8	588	591	+	3	0	0	9462
P42684-1#31	0	3	3	P42684-1	651	654	+	3	P42684-1	156	2061	ENST00000344730.8	143	2048	++	33	P42684-1#31	0	3	ENST00000344730.8	638	641	+	3	0	0	9463
P42684-1#32	0	3	3	P42684-1	690	693	+	3	P42684-1	156	3546	ENST00000512653.5	123	3513	++	134	P42684-1#32	0	3	ENST00000512653.5	657	660	+	3	0	0	9464
P42684-1#32	0	3	3	P42684-1	690	693	+	3	P42684-1	0	2061	ENST00000511413.5	0	2061	++	133	P42684-1#32	0	3	ENST00000511413.5	690	693	+	3	0	0	9465
P42684-1#32	0	3	3	P42684-1	690	693	+	3	P42684-1	0	2061	ENST00000507173.5	0	1998	++	132	P42684-1#32	0	3	ENST00000507173.5	627	630	+	3	0	0	9466
P42684-1#32	0	3	3	P42684-1	690	693	+	3	P42684-1	219	2061	ENST00000504405.5	111	1953	++	131	P42684-1#32	0	3	ENST00000504405.5	582	585	+	3	0	0	9467
P42684-1#32	0	3	3	P42684-1	690	693	+	3	P42684-1	0	3546	ENST00000502732.6	280	3826	++	130	P42684-1#32	0	3	ENST00000502732.6	970	973	+	3	0	0	9468
P42684-1#32	0	3	3	P42684-1	690	693	+	3	P42684-1	0	3546	ENST00000367623.8	0	3483	++	41	P42684-1#32	0	3	ENST00000367623.8	627	630	+	3	0	0	9469
P42684-1#32	0	3	3	P42684-1	690	693	+	3	P42684-1	156	2061	ENST00000344730.8	143	2048	++	33	P42684-1#32	0	3	ENST00000344730.8	677	680	+	3	0	0	9470
P42684-1#33	0	3	3	P42684-1	780	783	+	3	P42684-1	156	3546	ENST00000512653.5	123	3513	++	134	P42684-1#33	0	3	ENST00000512653.5	747	750	+	3	0	0	9471
P42684-1#33	0	3	3	P42684-1	780	783	+	3	P42684-1	0	2061	ENST00000511413.5	0	2061	++	133	P42684-1#33	0	3	ENST00000511413.5	780	783	+	3	0	0	9472
P42684-1#33	0	3	3	P42684-1	780	783	+	3	P42684-1	0	2061	ENST00000507173.5	0	1998	++	132	P42684-1#33	0	3	ENST00000507173.5	717	720	+	3	0	0	9473
P42684-1#33	0	3	3	P42684-1	780	783	+	3	P42684-1	219	2061	ENST00000504405.5	111	1953	++	131	P42684-1#33	0	3	ENST00000504405.5	672	675	+	3	0	0	9474
P42684-1#33	0	3	3	P42684-1	780	783	+	3	P42684-1	0	3546	ENST00000502732.6	280	3826	++	130	P42684-1#33	0	3	ENST00000502732.6	1060	1063	+	3	0	0	9475
P42684-1#33	0	3	3	P42684-1	780	783	+	3	P42684-1	0	3546	ENST00000367623.8	0	3483	++	41	P42684-1#33	0	3	ENST00000367623.8	717	720	+	3	0	0	9476
P42684-1#33	0	3	3	P42684-1	780	783	+	3	P42684-1	156	2061	ENST00000344730.8	143	2048	++	33	P42684-1#33	0	3	ENST00000344730.8	767	770	+	3	0	0	9477
P42684-1#34	0	3	3	P42684-1	813	816	+	3	P42684-1	156	3546	ENST00000512653.5	123	3513	++	134	P42684-1#34	0	3	ENST00000512653.5	780	783	+	3	0	0	9478
P42684-1#34	0	3	3	P42684-1	813	816	+	3	P42684-1	0	2061	ENST00000511413.5	0	2061	++	133	P42684-1#34	0	3	ENST00000511413.5	813	816	+	3	0	0	9479
P42684-1#34	0	3	3	P42684-1	813	816	+	3	P42684-1	0	2061	ENST00000507173.5	0	1998	++	132	P42684-1#34	0	3	ENST00000507173.5	750	753	+	3	0	0	9480
P42684-1#34	0	3	3	P42684-1	813	816	+	3	P42684-1	219	2061	ENST00000504405.5	111	1953	++	131	P42684-1#34	0	3	ENST00000504405.5	705	708	+	3	0	0	9481
P42684-1#34	0	3	3	P42684-1	813	816	+	3	P42684-1	0	3546	ENST00000502732.6	280	3826	++	130	P42684-1#34	0	3	ENST00000502732.6	1093	1096	+	3	0	0	9482
P42684-1#34	0	3	3	P42684-1	813	816	+	3	P42684-1	0	3546	ENST00000367623.8	0	3483	++	41	P42684-1#34	0	3	ENST00000367623.8	750	753	+	3	0	0	9483
P42684-1#34	0	3	3	P42684-1	813	816	+	3	P42684-1	156	2061	ENST00000344730.8	143	2048	++	33	P42684-1#34	0	3	ENST00000344730.8	800	803	+	3	0	0	9484
P42684-1#35	0	3	3	P42684-1	822	825	+	3	P42684-1	156	3546	ENST00000512653.5	123	3513	++	134	P42684-1#35	0	3	ENST00000512653.5	789	792	+	3	0	0	9485
P42684-1#35	0	3	3	P42684-1	822	825	+	3	P42684-1	0	2061	ENST00000511413.5	0	2061	++	133	P42684-1#35	0	3	ENST00000511413.5	822	825	+	3	0	0	9486
P42684-1#35	0	3	3	P42684-1	822	825	+	3	P42684-1	0	2061	ENST00000507173.5	0	1998	++	132	P42684-1#35	0	3	ENST00000507173.5	759	762	+	3	0	0	9487
P42684-1#35	0	3	3	P42684-1	822	825	+	3	P42684-1	219	2061	ENST00000504405.5	111	1953	++	131	P42684-1#35	0	3	ENST00000504405.5	714	717	+	3	0	0	9488
P42684-1#35	0	3	3	P42684-1	822	825	+	3	P42684-1	0	3546	ENST00000502732.6	280	3826	++	130	P42684-1#35	0	3	ENST00000502732.6	1102	1105	+	3	0	0	9489
P42684-1#35	0	3	3	P42684-1	822	825	+	3	P42684-1	0	3546	ENST00000367623.8	0	3483	++	41	P42684-1#35	0	3	ENST00000367623.8	759	762	+	3	0	0	9490
P42684-1#35	0	3	3	P42684-1	822	825	+	3	P42684-1	156	2061	ENST00000344730.8	143	2048	++	33	P42684-1#35	0	3	ENST00000344730.8	809	812	+	3	0	0	9491
P42684-1#36	0	3	3	P42684-1	894	897	+	3	P42684-1	156	3546	ENST00000512653.5	123	3513	++	134	P42684-1#36	0	3	ENST00000512653.5	861	864	+	3	0	0	9492
P42684-1#36	0	3	3	P42684-1	894	897	+	3	P42684-1	0	2061	ENST00000511413.5	0	2061	++	133	P42684-1#36	0	3	ENST00000511413.5	894	897	+	3	0	0	9493
P42684-1#36	0	3	3	P42684-1	894	897	+	3	P42684-1	0	2061	ENST00000507173.5	0	1998	++	132	P42684-1#36	0	3	ENST00000507173.5	831	834	+	3	0	0	9494
P42684-1#36	0	3	3	P42684-1	894	897	+	3	P42684-1	219	2061	ENST00000504405.5	111	1953	++	131	P42684-1#36	0	3	ENST00000504405.5	786	789	+	3	0	0	9495
P42684-1#36	0	3	3	P42684-1	894	897	+	3	P42684-1	0	3546	ENST00000502732.6	280	3826	++	130	P42684-1#36	0	3	ENST00000502732.6	1174	1177	+	3	0	0	9496
P42684-1#36	0	3	3	P42684-1	894	897	+	3	P42684-1	0	3546	ENST00000367623.8	0	3483	++	41	P42684-1#36	0	3	ENST00000367623.8	831	834	+	3	0	0	9497
P42684-1#36	0	3	3	P42684-1	894	897	+	3	P42684-1	156	2061	ENST00000344730.8	143	2048	++	33	P42684-1#36	0	3	ENST00000344730.8	881	884	+	3	0	0	9498
P42684-1#37	0	3	3	P42684-1	906	909	+	3	P42684-1	156	3546	ENST00000512653.5	123	3513	++	134	P42684-1#37	0	3	ENST00000512653.5	873	876	+	3	0	0	9499
P42684-1#37	0	3	3	P42684-1	906	909	+	3	P42684-1	0	2061	ENST00000511413.5	0	2061	++	133	P42684-1#37	0	3	ENST00000511413.5	906	909	+	3	0	0	9500
P42684-1#37	0	3	3	P42684-1	906	909	+	3	P42684-1	0	2061	ENST00000507173.5	0	1998	++	132	P42684-1#37	0	3	ENST00000507173.5	843	846	+	3	0	0	9501
P42684-1#37	0	3	3	P42684-1	906	909	+	3	P42684-1	219	2061	ENST00000504405.5	111	1953	++	131	P42684-1#37	0	3	ENST00000504405.5	798	801	+	3	0	0	9502
P42684-1#37	0	3	3	P42684-1	906	909	+	3	P42684-1	0	3546	ENST00000502732.6	280	3826	++	130	P42684-1#37	0	3	ENST00000502732.6	1186	1189	+	3	0	0	9503
P42684-1#37	0	3	3	P42684-1	906	909	+	3	P42684-1	0	3546	ENST00000367623.8	0	3483	++	41	P42684-1#37	0	3	ENST00000367623.8	843	846	+	3	0	0	9504
P42684-1#37	0	3	3	P42684-1	906	909	+	3	P42684-1	156	2061	ENST00000344730.8	143	2048	++	33	P42684-1#37	0	3	ENST00000344730.8	893	896	+	3	0	0	9505
P42684-1#38	0	3	3	P42684-1	1314	1317	+	3	P42684-1	156	3546	ENST00000512653.5	123	3513	++	134	P42684-1#38	0	3	ENST00000512653.5	1281	1284	+	3	0	0	9506
P42684-1#38	0	3	3	P42684-1	1314	1317	+	3	P42684-1	0	2061	ENST00000511413.5	0	2061	++	133	P42684-1#38	0	3	ENST00000511413.5	1314	1317	+	3	0	0	9507
P42684-1#38	0	3	3	P42684-1	1314	1317	+	3	P42684-1	0	2061	ENST00000507173.5	0	1998	++	132	P42684-1#38	0	3	ENST00000507173.5	1251	1254	+	3	0	0	9508
P42684-1#38	0	3	3	P42684-1	1314	1317	+	3	P42684-1	219	2061	ENST00000504405.5	111	1953	++	131	P42684-1#38	0	3	ENST00000504405.5	1206	1209	+	3	0	0	9509
P42684-1#38	0	3	3	P42684-1	1314	1317	+	3	P42684-1	0	3546	ENST00000502732.6	280	3826	++	130	P42684-1#38	0	3	ENST00000502732.6	1594	1597	+	3	0	0	9510
P42684-1#38	0	3	3	P42684-1	1314	1317	+	3	P42684-1	0	3546	ENST00000367623.8	0	3483	++	41	P42684-1#38	0	3	ENST00000367623.8	1251	1254	+	3	0	0	9511
P42684-1#38	0	3	3	P42684-1	1314	1317	+	3	P42684-1	156	2061	ENST00000344730.8	143	2048	++	33	P42684-1#38	0	3	ENST00000344730.8	1301	1304	+	3	0	0	9512
P42684-1#39	0	3	3	P42684-1	1374	1377	+	3	P42684-1	156	3546	ENST00000512653.5	123	3513	++	134	P42684-1#39	0	3	ENST00000512653.5	1341	1344	+	3	0	0	9513
P42684-1#39	0	3	3	P42684-1	1374	1377	+	3	P42684-1	0	2061	ENST00000511413.5	0	2061	++	133	P42684-1#39	0	3	ENST00000511413.5	1374	1377	+	3	0	0	9514
P42684-1#39	0	3	3	P42684-1	1374	1377	+	3	P42684-1	0	2061	ENST00000507173.5	0	1998	++	132	P42684-1#39	0	3	ENST00000507173.5	1311	1314	+	3	0	0	9515
P42684-1#39	0	3	3	P42684-1	1374	1377	+	3	P42684-1	219	2061	ENST00000504405.5	111	1953	++	131	P42684-1#39	0	3	ENST00000504405.5	1266	1269	+	3	0	0	9516
P42684-1#39	0	3	3	P42684-1	1374	1377	+	3	P42684-1	0	3546	ENST00000502732.6	280	3826	++	130	P42684-1#39	0	3	ENST00000502732.6	1654	1657	+	3	0	0	9517
P42684-1#39	0	3	3	P42684-1	1374	1377	+	3	P42684-1	0	3546	ENST00000367623.8	0	3483	++	41	P42684-1#39	0	3	ENST00000367623.8	1311	1314	+	3	0	0	9518
P42684-1#39	0	3	3	P42684-1	1374	1377	+	3	P42684-1	156	2061	ENST00000344730.8	143	2048	++	33	P42684-1#39	0	3	ENST00000344730.8	1361	1364	+	3	0	0	9519
P42684-1#40	0	3	3	P42684-1	1701	1704	+	3	P42684-1	156	3546	ENST00000512653.5	123	3513	++	134	P42684-1#40	0	3	ENST00000512653.5	1668	1671	+	3	0	0	9520
P42684-1#40	0	3	3	P42684-1	1701	1704	+	3	P42684-1	0	2061	ENST00000511413.5	0	2061	++	133	P42684-1#40	0	3	ENST00000511413.5	1701	1704	+	3	0	0	9521
P42684-1#40	0	3	3	P42684-1	1701	1704	+	3	P42684-1	0	2061	ENST00000507173.5	0	1998	++	132	P42684-1#40	0	3	ENST00000507173.5	1638	1641	+	3	0	0	9522
P42684-1#40	0	3	3	P42684-1	1701	1704	+	3	P42684-1	219	2061	ENST00000504405.5	111	1953	++	131	P42684-1#40	0	3	ENST00000504405.5	1593	1596	+	3	0	0	9523
P42684-1#40	0	3	3	P42684-1	1701	1704	+	3	P42684-1	0	3546	ENST00000502732.6	280	3826	++	130	P42684-1#40	0	3	ENST00000502732.6	1981	1984	+	3	0	0	9524
P42684-1#40	0	3	3	P42684-1	1701	1704	+	3	P42684-1	0	3546	ENST00000367623.8	0	3483	++	41	P42684-1#40	0	3	ENST00000367623.8	1638	1641	+	3	0	0	9525
P42684-1#40	0	3	3	P42684-1	1701	1704	+	3	P42684-1	156	2061	ENST00000344730.8	143	2048	++	33	P42684-1#40	0	3	ENST00000344730.8	1688	1691	+	3	0	0	9526
P42684-1#41	0	3	3	P42684-1	1857	1860	+	3	P42684-1	156	3546	ENST00000512653.5	123	3513	++	134	P42684-1#41	0	3	ENST00000512653.5	1824	1827	+	3	0	0	9527
P42684-1#41	0	3	3	P42684-1	1857	1860	+	3	P42684-1	0	2061	ENST00000511413.5	0	2061	++	133	P42684-1#41	0	3	ENST00000511413.5	1857	1860	+	3	0	0	9528
P42684-1#41	0	3	3	P42684-1	1857	1860	+	3	P42684-1	0	2061	ENST00000507173.5	0	1998	++	132	P42684-1#41	0	3	ENST00000507173.5	1794	1797	+	3	0	0	9529
P42684-1#41	0	3	3	P42684-1	1857	1860	+	3	P42684-1	219	2061	ENST00000504405.5	111	1953	++	131	P42684-1#41	0	3	ENST00000504405.5	1749	1752	+	3	0	0	9530
P42684-1#41	0	3	3	P42684-1	1857	1860	+	3	P42684-1	0	3546	ENST00000502732.6	280	3826	++	130	P42684-1#41	0	3	ENST00000502732.6	2137	2140	+	3	0	0	9531
P42684-1#41	0	3	3	P42684-1	1857	1860	+	3	P42684-1	0	3546	ENST00000367623.8	0	3483	++	41	P42684-1#41	0	3	ENST00000367623.8	1794	1797	+	3	0	0	9532
P42684-1#41	0	3	3	P42684-1	1857	1860	+	3	P42684-1	156	2061	ENST00000344730.8	143	2048	++	33	P42684-1#41	0	3	ENST00000344730.8	1844	1847	+	3	0	0	9533
P42684-1#42	0	3	3	P42684-1	1890	1893	+	3	P42684-1	156	3546	ENST00000512653.5	123	3513	++	134	P42684-1#42	0	3	ENST00000512653.5	1857	1860	+	3	0	0	9534
P42684-1#42	0	3	3	P42684-1	1890	1893	+	3	P42684-1	0	2061	ENST00000511413.5	0	2061	++	133	P42684-1#42	0	3	ENST00000511413.5	1890	1893	+	3	0	0	9535
P42684-1#42	0	3	3	P42684-1	1890	1893	+	3	P42684-1	0	2061	ENST00000507173.5	0	1998	++	132	P42684-1#42	0	3	ENST00000507173.5	1827	1830	+	3	0	0	9536
P42684-1#42	0	3	3	P42684-1	1890	1893	+	3	P42684-1	219	2061	ENST00000504405.5	111	1953	++	131	P42684-1#42	0	3	ENST00000504405.5	1782	1785	+	3	0	0	9537
P42684-1#42	0	3	3	P42684-1	1890	1893	+	3	P42684-1	0	3546	ENST00000502732.6	280	3826	++	130	P42684-1#42	0	3	ENST00000502732.6	2170	2173	+	3	0	0	9538
P42684-1#42	0	3	3	P42684-1	1890	1893	+	3	P42684-1	0	3546	ENST00000367623.8	0	3483	++	41	P42684-1#42	0	3	ENST00000367623.8	1827	1830	+	3	0	0	9539
P42684-1#42	0	3	3	P42684-1	1890	1893	+	3	P42684-1	156	2061	ENST00000344730.8	143	2048	++	33	P42684-1#42	0	3	ENST00000344730.8	1877	1880	+	3	0	0	9540
P42684-1#43	0	3	3	P42684-1	1896	1899	+	3	P42684-1	156	3546	ENST00000512653.5	123	3513	++	134	P42684-1#43	0	3	ENST00000512653.5	1863	1866	+	3	0	0	9541
P42684-1#43	0	3	3	P42684-1	1896	1899	+	3	P42684-1	0	2061	ENST00000511413.5	0	2061	++	133	P42684-1#43	0	3	ENST00000511413.5	1896	1899	+	3	0	0	9542
P42684-1#43	0	3	3	P42684-1	1896	1899	+	3	P42684-1	0	2061	ENST00000507173.5	0	1998	++	132	P42684-1#43	0	3	ENST00000507173.5	1833	1836	+	3	0	0	9543
P42684-1#43	0	3	3	P42684-1	1896	1899	+	3	P42684-1	219	2061	ENST00000504405.5	111	1953	++	131	P42684-1#43	0	3	ENST00000504405.5	1788	1791	+	3	0	0	9544
P42684-1#43	0	3	3	P42684-1	1896	1899	+	3	P42684-1	0	3546	ENST00000502732.6	280	3826	++	130	P42684-1#43	0	3	ENST00000502732.6	2176	2179	+	3	0	0	9545
P42684-1#43	0	3	3	P42684-1	1896	1899	+	3	P42684-1	0	3546	ENST00000367623.8	0	3483	++	41	P42684-1#43	0	3	ENST00000367623.8	1833	1836	+	3	0	0	9546
P42684-1#43	0	3	3	P42684-1	1896	1899	+	3	P42684-1	156	2061	ENST00000344730.8	143	2048	++	33	P42684-1#43	0	3	ENST00000344730.8	1883	1886	+	3	0	0	9547
P42684-1#44	0	3	3	P42684-1	1962	1965	+	3	P42684-1	156	3546	ENST00000512653.5	123	3513	++	134	P42684-1#44	0	3	ENST00000512653.5	1929	1932	+	3	0	0	9548
P42684-1#44	0	3	3	P42684-1	1962	1965	+	3	P42684-1	0	2061	ENST00000511413.5	0	2061	++	133	P42684-1#44	0	3	ENST00000511413.5	1962	1965	+	3	0	0	9549
P42684-1#44	0	3	3	P42684-1	1962	1965	+	3	P42684-1	0	2061	ENST00000507173.5	0	1998	++	132	P42684-1#44	0	3	ENST00000507173.5	1899	1902	+	3	0	0	9550
P42684-1#44	0	3	3	P42684-1	1962	1965	+	3	P42684-1	219	2061	ENST00000504405.5	111	1953	++	131	P42684-1#44	0	3	ENST00000504405.5	1854	1857	+	3	0	0	9551
P42684-1#44	0	3	3	P42684-1	1962	1965	+	3	P42684-1	0	3546	ENST00000502732.6	280	3826	++	130	P42684-1#44	0	3	ENST00000502732.6	2242	2245	+	3	0	0	9552
P42684-1#44	0	3	3	P42684-1	1962	1965	+	3	P42684-1	0	3546	ENST00000367623.8	0	3483	++	41	P42684-1#44	0	3	ENST00000367623.8	1899	1902	+	3	0	0	9553
P42684-1#44	0	3	3	P42684-1	1962	1965	+	3	P42684-1	156	2061	ENST00000344730.8	143	2048	++	33	P42684-1#44	0	3	ENST00000344730.8	1949	1952	+	3	0	0	9554
P42684-1#45	0	3	3	P42684-1	2004	2007	+	3	P42684-1	156	3546	ENST00000512653.5	123	3513	++	134	P42684-1#45	0	3	ENST00000512653.5	1971	1974	+	3	0	0	9555
P42684-1#45	0	3	3	P42684-1	2004	2007	+	3	P42684-1	0	2061	ENST00000511413.5	0	2061	++	133	P42684-1#45	0	3	ENST00000511413.5	2004	2007	+	3	0	0	9556
P42684-1#45	0	3	3	P42684-1	2004	2007	+	3	P42684-1	0	2061	ENST00000507173.5	0	1998	++	132	P42684-1#45	0	3	ENST00000507173.5	1941	1944	+	3	0	0	9557
P42684-1#45	0	3	3	P42684-1	2004	2007	+	3	P42684-1	219	2061	ENST00000504405.5	111	1953	++	131	P42684-1#45	0	3	ENST00000504405.5	1896	1899	+	3	0	0	9558
P42684-1#45	0	3	3	P42684-1	2004	2007	+	3	P42684-1	0	3546	ENST00000502732.6	280	3826	++	130	P42684-1#45	0	3	ENST00000502732.6	2284	2287	+	3	0	0	9559
P42684-1#45	0	3	3	P42684-1	2004	2007	+	3	P42684-1	0	3546	ENST00000367623.8	0	3483	++	41	P42684-1#45	0	3	ENST00000367623.8	1941	1944	+	3	0	0	9560
P42684-1#45	0	3	3	P42684-1	2004	2007	+	3	P42684-1	156	2061	ENST00000344730.8	143	2048	++	33	P42684-1#45	0	3	ENST00000344730.8	1991	1994	+	3	0	0	9561
P42684-1#46	0	3	3	P42684-1	2007	2010	+	3	P42684-1	156	3546	ENST00000512653.5	123	3513	++	134	P42684-1#46	0	3	ENST00000512653.5	1974	1977	+	3	0	0	9562
P42684-1#46	0	3	3	P42684-1	2007	2010	+	3	P42684-1	0	2061	ENST00000511413.5	0	2061	++	133	P42684-1#46	0	3	ENST00000511413.5	2007	2010	+	3	0	0	9563
P42684-1#46	0	3	3	P42684-1	2007	2010	+	3	P42684-1	0	2061	ENST00000507173.5	0	1998	++	132	P42684-1#46	0	3	ENST00000507173.5	1944	1947	+	3	0	0	9564
P42684-1#46	0	3	3	P42684-1	2007	2010	+	3	P42684-1	219	2061	ENST00000504405.5	111	1953	++	131	P42684-1#46	0	3	ENST00000504405.5	1899	1902	+	3	0	0	9565
P42684-1#46	0	3	3	P42684-1	2007	2010	+	3	P42684-1	0	3546	ENST00000502732.6	280	3826	++	130	P42684-1#46	0	3	ENST00000502732.6	2287	2290	+	3	0	0	9566
P42684-1#46	0	3	3	P42684-1	2007	2010	+	3	P42684-1	0	3546	ENST00000367623.8	0	3483	++	41	P42684-1#46	0	3	ENST00000367623.8	1944	1947	+	3	0	0	9567
P42684-1#46	0	3	3	P42684-1	2007	2010	+	3	P42684-1	156	2061	ENST00000344730.8	143	2048	++	33	P42684-1#46	0	3	ENST00000344730.8	1994	1997	+	3	0	0	9568
P42684-1#47	0	3	3	P42684-1	2010	2013	+	3	P42684-1	156	3546	ENST00000512653.5	123	3513	++	134	P42684-1#47	0	3	ENST00000512653.5	1977	1980	+	3	0	0	9569
P42684-1#47	0	3	3	P42684-1	2010	2013	+	3	P42684-1	0	2061	ENST00000511413.5	0	2061	++	133	P42684-1#47	0	3	ENST00000511413.5	2010	2013	+	3	0	0	9570
P42684-1#47	0	3	3	P42684-1	2010	2013	+	3	P42684-1	0	2061	ENST00000507173.5	0	1998	++	132	P42684-1#47	0	3	ENST00000507173.5	1947	1950	+	3	0	0	9571
P42684-1#47	0	3	3	P42684-1	2010	2013	+	3	P42684-1	219	2061	ENST00000504405.5	111	1953	++	131	P42684-1#47	0	3	ENST00000504405.5	1902	1905	+	3	0	0	9572
P42684-1#47	0	3	3	P42684-1	2010	2013	+	3	P42684-1	0	3546	ENST00000502732.6	280	3826	++	130	P42684-1#47	0	3	ENST00000502732.6	2290	2293	+	3	0	0	9573
P42684-1#47	0	3	3	P42684-1	2010	2013	+	3	P42684-1	0	3546	ENST00000367623.8	0	3483	++	41	P42684-1#47	0	3	ENST00000367623.8	1947	1950	+	3	0	0	9574
P42684-1#47	0	3	3	P42684-1	2010	2013	+	3	P42684-1	156	2061	ENST00000344730.8	143	2048	++	33	P42684-1#47	0	3	ENST00000344730.8	1997	2000	+	3	0	0	9575
P42684-1#48	0	3	3	P42684-1	2046	2049	+	3	P42684-1	156	3546	ENST00000512653.5	123	3513	++	134	P42684-1#48	0	3	ENST00000512653.5	2013	2016	+	3	0	0	9576
P42684-1#48	0	3	3	P42684-1	2046	2049	+	3	P42684-1	0	2061	ENST00000511413.5	0	2061	++	133	P42684-1#48	0	3	ENST00000511413.5	2046	2049	+	3	0	0	9577
P42684-1#48	0	3	3	P42684-1	2046	2049	+	3	P42684-1	0	2061	ENST00000507173.5	0	1998	++	132	P42684-1#48	0	3	ENST00000507173.5	1983	1986	+	3	0	0	9578
P42684-1#48	0	3	3	P42684-1	2046	2049	+	3	P42684-1	219	2061	ENST00000504405.5	111	1953	++	131	P42684-1#48	0	3	ENST00000504405.5	1938	1941	+	3	0	0	9579
P42684-1#48	0	3	3	P42684-1	2046	2049	+	3	P42684-1	0	3546	ENST00000502732.6	280	3826	++	130	P42684-1#48	0	3	ENST00000502732.6	2326	2329	+	3	0	0	9580
P42684-1#48	0	3	3	P42684-1	2046	2049	+	3	P42684-1	0	3546	ENST00000367623.8	0	3483	++	41	P42684-1#48	0	3	ENST00000367623.8	1983	1986	+	3	0	0	9581
P42684-1#48	0	3	3	P42684-1	2046	2049	+	3	P42684-1	156	2061	ENST00000344730.8	143	2048	++	33	P42684-1#48	0	3	ENST00000344730.8	2033	2036	+	3	0	0	9582
P42684-1#49	0	3	3	P42684-1	2151	2154	+	3	P42684-1	156	3546	ENST00000512653.5	123	3513	++	134	P42684-1#49	0	3	ENST00000512653.5	2118	2121	+	3	0	0	9583
P42684-1#49	0	3	3	P42684-1	2151	2154	+	3	P42684-1	0	3546	ENST00000502732.6	280	3826	++	130	P42684-1#49	0	3	ENST00000502732.6	2431	2434	+	3	0	0	9584
P42684-1#49	0	3	3	P42684-1	2151	2154	+	3	P42684-1	0	3546	ENST00000367623.8	0	3483	++	41	P42684-1#49	0	3	ENST00000367623.8	2088	2091	+	3	0	0	9585
P42684-1#50	0	3	3	P42684-1	2325	2328	+	3	P42684-1	156	3546	ENST00000512653.5	123	3513	++	134	P42684-1#50	0	3	ENST00000512653.5	2292	2295	+	3	0	0	9586
P42684-1#50	0	3	3	P42684-1	2325	2328	+	3	P42684-1	0	3546	ENST00000502732.6	280	3826	++	130	P42684-1#50	0	3	ENST00000502732.6	2605	2608	+	3	0	0	9587
P42684-1#50	0	3	3	P42684-1	2325	2328	+	3	P42684-1	0	3546	ENST00000367623.8	0	3483	++	41	P42684-1#50	0	3	ENST00000367623.8	2262	2265	+	3	0	0	9588
P42684-1#51	0	3	3	P42684-1	2346	2349	+	3	P42684-1	156	3546	ENST00000512653.5	123	3513	++	134	P42684-1#51	0	3	ENST00000512653.5	2313	2316	+	3	0	0	9589
P42684-1#51	0	3	3	P42684-1	2346	2349	+	3	P42684-1	0	3546	ENST00000502732.6	280	3826	++	130	P42684-1#51	0	3	ENST00000502732.6	2626	2629	+	3	0	0	9590
P42684-1#51	0	3	3	P42684-1	2346	2349	+	3	P42684-1	0	3546	ENST00000367623.8	0	3483	++	41	P42684-1#51	0	3	ENST00000367623.8	2283	2286	+	3	0	0	9591
P42684-1#52	0	3	3	P42684-1	2397	2400	+	3	P42684-1	156	3546	ENST00000512653.5	123	3513	++	134	P42684-1#52	0	3	ENST00000512653.5	2364	2367	+	3	0	0	9592
P42684-1#52	0	3	3	P42684-1	2397	2400	+	3	P42684-1	0	3546	ENST00000502732.6	280	3826	++	130	P42684-1#52	0	3	ENST00000502732.6	2677	2680	+	3	0	0	9593
P42684-1#52	0	3	3	P42684-1	2397	2400	+	3	P42684-1	0	3546	ENST00000367623.8	0	3483	++	41	P42684-1#52	0	3	ENST00000367623.8	2334	2337	+	3	0	0	9594
P42684-1#53	0	3	3	P42684-1	2448	2451	+	3	P42684-1	156	3546	ENST00000512653.5	123	3513	++	134	P42684-1#53	0	3	ENST00000512653.5	2415	2418	+	3	0	0	9595
P42684-1#53	0	3	3	P42684-1	2448	2451	+	3	P42684-1	0	3546	ENST00000502732.6	280	3826	++	130	P42684-1#53	0	3	ENST00000502732.6	2728	2731	+	3	0	0	9596
P42684-1#53	0	3	3	P42684-1	2448	2451	+	3	P42684-1	0	3546	ENST00000367623.8	0	3483	++	41	P42684-1#53	0	3	ENST00000367623.8	2385	2388	+	3	0	0	9597
P42684-1#54	0	3	3	P42684-1	2457	2460	+	3	P42684-1	156	3546	ENST00000512653.5	123	3513	++	134	P42684-1#54	0	3	ENST00000512653.5	2424	2427	+	3	0	0	9598
P42684-1#54	0	3	3	P42684-1	2457	2460	+	3	P42684-1	0	3546	ENST00000502732.6	280	3826	++	130	P42684-1#54	0	3	ENST00000502732.6	2737	2740	+	3	0	0	9599
P42684-1#54	0	3	3	P42684-1	2457	2460	+	3	P42684-1	0	3546	ENST00000367623.8	0	3483	++	41	P42684-1#54	0	3	ENST00000367623.8	2394	2397	+	3	0	0	9600
P42684-1#55	0	3	3	P42684-1	2742	2745	+	3	P42684-1	156	3546	ENST00000512653.5	123	3513	++	134	P42684-1#55	0	3	ENST00000512653.5	2709	2712	+	3	0	0	9601
P42684-1#55	0	3	3	P42684-1	2742	2745	+	3	P42684-1	0	3546	ENST00000502732.6	280	3826	++	130	P42684-1#55	0	3	ENST00000502732.6	3022	3025	+	3	0	0	9602
P42684-1#55	0	3	3	P42684-1	2742	2745	+	3	P42684-1	0	3546	ENST00000367623.8	0	3483	++	41	P42684-1#55	0	3	ENST00000367623.8	2679	2682	+	3	0	0	9603
P42684-1#56	0	3	3	P42684-1	2805	2808	+	3	P42684-1	156	3546	ENST00000512653.5	123	3513	++	134	P42684-1#56	0	3	ENST00000512653.5	2772	2775	+	3	0	0	9604
P42684-1#56	0	3	3	P42684-1	2805	2808	+	3	P42684-1	0	3546	ENST00000502732.6	280	3826	++	130	P42684-1#56	0	3	ENST00000502732.6	3085	3088	+	3	0	0	9605
P42684-1#56	0	3	3	P42684-1	2805	2808	+	3	P42684-1	0	3546	ENST00000367623.8	0	3483	++	41	P42684-1#56	0	3	ENST00000367623.8	2742	2745	+	3	0	0	9606
P42684-1#57	0	3	3	P42684-1	3	6	+	3	P42684-1	0	2061	ENST00000511413.5	0	2061	++	133	P42684-1#57	0	3	ENST00000511413.5	3	6	+	3	0	0	9607
P42684-1#57	0	3	3	P42684-1	3	6	+	3	P42684-1	0	2061	ENST00000507173.5	0	1998	++	132	P42684-1#57	0	3	ENST00000507173.5	3	6	+	3	0	0	9608
P42684-1#57	0	3	3	P42684-1	3	6	+	3	P42684-1	0	3546	ENST00000502732.6	280	3826	++	130	P42684-1#57	0	3	ENST00000502732.6	283	286	+	3	0	0	9609
P42684-1#57	0	3	3	P42684-1	3	6	+	3	P42684-1	0	3546	ENST00000367623.8	0	3483	++	41	P42684-1#57	0	3	ENST00000367623.8	3	6	+	3	0	0	9610
P42684-1#58	0	219	219	P42684-1	0	219	+	219	P42684-1	156	3546	ENST00000512653.5	123	3513	++	134	P42684-1#58	156	219	ENST00000512653.5	123	186	+	63	156	0	9611
P42684-1#58	0	219	219	P42684-1	0	219	+	219	P42684-1	0	2061	ENST00000511413.5	0	2061	++	133	P42684-1#58	0	219	ENST00000511413.5	0	219	+	219	0	0	9612
P42684-1#58	0	219	219	P42684-1	0	219	+	219	P42684-1	0	2061	ENST00000507173.5	0	1998	++	132	P42684-1#58	0	156	ENST00000507173.5	0	156	+	156	0	63	9613
P42684-1#58	0	219	219	P42684-1	0	219	+	219	P42684-1	0	3546	ENST00000502732.6	280	3826	++	130	P42684-1#58	0	219	ENST00000502732.6	280	499	+	219	0	0	9614
P42684-1#58	0	219	219	P42684-1	0	219	+	219	P42684-1	0	3546	ENST00000367623.8	0	3483	++	41	P42684-1#58	0	156	ENST00000367623.8	0	156	+	156	0	63	9615
P42684-1#58	0	219	219	P42684-1	0	219	+	219	P42684-1	156	2061	ENST00000344730.8	143	2048	++	33	P42684-1#58	156	219	ENST00000344730.8	143	206	+	63	156	0	9616
P42684-1#59	0	156	156	P42684-1	0	156	+	156	P42684-1	0	2061	ENST00000511413.5	0	2061	++	133	P42684-1#59	0	156	ENST00000511413.5	0	156	+	156	0	0	9617
P42684-1#59	0	156	156	P42684-1	0	156	+	156	P42684-1	0	2061	ENST00000507173.5	0	1998	++	132	P42684-1#59	0	156	ENST00000507173.5	0	156	+	156	0	0	9618
P42684-1#59	0	156	156	P42684-1	0	156	+	156	P42684-1	0	3546	ENST00000502732.6	280	3826	++	130	P42684-1#59	0	156	ENST00000502732.6	280	436	+	156	0	0	9619
P42684-1#59	0	156	156	P42684-1	0	156	+	156	P42684-1	0	3546	ENST00000367623.8	0	3483	++	41	P42684-1#59	0	156	ENST00000367623.8	0	156	+	156	0	0	9620
P42684-1#60	0	63	63	P42684-1	156	219	+	63	P42684-1	156	3546	ENST00000512653.5	123	3513	++	134	P42684-1#60	0	63	ENST00000512653.5	123	186	+	63	0	0	9621
P42684-1#60	0	63	63	P42684-1	156	219	+	63	P42684-1	0	2061	ENST00000511413.5	0	2061	++	133	P42684-1#60	0	63	ENST00000511413.5	156	219	+	63	0	0	9622
P42684-1#60	0	63	63	P42684-1	156	219	+	63	P42684-1	0	3546	ENST00000502732.6	280	3826	++	130	P42684-1#60	0	63	ENST00000502732.6	436	499	+	63	0	0	9623
P42684-1#60	0	63	63	P42684-1	156	219	+	63	P42684-1	156	2061	ENST00000344730.8	143	2048	++	33	P42684-1#60	0	63	ENST00000344730.8	143	206	+	63	0	0	9624
P42684-1#61	0	45	45	P42684-1	1647	1692	+	45	P42684-1	156	3546	ENST00000512653.5	123	3513	++	134	P42684-1#61	0	45	ENST00000512653.5	1614	1659	+	45	0	0	9625
P42684-1#61	0	45	45	P42684-1	1647	1692	+	45	P42684-1	0	2061	ENST00000511413.5	0	2061	++	133	P42684-1#61	0	45	ENST00000511413.5	1647	1692	+	45	0	0	9626
P42684-1#61	0	45	45	P42684-1	1647	1692	+	45	P42684-1	0	2061	ENST00000507173.5	0	1998	++	132	P42684-1#61	0	45	ENST00000507173.5	1584	1629	+	45	0	0	9627
P42684-1#61	0	45	45	P42684-1	1647	1692	+	45	P42684-1	219	2061	ENST00000504405.5	111	1953	++	131	P42684-1#61	0	45	ENST00000504405.5	1539	1584	+	45	0	0	9628
P42684-1#61	0	45	45	P42684-1	1647	1692	+	45	P42684-1	0	3546	ENST00000502732.6	280	3826	++	130	P42684-1#61	0	45	ENST00000502732.6	1927	1972	+	45	0	0	9629
P42684-1#61	0	45	45	P42684-1	1647	1692	+	45	P42684-1	0	3546	ENST00000367623.8	0	3483	++	41	P42684-1#61	0	45	ENST00000367623.8	1584	1629	+	45	0	0	9630
P42684-1#61	0	45	45	P42684-1	1647	1692	+	45	P42684-1	156	2061	ENST00000344730.8	143	2048	++	33	P42684-1#61	0	45	ENST00000344730.8	1634	1679	+	45	0	0	9631
P42684-1#62	0	1854	1854	P42684-1	1692	3546	+	1854	P42684-1	156	3546	ENST00000512653.5	123	3513	++	134	P42684-1#62	0	1854	ENST00000512653.5	1659	3513	+	1854	0	0	9632
P42684-1#62	0	1854	1854	P42684-1	1692	3546	+	1854	P42684-1	0	2061	ENST00000511413.5	0	2061	++	133	P42684-1#62	0	369	ENST00000511413.5	1692	2061	+	369	0	1485	9633
P42684-1#62	0	1854	1854	P42684-1	1692	3546	+	1854	P42684-1	0	2061	ENST00000507173.5	0	1998	++	132	P42684-1#62	0	369	ENST00000507173.5	1629	1998	+	369	0	1485	9634
P42684-1#62	0	1854	1854	P42684-1	1692	3546	+	1854	P42684-1	219	2061	ENST00000504405.5	111	1953	++	131	P42684-1#62	0	369	ENST00000504405.5	1584	1953	+	369	0	1485	9635
P42684-1#62	0	1854	1854	P42684-1	1692	3546	+	1854	P42684-1	0	3546	ENST00000502732.6	280	3826	++	130	P42684-1#62	0	1854	ENST00000502732.6	1972	3826	+	1854	0	0	9636
P42684-1#62	0	1854	1854	P42684-1	1692	3546	+	1854	P42684-1	0	3546	ENST00000367623.8	0	3483	++	41	P42684-1#62	0	1854	ENST00000367623.8	1629	3483	+	1854	0	0	9637
P42684-1#62	0	1854	1854	P42684-1	1692	3546	+	1854	P42684-1	156	2061	ENST00000344730.8	143	2048	++	33	P42684-1#62	0	369	ENST00000344730.8	1679	2048	+	369	0	1485	9638
P42684-1#63	0	309	309	P42684-1	2061	2370	+	309	P42684-1	156	3546	ENST00000512653.5	123	3513	++	134	P42684-1#63	0	309	ENST00000512653.5	2028	2337	+	309	0	0	9639
P42684-1#63	0	309	309	P42684-1	2061	2370	+	309	P42684-1	0	3546	ENST00000502732.6	280	3826	++	130	P42684-1#63	0	309	ENST00000502732.6	2341	2650	+	309	0	0	9640
P42684-1#63	0	309	309	P42684-1	2061	2370	+	309	P42684-1	0	3546	ENST00000367623.8	0	3483	++	41	P42684-1#63	0	309	ENST00000367623.8	1998	2307	+	309	0	0	9641
P42684-1#64	0	3	3	P42684-1	231	234	+	3	P42684-1	156	3546	ENST00000512653.5	123	3513	++	134	P42684-1#64	0	3	ENST00000512653.5	198	201	+	3	0	0	9642
P42684-1#64	0	3	3	P42684-1	231	234	+	3	P42684-1	0	2061	ENST00000511413.5	0	2061	++	133	P42684-1#64	0	3	ENST00000511413.5	231	234	+	3	0	0	9643
P42684-1#64	0	3	3	P42684-1	231	234	+	3	P42684-1	0	2061	ENST00000507173.5	0	1998	++	132	P42684-1#64	0	3	ENST00000507173.5	168	171	+	3	0	0	9644
P42684-1#64	0	3	3	P42684-1	231	234	+	3	P42684-1	219	2061	ENST00000504405.5	111	1953	++	131	P42684-1#64	0	3	ENST00000504405.5	123	126	+	3	0	0	9645
P42684-1#64	0	3	3	P42684-1	231	234	+	3	P42684-1	0	3546	ENST00000502732.6	280	3826	++	130	P42684-1#64	0	3	ENST00000502732.6	511	514	+	3	0	0	9646
P42684-1#64	0	3	3	P42684-1	231	234	+	3	P42684-1	0	3546	ENST00000367623.8	0	3483	++	41	P42684-1#64	0	3	ENST00000367623.8	168	171	+	3	0	0	9647
P42684-1#64	0	3	3	P42684-1	231	234	+	3	P42684-1	156	2061	ENST00000344730.8	143	2048	++	33	P42684-1#64	0	3	ENST00000344730.8	218	221	+	3	0	0	9648
P42684-1#65	0	3	3	P42684-1	294	297	+	3	P42684-1	156	3546	ENST00000512653.5	123	3513	++	134	P42684-1#65	0	3	ENST00000512653.5	261	264	+	3	0	0	9649
P42684-1#65	0	3	3	P42684-1	294	297	+	3	P42684-1	0	2061	ENST00000511413.5	0	2061	++	133	P42684-1#65	0	3	ENST00000511413.5	294	297	+	3	0	0	9650
P42684-1#65	0	3	3	P42684-1	294	297	+	3	P42684-1	0	2061	ENST00000507173.5	0	1998	++	132	P42684-1#65	0	3	ENST00000507173.5	231	234	+	3	0	0	9651
P42684-1#65	0	3	3	P42684-1	294	297	+	3	P42684-1	219	2061	ENST00000504405.5	111	1953	++	131	P42684-1#65	0	3	ENST00000504405.5	186	189	+	3	0	0	9652
P42684-1#65	0	3	3	P42684-1	294	297	+	3	P42684-1	0	3546	ENST00000502732.6	280	3826	++	130	P42684-1#65	0	3	ENST00000502732.6	574	577	+	3	0	0	9653
P42684-1#65	0	3	3	P42684-1	294	297	+	3	P42684-1	0	3546	ENST00000367623.8	0	3483	++	41	P42684-1#65	0	3	ENST00000367623.8	231	234	+	3	0	0	9654
P42684-1#65	0	3	3	P42684-1	294	297	+	3	P42684-1	156	2061	ENST00000344730.8	143	2048	++	33	P42684-1#65	0	3	ENST00000344730.8	281	284	+	3	0	0	9655
P42684-1#66	0	3	3	P42684-1	1554	1557	+	3	P42684-1	156	3546	ENST00000512653.5	123	3513	++	134	P42684-1#66	0	3	ENST00000512653.5	1521	1524	+	3	0	0	9656
P42684-1#66	0	3	3	P42684-1	1554	1557	+	3	P42684-1	0	2061	ENST00000511413.5	0	2061	++	133	P42684-1#66	0	3	ENST00000511413.5	1554	1557	+	3	0	0	9657
P42684-1#66	0	3	3	P42684-1	1554	1557	+	3	P42684-1	0	2061	ENST00000507173.5	0	1998	++	132	P42684-1#66	0	3	ENST00000507173.5	1491	1494	+	3	0	0	9658
P42684-1#66	0	3	3	P42684-1	1554	1557	+	3	P42684-1	219	2061	ENST00000504405.5	111	1953	++	131	P42684-1#66	0	3	ENST00000504405.5	1446	1449	+	3	0	0	9659
P42684-1#66	0	3	3	P42684-1	1554	1557	+	3	P42684-1	0	3546	ENST00000502732.6	280	3826	++	130	P42684-1#66	0	3	ENST00000502732.6	1834	1837	+	3	0	0	9660
P42684-1#66	0	3	3	P42684-1	1554	1557	+	3	P42684-1	0	3546	ENST00000367623.8	0	3483	++	41	P42684-1#66	0	3	ENST00000367623.8	1491	1494	+	3	0	0	9661
P42684-1#66	0	3	3	P42684-1	1554	1557	+	3	P42684-1	156	2061	ENST00000344730.8	143	2048	++	33	P42684-1#66	0	3	ENST00000344730.8	1541	1544	+	3	0	0	9662
P42684-1#67	0	3	3	P42684-1	2304	2307	+	3	P42684-1	156	3546	ENST00000512653.5	123	3513	++	134	P42684-1#67	0	3	ENST00000512653.5	2271	2274	+	3	0	0	9663
P42684-1#67	0	3	3	P42684-1	2304	2307	+	3	P42684-1	0	3546	ENST00000502732.6	280	3826	++	130	P42684-1#67	0	3	ENST00000502732.6	2584	2587	+	3	0	0	9664
P42684-1#67	0	3	3	P42684-1	2304	2307	+	3	P42684-1	0	3546	ENST00000367623.8	0	3483	++	41	P42684-1#67	0	3	ENST00000367623.8	2241	2244	+	3	0	0	9665
P42684-1#68	0	3	3	P42684-1	2787	2790	+	3	P42684-1	156	3546	ENST00000512653.5	123	3513	++	134	P42684-1#68	0	3	ENST00000512653.5	2754	2757	+	3	0	0	9666
P42684-1#68	0	3	3	P42684-1	2787	2790	+	3	P42684-1	0	3546	ENST00000502732.6	280	3826	++	130	P42684-1#68	0	3	ENST00000502732.6	3067	3070	+	3	0	0	9667
P42684-1#68	0	3	3	P42684-1	2787	2790	+	3	P42684-1	0	3546	ENST00000367623.8	0	3483	++	41	P42684-1#68	0	3	ENST00000367623.8	2724	2727	+	3	0	0	9668
P42684-1#69	0	3	3	P42684-1	2835	2838	+	3	P42684-1	156	3546	ENST00000512653.5	123	3513	++	134	P42684-1#69	0	3	ENST00000512653.5	2802	2805	+	3	0	0	9669
P42684-1#69	0	3	3	P42684-1	2835	2838	+	3	P42684-1	0	3546	ENST00000502732.6	280	3826	++	130	P42684-1#69	0	3	ENST00000502732.6	3115	3118	+	3	0	0	9670
P42684-1#69	0	3	3	P42684-1	2835	2838	+	3	P42684-1	0	3546	ENST00000367623.8	0	3483	++	41	P42684-1#69	0	3	ENST00000367623.8	2772	2775	+	3	0	0	9671
P42684-1#70	0	3	3	P42684-1	2985	2988	+	3	P42684-1	156	3546	ENST00000512653.5	123	3513	++	134	P42684-1#70	0	3	ENST00000512653.5	2952	2955	+	3	0	0	9672
P42684-1#70	0	3	3	P42684-1	2985	2988	+	3	P42684-1	0	3546	ENST00000502732.6	280	3826	++	130	P42684-1#70	0	3	ENST00000502732.6	3265	3268	+	3	0	0	9673
P42684-1#70	0	3	3	P42684-1	2985	2988	+	3	P42684-1	0	3546	ENST00000367623.8	0	3483	++	41	P42684-1#70	0	3	ENST00000367623.8	2922	2925	+	3	0	0	9674
P42684-1#71	0	3	3	P42684-1	3252	3255	+	3	P42684-1	156	3546	ENST00000512653.5	123	3513	++	134	P42684-1#71	0	3	ENST00000512653.5	3219	3222	+	3	0	0	9675
P42684-1#71	0	3	3	P42684-1	3252	3255	+	3	P42684-1	0	3546	ENST00000502732.6	280	3826	++	130	P42684-1#71	0	3	ENST00000502732.6	3532	3535	+	3	0	0	9676
P42684-1#71	0	3	3	P42684-1	3252	3255	+	3	P42684-1	0	3546	ENST00000367623.8	0	3483	++	41	P42684-1#71	0	3	ENST00000367623.8	3189	3192	+	3	0	0	9677
P42684-1#72	0	3	3	P42684-1	3300	3303	+	3	P42684-1	156	3546	ENST00000512653.5	123	3513	++	134	P42684-1#72	0	3	ENST00000512653.5	3267	3270	+	3	0	0	9678
P42684-1#72	0	3	3	P42684-1	3300	3303	+	3	P42684-1	0	3546	ENST00000502732.6	280	3826	++	130	P42684-1#72	0	3	ENST00000502732.6	3580	3583	+	3	0	0	9679
P42684-1#72	0	3	3	P42684-1	3300	3303	+	3	P42684-1	0	3546	ENST00000367623.8	0	3483	++	41	P42684-1#72	0	3	ENST00000367623.8	3237	3240	+	3	0	0	9680
P42684-1#73	0	6	6	P42684-1	1026	1032	+	6	P42684-1	156	3546	ENST00000512653.5	123	3513	++	134	P42684-1#73	0	6	ENST00000512653.5	993	999	+	6	0	0	9681
P42684-1#73	0	6	6	P42684-1	1026	1032	+	6	P42684-1	0	2061	ENST00000511413.5	0	2061	++	133	P42684-1#73	0	6	ENST00000511413.5	1026	1032	+	6	0	0	9682
P42684-1#73	0	6	6	P42684-1	1026	1032	+	6	P42684-1	0	2061	ENST00000507173.5	0	1998	++	132	P42684-1#73	0	6	ENST00000507173.5	963	969	+	6	0	0	9683
P42684-1#73	0	6	6	P42684-1	1026	1032	+	6	P42684-1	219	2061	ENST00000504405.5	111	1953	++	131	P42684-1#73	0	6	ENST00000504405.5	918	924	+	6	0	0	9684
P42684-1#73	0	6	6	P42684-1	1026	1032	+	6	P42684-1	0	3546	ENST00000502732.6	280	3826	++	130	P42684-1#73	0	6	ENST00000502732.6	1306	1312	+	6	0	0	9685
P42684-1#73	0	6	6	P42684-1	1026	1032	+	6	P42684-1	0	3546	ENST00000367623.8	0	3483	++	41	P42684-1#73	0	6	ENST00000367623.8	963	969	+	6	0	0	9686
P42684-1#73	0	6	6	P42684-1	1026	1032	+	6	P42684-1	156	2061	ENST00000344730.8	143	2048	++	33	P42684-1#73	0	6	ENST00000344730.8	1013	1019	+	6	0	0	9687
P42684-1#74	0	3	3	P42684-1	1302	1305	+	3	P42684-1	156	3546	ENST00000512653.5	123	3513	++	134	P42684-1#74	0	3	ENST00000512653.5	1269	1272	+	3	0	0	9688
P42684-1#74	0	3	3	P42684-1	1302	1305	+	3	P42684-1	0	2061	ENST00000511413.5	0	2061	++	133	P42684-1#74	0	3	ENST00000511413.5	1302	1305	+	3	0	0	9689
P42684-1#74	0	3	3	P42684-1	1302	1305	+	3	P42684-1	0	2061	ENST00000507173.5	0	1998	++	132	P42684-1#74	0	3	ENST00000507173.5	1239	1242	+	3	0	0	9690
P42684-1#74	0	3	3	P42684-1	1302	1305	+	3	P42684-1	219	2061	ENST00000504405.5	111	1953	++	131	P42684-1#74	0	3	ENST00000504405.5	1194	1197	+	3	0	0	9691
P42684-1#74	0	3	3	P42684-1	1302	1305	+	3	P42684-1	0	3546	ENST00000502732.6	280	3826	++	130	P42684-1#74	0	3	ENST00000502732.6	1582	1585	+	3	0	0	9692
P42684-1#74	0	3	3	P42684-1	1302	1305	+	3	P42684-1	0	3546	ENST00000367623.8	0	3483	++	41	P42684-1#74	0	3	ENST00000367623.8	1239	1242	+	3	0	0	9693
P42684-1#74	0	3	3	P42684-1	1302	1305	+	3	P42684-1	156	2061	ENST00000344730.8	143	2048	++	33	P42684-1#74	0	3	ENST00000344730.8	1289	1292	+	3	0	0	9694
P42684-1#75	0	3	3	P42684-1	2940	2943	+	3	P42684-1	156	3546	ENST00000512653.5	123	3513	++	134	P42684-1#75	0	3	ENST00000512653.5	2907	2910	+	3	0	0	9695
P42684-1#75	0	3	3	P42684-1	2940	2943	+	3	P42684-1	0	3546	ENST00000502732.6	280	3826	++	130	P42684-1#75	0	3	ENST00000502732.6	3220	3223	+	3	0	0	9696
P42684-1#75	0	3	3	P42684-1	2940	2943	+	3	P42684-1	0	3546	ENST00000367623.8	0	3483	++	41	P42684-1#75	0	3	ENST00000367623.8	2877	2880	+	3	0	0	9697
P42684-1#76	0	18	18	P42684-1	330	348	+	18	P42684-1	156	3546	ENST00000512653.5	123	3513	++	134	P42684-1#76	0	18	ENST00000512653.5	297	315	+	18	0	0	9698
P42684-1#76	0	18	18	P42684-1	330	348	+	18	P42684-1	0	2061	ENST00000511413.5	0	2061	++	133	P42684-1#76	0	18	ENST00000511413.5	330	348	+	18	0	0	9699
P42684-1#76	0	18	18	P42684-1	330	348	+	18	P42684-1	0	2061	ENST00000507173.5	0	1998	++	132	P42684-1#76	0	18	ENST00000507173.5	267	285	+	18	0	0	9700
P42684-1#76	0	18	18	P42684-1	330	348	+	18	P42684-1	219	2061	ENST00000504405.5	111	1953	++	131	P42684-1#76	0	18	ENST00000504405.5	222	240	+	18	0	0	9701
P42684-1#76	0	18	18	P42684-1	330	348	+	18	P42684-1	0	3546	ENST00000502732.6	280	3826	++	130	P42684-1#76	0	18	ENST00000502732.6	610	628	+	18	0	0	9702
P42684-1#76	0	18	18	P42684-1	330	348	+	18	P42684-1	0	3546	ENST00000367623.8	0	3483	++	41	P42684-1#76	0	18	ENST00000367623.8	267	285	+	18	0	0	9703
P42684-1#76	0	18	18	P42684-1	330	348	+	18	P42684-1	156	2061	ENST00000344730.8	143	2048	++	33	P42684-1#76	0	18	ENST00000344730.8	317	335	+	18	0	0	9704
P42684-1#77	0	21	21	P42684-1	396	417	+	21	P42684-1	156	3546	ENST00000512653.5	123	3513	++	134	P42684-1#77	0	21	ENST00000512653.5	363	384	+	21	0	0	9705
P42684-1#77	0	21	21	P42684-1	396	417	+	21	P42684-1	0	2061	ENST00000511413.5	0	2061	++	133	P42684-1#77	0	21	ENST00000511413.5	396	417	+	21	0	0	9706
P42684-1#77	0	21	21	P42684-1	396	417	+	21	P42684-1	0	2061	ENST00000507173.5	0	1998	++	132	P42684-1#77	0	21	ENST00000507173.5	333	354	+	21	0	0	9707
P42684-1#77	0	21	21	P42684-1	396	417	+	21	P42684-1	219	2061	ENST00000504405.5	111	1953	++	131	P42684-1#77	0	21	ENST00000504405.5	288	309	+	21	0	0	9708
P42684-1#77	0	21	21	P42684-1	396	417	+	21	P42684-1	0	3546	ENST00000502732.6	280	3826	++	130	P42684-1#77	0	21	ENST00000502732.6	676	697	+	21	0	0	9709
P42684-1#77	0	21	21	P42684-1	396	417	+	21	P42684-1	0	3546	ENST00000367623.8	0	3483	++	41	P42684-1#77	0	21	ENST00000367623.8	333	354	+	21	0	0	9710
P42684-1#77	0	21	21	P42684-1	396	417	+	21	P42684-1	156	2061	ENST00000344730.8	143	2048	++	33	P42684-1#77	0	21	ENST00000344730.8	383	404	+	21	0	0	9711
P42684-1#78	0	30	30	P42684-1	420	450	+	30	P42684-1	156	3546	ENST00000512653.5	123	3513	++	134	P42684-1#78	0	30	ENST00000512653.5	387	417	+	30	0	0	9712
P42684-1#78	0	30	30	P42684-1	420	450	+	30	P42684-1	0	2061	ENST00000511413.5	0	2061	++	133	P42684-1#78	0	30	ENST00000511413.5	420	450	+	30	0	0	9713
P42684-1#78	0	30	30	P42684-1	420	450	+	30	P42684-1	0	2061	ENST00000507173.5	0	1998	++	132	P42684-1#78	0	30	ENST00000507173.5	357	387	+	30	0	0	9714
P42684-1#78	0	30	30	P42684-1	420	450	+	30	P42684-1	219	2061	ENST00000504405.5	111	1953	++	131	P42684-1#78	0	30	ENST00000504405.5	312	342	+	30	0	0	9715
P42684-1#78	0	30	30	P42684-1	420	450	+	30	P42684-1	0	3546	ENST00000502732.6	280	3826	++	130	P42684-1#78	0	30	ENST00000502732.6	700	730	+	30	0	0	9716
P42684-1#78	0	30	30	P42684-1	420	450	+	30	P42684-1	0	3546	ENST00000367623.8	0	3483	++	41	P42684-1#78	0	30	ENST00000367623.8	357	387	+	30	0	0	9717
P42684-1#78	0	30	30	P42684-1	420	450	+	30	P42684-1	156	2061	ENST00000344730.8	143	2048	++	33	P42684-1#78	0	30	ENST00000344730.8	407	437	+	30	0	0	9718
P42684-1#79	0	18	18	P42684-1	456	474	+	18	P42684-1	156	3546	ENST00000512653.5	123	3513	++	134	P42684-1#79	0	18	ENST00000512653.5	423	441	+	18	0	0	9719
P42684-1#79	0	18	18	P42684-1	456	474	+	18	P42684-1	0	2061	ENST00000511413.5	0	2061	++	133	P42684-1#79	0	18	ENST00000511413.5	456	474	+	18	0	0	9720
P42684-1#79	0	18	18	P42684-1	456	474	+	18	P42684-1	0	2061	ENST00000507173.5	0	1998	++	132	P42684-1#79	0	18	ENST00000507173.5	393	411	+	18	0	0	9721
P42684-1#79	0	18	18	P42684-1	456	474	+	18	P42684-1	219	2061	ENST00000504405.5	111	1953	++	131	P42684-1#79	0	18	ENST00000504405.5	348	366	+	18	0	0	9722
P42684-1#79	0	18	18	P42684-1	456	474	+	18	P42684-1	0	3546	ENST00000502732.6	280	3826	++	130	P42684-1#79	0	18	ENST00000502732.6	736	754	+	18	0	0	9723
P42684-1#79	0	18	18	P42684-1	456	474	+	18	P42684-1	0	3546	ENST00000367623.8	0	3483	++	41	P42684-1#79	0	18	ENST00000367623.8	393	411	+	18	0	0	9724
P42684-1#79	0	18	18	P42684-1	456	474	+	18	P42684-1	156	2061	ENST00000344730.8	143	2048	++	33	P42684-1#79	0	18	ENST00000344730.8	443	461	+	18	0	0	9725
P42684-1#80	0	9	9	P42684-1	474	483	+	9	P42684-1	156	3546	ENST00000512653.5	123	3513	++	134	P42684-1#80	0	9	ENST00000512653.5	441	450	+	9	0	0	9726
P42684-1#80	0	9	9	P42684-1	474	483	+	9	P42684-1	0	2061	ENST00000511413.5	0	2061	++	133	P42684-1#80	0	9	ENST00000511413.5	474	483	+	9	0	0	9727
P42684-1#80	0	9	9	P42684-1	474	483	+	9	P42684-1	0	2061	ENST00000507173.5	0	1998	++	132	P42684-1#80	0	9	ENST00000507173.5	411	420	+	9	0	0	9728
P42684-1#80	0	9	9	P42684-1	474	483	+	9	P42684-1	219	2061	ENST00000504405.5	111	1953	++	131	P42684-1#80	0	9	ENST00000504405.5	366	375	+	9	0	0	9729
P42684-1#80	0	9	9	P42684-1	474	483	+	9	P42684-1	0	3546	ENST00000502732.6	280	3826	++	130	P42684-1#80	0	9	ENST00000502732.6	754	763	+	9	0	0	9730
P42684-1#80	0	9	9	P42684-1	474	483	+	9	P42684-1	0	3546	ENST00000367623.8	0	3483	++	41	P42684-1#80	0	9	ENST00000367623.8	411	420	+	9	0	0	9731
P42684-1#80	0	9	9	P42684-1	474	483	+	9	P42684-1	156	2061	ENST00000344730.8	143	2048	++	33	P42684-1#80	0	9	ENST00000344730.8	461	470	+	9	0	0	9732
P42684-1#81	0	9	9	P42684-1	483	492	+	9	P42684-1	156	3546	ENST00000512653.5	123	3513	++	134	P42684-1#81	0	9	ENST00000512653.5	450	459	+	9	0	0	9733
P42684-1#81	0	9	9	P42684-1	483	492	+	9	P42684-1	0	2061	ENST00000511413.5	0	2061	++	133	P42684-1#81	0	9	ENST00000511413.5	483	492	+	9	0	0	9734
P42684-1#81	0	9	9	P42684-1	483	492	+	9	P42684-1	0	2061	ENST00000507173.5	0	1998	++	132	P42684-1#81	0	9	ENST00000507173.5	420	429	+	9	0	0	9735
P42684-1#81	0	9	9	P42684-1	483	492	+	9	P42684-1	219	2061	ENST00000504405.5	111	1953	++	131	P42684-1#81	0	9	ENST00000504405.5	375	384	+	9	0	0	9736
P42684-1#81	0	9	9	P42684-1	483	492	+	9	P42684-1	0	3546	ENST00000502732.6	280	3826	++	130	P42684-1#81	0	9	ENST00000502732.6	763	772	+	9	0	0	9737
P42684-1#81	0	9	9	P42684-1	483	492	+	9	P42684-1	0	3546	ENST00000367623.8	0	3483	++	41	P42684-1#81	0	9	ENST00000367623.8	420	429	+	9	0	0	9738
P42684-1#81	0	9	9	P42684-1	483	492	+	9	P42684-1	156	2061	ENST00000344730.8	143	2048	++	33	P42684-1#81	0	9	ENST00000344730.8	470	479	+	9	0	0	9739
P42684-1#82	0	9	9	P42684-1	501	510	+	9	P42684-1	156	3546	ENST00000512653.5	123	3513	++	134	P42684-1#82	0	9	ENST00000512653.5	468	477	+	9	0	0	9740
P42684-1#82	0	9	9	P42684-1	501	510	+	9	P42684-1	0	2061	ENST00000511413.5	0	2061	++	133	P42684-1#82	0	9	ENST00000511413.5	501	510	+	9	0	0	9741
P42684-1#82	0	9	9	P42684-1	501	510	+	9	P42684-1	0	2061	ENST00000507173.5	0	1998	++	132	P42684-1#82	0	9	ENST00000507173.5	438	447	+	9	0	0	9742
P42684-1#82	0	9	9	P42684-1	501	510	+	9	P42684-1	219	2061	ENST00000504405.5	111	1953	++	131	P42684-1#82	0	9	ENST00000504405.5	393	402	+	9	0	0	9743
P42684-1#82	0	9	9	P42684-1	501	510	+	9	P42684-1	0	3546	ENST00000502732.6	280	3826	++	130	P42684-1#82	0	9	ENST00000502732.6	781	790	+	9	0	0	9744
P42684-1#82	0	9	9	P42684-1	501	510	+	9	P42684-1	0	3546	ENST00000367623.8	0	3483	++	41	P42684-1#82	0	9	ENST00000367623.8	438	447	+	9	0	0	9745
P42684-1#82	0	9	9	P42684-1	501	510	+	9	P42684-1	156	2061	ENST00000344730.8	143	2048	++	33	P42684-1#82	0	9	ENST00000344730.8	488	497	+	9	0	0	9746
P42684-1#83	0	12	12	P42684-1	519	531	+	12	P42684-1	156	3546	ENST00000512653.5	123	3513	++	134	P42684-1#83	0	12	ENST00000512653.5	486	498	+	12	0	0	9747
P42684-1#83	0	12	12	P42684-1	519	531	+	12	P42684-1	0	2061	ENST00000511413.5	0	2061	++	133	P42684-1#83	0	12	ENST00000511413.5	519	531	+	12	0	0	9748
P42684-1#83	0	12	12	P42684-1	519	531	+	12	P42684-1	0	2061	ENST00000507173.5	0	1998	++	132	P42684-1#83	0	12	ENST00000507173.5	456	468	+	12	0	0	9749
P42684-1#83	0	12	12	P42684-1	519	531	+	12	P42684-1	219	2061	ENST00000504405.5	111	1953	++	131	P42684-1#83	0	12	ENST00000504405.5	411	423	+	12	0	0	9750
P42684-1#83	0	12	12	P42684-1	519	531	+	12	P42684-1	0	3546	ENST00000502732.6	280	3826	++	130	P42684-1#83	0	12	ENST00000502732.6	799	811	+	12	0	0	9751
P42684-1#83	0	12	12	P42684-1	519	531	+	12	P42684-1	0	3546	ENST00000367623.8	0	3483	++	41	P42684-1#83	0	12	ENST00000367623.8	456	468	+	12	0	0	9752
P42684-1#83	0	12	12	P42684-1	519	531	+	12	P42684-1	156	2061	ENST00000344730.8	143	2048	++	33	P42684-1#83	0	12	ENST00000344730.8	506	518	+	12	0	0	9753
P42684-1#84	0	24	24	P42684-1	537	561	+	24	P42684-1	156	3546	ENST00000512653.5	123	3513	++	134	P42684-1#84	0	24	ENST00000512653.5	504	528	+	24	0	0	9754
P42684-1#84	0	24	24	P42684-1	537	561	+	24	P42684-1	0	2061	ENST00000511413.5	0	2061	++	133	P42684-1#84	0	24	ENST00000511413.5	537	561	+	24	0	0	9755
P42684-1#84	0	24	24	P42684-1	537	561	+	24	P42684-1	0	2061	ENST00000507173.5	0	1998	++	132	P42684-1#84	0	24	ENST00000507173.5	474	498	+	24	0	0	9756
P42684-1#84	0	24	24	P42684-1	537	561	+	24	P42684-1	219	2061	ENST00000504405.5	111	1953	++	131	P42684-1#84	0	24	ENST00000504405.5	429	453	+	24	0	0	9757
P42684-1#84	0	24	24	P42684-1	537	561	+	24	P42684-1	0	3546	ENST00000502732.6	280	3826	++	130	P42684-1#84	0	24	ENST00000502732.6	817	841	+	24	0	0	9758
P42684-1#84	0	24	24	P42684-1	537	561	+	24	P42684-1	0	3546	ENST00000367623.8	0	3483	++	41	P42684-1#84	0	24	ENST00000367623.8	474	498	+	24	0	0	9759
P42684-1#84	0	24	24	P42684-1	537	561	+	24	P42684-1	156	2061	ENST00000344730.8	143	2048	++	33	P42684-1#84	0	24	ENST00000344730.8	524	548	+	24	0	0	9760
P42684-1#85	0	18	18	P42684-1	579	597	+	18	P42684-1	156	3546	ENST00000512653.5	123	3513	++	134	P42684-1#85	0	18	ENST00000512653.5	546	564	+	18	0	0	9761
P42684-1#85	0	18	18	P42684-1	579	597	+	18	P42684-1	0	2061	ENST00000511413.5	0	2061	++	133	P42684-1#85	0	18	ENST00000511413.5	579	597	+	18	0	0	9762
P42684-1#85	0	18	18	P42684-1	579	597	+	18	P42684-1	0	2061	ENST00000507173.5	0	1998	++	132	P42684-1#85	0	18	ENST00000507173.5	516	534	+	18	0	0	9763
P42684-1#85	0	18	18	P42684-1	579	597	+	18	P42684-1	219	2061	ENST00000504405.5	111	1953	++	131	P42684-1#85	0	18	ENST00000504405.5	471	489	+	18	0	0	9764
P42684-1#85	0	18	18	P42684-1	579	597	+	18	P42684-1	0	3546	ENST00000502732.6	280	3826	++	130	P42684-1#85	0	18	ENST00000502732.6	859	877	+	18	0	0	9765
P42684-1#85	0	18	18	P42684-1	579	597	+	18	P42684-1	0	3546	ENST00000367623.8	0	3483	++	41	P42684-1#85	0	18	ENST00000367623.8	516	534	+	18	0	0	9766
P42684-1#85	0	18	18	P42684-1	579	597	+	18	P42684-1	156	2061	ENST00000344730.8	143	2048	++	33	P42684-1#85	0	18	ENST00000344730.8	566	584	+	18	0	0	9767
P42684-1#86	0	21	21	P42684-1	618	639	+	21	P42684-1	156	3546	ENST00000512653.5	123	3513	++	134	P42684-1#86	0	21	ENST00000512653.5	585	606	+	21	0	0	9768
P42684-1#86	0	21	21	P42684-1	618	639	+	21	P42684-1	0	2061	ENST00000511413.5	0	2061	++	133	P42684-1#86	0	21	ENST00000511413.5	618	639	+	21	0	0	9769
P42684-1#86	0	21	21	P42684-1	618	639	+	21	P42684-1	0	2061	ENST00000507173.5	0	1998	++	132	P42684-1#86	0	21	ENST00000507173.5	555	576	+	21	0	0	9770
P42684-1#86	0	21	21	P42684-1	618	639	+	21	P42684-1	219	2061	ENST00000504405.5	111	1953	++	131	P42684-1#86	0	21	ENST00000504405.5	510	531	+	21	0	0	9771
P42684-1#86	0	21	21	P42684-1	618	639	+	21	P42684-1	0	3546	ENST00000502732.6	280	3826	++	130	P42684-1#86	0	21	ENST00000502732.6	898	919	+	21	0	0	9772
P42684-1#86	0	21	21	P42684-1	618	639	+	21	P42684-1	0	3546	ENST00000367623.8	0	3483	++	41	P42684-1#86	0	21	ENST00000367623.8	555	576	+	21	0	0	9773
P42684-1#86	0	21	21	P42684-1	618	639	+	21	P42684-1	156	2061	ENST00000344730.8	143	2048	++	33	P42684-1#86	0	21	ENST00000344730.8	605	626	+	21	0	0	9774
P42684-1#87	0	18	18	P42684-1	645	663	+	18	P42684-1	156	3546	ENST00000512653.5	123	3513	++	134	P42684-1#87	0	18	ENST00000512653.5	612	630	+	18	0	0	9775
P42684-1#87	0	18	18	P42684-1	645	663	+	18	P42684-1	0	2061	ENST00000511413.5	0	2061	++	133	P42684-1#87	0	18	ENST00000511413.5	645	663	+	18	0	0	9776
P42684-1#87	0	18	18	P42684-1	645	663	+	18	P42684-1	0	2061	ENST00000507173.5	0	1998	++	132	P42684-1#87	0	18	ENST00000507173.5	582	600	+	18	0	0	9777
P42684-1#87	0	18	18	P42684-1	645	663	+	18	P42684-1	219	2061	ENST00000504405.5	111	1953	++	131	P42684-1#87	0	18	ENST00000504405.5	537	555	+	18	0	0	9778
P42684-1#87	0	18	18	P42684-1	645	663	+	18	P42684-1	0	3546	ENST00000502732.6	280	3826	++	130	P42684-1#87	0	18	ENST00000502732.6	925	943	+	18	0	0	9779
P42684-1#87	0	18	18	P42684-1	645	663	+	18	P42684-1	0	3546	ENST00000367623.8	0	3483	++	41	P42684-1#87	0	18	ENST00000367623.8	582	600	+	18	0	0	9780
P42684-1#87	0	18	18	P42684-1	645	663	+	18	P42684-1	156	2061	ENST00000344730.8	143	2048	++	33	P42684-1#87	0	18	ENST00000344730.8	632	650	+	18	0	0	9781
P42684-1#88	0	9	9	P42684-1	675	684	+	9	P42684-1	156	3546	ENST00000512653.5	123	3513	++	134	P42684-1#88	0	9	ENST00000512653.5	642	651	+	9	0	0	9782
P42684-1#88	0	9	9	P42684-1	675	684	+	9	P42684-1	0	2061	ENST00000511413.5	0	2061	++	133	P42684-1#88	0	9	ENST00000511413.5	675	684	+	9	0	0	9783
P42684-1#88	0	9	9	P42684-1	675	684	+	9	P42684-1	0	2061	ENST00000507173.5	0	1998	++	132	P42684-1#88	0	9	ENST00000507173.5	612	621	+	9	0	0	9784
P42684-1#88	0	9	9	P42684-1	675	684	+	9	P42684-1	219	2061	ENST00000504405.5	111	1953	++	131	P42684-1#88	0	9	ENST00000504405.5	567	576	+	9	0	0	9785
P42684-1#88	0	9	9	P42684-1	675	684	+	9	P42684-1	0	3546	ENST00000502732.6	280	3826	++	130	P42684-1#88	0	9	ENST00000502732.6	955	964	+	9	0	0	9786
P42684-1#88	0	9	9	P42684-1	675	684	+	9	P42684-1	0	3546	ENST00000367623.8	0	3483	++	41	P42684-1#88	0	9	ENST00000367623.8	612	621	+	9	0	0	9787
P42684-1#88	0	9	9	P42684-1	675	684	+	9	P42684-1	156	2061	ENST00000344730.8	143	2048	++	33	P42684-1#88	0	9	ENST00000344730.8	662	671	+	9	0	0	9788
P42684-1#89	0	12	12	P42684-1	687	699	+	12	P42684-1	156	3546	ENST00000512653.5	123	3513	++	134	P42684-1#89	0	12	ENST00000512653.5	654	666	+	12	0	0	9789
P42684-1#89	0	12	12	P42684-1	687	699	+	12	P42684-1	0	2061	ENST00000511413.5	0	2061	++	133	P42684-1#89	0	12	ENST00000511413.5	687	699	+	12	0	0	9790
P42684-1#89	0	12	12	P42684-1	687	699	+	12	P42684-1	0	2061	ENST00000507173.5	0	1998	++	132	P42684-1#89	0	12	ENST00000507173.5	624	636	+	12	0	0	9791
P42684-1#89	0	12	12	P42684-1	687	699	+	12	P42684-1	219	2061	ENST00000504405.5	111	1953	++	131	P42684-1#89	0	12	ENST00000504405.5	579	591	+	12	0	0	9792
P42684-1#89	0	12	12	P42684-1	687	699	+	12	P42684-1	0	3546	ENST00000502732.6	280	3826	++	130	P42684-1#89	0	12	ENST00000502732.6	967	979	+	12	0	0	9793
P42684-1#89	0	12	12	P42684-1	687	699	+	12	P42684-1	0	3546	ENST00000367623.8	0	3483	++	41	P42684-1#89	0	12	ENST00000367623.8	624	636	+	12	0	0	9794
P42684-1#89	0	12	12	P42684-1	687	699	+	12	P42684-1	156	2061	ENST00000344730.8	143	2048	++	33	P42684-1#89	0	12	ENST00000344730.8	674	686	+	12	0	0	9795
P42684-1#90	0	15	15	P42684-1	705	720	+	15	P42684-1	156	3546	ENST00000512653.5	123	3513	++	134	P42684-1#90	0	15	ENST00000512653.5	672	687	+	15	0	0	9796
P42684-1#90	0	15	15	P42684-1	705	720	+	15	P42684-1	0	2061	ENST00000511413.5	0	2061	++	133	P42684-1#90	0	15	ENST00000511413.5	705	720	+	15	0	0	9797
P42684-1#90	0	15	15	P42684-1	705	720	+	15	P42684-1	0	2061	ENST00000507173.5	0	1998	++	132	P42684-1#90	0	15	ENST00000507173.5	642	657	+	15	0	0	9798
P42684-1#90	0	15	15	P42684-1	705	720	+	15	P42684-1	219	2061	ENST00000504405.5	111	1953	++	131	P42684-1#90	0	15	ENST00000504405.5	597	612	+	15	0	0	9799
P42684-1#90	0	15	15	P42684-1	705	720	+	15	P42684-1	0	3546	ENST00000502732.6	280	3826	++	130	P42684-1#90	0	15	ENST00000502732.6	985	1000	+	15	0	0	9800
P42684-1#90	0	15	15	P42684-1	705	720	+	15	P42684-1	0	3546	ENST00000367623.8	0	3483	++	41	P42684-1#90	0	15	ENST00000367623.8	642	657	+	15	0	0	9801
P42684-1#90	0	15	15	P42684-1	705	720	+	15	P42684-1	156	2061	ENST00000344730.8	143	2048	++	33	P42684-1#90	0	15	ENST00000344730.8	692	707	+	15	0	0	9802
P42684-1#91	0	24	24	P42684-1	720	744	+	24	P42684-1	156	3546	ENST00000512653.5	123	3513	++	134	P42684-1#91	0	24	ENST00000512653.5	687	711	+	24	0	0	9803
P42684-1#91	0	24	24	P42684-1	720	744	+	24	P42684-1	0	2061	ENST00000511413.5	0	2061	++	133	P42684-1#91	0	24	ENST00000511413.5	720	744	+	24	0	0	9804
P42684-1#91	0	24	24	P42684-1	720	744	+	24	P42684-1	0	2061	ENST00000507173.5	0	1998	++	132	P42684-1#91	0	24	ENST00000507173.5	657	681	+	24	0	0	9805
P42684-1#91	0	24	24	P42684-1	720	744	+	24	P42684-1	219	2061	ENST00000504405.5	111	1953	++	131	P42684-1#91	0	24	ENST00000504405.5	612	636	+	24	0	0	9806
P42684-1#91	0	24	24	P42684-1	720	744	+	24	P42684-1	0	3546	ENST00000502732.6	280	3826	++	130	P42684-1#91	0	24	ENST00000502732.6	1000	1024	+	24	0	0	9807
P42684-1#91	0	24	24	P42684-1	720	744	+	24	P42684-1	0	3546	ENST00000367623.8	0	3483	++	41	P42684-1#91	0	24	ENST00000367623.8	657	681	+	24	0	0	9808
P42684-1#91	0	24	24	P42684-1	720	744	+	24	P42684-1	156	2061	ENST00000344730.8	143	2048	++	33	P42684-1#91	0	24	ENST00000344730.8	707	731	+	24	0	0	9809
P42684-1#92	0	9	9	P42684-1	762	771	+	9	P42684-1	156	3546	ENST00000512653.5	123	3513	++	134	P42684-1#92	0	9	ENST00000512653.5	729	738	+	9	0	0	9810
P42684-1#92	0	9	9	P42684-1	762	771	+	9	P42684-1	0	2061	ENST00000511413.5	0	2061	++	133	P42684-1#92	0	9	ENST00000511413.5	762	771	+	9	0	0	9811
P42684-1#92	0	9	9	P42684-1	762	771	+	9	P42684-1	0	2061	ENST00000507173.5	0	1998	++	132	P42684-1#92	0	9	ENST00000507173.5	699	708	+	9	0	0	9812
P42684-1#92	0	9	9	P42684-1	762	771	+	9	P42684-1	219	2061	ENST00000504405.5	111	1953	++	131	P42684-1#92	0	9	ENST00000504405.5	654	663	+	9	0	0	9813
P42684-1#92	0	9	9	P42684-1	762	771	+	9	P42684-1	0	3546	ENST00000502732.6	280	3826	++	130	P42684-1#92	0	9	ENST00000502732.6	1042	1051	+	9	0	0	9814
P42684-1#92	0	9	9	P42684-1	762	771	+	9	P42684-1	0	3546	ENST00000367623.8	0	3483	++	41	P42684-1#92	0	9	ENST00000367623.8	699	708	+	9	0	0	9815
P42684-1#92	0	9	9	P42684-1	762	771	+	9	P42684-1	156	2061	ENST00000344730.8	143	2048	++	33	P42684-1#92	0	9	ENST00000344730.8	749	758	+	9	0	0	9816
P42684-1#93	0	9	9	P42684-1	837	846	+	9	P42684-1	156	3546	ENST00000512653.5	123	3513	++	134	P42684-1#93	0	9	ENST00000512653.5	804	813	+	9	0	0	9817
P42684-1#93	0	9	9	P42684-1	837	846	+	9	P42684-1	0	2061	ENST00000511413.5	0	2061	++	133	P42684-1#93	0	9	ENST00000511413.5	837	846	+	9	0	0	9818
P42684-1#93	0	9	9	P42684-1	837	846	+	9	P42684-1	0	2061	ENST00000507173.5	0	1998	++	132	P42684-1#93	0	9	ENST00000507173.5	774	783	+	9	0	0	9819
P42684-1#93	0	9	9	P42684-1	837	846	+	9	P42684-1	219	2061	ENST00000504405.5	111	1953	++	131	P42684-1#93	0	9	ENST00000504405.5	729	738	+	9	0	0	9820
P42684-1#93	0	9	9	P42684-1	837	846	+	9	P42684-1	0	3546	ENST00000502732.6	280	3826	++	130	P42684-1#93	0	9	ENST00000502732.6	1117	1126	+	9	0	0	9821
P42684-1#93	0	9	9	P42684-1	837	846	+	9	P42684-1	0	3546	ENST00000367623.8	0	3483	++	41	P42684-1#93	0	9	ENST00000367623.8	774	783	+	9	0	0	9822
P42684-1#93	0	9	9	P42684-1	837	846	+	9	P42684-1	156	2061	ENST00000344730.8	143	2048	++	33	P42684-1#93	0	9	ENST00000344730.8	824	833	+	9	0	0	9823
P42684-1#94	0	9	9	P42684-1	852	861	+	9	P42684-1	156	3546	ENST00000512653.5	123	3513	++	134	P42684-1#94	0	9	ENST00000512653.5	819	828	+	9	0	0	9824
P42684-1#94	0	9	9	P42684-1	852	861	+	9	P42684-1	0	2061	ENST00000511413.5	0	2061	++	133	P42684-1#94	0	9	ENST00000511413.5	852	861	+	9	0	0	9825
P42684-1#94	0	9	9	P42684-1	852	861	+	9	P42684-1	0	2061	ENST00000507173.5	0	1998	++	132	P42684-1#94	0	9	ENST00000507173.5	789	798	+	9	0	0	9826
P42684-1#94	0	9	9	P42684-1	852	861	+	9	P42684-1	219	2061	ENST00000504405.5	111	1953	++	131	P42684-1#94	0	9	ENST00000504405.5	744	753	+	9	0	0	9827
P42684-1#94	0	9	9	P42684-1	852	861	+	9	P42684-1	0	3546	ENST00000502732.6	280	3826	++	130	P42684-1#94	0	9	ENST00000502732.6	1132	1141	+	9	0	0	9828
P42684-1#94	0	9	9	P42684-1	852	861	+	9	P42684-1	0	3546	ENST00000367623.8	0	3483	++	41	P42684-1#94	0	9	ENST00000367623.8	789	798	+	9	0	0	9829
P42684-1#94	0	9	9	P42684-1	852	861	+	9	P42684-1	156	2061	ENST00000344730.8	143	2048	++	33	P42684-1#94	0	9	ENST00000344730.8	839	848	+	9	0	0	9830
P42684-1#95	0	18	18	P42684-1	861	879	+	18	P42684-1	156	3546	ENST00000512653.5	123	3513	++	134	P42684-1#95	0	18	ENST00000512653.5	828	846	+	18	0	0	9831
P42684-1#95	0	18	18	P42684-1	861	879	+	18	P42684-1	0	2061	ENST00000511413.5	0	2061	++	133	P42684-1#95	0	18	ENST00000511413.5	861	879	+	18	0	0	9832
P42684-1#95	0	18	18	P42684-1	861	879	+	18	P42684-1	0	2061	ENST00000507173.5	0	1998	++	132	P42684-1#95	0	18	ENST00000507173.5	798	816	+	18	0	0	9833
P42684-1#95	0	18	18	P42684-1	861	879	+	18	P42684-1	219	2061	ENST00000504405.5	111	1953	++	131	P42684-1#95	0	18	ENST00000504405.5	753	771	+	18	0	0	9834
P42684-1#95	0	18	18	P42684-1	861	879	+	18	P42684-1	0	3546	ENST00000502732.6	280	3826	++	130	P42684-1#95	0	18	ENST00000502732.6	1141	1159	+	18	0	0	9835
P42684-1#95	0	18	18	P42684-1	861	879	+	18	P42684-1	0	3546	ENST00000367623.8	0	3483	++	41	P42684-1#95	0	18	ENST00000367623.8	798	816	+	18	0	0	9836
P42684-1#95	0	18	18	P42684-1	861	879	+	18	P42684-1	156	2061	ENST00000344730.8	143	2048	++	33	P42684-1#95	0	18	ENST00000344730.8	848	866	+	18	0	0	9837
P42684-1#96	0	12	12	P42684-1	879	891	+	12	P42684-1	156	3546	ENST00000512653.5	123	3513	++	134	P42684-1#96	0	12	ENST00000512653.5	846	858	+	12	0	0	9838
P42684-1#96	0	12	12	P42684-1	879	891	+	12	P42684-1	0	2061	ENST00000511413.5	0	2061	++	133	P42684-1#96	0	12	ENST00000511413.5	879	891	+	12	0	0	9839
P42684-1#96	0	12	12	P42684-1	879	891	+	12	P42684-1	0	2061	ENST00000507173.5	0	1998	++	132	P42684-1#96	0	12	ENST00000507173.5	816	828	+	12	0	0	9840
P42684-1#96	0	12	12	P42684-1	879	891	+	12	P42684-1	219	2061	ENST00000504405.5	111	1953	++	131	P42684-1#96	0	12	ENST00000504405.5	771	783	+	12	0	0	9841
P42684-1#96	0	12	12	P42684-1	879	891	+	12	P42684-1	0	3546	ENST00000502732.6	280	3826	++	130	P42684-1#96	0	12	ENST00000502732.6	1159	1171	+	12	0	0	9842
P42684-1#96	0	12	12	P42684-1	879	891	+	12	P42684-1	0	3546	ENST00000367623.8	0	3483	++	41	P42684-1#96	0	12	ENST00000367623.8	816	828	+	12	0	0	9843
P42684-1#96	0	12	12	P42684-1	879	891	+	12	P42684-1	156	2061	ENST00000344730.8	143	2048	++	33	P42684-1#96	0	12	ENST00000344730.8	866	878	+	12	0	0	9844
P42684-1#97	0	24	24	P42684-1	897	921	+	24	P42684-1	156	3546	ENST00000512653.5	123	3513	++	134	P42684-1#97	0	24	ENST00000512653.5	864	888	+	24	0	0	9845
P42684-1#97	0	24	24	P42684-1	897	921	+	24	P42684-1	0	2061	ENST00000511413.5	0	2061	++	133	P42684-1#97	0	24	ENST00000511413.5	897	921	+	24	0	0	9846
P42684-1#97	0	24	24	P42684-1	897	921	+	24	P42684-1	0	2061	ENST00000507173.5	0	1998	++	132	P42684-1#97	0	24	ENST00000507173.5	834	858	+	24	0	0	9847
P42684-1#97	0	24	24	P42684-1	897	921	+	24	P42684-1	219	2061	ENST00000504405.5	111	1953	++	131	P42684-1#97	0	24	ENST00000504405.5	789	813	+	24	0	0	9848
P42684-1#97	0	24	24	P42684-1	897	921	+	24	P42684-1	0	3546	ENST00000502732.6	280	3826	++	130	P42684-1#97	0	24	ENST00000502732.6	1177	1201	+	24	0	0	9849
P42684-1#97	0	24	24	P42684-1	897	921	+	24	P42684-1	0	3546	ENST00000367623.8	0	3483	++	41	P42684-1#97	0	24	ENST00000367623.8	834	858	+	24	0	0	9850
P42684-1#97	0	24	24	P42684-1	897	921	+	24	P42684-1	156	2061	ENST00000344730.8	143	2048	++	33	P42684-1#97	0	24	ENST00000344730.8	884	908	+	24	0	0	9851
P42684-1#98	0	9	9	P42684-1	921	930	+	9	P42684-1	156	3546	ENST00000512653.5	123	3513	++	134	P42684-1#98	0	9	ENST00000512653.5	888	897	+	9	0	0	9852
P42684-1#98	0	9	9	P42684-1	921	930	+	9	P42684-1	0	2061	ENST00000511413.5	0	2061	++	133	P42684-1#98	0	9	ENST00000511413.5	921	930	+	9	0	0	9853
P42684-1#98	0	9	9	P42684-1	921	930	+	9	P42684-1	0	2061	ENST00000507173.5	0	1998	++	132	P42684-1#98	0	9	ENST00000507173.5	858	867	+	9	0	0	9854
P42684-1#98	0	9	9	P42684-1	921	930	+	9	P42684-1	219	2061	ENST00000504405.5	111	1953	++	131	P42684-1#98	0	9	ENST00000504405.5	813	822	+	9	0	0	9855
P42684-1#98	0	9	9	P42684-1	921	930	+	9	P42684-1	0	3546	ENST00000502732.6	280	3826	++	130	P42684-1#98	0	9	ENST00000502732.6	1201	1210	+	9	0	0	9856
P42684-1#98	0	9	9	P42684-1	921	930	+	9	P42684-1	0	3546	ENST00000367623.8	0	3483	++	41	P42684-1#98	0	9	ENST00000367623.8	858	867	+	9	0	0	9857
P42684-1#98	0	9	9	P42684-1	921	930	+	9	P42684-1	156	2061	ENST00000344730.8	143	2048	++	33	P42684-1#98	0	9	ENST00000344730.8	908	917	+	9	0	0	9858
P42684-1#99	0	21	21	P42684-1	933	954	+	21	P42684-1	156	3546	ENST00000512653.5	123	3513	++	134	P42684-1#99	0	21	ENST00000512653.5	900	921	+	21	0	0	9859
P42684-1#99	0	21	21	P42684-1	933	954	+	21	P42684-1	0	2061	ENST00000511413.5	0	2061	++	133	P42684-1#99	0	21	ENST00000511413.5	933	954	+	21	0	0	9860
P42684-1#99	0	21	21	P42684-1	933	954	+	21	P42684-1	0	2061	ENST00000507173.5	0	1998	++	132	P42684-1#99	0	21	ENST00000507173.5	870	891	+	21	0	0	9861
P42684-1#99	0	21	21	P42684-1	933	954	+	21	P42684-1	219	2061	ENST00000504405.5	111	1953	++	131	P42684-1#99	0	21	ENST00000504405.5	825	846	+	21	0	0	9862
P42684-1#99	0	21	21	P42684-1	933	954	+	21	P42684-1	0	3546	ENST00000502732.6	280	3826	++	130	P42684-1#99	0	21	ENST00000502732.6	1213	1234	+	21	0	0	9863
P42684-1#99	0	21	21	P42684-1	933	954	+	21	P42684-1	0	3546	ENST00000367623.8	0	3483	++	41	P42684-1#99	0	21	ENST00000367623.8	870	891	+	21	0	0	9864
P42684-1#99	0	21	21	P42684-1	933	954	+	21	P42684-1	156	2061	ENST00000344730.8	143	2048	++	33	P42684-1#99	0	21	ENST00000344730.8	920	941	+	21	0	0	9865
P42684-1#100	0	36	36	P42684-1	975	1011	+	36	P42684-1	156	3546	ENST00000512653.5	123	3513	++	134	P42684-1#100	0	36	ENST00000512653.5	942	978	+	36	0	0	9866
P42684-1#100	0	36	36	P42684-1	975	1011	+	36	P42684-1	0	2061	ENST00000511413.5	0	2061	++	133	P42684-1#100	0	36	ENST00000511413.5	975	1011	+	36	0	0	9867
P42684-1#100	0	36	36	P42684-1	975	1011	+	36	P42684-1	0	2061	ENST00000507173.5	0	1998	++	132	P42684-1#100	0	36	ENST00000507173.5	912	948	+	36	0	0	9868
P42684-1#100	0	36	36	P42684-1	975	1011	+	36	P42684-1	219	2061	ENST00000504405.5	111	1953	++	131	P42684-1#100	0	36	ENST00000504405.5	867	903	+	36	0	0	9869
P42684-1#100	0	36	36	P42684-1	975	1011	+	36	P42684-1	0	3546	ENST00000502732.6	280	3826	++	130	P42684-1#100	0	36	ENST00000502732.6	1255	1291	+	36	0	0	9870
P42684-1#100	0	36	36	P42684-1	975	1011	+	36	P42684-1	0	3546	ENST00000367623.8	0	3483	++	41	P42684-1#100	0	36	ENST00000367623.8	912	948	+	36	0	0	9871
P42684-1#100	0	36	36	P42684-1	975	1011	+	36	P42684-1	156	2061	ENST00000344730.8	143	2048	++	33	P42684-1#100	0	36	ENST00000344730.8	962	998	+	36	0	0	9872
P42684-1#101	0	15	15	P42684-1	1038	1053	+	15	P42684-1	156	3546	ENST00000512653.5	123	3513	++	134	P42684-1#101	0	15	ENST00000512653.5	1005	1020	+	15	0	0	9873
P42684-1#101	0	15	15	P42684-1	1038	1053	+	15	P42684-1	0	2061	ENST00000511413.5	0	2061	++	133	P42684-1#101	0	15	ENST00000511413.5	1038	1053	+	15	0	0	9874
P42684-1#101	0	15	15	P42684-1	1038	1053	+	15	P42684-1	0	2061	ENST00000507173.5	0	1998	++	132	P42684-1#101	0	15	ENST00000507173.5	975	990	+	15	0	0	9875
P42684-1#101	0	15	15	P42684-1	1038	1053	+	15	P42684-1	219	2061	ENST00000504405.5	111	1953	++	131	P42684-1#101	0	15	ENST00000504405.5	930	945	+	15	0	0	9876
P42684-1#101	0	15	15	P42684-1	1038	1053	+	15	P42684-1	0	3546	ENST00000502732.6	280	3826	++	130	P42684-1#101	0	15	ENST00000502732.6	1318	1333	+	15	0	0	9877
P42684-1#101	0	15	15	P42684-1	1038	1053	+	15	P42684-1	0	3546	ENST00000367623.8	0	3483	++	41	P42684-1#101	0	15	ENST00000367623.8	975	990	+	15	0	0	9878
P42684-1#101	0	15	15	P42684-1	1038	1053	+	15	P42684-1	156	2061	ENST00000344730.8	143	2048	++	33	P42684-1#101	0	15	ENST00000344730.8	1025	1040	+	15	0	0	9879
P42684-1#102	0	12	12	P42684-1	1056	1068	+	12	P42684-1	156	3546	ENST00000512653.5	123	3513	++	134	P42684-1#102	0	12	ENST00000512653.5	1023	1035	+	12	0	0	9880
P42684-1#102	0	12	12	P42684-1	1056	1068	+	12	P42684-1	0	2061	ENST00000511413.5	0	2061	++	133	P42684-1#102	0	12	ENST00000511413.5	1056	1068	+	12	0	0	9881
P42684-1#102	0	12	12	P42684-1	1056	1068	+	12	P42684-1	0	2061	ENST00000507173.5	0	1998	++	132	P42684-1#102	0	12	ENST00000507173.5	993	1005	+	12	0	0	9882
P42684-1#102	0	12	12	P42684-1	1056	1068	+	12	P42684-1	219	2061	ENST00000504405.5	111	1953	++	131	P42684-1#102	0	12	ENST00000504405.5	948	960	+	12	0	0	9883
P42684-1#102	0	12	12	P42684-1	1056	1068	+	12	P42684-1	0	3546	ENST00000502732.6	280	3826	++	130	P42684-1#102	0	12	ENST00000502732.6	1336	1348	+	12	0	0	9884
P42684-1#102	0	12	12	P42684-1	1056	1068	+	12	P42684-1	0	3546	ENST00000367623.8	0	3483	++	41	P42684-1#102	0	12	ENST00000367623.8	993	1005	+	12	0	0	9885
P42684-1#102	0	12	12	P42684-1	1056	1068	+	12	P42684-1	156	2061	ENST00000344730.8	143	2048	++	33	P42684-1#102	0	12	ENST00000344730.8	1043	1055	+	12	0	0	9886
P42684-1#103	0	15	15	P42684-1	1071	1086	+	15	P42684-1	156	3546	ENST00000512653.5	123	3513	++	134	P42684-1#103	0	15	ENST00000512653.5	1038	1053	+	15	0	0	9887
P42684-1#103	0	15	15	P42684-1	1071	1086	+	15	P42684-1	0	2061	ENST00000511413.5	0	2061	++	133	P42684-1#103	0	15	ENST00000511413.5	1071	1086	+	15	0	0	9888
P42684-1#103	0	15	15	P42684-1	1071	1086	+	15	P42684-1	0	2061	ENST00000507173.5	0	1998	++	132	P42684-1#103	0	15	ENST00000507173.5	1008	1023	+	15	0	0	9889
P42684-1#103	0	15	15	P42684-1	1071	1086	+	15	P42684-1	219	2061	ENST00000504405.5	111	1953	++	131	P42684-1#103	0	15	ENST00000504405.5	963	978	+	15	0	0	9890
P42684-1#103	0	15	15	P42684-1	1071	1086	+	15	P42684-1	0	3546	ENST00000502732.6	280	3826	++	130	P42684-1#103	0	15	ENST00000502732.6	1351	1366	+	15	0	0	9891
P42684-1#103	0	15	15	P42684-1	1071	1086	+	15	P42684-1	0	3546	ENST00000367623.8	0	3483	++	41	P42684-1#103	0	15	ENST00000367623.8	1008	1023	+	15	0	0	9892
P42684-1#103	0	15	15	P42684-1	1071	1086	+	15	P42684-1	156	2061	ENST00000344730.8	143	2048	++	33	P42684-1#103	0	15	ENST00000344730.8	1058	1073	+	15	0	0	9893
P42684-1#104	0	21	21	P42684-1	1104	1125	+	21	P42684-1	156	3546	ENST00000512653.5	123	3513	++	134	P42684-1#104	0	21	ENST00000512653.5	1071	1092	+	21	0	0	9894
P42684-1#104	0	21	21	P42684-1	1104	1125	+	21	P42684-1	0	2061	ENST00000511413.5	0	2061	++	133	P42684-1#104	0	21	ENST00000511413.5	1104	1125	+	21	0	0	9895
P42684-1#104	0	21	21	P42684-1	1104	1125	+	21	P42684-1	0	2061	ENST00000507173.5	0	1998	++	132	P42684-1#104	0	21	ENST00000507173.5	1041	1062	+	21	0	0	9896
P42684-1#104	0	21	21	P42684-1	1104	1125	+	21	P42684-1	219	2061	ENST00000504405.5	111	1953	++	131	P42684-1#104	0	21	ENST00000504405.5	996	1017	+	21	0	0	9897
P42684-1#104	0	21	21	P42684-1	1104	1125	+	21	P42684-1	0	3546	ENST00000502732.6	280	3826	++	130	P42684-1#104	0	21	ENST00000502732.6	1384	1405	+	21	0	0	9898
P42684-1#104	0	21	21	P42684-1	1104	1125	+	21	P42684-1	0	3546	ENST00000367623.8	0	3483	++	41	P42684-1#104	0	21	ENST00000367623.8	1041	1062	+	21	0	0	9899
P42684-1#104	0	21	21	P42684-1	1104	1125	+	21	P42684-1	156	2061	ENST00000344730.8	143	2048	++	33	P42684-1#104	0	21	ENST00000344730.8	1091	1112	+	21	0	0	9900
P42684-1#105	0	9	9	P42684-1	1131	1140	+	9	P42684-1	156	3546	ENST00000512653.5	123	3513	++	134	P42684-1#105	0	9	ENST00000512653.5	1098	1107	+	9	0	0	9901
P42684-1#105	0	9	9	P42684-1	1131	1140	+	9	P42684-1	0	2061	ENST00000511413.5	0	2061	++	133	P42684-1#105	0	9	ENST00000511413.5	1131	1140	+	9	0	0	9902
P42684-1#105	0	9	9	P42684-1	1131	1140	+	9	P42684-1	0	2061	ENST00000507173.5	0	1998	++	132	P42684-1#105	0	9	ENST00000507173.5	1068	1077	+	9	0	0	9903
P42684-1#105	0	9	9	P42684-1	1131	1140	+	9	P42684-1	219	2061	ENST00000504405.5	111	1953	++	131	P42684-1#105	0	9	ENST00000504405.5	1023	1032	+	9	0	0	9904
P42684-1#105	0	9	9	P42684-1	1131	1140	+	9	P42684-1	0	3546	ENST00000502732.6	280	3826	++	130	P42684-1#105	0	9	ENST00000502732.6	1411	1420	+	9	0	0	9905
P42684-1#105	0	9	9	P42684-1	1131	1140	+	9	P42684-1	0	3546	ENST00000367623.8	0	3483	++	41	P42684-1#105	0	9	ENST00000367623.8	1068	1077	+	9	0	0	9906
P42684-1#105	0	9	9	P42684-1	1131	1140	+	9	P42684-1	156	2061	ENST00000344730.8	143	2048	++	33	P42684-1#105	0	9	ENST00000344730.8	1118	1127	+	9	0	0	9907
P42684-1#106	0	60	60	P42684-1	1146	1206	+	60	P42684-1	156	3546	ENST00000512653.5	123	3513	++	134	P42684-1#106	0	60	ENST00000512653.5	1113	1173	+	60	0	0	9908
P42684-1#106	0	60	60	P42684-1	1146	1206	+	60	P42684-1	0	2061	ENST00000511413.5	0	2061	++	133	P42684-1#106	0	60	ENST00000511413.5	1146	1206	+	60	0	0	9909
P42684-1#106	0	60	60	P42684-1	1146	1206	+	60	P42684-1	0	2061	ENST00000507173.5	0	1998	++	132	P42684-1#106	0	60	ENST00000507173.5	1083	1143	+	60	0	0	9910
P42684-1#106	0	60	60	P42684-1	1146	1206	+	60	P42684-1	219	2061	ENST00000504405.5	111	1953	++	131	P42684-1#106	0	60	ENST00000504405.5	1038	1098	+	60	0	0	9911
P42684-1#106	0	60	60	P42684-1	1146	1206	+	60	P42684-1	0	3546	ENST00000502732.6	280	3826	++	130	P42684-1#106	0	60	ENST00000502732.6	1426	1486	+	60	0	0	9912
P42684-1#106	0	60	60	P42684-1	1146	1206	+	60	P42684-1	0	3546	ENST00000367623.8	0	3483	++	41	P42684-1#106	0	60	ENST00000367623.8	1083	1143	+	60	0	0	9913
P42684-1#106	0	60	60	P42684-1	1146	1206	+	60	P42684-1	156	2061	ENST00000344730.8	143	2048	++	33	P42684-1#106	0	60	ENST00000344730.8	1133	1193	+	60	0	0	9914
P42684-1#107	0	9	9	P42684-1	1233	1242	+	9	P42684-1	156	3546	ENST00000512653.5	123	3513	++	134	P42684-1#107	0	9	ENST00000512653.5	1200	1209	+	9	0	0	9915
P42684-1#107	0	9	9	P42684-1	1233	1242	+	9	P42684-1	0	2061	ENST00000511413.5	0	2061	++	133	P42684-1#107	0	9	ENST00000511413.5	1233	1242	+	9	0	0	9916
P42684-1#107	0	9	9	P42684-1	1233	1242	+	9	P42684-1	0	2061	ENST00000507173.5	0	1998	++	132	P42684-1#107	0	9	ENST00000507173.5	1170	1179	+	9	0	0	9917
P42684-1#107	0	9	9	P42684-1	1233	1242	+	9	P42684-1	219	2061	ENST00000504405.5	111	1953	++	131	P42684-1#107	0	9	ENST00000504405.5	1125	1134	+	9	0	0	9918
P42684-1#107	0	9	9	P42684-1	1233	1242	+	9	P42684-1	0	3546	ENST00000502732.6	280	3826	++	130	P42684-1#107	0	9	ENST00000502732.6	1513	1522	+	9	0	0	9919
P42684-1#107	0	9	9	P42684-1	1233	1242	+	9	P42684-1	0	3546	ENST00000367623.8	0	3483	++	41	P42684-1#107	0	9	ENST00000367623.8	1170	1179	+	9	0	0	9920
P42684-1#107	0	9	9	P42684-1	1233	1242	+	9	P42684-1	156	2061	ENST00000344730.8	143	2048	++	33	P42684-1#107	0	9	ENST00000344730.8	1220	1229	+	9	0	0	9921
P42684-1#108	0	9	9	P42684-1	1242	1251	+	9	P42684-1	156	3546	ENST00000512653.5	123	3513	++	134	P42684-1#108	0	9	ENST00000512653.5	1209	1218	+	9	0	0	9922
P42684-1#108	0	9	9	P42684-1	1242	1251	+	9	P42684-1	0	2061	ENST00000511413.5	0	2061	++	133	P42684-1#108	0	9	ENST00000511413.5	1242	1251	+	9	0	0	9923
P42684-1#108	0	9	9	P42684-1	1242	1251	+	9	P42684-1	0	2061	ENST00000507173.5	0	1998	++	132	P42684-1#108	0	9	ENST00000507173.5	1179	1188	+	9	0	0	9924
P42684-1#108	0	9	9	P42684-1	1242	1251	+	9	P42684-1	219	2061	ENST00000504405.5	111	1953	++	131	P42684-1#108	0	9	ENST00000504405.5	1134	1143	+	9	0	0	9925
P42684-1#108	0	9	9	P42684-1	1242	1251	+	9	P42684-1	0	3546	ENST00000502732.6	280	3826	++	130	P42684-1#108	0	9	ENST00000502732.6	1522	1531	+	9	0	0	9926
P42684-1#108	0	9	9	P42684-1	1242	1251	+	9	P42684-1	0	3546	ENST00000367623.8	0	3483	++	41	P42684-1#108	0	9	ENST00000367623.8	1179	1188	+	9	0	0	9927
P42684-1#108	0	9	9	P42684-1	1242	1251	+	9	P42684-1	156	2061	ENST00000344730.8	143	2048	++	33	P42684-1#108	0	9	ENST00000344730.8	1229	1238	+	9	0	0	9928
P42684-1#109	0	9	9	P42684-1	1254	1263	+	9	P42684-1	156	3546	ENST00000512653.5	123	3513	++	134	P42684-1#109	0	9	ENST00000512653.5	1221	1230	+	9	0	0	9929
P42684-1#109	0	9	9	P42684-1	1254	1263	+	9	P42684-1	0	2061	ENST00000511413.5	0	2061	++	133	P42684-1#109	0	9	ENST00000511413.5	1254	1263	+	9	0	0	9930
P42684-1#109	0	9	9	P42684-1	1254	1263	+	9	P42684-1	0	2061	ENST00000507173.5	0	1998	++	132	P42684-1#109	0	9	ENST00000507173.5	1191	1200	+	9	0	0	9931
P42684-1#109	0	9	9	P42684-1	1254	1263	+	9	P42684-1	219	2061	ENST00000504405.5	111	1953	++	131	P42684-1#109	0	9	ENST00000504405.5	1146	1155	+	9	0	0	9932
P42684-1#109	0	9	9	P42684-1	1254	1263	+	9	P42684-1	0	3546	ENST00000502732.6	280	3826	++	130	P42684-1#109	0	9	ENST00000502732.6	1534	1543	+	9	0	0	9933
P42684-1#109	0	9	9	P42684-1	1254	1263	+	9	P42684-1	0	3546	ENST00000367623.8	0	3483	++	41	P42684-1#109	0	9	ENST00000367623.8	1191	1200	+	9	0	0	9934
P42684-1#109	0	9	9	P42684-1	1254	1263	+	9	P42684-1	156	2061	ENST00000344730.8	143	2048	++	33	P42684-1#109	0	9	ENST00000344730.8	1241	1250	+	9	0	0	9935
P42684-1#110	0	9	9	P42684-1	1266	1275	+	9	P42684-1	156	3546	ENST00000512653.5	123	3513	++	134	P42684-1#110	0	9	ENST00000512653.5	1233	1242	+	9	0	0	9936
P42684-1#110	0	9	9	P42684-1	1266	1275	+	9	P42684-1	0	2061	ENST00000511413.5	0	2061	++	133	P42684-1#110	0	9	ENST00000511413.5	1266	1275	+	9	0	0	9937
P42684-1#110	0	9	9	P42684-1	1266	1275	+	9	P42684-1	0	2061	ENST00000507173.5	0	1998	++	132	P42684-1#110	0	9	ENST00000507173.5	1203	1212	+	9	0	0	9938
P42684-1#110	0	9	9	P42684-1	1266	1275	+	9	P42684-1	219	2061	ENST00000504405.5	111	1953	++	131	P42684-1#110	0	9	ENST00000504405.5	1158	1167	+	9	0	0	9939
P42684-1#110	0	9	9	P42684-1	1266	1275	+	9	P42684-1	0	3546	ENST00000502732.6	280	3826	++	130	P42684-1#110	0	9	ENST00000502732.6	1546	1555	+	9	0	0	9940
P42684-1#110	0	9	9	P42684-1	1266	1275	+	9	P42684-1	0	3546	ENST00000367623.8	0	3483	++	41	P42684-1#110	0	9	ENST00000367623.8	1203	1212	+	9	0	0	9941
P42684-1#110	0	9	9	P42684-1	1266	1275	+	9	P42684-1	156	2061	ENST00000344730.8	143	2048	++	33	P42684-1#110	0	9	ENST00000344730.8	1253	1262	+	9	0	0	9942
P42684-1#111	0	9	9	P42684-1	1302	1311	+	9	P42684-1	156	3546	ENST00000512653.5	123	3513	++	134	P42684-1#111	0	9	ENST00000512653.5	1269	1278	+	9	0	0	9943
P42684-1#111	0	9	9	P42684-1	1302	1311	+	9	P42684-1	0	2061	ENST00000511413.5	0	2061	++	133	P42684-1#111	0	9	ENST00000511413.5	1302	1311	+	9	0	0	9944
P42684-1#111	0	9	9	P42684-1	1302	1311	+	9	P42684-1	0	2061	ENST00000507173.5	0	1998	++	132	P42684-1#111	0	9	ENST00000507173.5	1239	1248	+	9	0	0	9945
P42684-1#111	0	9	9	P42684-1	1302	1311	+	9	P42684-1	219	2061	ENST00000504405.5	111	1953	++	131	P42684-1#111	0	9	ENST00000504405.5	1194	1203	+	9	0	0	9946
P42684-1#111	0	9	9	P42684-1	1302	1311	+	9	P42684-1	0	3546	ENST00000502732.6	280	3826	++	130	P42684-1#111	0	9	ENST00000502732.6	1582	1591	+	9	0	0	9947
P42684-1#111	0	9	9	P42684-1	1302	1311	+	9	P42684-1	0	3546	ENST00000367623.8	0	3483	++	41	P42684-1#111	0	9	ENST00000367623.8	1239	1248	+	9	0	0	9948
P42684-1#111	0	9	9	P42684-1	1302	1311	+	9	P42684-1	156	2061	ENST00000344730.8	143	2048	++	33	P42684-1#111	0	9	ENST00000344730.8	1289	1298	+	9	0	0	9949
P42684-1#112	0	9	9	P42684-1	1311	1320	+	9	P42684-1	156	3546	ENST00000512653.5	123	3513	++	134	P42684-1#112	0	9	ENST00000512653.5	1278	1287	+	9	0	0	9950
P42684-1#112	0	9	9	P42684-1	1311	1320	+	9	P42684-1	0	2061	ENST00000511413.5	0	2061	++	133	P42684-1#112	0	9	ENST00000511413.5	1311	1320	+	9	0	0	9951
P42684-1#112	0	9	9	P42684-1	1311	1320	+	9	P42684-1	0	2061	ENST00000507173.5	0	1998	++	132	P42684-1#112	0	9	ENST00000507173.5	1248	1257	+	9	0	0	9952
P42684-1#112	0	9	9	P42684-1	1311	1320	+	9	P42684-1	219	2061	ENST00000504405.5	111	1953	++	131	P42684-1#112	0	9	ENST00000504405.5	1203	1212	+	9	0	0	9953
P42684-1#112	0	9	9	P42684-1	1311	1320	+	9	P42684-1	0	3546	ENST00000502732.6	280	3826	++	130	P42684-1#112	0	9	ENST00000502732.6	1591	1600	+	9	0	0	9954
P42684-1#112	0	9	9	P42684-1	1311	1320	+	9	P42684-1	0	3546	ENST00000367623.8	0	3483	++	41	P42684-1#112	0	9	ENST00000367623.8	1248	1257	+	9	0	0	9955
P42684-1#112	0	9	9	P42684-1	1311	1320	+	9	P42684-1	156	2061	ENST00000344730.8	143	2048	++	33	P42684-1#112	0	9	ENST00000344730.8	1298	1307	+	9	0	0	9956
P42684-1#113	0	9	9	P42684-1	1344	1353	+	9	P42684-1	156	3546	ENST00000512653.5	123	3513	++	134	P42684-1#113	0	9	ENST00000512653.5	1311	1320	+	9	0	0	9957
P42684-1#113	0	9	9	P42684-1	1344	1353	+	9	P42684-1	0	2061	ENST00000511413.5	0	2061	++	133	P42684-1#113	0	9	ENST00000511413.5	1344	1353	+	9	0	0	9958
P42684-1#113	0	9	9	P42684-1	1344	1353	+	9	P42684-1	0	2061	ENST00000507173.5	0	1998	++	132	P42684-1#113	0	9	ENST00000507173.5	1281	1290	+	9	0	0	9959
P42684-1#113	0	9	9	P42684-1	1344	1353	+	9	P42684-1	219	2061	ENST00000504405.5	111	1953	++	131	P42684-1#113	0	9	ENST00000504405.5	1236	1245	+	9	0	0	9960
P42684-1#113	0	9	9	P42684-1	1344	1353	+	9	P42684-1	0	3546	ENST00000502732.6	280	3826	++	130	P42684-1#113	0	9	ENST00000502732.6	1624	1633	+	9	0	0	9961
P42684-1#113	0	9	9	P42684-1	1344	1353	+	9	P42684-1	0	3546	ENST00000367623.8	0	3483	++	41	P42684-1#113	0	9	ENST00000367623.8	1281	1290	+	9	0	0	9962
P42684-1#113	0	9	9	P42684-1	1344	1353	+	9	P42684-1	156	2061	ENST00000344730.8	143	2048	++	33	P42684-1#113	0	9	ENST00000344730.8	1331	1340	+	9	0	0	9963
P42684-1#114	0	18	18	P42684-1	1359	1377	+	18	P42684-1	156	3546	ENST00000512653.5	123	3513	++	134	P42684-1#114	0	18	ENST00000512653.5	1326	1344	+	18	0	0	9964
P42684-1#114	0	18	18	P42684-1	1359	1377	+	18	P42684-1	0	2061	ENST00000511413.5	0	2061	++	133	P42684-1#114	0	18	ENST00000511413.5	1359	1377	+	18	0	0	9965
P42684-1#114	0	18	18	P42684-1	1359	1377	+	18	P42684-1	0	2061	ENST00000507173.5	0	1998	++	132	P42684-1#114	0	18	ENST00000507173.5	1296	1314	+	18	0	0	9966
P42684-1#114	0	18	18	P42684-1	1359	1377	+	18	P42684-1	219	2061	ENST00000504405.5	111	1953	++	131	P42684-1#114	0	18	ENST00000504405.5	1251	1269	+	18	0	0	9967
P42684-1#114	0	18	18	P42684-1	1359	1377	+	18	P42684-1	0	3546	ENST00000502732.6	280	3826	++	130	P42684-1#114	0	18	ENST00000502732.6	1639	1657	+	18	0	0	9968
P42684-1#114	0	18	18	P42684-1	1359	1377	+	18	P42684-1	0	3546	ENST00000367623.8	0	3483	++	41	P42684-1#114	0	18	ENST00000367623.8	1296	1314	+	18	0	0	9969
P42684-1#114	0	18	18	P42684-1	1359	1377	+	18	P42684-1	156	2061	ENST00000344730.8	143	2048	++	33	P42684-1#114	0	18	ENST00000344730.8	1346	1364	+	18	0	0	9970
P42684-1#115	0	48	48	P42684-1	1389	1437	+	48	P42684-1	156	3546	ENST00000512653.5	123	3513	++	134	P42684-1#115	0	48	ENST00000512653.5	1356	1404	+	48	0	0	9971
P42684-1#115	0	48	48	P42684-1	1389	1437	+	48	P42684-1	0	2061	ENST00000511413.5	0	2061	++	133	P42684-1#115	0	48	ENST00000511413.5	1389	1437	+	48	0	0	9972
P42684-1#115	0	48	48	P42684-1	1389	1437	+	48	P42684-1	0	2061	ENST00000507173.5	0	1998	++	132	P42684-1#115	0	48	ENST00000507173.5	1326	1374	+	48	0	0	9973
P42684-1#115	0	48	48	P42684-1	1389	1437	+	48	P42684-1	219	2061	ENST00000504405.5	111	1953	++	131	P42684-1#115	0	48	ENST00000504405.5	1281	1329	+	48	0	0	9974
P42684-1#115	0	48	48	P42684-1	1389	1437	+	48	P42684-1	0	3546	ENST00000502732.6	280	3826	++	130	P42684-1#115	0	48	ENST00000502732.6	1669	1717	+	48	0	0	9975
P42684-1#115	0	48	48	P42684-1	1389	1437	+	48	P42684-1	0	3546	ENST00000367623.8	0	3483	++	41	P42684-1#115	0	48	ENST00000367623.8	1326	1374	+	48	0	0	9976
P42684-1#115	0	48	48	P42684-1	1389	1437	+	48	P42684-1	156	2061	ENST00000344730.8	143	2048	++	33	P42684-1#115	0	48	ENST00000344730.8	1376	1424	+	48	0	0	9977
P42684-1#116	0	9	9	P42684-1	1470	1479	+	9	P42684-1	156	3546	ENST00000512653.5	123	3513	++	134	P42684-1#116	0	9	ENST00000512653.5	1437	1446	+	9	0	0	9978
P42684-1#116	0	9	9	P42684-1	1470	1479	+	9	P42684-1	0	2061	ENST00000511413.5	0	2061	++	133	P42684-1#116	0	9	ENST00000511413.5	1470	1479	+	9	0	0	9979
P42684-1#116	0	9	9	P42684-1	1470	1479	+	9	P42684-1	0	2061	ENST00000507173.5	0	1998	++	132	P42684-1#116	0	9	ENST00000507173.5	1407	1416	+	9	0	0	9980
P42684-1#116	0	9	9	P42684-1	1470	1479	+	9	P42684-1	219	2061	ENST00000504405.5	111	1953	++	131	P42684-1#116	0	9	ENST00000504405.5	1362	1371	+	9	0	0	9981
P42684-1#116	0	9	9	P42684-1	1470	1479	+	9	P42684-1	0	3546	ENST00000502732.6	280	3826	++	130	P42684-1#116	0	9	ENST00000502732.6	1750	1759	+	9	0	0	9982
P42684-1#116	0	9	9	P42684-1	1470	1479	+	9	P42684-1	0	3546	ENST00000367623.8	0	3483	++	41	P42684-1#116	0	9	ENST00000367623.8	1407	1416	+	9	0	0	9983
P42684-1#116	0	9	9	P42684-1	1470	1479	+	9	P42684-1	156	2061	ENST00000344730.8	143	2048	++	33	P42684-1#116	0	9	ENST00000344730.8	1457	1466	+	9	0	0	9984
P42684-1#117	0	18	18	P42684-1	1479	1497	+	18	P42684-1	156	3546	ENST00000512653.5	123	3513	++	134	P42684-1#117	0	18	ENST00000512653.5	1446	1464	+	18	0	0	9985
P42684-1#117	0	18	18	P42684-1	1479	1497	+	18	P42684-1	0	2061	ENST00000511413.5	0	2061	++	133	P42684-1#117	0	18	ENST00000511413.5	1479	1497	+	18	0	0	9986
P42684-1#117	0	18	18	P42684-1	1479	1497	+	18	P42684-1	0	2061	ENST00000507173.5	0	1998	++	132	P42684-1#117	0	18	ENST00000507173.5	1416	1434	+	18	0	0	9987
P42684-1#117	0	18	18	P42684-1	1479	1497	+	18	P42684-1	219	2061	ENST00000504405.5	111	1953	++	131	P42684-1#117	0	18	ENST00000504405.5	1371	1389	+	18	0	0	9988
P42684-1#117	0	18	18	P42684-1	1479	1497	+	18	P42684-1	0	3546	ENST00000502732.6	280	3826	++	130	P42684-1#117	0	18	ENST00000502732.6	1759	1777	+	18	0	0	9989
P42684-1#117	0	18	18	P42684-1	1479	1497	+	18	P42684-1	0	3546	ENST00000367623.8	0	3483	++	41	P42684-1#117	0	18	ENST00000367623.8	1416	1434	+	18	0	0	9990
P42684-1#117	0	18	18	P42684-1	1479	1497	+	18	P42684-1	156	2061	ENST00000344730.8	143	2048	++	33	P42684-1#117	0	18	ENST00000344730.8	1466	1484	+	18	0	0	9991
P42684-1#118	0	30	30	P42684-1	1533	1563	+	30	P42684-1	156	3546	ENST00000512653.5	123	3513	++	134	P42684-1#118	0	30	ENST00000512653.5	1500	1530	+	30	0	0	9992
P42684-1#118	0	30	30	P42684-1	1533	1563	+	30	P42684-1	0	2061	ENST00000511413.5	0	2061	++	133	P42684-1#118	0	30	ENST00000511413.5	1533	1563	+	30	0	0	9993
P42684-1#118	0	30	30	P42684-1	1533	1563	+	30	P42684-1	0	2061	ENST00000507173.5	0	1998	++	132	P42684-1#118	0	30	ENST00000507173.5	1470	1500	+	30	0	0	9994
P42684-1#118	0	30	30	P42684-1	1533	1563	+	30	P42684-1	219	2061	ENST00000504405.5	111	1953	++	131	P42684-1#118	0	30	ENST00000504405.5	1425	1455	+	30	0	0	9995
P42684-1#118	0	30	30	P42684-1	1533	1563	+	30	P42684-1	0	3546	ENST00000502732.6	280	3826	++	130	P42684-1#118	0	30	ENST00000502732.6	1813	1843	+	30	0	0	9996
P42684-1#118	0	30	30	P42684-1	1533	1563	+	30	P42684-1	0	3546	ENST00000367623.8	0	3483	++	41	P42684-1#118	0	30	ENST00000367623.8	1470	1500	+	30	0	0	9997
P42684-1#118	0	30	30	P42684-1	1533	1563	+	30	P42684-1	156	2061	ENST00000344730.8	143	2048	++	33	P42684-1#118	0	30	ENST00000344730.8	1520	1550	+	30	0	0	9998
P42684-1#119	0	9	9	P42684-1	1575	1584	+	9	P42684-1	156	3546	ENST00000512653.5	123	3513	++	134	P42684-1#119	0	9	ENST00000512653.5	1542	1551	+	9	0	0	9999
P42684-1#119	0	9	9	P42684-1	1575	1584	+	9	P42684-1	0	2061	ENST00000511413.5	0	2061	++	133	P42684-1#119	0	9	ENST00000511413.5	1575	1584	+	9	0	0	10000
P42684-1#119	0	9	9	P42684-1	1575	1584	+	9	P42684-1	0	2061	ENST00000507173.5	0	1998	++	132	P42684-1#119	0	9	ENST00000507173.5	1512	1521	+	9	0	0	10001
P42684-1#119	0	9	9	P42684-1	1575	1584	+	9	P42684-1	219	2061	ENST00000504405.5	111	1953	++	131	P42684-1#119	0	9	ENST00000504405.5	1467	1476	+	9	0	0	10002
P42684-1#119	0	9	9	P42684-1	1575	1584	+	9	P42684-1	0	3546	ENST00000502732.6	280	3826	++	130	P42684-1#119	0	9	ENST00000502732.6	1855	1864	+	9	0	0	10003
P42684-1#119	0	9	9	P42684-1	1575	1584	+	9	P42684-1	0	3546	ENST00000367623.8	0	3483	++	41	P42684-1#119	0	9	ENST00000367623.8	1512	1521	+	9	0	0	10004
P42684-1#119	0	9	9	P42684-1	1575	1584	+	9	P42684-1	156	2061	ENST00000344730.8	143	2048	++	33	P42684-1#119	0	9	ENST00000344730.8	1562	1571	+	9	0	0	10005
P42684-1#120	0	42	42	P42684-1	1593	1635	+	42	P42684-1	156	3546	ENST00000512653.5	123	3513	++	134	P42684-1#120	0	42	ENST00000512653.5	1560	1602	+	42	0	0	10006
P42684-1#120	0	42	42	P42684-1	1593	1635	+	42	P42684-1	0	2061	ENST00000511413.5	0	2061	++	133	P42684-1#120	0	42	ENST00000511413.5	1593	1635	+	42	0	0	10007
P42684-1#120	0	42	42	P42684-1	1593	1635	+	42	P42684-1	0	2061	ENST00000507173.5	0	1998	++	132	P42684-1#120	0	42	ENST00000507173.5	1530	1572	+	42	0	0	10008
P42684-1#120	0	42	42	P42684-1	1593	1635	+	42	P42684-1	219	2061	ENST00000504405.5	111	1953	++	131	P42684-1#120	0	42	ENST00000504405.5	1485	1527	+	42	0	0	10009
P42684-1#120	0	42	42	P42684-1	1593	1635	+	42	P42684-1	0	3546	ENST00000502732.6	280	3826	++	130	P42684-1#120	0	42	ENST00000502732.6	1873	1915	+	42	0	0	10010
P42684-1#120	0	42	42	P42684-1	1593	1635	+	42	P42684-1	0	3546	ENST00000367623.8	0	3483	++	41	P42684-1#120	0	42	ENST00000367623.8	1530	1572	+	42	0	0	10011
P42684-1#120	0	42	42	P42684-1	1593	1635	+	42	P42684-1	156	2061	ENST00000344730.8	143	2048	++	33	P42684-1#120	0	42	ENST00000344730.8	1580	1622	+	42	0	0	10012
P42684-1#121	0	9	9	P42684-1	3204	3213	+	9	P42684-1	156	3546	ENST00000512653.5	123	3513	++	134	P42684-1#121	0	9	ENST00000512653.5	3171	3180	+	9	0	0	10013
P42684-1#121	0	9	9	P42684-1	3204	3213	+	9	P42684-1	0	3546	ENST00000502732.6	280	3826	++	130	P42684-1#121	0	9	ENST00000502732.6	3484	3493	+	9	0	0	10014
P42684-1#121	0	9	9	P42684-1	3204	3213	+	9	P42684-1	0	3546	ENST00000367623.8	0	3483	++	41	P42684-1#121	0	9	ENST00000367623.8	3141	3150	+	9	0	0	10015
P42684-1#122	0	9	9	P42684-1	3225	3234	+	9	P42684-1	156	3546	ENST00000512653.5	123	3513	++	134	P42684-1#122	0	9	ENST00000512653.5	3192	3201	+	9	0	0	10016
P42684-1#122	0	9	9	P42684-1	3225	3234	+	9	P42684-1	0	3546	ENST00000502732.6	280	3826	++	130	P42684-1#122	0	9	ENST00000502732.6	3505	3514	+	9	0	0	10017
P42684-1#122	0	9	9	P42684-1	3225	3234	+	9	P42684-1	0	3546	ENST00000367623.8	0	3483	++	41	P42684-1#122	0	9	ENST00000367623.8	3162	3171	+	9	0	0	10018
P42684-1#123	0	12	12	P42684-1	3237	3249	+	12	P42684-1	156	3546	ENST00000512653.5	123	3513	++	134	P42684-1#123	0	12	ENST00000512653.5	3204	3216	+	12	0	0	10019
P42684-1#123	0	12	12	P42684-1	3237	3249	+	12	P42684-1	0	3546	ENST00000502732.6	280	3826	++	130	P42684-1#123	0	12	ENST00000502732.6	3517	3529	+	12	0	0	10020
P42684-1#123	0	12	12	P42684-1	3237	3249	+	12	P42684-1	0	3546	ENST00000367623.8	0	3483	++	41	P42684-1#123	0	12	ENST00000367623.8	3174	3186	+	12	0	0	10021
P42684-1#124	0	42	42	P42684-1	3255	3297	+	42	P42684-1	156	3546	ENST00000512653.5	123	3513	++	134	P42684-1#124	0	42	ENST00000512653.5	3222	3264	+	42	0	0	10022
P42684-1#124	0	42	42	P42684-1	3255	3297	+	42	P42684-1	0	3546	ENST00000502732.6	280	3826	++	130	P42684-1#124	0	42	ENST00000502732.6	3535	3577	+	42	0	0	10023
P42684-1#124	0	42	42	P42684-1	3255	3297	+	42	P42684-1	0	3546	ENST00000367623.8	0	3483	++	41	P42684-1#124	0	42	ENST00000367623.8	3192	3234	+	42	0	0	10024
P42684-1#125	0	54	54	P42684-1	3315	3369	+	54	P42684-1	156	3546	ENST00000512653.5	123	3513	++	134	P42684-1#125	0	54	ENST00000512653.5	3282	3336	+	54	0	0	10025
P42684-1#125	0	54	54	P42684-1	3315	3369	+	54	P42684-1	0	3546	ENST00000502732.6	280	3826	++	130	P42684-1#125	0	54	ENST00000502732.6	3595	3649	+	54	0	0	10026
P42684-1#125	0	54	54	P42684-1	3315	3369	+	54	P42684-1	0	3546	ENST00000367623.8	0	3483	++	41	P42684-1#125	0	54	ENST00000367623.8	3252	3306	+	54	0	0	10027
P42684-1#126	0	9	9	P42684-1	3369	3378	+	9	P42684-1	156	3546	ENST00000512653.5	123	3513	++	134	P42684-1#126	0	9	ENST00000512653.5	3336	3345	+	9	0	0	10028
P42684-1#126	0	9	9	P42684-1	3369	3378	+	9	P42684-1	0	3546	ENST00000502732.6	280	3826	++	130	P42684-1#126	0	9	ENST00000502732.6	3649	3658	+	9	0	0	10029
P42684-1#126	0	9	9	P42684-1	3369	3378	+	9	P42684-1	0	3546	ENST00000367623.8	0	3483	++	41	P42684-1#126	0	9	ENST00000367623.8	3306	3315	+	9	0	0	10030
P42684-1#127	0	69	69	P42684-1	3387	3456	+	69	P42684-1	156	3546	ENST00000512653.5	123	3513	++	134	P42684-1#127	0	69	ENST00000512653.5	3354	3423	+	69	0	0	10031
P42684-1#127	0	69	69	P42684-1	3387	3456	+	69	P42684-1	0	3546	ENST00000502732.6	280	3826	++	130	P42684-1#127	0	69	ENST00000502732.6	3667	3736	+	69	0	0	10032
P42684-1#127	0	69	69	P42684-1	3387	3456	+	69	P42684-1	0	3546	ENST00000367623.8	0	3483	++	41	P42684-1#127	0	69	ENST00000367623.8	3324	3393	+	69	0	0	10033
P42684-1#128	0	12	12	P42684-1	3462	3474	+	12	P42684-1	156	3546	ENST00000512653.5	123	3513	++	134	P42684-1#128	0	12	ENST00000512653.5	3429	3441	+	12	0	0	10034
P42684-1#128	0	12	12	P42684-1	3462	3474	+	12	P42684-1	0	3546	ENST00000502732.6	280	3826	++	130	P42684-1#128	0	12	ENST00000502732.6	3742	3754	+	12	0	0	10035
P42684-1#128	0	12	12	P42684-1	3462	3474	+	12	P42684-1	0	3546	ENST00000367623.8	0	3483	++	41	P42684-1#128	0	12	ENST00000367623.8	3399	3411	+	12	0	0	10036
P42684-1#129	0	51	51	P42684-1	3492	3543	+	51	P42684-1	156	3546	ENST00000512653.5	123	3513	++	134	P42684-1#129	0	51	ENST00000512653.5	3459	3510	+	51	0	0	10037
P42684-1#129	0	51	51	P42684-1	3492	3543	+	51	P42684-1	0	3546	ENST00000502732.6	280	3826	++	130	P42684-1#129	0	51	ENST00000502732.6	3772	3823	+	51	0	0	10038
P42684-1#129	0	51	51	P42684-1	3492	3543	+	51	P42684-1	0	3546	ENST00000367623.8	0	3483	++	41	P42684-1#129	0	51	ENST00000367623.8	3429	3480	+	51	0	0	10039
P42684-1#130	0	3	3	P42684-1	1938	1941	+	3	P42684-1	156	3546	ENST00000512653.5	123	3513	++	134	P42684-1#130	0	3	ENST00000512653.5	1905	1908	+	3	0	0	10040
P42684-1#130	0	3	3	P42684-1	1938	1941	+	3	P42684-1	0	2061	ENST00000511413.5	0	2061	++	133	P42684-1#130	0	3	ENST00000511413.5	1938	1941	+	3	0	0	10041
P42684-1#130	0	3	3	P42684-1	1938	1941	+	3	P42684-1	0	2061	ENST00000507173.5	0	1998	++	132	P42684-1#130	0	3	ENST00000507173.5	1875	1878	+	3	0	0	10042
P42684-1#130	0	3	3	P42684-1	1938	1941	+	3	P42684-1	219	2061	ENST00000504405.5	111	1953	++	131	P42684-1#130	0	3	ENST00000504405.5	1830	1833	+	3	0	0	10043
P42684-1#130	0	3	3	P42684-1	1938	1941	+	3	P42684-1	0	3546	ENST00000502732.6	280	3826	++	130	P42684-1#130	0	3	ENST00000502732.6	2218	2221	+	3	0	0	10044
P42684-1#130	0	3	3	P42684-1	1938	1941	+	3	P42684-1	0	3546	ENST00000367623.8	0	3483	++	41	P42684-1#130	0	3	ENST00000367623.8	1875	1878	+	3	0	0	10045
P42684-1#130	0	3	3	P42684-1	1938	1941	+	3	P42684-1	156	2061	ENST00000344730.8	143	2048	++	33	P42684-1#130	0	3	ENST00000344730.8	1925	1928	+	3	0	0	10046
P42684-1#131	0	3	3	P42684-1	33	36	+	3	P42684-1	0	2061	ENST00000511413.5	0	2061	++	133	P42684-1#131	0	3	ENST00000511413.5	33	36	+	3	0	0	10047
P42684-1#131	0	3	3	P42684-1	33	36	+	3	P42684-1	0	2061	ENST00000507173.5	0	1998	++	132	P42684-1#131	0	3	ENST00000507173.5	33	36	+	3	0	0	10048
P42684-1#131	0	3	3	P42684-1	33	36	+	3	P42684-1	0	3546	ENST00000502732.6	280	3826	++	130	P42684-1#131	0	3	ENST00000502732.6	313	316	+	3	0	0	10049
P42684-1#131	0	3	3	P42684-1	33	36	+	3	P42684-1	0	3546	ENST00000367623.8	0	3483	++	41	P42684-1#131	0	3	ENST00000367623.8	33	36	+	3	0	0	10050
P42684-1#132	0	3	3	P42684-1	2046	2049	+	3	P42684-1	156	3546	ENST00000512653.5	123	3513	++	134	P42684-1#132	0	3	ENST00000512653.5	2013	2016	+	3	0	0	10051
P42684-1#132	0	3	3	P42684-1	2046	2049	+	3	P42684-1	0	2061	ENST00000511413.5	0	2061	++	133	P42684-1#132	0	3	ENST00000511413.5	2046	2049	+	3	0	0	10052
P42684-1#132	0	3	3	P42684-1	2046	2049	+	3	P42684-1	0	2061	ENST00000507173.5	0	1998	++	132	P42684-1#132	0	3	ENST00000507173.5	1983	1986	+	3	0	0	10053
P42684-1#132	0	3	3	P42684-1	2046	2049	+	3	P42684-1	219	2061	ENST00000504405.5	111	1953	++	131	P42684-1#132	0	3	ENST00000504405.5	1938	1941	+	3	0	0	10054
P42684-1#132	0	3	3	P42684-1	2046	2049	+	3	P42684-1	0	3546	ENST00000502732.6	280	3826	++	130	P42684-1#132	0	3	ENST00000502732.6	2326	2329	+	3	0	0	10055
P42684-1#132	0	3	3	P42684-1	2046	2049	+	3	P42684-1	0	3546	ENST00000367623.8	0	3483	++	41	P42684-1#132	0	3	ENST00000367623.8	1983	1986	+	3	0	0	10056
P42684-1#132	0	3	3	P42684-1	2046	2049	+	3	P42684-1	156	2061	ENST00000344730.8	143	2048	++	33	P42684-1#132	0	3	ENST00000344730.8	2033	2036	+	3	0	0	10057
P42684-1#133	0	3	3	P42684-1	1983	1986	+	3	P42684-1	156	3546	ENST00000512653.5	123	3513	++	134	P42684-1#133	0	3	ENST00000512653.5	1950	1953	+	3	0	0	10058
P42684-1#133	0	3	3	P42684-1	1983	1986	+	3	P42684-1	0	2061	ENST00000511413.5	0	2061	++	133	P42684-1#133	0	3	ENST00000511413.5	1983	1986	+	3	0	0	10059
P42684-1#133	0	3	3	P42684-1	1983	1986	+	3	P42684-1	0	2061	ENST00000507173.5	0	1998	++	132	P42684-1#133	0	3	ENST00000507173.5	1920	1923	+	3	0	0	10060
P42684-1#133	0	3	3	P42684-1	1983	1986	+	3	P42684-1	219	2061	ENST00000504405.5	111	1953	++	131	P42684-1#133	0	3	ENST00000504405.5	1875	1878	+	3	0	0	10061
P42684-1#133	0	3	3	P42684-1	1983	1986	+	3	P42684-1	0	3546	ENST00000502732.6	280	3826	++	130	P42684-1#133	0	3	ENST00000502732.6	2263	2266	+	3	0	0	10062
P42684-1#133	0	3	3	P42684-1	1983	1986	+	3	P42684-1	0	3546	ENST00000367623.8	0	3483	++	41	P42684-1#133	0	3	ENST00000367623.8	1920	1923	+	3	0	0	10063
P42684-1#133	0	3	3	P42684-1	1983	1986	+	3	P42684-1	156	2061	ENST00000344730.8	143	2048	++	33	P42684-1#133	0	3	ENST00000344730.8	1970	1973	+	3	0	0	10064
P42684-1#134	0	3	3	P42684-1	2001	2004	+	3	P42684-1	156	3546	ENST00000512653.5	123	3513	++	134	P42684-1#134	0	3	ENST00000512653.5	1968	1971	+	3	0	0	10065
P42684-1#134	0	3	3	P42684-1	2001	2004	+	3	P42684-1	0	2061	ENST00000511413.5	0	2061	++	133	P42684-1#134	0	3	ENST00000511413.5	2001	2004	+	3	0	0	10066
P42684-1#134	0	3	3	P42684-1	2001	2004	+	3	P42684-1	0	2061	ENST00000507173.5	0	1998	++	132	P42684-1#134	0	3	ENST00000507173.5	1938	1941	+	3	0	0	10067
P42684-1#134	0	3	3	P42684-1	2001	2004	+	3	P42684-1	219	2061	ENST00000504405.5	111	1953	++	131	P42684-1#134	0	3	ENST00000504405.5	1893	1896	+	3	0	0	10068
P42684-1#134	0	3	3	P42684-1	2001	2004	+	3	P42684-1	0	3546	ENST00000502732.6	280	3826	++	130	P42684-1#134	0	3	ENST00000502732.6	2281	2284	+	3	0	0	10069
P42684-1#134	0	3	3	P42684-1	2001	2004	+	3	P42684-1	0	3546	ENST00000367623.8	0	3483	++	41	P42684-1#134	0	3	ENST00000367623.8	1938	1941	+	3	0	0	10070
P42684-1#134	0	3	3	P42684-1	2001	2004	+	3	P42684-1	156	2061	ENST00000344730.8	143	2048	++	33	P42684-1#134	0	3	ENST00000344730.8	1988	1991	+	3	0	0	10071
Q96D53-1#0	0	1632	1632	Q96D53-1	0	1632	+	1632	Q96D53-1	0	313	ENST00000679315.1	109	355	+	272	Q96D53-1#0	0	313	ENST00000679315.1	109	355	+	246	0	1319	10072
Q96D53-1#0	0	1632	1632	Q96D53-1	0	1632	+	1632	Q96D53-1	0	1632	ENST00000679130.1	149	1781	++	271	Q96D53-1#0	0	1632	ENST00000679130.1	149	1781	+	1632	0	0	10073
Q96D53-1#0	0	1632	1632	Q96D53-1	0	1632	+	1632	Q96D53-1	327	577	ENST00000679070.1	229	472	+	270	Q96D53-1#0	327	577	ENST00000679070.1	229	472	+	243	327	1055	10074
Q96D53-1#0	0	1632	1632	Q96D53-1	0	1632	+	1632	Q96D53-1	412	1632	ENST00000679012.1	561	1749	+	269	Q96D53-1#0	412	1632	ENST00000679012.1	561	1749	+	1188	412	0	10075
Q96D53-1#0	0	1632	1632	Q96D53-1	0	1632	+	1632	Q96D53-1	0	1015	ENST00000678569.1	101	1112	+	268	Q96D53-1#0	0	1015	ENST00000678569.1	101	1112	+	1011	0	617	10076
Q96D53-1#0	0	1632	1632	Q96D53-1	0	1632	+	1632	Q96D53-1	0	1632	ENST00000678467.1	117	1749	++	267	Q96D53-1#0	0	1632	ENST00000678467.1	117	1749	+	1632	0	0	10077
Q96D53-1#0	0	1632	1632	Q96D53-1	0	1632	+	1632	Q96D53-1	0	1632	ENST00000678419.1	81	1713	++	266	Q96D53-1#0	0	1632	ENST00000678419.1	81	1713	+	1632	0	0	10078
Q96D53-1#0	0	1632	1632	Q96D53-1	0	1632	+	1632	Q96D53-1	0	1632	ENST00000678404.1	295	1927	++	265	Q96D53-1#0	0	1632	ENST00000678404.1	295	1927	+	1632	0	0	10079
Q96D53-1#0	0	1632	1632	Q96D53-1	0	1632	+	1632	Q96D53-1	0	577	ENST00000678316.1	139	691	+	264	Q96D53-1#0	0	577	ENST00000678316.1	139	691	+	552	0	1055	10080
Q96D53-1#0	0	1632	1632	Q96D53-1	0	1632	+	1632	Q96D53-1	0	313	ENST00000678057.1	205	451	+	263	Q96D53-1#0	0	313	ENST00000678057.1	205	451	+	246	0	1319	10081
Q96D53-1#0	0	1632	1632	Q96D53-1	0	1632	+	1632	Q96D53-1	0	490	ENST00000677800.1	25	392	+	262	Q96D53-1#0	0	490	ENST00000677800.1	25	392	+	367	0	1142	10082
Q96D53-1#0	0	1632	1632	Q96D53-1	0	1632	+	1632	Q96D53-1	0	577	ENST00000677633.1	120	690	+	261	Q96D53-1#0	0	577	ENST00000677633.1	120	690	+	570	0	1055	10083
Q96D53-1#0	0	1632	1632	Q96D53-1	0	1632	+	1632	Q96D53-1	327	1632	ENST00000677517.1	213	1518	+	260	Q96D53-1#0	327	1632	ENST00000677517.1	213	1518	+	1305	327	0	10084
Q96D53-1#0	0	1632	1632	Q96D53-1	0	1632	+	1632	Q96D53-1	327	1632	ENST00000677496.1	217	1522	+	259	Q96D53-1#0	327	1632	ENST00000677496.1	217	1522	+	1305	327	0	10085
Q96D53-1#0	0	1632	1632	Q96D53-1	0	1632	+	1632	Q96D53-1	0	1632	ENST00000677018.1	141	1773	++	258	Q96D53-1#0	0	1632	ENST00000677018.1	141	1773	+	1632	0	0	10086
Q96D53-1#0	0	1632	1632	Q96D53-1	0	1632	+	1632	Q96D53-1	0	222	ENST00000676578.1	78	300	+	257	Q96D53-1#0	0	222	ENST00000676578.1	78	300	+	222	0	1410	10087
Q96D53-1#0	0	1632	1632	Q96D53-1	0	1632	+	1632	Q96D53-1	0	1143	ENST00000676555.1	101	1244	+	256	Q96D53-1#0	0	1143	ENST00000676555.1	101	1244	+	1143	0	489	10088
Q96D53-1#0	0	1632	1632	Q96D53-1	0	1632	+	1632	Q96D53-1	0	1632	ENST00000601967.6	45	1677	++	226	Q96D53-1#0	0	1632	ENST00000601967.6	45	1677	+	1632	0	0	10089
Q96D53-1#0	0	1632	1632	Q96D53-1	0	1632	+	1632	Q96D53-1	0	226	ENST00000601304.5	153	399	+	223	Q96D53-1#0	0	226	ENST00000601304.5	153	399	+	226	0	1406	10090
Q96D53-1#0	0	1632	1632	Q96D53-1	0	1632	+	1632	Q96D53-1	0	364	ENST00000600707.5	30	394	+	219	Q96D53-1#0	0	364	ENST00000600707.5	30	394	+	364	0	1268	10091
Q96D53-1#0	0	1632	1632	Q96D53-1	0	1632	+	1632	Q96D53-1	327	554	ENST00000600080.5	253	473	+	218	Q96D53-1#0	327	554	ENST00000600080.5	253	473	+	220	327	1078	10092
Q96D53-1#0	0	1632	1632	Q96D53-1	0	1632	+	1632	Q96D53-1	0	730	ENST00000599643.5	52	400	+	216	Q96D53-1#0	0	730	ENST00000599643.5	52	400	+	348	0	902	10093
Q96D53-1#0	0	1632	1632	Q96D53-1	0	1632	+	1632	Q96D53-1	0	331	ENST00000596357.1	42	373	+	212	Q96D53-1#0	0	331	ENST00000596357.1	42	373	+	331	0	1301	10094
Q96D53-1#0	0	1632	1632	Q96D53-1	0	1632	+	1632	Q96D53-1	327	940	ENST00000595254.5	254	867	+	209	Q96D53-1#0	327	940	ENST00000595254.5	254	867	+	613	327	692	10095
Q96D53-1#0	0	1632	1632	Q96D53-1	0	1632	+	1632	Q96D53-1	0	1632	ENST00000594720.6	38	1670	++	206	Q96D53-1#0	0	1632	ENST00000594720.6	38	1670	+	1632	0	0	10096
Q96D53-1#0	0	1632	1632	Q96D53-1	0	1632	+	1632	Q96D53-1	0	1632	ENST00000594490.6	29	1583	+	205	Q96D53-1#0	0	1632	ENST00000594490.6	29	1583	+	1554	0	0	10097
Q96D53-1#0	0	1632	1632	Q96D53-1	0	1632	+	1632	Q96D53-1	0	473	ENST00000594084.5	121	594	+	204	Q96D53-1#0	0	473	ENST00000594084.5	121	594	+	473	0	1159	10098
Q96D53-1#0	0	1632	1632	Q96D53-1	0	1632	+	1632	Q96D53-1	0	1632	ENST00000324464.8	303	1935	++	26	Q96D53-1#0	0	1632	ENST00000324464.8	303	1935	+	1632	0	0	10099
Q96D53-1#0	0	1632	1632	Q96D53-1	0	1632	+	1632	Q96D53-1	0	1632	ENST00000243583.10	24	1533	++	3	Q96D53-1#0	0	1632	ENST00000243583.10	24	1533	+	1509	0	0	10100
Q96D53-1#1	0	51	51	Q96D53-1	273	324	+	51	Q96D53-1	0	313	ENST00000679315.1	109	355	+	272	Q96D53-1#1	16	40	ENST00000679315.1	331	355	+	24	16	11	10101
Q96D53-1#1	0	51	51	Q96D53-1	273	324	+	51	Q96D53-1	0	1632	ENST00000679130.1	149	1781	++	271	Q96D53-1#1	0	51	ENST00000679130.1	422	473	+	51	0	0	10102
Q96D53-1#1	0	51	51	Q96D53-1	273	324	+	51	Q96D53-1	0	1015	ENST00000678569.1	101	1112	+	268	Q96D53-1#1	0	51	ENST00000678569.1	374	425	+	51	0	0	10103
Q96D53-1#1	0	51	51	Q96D53-1	273	324	+	51	Q96D53-1	0	1632	ENST00000678467.1	117	1749	++	267	Q96D53-1#1	0	51	ENST00000678467.1	390	441	+	51	0	0	10104
Q96D53-1#1	0	51	51	Q96D53-1	273	324	+	51	Q96D53-1	0	1632	ENST00000678419.1	81	1713	++	266	Q96D53-1#1	0	51	ENST00000678419.1	354	405	+	51	0	0	10105
Q96D53-1#1	0	51	51	Q96D53-1	273	324	+	51	Q96D53-1	0	1632	ENST00000678404.1	295	1927	++	265	Q96D53-1#1	0	51	ENST00000678404.1	568	619	+	51	0	0	10106
Q96D53-1#1	0	51	51	Q96D53-1	273	324	+	51	Q96D53-1	0	577	ENST00000678316.1	139	691	+	264	Q96D53-1#1	0	51	ENST00000678316.1	412	463	+	51	0	0	10107
Q96D53-1#1	0	51	51	Q96D53-1	273	324	+	51	Q96D53-1	0	313	ENST00000678057.1	205	451	+	263	Q96D53-1#1	16	40	ENST00000678057.1	427	451	+	24	16	11	10108
Q96D53-1#1	0	51	51	Q96D53-1	273	324	+	51	Q96D53-1	0	490	ENST00000677800.1	25	392	+	262	Q96D53-1#1	0	51	ENST00000677800.1	298	349	+	51	0	0	10109
Q96D53-1#1	0	51	51	Q96D53-1	273	324	+	51	Q96D53-1	0	577	ENST00000677633.1	120	690	+	261	Q96D53-1#1	0	51	ENST00000677633.1	393	444	+	51	0	0	10110
Q96D53-1#1	0	51	51	Q96D53-1	273	324	+	51	Q96D53-1	0	1632	ENST00000677018.1	141	1773	++	258	Q96D53-1#1	0	51	ENST00000677018.1	414	465	+	51	0	0	10111
Q96D53-1#1	0	51	51	Q96D53-1	273	324	+	51	Q96D53-1	0	1143	ENST00000676555.1	101	1244	+	256	Q96D53-1#1	0	51	ENST00000676555.1	374	425	+	51	0	0	10112
Q96D53-1#1	0	51	51	Q96D53-1	273	324	+	51	Q96D53-1	0	1632	ENST00000601967.6	45	1677	++	226	Q96D53-1#1	0	51	ENST00000601967.6	318	369	+	51	0	0	10113
Q96D53-1#1	0	51	51	Q96D53-1	273	324	+	51	Q96D53-1	0	364	ENST00000600707.5	30	394	+	219	Q96D53-1#1	0	51	ENST00000600707.5	303	354	+	51	0	0	10114
Q96D53-1#1	0	51	51	Q96D53-1	273	324	+	51	Q96D53-1	0	331	ENST00000596357.1	42	373	+	212	Q96D53-1#1	0	51	ENST00000596357.1	315	366	+	51	0	0	10115
Q96D53-1#1	0	51	51	Q96D53-1	273	324	+	51	Q96D53-1	0	1632	ENST00000594720.6	38	1670	++	206	Q96D53-1#1	0	51	ENST00000594720.6	311	362	+	51	0	0	10116
Q96D53-1#1	0	51	51	Q96D53-1	273	324	+	51	Q96D53-1	0	1632	ENST00000594490.6	29	1583	+	205	Q96D53-1#1	0	16	ENST00000594490.6	302	318	+	16	0	35	10117
Q96D53-1#1	0	51	51	Q96D53-1	273	324	+	51	Q96D53-1	0	473	ENST00000594084.5	121	594	+	204	Q96D53-1#1	0	51	ENST00000594084.5	394	445	+	51	0	0	10118
Q96D53-1#1	0	51	51	Q96D53-1	273	324	+	51	Q96D53-1	0	1632	ENST00000324464.8	303	1935	++	26	Q96D53-1#1	0	51	ENST00000324464.8	576	627	+	51	0	0	10119
Q96D53-1#1	0	51	51	Q96D53-1	273	324	+	51	Q96D53-1	0	1632	ENST00000243583.10	24	1533	++	3	Q96D53-1#1	0	51	ENST00000243583.10	297	348	+	51	0	0	10120
Q96D53-1#2	0	699	699	Q96D53-1	570	1269	+	699	Q96D53-1	0	1632	ENST00000679130.1	149	1781	++	271	Q96D53-1#2	0	699	ENST00000679130.1	719	1418	+	699	0	0	10121
Q96D53-1#2	0	699	699	Q96D53-1	570	1269	+	699	Q96D53-1	327	577	ENST00000679070.1	229	472	+	270	Q96D53-1#2	0	7	ENST00000679070.1	465	472	+	7	0	692	10122
Q96D53-1#2	0	699	699	Q96D53-1	570	1269	+	699	Q96D53-1	412	1632	ENST00000679012.1	561	1749	+	269	Q96D53-1#2	0	699	ENST00000679012.1	687	1386	+	699	0	0	10123
Q96D53-1#2	0	699	699	Q96D53-1	570	1269	+	699	Q96D53-1	0	1015	ENST00000678569.1	101	1112	+	268	Q96D53-1#2	0	445	ENST00000678569.1	671	1112	+	441	0	254	10124
Q96D53-1#2	0	699	699	Q96D53-1	570	1269	+	699	Q96D53-1	0	1632	ENST00000678467.1	117	1749	++	267	Q96D53-1#2	0	699	ENST00000678467.1	687	1386	+	699	0	0	10125
Q96D53-1#2	0	699	699	Q96D53-1	570	1269	+	699	Q96D53-1	0	1632	ENST00000678419.1	81	1713	++	266	Q96D53-1#2	0	699	ENST00000678419.1	651	1350	+	699	0	0	10126
Q96D53-1#2	0	699	699	Q96D53-1	570	1269	+	699	Q96D53-1	0	1632	ENST00000678404.1	295	1927	++	265	Q96D53-1#2	0	699	ENST00000678404.1	865	1564	+	699	0	0	10127
Q96D53-1#2	0	699	699	Q96D53-1	570	1269	+	699	Q96D53-1	0	577	ENST00000678316.1	139	691	+	264	Q96D53-1#2	0	7	ENST00000678316.1	684	691	+	7	0	692	10128
Q96D53-1#2	0	699	699	Q96D53-1	570	1269	+	699	Q96D53-1	0	577	ENST00000677633.1	120	690	+	261	Q96D53-1#2	0	7	ENST00000677633.1	683	690	+	7	0	692	10129
Q96D53-1#2	0	699	699	Q96D53-1	570	1269	+	699	Q96D53-1	327	1632	ENST00000677517.1	213	1518	+	260	Q96D53-1#2	0	699	ENST00000677517.1	456	1155	+	699	0	0	10130
Q96D53-1#2	0	699	699	Q96D53-1	570	1269	+	699	Q96D53-1	327	1632	ENST00000677496.1	217	1522	+	259	Q96D53-1#2	0	699	ENST00000677496.1	460	1159	+	699	0	0	10131
Q96D53-1#2	0	699	699	Q96D53-1	570	1269	+	699	Q96D53-1	0	1632	ENST00000677018.1	141	1773	++	258	Q96D53-1#2	0	699	ENST00000677018.1	711	1410	+	699	0	0	10132
Q96D53-1#2	0	699	699	Q96D53-1	570	1269	+	699	Q96D53-1	0	1143	ENST00000676555.1	101	1244	+	256	Q96D53-1#2	0	573	ENST00000676555.1	671	1244	+	573	0	126	10133
Q96D53-1#2	0	699	699	Q96D53-1	570	1269	+	699	Q96D53-1	0	1632	ENST00000601967.6	45	1677	++	226	Q96D53-1#2	0	699	ENST00000601967.6	615	1314	+	699	0	0	10134
Q96D53-1#2	0	699	699	Q96D53-1	570	1269	+	699	Q96D53-1	0	730	ENST00000599643.5	52	400	+	216	Q96D53-1#2	0	160	ENST00000599643.5	381	400	+	19	0	539	10135
Q96D53-1#2	0	699	699	Q96D53-1	570	1269	+	699	Q96D53-1	327	940	ENST00000595254.5	254	867	+	209	Q96D53-1#2	0	370	ENST00000595254.5	497	867	+	370	0	329	10136
Q96D53-1#2	0	699	699	Q96D53-1	570	1269	+	699	Q96D53-1	0	1632	ENST00000594720.6	38	1670	++	206	Q96D53-1#2	0	699	ENST00000594720.6	608	1307	+	699	0	0	10137
Q96D53-1#2	0	699	699	Q96D53-1	570	1269	+	699	Q96D53-1	0	1632	ENST00000594490.6	29	1583	+	205	Q96D53-1#2	0	699	ENST00000594490.6	521	1220	+	699	0	0	10138
Q96D53-1#2	0	699	699	Q96D53-1	570	1269	+	699	Q96D53-1	0	1632	ENST00000324464.8	303	1935	++	26	Q96D53-1#2	0	699	ENST00000324464.8	873	1572	+	699	0	0	10139
Q96D53-1#2	0	699	699	Q96D53-1	570	1269	+	699	Q96D53-1	0	1632	ENST00000243583.10	24	1533	++	3	Q96D53-1#2	0	699	ENST00000243583.10	471	1170	+	699	0	0	10140
Q96D53-1#3	0	126	126	Q96D53-1	132	258	+	126	Q96D53-1	0	313	ENST00000679315.1	109	355	+	272	Q96D53-1#3	0	90	ENST00000679315.1	241	331	+	90	0	36	10141
Q96D53-1#3	0	126	126	Q96D53-1	132	258	+	126	Q96D53-1	0	1632	ENST00000679130.1	149	1781	++	271	Q96D53-1#3	0	126	ENST00000679130.1	281	407	+	126	0	0	10142
Q96D53-1#3	0	126	126	Q96D53-1	132	258	+	126	Q96D53-1	0	1015	ENST00000678569.1	101	1112	+	268	Q96D53-1#3	0	126	ENST00000678569.1	233	359	+	126	0	0	10143
Q96D53-1#3	0	126	126	Q96D53-1	132	258	+	126	Q96D53-1	0	1632	ENST00000678467.1	117	1749	++	267	Q96D53-1#3	0	126	ENST00000678467.1	249	375	+	126	0	0	10144
Q96D53-1#3	0	126	126	Q96D53-1	132	258	+	126	Q96D53-1	0	1632	ENST00000678419.1	81	1713	++	266	Q96D53-1#3	0	126	ENST00000678419.1	213	339	+	126	0	0	10145
Q96D53-1#3	0	126	126	Q96D53-1	132	258	+	126	Q96D53-1	0	1632	ENST00000678404.1	295	1927	++	265	Q96D53-1#3	0	126	ENST00000678404.1	427	553	+	126	0	0	10146
Q96D53-1#3	0	126	126	Q96D53-1	132	258	+	126	Q96D53-1	0	577	ENST00000678316.1	139	691	+	264	Q96D53-1#3	0	126	ENST00000678316.1	271	397	+	126	0	0	10147
Q96D53-1#3	0	126	126	Q96D53-1	132	258	+	126	Q96D53-1	0	313	ENST00000678057.1	205	451	+	263	Q96D53-1#3	0	90	ENST00000678057.1	337	427	+	90	0	36	10148
Q96D53-1#3	0	126	126	Q96D53-1	132	258	+	126	Q96D53-1	0	490	ENST00000677800.1	25	392	+	262	Q96D53-1#3	0	126	ENST00000677800.1	157	283	+	126	0	0	10149
Q96D53-1#3	0	126	126	Q96D53-1	132	258	+	126	Q96D53-1	0	577	ENST00000677633.1	120	690	+	261	Q96D53-1#3	0	126	ENST00000677633.1	252	378	+	126	0	0	10150
Q96D53-1#3	0	126	126	Q96D53-1	132	258	+	126	Q96D53-1	0	1632	ENST00000677018.1	141	1773	++	258	Q96D53-1#3	0	126	ENST00000677018.1	273	399	+	126	0	0	10151
Q96D53-1#3	0	126	126	Q96D53-1	132	258	+	126	Q96D53-1	0	222	ENST00000676578.1	78	300	+	257	Q96D53-1#3	0	90	ENST00000676578.1	210	300	+	90	0	36	10152
Q96D53-1#3	0	126	126	Q96D53-1	132	258	+	126	Q96D53-1	0	1143	ENST00000676555.1	101	1244	+	256	Q96D53-1#3	0	126	ENST00000676555.1	233	359	+	126	0	0	10153
Q96D53-1#3	0	126	126	Q96D53-1	132	258	+	126	Q96D53-1	0	1632	ENST00000601967.6	45	1677	++	226	Q96D53-1#3	0	126	ENST00000601967.6	177	303	+	126	0	0	10154
Q96D53-1#3	0	126	126	Q96D53-1	132	258	+	126	Q96D53-1	0	226	ENST00000601304.5	153	399	+	223	Q96D53-1#3	0	94	ENST00000601304.5	285	399	+	94	0	32	10155
Q96D53-1#3	0	126	126	Q96D53-1	132	258	+	126	Q96D53-1	0	364	ENST00000600707.5	30	394	+	219	Q96D53-1#3	0	126	ENST00000600707.5	162	288	+	126	0	0	10156
Q96D53-1#3	0	126	126	Q96D53-1	132	258	+	126	Q96D53-1	0	730	ENST00000599643.5	52	400	+	216	Q96D53-1#3	0	117	ENST00000599643.5	184	301	+	117	0	9	10157
Q96D53-1#3	0	126	126	Q96D53-1	132	258	+	126	Q96D53-1	0	331	ENST00000596357.1	42	373	+	212	Q96D53-1#3	0	126	ENST00000596357.1	174	300	+	126	0	0	10158
Q96D53-1#3	0	126	126	Q96D53-1	132	258	+	126	Q96D53-1	0	1632	ENST00000594720.6	38	1670	++	206	Q96D53-1#3	0	126	ENST00000594720.6	170	296	+	126	0	0	10159
Q96D53-1#3	0	126	126	Q96D53-1	132	258	+	126	Q96D53-1	0	1632	ENST00000594490.6	29	1583	+	205	Q96D53-1#3	0	126	ENST00000594490.6	161	287	+	126	0	0	10160
Q96D53-1#3	0	126	126	Q96D53-1	132	258	+	126	Q96D53-1	0	473	ENST00000594084.5	121	594	+	204	Q96D53-1#3	0	126	ENST00000594084.5	253	379	+	126	0	0	10161
Q96D53-1#3	0	126	126	Q96D53-1	132	258	+	126	Q96D53-1	0	1632	ENST00000324464.8	303	1935	++	26	Q96D53-1#3	0	126	ENST00000324464.8	435	561	+	126	0	0	10162
Q96D53-1#3	0	126	126	Q96D53-1	132	258	+	126	Q96D53-1	0	1632	ENST00000243583.10	24	1533	++	3	Q96D53-1#3	0	126	ENST00000243583.10	156	282	+	126	0	0	10163
Q96D53-1#4	0	12	12	Q96D53-1	462	474	+	12	Q96D53-1	0	1632	ENST00000679130.1	149	1781	++	271	Q96D53-1#4	0	12	ENST00000679130.1	611	623	+	12	0	0	10164
Q96D53-1#4	0	12	12	Q96D53-1	462	474	+	12	Q96D53-1	327	577	ENST00000679070.1	229	472	+	270	Q96D53-1#4	0	12	ENST00000679070.1	364	376	+	12	0	0	10165
Q96D53-1#4	0	12	12	Q96D53-1	462	474	+	12	Q96D53-1	412	1632	ENST00000679012.1	561	1749	+	269	Q96D53-1#4	0	3	ENST00000679012.1	611	614	+	3	0	9	10166
Q96D53-1#4	0	12	12	Q96D53-1	462	474	+	12	Q96D53-1	0	1015	ENST00000678569.1	101	1112	+	268	Q96D53-1#4	0	12	ENST00000678569.1	563	575	+	12	0	0	10167
Q96D53-1#4	0	12	12	Q96D53-1	462	474	+	12	Q96D53-1	0	1632	ENST00000678467.1	117	1749	++	267	Q96D53-1#4	0	12	ENST00000678467.1	579	591	+	12	0	0	10168
Q96D53-1#4	0	12	12	Q96D53-1	462	474	+	12	Q96D53-1	0	1632	ENST00000678419.1	81	1713	++	266	Q96D53-1#4	0	12	ENST00000678419.1	543	555	+	12	0	0	10169
Q96D53-1#4	0	12	12	Q96D53-1	462	474	+	12	Q96D53-1	0	1632	ENST00000678404.1	295	1927	++	265	Q96D53-1#4	0	12	ENST00000678404.1	757	769	+	12	0	0	10170
Q96D53-1#4	0	12	12	Q96D53-1	462	474	+	12	Q96D53-1	0	577	ENST00000678316.1	139	691	+	264	Q96D53-1#4	0	3	ENST00000678316.1	601	604	+	3	0	9	10171
Q96D53-1#4	0	12	12	Q96D53-1	462	474	+	12	Q96D53-1	0	577	ENST00000677633.1	120	690	+	261	Q96D53-1#4	0	12	ENST00000677633.1	582	594	+	12	0	0	10172
Q96D53-1#4	0	12	12	Q96D53-1	462	474	+	12	Q96D53-1	327	1632	ENST00000677517.1	213	1518	+	260	Q96D53-1#4	0	12	ENST00000677517.1	348	360	+	12	0	0	10173
Q96D53-1#4	0	12	12	Q96D53-1	462	474	+	12	Q96D53-1	327	1632	ENST00000677496.1	217	1522	+	259	Q96D53-1#4	0	12	ENST00000677496.1	352	364	+	12	0	0	10174
Q96D53-1#4	0	12	12	Q96D53-1	462	474	+	12	Q96D53-1	0	1632	ENST00000677018.1	141	1773	++	258	Q96D53-1#4	0	12	ENST00000677018.1	603	615	+	12	0	0	10175
Q96D53-1#4	0	12	12	Q96D53-1	462	474	+	12	Q96D53-1	0	1143	ENST00000676555.1	101	1244	+	256	Q96D53-1#4	0	12	ENST00000676555.1	563	575	+	12	0	0	10176
Q96D53-1#4	0	12	12	Q96D53-1	462	474	+	12	Q96D53-1	0	1632	ENST00000601967.6	45	1677	++	226	Q96D53-1#4	0	12	ENST00000601967.6	507	519	+	12	0	0	10177
Q96D53-1#4	0	12	12	Q96D53-1	462	474	+	12	Q96D53-1	327	554	ENST00000600080.5	253	473	+	218	Q96D53-1#4	0	12	ENST00000600080.5	388	400	+	12	0	0	10178
Q96D53-1#4	0	12	12	Q96D53-1	462	474	+	12	Q96D53-1	327	940	ENST00000595254.5	254	867	+	209	Q96D53-1#4	0	12	ENST00000595254.5	389	401	+	12	0	0	10179
Q96D53-1#4	0	12	12	Q96D53-1	462	474	+	12	Q96D53-1	0	1632	ENST00000594720.6	38	1670	++	206	Q96D53-1#4	0	12	ENST00000594720.6	500	512	+	12	0	0	10180
Q96D53-1#4	0	12	12	Q96D53-1	462	474	+	12	Q96D53-1	0	1632	ENST00000594490.6	29	1583	+	205	Q96D53-1#4	0	12	ENST00000594490.6	413	425	+	12	0	0	10181
Q96D53-1#4	0	12	12	Q96D53-1	462	474	+	12	Q96D53-1	0	473	ENST00000594084.5	121	594	+	204	Q96D53-1#4	0	11	ENST00000594084.5	583	594	+	11	0	1	10182
Q96D53-1#4	0	12	12	Q96D53-1	462	474	+	12	Q96D53-1	0	1632	ENST00000324464.8	303	1935	++	26	Q96D53-1#4	0	12	ENST00000324464.8	765	777	+	12	0	0	10183
Q96D53-1#5	0	12	12	Q96D53-1	645	657	+	12	Q96D53-1	0	1632	ENST00000679130.1	149	1781	++	271	Q96D53-1#5	0	12	ENST00000679130.1	794	806	+	12	0	0	10184
Q96D53-1#5	0	12	12	Q96D53-1	645	657	+	12	Q96D53-1	412	1632	ENST00000679012.1	561	1749	+	269	Q96D53-1#5	0	12	ENST00000679012.1	762	774	+	12	0	0	10185
Q96D53-1#5	0	12	12	Q96D53-1	645	657	+	12	Q96D53-1	0	1015	ENST00000678569.1	101	1112	+	268	Q96D53-1#5	0	12	ENST00000678569.1	746	758	+	12	0	0	10186
Q96D53-1#5	0	12	12	Q96D53-1	645	657	+	12	Q96D53-1	0	1632	ENST00000678467.1	117	1749	++	267	Q96D53-1#5	0	12	ENST00000678467.1	762	774	+	12	0	0	10187
Q96D53-1#5	0	12	12	Q96D53-1	645	657	+	12	Q96D53-1	0	1632	ENST00000678419.1	81	1713	++	266	Q96D53-1#5	0	12	ENST00000678419.1	726	738	+	12	0	0	10188
Q96D53-1#5	0	12	12	Q96D53-1	645	657	+	12	Q96D53-1	0	1632	ENST00000678404.1	295	1927	++	265	Q96D53-1#5	0	12	ENST00000678404.1	940	952	+	12	0	0	10189
Q96D53-1#5	0	12	12	Q96D53-1	645	657	+	12	Q96D53-1	327	1632	ENST00000677517.1	213	1518	+	260	Q96D53-1#5	0	12	ENST00000677517.1	531	543	+	12	0	0	10190
Q96D53-1#5	0	12	12	Q96D53-1	645	657	+	12	Q96D53-1	327	1632	ENST00000677496.1	217	1522	+	259	Q96D53-1#5	0	12	ENST00000677496.1	535	547	+	12	0	0	10191
Q96D53-1#5	0	12	12	Q96D53-1	645	657	+	12	Q96D53-1	0	1632	ENST00000677018.1	141	1773	++	258	Q96D53-1#5	0	12	ENST00000677018.1	786	798	+	12	0	0	10192
Q96D53-1#5	0	12	12	Q96D53-1	645	657	+	12	Q96D53-1	0	1143	ENST00000676555.1	101	1244	+	256	Q96D53-1#5	0	12	ENST00000676555.1	746	758	+	12	0	0	10193
Q96D53-1#5	0	12	12	Q96D53-1	645	657	+	12	Q96D53-1	0	1632	ENST00000601967.6	45	1677	++	226	Q96D53-1#5	0	12	ENST00000601967.6	690	702	+	12	0	0	10194
Q96D53-1#5	0	12	12	Q96D53-1	645	657	+	12	Q96D53-1	327	940	ENST00000595254.5	254	867	+	209	Q96D53-1#5	0	12	ENST00000595254.5	572	584	+	12	0	0	10195
Q96D53-1#5	0	12	12	Q96D53-1	645	657	+	12	Q96D53-1	0	1632	ENST00000594720.6	38	1670	++	206	Q96D53-1#5	0	12	ENST00000594720.6	683	695	+	12	0	0	10196
Q96D53-1#5	0	12	12	Q96D53-1	645	657	+	12	Q96D53-1	0	1632	ENST00000594490.6	29	1583	+	205	Q96D53-1#5	0	12	ENST00000594490.6	596	608	+	12	0	0	10197
Q96D53-1#5	0	12	12	Q96D53-1	645	657	+	12	Q96D53-1	0	1632	ENST00000324464.8	303	1935	++	26	Q96D53-1#5	0	12	ENST00000324464.8	948	960	+	12	0	0	10198
Q96D53-1#5	0	12	12	Q96D53-1	645	657	+	12	Q96D53-1	0	1632	ENST00000243583.10	24	1533	++	3	Q96D53-1#5	0	12	ENST00000243583.10	546	558	+	12	0	0	10199
Q96D53-1#6	0	108	108	Q96D53-1	150	258	+	108	Q96D53-1	0	313	ENST00000679315.1	109	355	+	272	Q96D53-1#6	0	72	ENST00000679315.1	259	331	+	72	0	36	10200
Q96D53-1#6	0	108	108	Q96D53-1	150	258	+	108	Q96D53-1	0	1632	ENST00000679130.1	149	1781	++	271	Q96D53-1#6	0	108	ENST00000679130.1	299	407	+	108	0	0	10201
Q96D53-1#6	0	108	108	Q96D53-1	150	258	+	108	Q96D53-1	0	1015	ENST00000678569.1	101	1112	+	268	Q96D53-1#6	0	108	ENST00000678569.1	251	359	+	108	0	0	10202
Q96D53-1#6	0	108	108	Q96D53-1	150	258	+	108	Q96D53-1	0	1632	ENST00000678467.1	117	1749	++	267	Q96D53-1#6	0	108	ENST00000678467.1	267	375	+	108	0	0	10203
Q96D53-1#6	0	108	108	Q96D53-1	150	258	+	108	Q96D53-1	0	1632	ENST00000678419.1	81	1713	++	266	Q96D53-1#6	0	108	ENST00000678419.1	231	339	+	108	0	0	10204
Q96D53-1#6	0	108	108	Q96D53-1	150	258	+	108	Q96D53-1	0	1632	ENST00000678404.1	295	1927	++	265	Q96D53-1#6	0	108	ENST00000678404.1	445	553	+	108	0	0	10205
Q96D53-1#6	0	108	108	Q96D53-1	150	258	+	108	Q96D53-1	0	577	ENST00000678316.1	139	691	+	264	Q96D53-1#6	0	108	ENST00000678316.1	289	397	+	108	0	0	10206
Q96D53-1#6	0	108	108	Q96D53-1	150	258	+	108	Q96D53-1	0	313	ENST00000678057.1	205	451	+	263	Q96D53-1#6	0	72	ENST00000678057.1	355	427	+	72	0	36	10207
Q96D53-1#6	0	108	108	Q96D53-1	150	258	+	108	Q96D53-1	0	490	ENST00000677800.1	25	392	+	262	Q96D53-1#6	0	108	ENST00000677800.1	175	283	+	108	0	0	10208
Q96D53-1#6	0	108	108	Q96D53-1	150	258	+	108	Q96D53-1	0	577	ENST00000677633.1	120	690	+	261	Q96D53-1#6	0	108	ENST00000677633.1	270	378	+	108	0	0	10209
Q96D53-1#6	0	108	108	Q96D53-1	150	258	+	108	Q96D53-1	0	1632	ENST00000677018.1	141	1773	++	258	Q96D53-1#6	0	108	ENST00000677018.1	291	399	+	108	0	0	10210
Q96D53-1#6	0	108	108	Q96D53-1	150	258	+	108	Q96D53-1	0	222	ENST00000676578.1	78	300	+	257	Q96D53-1#6	0	72	ENST00000676578.1	228	300	+	72	0	36	10211
Q96D53-1#6	0	108	108	Q96D53-1	150	258	+	108	Q96D53-1	0	1143	ENST00000676555.1	101	1244	+	256	Q96D53-1#6	0	108	ENST00000676555.1	251	359	+	108	0	0	10212
Q96D53-1#6	0	108	108	Q96D53-1	150	258	+	108	Q96D53-1	0	1632	ENST00000601967.6	45	1677	++	226	Q96D53-1#6	0	108	ENST00000601967.6	195	303	+	108	0	0	10213
Q96D53-1#6	0	108	108	Q96D53-1	150	258	+	108	Q96D53-1	0	226	ENST00000601304.5	153	399	+	223	Q96D53-1#6	0	76	ENST00000601304.5	303	399	+	76	0	32	10214
Q96D53-1#6	0	108	108	Q96D53-1	150	258	+	108	Q96D53-1	0	364	ENST00000600707.5	30	394	+	219	Q96D53-1#6	0	108	ENST00000600707.5	180	288	+	108	0	0	10215
Q96D53-1#6	0	108	108	Q96D53-1	150	258	+	108	Q96D53-1	0	730	ENST00000599643.5	52	400	+	216	Q96D53-1#6	0	99	ENST00000599643.5	202	301	+	99	0	9	10216
Q96D53-1#6	0	108	108	Q96D53-1	150	258	+	108	Q96D53-1	0	331	ENST00000596357.1	42	373	+	212	Q96D53-1#6	0	108	ENST00000596357.1	192	300	+	108	0	0	10217
Q96D53-1#6	0	108	108	Q96D53-1	150	258	+	108	Q96D53-1	0	1632	ENST00000594720.6	38	1670	++	206	Q96D53-1#6	0	108	ENST00000594720.6	188	296	+	108	0	0	10218
Q96D53-1#6	0	108	108	Q96D53-1	150	258	+	108	Q96D53-1	0	1632	ENST00000594490.6	29	1583	+	205	Q96D53-1#6	0	108	ENST00000594490.6	179	287	+	108	0	0	10219
Q96D53-1#6	0	108	108	Q96D53-1	150	258	+	108	Q96D53-1	0	473	ENST00000594084.5	121	594	+	204	Q96D53-1#6	0	108	ENST00000594084.5	271	379	+	108	0	0	10220
Q96D53-1#6	0	108	108	Q96D53-1	150	258	+	108	Q96D53-1	0	1632	ENST00000324464.8	303	1935	++	26	Q96D53-1#6	0	108	ENST00000324464.8	453	561	+	108	0	0	10221
Q96D53-1#6	0	108	108	Q96D53-1	150	258	+	108	Q96D53-1	0	1632	ENST00000243583.10	24	1533	++	3	Q96D53-1#6	0	108	ENST00000243583.10	174	282	+	108	0	0	10222
Q96D53-1#7	0	3	3	Q96D53-1	1098	1101	+	3	Q96D53-1	0	1632	ENST00000679130.1	149	1781	++	271	Q96D53-1#7	0	3	ENST00000679130.1	1247	1250	+	3	0	0	10223
Q96D53-1#7	0	3	3	Q96D53-1	1098	1101	+	3	Q96D53-1	412	1632	ENST00000679012.1	561	1749	+	269	Q96D53-1#7	0	3	ENST00000679012.1	1215	1218	+	3	0	0	10224
Q96D53-1#7	0	3	3	Q96D53-1	1098	1101	+	3	Q96D53-1	0	1632	ENST00000678467.1	117	1749	++	267	Q96D53-1#7	0	3	ENST00000678467.1	1215	1218	+	3	0	0	10225
Q96D53-1#7	0	3	3	Q96D53-1	1098	1101	+	3	Q96D53-1	0	1632	ENST00000678419.1	81	1713	++	266	Q96D53-1#7	0	3	ENST00000678419.1	1179	1182	+	3	0	0	10226
Q96D53-1#7	0	3	3	Q96D53-1	1098	1101	+	3	Q96D53-1	0	1632	ENST00000678404.1	295	1927	++	265	Q96D53-1#7	0	3	ENST00000678404.1	1393	1396	+	3	0	0	10227
Q96D53-1#7	0	3	3	Q96D53-1	1098	1101	+	3	Q96D53-1	327	1632	ENST00000677517.1	213	1518	+	260	Q96D53-1#7	0	3	ENST00000677517.1	984	987	+	3	0	0	10228
Q96D53-1#7	0	3	3	Q96D53-1	1098	1101	+	3	Q96D53-1	327	1632	ENST00000677496.1	217	1522	+	259	Q96D53-1#7	0	3	ENST00000677496.1	988	991	+	3	0	0	10229
Q96D53-1#7	0	3	3	Q96D53-1	1098	1101	+	3	Q96D53-1	0	1632	ENST00000677018.1	141	1773	++	258	Q96D53-1#7	0	3	ENST00000677018.1	1239	1242	+	3	0	0	10230
Q96D53-1#7	0	3	3	Q96D53-1	1098	1101	+	3	Q96D53-1	0	1143	ENST00000676555.1	101	1244	+	256	Q96D53-1#7	0	3	ENST00000676555.1	1199	1202	+	3	0	0	10231
Q96D53-1#7	0	3	3	Q96D53-1	1098	1101	+	3	Q96D53-1	0	1632	ENST00000601967.6	45	1677	++	226	Q96D53-1#7	0	3	ENST00000601967.6	1143	1146	+	3	0	0	10232
Q96D53-1#7	0	3	3	Q96D53-1	1098	1101	+	3	Q96D53-1	0	1632	ENST00000594720.6	38	1670	++	206	Q96D53-1#7	0	3	ENST00000594720.6	1136	1139	+	3	0	0	10233
Q96D53-1#7	0	3	3	Q96D53-1	1098	1101	+	3	Q96D53-1	0	1632	ENST00000594490.6	29	1583	+	205	Q96D53-1#7	0	3	ENST00000594490.6	1049	1052	+	3	0	0	10234
Q96D53-1#7	0	3	3	Q96D53-1	1098	1101	+	3	Q96D53-1	0	1632	ENST00000324464.8	303	1935	++	26	Q96D53-1#7	0	3	ENST00000324464.8	1401	1404	+	3	0	0	10235
Q96D53-1#7	0	3	3	Q96D53-1	1098	1101	+	3	Q96D53-1	0	1632	ENST00000243583.10	24	1533	++	3	Q96D53-1#7	0	3	ENST00000243583.10	999	1002	+	3	0	0	10236
Q96D53-1#8	0	3	3	Q96D53-1	654	657	+	3	Q96D53-1	0	1632	ENST00000679130.1	149	1781	++	271	Q96D53-1#8	0	3	ENST00000679130.1	803	806	+	3	0	0	10237
Q96D53-1#8	0	3	3	Q96D53-1	654	657	+	3	Q96D53-1	412	1632	ENST00000679012.1	561	1749	+	269	Q96D53-1#8	0	3	ENST00000679012.1	771	774	+	3	0	0	10238
Q96D53-1#8	0	3	3	Q96D53-1	654	657	+	3	Q96D53-1	0	1015	ENST00000678569.1	101	1112	+	268	Q96D53-1#8	0	3	ENST00000678569.1	755	758	+	3	0	0	10239
Q96D53-1#8	0	3	3	Q96D53-1	654	657	+	3	Q96D53-1	0	1632	ENST00000678467.1	117	1749	++	267	Q96D53-1#8	0	3	ENST00000678467.1	771	774	+	3	0	0	10240
Q96D53-1#8	0	3	3	Q96D53-1	654	657	+	3	Q96D53-1	0	1632	ENST00000678419.1	81	1713	++	266	Q96D53-1#8	0	3	ENST00000678419.1	735	738	+	3	0	0	10241
Q96D53-1#8	0	3	3	Q96D53-1	654	657	+	3	Q96D53-1	0	1632	ENST00000678404.1	295	1927	++	265	Q96D53-1#8	0	3	ENST00000678404.1	949	952	+	3	0	0	10242
Q96D53-1#8	0	3	3	Q96D53-1	654	657	+	3	Q96D53-1	327	1632	ENST00000677517.1	213	1518	+	260	Q96D53-1#8	0	3	ENST00000677517.1	540	543	+	3	0	0	10243
Q96D53-1#8	0	3	3	Q96D53-1	654	657	+	3	Q96D53-1	327	1632	ENST00000677496.1	217	1522	+	259	Q96D53-1#8	0	3	ENST00000677496.1	544	547	+	3	0	0	10244
Q96D53-1#8	0	3	3	Q96D53-1	654	657	+	3	Q96D53-1	0	1632	ENST00000677018.1	141	1773	++	258	Q96D53-1#8	0	3	ENST00000677018.1	795	798	+	3	0	0	10245
Q96D53-1#8	0	3	3	Q96D53-1	654	657	+	3	Q96D53-1	0	1143	ENST00000676555.1	101	1244	+	256	Q96D53-1#8	0	3	ENST00000676555.1	755	758	+	3	0	0	10246
Q96D53-1#8	0	3	3	Q96D53-1	654	657	+	3	Q96D53-1	0	1632	ENST00000601967.6	45	1677	++	226	Q96D53-1#8	0	3	ENST00000601967.6	699	702	+	3	0	0	10247
Q96D53-1#8	0	3	3	Q96D53-1	654	657	+	3	Q96D53-1	327	940	ENST00000595254.5	254	867	+	209	Q96D53-1#8	0	3	ENST00000595254.5	581	584	+	3	0	0	10248
Q96D53-1#8	0	3	3	Q96D53-1	654	657	+	3	Q96D53-1	0	1632	ENST00000594720.6	38	1670	++	206	Q96D53-1#8	0	3	ENST00000594720.6	692	695	+	3	0	0	10249
Q96D53-1#8	0	3	3	Q96D53-1	654	657	+	3	Q96D53-1	0	1632	ENST00000594490.6	29	1583	+	205	Q96D53-1#8	0	3	ENST00000594490.6	605	608	+	3	0	0	10250
Q96D53-1#8	0	3	3	Q96D53-1	654	657	+	3	Q96D53-1	0	1632	ENST00000324464.8	303	1935	++	26	Q96D53-1#8	0	3	ENST00000324464.8	957	960	+	3	0	0	10251
Q96D53-1#8	0	3	3	Q96D53-1	654	657	+	3	Q96D53-1	0	1632	ENST00000243583.10	24	1533	++	3	Q96D53-1#8	0	3	ENST00000243583.10	555	558	+	3	0	0	10252
Q96D53-1#9	0	3	3	Q96D53-1	708	711	+	3	Q96D53-1	0	1632	ENST00000679130.1	149	1781	++	271	Q96D53-1#9	0	3	ENST00000679130.1	857	860	+	3	0	0	10253
Q96D53-1#9	0	3	3	Q96D53-1	708	711	+	3	Q96D53-1	412	1632	ENST00000679012.1	561	1749	+	269	Q96D53-1#9	0	3	ENST00000679012.1	825	828	+	3	0	0	10254
Q96D53-1#9	0	3	3	Q96D53-1	708	711	+	3	Q96D53-1	0	1015	ENST00000678569.1	101	1112	+	268	Q96D53-1#9	0	3	ENST00000678569.1	809	812	+	3	0	0	10255
Q96D53-1#9	0	3	3	Q96D53-1	708	711	+	3	Q96D53-1	0	1632	ENST00000678467.1	117	1749	++	267	Q96D53-1#9	0	3	ENST00000678467.1	825	828	+	3	0	0	10256
Q96D53-1#9	0	3	3	Q96D53-1	708	711	+	3	Q96D53-1	0	1632	ENST00000678419.1	81	1713	++	266	Q96D53-1#9	0	3	ENST00000678419.1	789	792	+	3	0	0	10257
Q96D53-1#9	0	3	3	Q96D53-1	708	711	+	3	Q96D53-1	0	1632	ENST00000678404.1	295	1927	++	265	Q96D53-1#9	0	3	ENST00000678404.1	1003	1006	+	3	0	0	10258
Q96D53-1#9	0	3	3	Q96D53-1	708	711	+	3	Q96D53-1	327	1632	ENST00000677517.1	213	1518	+	260	Q96D53-1#9	0	3	ENST00000677517.1	594	597	+	3	0	0	10259
Q96D53-1#9	0	3	3	Q96D53-1	708	711	+	3	Q96D53-1	327	1632	ENST00000677496.1	217	1522	+	259	Q96D53-1#9	0	3	ENST00000677496.1	598	601	+	3	0	0	10260
Q96D53-1#9	0	3	3	Q96D53-1	708	711	+	3	Q96D53-1	0	1632	ENST00000677018.1	141	1773	++	258	Q96D53-1#9	0	3	ENST00000677018.1	849	852	+	3	0	0	10261
Q96D53-1#9	0	3	3	Q96D53-1	708	711	+	3	Q96D53-1	0	1143	ENST00000676555.1	101	1244	+	256	Q96D53-1#9	0	3	ENST00000676555.1	809	812	+	3	0	0	10262
Q96D53-1#9	0	3	3	Q96D53-1	708	711	+	3	Q96D53-1	0	1632	ENST00000601967.6	45	1677	++	226	Q96D53-1#9	0	3	ENST00000601967.6	753	756	+	3	0	0	10263
Q96D53-1#9	0	3	3	Q96D53-1	708	711	+	3	Q96D53-1	327	940	ENST00000595254.5	254	867	+	209	Q96D53-1#9	0	3	ENST00000595254.5	635	638	+	3	0	0	10264
Q96D53-1#9	0	3	3	Q96D53-1	708	711	+	3	Q96D53-1	0	1632	ENST00000594720.6	38	1670	++	206	Q96D53-1#9	0	3	ENST00000594720.6	746	749	+	3	0	0	10265
Q96D53-1#9	0	3	3	Q96D53-1	708	711	+	3	Q96D53-1	0	1632	ENST00000594490.6	29	1583	+	205	Q96D53-1#9	0	3	ENST00000594490.6	659	662	+	3	0	0	10266
Q96D53-1#9	0	3	3	Q96D53-1	708	711	+	3	Q96D53-1	0	1632	ENST00000324464.8	303	1935	++	26	Q96D53-1#9	0	3	ENST00000324464.8	1011	1014	+	3	0	0	10267
Q96D53-1#9	0	3	3	Q96D53-1	708	711	+	3	Q96D53-1	0	1632	ENST00000243583.10	24	1533	++	3	Q96D53-1#9	0	3	ENST00000243583.10	609	612	+	3	0	0	10268
Q96D53-1#10	0	12	12	Q96D53-1	969	981	+	12	Q96D53-1	0	1632	ENST00000679130.1	149	1781	++	271	Q96D53-1#10	0	12	ENST00000679130.1	1118	1130	+	12	0	0	10269
Q96D53-1#10	0	12	12	Q96D53-1	969	981	+	12	Q96D53-1	412	1632	ENST00000679012.1	561	1749	+	269	Q96D53-1#10	0	12	ENST00000679012.1	1086	1098	+	12	0	0	10270
Q96D53-1#10	0	12	12	Q96D53-1	969	981	+	12	Q96D53-1	0	1015	ENST00000678569.1	101	1112	+	268	Q96D53-1#10	0	12	ENST00000678569.1	1066	1078	+	12	0	0	10271
Q96D53-1#10	0	12	12	Q96D53-1	969	981	+	12	Q96D53-1	0	1632	ENST00000678467.1	117	1749	++	267	Q96D53-1#10	0	12	ENST00000678467.1	1086	1098	+	12	0	0	10272
Q96D53-1#10	0	12	12	Q96D53-1	969	981	+	12	Q96D53-1	0	1632	ENST00000678419.1	81	1713	++	266	Q96D53-1#10	0	12	ENST00000678419.1	1050	1062	+	12	0	0	10273
Q96D53-1#10	0	12	12	Q96D53-1	969	981	+	12	Q96D53-1	0	1632	ENST00000678404.1	295	1927	++	265	Q96D53-1#10	0	12	ENST00000678404.1	1264	1276	+	12	0	0	10274
Q96D53-1#10	0	12	12	Q96D53-1	969	981	+	12	Q96D53-1	327	1632	ENST00000677517.1	213	1518	+	260	Q96D53-1#10	0	12	ENST00000677517.1	855	867	+	12	0	0	10275
Q96D53-1#10	0	12	12	Q96D53-1	969	981	+	12	Q96D53-1	327	1632	ENST00000677496.1	217	1522	+	259	Q96D53-1#10	0	12	ENST00000677496.1	859	871	+	12	0	0	10276
Q96D53-1#10	0	12	12	Q96D53-1	969	981	+	12	Q96D53-1	0	1632	ENST00000677018.1	141	1773	++	258	Q96D53-1#10	0	12	ENST00000677018.1	1110	1122	+	12	0	0	10277
Q96D53-1#10	0	12	12	Q96D53-1	969	981	+	12	Q96D53-1	0	1143	ENST00000676555.1	101	1244	+	256	Q96D53-1#10	0	12	ENST00000676555.1	1070	1082	+	12	0	0	10278
Q96D53-1#10	0	12	12	Q96D53-1	969	981	+	12	Q96D53-1	0	1632	ENST00000601967.6	45	1677	++	226	Q96D53-1#10	0	12	ENST00000601967.6	1014	1026	+	12	0	0	10279
Q96D53-1#10	0	12	12	Q96D53-1	969	981	+	12	Q96D53-1	0	1632	ENST00000594720.6	38	1670	++	206	Q96D53-1#10	0	12	ENST00000594720.6	1007	1019	+	12	0	0	10280
Q96D53-1#10	0	12	12	Q96D53-1	969	981	+	12	Q96D53-1	0	1632	ENST00000594490.6	29	1583	+	205	Q96D53-1#10	0	12	ENST00000594490.6	920	932	+	12	0	0	10281
Q96D53-1#10	0	12	12	Q96D53-1	969	981	+	12	Q96D53-1	0	1632	ENST00000324464.8	303	1935	++	26	Q96D53-1#10	0	12	ENST00000324464.8	1272	1284	+	12	0	0	10282
Q96D53-1#10	0	12	12	Q96D53-1	969	981	+	12	Q96D53-1	0	1632	ENST00000243583.10	24	1533	++	3	Q96D53-1#10	0	12	ENST00000243583.10	870	882	+	12	0	0	10283
Q96D53-1#11	0	3	3	Q96D53-1	1113	1116	+	3	Q96D53-1	0	1632	ENST00000679130.1	149	1781	++	271	Q96D53-1#11	0	3	ENST00000679130.1	1262	1265	+	3	0	0	10284
Q96D53-1#11	0	3	3	Q96D53-1	1113	1116	+	3	Q96D53-1	412	1632	ENST00000679012.1	561	1749	+	269	Q96D53-1#11	0	3	ENST00000679012.1	1230	1233	+	3	0	0	10285
Q96D53-1#11	0	3	3	Q96D53-1	1113	1116	+	3	Q96D53-1	0	1632	ENST00000678467.1	117	1749	++	267	Q96D53-1#11	0	3	ENST00000678467.1	1230	1233	+	3	0	0	10286
Q96D53-1#11	0	3	3	Q96D53-1	1113	1116	+	3	Q96D53-1	0	1632	ENST00000678419.1	81	1713	++	266	Q96D53-1#11	0	3	ENST00000678419.1	1194	1197	+	3	0	0	10287
Q96D53-1#11	0	3	3	Q96D53-1	1113	1116	+	3	Q96D53-1	0	1632	ENST00000678404.1	295	1927	++	265	Q96D53-1#11	0	3	ENST00000678404.1	1408	1411	+	3	0	0	10288
Q96D53-1#11	0	3	3	Q96D53-1	1113	1116	+	3	Q96D53-1	327	1632	ENST00000677517.1	213	1518	+	260	Q96D53-1#11	0	3	ENST00000677517.1	999	1002	+	3	0	0	10289
Q96D53-1#11	0	3	3	Q96D53-1	1113	1116	+	3	Q96D53-1	327	1632	ENST00000677496.1	217	1522	+	259	Q96D53-1#11	0	3	ENST00000677496.1	1003	1006	+	3	0	0	10290
Q96D53-1#11	0	3	3	Q96D53-1	1113	1116	+	3	Q96D53-1	0	1632	ENST00000677018.1	141	1773	++	258	Q96D53-1#11	0	3	ENST00000677018.1	1254	1257	+	3	0	0	10291
Q96D53-1#11	0	3	3	Q96D53-1	1113	1116	+	3	Q96D53-1	0	1143	ENST00000676555.1	101	1244	+	256	Q96D53-1#11	0	3	ENST00000676555.1	1214	1217	+	3	0	0	10292
Q96D53-1#11	0	3	3	Q96D53-1	1113	1116	+	3	Q96D53-1	0	1632	ENST00000601967.6	45	1677	++	226	Q96D53-1#11	0	3	ENST00000601967.6	1158	1161	+	3	0	0	10293
Q96D53-1#11	0	3	3	Q96D53-1	1113	1116	+	3	Q96D53-1	0	1632	ENST00000594720.6	38	1670	++	206	Q96D53-1#11	0	3	ENST00000594720.6	1151	1154	+	3	0	0	10294
Q96D53-1#11	0	3	3	Q96D53-1	1113	1116	+	3	Q96D53-1	0	1632	ENST00000594490.6	29	1583	+	205	Q96D53-1#11	0	3	ENST00000594490.6	1064	1067	+	3	0	0	10295
Q96D53-1#11	0	3	3	Q96D53-1	1113	1116	+	3	Q96D53-1	0	1632	ENST00000324464.8	303	1935	++	26	Q96D53-1#11	0	3	ENST00000324464.8	1416	1419	+	3	0	0	10296
Q96D53-1#11	0	3	3	Q96D53-1	1113	1116	+	3	Q96D53-1	0	1632	ENST00000243583.10	24	1533	++	3	Q96D53-1#11	0	3	ENST00000243583.10	1014	1017	+	3	0	0	10297
Q96D53-1#12	0	3	3	Q96D53-1	1155	1158	+	3	Q96D53-1	0	1632	ENST00000679130.1	149	1781	++	271	Q96D53-1#12	0	3	ENST00000679130.1	1304	1307	+	3	0	0	10298
Q96D53-1#12	0	3	3	Q96D53-1	1155	1158	+	3	Q96D53-1	412	1632	ENST00000679012.1	561	1749	+	269	Q96D53-1#12	0	3	ENST00000679012.1	1272	1275	+	3	0	0	10299
Q96D53-1#12	0	3	3	Q96D53-1	1155	1158	+	3	Q96D53-1	0	1632	ENST00000678467.1	117	1749	++	267	Q96D53-1#12	0	3	ENST00000678467.1	1272	1275	+	3	0	0	10300
Q96D53-1#12	0	3	3	Q96D53-1	1155	1158	+	3	Q96D53-1	0	1632	ENST00000678419.1	81	1713	++	266	Q96D53-1#12	0	3	ENST00000678419.1	1236	1239	+	3	0	0	10301
Q96D53-1#12	0	3	3	Q96D53-1	1155	1158	+	3	Q96D53-1	0	1632	ENST00000678404.1	295	1927	++	265	Q96D53-1#12	0	3	ENST00000678404.1	1450	1453	+	3	0	0	10302
Q96D53-1#12	0	3	3	Q96D53-1	1155	1158	+	3	Q96D53-1	327	1632	ENST00000677517.1	213	1518	+	260	Q96D53-1#12	0	3	ENST00000677517.1	1041	1044	+	3	0	0	10303
Q96D53-1#12	0	3	3	Q96D53-1	1155	1158	+	3	Q96D53-1	327	1632	ENST00000677496.1	217	1522	+	259	Q96D53-1#12	0	3	ENST00000677496.1	1045	1048	+	3	0	0	10304
Q96D53-1#12	0	3	3	Q96D53-1	1155	1158	+	3	Q96D53-1	0	1632	ENST00000677018.1	141	1773	++	258	Q96D53-1#12	0	3	ENST00000677018.1	1296	1299	+	3	0	0	10305
Q96D53-1#12	0	3	3	Q96D53-1	1155	1158	+	3	Q96D53-1	0	1632	ENST00000601967.6	45	1677	++	226	Q96D53-1#12	0	3	ENST00000601967.6	1200	1203	+	3	0	0	10306
Q96D53-1#12	0	3	3	Q96D53-1	1155	1158	+	3	Q96D53-1	0	1632	ENST00000594720.6	38	1670	++	206	Q96D53-1#12	0	3	ENST00000594720.6	1193	1196	+	3	0	0	10307
Q96D53-1#12	0	3	3	Q96D53-1	1155	1158	+	3	Q96D53-1	0	1632	ENST00000594490.6	29	1583	+	205	Q96D53-1#12	0	3	ENST00000594490.6	1106	1109	+	3	0	0	10308
Q96D53-1#12	0	3	3	Q96D53-1	1155	1158	+	3	Q96D53-1	0	1632	ENST00000324464.8	303	1935	++	26	Q96D53-1#12	0	3	ENST00000324464.8	1458	1461	+	3	0	0	10309
Q96D53-1#12	0	3	3	Q96D53-1	1155	1158	+	3	Q96D53-1	0	1632	ENST00000243583.10	24	1533	++	3	Q96D53-1#12	0	3	ENST00000243583.10	1056	1059	+	3	0	0	10310
Q96D53-1#13	0	123	123	Q96D53-1	366	489	+	123	Q96D53-1	0	1632	ENST00000679130.1	149	1781	++	271	Q96D53-1#13	0	123	ENST00000679130.1	515	638	+	123	0	0	10311
Q96D53-1#13	0	123	123	Q96D53-1	366	489	+	123	Q96D53-1	327	577	ENST00000679070.1	229	472	+	270	Q96D53-1#13	0	123	ENST00000679070.1	268	391	+	123	0	0	10312
Q96D53-1#13	0	123	123	Q96D53-1	366	489	+	123	Q96D53-1	412	1632	ENST00000679012.1	561	1749	+	269	Q96D53-1#13	46	99	ENST00000679012.1	561	614	+	53	46	24	10313
Q96D53-1#13	0	123	123	Q96D53-1	366	489	+	123	Q96D53-1	0	1015	ENST00000678569.1	101	1112	+	268	Q96D53-1#13	0	123	ENST00000678569.1	467	590	+	123	0	0	10314
Q96D53-1#13	0	123	123	Q96D53-1	366	489	+	123	Q96D53-1	0	1632	ENST00000678467.1	117	1749	++	267	Q96D53-1#13	0	123	ENST00000678467.1	483	606	+	123	0	0	10315
Q96D53-1#13	0	123	123	Q96D53-1	366	489	+	123	Q96D53-1	0	1632	ENST00000678419.1	81	1713	++	266	Q96D53-1#13	0	123	ENST00000678419.1	447	570	+	123	0	0	10316
Q96D53-1#13	0	123	123	Q96D53-1	366	489	+	123	Q96D53-1	0	1632	ENST00000678404.1	295	1927	++	265	Q96D53-1#13	0	123	ENST00000678404.1	661	784	+	123	0	0	10317
Q96D53-1#13	0	123	123	Q96D53-1	366	489	+	123	Q96D53-1	0	577	ENST00000678316.1	139	691	+	264	Q96D53-1#13	0	99	ENST00000678316.1	505	604	+	99	0	24	10318
Q96D53-1#13	0	123	123	Q96D53-1	366	489	+	123	Q96D53-1	0	577	ENST00000677633.1	120	690	+	261	Q96D53-1#13	0	123	ENST00000677633.1	486	609	+	123	0	0	10319
Q96D53-1#13	0	123	123	Q96D53-1	366	489	+	123	Q96D53-1	327	1632	ENST00000677517.1	213	1518	+	260	Q96D53-1#13	0	123	ENST00000677517.1	252	375	+	123	0	0	10320
Q96D53-1#13	0	123	123	Q96D53-1	366	489	+	123	Q96D53-1	327	1632	ENST00000677496.1	217	1522	+	259	Q96D53-1#13	0	123	ENST00000677496.1	256	379	+	123	0	0	10321
Q96D53-1#13	0	123	123	Q96D53-1	366	489	+	123	Q96D53-1	0	1632	ENST00000677018.1	141	1773	++	258	Q96D53-1#13	0	123	ENST00000677018.1	507	630	+	123	0	0	10322
Q96D53-1#13	0	123	123	Q96D53-1	366	489	+	123	Q96D53-1	0	1143	ENST00000676555.1	101	1244	+	256	Q96D53-1#13	0	123	ENST00000676555.1	467	590	+	123	0	0	10323
Q96D53-1#13	0	123	123	Q96D53-1	366	489	+	123	Q96D53-1	0	1632	ENST00000601967.6	45	1677	++	226	Q96D53-1#13	0	123	ENST00000601967.6	411	534	+	123	0	0	10324
Q96D53-1#13	0	123	123	Q96D53-1	366	489	+	123	Q96D53-1	327	554	ENST00000600080.5	253	473	+	218	Q96D53-1#13	0	123	ENST00000600080.5	292	415	+	123	0	0	10325
Q96D53-1#13	0	123	123	Q96D53-1	366	489	+	123	Q96D53-1	327	940	ENST00000595254.5	254	867	+	209	Q96D53-1#13	0	123	ENST00000595254.5	293	416	+	123	0	0	10326
Q96D53-1#13	0	123	123	Q96D53-1	366	489	+	123	Q96D53-1	0	1632	ENST00000594720.6	38	1670	++	206	Q96D53-1#13	0	123	ENST00000594720.6	404	527	+	123	0	0	10327
Q96D53-1#13	0	123	123	Q96D53-1	366	489	+	123	Q96D53-1	0	1632	ENST00000594490.6	29	1583	+	205	Q96D53-1#13	1	123	ENST00000594490.6	318	440	+	122	1	0	10328
Q96D53-1#13	0	123	123	Q96D53-1	366	489	+	123	Q96D53-1	0	473	ENST00000594084.5	121	594	+	204	Q96D53-1#13	0	107	ENST00000594084.5	487	594	+	107	0	16	10329
Q96D53-1#13	0	123	123	Q96D53-1	366	489	+	123	Q96D53-1	0	1632	ENST00000324464.8	303	1935	++	26	Q96D53-1#13	0	123	ENST00000324464.8	669	792	+	123	0	0	10330
Q96D53-1#14	0	3	3	Q96D53-1	231	234	+	3	Q96D53-1	0	1632	ENST00000679130.1	149	1781	++	271	Q96D53-1#14	0	3	ENST00000679130.1	380	383	+	3	0	0	10331
Q96D53-1#14	0	3	3	Q96D53-1	231	234	+	3	Q96D53-1	0	1015	ENST00000678569.1	101	1112	+	268	Q96D53-1#14	0	3	ENST00000678569.1	332	335	+	3	0	0	10332
Q96D53-1#14	0	3	3	Q96D53-1	231	234	+	3	Q96D53-1	0	1632	ENST00000678467.1	117	1749	++	267	Q96D53-1#14	0	3	ENST00000678467.1	348	351	+	3	0	0	10333
Q96D53-1#14	0	3	3	Q96D53-1	231	234	+	3	Q96D53-1	0	1632	ENST00000678419.1	81	1713	++	266	Q96D53-1#14	0	3	ENST00000678419.1	312	315	+	3	0	0	10334
Q96D53-1#14	0	3	3	Q96D53-1	231	234	+	3	Q96D53-1	0	1632	ENST00000678404.1	295	1927	++	265	Q96D53-1#14	0	3	ENST00000678404.1	526	529	+	3	0	0	10335
Q96D53-1#14	0	3	3	Q96D53-1	231	234	+	3	Q96D53-1	0	577	ENST00000678316.1	139	691	+	264	Q96D53-1#14	0	3	ENST00000678316.1	370	373	+	3	0	0	10336
Q96D53-1#14	0	3	3	Q96D53-1	231	234	+	3	Q96D53-1	0	490	ENST00000677800.1	25	392	+	262	Q96D53-1#14	0	3	ENST00000677800.1	256	259	+	3	0	0	10337
Q96D53-1#14	0	3	3	Q96D53-1	231	234	+	3	Q96D53-1	0	577	ENST00000677633.1	120	690	+	261	Q96D53-1#14	0	3	ENST00000677633.1	351	354	+	3	0	0	10338
Q96D53-1#14	0	3	3	Q96D53-1	231	234	+	3	Q96D53-1	0	1632	ENST00000677018.1	141	1773	++	258	Q96D53-1#14	0	3	ENST00000677018.1	372	375	+	3	0	0	10339
Q96D53-1#14	0	3	3	Q96D53-1	231	234	+	3	Q96D53-1	0	1143	ENST00000676555.1	101	1244	+	256	Q96D53-1#14	0	3	ENST00000676555.1	332	335	+	3	0	0	10340
Q96D53-1#14	0	3	3	Q96D53-1	231	234	+	3	Q96D53-1	0	1632	ENST00000601967.6	45	1677	++	226	Q96D53-1#14	0	3	ENST00000601967.6	276	279	+	3	0	0	10341
Q96D53-1#14	0	3	3	Q96D53-1	231	234	+	3	Q96D53-1	0	364	ENST00000600707.5	30	394	+	219	Q96D53-1#14	0	3	ENST00000600707.5	261	264	+	3	0	0	10342
Q96D53-1#14	0	3	3	Q96D53-1	231	234	+	3	Q96D53-1	0	730	ENST00000599643.5	52	400	+	216	Q96D53-1#14	0	3	ENST00000599643.5	283	286	+	3	0	0	10343
Q96D53-1#14	0	3	3	Q96D53-1	231	234	+	3	Q96D53-1	0	331	ENST00000596357.1	42	373	+	212	Q96D53-1#14	0	3	ENST00000596357.1	273	276	+	3	0	0	10344
Q96D53-1#14	0	3	3	Q96D53-1	231	234	+	3	Q96D53-1	0	1632	ENST00000594720.6	38	1670	++	206	Q96D53-1#14	0	3	ENST00000594720.6	269	272	+	3	0	0	10345
Q96D53-1#14	0	3	3	Q96D53-1	231	234	+	3	Q96D53-1	0	1632	ENST00000594490.6	29	1583	+	205	Q96D53-1#14	0	3	ENST00000594490.6	260	263	+	3	0	0	10346
Q96D53-1#14	0	3	3	Q96D53-1	231	234	+	3	Q96D53-1	0	473	ENST00000594084.5	121	594	+	204	Q96D53-1#14	0	3	ENST00000594084.5	352	355	+	3	0	0	10347
Q96D53-1#14	0	3	3	Q96D53-1	231	234	+	3	Q96D53-1	0	1632	ENST00000324464.8	303	1935	++	26	Q96D53-1#14	0	3	ENST00000324464.8	534	537	+	3	0	0	10348
Q96D53-1#14	0	3	3	Q96D53-1	231	234	+	3	Q96D53-1	0	1632	ENST00000243583.10	24	1533	++	3	Q96D53-1#14	0	3	ENST00000243583.10	255	258	+	3	0	0	10349
Q96D53-1#15	0	3	3	Q96D53-1	291	294	+	3	Q96D53-1	0	313	ENST00000679315.1	109	355	+	272	Q96D53-1#15	0	3	ENST00000679315.1	333	336	+	3	0	0	10350
Q96D53-1#15	0	3	3	Q96D53-1	291	294	+	3	Q96D53-1	0	1632	ENST00000679130.1	149	1781	++	271	Q96D53-1#15	0	3	ENST00000679130.1	440	443	+	3	0	0	10351
Q96D53-1#15	0	3	3	Q96D53-1	291	294	+	3	Q96D53-1	0	1015	ENST00000678569.1	101	1112	+	268	Q96D53-1#15	0	3	ENST00000678569.1	392	395	+	3	0	0	10352
Q96D53-1#15	0	3	3	Q96D53-1	291	294	+	3	Q96D53-1	0	1632	ENST00000678467.1	117	1749	++	267	Q96D53-1#15	0	3	ENST00000678467.1	408	411	+	3	0	0	10353
Q96D53-1#15	0	3	3	Q96D53-1	291	294	+	3	Q96D53-1	0	1632	ENST00000678419.1	81	1713	++	266	Q96D53-1#15	0	3	ENST00000678419.1	372	375	+	3	0	0	10354
Q96D53-1#15	0	3	3	Q96D53-1	291	294	+	3	Q96D53-1	0	1632	ENST00000678404.1	295	1927	++	265	Q96D53-1#15	0	3	ENST00000678404.1	586	589	+	3	0	0	10355
Q96D53-1#15	0	3	3	Q96D53-1	291	294	+	3	Q96D53-1	0	577	ENST00000678316.1	139	691	+	264	Q96D53-1#15	0	3	ENST00000678316.1	430	433	+	3	0	0	10356
Q96D53-1#15	0	3	3	Q96D53-1	291	294	+	3	Q96D53-1	0	313	ENST00000678057.1	205	451	+	263	Q96D53-1#15	0	3	ENST00000678057.1	429	432	+	3	0	0	10357
Q96D53-1#15	0	3	3	Q96D53-1	291	294	+	3	Q96D53-1	0	490	ENST00000677800.1	25	392	+	262	Q96D53-1#15	0	3	ENST00000677800.1	316	319	+	3	0	0	10358
Q96D53-1#15	0	3	3	Q96D53-1	291	294	+	3	Q96D53-1	0	577	ENST00000677633.1	120	690	+	261	Q96D53-1#15	0	3	ENST00000677633.1	411	414	+	3	0	0	10359
Q96D53-1#15	0	3	3	Q96D53-1	291	294	+	3	Q96D53-1	0	1632	ENST00000677018.1	141	1773	++	258	Q96D53-1#15	0	3	ENST00000677018.1	432	435	+	3	0	0	10360
Q96D53-1#15	0	3	3	Q96D53-1	291	294	+	3	Q96D53-1	0	1143	ENST00000676555.1	101	1244	+	256	Q96D53-1#15	0	3	ENST00000676555.1	392	395	+	3	0	0	10361
Q96D53-1#15	0	3	3	Q96D53-1	291	294	+	3	Q96D53-1	0	1632	ENST00000601967.6	45	1677	++	226	Q96D53-1#15	0	3	ENST00000601967.6	336	339	+	3	0	0	10362
Q96D53-1#15	0	3	3	Q96D53-1	291	294	+	3	Q96D53-1	0	364	ENST00000600707.5	30	394	+	219	Q96D53-1#15	0	3	ENST00000600707.5	321	324	+	3	0	0	10363
Q96D53-1#15	0	3	3	Q96D53-1	291	294	+	3	Q96D53-1	0	331	ENST00000596357.1	42	373	+	212	Q96D53-1#15	0	3	ENST00000596357.1	333	336	+	3	0	0	10364
Q96D53-1#15	0	3	3	Q96D53-1	291	294	+	3	Q96D53-1	0	1632	ENST00000594720.6	38	1670	++	206	Q96D53-1#15	0	3	ENST00000594720.6	329	332	+	3	0	0	10365
Q96D53-1#15	0	3	3	Q96D53-1	291	294	+	3	Q96D53-1	0	473	ENST00000594084.5	121	594	+	204	Q96D53-1#15	0	3	ENST00000594084.5	412	415	+	3	0	0	10366
Q96D53-1#15	0	3	3	Q96D53-1	291	294	+	3	Q96D53-1	0	1632	ENST00000324464.8	303	1935	++	26	Q96D53-1#15	0	3	ENST00000324464.8	594	597	+	3	0	0	10367
Q96D53-1#15	0	3	3	Q96D53-1	291	294	+	3	Q96D53-1	0	1632	ENST00000243583.10	24	1533	++	3	Q96D53-1#15	0	3	ENST00000243583.10	315	318	+	3	0	0	10368
Q96D53-1#16	0	3	3	Q96D53-1	519	522	+	3	Q96D53-1	0	1632	ENST00000679130.1	149	1781	++	271	Q96D53-1#16	0	3	ENST00000679130.1	668	671	+	3	0	0	10369
Q96D53-1#16	0	3	3	Q96D53-1	519	522	+	3	Q96D53-1	327	577	ENST00000679070.1	229	472	+	270	Q96D53-1#16	0	3	ENST00000679070.1	414	417	+	3	0	0	10370
Q96D53-1#16	0	3	3	Q96D53-1	519	522	+	3	Q96D53-1	412	1632	ENST00000679012.1	561	1749	+	269	Q96D53-1#16	0	3	ENST00000679012.1	636	639	+	3	0	0	10371
Q96D53-1#16	0	3	3	Q96D53-1	519	522	+	3	Q96D53-1	0	1015	ENST00000678569.1	101	1112	+	268	Q96D53-1#16	0	3	ENST00000678569.1	620	623	+	3	0	0	10372
Q96D53-1#16	0	3	3	Q96D53-1	519	522	+	3	Q96D53-1	0	1632	ENST00000678467.1	117	1749	++	267	Q96D53-1#16	0	3	ENST00000678467.1	636	639	+	3	0	0	10373
Q96D53-1#16	0	3	3	Q96D53-1	519	522	+	3	Q96D53-1	0	1632	ENST00000678419.1	81	1713	++	266	Q96D53-1#16	0	3	ENST00000678419.1	600	603	+	3	0	0	10374
Q96D53-1#16	0	3	3	Q96D53-1	519	522	+	3	Q96D53-1	0	1632	ENST00000678404.1	295	1927	++	265	Q96D53-1#16	0	3	ENST00000678404.1	814	817	+	3	0	0	10375
Q96D53-1#16	0	3	3	Q96D53-1	519	522	+	3	Q96D53-1	0	577	ENST00000678316.1	139	691	+	264	Q96D53-1#16	0	3	ENST00000678316.1	633	636	+	3	0	0	10376
Q96D53-1#16	0	3	3	Q96D53-1	519	522	+	3	Q96D53-1	0	577	ENST00000677633.1	120	690	+	261	Q96D53-1#16	0	3	ENST00000677633.1	632	635	+	3	0	0	10377
Q96D53-1#16	0	3	3	Q96D53-1	519	522	+	3	Q96D53-1	327	1632	ENST00000677517.1	213	1518	+	260	Q96D53-1#16	0	3	ENST00000677517.1	405	408	+	3	0	0	10378
Q96D53-1#16	0	3	3	Q96D53-1	519	522	+	3	Q96D53-1	327	1632	ENST00000677496.1	217	1522	+	259	Q96D53-1#16	0	3	ENST00000677496.1	409	412	+	3	0	0	10379
Q96D53-1#16	0	3	3	Q96D53-1	519	522	+	3	Q96D53-1	0	1632	ENST00000677018.1	141	1773	++	258	Q96D53-1#16	0	3	ENST00000677018.1	660	663	+	3	0	0	10380
Q96D53-1#16	0	3	3	Q96D53-1	519	522	+	3	Q96D53-1	0	1143	ENST00000676555.1	101	1244	+	256	Q96D53-1#16	0	3	ENST00000676555.1	620	623	+	3	0	0	10381
Q96D53-1#16	0	3	3	Q96D53-1	519	522	+	3	Q96D53-1	0	1632	ENST00000601967.6	45	1677	++	226	Q96D53-1#16	0	3	ENST00000601967.6	564	567	+	3	0	0	10382
Q96D53-1#16	0	3	3	Q96D53-1	519	522	+	3	Q96D53-1	327	554	ENST00000600080.5	253	473	+	218	Q96D53-1#16	0	3	ENST00000600080.5	438	441	+	3	0	0	10383
Q96D53-1#16	0	3	3	Q96D53-1	519	522	+	3	Q96D53-1	0	730	ENST00000599643.5	52	400	+	216	Q96D53-1#16	0	3	ENST00000599643.5	330	333	+	3	0	0	10384
Q96D53-1#16	0	3	3	Q96D53-1	519	522	+	3	Q96D53-1	327	940	ENST00000595254.5	254	867	+	209	Q96D53-1#16	0	3	ENST00000595254.5	446	449	+	3	0	0	10385
Q96D53-1#16	0	3	3	Q96D53-1	519	522	+	3	Q96D53-1	0	1632	ENST00000594720.6	38	1670	++	206	Q96D53-1#16	0	3	ENST00000594720.6	557	560	+	3	0	0	10386
Q96D53-1#16	0	3	3	Q96D53-1	519	522	+	3	Q96D53-1	0	1632	ENST00000594490.6	29	1583	+	205	Q96D53-1#16	0	3	ENST00000594490.6	470	473	+	3	0	0	10387
Q96D53-1#16	0	3	3	Q96D53-1	519	522	+	3	Q96D53-1	0	1632	ENST00000324464.8	303	1935	++	26	Q96D53-1#16	0	3	ENST00000324464.8	822	825	+	3	0	0	10388
Q96D53-1#16	0	3	3	Q96D53-1	519	522	+	3	Q96D53-1	0	1632	ENST00000243583.10	24	1533	++	3	Q96D53-1#16	0	3	ENST00000243583.10	420	423	+	3	0	0	10389
Q96D53-1#17	0	3	3	Q96D53-1	531	534	+	3	Q96D53-1	0	1632	ENST00000679130.1	149	1781	++	271	Q96D53-1#17	0	3	ENST00000679130.1	680	683	+	3	0	0	10390
Q96D53-1#17	0	3	3	Q96D53-1	531	534	+	3	Q96D53-1	327	577	ENST00000679070.1	229	472	+	270	Q96D53-1#17	0	3	ENST00000679070.1	426	429	+	3	0	0	10391
Q96D53-1#17	0	3	3	Q96D53-1	531	534	+	3	Q96D53-1	412	1632	ENST00000679012.1	561	1749	+	269	Q96D53-1#17	0	3	ENST00000679012.1	648	651	+	3	0	0	10392
Q96D53-1#17	0	3	3	Q96D53-1	531	534	+	3	Q96D53-1	0	1015	ENST00000678569.1	101	1112	+	268	Q96D53-1#17	0	3	ENST00000678569.1	632	635	+	3	0	0	10393
Q96D53-1#17	0	3	3	Q96D53-1	531	534	+	3	Q96D53-1	0	1632	ENST00000678467.1	117	1749	++	267	Q96D53-1#17	0	3	ENST00000678467.1	648	651	+	3	0	0	10394
Q96D53-1#17	0	3	3	Q96D53-1	531	534	+	3	Q96D53-1	0	1632	ENST00000678419.1	81	1713	++	266	Q96D53-1#17	0	3	ENST00000678419.1	612	615	+	3	0	0	10395
Q96D53-1#17	0	3	3	Q96D53-1	531	534	+	3	Q96D53-1	0	1632	ENST00000678404.1	295	1927	++	265	Q96D53-1#17	0	3	ENST00000678404.1	826	829	+	3	0	0	10396
Q96D53-1#17	0	3	3	Q96D53-1	531	534	+	3	Q96D53-1	0	577	ENST00000678316.1	139	691	+	264	Q96D53-1#17	0	3	ENST00000678316.1	645	648	+	3	0	0	10397
Q96D53-1#17	0	3	3	Q96D53-1	531	534	+	3	Q96D53-1	0	577	ENST00000677633.1	120	690	+	261	Q96D53-1#17	0	3	ENST00000677633.1	644	647	+	3	0	0	10398
Q96D53-1#17	0	3	3	Q96D53-1	531	534	+	3	Q96D53-1	327	1632	ENST00000677517.1	213	1518	+	260	Q96D53-1#17	0	3	ENST00000677517.1	417	420	+	3	0	0	10399
Q96D53-1#17	0	3	3	Q96D53-1	531	534	+	3	Q96D53-1	327	1632	ENST00000677496.1	217	1522	+	259	Q96D53-1#17	0	3	ENST00000677496.1	421	424	+	3	0	0	10400
Q96D53-1#17	0	3	3	Q96D53-1	531	534	+	3	Q96D53-1	0	1632	ENST00000677018.1	141	1773	++	258	Q96D53-1#17	0	3	ENST00000677018.1	672	675	+	3	0	0	10401
Q96D53-1#17	0	3	3	Q96D53-1	531	534	+	3	Q96D53-1	0	1143	ENST00000676555.1	101	1244	+	256	Q96D53-1#17	0	3	ENST00000676555.1	632	635	+	3	0	0	10402
Q96D53-1#17	0	3	3	Q96D53-1	531	534	+	3	Q96D53-1	0	1632	ENST00000601967.6	45	1677	++	226	Q96D53-1#17	0	3	ENST00000601967.6	576	579	+	3	0	0	10403
Q96D53-1#17	0	3	3	Q96D53-1	531	534	+	3	Q96D53-1	327	554	ENST00000600080.5	253	473	+	218	Q96D53-1#17	0	3	ENST00000600080.5	450	453	+	3	0	0	10404
Q96D53-1#17	0	3	3	Q96D53-1	531	534	+	3	Q96D53-1	0	730	ENST00000599643.5	52	400	+	216	Q96D53-1#17	0	3	ENST00000599643.5	342	345	+	3	0	0	10405
Q96D53-1#17	0	3	3	Q96D53-1	531	534	+	3	Q96D53-1	327	940	ENST00000595254.5	254	867	+	209	Q96D53-1#17	0	3	ENST00000595254.5	458	461	+	3	0	0	10406
Q96D53-1#17	0	3	3	Q96D53-1	531	534	+	3	Q96D53-1	0	1632	ENST00000594720.6	38	1670	++	206	Q96D53-1#17	0	3	ENST00000594720.6	569	572	+	3	0	0	10407
Q96D53-1#17	0	3	3	Q96D53-1	531	534	+	3	Q96D53-1	0	1632	ENST00000594490.6	29	1583	+	205	Q96D53-1#17	0	3	ENST00000594490.6	482	485	+	3	0	0	10408
Q96D53-1#17	0	3	3	Q96D53-1	531	534	+	3	Q96D53-1	0	1632	ENST00000324464.8	303	1935	++	26	Q96D53-1#17	0	3	ENST00000324464.8	834	837	+	3	0	0	10409
Q96D53-1#17	0	3	3	Q96D53-1	531	534	+	3	Q96D53-1	0	1632	ENST00000243583.10	24	1533	++	3	Q96D53-1#17	0	3	ENST00000243583.10	432	435	+	3	0	0	10410
Q96D53-1#18	0	3	3	Q96D53-1	855	858	+	3	Q96D53-1	0	1632	ENST00000679130.1	149	1781	++	271	Q96D53-1#18	0	3	ENST00000679130.1	1004	1007	+	3	0	0	10411
Q96D53-1#18	0	3	3	Q96D53-1	855	858	+	3	Q96D53-1	412	1632	ENST00000679012.1	561	1749	+	269	Q96D53-1#18	0	3	ENST00000679012.1	972	975	+	3	0	0	10412
Q96D53-1#18	0	3	3	Q96D53-1	855	858	+	3	Q96D53-1	0	1015	ENST00000678569.1	101	1112	+	268	Q96D53-1#18	0	3	ENST00000678569.1	956	959	+	3	0	0	10413
Q96D53-1#18	0	3	3	Q96D53-1	855	858	+	3	Q96D53-1	0	1632	ENST00000678467.1	117	1749	++	267	Q96D53-1#18	0	3	ENST00000678467.1	972	975	+	3	0	0	10414
Q96D53-1#18	0	3	3	Q96D53-1	855	858	+	3	Q96D53-1	0	1632	ENST00000678419.1	81	1713	++	266	Q96D53-1#18	0	3	ENST00000678419.1	936	939	+	3	0	0	10415
Q96D53-1#18	0	3	3	Q96D53-1	855	858	+	3	Q96D53-1	0	1632	ENST00000678404.1	295	1927	++	265	Q96D53-1#18	0	3	ENST00000678404.1	1150	1153	+	3	0	0	10416
Q96D53-1#18	0	3	3	Q96D53-1	855	858	+	3	Q96D53-1	327	1632	ENST00000677517.1	213	1518	+	260	Q96D53-1#18	0	3	ENST00000677517.1	741	744	+	3	0	0	10417
Q96D53-1#18	0	3	3	Q96D53-1	855	858	+	3	Q96D53-1	327	1632	ENST00000677496.1	217	1522	+	259	Q96D53-1#18	0	3	ENST00000677496.1	745	748	+	3	0	0	10418
Q96D53-1#18	0	3	3	Q96D53-1	855	858	+	3	Q96D53-1	0	1632	ENST00000677018.1	141	1773	++	258	Q96D53-1#18	0	3	ENST00000677018.1	996	999	+	3	0	0	10419
Q96D53-1#18	0	3	3	Q96D53-1	855	858	+	3	Q96D53-1	0	1143	ENST00000676555.1	101	1244	+	256	Q96D53-1#18	0	3	ENST00000676555.1	956	959	+	3	0	0	10420
Q96D53-1#18	0	3	3	Q96D53-1	855	858	+	3	Q96D53-1	0	1632	ENST00000601967.6	45	1677	++	226	Q96D53-1#18	0	3	ENST00000601967.6	900	903	+	3	0	0	10421
Q96D53-1#18	0	3	3	Q96D53-1	855	858	+	3	Q96D53-1	327	940	ENST00000595254.5	254	867	+	209	Q96D53-1#18	0	3	ENST00000595254.5	782	785	+	3	0	0	10422
Q96D53-1#18	0	3	3	Q96D53-1	855	858	+	3	Q96D53-1	0	1632	ENST00000594720.6	38	1670	++	206	Q96D53-1#18	0	3	ENST00000594720.6	893	896	+	3	0	0	10423
Q96D53-1#18	0	3	3	Q96D53-1	855	858	+	3	Q96D53-1	0	1632	ENST00000594490.6	29	1583	+	205	Q96D53-1#18	0	3	ENST00000594490.6	806	809	+	3	0	0	10424
Q96D53-1#18	0	3	3	Q96D53-1	855	858	+	3	Q96D53-1	0	1632	ENST00000324464.8	303	1935	++	26	Q96D53-1#18	0	3	ENST00000324464.8	1158	1161	+	3	0	0	10425
Q96D53-1#18	0	3	3	Q96D53-1	855	858	+	3	Q96D53-1	0	1632	ENST00000243583.10	24	1533	++	3	Q96D53-1#18	0	3	ENST00000243583.10	756	759	+	3	0	0	10426
Q96D53-1#19	0	3	3	Q96D53-1	927	930	+	3	Q96D53-1	0	1632	ENST00000679130.1	149	1781	++	271	Q96D53-1#19	0	3	ENST00000679130.1	1076	1079	+	3	0	0	10427
Q96D53-1#19	0	3	3	Q96D53-1	927	930	+	3	Q96D53-1	412	1632	ENST00000679012.1	561	1749	+	269	Q96D53-1#19	0	3	ENST00000679012.1	1044	1047	+	3	0	0	10428
Q96D53-1#19	0	3	3	Q96D53-1	927	930	+	3	Q96D53-1	0	1015	ENST00000678569.1	101	1112	+	268	Q96D53-1#19	0	3	ENST00000678569.1	1024	1027	+	3	0	0	10429
Q96D53-1#19	0	3	3	Q96D53-1	927	930	+	3	Q96D53-1	0	1632	ENST00000678467.1	117	1749	++	267	Q96D53-1#19	0	3	ENST00000678467.1	1044	1047	+	3	0	0	10430
Q96D53-1#19	0	3	3	Q96D53-1	927	930	+	3	Q96D53-1	0	1632	ENST00000678419.1	81	1713	++	266	Q96D53-1#19	0	3	ENST00000678419.1	1008	1011	+	3	0	0	10431
Q96D53-1#19	0	3	3	Q96D53-1	927	930	+	3	Q96D53-1	0	1632	ENST00000678404.1	295	1927	++	265	Q96D53-1#19	0	3	ENST00000678404.1	1222	1225	+	3	0	0	10432
Q96D53-1#19	0	3	3	Q96D53-1	927	930	+	3	Q96D53-1	327	1632	ENST00000677517.1	213	1518	+	260	Q96D53-1#19	0	3	ENST00000677517.1	813	816	+	3	0	0	10433
Q96D53-1#19	0	3	3	Q96D53-1	927	930	+	3	Q96D53-1	327	1632	ENST00000677496.1	217	1522	+	259	Q96D53-1#19	0	3	ENST00000677496.1	817	820	+	3	0	0	10434
Q96D53-1#19	0	3	3	Q96D53-1	927	930	+	3	Q96D53-1	0	1632	ENST00000677018.1	141	1773	++	258	Q96D53-1#19	0	3	ENST00000677018.1	1068	1071	+	3	0	0	10435
Q96D53-1#19	0	3	3	Q96D53-1	927	930	+	3	Q96D53-1	0	1143	ENST00000676555.1	101	1244	+	256	Q96D53-1#19	0	3	ENST00000676555.1	1028	1031	+	3	0	0	10436
Q96D53-1#19	0	3	3	Q96D53-1	927	930	+	3	Q96D53-1	0	1632	ENST00000601967.6	45	1677	++	226	Q96D53-1#19	0	3	ENST00000601967.6	972	975	+	3	0	0	10437
Q96D53-1#19	0	3	3	Q96D53-1	927	930	+	3	Q96D53-1	327	940	ENST00000595254.5	254	867	+	209	Q96D53-1#19	0	3	ENST00000595254.5	854	857	+	3	0	0	10438
Q96D53-1#19	0	3	3	Q96D53-1	927	930	+	3	Q96D53-1	0	1632	ENST00000594720.6	38	1670	++	206	Q96D53-1#19	0	3	ENST00000594720.6	965	968	+	3	0	0	10439
Q96D53-1#19	0	3	3	Q96D53-1	927	930	+	3	Q96D53-1	0	1632	ENST00000594490.6	29	1583	+	205	Q96D53-1#19	0	3	ENST00000594490.6	878	881	+	3	0	0	10440
Q96D53-1#19	0	3	3	Q96D53-1	927	930	+	3	Q96D53-1	0	1632	ENST00000324464.8	303	1935	++	26	Q96D53-1#19	0	3	ENST00000324464.8	1230	1233	+	3	0	0	10441
Q96D53-1#19	0	3	3	Q96D53-1	927	930	+	3	Q96D53-1	0	1632	ENST00000243583.10	24	1533	++	3	Q96D53-1#19	0	3	ENST00000243583.10	828	831	+	3	0	0	10442
Q96D53-1#20	0	3	3	Q96D53-1	951	954	+	3	Q96D53-1	0	1632	ENST00000679130.1	149	1781	++	271	Q96D53-1#20	0	3	ENST00000679130.1	1100	1103	+	3	0	0	10443
Q96D53-1#20	0	3	3	Q96D53-1	951	954	+	3	Q96D53-1	412	1632	ENST00000679012.1	561	1749	+	269	Q96D53-1#20	0	3	ENST00000679012.1	1068	1071	+	3	0	0	10444
Q96D53-1#20	0	3	3	Q96D53-1	951	954	+	3	Q96D53-1	0	1015	ENST00000678569.1	101	1112	+	268	Q96D53-1#20	0	3	ENST00000678569.1	1048	1051	+	3	0	0	10445
Q96D53-1#20	0	3	3	Q96D53-1	951	954	+	3	Q96D53-1	0	1632	ENST00000678467.1	117	1749	++	267	Q96D53-1#20	0	3	ENST00000678467.1	1068	1071	+	3	0	0	10446
Q96D53-1#20	0	3	3	Q96D53-1	951	954	+	3	Q96D53-1	0	1632	ENST00000678419.1	81	1713	++	266	Q96D53-1#20	0	3	ENST00000678419.1	1032	1035	+	3	0	0	10447
Q96D53-1#20	0	3	3	Q96D53-1	951	954	+	3	Q96D53-1	0	1632	ENST00000678404.1	295	1927	++	265	Q96D53-1#20	0	3	ENST00000678404.1	1246	1249	+	3	0	0	10448
Q96D53-1#20	0	3	3	Q96D53-1	951	954	+	3	Q96D53-1	327	1632	ENST00000677517.1	213	1518	+	260	Q96D53-1#20	0	3	ENST00000677517.1	837	840	+	3	0	0	10449
Q96D53-1#20	0	3	3	Q96D53-1	951	954	+	3	Q96D53-1	327	1632	ENST00000677496.1	217	1522	+	259	Q96D53-1#20	0	3	ENST00000677496.1	841	844	+	3	0	0	10450
Q96D53-1#20	0	3	3	Q96D53-1	951	954	+	3	Q96D53-1	0	1632	ENST00000677018.1	141	1773	++	258	Q96D53-1#20	0	3	ENST00000677018.1	1092	1095	+	3	0	0	10451
Q96D53-1#20	0	3	3	Q96D53-1	951	954	+	3	Q96D53-1	0	1143	ENST00000676555.1	101	1244	+	256	Q96D53-1#20	0	3	ENST00000676555.1	1052	1055	+	3	0	0	10452
Q96D53-1#20	0	3	3	Q96D53-1	951	954	+	3	Q96D53-1	0	1632	ENST00000601967.6	45	1677	++	226	Q96D53-1#20	0	3	ENST00000601967.6	996	999	+	3	0	0	10453
Q96D53-1#20	0	3	3	Q96D53-1	951	954	+	3	Q96D53-1	0	1632	ENST00000594720.6	38	1670	++	206	Q96D53-1#20	0	3	ENST00000594720.6	989	992	+	3	0	0	10454
Q96D53-1#20	0	3	3	Q96D53-1	951	954	+	3	Q96D53-1	0	1632	ENST00000594490.6	29	1583	+	205	Q96D53-1#20	0	3	ENST00000594490.6	902	905	+	3	0	0	10455
Q96D53-1#20	0	3	3	Q96D53-1	951	954	+	3	Q96D53-1	0	1632	ENST00000324464.8	303	1935	++	26	Q96D53-1#20	0	3	ENST00000324464.8	1254	1257	+	3	0	0	10456
Q96D53-1#20	0	3	3	Q96D53-1	951	954	+	3	Q96D53-1	0	1632	ENST00000243583.10	24	1533	++	3	Q96D53-1#20	0	3	ENST00000243583.10	852	855	+	3	0	0	10457
Q96D53-1#21	0	3	3	Q96D53-1	957	960	+	3	Q96D53-1	0	1632	ENST00000679130.1	149	1781	++	271	Q96D53-1#21	0	3	ENST00000679130.1	1106	1109	+	3	0	0	10458
Q96D53-1#21	0	3	3	Q96D53-1	957	960	+	3	Q96D53-1	412	1632	ENST00000679012.1	561	1749	+	269	Q96D53-1#21	0	3	ENST00000679012.1	1074	1077	+	3	0	0	10459
Q96D53-1#21	0	3	3	Q96D53-1	957	960	+	3	Q96D53-1	0	1015	ENST00000678569.1	101	1112	+	268	Q96D53-1#21	0	3	ENST00000678569.1	1054	1057	+	3	0	0	10460
Q96D53-1#21	0	3	3	Q96D53-1	957	960	+	3	Q96D53-1	0	1632	ENST00000678467.1	117	1749	++	267	Q96D53-1#21	0	3	ENST00000678467.1	1074	1077	+	3	0	0	10461
Q96D53-1#21	0	3	3	Q96D53-1	957	960	+	3	Q96D53-1	0	1632	ENST00000678419.1	81	1713	++	266	Q96D53-1#21	0	3	ENST00000678419.1	1038	1041	+	3	0	0	10462
Q96D53-1#21	0	3	3	Q96D53-1	957	960	+	3	Q96D53-1	0	1632	ENST00000678404.1	295	1927	++	265	Q96D53-1#21	0	3	ENST00000678404.1	1252	1255	+	3	0	0	10463
Q96D53-1#21	0	3	3	Q96D53-1	957	960	+	3	Q96D53-1	327	1632	ENST00000677517.1	213	1518	+	260	Q96D53-1#21	0	3	ENST00000677517.1	843	846	+	3	0	0	10464
Q96D53-1#21	0	3	3	Q96D53-1	957	960	+	3	Q96D53-1	327	1632	ENST00000677496.1	217	1522	+	259	Q96D53-1#21	0	3	ENST00000677496.1	847	850	+	3	0	0	10465
Q96D53-1#21	0	3	3	Q96D53-1	957	960	+	3	Q96D53-1	0	1632	ENST00000677018.1	141	1773	++	258	Q96D53-1#21	0	3	ENST00000677018.1	1098	1101	+	3	0	0	10466
Q96D53-1#21	0	3	3	Q96D53-1	957	960	+	3	Q96D53-1	0	1143	ENST00000676555.1	101	1244	+	256	Q96D53-1#21	0	3	ENST00000676555.1	1058	1061	+	3	0	0	10467
Q96D53-1#21	0	3	3	Q96D53-1	957	960	+	3	Q96D53-1	0	1632	ENST00000601967.6	45	1677	++	226	Q96D53-1#21	0	3	ENST00000601967.6	1002	1005	+	3	0	0	10468
Q96D53-1#21	0	3	3	Q96D53-1	957	960	+	3	Q96D53-1	0	1632	ENST00000594720.6	38	1670	++	206	Q96D53-1#21	0	3	ENST00000594720.6	995	998	+	3	0	0	10469
Q96D53-1#21	0	3	3	Q96D53-1	957	960	+	3	Q96D53-1	0	1632	ENST00000594490.6	29	1583	+	205	Q96D53-1#21	0	3	ENST00000594490.6	908	911	+	3	0	0	10470
Q96D53-1#21	0	3	3	Q96D53-1	957	960	+	3	Q96D53-1	0	1632	ENST00000324464.8	303	1935	++	26	Q96D53-1#21	0	3	ENST00000324464.8	1260	1263	+	3	0	0	10471
Q96D53-1#21	0	3	3	Q96D53-1	957	960	+	3	Q96D53-1	0	1632	ENST00000243583.10	24	1533	++	3	Q96D53-1#21	0	3	ENST00000243583.10	858	861	+	3	0	0	10472
Q96D53-1#22	0	3	3	Q96D53-1	1026	1029	+	3	Q96D53-1	0	1632	ENST00000679130.1	149	1781	++	271	Q96D53-1#22	0	3	ENST00000679130.1	1175	1178	+	3	0	0	10473
Q96D53-1#22	0	3	3	Q96D53-1	1026	1029	+	3	Q96D53-1	412	1632	ENST00000679012.1	561	1749	+	269	Q96D53-1#22	0	3	ENST00000679012.1	1143	1146	+	3	0	0	10474
Q96D53-1#22	0	3	3	Q96D53-1	1026	1029	+	3	Q96D53-1	0	1632	ENST00000678467.1	117	1749	++	267	Q96D53-1#22	0	3	ENST00000678467.1	1143	1146	+	3	0	0	10475
Q96D53-1#22	0	3	3	Q96D53-1	1026	1029	+	3	Q96D53-1	0	1632	ENST00000678419.1	81	1713	++	266	Q96D53-1#22	0	3	ENST00000678419.1	1107	1110	+	3	0	0	10476
Q96D53-1#22	0	3	3	Q96D53-1	1026	1029	+	3	Q96D53-1	0	1632	ENST00000678404.1	295	1927	++	265	Q96D53-1#22	0	3	ENST00000678404.1	1321	1324	+	3	0	0	10477
Q96D53-1#22	0	3	3	Q96D53-1	1026	1029	+	3	Q96D53-1	327	1632	ENST00000677517.1	213	1518	+	260	Q96D53-1#22	0	3	ENST00000677517.1	912	915	+	3	0	0	10478
Q96D53-1#22	0	3	3	Q96D53-1	1026	1029	+	3	Q96D53-1	327	1632	ENST00000677496.1	217	1522	+	259	Q96D53-1#22	0	3	ENST00000677496.1	916	919	+	3	0	0	10479
Q96D53-1#22	0	3	3	Q96D53-1	1026	1029	+	3	Q96D53-1	0	1632	ENST00000677018.1	141	1773	++	258	Q96D53-1#22	0	3	ENST00000677018.1	1167	1170	+	3	0	0	10480
Q96D53-1#22	0	3	3	Q96D53-1	1026	1029	+	3	Q96D53-1	0	1143	ENST00000676555.1	101	1244	+	256	Q96D53-1#22	0	3	ENST00000676555.1	1127	1130	+	3	0	0	10481
Q96D53-1#22	0	3	3	Q96D53-1	1026	1029	+	3	Q96D53-1	0	1632	ENST00000601967.6	45	1677	++	226	Q96D53-1#22	0	3	ENST00000601967.6	1071	1074	+	3	0	0	10482
Q96D53-1#22	0	3	3	Q96D53-1	1026	1029	+	3	Q96D53-1	0	1632	ENST00000594720.6	38	1670	++	206	Q96D53-1#22	0	3	ENST00000594720.6	1064	1067	+	3	0	0	10483
Q96D53-1#22	0	3	3	Q96D53-1	1026	1029	+	3	Q96D53-1	0	1632	ENST00000594490.6	29	1583	+	205	Q96D53-1#22	0	3	ENST00000594490.6	977	980	+	3	0	0	10484
Q96D53-1#22	0	3	3	Q96D53-1	1026	1029	+	3	Q96D53-1	0	1632	ENST00000324464.8	303	1935	++	26	Q96D53-1#22	0	3	ENST00000324464.8	1329	1332	+	3	0	0	10485
Q96D53-1#22	0	3	3	Q96D53-1	1026	1029	+	3	Q96D53-1	0	1632	ENST00000243583.10	24	1533	++	3	Q96D53-1#22	0	3	ENST00000243583.10	927	930	+	3	0	0	10486
Q96D53-1#23	0	3	3	Q96D53-1	1053	1056	+	3	Q96D53-1	0	1632	ENST00000679130.1	149	1781	++	271	Q96D53-1#23	0	3	ENST00000679130.1	1202	1205	+	3	0	0	10487
Q96D53-1#23	0	3	3	Q96D53-1	1053	1056	+	3	Q96D53-1	412	1632	ENST00000679012.1	561	1749	+	269	Q96D53-1#23	0	3	ENST00000679012.1	1170	1173	+	3	0	0	10488
Q96D53-1#23	0	3	3	Q96D53-1	1053	1056	+	3	Q96D53-1	0	1632	ENST00000678467.1	117	1749	++	267	Q96D53-1#23	0	3	ENST00000678467.1	1170	1173	+	3	0	0	10489
Q96D53-1#23	0	3	3	Q96D53-1	1053	1056	+	3	Q96D53-1	0	1632	ENST00000678419.1	81	1713	++	266	Q96D53-1#23	0	3	ENST00000678419.1	1134	1137	+	3	0	0	10490
Q96D53-1#23	0	3	3	Q96D53-1	1053	1056	+	3	Q96D53-1	0	1632	ENST00000678404.1	295	1927	++	265	Q96D53-1#23	0	3	ENST00000678404.1	1348	1351	+	3	0	0	10491
Q96D53-1#23	0	3	3	Q96D53-1	1053	1056	+	3	Q96D53-1	327	1632	ENST00000677517.1	213	1518	+	260	Q96D53-1#23	0	3	ENST00000677517.1	939	942	+	3	0	0	10492
Q96D53-1#23	0	3	3	Q96D53-1	1053	1056	+	3	Q96D53-1	327	1632	ENST00000677496.1	217	1522	+	259	Q96D53-1#23	0	3	ENST00000677496.1	943	946	+	3	0	0	10493
Q96D53-1#23	0	3	3	Q96D53-1	1053	1056	+	3	Q96D53-1	0	1632	ENST00000677018.1	141	1773	++	258	Q96D53-1#23	0	3	ENST00000677018.1	1194	1197	+	3	0	0	10494
Q96D53-1#23	0	3	3	Q96D53-1	1053	1056	+	3	Q96D53-1	0	1143	ENST00000676555.1	101	1244	+	256	Q96D53-1#23	0	3	ENST00000676555.1	1154	1157	+	3	0	0	10495
Q96D53-1#23	0	3	3	Q96D53-1	1053	1056	+	3	Q96D53-1	0	1632	ENST00000601967.6	45	1677	++	226	Q96D53-1#23	0	3	ENST00000601967.6	1098	1101	+	3	0	0	10496
Q96D53-1#23	0	3	3	Q96D53-1	1053	1056	+	3	Q96D53-1	0	1632	ENST00000594720.6	38	1670	++	206	Q96D53-1#23	0	3	ENST00000594720.6	1091	1094	+	3	0	0	10497
Q96D53-1#23	0	3	3	Q96D53-1	1053	1056	+	3	Q96D53-1	0	1632	ENST00000594490.6	29	1583	+	205	Q96D53-1#23	0	3	ENST00000594490.6	1004	1007	+	3	0	0	10498
Q96D53-1#23	0	3	3	Q96D53-1	1053	1056	+	3	Q96D53-1	0	1632	ENST00000324464.8	303	1935	++	26	Q96D53-1#23	0	3	ENST00000324464.8	1356	1359	+	3	0	0	10499
Q96D53-1#23	0	3	3	Q96D53-1	1053	1056	+	3	Q96D53-1	0	1632	ENST00000243583.10	24	1533	++	3	Q96D53-1#23	0	3	ENST00000243583.10	954	957	+	3	0	0	10500
Q96D53-1#24	0	3	3	Q96D53-1	1383	1386	+	3	Q96D53-1	0	1632	ENST00000679130.1	149	1781	++	271	Q96D53-1#24	0	3	ENST00000679130.1	1532	1535	+	3	0	0	10501
Q96D53-1#24	0	3	3	Q96D53-1	1383	1386	+	3	Q96D53-1	412	1632	ENST00000679012.1	561	1749	+	269	Q96D53-1#24	0	3	ENST00000679012.1	1500	1503	+	3	0	0	10502
Q96D53-1#24	0	3	3	Q96D53-1	1383	1386	+	3	Q96D53-1	0	1632	ENST00000678467.1	117	1749	++	267	Q96D53-1#24	0	3	ENST00000678467.1	1500	1503	+	3	0	0	10503
Q96D53-1#24	0	3	3	Q96D53-1	1383	1386	+	3	Q96D53-1	0	1632	ENST00000678419.1	81	1713	++	266	Q96D53-1#24	0	3	ENST00000678419.1	1464	1467	+	3	0	0	10504
Q96D53-1#24	0	3	3	Q96D53-1	1383	1386	+	3	Q96D53-1	0	1632	ENST00000678404.1	295	1927	++	265	Q96D53-1#24	0	3	ENST00000678404.1	1678	1681	+	3	0	0	10505
Q96D53-1#24	0	3	3	Q96D53-1	1383	1386	+	3	Q96D53-1	327	1632	ENST00000677517.1	213	1518	+	260	Q96D53-1#24	0	3	ENST00000677517.1	1269	1272	+	3	0	0	10506
Q96D53-1#24	0	3	3	Q96D53-1	1383	1386	+	3	Q96D53-1	327	1632	ENST00000677496.1	217	1522	+	259	Q96D53-1#24	0	3	ENST00000677496.1	1273	1276	+	3	0	0	10507
Q96D53-1#24	0	3	3	Q96D53-1	1383	1386	+	3	Q96D53-1	0	1632	ENST00000677018.1	141	1773	++	258	Q96D53-1#24	0	3	ENST00000677018.1	1524	1527	+	3	0	0	10508
Q96D53-1#24	0	3	3	Q96D53-1	1383	1386	+	3	Q96D53-1	0	1632	ENST00000601967.6	45	1677	++	226	Q96D53-1#24	0	3	ENST00000601967.6	1428	1431	+	3	0	0	10509
Q96D53-1#24	0	3	3	Q96D53-1	1383	1386	+	3	Q96D53-1	0	1632	ENST00000594720.6	38	1670	++	206	Q96D53-1#24	0	3	ENST00000594720.6	1421	1424	+	3	0	0	10510
Q96D53-1#24	0	3	3	Q96D53-1	1383	1386	+	3	Q96D53-1	0	1632	ENST00000594490.6	29	1583	+	205	Q96D53-1#24	0	3	ENST00000594490.6	1334	1337	+	3	0	0	10511
Q96D53-1#24	0	3	3	Q96D53-1	1383	1386	+	3	Q96D53-1	0	1632	ENST00000324464.8	303	1935	++	26	Q96D53-1#24	0	3	ENST00000324464.8	1686	1689	+	3	0	0	10512
Q96D53-1#24	0	3	3	Q96D53-1	1383	1386	+	3	Q96D53-1	0	1632	ENST00000243583.10	24	1533	++	3	Q96D53-1#24	0	3	ENST00000243583.10	1284	1287	+	3	0	0	10513
Q96D53-1#25	0	3	3	Q96D53-1	1428	1431	+	3	Q96D53-1	0	1632	ENST00000679130.1	149	1781	++	271	Q96D53-1#25	0	3	ENST00000679130.1	1577	1580	+	3	0	0	10514
Q96D53-1#25	0	3	3	Q96D53-1	1428	1431	+	3	Q96D53-1	412	1632	ENST00000679012.1	561	1749	+	269	Q96D53-1#25	0	3	ENST00000679012.1	1545	1548	+	3	0	0	10515
Q96D53-1#25	0	3	3	Q96D53-1	1428	1431	+	3	Q96D53-1	0	1632	ENST00000678467.1	117	1749	++	267	Q96D53-1#25	0	3	ENST00000678467.1	1545	1548	+	3	0	0	10516
Q96D53-1#25	0	3	3	Q96D53-1	1428	1431	+	3	Q96D53-1	0	1632	ENST00000678419.1	81	1713	++	266	Q96D53-1#25	0	3	ENST00000678419.1	1509	1512	+	3	0	0	10517
Q96D53-1#25	0	3	3	Q96D53-1	1428	1431	+	3	Q96D53-1	0	1632	ENST00000678404.1	295	1927	++	265	Q96D53-1#25	0	3	ENST00000678404.1	1723	1726	+	3	0	0	10518
Q96D53-1#25	0	3	3	Q96D53-1	1428	1431	+	3	Q96D53-1	327	1632	ENST00000677517.1	213	1518	+	260	Q96D53-1#25	0	3	ENST00000677517.1	1314	1317	+	3	0	0	10519
Q96D53-1#25	0	3	3	Q96D53-1	1428	1431	+	3	Q96D53-1	327	1632	ENST00000677496.1	217	1522	+	259	Q96D53-1#25	0	3	ENST00000677496.1	1318	1321	+	3	0	0	10520
Q96D53-1#25	0	3	3	Q96D53-1	1428	1431	+	3	Q96D53-1	0	1632	ENST00000677018.1	141	1773	++	258	Q96D53-1#25	0	3	ENST00000677018.1	1569	1572	+	3	0	0	10521
Q96D53-1#25	0	3	3	Q96D53-1	1428	1431	+	3	Q96D53-1	0	1632	ENST00000601967.6	45	1677	++	226	Q96D53-1#25	0	3	ENST00000601967.6	1473	1476	+	3	0	0	10522
Q96D53-1#25	0	3	3	Q96D53-1	1428	1431	+	3	Q96D53-1	0	1632	ENST00000594720.6	38	1670	++	206	Q96D53-1#25	0	3	ENST00000594720.6	1466	1469	+	3	0	0	10523
Q96D53-1#25	0	3	3	Q96D53-1	1428	1431	+	3	Q96D53-1	0	1632	ENST00000594490.6	29	1583	+	205	Q96D53-1#25	0	3	ENST00000594490.6	1379	1382	+	3	0	0	10524
Q96D53-1#25	0	3	3	Q96D53-1	1428	1431	+	3	Q96D53-1	0	1632	ENST00000324464.8	303	1935	++	26	Q96D53-1#25	0	3	ENST00000324464.8	1731	1734	+	3	0	0	10525
Q96D53-1#25	0	3	3	Q96D53-1	1428	1431	+	3	Q96D53-1	0	1632	ENST00000243583.10	24	1533	++	3	Q96D53-1#25	0	3	ENST00000243583.10	1329	1332	+	3	0	0	10526
Q96D53-1#26	0	3	3	Q96D53-1	1491	1494	+	3	Q96D53-1	0	1632	ENST00000679130.1	149	1781	++	271	Q96D53-1#26	0	3	ENST00000679130.1	1640	1643	+	3	0	0	10527
Q96D53-1#26	0	3	3	Q96D53-1	1491	1494	+	3	Q96D53-1	412	1632	ENST00000679012.1	561	1749	+	269	Q96D53-1#26	0	3	ENST00000679012.1	1608	1611	+	3	0	0	10528
Q96D53-1#26	0	3	3	Q96D53-1	1491	1494	+	3	Q96D53-1	0	1632	ENST00000678467.1	117	1749	++	267	Q96D53-1#26	0	3	ENST00000678467.1	1608	1611	+	3	0	0	10529
Q96D53-1#26	0	3	3	Q96D53-1	1491	1494	+	3	Q96D53-1	0	1632	ENST00000678419.1	81	1713	++	266	Q96D53-1#26	0	3	ENST00000678419.1	1572	1575	+	3	0	0	10530
Q96D53-1#26	0	3	3	Q96D53-1	1491	1494	+	3	Q96D53-1	0	1632	ENST00000678404.1	295	1927	++	265	Q96D53-1#26	0	3	ENST00000678404.1	1786	1789	+	3	0	0	10531
Q96D53-1#26	0	3	3	Q96D53-1	1491	1494	+	3	Q96D53-1	327	1632	ENST00000677517.1	213	1518	+	260	Q96D53-1#26	0	3	ENST00000677517.1	1377	1380	+	3	0	0	10532
Q96D53-1#26	0	3	3	Q96D53-1	1491	1494	+	3	Q96D53-1	327	1632	ENST00000677496.1	217	1522	+	259	Q96D53-1#26	0	3	ENST00000677496.1	1381	1384	+	3	0	0	10533
Q96D53-1#26	0	3	3	Q96D53-1	1491	1494	+	3	Q96D53-1	0	1632	ENST00000677018.1	141	1773	++	258	Q96D53-1#26	0	3	ENST00000677018.1	1632	1635	+	3	0	0	10534
Q96D53-1#26	0	3	3	Q96D53-1	1491	1494	+	3	Q96D53-1	0	1632	ENST00000601967.6	45	1677	++	226	Q96D53-1#26	0	3	ENST00000601967.6	1536	1539	+	3	0	0	10535
Q96D53-1#26	0	3	3	Q96D53-1	1491	1494	+	3	Q96D53-1	0	1632	ENST00000594720.6	38	1670	++	206	Q96D53-1#26	0	3	ENST00000594720.6	1529	1532	+	3	0	0	10536
Q96D53-1#26	0	3	3	Q96D53-1	1491	1494	+	3	Q96D53-1	0	1632	ENST00000594490.6	29	1583	+	205	Q96D53-1#26	0	3	ENST00000594490.6	1442	1445	+	3	0	0	10537
Q96D53-1#26	0	3	3	Q96D53-1	1491	1494	+	3	Q96D53-1	0	1632	ENST00000324464.8	303	1935	++	26	Q96D53-1#26	0	3	ENST00000324464.8	1794	1797	+	3	0	0	10538
Q96D53-1#26	0	3	3	Q96D53-1	1491	1494	+	3	Q96D53-1	0	1632	ENST00000243583.10	24	1533	++	3	Q96D53-1#26	0	3	ENST00000243583.10	1392	1395	+	3	0	0	10539
Q96D53-1#27	0	9	9	Q96D53-1	489	498	+	9	Q96D53-1	0	1632	ENST00000679130.1	149	1781	++	271	Q96D53-1#27	0	9	ENST00000679130.1	638	647	+	9	0	0	10540
Q96D53-1#27	0	9	9	Q96D53-1	489	498	+	9	Q96D53-1	327	577	ENST00000679070.1	229	472	+	270	Q96D53-1#27	0	9	ENST00000679070.1	391	393	+	2	0	0	10541
Q96D53-1#27	0	9	9	Q96D53-1	489	498	+	9	Q96D53-1	412	1632	ENST00000679012.1	561	1749	+	269	Q96D53-1#27	8	9	ENST00000679012.1	614	615	+	1	8	0	10542
Q96D53-1#27	0	9	9	Q96D53-1	489	498	+	9	Q96D53-1	0	1015	ENST00000678569.1	101	1112	+	268	Q96D53-1#27	0	9	ENST00000678569.1	590	599	+	9	0	0	10543
Q96D53-1#27	0	9	9	Q96D53-1	489	498	+	9	Q96D53-1	0	1632	ENST00000678467.1	117	1749	++	267	Q96D53-1#27	0	9	ENST00000678467.1	606	615	+	9	0	0	10544
Q96D53-1#27	0	9	9	Q96D53-1	489	498	+	9	Q96D53-1	0	1632	ENST00000678419.1	81	1713	++	266	Q96D53-1#27	0	9	ENST00000678419.1	570	579	+	9	0	0	10545
Q96D53-1#27	0	9	9	Q96D53-1	489	498	+	9	Q96D53-1	0	1632	ENST00000678404.1	295	1927	++	265	Q96D53-1#27	0	9	ENST00000678404.1	784	793	+	9	0	0	10546
Q96D53-1#27	0	9	9	Q96D53-1	489	498	+	9	Q96D53-1	0	577	ENST00000678316.1	139	691	+	264	Q96D53-1#27	1	9	ENST00000678316.1	604	612	+	8	1	0	10547
Q96D53-1#27	0	9	9	Q96D53-1	489	498	+	9	Q96D53-1	0	490	ENST00000677800.1	25	392	+	262	Q96D53-1#27	0	1	ENST00000677800.1	391	392	+	1	0	8	10548
Q96D53-1#27	0	9	9	Q96D53-1	489	498	+	9	Q96D53-1	0	577	ENST00000677633.1	120	690	+	261	Q96D53-1#27	0	9	ENST00000677633.1	609	611	+	2	0	0	10549
Q96D53-1#27	0	9	9	Q96D53-1	489	498	+	9	Q96D53-1	327	1632	ENST00000677517.1	213	1518	+	260	Q96D53-1#27	0	9	ENST00000677517.1	375	384	+	9	0	0	10550
Q96D53-1#27	0	9	9	Q96D53-1	489	498	+	9	Q96D53-1	327	1632	ENST00000677496.1	217	1522	+	259	Q96D53-1#27	0	9	ENST00000677496.1	379	388	+	9	0	0	10551
Q96D53-1#27	0	9	9	Q96D53-1	489	498	+	9	Q96D53-1	0	1632	ENST00000677018.1	141	1773	++	258	Q96D53-1#27	0	9	ENST00000677018.1	630	639	+	9	0	0	10552
Q96D53-1#27	0	9	9	Q96D53-1	489	498	+	9	Q96D53-1	0	1143	ENST00000676555.1	101	1244	+	256	Q96D53-1#27	0	9	ENST00000676555.1	590	599	+	9	0	0	10553
Q96D53-1#27	0	9	9	Q96D53-1	489	498	+	9	Q96D53-1	0	1632	ENST00000601967.6	45	1677	++	226	Q96D53-1#27	0	9	ENST00000601967.6	534	543	+	9	0	0	10554
Q96D53-1#27	0	9	9	Q96D53-1	489	498	+	9	Q96D53-1	327	554	ENST00000600080.5	253	473	+	218	Q96D53-1#27	0	9	ENST00000600080.5	415	417	+	2	0	0	10555
Q96D53-1#27	0	9	9	Q96D53-1	489	498	+	9	Q96D53-1	0	730	ENST00000599643.5	52	400	+	216	Q96D53-1#27	1	9	ENST00000599643.5	301	309	+	8	1	0	10556
Q96D53-1#27	0	9	9	Q96D53-1	489	498	+	9	Q96D53-1	327	940	ENST00000595254.5	254	867	+	209	Q96D53-1#27	0	9	ENST00000595254.5	416	425	+	9	0	0	10557
Q96D53-1#27	0	9	9	Q96D53-1	489	498	+	9	Q96D53-1	0	1632	ENST00000594720.6	38	1670	++	206	Q96D53-1#27	0	9	ENST00000594720.6	527	536	+	9	0	0	10558
Q96D53-1#27	0	9	9	Q96D53-1	489	498	+	9	Q96D53-1	0	1632	ENST00000594490.6	29	1583	+	205	Q96D53-1#27	0	9	ENST00000594490.6	440	449	+	9	0	0	10559
Q96D53-1#27	0	9	9	Q96D53-1	489	498	+	9	Q96D53-1	0	1632	ENST00000324464.8	303	1935	++	26	Q96D53-1#27	0	9	ENST00000324464.8	792	801	+	9	0	0	10560
Q96D53-1#27	0	9	9	Q96D53-1	489	498	+	9	Q96D53-1	0	1632	ENST00000243583.10	24	1533	++	3	Q96D53-1#27	0	9	ENST00000243583.10	390	399	+	9	0	0	10561
Q9NTW7-1#0	0	1935	1935	Q9NTW7-1	0	1935	+	1935	Q9NTW7-1	884	1442	ENST00000456175.5	0	361	+	103	Q9NTW7-1#0	884	1442	ENST00000456175.5	0	361	+	361	884	493	10562
Q9NTW7-1#0	0	1935	1935	Q9NTW7-1	0	1935	+	1935	Q9NTW7-1	763	1254	ENST00000395989.7	271	762	+	66	Q9NTW7-1#0	763	1254	ENST00000395989.7	271	762	+	491	763	681	10563
Q9NTW7-1#0	0	1935	1935	Q9NTW7-1	0	1935	+	1935	Q9NTW7-1	763	976	ENST00000395979.1	198	411	+	65	Q9NTW7-1#0	763	976	ENST00000395979.1	198	411	+	213	763	959	10564
Q9NTW7-1#0	0	1935	1935	Q9NTW7-1	0	1935	+	1935	Q9NTW7-1	714	1935	ENST00000371523.8	464	1685	++	47	Q9NTW7-1#0	714	1935	ENST00000371523.8	464	1685	+	1221	714	0	10565
Q9NTW7-1#0	0	1935	1935	Q9NTW7-1	0	1935	+	1935	Q9NTW7-1	0	1230	ENST00000371518.6	143	1373	++	46	Q9NTW7-1#0	0	1230	ENST00000371518.6	143	1373	+	1230	0	705	10566
Q9NTW7-1#0	0	1935	1935	Q9NTW7-1	0	1935	+	1935	Q9NTW7-1	0	1935	ENST00000361387.6	61	1996	++	39	Q9NTW7-1#0	0	1935	ENST00000361387.6	61	1996	+	1935	0	0	10567
Q9NTW7-1#1	0	69	69	Q9NTW7-1	522	591	+	69	Q9NTW7-1	0	1230	ENST00000371518.6	143	1373	++	46	Q9NTW7-1#1	0	69	ENST00000371518.6	665	734	+	69	0	0	10568
Q9NTW7-1#1	0	69	69	Q9NTW7-1	522	591	+	69	Q9NTW7-1	0	1935	ENST00000361387.6	61	1996	++	39	Q9NTW7-1#1	0	69	ENST00000361387.6	583	652	+	69	0	0	10569
Q9NTW7-1#2	0	69	69	Q9NTW7-1	606	675	+	69	Q9NTW7-1	0	1230	ENST00000371518.6	143	1373	++	46	Q9NTW7-1#2	0	69	ENST00000371518.6	749	818	+	69	0	0	10570
Q9NTW7-1#2	0	69	69	Q9NTW7-1	606	675	+	69	Q9NTW7-1	0	1935	ENST00000361387.6	61	1996	++	39	Q9NTW7-1#2	0	69	ENST00000361387.6	667	736	+	69	0	0	10571
Q9NTW7-1#3	0	69	69	Q9NTW7-1	690	759	+	69	Q9NTW7-1	714	1935	ENST00000371523.8	464	1685	++	47	Q9NTW7-1#3	24	69	ENST00000371523.8	464	509	+	45	24	0	10572
Q9NTW7-1#3	0	69	69	Q9NTW7-1	690	759	+	69	Q9NTW7-1	0	1230	ENST00000371518.6	143	1373	++	46	Q9NTW7-1#3	0	69	ENST00000371518.6	833	902	+	69	0	0	10573
Q9NTW7-1#3	0	69	69	Q9NTW7-1	690	759	+	69	Q9NTW7-1	0	1935	ENST00000361387.6	61	1996	++	39	Q9NTW7-1#3	0	69	ENST00000361387.6	751	820	+	69	0	0	10574
Q9NTW7-1#4	0	78	78	Q9NTW7-1	894	972	+	78	Q9NTW7-1	884	1442	ENST00000456175.5	0	361	+	103	Q9NTW7-1#4	0	78	ENST00000456175.5	10	88	+	78	0	0	10575
Q9NTW7-1#4	0	78	78	Q9NTW7-1	894	972	+	78	Q9NTW7-1	763	1254	ENST00000395989.7	271	762	+	66	Q9NTW7-1#4	0	78	ENST00000395989.7	402	480	+	78	0	0	10576
Q9NTW7-1#4	0	78	78	Q9NTW7-1	894	972	+	78	Q9NTW7-1	763	976	ENST00000395979.1	198	411	+	65	Q9NTW7-1#4	0	78	ENST00000395979.1	329	407	+	78	0	0	10577
Q9NTW7-1#4	0	78	78	Q9NTW7-1	894	972	+	78	Q9NTW7-1	714	1935	ENST00000371523.8	464	1685	++	47	Q9NTW7-1#4	0	78	ENST00000371523.8	644	722	+	78	0	0	10578
Q9NTW7-1#4	0	78	78	Q9NTW7-1	894	972	+	78	Q9NTW7-1	0	1230	ENST00000371518.6	143	1373	++	46	Q9NTW7-1#4	0	78	ENST00000371518.6	1037	1115	+	78	0	0	10579
Q9NTW7-1#4	0	78	78	Q9NTW7-1	894	972	+	78	Q9NTW7-1	0	1935	ENST00000361387.6	61	1996	++	39	Q9NTW7-1#4	0	78	ENST00000361387.6	955	1033	+	78	0	0	10580
Q9NTW7-1#5	0	69	69	Q9NTW7-1	987	1056	+	69	Q9NTW7-1	884	1442	ENST00000456175.5	0	361	+	103	Q9NTW7-1#5	0	69	ENST00000456175.5	103	172	+	69	0	0	10581
Q9NTW7-1#5	0	69	69	Q9NTW7-1	987	1056	+	69	Q9NTW7-1	763	1254	ENST00000395989.7	271	762	+	66	Q9NTW7-1#5	0	69	ENST00000395989.7	495	564	+	69	0	0	10582
Q9NTW7-1#5	0	69	69	Q9NTW7-1	987	1056	+	69	Q9NTW7-1	714	1935	ENST00000371523.8	464	1685	++	47	Q9NTW7-1#5	0	69	ENST00000371523.8	737	806	+	69	0	0	10583
Q9NTW7-1#5	0	69	69	Q9NTW7-1	987	1056	+	69	Q9NTW7-1	0	1230	ENST00000371518.6	143	1373	++	46	Q9NTW7-1#5	0	69	ENST00000371518.6	1130	1199	+	69	0	0	10584
Q9NTW7-1#5	0	69	69	Q9NTW7-1	987	1056	+	69	Q9NTW7-1	0	1935	ENST00000361387.6	61	1996	++	39	Q9NTW7-1#5	0	69	ENST00000361387.6	1048	1117	+	69	0	0	10585
Q9NTW7-1#6	0	69	69	Q9NTW7-1	1071	1140	+	69	Q9NTW7-1	884	1442	ENST00000456175.5	0	361	+	103	Q9NTW7-1#6	0	69	ENST00000456175.5	187	256	+	69	0	0	10586
Q9NTW7-1#6	0	69	69	Q9NTW7-1	1071	1140	+	69	Q9NTW7-1	763	1254	ENST00000395989.7	271	762	+	66	Q9NTW7-1#6	0	69	ENST00000395989.7	579	648	+	69	0	0	10587
Q9NTW7-1#6	0	69	69	Q9NTW7-1	1071	1140	+	69	Q9NTW7-1	714	1935	ENST00000371523.8	464	1685	++	47	Q9NTW7-1#6	0	69	ENST00000371523.8	821	890	+	69	0	0	10588
Q9NTW7-1#6	0	69	69	Q9NTW7-1	1071	1140	+	69	Q9NTW7-1	0	1230	ENST00000371518.6	143	1373	++	46	Q9NTW7-1#6	0	69	ENST00000371518.6	1214	1283	+	69	0	0	10589
Q9NTW7-1#6	0	69	69	Q9NTW7-1	1071	1140	+	69	Q9NTW7-1	0	1935	ENST00000361387.6	61	1996	++	39	Q9NTW7-1#6	0	69	ENST00000361387.6	1132	1201	+	69	0	0	10590
Q9NTW7-1#7	0	69	69	Q9NTW7-1	1155	1224	+	69	Q9NTW7-1	884	1442	ENST00000456175.5	0	361	+	103	Q9NTW7-1#7	0	69	ENST00000456175.5	271	340	+	69	0	0	10591
Q9NTW7-1#7	0	69	69	Q9NTW7-1	1155	1224	+	69	Q9NTW7-1	763	1254	ENST00000395989.7	271	762	+	66	Q9NTW7-1#7	0	69	ENST00000395989.7	663	732	+	69	0	0	10592
Q9NTW7-1#7	0	69	69	Q9NTW7-1	1155	1224	+	69	Q9NTW7-1	714	1935	ENST00000371523.8	464	1685	++	47	Q9NTW7-1#7	0	69	ENST00000371523.8	905	974	+	69	0	0	10593
Q9NTW7-1#7	0	69	69	Q9NTW7-1	1155	1224	+	69	Q9NTW7-1	0	1230	ENST00000371518.6	143	1373	++	46	Q9NTW7-1#7	0	69	ENST00000371518.6	1298	1367	+	69	0	0	10594
Q9NTW7-1#7	0	69	69	Q9NTW7-1	1155	1224	+	69	Q9NTW7-1	0	1935	ENST00000361387.6	61	1996	++	39	Q9NTW7-1#7	0	69	ENST00000361387.6	1216	1285	+	69	0	0	10595
Q9NTW7-1#8	0	69	69	Q9NTW7-1	1239	1308	+	69	Q9NTW7-1	763	1254	ENST00000395989.7	271	762	+	66	Q9NTW7-1#8	0	15	ENST00000395989.7	747	762	+	15	0	54	10596
Q9NTW7-1#8	0	69	69	Q9NTW7-1	1239	1308	+	69	Q9NTW7-1	714	1935	ENST00000371523.8	464	1685	++	47	Q9NTW7-1#8	0	69	ENST00000371523.8	989	1058	+	69	0	0	10597
Q9NTW7-1#8	0	69	69	Q9NTW7-1	1239	1308	+	69	Q9NTW7-1	0	1935	ENST00000361387.6	61	1996	++	39	Q9NTW7-1#8	0	69	ENST00000361387.6	1300	1369	+	69	0	0	10598
Q9NTW7-1#9	0	72	72	Q9NTW7-1	1323	1395	+	72	Q9NTW7-1	714	1935	ENST00000371523.8	464	1685	++	47	Q9NTW7-1#9	0	72	ENST00000371523.8	1073	1145	+	72	0	0	10599
Q9NTW7-1#9	0	72	72	Q9NTW7-1	1323	1395	+	72	Q9NTW7-1	0	1935	ENST00000361387.6	61	1996	++	39	Q9NTW7-1#9	0	72	ENST00000361387.6	1384	1456	+	72	0	0	10600
Q9NTW7-1#10	0	69	69	Q9NTW7-1	1398	1467	+	69	Q9NTW7-1	884	1442	ENST00000456175.5	0	361	+	103	Q9NTW7-1#10	27	44	ENST00000456175.5	344	361	+	17	27	25	10601
Q9NTW7-1#10	0	69	69	Q9NTW7-1	1398	1467	+	69	Q9NTW7-1	714	1935	ENST00000371523.8	464	1685	++	47	Q9NTW7-1#10	0	69	ENST00000371523.8	1148	1217	+	69	0	0	10602
Q9NTW7-1#10	0	69	69	Q9NTW7-1	1398	1467	+	69	Q9NTW7-1	0	1935	ENST00000361387.6	61	1996	++	39	Q9NTW7-1#10	0	69	ENST00000361387.6	1459	1528	+	69	0	0	10603
Q9NTW7-1#11	0	69	69	Q9NTW7-1	1482	1551	+	69	Q9NTW7-1	714	1935	ENST00000371523.8	464	1685	++	47	Q9NTW7-1#11	0	69	ENST00000371523.8	1232	1301	+	69	0	0	10604
Q9NTW7-1#11	0	69	69	Q9NTW7-1	1482	1551	+	69	Q9NTW7-1	0	1935	ENST00000361387.6	61	1996	++	39	Q9NTW7-1#11	0	69	ENST00000361387.6	1543	1612	+	69	0	0	10605
Q9NTW7-1#12	0	72	72	Q9NTW7-1	1566	1638	+	72	Q9NTW7-1	714	1935	ENST00000371523.8	464	1685	++	47	Q9NTW7-1#12	0	72	ENST00000371523.8	1316	1388	+	72	0	0	10606
Q9NTW7-1#12	0	72	72	Q9NTW7-1	1566	1638	+	72	Q9NTW7-1	0	1935	ENST00000361387.6	61	1996	++	39	Q9NTW7-1#12	0	72	ENST00000361387.6	1627	1699	+	72	0	0	10607
Q9NTW7-1#13	0	69	69	Q9NTW7-1	1737	1806	+	69	Q9NTW7-1	714	1935	ENST00000371523.8	464	1685	++	47	Q9NTW7-1#13	0	69	ENST00000371523.8	1487	1556	+	69	0	0	10608
Q9NTW7-1#13	0	69	69	Q9NTW7-1	1737	1806	+	69	Q9NTW7-1	0	1935	ENST00000361387.6	61	1996	++	39	Q9NTW7-1#13	0	69	ENST00000361387.6	1798	1867	+	69	0	0	10609
Q9NTW7-1#14	0	75	75	Q9NTW7-1	1626	1701	+	75	Q9NTW7-1	714	1935	ENST00000371523.8	464	1685	++	47	Q9NTW7-1#14	0	75	ENST00000371523.8	1376	1451	+	75	0	0	10610
Q9NTW7-1#14	0	75	75	Q9NTW7-1	1626	1701	+	75	Q9NTW7-1	0	1935	ENST00000361387.6	61	1996	++	39	Q9NTW7-1#14	0	75	ENST00000361387.6	1687	1762	+	75	0	0	10611
Q9NTW7-1#15	0	138	138	Q9NTW7-1	1797	1935	+	138	Q9NTW7-1	714	1935	ENST00000371523.8	464	1685	++	47	Q9NTW7-1#15	0	138	ENST00000371523.8	1547	1685	+	138	0	0	10612
Q9NTW7-1#15	0	138	138	Q9NTW7-1	1797	1935	+	138	Q9NTW7-1	0	1935	ENST00000361387.6	61	1996	++	39	Q9NTW7-1#15	0	138	ENST00000361387.6	1858	1996	+	138	0	0	10613
Q9NTW7-1#16	0	54	54	Q9NTW7-1	1626	1680	+	54	Q9NTW7-1	714	1935	ENST00000371523.8	464	1685	++	47	Q9NTW7-1#16	0	54	ENST00000371523.8	1376	1430	+	54	0	0	10614
Q9NTW7-1#16	0	54	54	Q9NTW7-1	1626	1680	+	54	Q9NTW7-1	0	1935	ENST00000361387.6	61	1996	++	39	Q9NTW7-1#16	0	54	ENST00000361387.6	1687	1741	+	54	0	0	10615
Q9NTW7-1#17	0	75	75	Q9NTW7-1	1821	1896	+	75	Q9NTW7-1	714	1935	ENST00000371523.8	464	1685	++	47	Q9NTW7-1#17	0	75	ENST00000371523.8	1571	1646	+	75	0	0	10616
Q9NTW7-1#17	0	75	75	Q9NTW7-1	1821	1896	+	75	Q9NTW7-1	0	1935	ENST00000361387.6	61	1996	++	39	Q9NTW7-1#17	0	75	ENST00000361387.6	1882	1957	+	75	0	0	10617
Q9NTW7-1#18	0	657	657	Q9NTW7-1	0	657	+	657	Q9NTW7-1	0	1230	ENST00000371518.6	143	1373	++	46	Q9NTW7-1#18	0	657	ENST00000371518.6	143	800	+	657	0	0	10618
Q9NTW7-1#18	0	657	657	Q9NTW7-1	0	657	+	657	Q9NTW7-1	0	1935	ENST00000361387.6	61	1996	++	39	Q9NTW7-1#18	0	657	ENST00000361387.6	61	718	+	657	0	0	10619
Q9NTW7-1#19	0	9	9	Q9NTW7-1	45	54	+	9	Q9NTW7-1	0	1230	ENST00000371518.6	143	1373	++	46	Q9NTW7-1#19	0	9	ENST00000371518.6	188	197	+	9	0	0	10620
Q9NTW7-1#19	0	9	9	Q9NTW7-1	45	54	+	9	Q9NTW7-1	0	1935	ENST00000361387.6	61	1996	++	39	Q9NTW7-1#19	0	9	ENST00000361387.6	106	115	+	9	0	0	10621
Q9NTW7-1#20	0	162	162	Q9NTW7-1	285	447	+	162	Q9NTW7-1	0	1230	ENST00000371518.6	143	1373	++	46	Q9NTW7-1#20	0	162	ENST00000371518.6	428	590	+	162	0	0	10622
Q9NTW7-1#20	0	162	162	Q9NTW7-1	285	447	+	162	Q9NTW7-1	0	1935	ENST00000361387.6	61	1996	++	39	Q9NTW7-1#20	0	162	ENST00000361387.6	346	508	+	162	0	0	10623
Q9NTW7-1#21	0	105	105	Q9NTW7-1	657	762	+	105	Q9NTW7-1	714	1935	ENST00000371523.8	464	1685	++	47	Q9NTW7-1#21	57	105	ENST00000371523.8	464	512	+	48	57	0	10624
Q9NTW7-1#21	0	105	105	Q9NTW7-1	657	762	+	105	Q9NTW7-1	0	1230	ENST00000371518.6	143	1373	++	46	Q9NTW7-1#21	0	105	ENST00000371518.6	800	905	+	105	0	0	10625
Q9NTW7-1#21	0	105	105	Q9NTW7-1	657	762	+	105	Q9NTW7-1	0	1935	ENST00000361387.6	61	1996	++	39	Q9NTW7-1#21	0	105	ENST00000361387.6	718	823	+	105	0	0	10626
Q9NTW7-1#22	0	465	465	Q9NTW7-1	705	1170	+	465	Q9NTW7-1	884	1442	ENST00000456175.5	0	361	+	103	Q9NTW7-1#22	179	465	ENST00000456175.5	0	286	+	286	179	0	10627
Q9NTW7-1#22	0	465	465	Q9NTW7-1	705	1170	+	465	Q9NTW7-1	763	1254	ENST00000395989.7	271	762	+	66	Q9NTW7-1#22	58	465	ENST00000395989.7	271	678	+	407	58	0	10628
Q9NTW7-1#22	0	465	465	Q9NTW7-1	705	1170	+	465	Q9NTW7-1	763	976	ENST00000395979.1	198	411	+	65	Q9NTW7-1#22	58	271	ENST00000395979.1	198	411	+	213	58	194	10629
Q9NTW7-1#22	0	465	465	Q9NTW7-1	705	1170	+	465	Q9NTW7-1	714	1935	ENST00000371523.8	464	1685	++	47	Q9NTW7-1#22	9	465	ENST00000371523.8	464	920	+	456	9	0	10630
Q9NTW7-1#22	0	465	465	Q9NTW7-1	705	1170	+	465	Q9NTW7-1	0	1230	ENST00000371518.6	143	1373	++	46	Q9NTW7-1#22	0	465	ENST00000371518.6	848	1313	+	465	0	0	10631
Q9NTW7-1#22	0	465	465	Q9NTW7-1	705	1170	+	465	Q9NTW7-1	0	1935	ENST00000361387.6	61	1996	++	39	Q9NTW7-1#22	0	465	ENST00000361387.6	766	1231	+	465	0	0	10632
Q9NTW7-1#23	0	15	15	Q9NTW7-1	1230	1245	+	15	Q9NTW7-1	763	1254	ENST00000395989.7	271	762	+	66	Q9NTW7-1#23	0	15	ENST00000395989.7	738	753	+	15	0	0	10633
Q9NTW7-1#23	0	15	15	Q9NTW7-1	1230	1245	+	15	Q9NTW7-1	714	1935	ENST00000371523.8	464	1685	++	47	Q9NTW7-1#23	0	15	ENST00000371523.8	980	995	+	15	0	0	10634
Q9NTW7-1#23	0	15	15	Q9NTW7-1	1230	1245	+	15	Q9NTW7-1	0	1935	ENST00000361387.6	61	1996	++	39	Q9NTW7-1#23	0	15	ENST00000361387.6	1291	1306	+	15	0	0	10635
Q9NTW7-1#24	0	702	702	Q9NTW7-1	1233	1935	+	702	Q9NTW7-1	884	1442	ENST00000456175.5	0	361	+	103	Q9NTW7-1#24	192	209	ENST00000456175.5	344	361	+	17	192	493	10636
Q9NTW7-1#24	0	702	702	Q9NTW7-1	1233	1935	+	702	Q9NTW7-1	763	1254	ENST00000395989.7	271	762	+	66	Q9NTW7-1#24	0	21	ENST00000395989.7	741	762	+	21	0	681	10637
Q9NTW7-1#24	0	702	702	Q9NTW7-1	1233	1935	+	702	Q9NTW7-1	714	1935	ENST00000371523.8	464	1685	++	47	Q9NTW7-1#24	0	702	ENST00000371523.8	983	1685	+	702	0	0	10638
Q9NTW7-1#24	0	702	702	Q9NTW7-1	1233	1935	+	702	Q9NTW7-1	0	1935	ENST00000361387.6	61	1996	++	39	Q9NTW7-1#24	0	702	ENST00000361387.6	1294	1996	+	702	0	0	10639
Q9NTW7-1#25	0	690	690	Q9NTW7-1	1245	1935	+	690	Q9NTW7-1	884	1442	ENST00000456175.5	0	361	+	103	Q9NTW7-1#25	180	197	ENST00000456175.5	344	361	+	17	180	493	10640
Q9NTW7-1#25	0	690	690	Q9NTW7-1	1245	1935	+	690	Q9NTW7-1	763	1254	ENST00000395989.7	271	762	+	66	Q9NTW7-1#25	0	9	ENST00000395989.7	753	762	+	9	0	681	10641
Q9NTW7-1#25	0	690	690	Q9NTW7-1	1245	1935	+	690	Q9NTW7-1	714	1935	ENST00000371523.8	464	1685	++	47	Q9NTW7-1#25	0	690	ENST00000371523.8	995	1685	+	690	0	0	10642
Q9NTW7-1#25	0	690	690	Q9NTW7-1	1245	1935	+	690	Q9NTW7-1	0	1935	ENST00000361387.6	61	1996	++	39	Q9NTW7-1#25	0	690	ENST00000361387.6	1306	1996	+	690	0	0	10643
Q9NTW7-1#26	0	3	3	Q9NTW7-1	201	204	+	3	Q9NTW7-1	0	1230	ENST00000371518.6	143	1373	++	46	Q9NTW7-1#26	0	3	ENST00000371518.6	344	347	+	3	0	0	10644
Q9NTW7-1#26	0	3	3	Q9NTW7-1	201	204	+	3	Q9NTW7-1	0	1935	ENST00000361387.6	61	1996	++	39	Q9NTW7-1#26	0	3	ENST00000361387.6	262	265	+	3	0	0	10645
Q9NTW7-1#27	0	3	3	Q9NTW7-1	414	417	+	3	Q9NTW7-1	0	1230	ENST00000371518.6	143	1373	++	46	Q9NTW7-1#27	0	3	ENST00000371518.6	557	560	+	3	0	0	10646
Q9NTW7-1#27	0	3	3	Q9NTW7-1	414	417	+	3	Q9NTW7-1	0	1935	ENST00000361387.6	61	1996	++	39	Q9NTW7-1#27	0	3	ENST00000361387.6	475	478	+	3	0	0	10647
Q9NTW7-1#28	0	3	3	Q9NTW7-1	1776	1779	+	3	Q9NTW7-1	714	1935	ENST00000371523.8	464	1685	++	47	Q9NTW7-1#28	0	3	ENST00000371523.8	1526	1529	+	3	0	0	10648
Q9NTW7-1#28	0	3	3	Q9NTW7-1	1776	1779	+	3	Q9NTW7-1	0	1935	ENST00000361387.6	61	1996	++	39	Q9NTW7-1#28	0	3	ENST00000361387.6	1837	1840	+	3	0	0	10649
Q9NTW7-1#29	0	3	3	Q9NTW7-1	1824	1827	+	3	Q9NTW7-1	714	1935	ENST00000371523.8	464	1685	++	47	Q9NTW7-1#29	0	3	ENST00000371523.8	1574	1577	+	3	0	0	10650
Q9NTW7-1#29	0	3	3	Q9NTW7-1	1824	1827	+	3	Q9NTW7-1	0	1935	ENST00000361387.6	61	1996	++	39	Q9NTW7-1#29	0	3	ENST00000361387.6	1885	1888	+	3	0	0	10651
Q9NTW7-1#30	0	3	3	Q9NTW7-1	717	720	+	3	Q9NTW7-1	714	1935	ENST00000371523.8	464	1685	++	47	Q9NTW7-1#30	0	3	ENST00000371523.8	467	470	+	3	0	0	10652
Q9NTW7-1#30	0	3	3	Q9NTW7-1	717	720	+	3	Q9NTW7-1	0	1230	ENST00000371518.6	143	1373	++	46	Q9NTW7-1#30	0	3	ENST00000371518.6	860	863	+	3	0	0	10653
Q9NTW7-1#30	0	3	3	Q9NTW7-1	717	720	+	3	Q9NTW7-1	0	1935	ENST00000361387.6	61	1996	++	39	Q9NTW7-1#30	0	3	ENST00000361387.6	778	781	+	3	0	0	10654
Q9NTW7-1#31	0	3	3	Q9NTW7-1	1560	1563	+	3	Q9NTW7-1	714	1935	ENST00000371523.8	464	1685	++	47	Q9NTW7-1#31	0	3	ENST00000371523.8	1310	1313	+	3	0	0	10655
Q9NTW7-1#31	0	3	3	Q9NTW7-1	1560	1563	+	3	Q9NTW7-1	0	1935	ENST00000361387.6	61	1996	++	39	Q9NTW7-1#31	0	3	ENST00000361387.6	1621	1624	+	3	0	0	10656
Q9NTW7-1#32	0	9	9	Q9NTW7-1	531	540	+	9	Q9NTW7-1	0	1230	ENST00000371518.6	143	1373	++	46	Q9NTW7-1#32	0	9	ENST00000371518.6	674	683	+	9	0	0	10657
Q9NTW7-1#32	0	9	9	Q9NTW7-1	531	540	+	9	Q9NTW7-1	0	1935	ENST00000361387.6	61	1996	++	39	Q9NTW7-1#32	0	9	ENST00000361387.6	592	601	+	9	0	0	10658
Q9NTW7-1#33	0	21	21	Q9NTW7-1	558	579	+	21	Q9NTW7-1	0	1230	ENST00000371518.6	143	1373	++	46	Q9NTW7-1#33	0	21	ENST00000371518.6	701	722	+	21	0	0	10659
Q9NTW7-1#33	0	21	21	Q9NTW7-1	558	579	+	21	Q9NTW7-1	0	1935	ENST00000361387.6	61	1996	++	39	Q9NTW7-1#33	0	21	ENST00000361387.6	619	640	+	21	0	0	10660
Q9NTW7-1#34	0	9	9	Q9NTW7-1	579	588	+	9	Q9NTW7-1	0	1230	ENST00000371518.6	143	1373	++	46	Q9NTW7-1#34	0	9	ENST00000371518.6	722	731	+	9	0	0	10661
Q9NTW7-1#34	0	9	9	Q9NTW7-1	579	588	+	9	Q9NTW7-1	0	1935	ENST00000361387.6	61	1996	++	39	Q9NTW7-1#34	0	9	ENST00000361387.6	640	649	+	9	0	0	10662
Q9NTW7-1#35	0	9	9	Q9NTW7-1	603	612	+	9	Q9NTW7-1	0	1230	ENST00000371518.6	143	1373	++	46	Q9NTW7-1#35	0	9	ENST00000371518.6	746	755	+	9	0	0	10663
Q9NTW7-1#35	0	9	9	Q9NTW7-1	603	612	+	9	Q9NTW7-1	0	1935	ENST00000361387.6	61	1996	++	39	Q9NTW7-1#35	0	9	ENST00000361387.6	664	673	+	9	0	0	10664
Q9NTW7-1#36	0	9	9	Q9NTW7-1	615	624	+	9	Q9NTW7-1	0	1230	ENST00000371518.6	143	1373	++	46	Q9NTW7-1#36	0	9	ENST00000371518.6	758	767	+	9	0	0	10665
Q9NTW7-1#36	0	9	9	Q9NTW7-1	615	624	+	9	Q9NTW7-1	0	1935	ENST00000361387.6	61	1996	++	39	Q9NTW7-1#36	0	9	ENST00000361387.6	676	685	+	9	0	0	10666
Q9NTW7-1#37	0	12	12	Q9NTW7-1	630	642	+	12	Q9NTW7-1	0	1230	ENST00000371518.6	143	1373	++	46	Q9NTW7-1#37	0	12	ENST00000371518.6	773	785	+	12	0	0	10667
Q9NTW7-1#37	0	12	12	Q9NTW7-1	630	642	+	12	Q9NTW7-1	0	1935	ENST00000361387.6	61	1996	++	39	Q9NTW7-1#37	0	12	ENST00000361387.6	691	703	+	12	0	0	10668
Q9NTW7-1#38	0	30	30	Q9NTW7-1	642	672	+	30	Q9NTW7-1	0	1230	ENST00000371518.6	143	1373	++	46	Q9NTW7-1#38	0	30	ENST00000371518.6	785	815	+	30	0	0	10669
Q9NTW7-1#38	0	30	30	Q9NTW7-1	642	672	+	30	Q9NTW7-1	0	1935	ENST00000361387.6	61	1996	++	39	Q9NTW7-1#38	0	30	ENST00000361387.6	703	733	+	30	0	0	10670
Q9NTW7-1#39	0	12	12	Q9NTW7-1	699	711	+	12	Q9NTW7-1	0	1230	ENST00000371518.6	143	1373	++	46	Q9NTW7-1#39	0	12	ENST00000371518.6	842	854	+	12	0	0	10671
Q9NTW7-1#39	0	12	12	Q9NTW7-1	699	711	+	12	Q9NTW7-1	0	1935	ENST00000361387.6	61	1996	++	39	Q9NTW7-1#39	0	12	ENST00000361387.6	760	772	+	12	0	0	10672
Q9NTW7-1#40	0	12	12	Q9NTW7-1	714	726	+	12	Q9NTW7-1	714	1935	ENST00000371523.8	464	1685	++	47	Q9NTW7-1#40	0	12	ENST00000371523.8	464	476	+	12	0	0	10673
Q9NTW7-1#40	0	12	12	Q9NTW7-1	714	726	+	12	Q9NTW7-1	0	1230	ENST00000371518.6	143	1373	++	46	Q9NTW7-1#40	0	12	ENST00000371518.6	857	869	+	12	0	0	10674
Q9NTW7-1#40	0	12	12	Q9NTW7-1	714	726	+	12	Q9NTW7-1	0	1935	ENST00000361387.6	61	1996	++	39	Q9NTW7-1#40	0	12	ENST00000361387.6	775	787	+	12	0	0	10675
Q9NTW7-1#41	0	24	24	Q9NTW7-1	726	750	+	24	Q9NTW7-1	714	1935	ENST00000371523.8	464	1685	++	47	Q9NTW7-1#41	0	24	ENST00000371523.8	476	500	+	24	0	0	10676
Q9NTW7-1#41	0	24	24	Q9NTW7-1	726	750	+	24	Q9NTW7-1	0	1230	ENST00000371518.6	143	1373	++	46	Q9NTW7-1#41	0	24	ENST00000371518.6	869	893	+	24	0	0	10677
Q9NTW7-1#41	0	24	24	Q9NTW7-1	726	750	+	24	Q9NTW7-1	0	1935	ENST00000361387.6	61	1996	++	39	Q9NTW7-1#41	0	24	ENST00000361387.6	787	811	+	24	0	0	10678
Q9NTW7-1#42	0	9	9	Q9NTW7-1	1479	1488	+	9	Q9NTW7-1	714	1935	ENST00000371523.8	464	1685	++	47	Q9NTW7-1#42	0	9	ENST00000371523.8	1229	1238	+	9	0	0	10679
Q9NTW7-1#42	0	9	9	Q9NTW7-1	1479	1488	+	9	Q9NTW7-1	0	1935	ENST00000361387.6	61	1996	++	39	Q9NTW7-1#42	0	9	ENST00000361387.6	1540	1549	+	9	0	0	10680
Q9NTW7-1#43	0	12	12	Q9NTW7-1	1491	1503	+	12	Q9NTW7-1	714	1935	ENST00000371523.8	464	1685	++	47	Q9NTW7-1#43	0	12	ENST00000371523.8	1241	1253	+	12	0	0	10681
Q9NTW7-1#43	0	12	12	Q9NTW7-1	1491	1503	+	12	Q9NTW7-1	0	1935	ENST00000361387.6	61	1996	++	39	Q9NTW7-1#43	0	12	ENST00000361387.6	1552	1564	+	12	0	0	10682
Q9NTW7-1#44	0	12	12	Q9NTW7-1	1506	1518	+	12	Q9NTW7-1	714	1935	ENST00000371523.8	464	1685	++	47	Q9NTW7-1#44	0	12	ENST00000371523.8	1256	1268	+	12	0	0	10683
Q9NTW7-1#44	0	12	12	Q9NTW7-1	1506	1518	+	12	Q9NTW7-1	0	1935	ENST00000361387.6	61	1996	++	39	Q9NTW7-1#44	0	12	ENST00000361387.6	1567	1579	+	12	0	0	10684
Q9NTW7-1#45	0	24	24	Q9NTW7-1	1518	1542	+	24	Q9NTW7-1	714	1935	ENST00000371523.8	464	1685	++	47	Q9NTW7-1#45	0	24	ENST00000371523.8	1268	1292	+	24	0	0	10685
Q9NTW7-1#45	0	24	24	Q9NTW7-1	1518	1542	+	24	Q9NTW7-1	0	1935	ENST00000361387.6	61	1996	++	39	Q9NTW7-1#45	0	24	ENST00000361387.6	1579	1603	+	24	0	0	10686
Q9NTW7-1#46	0	9	9	Q9NTW7-1	1542	1551	+	9	Q9NTW7-1	714	1935	ENST00000371523.8	464	1685	++	47	Q9NTW7-1#46	0	9	ENST00000371523.8	1292	1301	+	9	0	0	10687
Q9NTW7-1#46	0	9	9	Q9NTW7-1	1542	1551	+	9	Q9NTW7-1	0	1935	ENST00000361387.6	61	1996	++	39	Q9NTW7-1#46	0	9	ENST00000361387.6	1603	1612	+	9	0	0	10688
Q9NTW7-1#47	0	9	9	Q9NTW7-1	1563	1572	+	9	Q9NTW7-1	714	1935	ENST00000371523.8	464	1685	++	47	Q9NTW7-1#47	0	9	ENST00000371523.8	1313	1322	+	9	0	0	10689
Q9NTW7-1#47	0	9	9	Q9NTW7-1	1563	1572	+	9	Q9NTW7-1	0	1935	ENST00000361387.6	61	1996	++	39	Q9NTW7-1#47	0	9	ENST00000361387.6	1624	1633	+	9	0	0	10690
Q9NTW7-1#48	0	12	12	Q9NTW7-1	1575	1587	+	12	Q9NTW7-1	714	1935	ENST00000371523.8	464	1685	++	47	Q9NTW7-1#48	0	12	ENST00000371523.8	1325	1337	+	12	0	0	10691
Q9NTW7-1#48	0	12	12	Q9NTW7-1	1575	1587	+	12	Q9NTW7-1	0	1935	ENST00000361387.6	61	1996	++	39	Q9NTW7-1#48	0	12	ENST00000361387.6	1636	1648	+	12	0	0	10692
Q9NTW7-1#49	0	12	12	Q9NTW7-1	1590	1602	+	12	Q9NTW7-1	714	1935	ENST00000371523.8	464	1685	++	47	Q9NTW7-1#49	0	12	ENST00000371523.8	1340	1352	+	12	0	0	10693
Q9NTW7-1#49	0	12	12	Q9NTW7-1	1590	1602	+	12	Q9NTW7-1	0	1935	ENST00000361387.6	61	1996	++	39	Q9NTW7-1#49	0	12	ENST00000361387.6	1651	1663	+	12	0	0	10694
Q9NTW7-1#50	0	36	36	Q9NTW7-1	1602	1638	+	36	Q9NTW7-1	714	1935	ENST00000371523.8	464	1685	++	47	Q9NTW7-1#50	0	36	ENST00000371523.8	1352	1388	+	36	0	0	10695
Q9NTW7-1#50	0	36	36	Q9NTW7-1	1602	1638	+	36	Q9NTW7-1	0	1935	ENST00000361387.6	61	1996	++	39	Q9NTW7-1#50	0	36	ENST00000361387.6	1663	1699	+	36	0	0	10696
Q9NTW7-1#51	0	3	3	Q9NTW7-1	1632	1635	+	3	Q9NTW7-1	714	1935	ENST00000371523.8	464	1685	++	47	Q9NTW7-1#51	0	3	ENST00000371523.8	1382	1385	+	3	0	0	10697
Q9NTW7-1#51	0	3	3	Q9NTW7-1	1632	1635	+	3	Q9NTW7-1	0	1935	ENST00000361387.6	61	1996	++	39	Q9NTW7-1#51	0	3	ENST00000361387.6	1693	1696	+	3	0	0	10698
Q9NTW7-1#52	0	3	3	Q9NTW7-1	855	858	+	3	Q9NTW7-1	763	1254	ENST00000395989.7	271	762	+	66	Q9NTW7-1#52	0	3	ENST00000395989.7	363	366	+	3	0	0	10699
Q9NTW7-1#52	0	3	3	Q9NTW7-1	855	858	+	3	Q9NTW7-1	763	976	ENST00000395979.1	198	411	+	65	Q9NTW7-1#52	0	3	ENST00000395979.1	290	293	+	3	0	0	10700
Q9NTW7-1#52	0	3	3	Q9NTW7-1	855	858	+	3	Q9NTW7-1	714	1935	ENST00000371523.8	464	1685	++	47	Q9NTW7-1#52	0	3	ENST00000371523.8	605	608	+	3	0	0	10701
Q9NTW7-1#52	0	3	3	Q9NTW7-1	855	858	+	3	Q9NTW7-1	0	1230	ENST00000371518.6	143	1373	++	46	Q9NTW7-1#52	0	3	ENST00000371518.6	998	1001	+	3	0	0	10702
Q9NTW7-1#52	0	3	3	Q9NTW7-1	855	858	+	3	Q9NTW7-1	0	1935	ENST00000361387.6	61	1996	++	39	Q9NTW7-1#52	0	3	ENST00000361387.6	916	919	+	3	0	0	10703
Q9NTW7-1#53	0	3	3	Q9NTW7-1	1188	1191	+	3	Q9NTW7-1	884	1442	ENST00000456175.5	0	361	+	103	Q9NTW7-1#53	0	3	ENST00000456175.5	304	307	+	3	0	0	10704
Q9NTW7-1#53	0	3	3	Q9NTW7-1	1188	1191	+	3	Q9NTW7-1	763	1254	ENST00000395989.7	271	762	+	66	Q9NTW7-1#53	0	3	ENST00000395989.7	696	699	+	3	0	0	10705
Q9NTW7-1#53	0	3	3	Q9NTW7-1	1188	1191	+	3	Q9NTW7-1	714	1935	ENST00000371523.8	464	1685	++	47	Q9NTW7-1#53	0	3	ENST00000371523.8	938	941	+	3	0	0	10706
Q9NTW7-1#53	0	3	3	Q9NTW7-1	1188	1191	+	3	Q9NTW7-1	0	1230	ENST00000371518.6	143	1373	++	46	Q9NTW7-1#53	0	3	ENST00000371518.6	1331	1334	+	3	0	0	10707
Q9NTW7-1#53	0	3	3	Q9NTW7-1	1188	1191	+	3	Q9NTW7-1	0	1935	ENST00000361387.6	61	1996	++	39	Q9NTW7-1#53	0	3	ENST00000361387.6	1249	1252	+	3	0	0	10708
Q9NTW7-1#54	0	3	3	Q9NTW7-1	1272	1275	+	3	Q9NTW7-1	714	1935	ENST00000371523.8	464	1685	++	47	Q9NTW7-1#54	0	3	ENST00000371523.8	1022	1025	+	3	0	0	10709
Q9NTW7-1#54	0	3	3	Q9NTW7-1	1272	1275	+	3	Q9NTW7-1	0	1935	ENST00000361387.6	61	1996	++	39	Q9NTW7-1#54	0	3	ENST00000361387.6	1333	1336	+	3	0	0	10710
Q9NTW7-1#55	0	3	3	Q9NTW7-1	1350	1353	+	3	Q9NTW7-1	714	1935	ENST00000371523.8	464	1685	++	47	Q9NTW7-1#55	0	3	ENST00000371523.8	1100	1103	+	3	0	0	10711
Q9NTW7-1#55	0	3	3	Q9NTW7-1	1350	1353	+	3	Q9NTW7-1	0	1935	ENST00000361387.6	61	1996	++	39	Q9NTW7-1#55	0	3	ENST00000361387.6	1411	1414	+	3	0	0	10712
