#srcQName	srcQStart	srcQEnd	srcQSize	srcTName	srcTStart	srcTEnd	srcStrand	srcAligned	mappingQName	mappingQStart	mappingQEnd	mappingTName	mappingTStart	mappingTEnd	mappingStrand	mappingId	mappedQName	mappedQStart	mappedQEnd	mappedTName	mappedTStart	mappedTEnd	mappedStrand	mappedAligned	qStartTrunc	qEndTrunc	mappedPslLine
P00519-1#0	0	1130	1130	P00519-1	0	1130	+	1130	P00519-1	23	46	ENST00000393293.4	463	532	++	63	P00519-1#0	69	138	ENST00000393293.4	463	532	+	69	69	992	0
P00519-1#0	0	1130	1130	P00519-1	0	1130	+	1130	P00519-1	26	1130	ENST00000372348.9	1412	4724	++	47	P00519-1#0	78	3390	ENST00000372348.9	1412	4724	+	3312	78	-2260	1
P00519-1#0	0	1130	1130	P00519-1	0	1130	+	1130	P00519-1	0	1130	ENST00000318560.6	193	3583	++	25	P00519-1#0	0	3390	ENST00000318560.6	193	3583	+	3390	0	-2260	2
P00519-1#1	0	61	61	P00519-1	60	121	+	61	P00519-1	26	1130	ENST00000372348.9	1412	4724	++	47	P00519-1#1	0	183	ENST00000372348.9	1514	1697	+	183	0	-122	3
P00519-1#1	0	61	61	P00519-1	60	121	+	61	P00519-1	0	1130	ENST00000318560.6	193	3583	++	25	P00519-1#1	0	183	ENST00000318560.6	373	556	+	183	0	-122	4
P00519-1#2	0	91	91	P00519-1	126	217	+	91	P00519-1	26	1130	ENST00000372348.9	1412	4724	++	47	P00519-1#2	0	273	ENST00000372348.9	1712	1985	+	273	0	-182	5
P00519-1#2	0	91	91	P00519-1	126	217	+	91	P00519-1	0	1130	ENST00000318560.6	193	3583	++	25	P00519-1#2	0	273	ENST00000318560.6	571	844	+	273	0	-182	6
P00519-1#3	0	252	252	P00519-1	241	493	+	252	P00519-1	26	1130	ENST00000372348.9	1412	4724	++	47	P00519-1#3	0	756	ENST00000372348.9	2057	2813	+	756	0	-504	7
P00519-1#3	0	252	252	P00519-1	241	493	+	252	P00519-1	0	1130	ENST00000318560.6	193	3583	++	25	P00519-1#3	0	756	ENST00000318560.6	916	1672	+	756	0	-504	8
P00519-1#4	0	60	60	P00519-1	0	60	+	60	P00519-1	23	46	ENST00000393293.4	463	532	++	63	P00519-1#4	69	138	ENST00000393293.4	463	532	+	69	69	-78	9
P00519-1#4	0	60	60	P00519-1	0	60	+	60	P00519-1	26	1130	ENST00000372348.9	1412	4724	++	47	P00519-1#4	78	180	ENST00000372348.9	1412	1514	+	102	78	-120	10
P00519-1#4	0	60	60	P00519-1	0	60	+	60	P00519-1	0	1130	ENST00000318560.6	193	3583	++	25	P00519-1#4	0	180	ENST00000318560.6	193	373	+	180	0	-120	11
P00519-1#5	0	479	479	P00519-1	517	996	+	479	P00519-1	26	1130	ENST00000372348.9	1412	4724	++	47	P00519-1#5	0	1437	ENST00000372348.9	2885	4322	+	1437	0	-958	12
P00519-1#5	0	479	479	P00519-1	517	996	+	479	P00519-1	0	1130	ENST00000318560.6	193	3583	++	25	P00519-1#5	0	1437	ENST00000318560.6	1744	3181	+	1437	0	-958	13
P00519-1#6	0	100	100	P00519-1	868	968	+	100	P00519-1	26	1130	ENST00000372348.9	1412	4724	++	47	P00519-1#6	0	300	ENST00000372348.9	3938	4238	+	300	0	-200	14
P00519-1#6	0	100	100	P00519-1	868	968	+	100	P00519-1	0	1130	ENST00000318560.6	193	3583	++	25	P00519-1#6	0	300	ENST00000318560.6	2797	3097	+	300	0	-200	15
P00519-1#7	0	178	178	P00519-1	952	1130	+	178	P00519-1	26	1130	ENST00000372348.9	1412	4724	++	47	P00519-1#7	0	534	ENST00000372348.9	4190	4724	+	534	0	-356	16
P00519-1#7	0	178	178	P00519-1	952	1130	+	178	P00519-1	0	1130	ENST00000318560.6	193	3583	++	25	P00519-1#7	0	534	ENST00000318560.6	3049	3583	+	534	0	-356	17
P00519-1#8	0	25	25	P00519-1	380	405	+	25	P00519-1	26	1130	ENST00000372348.9	1412	4724	++	47	P00519-1#8	0	75	ENST00000372348.9	2474	2549	+	75	0	-50	18
P00519-1#8	0	25	25	P00519-1	380	405	+	25	P00519-1	0	1130	ENST00000318560.6	193	3583	++	25	P00519-1#8	0	75	ENST00000318560.6	1333	1408	+	75	0	-50	19
P00519-1#9	0	5	5	P00519-1	604	609	+	5	P00519-1	26	1130	ENST00000372348.9	1412	4724	++	47	P00519-1#9	0	15	ENST00000372348.9	3146	3161	+	15	0	-10	20
P00519-1#9	0	5	5	P00519-1	604	609	+	5	P00519-1	0	1130	ENST00000318560.6	193	3583	++	25	P00519-1#9	0	15	ENST00000318560.6	2005	2020	+	15	0	-10	21
P00519-1#10	0	7	7	P00519-1	708	715	+	7	P00519-1	26	1130	ENST00000372348.9	1412	4724	++	47	P00519-1#10	0	21	ENST00000372348.9	3458	3479	+	21	0	-14	22
P00519-1#10	0	7	7	P00519-1	708	715	+	7	P00519-1	0	1130	ENST00000318560.6	193	3583	++	25	P00519-1#10	0	21	ENST00000318560.6	2317	2338	+	21	0	-14	23
P00519-1#11	0	8	8	P00519-1	761	769	+	8	P00519-1	26	1130	ENST00000372348.9	1412	4724	++	47	P00519-1#11	0	24	ENST00000372348.9	3617	3641	+	24	0	-16	24
P00519-1#11	0	8	8	P00519-1	761	769	+	8	P00519-1	0	1130	ENST00000318560.6	193	3583	++	25	P00519-1#11	0	24	ENST00000318560.6	2476	2500	+	24	0	-16	25
P00519-1#12	0	11	11	P00519-1	1089	1100	+	11	P00519-1	26	1130	ENST00000372348.9	1412	4724	++	47	P00519-1#12	0	33	ENST00000372348.9	4601	4634	+	33	0	-22	26
P00519-1#12	0	11	11	P00519-1	1089	1100	+	11	P00519-1	0	1130	ENST00000318560.6	193	3583	++	25	P00519-1#12	0	33	ENST00000318560.6	3460	3493	+	33	0	-22	27
P00519-1#13	0	17	17	P00519-1	532	549	+	17	P00519-1	26	1130	ENST00000372348.9	1412	4724	++	47	P00519-1#13	0	51	ENST00000372348.9	2930	2981	+	51	0	-34	28
P00519-1#13	0	17	17	P00519-1	532	549	+	17	P00519-1	0	1130	ENST00000318560.6	193	3583	++	25	P00519-1#13	0	51	ENST00000318560.6	1789	1840	+	51	0	-34	29
P00519-1#14	0	23	23	P00519-1	578	601	+	23	P00519-1	26	1130	ENST00000372348.9	1412	4724	++	47	P00519-1#14	0	69	ENST00000372348.9	3068	3137	+	69	0	-46	30
P00519-1#14	0	23	23	P00519-1	578	601	+	23	P00519-1	0	1130	ENST00000318560.6	193	3583	++	25	P00519-1#14	0	69	ENST00000318560.6	1927	1996	+	69	0	-46	31
P00519-1#15	0	17	17	P00519-1	621	638	+	17	P00519-1	26	1130	ENST00000372348.9	1412	4724	++	47	P00519-1#15	0	51	ENST00000372348.9	3197	3248	+	51	0	-34	32
P00519-1#15	0	17	17	P00519-1	621	638	+	17	P00519-1	0	1130	ENST00000318560.6	193	3583	++	25	P00519-1#15	0	51	ENST00000318560.6	2056	2107	+	51	0	-34	33
P00519-1#16	0	19	19	P00519-1	684	703	+	19	P00519-1	26	1130	ENST00000372348.9	1412	4724	++	47	P00519-1#16	0	57	ENST00000372348.9	3386	3443	+	57	0	-38	34
P00519-1#16	0	19	19	P00519-1	684	703	+	19	P00519-1	0	1130	ENST00000318560.6	193	3583	++	25	P00519-1#16	0	57	ENST00000318560.6	2245	2302	+	57	0	-38	35
P00519-1#17	0	19	19	P00519-1	734	753	+	19	P00519-1	26	1130	ENST00000372348.9	1412	4724	++	47	P00519-1#17	0	57	ENST00000372348.9	3536	3593	+	57	0	-38	36
P00519-1#17	0	19	19	P00519-1	734	753	+	19	P00519-1	0	1130	ENST00000318560.6	193	3583	++	25	P00519-1#17	0	57	ENST00000318560.6	2395	2452	+	57	0	-38	37
P00519-1#18	0	15	15	P00519-1	757	772	+	15	P00519-1	26	1130	ENST00000372348.9	1412	4724	++	47	P00519-1#18	0	45	ENST00000372348.9	3605	3650	+	45	0	-30	38
P00519-1#18	0	15	15	P00519-1	757	772	+	15	P00519-1	0	1130	ENST00000318560.6	193	3583	++	25	P00519-1#18	0	45	ENST00000318560.6	2464	2509	+	45	0	-30	39
P00519-1#19	0	25	25	P00519-1	869	894	+	25	P00519-1	26	1130	ENST00000372348.9	1412	4724	++	47	P00519-1#19	0	75	ENST00000372348.9	3941	4016	+	75	0	-50	40
P00519-1#19	0	25	25	P00519-1	869	894	+	25	P00519-1	0	1130	ENST00000318560.6	193	3583	++	25	P00519-1#19	0	75	ENST00000318560.6	2800	2875	+	75	0	-50	41
P00519-1#20	0	1	1	P00519-1	362	363	+	1	P00519-1	26	1130	ENST00000372348.9	1412	4724	++	47	P00519-1#20	0	3	ENST00000372348.9	2420	2423	+	3	0	-2	42
P00519-1#20	0	1	1	P00519-1	362	363	+	1	P00519-1	0	1130	ENST00000318560.6	193	3583	++	25	P00519-1#20	0	3	ENST00000318560.6	1279	1282	+	3	0	-2	43
P00519-1#21	0	9	9	P00519-1	247	256	+	9	P00519-1	26	1130	ENST00000372348.9	1412	4724	++	47	P00519-1#21	0	27	ENST00000372348.9	2075	2102	+	27	0	-18	44
P00519-1#21	0	9	9	P00519-1	247	256	+	9	P00519-1	0	1130	ENST00000318560.6	193	3583	++	25	P00519-1#21	0	27	ENST00000318560.6	934	961	+	27	0	-18	45
P00519-1#22	0	1	1	P00519-1	270	271	+	1	P00519-1	26	1130	ENST00000372348.9	1412	4724	++	47	P00519-1#22	0	3	ENST00000372348.9	2144	2147	+	3	0	-2	46
P00519-1#22	0	1	1	P00519-1	270	271	+	1	P00519-1	0	1130	ENST00000318560.6	193	3583	++	25	P00519-1#22	0	3	ENST00000318560.6	1003	1006	+	3	0	-2	47
P00519-1#23	0	7	7	P00519-1	315	322	+	7	P00519-1	26	1130	ENST00000372348.9	1412	4724	++	47	P00519-1#23	0	21	ENST00000372348.9	2279	2300	+	21	0	-14	48
P00519-1#23	0	7	7	P00519-1	315	322	+	7	P00519-1	0	1130	ENST00000318560.6	193	3583	++	25	P00519-1#23	0	21	ENST00000318560.6	1138	1159	+	21	0	-14	49
P00519-1#24	0	2	2	P00519-1	25	27	+	2	P00519-1	23	46	ENST00000393293.4	463	532	++	63	P00519-1#24	0	6	ENST00000393293.4	469	475	+	6	0	-4	50
P00519-1#24	0	2	2	P00519-1	25	27	+	2	P00519-1	26	1130	ENST00000372348.9	1412	4724	++	47	P00519-1#24	3	6	ENST00000372348.9	1412	1415	+	3	3	-4	51
P00519-1#24	0	2	2	P00519-1	25	27	+	2	P00519-1	0	1130	ENST00000318560.6	193	3583	++	25	P00519-1#24	0	6	ENST00000318560.6	268	274	+	6	0	-4	52
P00519-1#25	0	1	1	P00519-1	49	50	+	1	P00519-1	26	1130	ENST00000372348.9	1412	4724	++	47	P00519-1#25	0	3	ENST00000372348.9	1481	1484	+	3	0	-2	53
P00519-1#25	0	1	1	P00519-1	49	50	+	1	P00519-1	0	1130	ENST00000318560.6	193	3583	++	25	P00519-1#25	0	3	ENST00000318560.6	340	343	+	3	0	-2	54
P00519-1#26	0	1	1	P00519-1	69	70	+	1	P00519-1	26	1130	ENST00000372348.9	1412	4724	++	47	P00519-1#26	0	3	ENST00000372348.9	1541	1544	+	3	0	-2	55
P00519-1#26	0	1	1	P00519-1	69	70	+	1	P00519-1	0	1130	ENST00000318560.6	193	3583	++	25	P00519-1#26	0	3	ENST00000318560.6	400	403	+	3	0	-2	56
P00519-1#27	0	1	1	P00519-1	114	115	+	1	P00519-1	26	1130	ENST00000372348.9	1412	4724	++	47	P00519-1#27	0	3	ENST00000372348.9	1676	1679	+	3	0	-2	57
P00519-1#27	0	1	1	P00519-1	114	115	+	1	P00519-1	0	1130	ENST00000318560.6	193	3583	++	25	P00519-1#27	0	3	ENST00000318560.6	535	538	+	3	0	-2	58
P00519-1#28	0	1	1	P00519-1	127	128	+	1	P00519-1	26	1130	ENST00000372348.9	1412	4724	++	47	P00519-1#28	0	3	ENST00000372348.9	1715	1718	+	3	0	-2	59
P00519-1#28	0	1	1	P00519-1	127	128	+	1	P00519-1	0	1130	ENST00000318560.6	193	3583	++	25	P00519-1#28	0	3	ENST00000318560.6	574	577	+	3	0	-2	60
P00519-1#29	0	1	1	P00519-1	138	139	+	1	P00519-1	26	1130	ENST00000372348.9	1412	4724	++	47	P00519-1#29	0	3	ENST00000372348.9	1748	1751	+	3	0	-2	61
P00519-1#29	0	1	1	P00519-1	138	139	+	1	P00519-1	0	1130	ENST00000318560.6	193	3583	++	25	P00519-1#29	0	3	ENST00000318560.6	607	610	+	3	0	-2	62
P00519-1#30	0	1	1	P00519-1	171	172	+	1	P00519-1	26	1130	ENST00000372348.9	1412	4724	++	47	P00519-1#30	0	3	ENST00000372348.9	1847	1850	+	3	0	-2	63
P00519-1#30	0	1	1	P00519-1	171	172	+	1	P00519-1	0	1130	ENST00000318560.6	193	3583	++	25	P00519-1#30	0	3	ENST00000318560.6	706	709	+	3	0	-2	64
P00519-1#31	0	1	1	P00519-1	184	185	+	1	P00519-1	26	1130	ENST00000372348.9	1412	4724	++	47	P00519-1#31	0	3	ENST00000372348.9	1886	1889	+	3	0	-2	65
P00519-1#31	0	1	1	P00519-1	184	185	+	1	P00519-1	0	1130	ENST00000318560.6	193	3583	++	25	P00519-1#31	0	3	ENST00000318560.6	745	748	+	3	0	-2	66
P00519-1#32	0	1	1	P00519-1	214	215	+	1	P00519-1	26	1130	ENST00000372348.9	1412	4724	++	47	P00519-1#32	0	3	ENST00000372348.9	1976	1979	+	3	0	-2	67
P00519-1#32	0	1	1	P00519-1	214	215	+	1	P00519-1	0	1130	ENST00000318560.6	193	3583	++	25	P00519-1#32	0	3	ENST00000318560.6	835	838	+	3	0	-2	68
P00519-1#33	0	1	1	P00519-1	225	226	+	1	P00519-1	26	1130	ENST00000372348.9	1412	4724	++	47	P00519-1#33	0	3	ENST00000372348.9	2009	2012	+	3	0	-2	69
P00519-1#33	0	1	1	P00519-1	225	226	+	1	P00519-1	0	1130	ENST00000318560.6	193	3583	++	25	P00519-1#33	0	3	ENST00000318560.6	868	871	+	3	0	-2	70
P00519-1#34	0	1	1	P00519-1	228	229	+	1	P00519-1	26	1130	ENST00000372348.9	1412	4724	++	47	P00519-1#34	0	3	ENST00000372348.9	2018	2021	+	3	0	-2	71
P00519-1#34	0	1	1	P00519-1	228	229	+	1	P00519-1	0	1130	ENST00000318560.6	193	3583	++	25	P00519-1#34	0	3	ENST00000318560.6	877	880	+	3	0	-2	72
P00519-1#35	0	1	1	P00519-1	252	253	+	1	P00519-1	26	1130	ENST00000372348.9	1412	4724	++	47	P00519-1#35	0	3	ENST00000372348.9	2090	2093	+	3	0	-2	73
P00519-1#35	0	1	1	P00519-1	252	253	+	1	P00519-1	0	1130	ENST00000318560.6	193	3583	++	25	P00519-1#35	0	3	ENST00000318560.6	949	952	+	3	0	-2	74
P00519-1#36	0	1	1	P00519-1	256	257	+	1	P00519-1	26	1130	ENST00000372348.9	1412	4724	++	47	P00519-1#36	0	3	ENST00000372348.9	2102	2105	+	3	0	-2	75
P00519-1#36	0	1	1	P00519-1	256	257	+	1	P00519-1	0	1130	ENST00000318560.6	193	3583	++	25	P00519-1#36	0	3	ENST00000318560.6	961	964	+	3	0	-2	76
P00519-1#37	0	1	1	P00519-1	392	393	+	1	P00519-1	26	1130	ENST00000372348.9	1412	4724	++	47	P00519-1#37	0	3	ENST00000372348.9	2510	2513	+	3	0	-2	77
P00519-1#37	0	1	1	P00519-1	392	393	+	1	P00519-1	0	1130	ENST00000318560.6	193	3583	++	25	P00519-1#37	0	3	ENST00000318560.6	1369	1372	+	3	0	-2	78
P00519-1#38	0	1	1	P00519-1	412	413	+	1	P00519-1	26	1130	ENST00000372348.9	1412	4724	++	47	P00519-1#38	0	3	ENST00000372348.9	2570	2573	+	3	0	-2	79
P00519-1#38	0	1	1	P00519-1	412	413	+	1	P00519-1	0	1130	ENST00000318560.6	193	3583	++	25	P00519-1#38	0	3	ENST00000318560.6	1429	1432	+	3	0	-2	80
P00519-1#39	0	1	1	P00519-1	445	446	+	1	P00519-1	26	1130	ENST00000372348.9	1412	4724	++	47	P00519-1#39	0	3	ENST00000372348.9	2669	2672	+	3	0	-2	81
P00519-1#39	0	1	1	P00519-1	445	446	+	1	P00519-1	0	1130	ENST00000318560.6	193	3583	++	25	P00519-1#39	0	3	ENST00000318560.6	1528	1531	+	3	0	-2	82
P00519-1#40	0	1	1	P00519-1	558	559	+	1	P00519-1	26	1130	ENST00000372348.9	1412	4724	++	47	P00519-1#40	0	3	ENST00000372348.9	3008	3011	+	3	0	-2	83
P00519-1#40	0	1	1	P00519-1	558	559	+	1	P00519-1	0	1130	ENST00000318560.6	193	3583	++	25	P00519-1#40	0	3	ENST00000318560.6	1867	1870	+	3	0	-2	84
P00519-1#41	0	1	1	P00519-1	568	569	+	1	P00519-1	26	1130	ENST00000372348.9	1412	4724	++	47	P00519-1#41	0	3	ENST00000372348.9	3038	3041	+	3	0	-2	85
P00519-1#41	0	1	1	P00519-1	568	569	+	1	P00519-1	0	1130	ENST00000318560.6	193	3583	++	25	P00519-1#41	0	3	ENST00000318560.6	1897	1900	+	3	0	-2	86
P00519-1#42	0	1	1	P00519-1	617	618	+	1	P00519-1	26	1130	ENST00000372348.9	1412	4724	++	47	P00519-1#42	0	3	ENST00000372348.9	3185	3188	+	3	0	-2	87
P00519-1#42	0	1	1	P00519-1	617	618	+	1	P00519-1	0	1130	ENST00000318560.6	193	3583	++	25	P00519-1#42	0	3	ENST00000318560.6	2044	2047	+	3	0	-2	88
P00519-1#43	0	1	1	P00519-1	618	619	+	1	P00519-1	26	1130	ENST00000372348.9	1412	4724	++	47	P00519-1#43	0	3	ENST00000372348.9	3188	3191	+	3	0	-2	89
P00519-1#43	0	1	1	P00519-1	618	619	+	1	P00519-1	0	1130	ENST00000318560.6	193	3583	++	25	P00519-1#43	0	3	ENST00000318560.6	2047	2050	+	3	0	-2	90
P00519-1#44	0	1	1	P00519-1	619	620	+	1	P00519-1	26	1130	ENST00000372348.9	1412	4724	++	47	P00519-1#44	0	3	ENST00000372348.9	3191	3194	+	3	0	-2	91
P00519-1#44	0	1	1	P00519-1	619	620	+	1	P00519-1	0	1130	ENST00000318560.6	193	3583	++	25	P00519-1#44	0	3	ENST00000318560.6	2050	2053	+	3	0	-2	92
P00519-1#45	0	1	1	P00519-1	658	659	+	1	P00519-1	26	1130	ENST00000372348.9	1412	4724	++	47	P00519-1#45	0	3	ENST00000372348.9	3308	3311	+	3	0	-2	93
P00519-1#45	0	1	1	P00519-1	658	659	+	1	P00519-1	0	1130	ENST00000318560.6	193	3583	++	25	P00519-1#45	0	3	ENST00000318560.6	2167	2170	+	3	0	-2	94
P00519-1#46	0	1	1	P00519-1	682	683	+	1	P00519-1	26	1130	ENST00000372348.9	1412	4724	++	47	P00519-1#46	0	3	ENST00000372348.9	3380	3383	+	3	0	-2	95
P00519-1#46	0	1	1	P00519-1	682	683	+	1	P00519-1	0	1130	ENST00000318560.6	193	3583	++	25	P00519-1#46	0	3	ENST00000318560.6	2239	2242	+	3	0	-2	96
P00519-1#47	0	1	1	P00519-1	710	711	+	1	P00519-1	26	1130	ENST00000372348.9	1412	4724	++	47	P00519-1#47	0	3	ENST00000372348.9	3464	3467	+	3	0	-2	97
P00519-1#47	0	1	1	P00519-1	710	711	+	1	P00519-1	0	1130	ENST00000318560.6	193	3583	++	25	P00519-1#47	0	3	ENST00000318560.6	2323	2326	+	3	0	-2	98
P00519-1#48	0	1	1	P00519-1	717	718	+	1	P00519-1	26	1130	ENST00000372348.9	1412	4724	++	47	P00519-1#48	0	3	ENST00000372348.9	3485	3488	+	3	0	-2	99
P00519-1#48	0	1	1	P00519-1	717	718	+	1	P00519-1	0	1130	ENST00000318560.6	193	3583	++	25	P00519-1#48	0	3	ENST00000318560.6	2344	2347	+	3	0	-2	100
P00519-1#49	0	1	1	P00519-1	734	735	+	1	P00519-1	26	1130	ENST00000372348.9	1412	4724	++	47	P00519-1#49	0	3	ENST00000372348.9	3536	3539	+	3	0	-2	101
P00519-1#49	0	1	1	P00519-1	734	735	+	1	P00519-1	0	1130	ENST00000318560.6	193	3583	++	25	P00519-1#49	0	3	ENST00000318560.6	2395	2398	+	3	0	-2	102
P00519-1#50	0	1	1	P00519-1	750	751	+	1	P00519-1	26	1130	ENST00000372348.9	1412	4724	++	47	P00519-1#50	0	3	ENST00000372348.9	3584	3587	+	3	0	-2	103
P00519-1#50	0	1	1	P00519-1	750	751	+	1	P00519-1	0	1130	ENST00000318560.6	193	3583	++	25	P00519-1#50	0	3	ENST00000318560.6	2443	2446	+	3	0	-2	104
P00519-1#51	0	1	1	P00519-1	780	781	+	1	P00519-1	26	1130	ENST00000372348.9	1412	4724	++	47	P00519-1#51	0	3	ENST00000372348.9	3674	3677	+	3	0	-2	105
P00519-1#51	0	1	1	P00519-1	780	781	+	1	P00519-1	0	1130	ENST00000318560.6	193	3583	++	25	P00519-1#51	0	3	ENST00000318560.6	2533	2536	+	3	0	-2	106
P00519-1#52	0	1	1	P00519-1	813	814	+	1	P00519-1	26	1130	ENST00000372348.9	1412	4724	++	47	P00519-1#52	0	3	ENST00000372348.9	3773	3776	+	3	0	-2	107
P00519-1#52	0	1	1	P00519-1	813	814	+	1	P00519-1	0	1130	ENST00000318560.6	193	3583	++	25	P00519-1#52	0	3	ENST00000318560.6	2632	2635	+	3	0	-2	108
P00519-1#53	0	1	1	P00519-1	822	823	+	1	P00519-1	26	1130	ENST00000372348.9	1412	4724	++	47	P00519-1#53	0	3	ENST00000372348.9	3800	3803	+	3	0	-2	109
P00519-1#53	0	1	1	P00519-1	822	823	+	1	P00519-1	0	1130	ENST00000318560.6	193	3583	++	25	P00519-1#53	0	3	ENST00000318560.6	2659	2662	+	3	0	-2	110
P00519-1#54	0	1	1	P00519-1	843	844	+	1	P00519-1	26	1130	ENST00000372348.9	1412	4724	++	47	P00519-1#54	0	3	ENST00000372348.9	3863	3866	+	3	0	-2	111
P00519-1#54	0	1	1	P00519-1	843	844	+	1	P00519-1	0	1130	ENST00000318560.6	193	3583	++	25	P00519-1#54	0	3	ENST00000318560.6	2722	2725	+	3	0	-2	112
P00519-1#55	0	1	1	P00519-1	851	852	+	1	P00519-1	26	1130	ENST00000372348.9	1412	4724	++	47	P00519-1#55	0	3	ENST00000372348.9	3887	3890	+	3	0	-2	113
P00519-1#55	0	1	1	P00519-1	851	852	+	1	P00519-1	0	1130	ENST00000318560.6	193	3583	++	25	P00519-1#55	0	3	ENST00000318560.6	2746	2749	+	3	0	-2	114
P00519-1#56	0	1	1	P00519-1	854	855	+	1	P00519-1	26	1130	ENST00000372348.9	1412	4724	++	47	P00519-1#56	0	3	ENST00000372348.9	3896	3899	+	3	0	-2	115
P00519-1#56	0	1	1	P00519-1	854	855	+	1	P00519-1	0	1130	ENST00000318560.6	193	3583	++	25	P00519-1#56	0	3	ENST00000318560.6	2755	2758	+	3	0	-2	116
P00519-1#57	0	1	1	P00519-1	916	917	+	1	P00519-1	26	1130	ENST00000372348.9	1412	4724	++	47	P00519-1#57	0	3	ENST00000372348.9	4082	4085	+	3	0	-2	117
P00519-1#57	0	1	1	P00519-1	916	917	+	1	P00519-1	0	1130	ENST00000318560.6	193	3583	++	25	P00519-1#57	0	3	ENST00000318560.6	2941	2944	+	3	0	-2	118
P00519-1#58	0	1	1	P00519-1	976	977	+	1	P00519-1	26	1130	ENST00000372348.9	1412	4724	++	47	P00519-1#58	0	3	ENST00000372348.9	4262	4265	+	3	0	-2	119
P00519-1#58	0	1	1	P00519-1	976	977	+	1	P00519-1	0	1130	ENST00000318560.6	193	3583	++	25	P00519-1#58	0	3	ENST00000318560.6	3121	3124	+	3	0	-2	120
P00519-1#59	0	26	26	P00519-1	0	26	+	26	P00519-1	23	46	ENST00000393293.4	463	532	++	63	P00519-1#59	69	78	ENST00000393293.4	463	472	+	9	69	-52	121
P00519-1#59	0	26	26	P00519-1	0	26	+	26	P00519-1	0	1130	ENST00000318560.6	193	3583	++	25	P00519-1#59	0	78	ENST00000318560.6	193	271	+	78	0	-52	122
P00519-1#60	0	1	1	P00519-1	46	47	+	1	P00519-1	26	1130	ENST00000372348.9	1412	4724	++	47	P00519-1#60	0	3	ENST00000372348.9	1472	1475	+	3	0	-2	123
P00519-1#60	0	1	1	P00519-1	46	47	+	1	P00519-1	0	1130	ENST00000318560.6	193	3583	++	25	P00519-1#60	0	3	ENST00000318560.6	331	334	+	3	0	-2	124
P00519-1#61	0	1	1	P00519-1	139	140	+	1	P00519-1	26	1130	ENST00000372348.9	1412	4724	++	47	P00519-1#61	0	3	ENST00000372348.9	1751	1754	+	3	0	-2	125
P00519-1#61	0	1	1	P00519-1	139	140	+	1	P00519-1	0	1130	ENST00000318560.6	193	3583	++	25	P00519-1#61	0	3	ENST00000318560.6	610	613	+	3	0	-2	126
P00519-1#62	0	1	1	P00519-1	165	166	+	1	P00519-1	26	1130	ENST00000372348.9	1412	4724	++	47	P00519-1#62	0	3	ENST00000372348.9	1829	1832	+	3	0	-2	127
P00519-1#62	0	1	1	P00519-1	165	166	+	1	P00519-1	0	1130	ENST00000318560.6	193	3583	++	25	P00519-1#62	0	3	ENST00000318560.6	688	691	+	3	0	-2	128
P00519-1#63	0	1	1	P00519-1	225	226	+	1	P00519-1	26	1130	ENST00000372348.9	1412	4724	++	47	P00519-1#63	0	3	ENST00000372348.9	2009	2012	+	3	0	-2	129
P00519-1#63	0	1	1	P00519-1	225	226	+	1	P00519-1	0	1130	ENST00000318560.6	193	3583	++	25	P00519-1#63	0	3	ENST00000318560.6	868	871	+	3	0	-2	130
P00519-1#64	0	1	1	P00519-1	246	247	+	1	P00519-1	26	1130	ENST00000372348.9	1412	4724	++	47	P00519-1#64	0	3	ENST00000372348.9	2072	2075	+	3	0	-2	131
P00519-1#64	0	1	1	P00519-1	246	247	+	1	P00519-1	0	1130	ENST00000318560.6	193	3583	++	25	P00519-1#64	0	3	ENST00000318560.6	931	934	+	3	0	-2	132
P00519-1#65	0	1	1	P00519-1	336	337	+	1	P00519-1	26	1130	ENST00000372348.9	1412	4724	++	47	P00519-1#65	0	3	ENST00000372348.9	2342	2345	+	3	0	-2	133
P00519-1#65	0	1	1	P00519-1	336	337	+	1	P00519-1	0	1130	ENST00000318560.6	193	3583	++	25	P00519-1#65	0	3	ENST00000318560.6	1201	1204	+	3	0	-2	134
P00519-1#66	0	1	1	P00519-1	705	706	+	1	P00519-1	26	1130	ENST00000372348.9	1412	4724	++	47	P00519-1#66	0	3	ENST00000372348.9	3449	3452	+	3	0	-2	135
P00519-1#66	0	1	1	P00519-1	705	706	+	1	P00519-1	0	1130	ENST00000318560.6	193	3583	++	25	P00519-1#66	0	3	ENST00000318560.6	2308	2311	+	3	0	-2	136
P00519-1#67	0	1	1	P00519-1	809	810	+	1	P00519-1	26	1130	ENST00000372348.9	1412	4724	++	47	P00519-1#67	0	3	ENST00000372348.9	3761	3764	+	3	0	-2	137
P00519-1#67	0	1	1	P00519-1	809	810	+	1	P00519-1	0	1130	ENST00000318560.6	193	3583	++	25	P00519-1#67	0	3	ENST00000318560.6	2620	2623	+	3	0	-2	138
P00519-1#68	0	1	1	P00519-1	851	852	+	1	P00519-1	26	1130	ENST00000372348.9	1412	4724	++	47	P00519-1#68	0	3	ENST00000372348.9	3887	3890	+	3	0	-2	139
P00519-1#68	0	1	1	P00519-1	851	852	+	1	P00519-1	0	1130	ENST00000318560.6	193	3583	++	25	P00519-1#68	0	3	ENST00000318560.6	2746	2749	+	3	0	-2	140
P00519-1#69	0	1	1	P00519-1	899	900	+	1	P00519-1	26	1130	ENST00000372348.9	1412	4724	++	47	P00519-1#69	0	3	ENST00000372348.9	4031	4034	+	3	0	-2	141
P00519-1#69	0	1	1	P00519-1	899	900	+	1	P00519-1	0	1130	ENST00000318560.6	193	3583	++	25	P00519-1#69	0	3	ENST00000318560.6	2890	2893	+	3	0	-2	142
P00519-1#70	0	1	1	P00519-1	967	968	+	1	P00519-1	26	1130	ENST00000372348.9	1412	4724	++	47	P00519-1#70	0	3	ENST00000372348.9	4235	4238	+	3	0	-2	143
P00519-1#70	0	1	1	P00519-1	967	968	+	1	P00519-1	0	1130	ENST00000318560.6	193	3583	++	25	P00519-1#70	0	3	ENST00000318560.6	3094	3097	+	3	0	-2	144
P00519-1#71	0	1	1	P00519-1	971	972	+	1	P00519-1	26	1130	ENST00000372348.9	1412	4724	++	47	P00519-1#71	0	3	ENST00000372348.9	4247	4250	+	3	0	-2	145
P00519-1#71	0	1	1	P00519-1	971	972	+	1	P00519-1	0	1130	ENST00000318560.6	193	3583	++	25	P00519-1#71	0	3	ENST00000318560.6	3106	3109	+	3	0	-2	146
P00519-1#72	0	1	1	P00519-1	734	735	+	1	P00519-1	26	1130	ENST00000372348.9	1412	4724	++	47	P00519-1#72	0	3	ENST00000372348.9	3536	3539	+	3	0	-2	147
P00519-1#72	0	1	1	P00519-1	734	735	+	1	P00519-1	0	1130	ENST00000318560.6	193	3583	++	25	P00519-1#72	0	3	ENST00000318560.6	2395	2398	+	3	0	-2	148
P00519-1#73	0	1	1	P00519-1	158	159	+	1	P00519-1	26	1130	ENST00000372348.9	1412	4724	++	47	P00519-1#73	0	3	ENST00000372348.9	1808	1811	+	3	0	-2	149
P00519-1#73	0	1	1	P00519-1	158	159	+	1	P00519-1	0	1130	ENST00000318560.6	193	3583	++	25	P00519-1#73	0	3	ENST00000318560.6	667	670	+	3	0	-2	150
P00519-1#74	0	2	2	P00519-1	423	425	+	2	P00519-1	26	1130	ENST00000372348.9	1412	4724	++	47	P00519-1#74	0	6	ENST00000372348.9	2603	2609	+	6	0	-4	151
P00519-1#74	0	2	2	P00519-1	423	425	+	2	P00519-1	0	1130	ENST00000318560.6	193	3583	++	25	P00519-1#74	0	6	ENST00000318560.6	1462	1468	+	6	0	-4	152
P00519-1#75	0	1	1	P00519-1	444	445	+	1	P00519-1	26	1130	ENST00000372348.9	1412	4724	++	47	P00519-1#75	0	3	ENST00000372348.9	2666	2669	+	3	0	-2	153
P00519-1#75	0	1	1	P00519-1	444	445	+	1	P00519-1	0	1130	ENST00000318560.6	193	3583	++	25	P00519-1#75	0	3	ENST00000318560.6	1525	1528	+	3	0	-2	154
P00519-1#76	0	1	1	P00519-1	458	459	+	1	P00519-1	26	1130	ENST00000372348.9	1412	4724	++	47	P00519-1#76	0	3	ENST00000372348.9	2708	2711	+	3	0	-2	155
P00519-1#76	0	1	1	P00519-1	458	459	+	1	P00519-1	0	1130	ENST00000318560.6	193	3583	++	25	P00519-1#76	0	3	ENST00000318560.6	1567	1570	+	3	0	-2	156
P00519-1#77	0	1	1	P00519-1	519	520	+	1	P00519-1	26	1130	ENST00000372348.9	1412	4724	++	47	P00519-1#77	0	3	ENST00000372348.9	2891	2894	+	3	0	-2	157
P00519-1#77	0	1	1	P00519-1	519	520	+	1	P00519-1	0	1130	ENST00000318560.6	193	3583	++	25	P00519-1#77	0	3	ENST00000318560.6	1750	1753	+	3	0	-2	158
P00519-1#78	0	1	1	P00519-1	718	719	+	1	P00519-1	26	1130	ENST00000372348.9	1412	4724	++	47	P00519-1#78	0	3	ENST00000372348.9	3488	3491	+	3	0	-2	159
P00519-1#78	0	1	1	P00519-1	718	719	+	1	P00519-1	0	1130	ENST00000318560.6	193	3583	++	25	P00519-1#78	0	3	ENST00000318560.6	2347	2350	+	3	0	-2	160
P00519-1#79	0	1	1	P00519-1	836	837	+	1	P00519-1	26	1130	ENST00000372348.9	1412	4724	++	47	P00519-1#79	0	3	ENST00000372348.9	3842	3845	+	3	0	-2	161
P00519-1#79	0	1	1	P00519-1	836	837	+	1	P00519-1	0	1130	ENST00000318560.6	193	3583	++	25	P00519-1#79	0	3	ENST00000318560.6	2701	2704	+	3	0	-2	162
P00519-1#80	0	1	1	P00519-1	836	837	+	1	P00519-1	26	1130	ENST00000372348.9	1412	4724	++	47	P00519-1#80	0	3	ENST00000372348.9	3842	3845	+	3	0	-2	163
P00519-1#80	0	1	1	P00519-1	836	837	+	1	P00519-1	0	1130	ENST00000318560.6	193	3583	++	25	P00519-1#80	0	3	ENST00000318560.6	2701	2704	+	3	0	-2	164
P00519-1#81	0	1	1	P00519-1	862	863	+	1	P00519-1	26	1130	ENST00000372348.9	1412	4724	++	47	P00519-1#81	0	3	ENST00000372348.9	3920	3923	+	3	0	-2	165
P00519-1#81	0	1	1	P00519-1	862	863	+	1	P00519-1	0	1130	ENST00000318560.6	193	3583	++	25	P00519-1#81	0	3	ENST00000318560.6	2779	2782	+	3	0	-2	166
P00519-1#82	0	1	1	P00519-1	893	894	+	1	P00519-1	26	1130	ENST00000372348.9	1412	4724	++	47	P00519-1#82	0	3	ENST00000372348.9	4013	4016	+	3	0	-2	167
P00519-1#82	0	1	1	P00519-1	893	894	+	1	P00519-1	0	1130	ENST00000318560.6	193	3583	++	25	P00519-1#82	0	3	ENST00000318560.6	2872	2875	+	3	0	-2	168
P00519-1#83	0	3	3	P00519-1	916	919	+	3	P00519-1	26	1130	ENST00000372348.9	1412	4724	++	47	P00519-1#83	0	9	ENST00000372348.9	4082	4091	+	9	0	-6	169
P00519-1#83	0	3	3	P00519-1	916	919	+	3	P00519-1	0	1130	ENST00000318560.6	193	3583	++	25	P00519-1#83	0	9	ENST00000318560.6	2941	2950	+	9	0	-6	170
P00519-1#84	0	1	1	P00519-1	951	952	+	1	P00519-1	26	1130	ENST00000372348.9	1412	4724	++	47	P00519-1#84	0	3	ENST00000372348.9	4187	4190	+	3	0	-2	171
P00519-1#84	0	1	1	P00519-1	951	952	+	1	P00519-1	0	1130	ENST00000318560.6	193	3583	++	25	P00519-1#84	0	3	ENST00000318560.6	3046	3049	+	3	0	-2	172
P00519-1#85	0	2	2	P00519-1	966	968	+	2	P00519-1	26	1130	ENST00000372348.9	1412	4724	++	47	P00519-1#85	0	6	ENST00000372348.9	4232	4238	+	6	0	-4	173
P00519-1#85	0	2	2	P00519-1	966	968	+	2	P00519-1	0	1130	ENST00000318560.6	193	3583	++	25	P00519-1#85	0	6	ENST00000318560.6	3091	3097	+	6	0	-4	174
P00519-1#86	0	1	1	P00519-1	981	982	+	1	P00519-1	26	1130	ENST00000372348.9	1412	4724	++	47	P00519-1#86	0	3	ENST00000372348.9	4277	4280	+	3	0	-2	175
P00519-1#86	0	1	1	P00519-1	981	982	+	1	P00519-1	0	1130	ENST00000318560.6	193	3583	++	25	P00519-1#86	0	3	ENST00000318560.6	3136	3139	+	3	0	-2	176
P00519-1#87	0	1	1	P00519-1	1021	1022	+	1	P00519-1	26	1130	ENST00000372348.9	1412	4724	++	47	P00519-1#87	0	3	ENST00000372348.9	4397	4400	+	3	0	-2	177
P00519-1#87	0	1	1	P00519-1	1021	1022	+	1	P00519-1	0	1130	ENST00000318560.6	193	3583	++	25	P00519-1#87	0	3	ENST00000318560.6	3256	3259	+	3	0	-2	178
P00519-1#88	0	1	1	P00519-1	1044	1045	+	1	P00519-1	26	1130	ENST00000372348.9	1412	4724	++	47	P00519-1#88	0	3	ENST00000372348.9	4466	4469	+	3	0	-2	179
P00519-1#88	0	1	1	P00519-1	1044	1045	+	1	P00519-1	0	1130	ENST00000318560.6	193	3583	++	25	P00519-1#88	0	3	ENST00000318560.6	3325	3328	+	3	0	-2	180
P00519-1#89	0	1	1	P00519-1	1102	1103	+	1	P00519-1	26	1130	ENST00000372348.9	1412	4724	++	47	P00519-1#89	0	3	ENST00000372348.9	4640	4643	+	3	0	-2	181
P00519-1#89	0	1	1	P00519-1	1102	1103	+	1	P00519-1	0	1130	ENST00000318560.6	193	3583	++	25	P00519-1#89	0	3	ENST00000318560.6	3499	3502	+	3	0	-2	182
P00519-1#90	0	7	7	P00519-1	25	32	+	7	P00519-1	23	46	ENST00000393293.4	463	532	++	63	P00519-1#90	0	21	ENST00000393293.4	469	490	+	21	0	-14	183
P00519-1#90	0	7	7	P00519-1	25	32	+	7	P00519-1	26	1130	ENST00000372348.9	1412	4724	++	47	P00519-1#90	3	21	ENST00000372348.9	1412	1430	+	18	3	-14	184
P00519-1#90	0	7	7	P00519-1	25	32	+	7	P00519-1	0	1130	ENST00000318560.6	193	3583	++	25	P00519-1#90	0	21	ENST00000318560.6	268	289	+	21	0	-14	185
P00519-1#91	0	6	6	P00519-1	38	44	+	6	P00519-1	23	46	ENST00000393293.4	463	532	++	63	P00519-1#91	0	18	ENST00000393293.4	508	526	+	18	0	-12	186
P00519-1#91	0	6	6	P00519-1	38	44	+	6	P00519-1	26	1130	ENST00000372348.9	1412	4724	++	47	P00519-1#91	0	18	ENST00000372348.9	1448	1466	+	18	0	-12	187
P00519-1#91	0	6	6	P00519-1	38	44	+	6	P00519-1	0	1130	ENST00000318560.6	193	3583	++	25	P00519-1#91	0	18	ENST00000318560.6	307	325	+	18	0	-12	188
P00519-1#92	0	3	3	P00519-1	44	47	+	3	P00519-1	23	46	ENST00000393293.4	463	532	++	63	P00519-1#92	0	6	ENST00000393293.4	526	532	+	6	0	-3	189
P00519-1#92	0	3	3	P00519-1	44	47	+	3	P00519-1	26	1130	ENST00000372348.9	1412	4724	++	47	P00519-1#92	0	9	ENST00000372348.9	1466	1475	+	9	0	-6	190
P00519-1#92	0	3	3	P00519-1	44	47	+	3	P00519-1	0	1130	ENST00000318560.6	193	3583	++	25	P00519-1#92	0	9	ENST00000318560.6	325	334	+	9	0	-6	191
P00519-1#93	0	5	5	P00519-1	48	53	+	5	P00519-1	26	1130	ENST00000372348.9	1412	4724	++	47	P00519-1#93	0	15	ENST00000372348.9	1478	1493	+	15	0	-10	192
P00519-1#93	0	5	5	P00519-1	48	53	+	5	P00519-1	0	1130	ENST00000318560.6	193	3583	++	25	P00519-1#93	0	15	ENST00000318560.6	337	352	+	15	0	-10	193
P00519-1#94	0	3	3	P00519-1	57	60	+	3	P00519-1	26	1130	ENST00000372348.9	1412	4724	++	47	P00519-1#94	0	9	ENST00000372348.9	1505	1514	+	9	0	-6	194
P00519-1#94	0	3	3	P00519-1	57	60	+	3	P00519-1	0	1130	ENST00000318560.6	193	3583	++	25	P00519-1#94	0	9	ENST00000318560.6	364	373	+	9	0	-6	195
P00519-1#95	0	6	6	P00519-1	64	70	+	6	P00519-1	26	1130	ENST00000372348.9	1412	4724	++	47	P00519-1#95	0	18	ENST00000372348.9	1526	1544	+	18	0	-12	196
P00519-1#95	0	6	6	P00519-1	64	70	+	6	P00519-1	0	1130	ENST00000318560.6	193	3583	++	25	P00519-1#95	0	18	ENST00000318560.6	385	403	+	18	0	-12	197
P00519-1#96	0	4	4	P00519-1	75	79	+	4	P00519-1	26	1130	ENST00000372348.9	1412	4724	++	47	P00519-1#96	0	12	ENST00000372348.9	1559	1571	+	12	0	-8	198
P00519-1#96	0	4	4	P00519-1	75	79	+	4	P00519-1	0	1130	ENST00000318560.6	193	3583	++	25	P00519-1#96	0	12	ENST00000318560.6	418	430	+	12	0	-8	199
P00519-1#97	0	7	7	P00519-1	86	93	+	7	P00519-1	26	1130	ENST00000372348.9	1412	4724	++	47	P00519-1#97	0	21	ENST00000372348.9	1592	1613	+	21	0	-14	200
P00519-1#97	0	7	7	P00519-1	86	93	+	7	P00519-1	0	1130	ENST00000318560.6	193	3583	++	25	P00519-1#97	0	21	ENST00000318560.6	451	472	+	21	0	-14	201
P00519-1#98	0	8	8	P00519-1	96	104	+	8	P00519-1	26	1130	ENST00000372348.9	1412	4724	++	47	P00519-1#98	0	24	ENST00000372348.9	1622	1646	+	24	0	-16	202
P00519-1#98	0	8	8	P00519-1	96	104	+	8	P00519-1	0	1130	ENST00000318560.6	193	3583	++	25	P00519-1#98	0	24	ENST00000318560.6	481	505	+	24	0	-16	203
P00519-1#99	0	6	6	P00519-1	106	112	+	6	P00519-1	26	1130	ENST00000372348.9	1412	4724	++	47	P00519-1#99	0	18	ENST00000372348.9	1652	1670	+	18	0	-12	204
P00519-1#99	0	6	6	P00519-1	106	112	+	6	P00519-1	0	1130	ENST00000318560.6	193	3583	++	25	P00519-1#99	0	18	ENST00000318560.6	511	529	+	18	0	-12	205
P00519-1#100	0	3	3	P00519-1	112	115	+	3	P00519-1	26	1130	ENST00000372348.9	1412	4724	++	47	P00519-1#100	0	9	ENST00000372348.9	1670	1679	+	9	0	-6	206
P00519-1#100	0	3	3	P00519-1	112	115	+	3	P00519-1	0	1130	ENST00000318560.6	193	3583	++	25	P00519-1#100	0	9	ENST00000318560.6	529	538	+	9	0	-6	207
P00519-1#101	0	3	3	P00519-1	115	118	+	3	P00519-1	26	1130	ENST00000372348.9	1412	4724	++	47	P00519-1#101	0	9	ENST00000372348.9	1679	1688	+	9	0	-6	208
P00519-1#101	0	3	3	P00519-1	115	118	+	3	P00519-1	0	1130	ENST00000318560.6	193	3583	++	25	P00519-1#101	0	9	ENST00000318560.6	538	547	+	9	0	-6	209
P00519-1#102	0	3	3	P00519-1	121	124	+	3	P00519-1	26	1130	ENST00000372348.9	1412	4724	++	47	P00519-1#102	0	9	ENST00000372348.9	1697	1706	+	9	0	-6	210
P00519-1#102	0	3	3	P00519-1	121	124	+	3	P00519-1	0	1130	ENST00000318560.6	193	3583	++	25	P00519-1#102	0	9	ENST00000318560.6	556	565	+	9	0	-6	211
P00519-1#103	0	4	4	P00519-1	127	131	+	4	P00519-1	26	1130	ENST00000372348.9	1412	4724	++	47	P00519-1#103	0	12	ENST00000372348.9	1715	1727	+	12	0	-8	212
P00519-1#103	0	4	4	P00519-1	127	131	+	4	P00519-1	0	1130	ENST00000318560.6	193	3583	++	25	P00519-1#103	0	12	ENST00000318560.6	574	586	+	12	0	-8	213
P00519-1#104	0	7	7	P00519-1	133	140	+	7	P00519-1	26	1130	ENST00000372348.9	1412	4724	++	47	P00519-1#104	0	21	ENST00000372348.9	1733	1754	+	21	0	-14	214
P00519-1#104	0	7	7	P00519-1	133	140	+	7	P00519-1	0	1130	ENST00000318560.6	193	3583	++	25	P00519-1#104	0	21	ENST00000318560.6	592	613	+	21	0	-14	215
P00519-1#105	0	3	3	P00519-1	140	143	+	3	P00519-1	26	1130	ENST00000372348.9	1412	4724	++	47	P00519-1#105	0	9	ENST00000372348.9	1754	1763	+	9	0	-6	216
P00519-1#105	0	3	3	P00519-1	140	143	+	3	P00519-1	0	1130	ENST00000318560.6	193	3583	++	25	P00519-1#105	0	9	ENST00000318560.6	613	622	+	9	0	-6	217
P00519-1#106	0	6	6	P00519-1	147	153	+	6	P00519-1	26	1130	ENST00000372348.9	1412	4724	++	47	P00519-1#106	0	18	ENST00000372348.9	1775	1793	+	18	0	-12	218
P00519-1#106	0	6	6	P00519-1	147	153	+	6	P00519-1	0	1130	ENST00000318560.6	193	3583	++	25	P00519-1#106	0	18	ENST00000318560.6	634	652	+	18	0	-12	219
P00519-1#107	0	3	3	P00519-1	154	157	+	3	P00519-1	26	1130	ENST00000372348.9	1412	4724	++	47	P00519-1#107	0	9	ENST00000372348.9	1796	1805	+	9	0	-6	220
P00519-1#107	0	3	3	P00519-1	154	157	+	3	P00519-1	0	1130	ENST00000318560.6	193	3583	++	25	P00519-1#107	0	9	ENST00000318560.6	655	664	+	9	0	-6	221
P00519-1#108	0	7	7	P00519-1	160	167	+	7	P00519-1	26	1130	ENST00000372348.9	1412	4724	++	47	P00519-1#108	0	21	ENST00000372348.9	1814	1835	+	21	0	-14	222
P00519-1#108	0	7	7	P00519-1	160	167	+	7	P00519-1	0	1130	ENST00000318560.6	193	3583	++	25	P00519-1#108	0	21	ENST00000318560.6	673	694	+	21	0	-14	223
P00519-1#109	0	6	6	P00519-1	169	175	+	6	P00519-1	26	1130	ENST00000372348.9	1412	4724	++	47	P00519-1#109	0	18	ENST00000372348.9	1841	1859	+	18	0	-12	224
P00519-1#109	0	6	6	P00519-1	169	175	+	6	P00519-1	0	1130	ENST00000318560.6	193	3583	++	25	P00519-1#109	0	18	ENST00000318560.6	700	718	+	18	0	-12	225
P00519-1#110	0	3	3	P00519-1	176	179	+	3	P00519-1	26	1130	ENST00000372348.9	1412	4724	++	47	P00519-1#110	0	9	ENST00000372348.9	1862	1871	+	9	0	-6	226
P00519-1#110	0	3	3	P00519-1	176	179	+	3	P00519-1	0	1130	ENST00000318560.6	193	3583	++	25	P00519-1#110	0	9	ENST00000318560.6	721	730	+	9	0	-6	227
P00519-1#111	0	3	3	P00519-1	179	182	+	3	P00519-1	26	1130	ENST00000372348.9	1412	4724	++	47	P00519-1#111	0	9	ENST00000372348.9	1871	1880	+	9	0	-6	228
P00519-1#111	0	3	3	P00519-1	179	182	+	3	P00519-1	0	1130	ENST00000318560.6	193	3583	++	25	P00519-1#111	0	9	ENST00000318560.6	730	739	+	9	0	-6	229
P00519-1#112	0	4	4	P00519-1	183	187	+	4	P00519-1	26	1130	ENST00000372348.9	1412	4724	++	47	P00519-1#112	0	12	ENST00000372348.9	1883	1895	+	12	0	-8	230
P00519-1#112	0	4	4	P00519-1	183	187	+	4	P00519-1	0	1130	ENST00000318560.6	193	3583	++	25	P00519-1#112	0	12	ENST00000318560.6	742	754	+	12	0	-8	231
P00519-1#113	0	5	5	P00519-1	189	194	+	5	P00519-1	26	1130	ENST00000372348.9	1412	4724	++	47	P00519-1#113	0	15	ENST00000372348.9	1901	1916	+	15	0	-10	232
P00519-1#113	0	5	5	P00519-1	189	194	+	5	P00519-1	0	1130	ENST00000318560.6	193	3583	++	25	P00519-1#113	0	15	ENST00000318560.6	760	775	+	15	0	-10	233
P00519-1#114	0	8	8	P00519-1	194	202	+	8	P00519-1	26	1130	ENST00000372348.9	1412	4724	++	47	P00519-1#114	0	24	ENST00000372348.9	1916	1940	+	24	0	-16	234
P00519-1#114	0	8	8	P00519-1	194	202	+	8	P00519-1	0	1130	ENST00000318560.6	193	3583	++	25	P00519-1#114	0	24	ENST00000318560.6	775	799	+	24	0	-16	235
P00519-1#115	0	3	3	P00519-1	208	211	+	3	P00519-1	26	1130	ENST00000372348.9	1412	4724	++	47	P00519-1#115	0	9	ENST00000372348.9	1958	1967	+	9	0	-6	236
P00519-1#115	0	3	3	P00519-1	208	211	+	3	P00519-1	0	1130	ENST00000318560.6	193	3583	++	25	P00519-1#115	0	9	ENST00000318560.6	817	826	+	9	0	-6	237
P00519-1#116	0	3	3	P00519-1	225	228	+	3	P00519-1	26	1130	ENST00000372348.9	1412	4724	++	47	P00519-1#116	0	9	ENST00000372348.9	2009	2018	+	9	0	-6	238
P00519-1#116	0	3	3	P00519-1	225	228	+	3	P00519-1	0	1130	ENST00000318560.6	193	3583	++	25	P00519-1#116	0	9	ENST00000318560.6	868	877	+	9	0	-6	239
P00519-1#117	0	3	3	P00519-1	228	231	+	3	P00519-1	26	1130	ENST00000372348.9	1412	4724	++	47	P00519-1#117	0	9	ENST00000372348.9	2018	2027	+	9	0	-6	240
P00519-1#117	0	3	3	P00519-1	228	231	+	3	P00519-1	0	1130	ENST00000318560.6	193	3583	++	25	P00519-1#117	0	9	ENST00000318560.6	877	886	+	9	0	-6	241
P00519-1#118	0	3	3	P00519-1	232	235	+	3	P00519-1	26	1130	ENST00000372348.9	1412	4724	++	47	P00519-1#118	0	9	ENST00000372348.9	2030	2039	+	9	0	-6	242
P00519-1#118	0	3	3	P00519-1	232	235	+	3	P00519-1	0	1130	ENST00000318560.6	193	3583	++	25	P00519-1#118	0	9	ENST00000318560.6	889	898	+	9	0	-6	243
P00519-1#119	0	3	3	P00519-1	238	241	+	3	P00519-1	26	1130	ENST00000372348.9	1412	4724	++	47	P00519-1#119	0	9	ENST00000372348.9	2048	2057	+	9	0	-6	244
P00519-1#119	0	3	3	P00519-1	238	241	+	3	P00519-1	0	1130	ENST00000318560.6	193	3583	++	25	P00519-1#119	0	9	ENST00000318560.6	907	916	+	9	0	-6	245
P00519-1#120	0	6	6	P00519-1	241	247	+	6	P00519-1	26	1130	ENST00000372348.9	1412	4724	++	47	P00519-1#120	0	18	ENST00000372348.9	2057	2075	+	18	0	-12	246
P00519-1#120	0	6	6	P00519-1	241	247	+	6	P00519-1	0	1130	ENST00000318560.6	193	3583	++	25	P00519-1#120	0	18	ENST00000318560.6	916	934	+	18	0	-12	247
P00519-1#121	0	4	4	P00519-1	247	251	+	4	P00519-1	26	1130	ENST00000372348.9	1412	4724	++	47	P00519-1#121	0	12	ENST00000372348.9	2075	2087	+	12	0	-8	248
P00519-1#121	0	4	4	P00519-1	247	251	+	4	P00519-1	0	1130	ENST00000318560.6	193	3583	++	25	P00519-1#121	0	12	ENST00000318560.6	934	946	+	12	0	-8	249
P00519-1#122	0	8	8	P00519-1	253	261	+	8	P00519-1	26	1130	ENST00000372348.9	1412	4724	++	47	P00519-1#122	0	24	ENST00000372348.9	2093	2117	+	24	0	-16	250
P00519-1#122	0	8	8	P00519-1	253	261	+	8	P00519-1	0	1130	ENST00000318560.6	193	3583	++	25	P00519-1#122	0	24	ENST00000318560.6	952	976	+	24	0	-16	251
P00519-1#123	0	3	3	P00519-1	261	264	+	3	P00519-1	26	1130	ENST00000372348.9	1412	4724	++	47	P00519-1#123	0	9	ENST00000372348.9	2117	2126	+	9	0	-6	252
P00519-1#123	0	3	3	P00519-1	261	264	+	3	P00519-1	0	1130	ENST00000318560.6	193	3583	++	25	P00519-1#123	0	9	ENST00000318560.6	976	985	+	9	0	-6	253
P00519-1#124	0	6	6	P00519-1	265	271	+	6	P00519-1	26	1130	ENST00000372348.9	1412	4724	++	47	P00519-1#124	0	18	ENST00000372348.9	2129	2147	+	18	0	-12	254
P00519-1#124	0	6	6	P00519-1	265	271	+	6	P00519-1	0	1130	ENST00000318560.6	193	3583	++	25	P00519-1#124	0	18	ENST00000318560.6	988	1006	+	18	0	-12	255
P00519-1#125	0	3	3	P00519-1	274	277	+	3	P00519-1	26	1130	ENST00000372348.9	1412	4724	++	47	P00519-1#125	0	9	ENST00000372348.9	2156	2165	+	9	0	-6	256
P00519-1#125	0	3	3	P00519-1	274	277	+	3	P00519-1	0	1130	ENST00000318560.6	193	3583	++	25	P00519-1#125	0	9	ENST00000318560.6	1015	1024	+	9	0	-6	257
P00519-1#126	0	11	11	P00519-1	279	290	+	11	P00519-1	26	1130	ENST00000372348.9	1412	4724	++	47	P00519-1#126	0	33	ENST00000372348.9	2171	2204	+	33	0	-22	258
P00519-1#126	0	11	11	P00519-1	279	290	+	11	P00519-1	0	1130	ENST00000318560.6	193	3583	++	25	P00519-1#126	0	33	ENST00000318560.6	1030	1063	+	33	0	-22	259
P00519-1#127	0	5	5	P00519-1	300	305	+	5	P00519-1	26	1130	ENST00000372348.9	1412	4724	++	47	P00519-1#127	0	15	ENST00000372348.9	2234	2249	+	15	0	-10	260
P00519-1#127	0	5	5	P00519-1	300	305	+	5	P00519-1	0	1130	ENST00000318560.6	193	3583	++	25	P00519-1#127	0	15	ENST00000318560.6	1093	1108	+	15	0	-10	261
P00519-1#128	0	4	4	P00519-1	306	310	+	4	P00519-1	26	1130	ENST00000372348.9	1412	4724	++	47	P00519-1#128	0	12	ENST00000372348.9	2252	2264	+	12	0	-8	262
P00519-1#128	0	4	4	P00519-1	306	310	+	4	P00519-1	0	1130	ENST00000318560.6	193	3583	++	25	P00519-1#128	0	12	ENST00000318560.6	1111	1123	+	12	0	-8	263
P00519-1#129	0	5	5	P00519-1	311	316	+	5	P00519-1	26	1130	ENST00000372348.9	1412	4724	++	47	P00519-1#129	0	15	ENST00000372348.9	2267	2282	+	15	0	-10	264
P00519-1#129	0	5	5	P00519-1	311	316	+	5	P00519-1	0	1130	ENST00000318560.6	193	3583	++	25	P00519-1#129	0	15	ENST00000318560.6	1126	1141	+	15	0	-10	265
P00519-1#130	0	4	4	P00519-1	318	322	+	4	P00519-1	26	1130	ENST00000372348.9	1412	4724	++	47	P00519-1#130	0	12	ENST00000372348.9	2288	2300	+	12	0	-8	266
P00519-1#130	0	4	4	P00519-1	318	322	+	4	P00519-1	0	1130	ENST00000318560.6	193	3583	++	25	P00519-1#130	0	12	ENST00000318560.6	1147	1159	+	12	0	-8	267
P00519-1#131	0	7	7	P00519-1	322	329	+	7	P00519-1	26	1130	ENST00000372348.9	1412	4724	++	47	P00519-1#131	0	21	ENST00000372348.9	2300	2321	+	21	0	-14	268
P00519-1#131	0	7	7	P00519-1	322	329	+	7	P00519-1	0	1130	ENST00000318560.6	193	3583	++	25	P00519-1#131	0	21	ENST00000318560.6	1159	1180	+	21	0	-14	269
P00519-1#132	0	3	3	P00519-1	331	334	+	3	P00519-1	26	1130	ENST00000372348.9	1412	4724	++	47	P00519-1#132	0	9	ENST00000372348.9	2327	2336	+	9	0	-6	270
P00519-1#132	0	3	3	P00519-1	331	334	+	3	P00519-1	0	1130	ENST00000318560.6	193	3583	++	25	P00519-1#132	0	9	ENST00000318560.6	1186	1195	+	9	0	-6	271
P00519-1#133	0	20	20	P00519-1	336	356	+	20	P00519-1	26	1130	ENST00000372348.9	1412	4724	++	47	P00519-1#133	0	60	ENST00000372348.9	2342	2402	+	60	0	-40	272
P00519-1#133	0	20	20	P00519-1	336	356	+	20	P00519-1	0	1130	ENST00000318560.6	193	3583	++	25	P00519-1#133	0	60	ENST00000318560.6	1201	1261	+	60	0	-40	273
P00519-1#134	0	3	3	P00519-1	358	361	+	3	P00519-1	26	1130	ENST00000372348.9	1412	4724	++	47	P00519-1#134	0	9	ENST00000372348.9	2408	2417	+	9	0	-6	274
P00519-1#134	0	3	3	P00519-1	358	361	+	3	P00519-1	0	1130	ENST00000318560.6	193	3583	++	25	P00519-1#134	0	9	ENST00000318560.6	1267	1276	+	9	0	-6	275
P00519-1#135	0	3	3	P00519-1	365	368	+	3	P00519-1	26	1130	ENST00000372348.9	1412	4724	++	47	P00519-1#135	0	9	ENST00000372348.9	2429	2438	+	9	0	-6	276
P00519-1#135	0	3	3	P00519-1	365	368	+	3	P00519-1	0	1130	ENST00000318560.6	193	3583	++	25	P00519-1#135	0	9	ENST00000318560.6	1288	1297	+	9	0	-6	277
P00519-1#136	0	3	3	P00519-1	368	371	+	3	P00519-1	26	1130	ENST00000372348.9	1412	4724	++	47	P00519-1#136	0	9	ENST00000372348.9	2438	2447	+	9	0	-6	278
P00519-1#136	0	3	3	P00519-1	368	371	+	3	P00519-1	0	1130	ENST00000318560.6	193	3583	++	25	P00519-1#136	0	9	ENST00000318560.6	1297	1306	+	9	0	-6	279
P00519-1#137	0	3	3	P00519-1	372	375	+	3	P00519-1	26	1130	ENST00000372348.9	1412	4724	++	47	P00519-1#137	0	9	ENST00000372348.9	2450	2459	+	9	0	-6	280
P00519-1#137	0	3	3	P00519-1	372	375	+	3	P00519-1	0	1130	ENST00000318560.6	193	3583	++	25	P00519-1#137	0	9	ENST00000318560.6	1309	1318	+	9	0	-6	281
P00519-1#138	0	3	3	P00519-1	376	379	+	3	P00519-1	26	1130	ENST00000372348.9	1412	4724	++	47	P00519-1#138	0	9	ENST00000372348.9	2462	2471	+	9	0	-6	282
P00519-1#138	0	3	3	P00519-1	376	379	+	3	P00519-1	0	1130	ENST00000318560.6	193	3583	++	25	P00519-1#138	0	9	ENST00000318560.6	1321	1330	+	9	0	-6	283
P00519-1#139	0	3	3	P00519-1	380	383	+	3	P00519-1	26	1130	ENST00000372348.9	1412	4724	++	47	P00519-1#139	0	9	ENST00000372348.9	2474	2483	+	9	0	-6	284
P00519-1#139	0	3	3	P00519-1	380	383	+	3	P00519-1	0	1130	ENST00000318560.6	193	3583	++	25	P00519-1#139	0	9	ENST00000318560.6	1333	1342	+	9	0	-6	285
P00519-1#140	0	4	4	P00519-1	383	387	+	4	P00519-1	26	1130	ENST00000372348.9	1412	4724	++	47	P00519-1#140	0	12	ENST00000372348.9	2483	2495	+	12	0	-8	286
P00519-1#140	0	4	4	P00519-1	383	387	+	4	P00519-1	0	1130	ENST00000318560.6	193	3583	++	25	P00519-1#140	0	12	ENST00000318560.6	1342	1354	+	12	0	-8	287
P00519-1#141	0	3	3	P00519-1	389	392	+	3	P00519-1	26	1130	ENST00000372348.9	1412	4724	++	47	P00519-1#141	0	9	ENST00000372348.9	2501	2510	+	9	0	-6	288
P00519-1#141	0	3	3	P00519-1	389	392	+	3	P00519-1	0	1130	ENST00000318560.6	193	3583	++	25	P00519-1#141	0	9	ENST00000318560.6	1360	1369	+	9	0	-6	289
P00519-1#142	0	4	4	P00519-1	392	396	+	4	P00519-1	26	1130	ENST00000372348.9	1412	4724	++	47	P00519-1#142	0	12	ENST00000372348.9	2510	2522	+	12	0	-8	290
P00519-1#142	0	4	4	P00519-1	392	396	+	4	P00519-1	0	1130	ENST00000318560.6	193	3583	++	25	P00519-1#142	0	12	ENST00000318560.6	1369	1381	+	12	0	-8	291
P00519-1#143	0	3	3	P00519-1	398	401	+	3	P00519-1	26	1130	ENST00000372348.9	1412	4724	++	47	P00519-1#143	0	9	ENST00000372348.9	2528	2537	+	9	0	-6	292
P00519-1#143	0	3	3	P00519-1	398	401	+	3	P00519-1	0	1130	ENST00000318560.6	193	3583	++	25	P00519-1#143	0	9	ENST00000318560.6	1387	1396	+	9	0	-6	293
P00519-1#144	0	3	3	P00519-1	402	405	+	3	P00519-1	26	1130	ENST00000372348.9	1412	4724	++	47	P00519-1#144	0	9	ENST00000372348.9	2540	2549	+	9	0	-6	294
P00519-1#144	0	3	3	P00519-1	402	405	+	3	P00519-1	0	1130	ENST00000318560.6	193	3583	++	25	P00519-1#144	0	9	ENST00000318560.6	1399	1408	+	9	0	-6	295
P00519-1#145	0	6	6	P00519-1	407	413	+	6	P00519-1	26	1130	ENST00000372348.9	1412	4724	++	47	P00519-1#145	0	18	ENST00000372348.9	2555	2573	+	18	0	-12	296
P00519-1#145	0	6	6	P00519-1	407	413	+	6	P00519-1	0	1130	ENST00000318560.6	193	3583	++	25	P00519-1#145	0	18	ENST00000318560.6	1414	1432	+	18	0	-12	297
P00519-1#146	0	16	16	P00519-1	417	433	+	16	P00519-1	26	1130	ENST00000372348.9	1412	4724	++	47	P00519-1#146	0	48	ENST00000372348.9	2585	2633	+	48	0	-32	298
P00519-1#146	0	16	16	P00519-1	417	433	+	16	P00519-1	0	1130	ENST00000318560.6	193	3583	++	25	P00519-1#146	0	48	ENST00000318560.6	1444	1492	+	48	0	-32	299
P00519-1#147	0	3	3	P00519-1	444	447	+	3	P00519-1	26	1130	ENST00000372348.9	1412	4724	++	47	P00519-1#147	0	9	ENST00000372348.9	2666	2675	+	9	0	-6	300
P00519-1#147	0	3	3	P00519-1	444	447	+	3	P00519-1	0	1130	ENST00000318560.6	193	3583	++	25	P00519-1#147	0	9	ENST00000318560.6	1525	1534	+	9	0	-6	301
P00519-1#148	0	6	6	P00519-1	447	453	+	6	P00519-1	26	1130	ENST00000372348.9	1412	4724	++	47	P00519-1#148	0	18	ENST00000372348.9	2675	2693	+	18	0	-12	302
P00519-1#148	0	6	6	P00519-1	447	453	+	6	P00519-1	0	1130	ENST00000318560.6	193	3583	++	25	P00519-1#148	0	18	ENST00000318560.6	1534	1552	+	18	0	-12	303
P00519-1#149	0	10	10	P00519-1	465	475	+	10	P00519-1	26	1130	ENST00000372348.9	1412	4724	++	47	P00519-1#149	0	30	ENST00000372348.9	2729	2759	+	30	0	-20	304
P00519-1#149	0	10	10	P00519-1	465	475	+	10	P00519-1	0	1130	ENST00000318560.6	193	3583	++	25	P00519-1#149	0	30	ENST00000318560.6	1588	1618	+	30	0	-20	305
P00519-1#150	0	3	3	P00519-1	479	482	+	3	P00519-1	26	1130	ENST00000372348.9	1412	4724	++	47	P00519-1#150	0	9	ENST00000372348.9	2771	2780	+	9	0	-6	306
P00519-1#150	0	3	3	P00519-1	479	482	+	3	P00519-1	0	1130	ENST00000318560.6	193	3583	++	25	P00519-1#150	0	9	ENST00000318560.6	1630	1639	+	9	0	-6	307
P00519-1#151	0	11	11	P00519-1	485	496	+	11	P00519-1	26	1130	ENST00000372348.9	1412	4724	++	47	P00519-1#151	0	33	ENST00000372348.9	2789	2822	+	33	0	-22	308
P00519-1#151	0	11	11	P00519-1	485	496	+	11	P00519-1	0	1130	ENST00000318560.6	193	3583	++	25	P00519-1#151	0	33	ENST00000318560.6	1648	1681	+	33	0	-22	309
P00519-1#152	0	3	3	P00519-1	497	500	+	3	P00519-1	26	1130	ENST00000372348.9	1412	4724	++	47	P00519-1#152	0	9	ENST00000372348.9	2825	2834	+	9	0	-6	310
P00519-1#152	0	3	3	P00519-1	497	500	+	3	P00519-1	0	1130	ENST00000318560.6	193	3583	++	25	P00519-1#152	0	9	ENST00000318560.6	1684	1693	+	9	0	-6	311
P00519-1#153	0	4	4	P00519-1	502	506	+	4	P00519-1	26	1130	ENST00000372348.9	1412	4724	++	47	P00519-1#153	0	12	ENST00000372348.9	2840	2852	+	12	0	-8	312
P00519-1#153	0	4	4	P00519-1	502	506	+	4	P00519-1	0	1130	ENST00000318560.6	193	3583	++	25	P00519-1#153	0	12	ENST00000318560.6	1699	1711	+	12	0	-8	313
P00519-1#154	0	3	3	P00519-1	509	512	+	3	P00519-1	26	1130	ENST00000372348.9	1412	4724	++	47	P00519-1#154	0	9	ENST00000372348.9	2861	2870	+	9	0	-6	314
P00519-1#154	0	3	3	P00519-1	509	512	+	3	P00519-1	0	1130	ENST00000318560.6	193	3583	++	25	P00519-1#154	0	9	ENST00000318560.6	1720	1729	+	9	0	-6	315
P00519-1#155	0	17	17	P00519-1	1028	1045	+	17	P00519-1	26	1130	ENST00000372348.9	1412	4724	++	47	P00519-1#155	0	51	ENST00000372348.9	4418	4469	+	51	0	-34	316
P00519-1#155	0	17	17	P00519-1	1028	1045	+	17	P00519-1	0	1130	ENST00000318560.6	193	3583	++	25	P00519-1#155	0	51	ENST00000318560.6	3277	3328	+	51	0	-34	317
P00519-1#156	0	3	3	P00519-1	1045	1048	+	3	P00519-1	26	1130	ENST00000372348.9	1412	4724	++	47	P00519-1#156	0	9	ENST00000372348.9	4469	4478	+	9	0	-6	318
P00519-1#156	0	3	3	P00519-1	1045	1048	+	3	P00519-1	0	1130	ENST00000318560.6	193	3583	++	25	P00519-1#156	0	9	ENST00000318560.6	3328	3337	+	9	0	-6	319
P00519-1#157	0	18	18	P00519-1	1052	1070	+	18	P00519-1	26	1130	ENST00000372348.9	1412	4724	++	47	P00519-1#157	0	54	ENST00000372348.9	4490	4544	+	54	0	-36	320
P00519-1#157	0	18	18	P00519-1	1052	1070	+	18	P00519-1	0	1130	ENST00000318560.6	193	3583	++	25	P00519-1#157	0	54	ENST00000318560.6	3349	3403	+	54	0	-36	321
P00519-1#158	0	3	3	P00519-1	1070	1073	+	3	P00519-1	26	1130	ENST00000372348.9	1412	4724	++	47	P00519-1#158	0	9	ENST00000372348.9	4544	4553	+	9	0	-6	322
P00519-1#158	0	3	3	P00519-1	1070	1073	+	3	P00519-1	0	1130	ENST00000318560.6	193	3583	++	25	P00519-1#158	0	9	ENST00000318560.6	3403	3412	+	9	0	-6	323
P00519-1#159	0	18	18	P00519-1	1079	1097	+	18	P00519-1	26	1130	ENST00000372348.9	1412	4724	++	47	P00519-1#159	0	54	ENST00000372348.9	4571	4625	+	54	0	-36	324
P00519-1#159	0	18	18	P00519-1	1079	1097	+	18	P00519-1	0	1130	ENST00000318560.6	193	3583	++	25	P00519-1#159	0	54	ENST00000318560.6	3430	3484	+	54	0	-36	325
P00519-1#160	0	4	4	P00519-1	1100	1104	+	4	P00519-1	26	1130	ENST00000372348.9	1412	4724	++	47	P00519-1#160	0	12	ENST00000372348.9	4634	4646	+	12	0	-8	326
P00519-1#160	0	4	4	P00519-1	1100	1104	+	4	P00519-1	0	1130	ENST00000318560.6	193	3583	++	25	P00519-1#160	0	12	ENST00000318560.6	3493	3505	+	12	0	-8	327
P00519-1#161	0	3	3	P00519-1	1105	1108	+	3	P00519-1	26	1130	ENST00000372348.9	1412	4724	++	47	P00519-1#161	0	9	ENST00000372348.9	4649	4658	+	9	0	-6	328
P00519-1#161	0	3	3	P00519-1	1105	1108	+	3	P00519-1	0	1130	ENST00000318560.6	193	3583	++	25	P00519-1#161	0	9	ENST00000318560.6	3508	3517	+	9	0	-6	329
P00519-1#162	0	14	14	P00519-1	1114	1128	+	14	P00519-1	26	1130	ENST00000372348.9	1412	4724	++	47	P00519-1#162	0	42	ENST00000372348.9	4676	4718	+	42	0	-28	330
P00519-1#162	0	14	14	P00519-1	1114	1128	+	14	P00519-1	0	1130	ENST00000318560.6	193	3583	++	25	P00519-1#162	0	42	ENST00000318560.6	3535	3577	+	42	0	-28	331
P00519-1#163	0	1	1	P00519-1	1	2	+	1	P00519-1	0	1130	ENST00000318560.6	193	3583	++	25	P00519-1#163	0	3	ENST00000318560.6	196	199	+	3	0	-2	332
O95831-1#0	0	54	54	O95831-1	0	54	+	54	O95831-1	0	613	ENST00000676436.1	34	1861	++	246	O95831-1#0	0	162	ENST00000676436.1	34	196	+	162	0	-108	333
O95831-1#0	0	54	54	O95831-1	0	54	+	54	O95831-1	0	613	ENST00000676328.1	56	1892	++	245	O95831-1#0	0	162	ENST00000676328.1	56	218	+	162	0	-108	334
O95831-1#0	0	54	54	O95831-1	0	54	+	54	O95831-1	0	613	ENST00000676229.1	223	2050	++	244	O95831-1#0	0	162	ENST00000676229.1	223	370	+	147	0	-108	335
O95831-1#0	0	54	54	O95831-1	0	54	+	54	O95831-1	0	613	ENST00000675857.1	82	1915	++	242	O95831-1#0	0	162	ENST00000675857.1	82	244	+	162	0	-108	336
O95831-1#0	0	54	54	O95831-1	0	54	+	54	O95831-1	0	36	ENST00000675774.1	41	149	++	241	O95831-1#0	0	108	ENST00000675774.1	41	149	+	108	0	-54	337
O95831-1#0	0	54	54	O95831-1	0	54	+	54	O95831-1	0	613	ENST00000675427.1	89	1925	++	240	O95831-1#0	0	162	ENST00000675427.1	89	251	+	162	0	-108	338
O95831-1#0	0	54	54	O95831-1	0	54	+	54	O95831-1	0	524	ENST00000675240.1	169	1741	++	239	O95831-1#0	0	162	ENST00000675240.1	169	331	+	162	0	-108	339
O95831-1#0	0	54	54	O95831-1	0	54	+	54	O95831-1	0	613	ENST00000675092.1	90	1956	++	238	O95831-1#0	0	162	ENST00000675092.1	90	252	+	162	0	-108	340
O95831-1#0	0	54	54	O95831-1	0	54	+	54	O95831-1	0	613	ENST00000675050.1	71	1898	++	237	O95831-1#0	0	162	ENST00000675050.1	71	218	+	147	0	-108	341
O95831-1#0	0	54	54	O95831-1	0	54	+	54	O95831-1	0	459	ENST00000675037.1	56	1433	++	236	O95831-1#0	0	162	ENST00000675037.1	56	218	+	162	0	-108	342
O95831-1#0	0	54	54	O95831-1	0	54	+	54	O95831-1	0	36	ENST00000674997.1	0	108	++	235	O95831-1#0	0	108	ENST00000674997.1	0	108	+	108	0	-54	343
O95831-1#0	0	54	54	O95831-1	0	54	+	54	O95831-1	0	238	ENST00000674722.1	13	727	++	233	O95831-1#0	0	162	ENST00000674722.1	13	175	+	162	0	-108	344
O95831-1#0	0	54	54	O95831-1	0	54	+	54	O95831-1	0	91	ENST00000674555.1	57	330	++	231	O95831-1#0	0	162	ENST00000674555.1	57	219	+	162	0	-108	345
O95831-1#0	0	54	54	O95831-1	0	54	+	54	O95831-1	0	587	ENST00000674546.1	185	1954	++	230	O95831-1#0	0	162	ENST00000674546.1	185	347	+	162	0	-108	346
O95831-1#0	0	54	54	O95831-1	0	54	+	54	O95831-1	0	322	ENST00000535724.6	8	974	++	150	O95831-1#0	0	162	ENST00000535724.6	8	170	+	162	0	-108	347
O95831-1#0	0	54	54	O95831-1	0	54	+	54	O95831-1	0	83	ENST00000529877.1	103	352	++	145	O95831-1#0	0	162	ENST00000529877.1	103	265	+	162	0	-108	348
O95831-1#0	0	54	54	O95831-1	0	54	+	54	O95831-1	0	36	ENST00000527892.5	8	116	++	142	O95831-1#0	0	108	ENST00000527892.5	8	116	+	108	0	-54	349
O95831-1#0	0	54	54	O95831-1	0	54	+	54	O95831-1	0	435	ENST00000416073.7	37	1336	++	76	O95831-1#0	0	162	ENST00000416073.7	37	199	+	162	0	-108	350
O95831-1#0	0	54	54	O95831-1	0	54	+	54	O95831-1	0	613	ENST00000346424.6	24	1002	++	35	O95831-1#0	0	105	ENST00000346424.6	24	129	+	105	0	-51	351
O95831-1#0	0	54	54	O95831-1	0	54	+	54	O95831-1	0	613	ENST00000319908.8	174	2007	++	26	O95831-1#0	0	162	ENST00000319908.8	174	336	+	162	0	-108	352
O95831-1#0	0	54	54	O95831-1	0	54	+	54	O95831-1	0	613	ENST00000287295.8	185	2024	++	18	O95831-1#0	0	162	ENST00000287295.8	185	347	+	162	0	-108	353
O95831-1#1	0	47	47	O95831-1	54	101	+	47	O95831-1	0	613	ENST00000676436.1	34	1861	++	246	O95831-1#1	0	141	ENST00000676436.1	196	337	+	141	0	-94	354
O95831-1#1	0	47	47	O95831-1	54	101	+	47	O95831-1	0	613	ENST00000676328.1	56	1892	++	245	O95831-1#1	0	141	ENST00000676328.1	218	359	+	141	0	-94	355
O95831-1#1	0	47	47	O95831-1	54	101	+	47	O95831-1	0	613	ENST00000676229.1	223	2050	++	244	O95831-1#1	0	141	ENST00000676229.1	370	514	+	141	0	-94	356
O95831-1#1	0	47	47	O95831-1	54	101	+	47	O95831-1	0	613	ENST00000675857.1	82	1915	++	242	O95831-1#1	0	141	ENST00000675857.1	244	385	+	141	0	-94	357
O95831-1#1	0	47	47	O95831-1	54	101	+	47	O95831-1	0	613	ENST00000675427.1	89	1925	++	240	O95831-1#1	0	141	ENST00000675427.1	251	392	+	141	0	-94	358
O95831-1#1	0	47	47	O95831-1	54	101	+	47	O95831-1	0	524	ENST00000675240.1	169	1741	++	239	O95831-1#1	0	141	ENST00000675240.1	331	472	+	141	0	-94	359
O95831-1#1	0	47	47	O95831-1	54	101	+	47	O95831-1	0	613	ENST00000675092.1	90	1956	++	238	O95831-1#1	0	141	ENST00000675092.1	252	393	+	141	0	-94	360
O95831-1#1	0	47	47	O95831-1	54	101	+	47	O95831-1	0	613	ENST00000675050.1	71	1898	++	237	O95831-1#1	0	141	ENST00000675050.1	218	362	+	141	0	-94	361
O95831-1#1	0	47	47	O95831-1	54	101	+	47	O95831-1	0	459	ENST00000675037.1	56	1433	++	236	O95831-1#1	0	141	ENST00000675037.1	218	359	+	141	0	-94	362
O95831-1#1	0	47	47	O95831-1	54	101	+	47	O95831-1	100	388	ENST00000674957.1	1	865	++	234	O95831-1#1	138	141	ENST00000674957.1	1	4	+	3	138	-94	363
O95831-1#1	0	47	47	O95831-1	54	101	+	47	O95831-1	0	238	ENST00000674722.1	13	727	++	233	O95831-1#1	0	141	ENST00000674722.1	175	316	+	141	0	-94	364
O95831-1#1	0	47	47	O95831-1	54	101	+	47	O95831-1	0	91	ENST00000674555.1	57	330	++	231	O95831-1#1	0	111	ENST00000674555.1	219	330	+	111	0	-64	365
O95831-1#1	0	47	47	O95831-1	54	101	+	47	O95831-1	0	587	ENST00000674546.1	185	1954	++	230	O95831-1#1	0	141	ENST00000674546.1	347	488	+	141	0	-94	366
O95831-1#1	0	47	47	O95831-1	54	101	+	47	O95831-1	0	322	ENST00000535724.6	8	974	++	150	O95831-1#1	0	141	ENST00000535724.6	170	311	+	141	0	-94	367
O95831-1#1	0	47	47	O95831-1	54	101	+	47	O95831-1	0	83	ENST00000529877.1	103	352	++	145	O95831-1#1	0	87	ENST00000529877.1	265	352	+	87	0	-40	368
O95831-1#1	0	47	47	O95831-1	54	101	+	47	O95831-1	0	435	ENST00000416073.7	37	1336	++	76	O95831-1#1	0	141	ENST00000416073.7	199	340	+	141	0	-94	369
O95831-1#1	0	47	47	O95831-1	54	101	+	47	O95831-1	0	613	ENST00000319908.8	174	2007	++	26	O95831-1#1	0	141	ENST00000319908.8	336	477	+	141	0	-94	370
O95831-1#1	0	47	47	O95831-1	54	101	+	47	O95831-1	0	613	ENST00000287295.8	185	2024	++	18	O95831-1#1	0	141	ENST00000287295.8	347	488	+	141	0	-94	371
O95831-1#2	0	512	512	O95831-1	101	613	+	512	O95831-1	0	613	ENST00000676436.1	34	1861	++	246	O95831-1#2	0	1536	ENST00000676436.1	337	1861	+	1524	0	-1024	372
O95831-1#2	0	512	512	O95831-1	101	613	+	512	O95831-1	0	613	ENST00000676328.1	56	1892	++	245	O95831-1#2	0	1536	ENST00000676328.1	359	1892	+	1533	0	-1024	373
O95831-1#2	0	512	512	O95831-1	101	613	+	512	O95831-1	0	613	ENST00000676229.1	223	2050	++	244	O95831-1#2	0	1536	ENST00000676229.1	514	2050	+	1536	0	-1024	374
O95831-1#2	0	512	512	O95831-1	101	613	+	512	O95831-1	109	136	ENST00000676144.1	102	183	++	243	O95831-1#2	24	105	ENST00000676144.1	102	183	+	81	24	407	375
O95831-1#2	0	512	512	O95831-1	101	613	+	512	O95831-1	0	613	ENST00000675857.1	82	1915	++	242	O95831-1#2	0	1536	ENST00000675857.1	385	1915	+	1530	0	-1024	376
O95831-1#2	0	512	512	O95831-1	101	613	+	512	O95831-1	0	613	ENST00000675427.1	89	1925	++	240	O95831-1#2	0	1536	ENST00000675427.1	392	1925	+	1533	0	-1024	377
O95831-1#2	0	512	512	O95831-1	101	613	+	512	O95831-1	0	524	ENST00000675240.1	169	1741	++	239	O95831-1#2	0	1269	ENST00000675240.1	472	1741	+	1269	0	-757	378
O95831-1#2	0	512	512	O95831-1	101	613	+	512	O95831-1	0	613	ENST00000675092.1	90	1956	++	238	O95831-1#2	0	1536	ENST00000675092.1	393	1956	+	1536	0	-1024	379
O95831-1#2	0	512	512	O95831-1	101	613	+	512	O95831-1	0	613	ENST00000675050.1	71	1898	++	237	O95831-1#2	0	1536	ENST00000675050.1	362	1898	+	1536	0	-1024	380
O95831-1#2	0	512	512	O95831-1	101	613	+	512	O95831-1	0	459	ENST00000675037.1	56	1433	++	236	O95831-1#2	0	1074	ENST00000675037.1	359	1433	+	1074	0	-562	381
O95831-1#2	0	512	512	O95831-1	101	613	+	512	O95831-1	100	388	ENST00000674957.1	1	865	++	234	O95831-1#2	0	861	ENST00000674957.1	4	865	+	861	0	-349	382
O95831-1#2	0	512	512	O95831-1	101	613	+	512	O95831-1	0	238	ENST00000674722.1	13	727	++	233	O95831-1#2	0	411	ENST00000674722.1	316	727	+	411	0	101	383
O95831-1#2	0	512	512	O95831-1	101	613	+	512	O95831-1	338	613	ENST00000674601.1	2	686	++	232	O95831-1#2	711	1536	ENST00000674601.1	2	686	+	684	711	-1024	384
O95831-1#2	0	512	512	O95831-1	101	613	+	512	O95831-1	0	587	ENST00000674546.1	185	1954	++	230	O95831-1#2	0	1458	ENST00000674546.1	488	1954	+	1458	0	-946	385
O95831-1#2	0	512	512	O95831-1	101	613	+	512	O95831-1	0	322	ENST00000535724.6	8	974	++	150	O95831-1#2	0	663	ENST00000535724.6	311	974	+	663	0	-151	386
O95831-1#2	0	512	512	O95831-1	101	613	+	512	O95831-1	339	613	ENST00000460436.6	905	1727	++	106	O95831-1#2	714	1536	ENST00000460436.6	905	1727	+	822	714	-1024	387
O95831-1#2	0	512	512	O95831-1	101	613	+	512	O95831-1	0	435	ENST00000416073.7	37	1336	++	76	O95831-1#2	0	1002	ENST00000416073.7	340	1336	+	996	0	-490	388
O95831-1#2	0	512	512	O95831-1	101	613	+	512	O95831-1	0	613	ENST00000346424.6	24	1002	++	35	O95831-1#2	663	1536	ENST00000346424.6	129	1002	+	873	663	-1024	389
O95831-1#2	0	512	512	O95831-1	101	613	+	512	O95831-1	0	613	ENST00000319908.8	174	2007	++	26	O95831-1#2	0	1536	ENST00000319908.8	477	2007	+	1530	0	-1024	390
O95831-1#2	0	512	512	O95831-1	101	613	+	512	O95831-1	0	613	ENST00000287295.8	185	2024	++	18	O95831-1#2	0	1536	ENST00000287295.8	488	2024	+	1536	0	-1024	391
O95831-1#3	0	28	28	O95831-1	99	127	+	28	O95831-1	0	613	ENST00000676436.1	34	1861	++	246	O95831-1#3	0	84	ENST00000676436.1	331	409	+	78	0	-56	392
O95831-1#3	0	28	28	O95831-1	99	127	+	28	O95831-1	0	613	ENST00000676328.1	56	1892	++	245	O95831-1#3	0	84	ENST00000676328.1	353	437	+	84	0	-56	393
O95831-1#3	0	28	28	O95831-1	99	127	+	28	O95831-1	0	613	ENST00000676229.1	223	2050	++	244	O95831-1#3	0	84	ENST00000676229.1	508	592	+	84	0	-56	394
O95831-1#3	0	28	28	O95831-1	99	127	+	28	O95831-1	109	136	ENST00000676144.1	102	183	++	243	O95831-1#3	30	84	ENST00000676144.1	102	156	+	54	30	-56	395
O95831-1#3	0	28	28	O95831-1	99	127	+	28	O95831-1	0	613	ENST00000675857.1	82	1915	++	242	O95831-1#3	0	84	ENST00000675857.1	379	457	+	78	0	-56	396
O95831-1#3	0	28	28	O95831-1	99	127	+	28	O95831-1	0	613	ENST00000675427.1	89	1925	++	240	O95831-1#3	0	84	ENST00000675427.1	386	470	+	84	0	-56	397
O95831-1#3	0	28	28	O95831-1	99	127	+	28	O95831-1	0	524	ENST00000675240.1	169	1741	++	239	O95831-1#3	0	84	ENST00000675240.1	466	550	+	84	0	-56	398
O95831-1#3	0	28	28	O95831-1	99	127	+	28	O95831-1	0	613	ENST00000675092.1	90	1956	++	238	O95831-1#3	0	84	ENST00000675092.1	387	471	+	84	0	-56	399
O95831-1#3	0	28	28	O95831-1	99	127	+	28	O95831-1	0	613	ENST00000675050.1	71	1898	++	237	O95831-1#3	0	84	ENST00000675050.1	356	440	+	84	0	-56	400
O95831-1#3	0	28	28	O95831-1	99	127	+	28	O95831-1	0	459	ENST00000675037.1	56	1433	++	236	O95831-1#3	0	84	ENST00000675037.1	353	437	+	84	0	-56	401
O95831-1#3	0	28	28	O95831-1	99	127	+	28	O95831-1	100	388	ENST00000674957.1	1	865	++	234	O95831-1#3	3	84	ENST00000674957.1	1	82	+	81	3	-56	402
O95831-1#3	0	28	28	O95831-1	99	127	+	28	O95831-1	0	238	ENST00000674722.1	13	727	++	233	O95831-1#3	0	84	ENST00000674722.1	310	394	+	84	0	-56	403
O95831-1#3	0	28	28	O95831-1	99	127	+	28	O95831-1	0	587	ENST00000674546.1	185	1954	++	230	O95831-1#3	0	84	ENST00000674546.1	482	566	+	84	0	-56	404
O95831-1#3	0	28	28	O95831-1	99	127	+	28	O95831-1	0	322	ENST00000535724.6	8	974	++	150	O95831-1#3	0	84	ENST00000535724.6	305	389	+	84	0	-56	405
O95831-1#3	0	28	28	O95831-1	99	127	+	28	O95831-1	0	435	ENST00000416073.7	37	1336	++	76	O95831-1#3	0	84	ENST00000416073.7	334	412	+	78	0	-56	406
O95831-1#3	0	28	28	O95831-1	99	127	+	28	O95831-1	0	613	ENST00000319908.8	174	2007	++	26	O95831-1#3	0	84	ENST00000319908.8	471	555	+	84	0	-56	407
O95831-1#3	0	28	28	O95831-1	99	127	+	28	O95831-1	0	613	ENST00000287295.8	185	2024	++	18	O95831-1#3	0	84	ENST00000287295.8	482	566	+	84	0	-56	408
O95831-1#4	0	350	350	O95831-1	133	483	+	350	O95831-1	0	613	ENST00000676436.1	34	1861	++	246	O95831-1#4	0	1050	ENST00000676436.1	427	1471	+	1044	0	-700	409
O95831-1#4	0	350	350	O95831-1	133	483	+	350	O95831-1	0	613	ENST00000676328.1	56	1892	++	245	O95831-1#4	0	1050	ENST00000676328.1	455	1502	+	1047	0	-700	410
O95831-1#4	0	350	350	O95831-1	133	483	+	350	O95831-1	0	613	ENST00000676229.1	223	2050	++	244	O95831-1#4	0	1050	ENST00000676229.1	610	1660	+	1050	0	-700	411
O95831-1#4	0	350	350	O95831-1	133	483	+	350	O95831-1	109	136	ENST00000676144.1	102	183	++	243	O95831-1#4	0	9	ENST00000676144.1	174	183	+	9	0	341	412
O95831-1#4	0	350	350	O95831-1	133	483	+	350	O95831-1	0	613	ENST00000675857.1	82	1915	++	242	O95831-1#4	0	1050	ENST00000675857.1	475	1525	+	1050	0	-700	413
O95831-1#4	0	350	350	O95831-1	133	483	+	350	O95831-1	0	613	ENST00000675427.1	89	1925	++	240	O95831-1#4	0	1050	ENST00000675427.1	488	1535	+	1047	0	-700	414
O95831-1#4	0	350	350	O95831-1	133	483	+	350	O95831-1	0	524	ENST00000675240.1	169	1741	++	239	O95831-1#4	0	1050	ENST00000675240.1	568	1618	+	1050	0	-700	415
O95831-1#4	0	350	350	O95831-1	133	483	+	350	O95831-1	0	613	ENST00000675092.1	90	1956	++	238	O95831-1#4	0	1050	ENST00000675092.1	489	1539	+	1050	0	-700	416
O95831-1#4	0	350	350	O95831-1	133	483	+	350	O95831-1	0	613	ENST00000675050.1	71	1898	++	237	O95831-1#4	0	1050	ENST00000675050.1	458	1508	+	1050	0	-700	417
O95831-1#4	0	350	350	O95831-1	133	483	+	350	O95831-1	0	459	ENST00000675037.1	56	1433	++	236	O95831-1#4	0	978	ENST00000675037.1	455	1433	+	978	0	-628	418
O95831-1#4	0	350	350	O95831-1	133	483	+	350	O95831-1	100	388	ENST00000674957.1	1	865	++	234	O95831-1#4	0	765	ENST00000674957.1	100	865	+	765	0	-415	419
O95831-1#4	0	350	350	O95831-1	133	483	+	350	O95831-1	0	238	ENST00000674722.1	13	727	++	233	O95831-1#4	0	315	ENST00000674722.1	412	727	+	315	0	35	420
O95831-1#4	0	350	350	O95831-1	133	483	+	350	O95831-1	338	613	ENST00000674601.1	2	686	++	232	O95831-1#4	615	1050	ENST00000674601.1	2	296	+	294	615	-700	421
O95831-1#4	0	350	350	O95831-1	133	483	+	350	O95831-1	0	587	ENST00000674546.1	185	1954	++	230	O95831-1#4	0	1050	ENST00000674546.1	584	1634	+	1050	0	-700	422
O95831-1#4	0	350	350	O95831-1	133	483	+	350	O95831-1	0	322	ENST00000535724.6	8	974	++	150	O95831-1#4	0	567	ENST00000535724.6	407	974	+	567	0	-217	423
O95831-1#4	0	350	350	O95831-1	133	483	+	350	O95831-1	339	613	ENST00000460436.6	905	1727	++	106	O95831-1#4	618	1050	ENST00000460436.6	905	1337	+	432	618	-700	424
O95831-1#4	0	350	350	O95831-1	133	483	+	350	O95831-1	0	435	ENST00000416073.7	37	1336	++	76	O95831-1#4	0	906	ENST00000416073.7	430	1336	+	906	0	-556	425
O95831-1#4	0	350	350	O95831-1	133	483	+	350	O95831-1	0	613	ENST00000346424.6	24	1002	++	35	O95831-1#4	567	1050	ENST00000346424.6	129	612	+	483	567	-700	426
O95831-1#4	0	350	350	O95831-1	133	483	+	350	O95831-1	0	613	ENST00000319908.8	174	2007	++	26	O95831-1#4	0	1047	ENST00000319908.8	573	1617	+	1044	0	-697	427
O95831-1#4	0	350	350	O95831-1	133	483	+	350	O95831-1	0	613	ENST00000287295.8	185	2024	++	18	O95831-1#4	0	1050	ENST00000287295.8	584	1634	+	1050	0	-700	428
O95831-1#5	0	42	42	O95831-1	512	554	+	42	O95831-1	0	613	ENST00000676436.1	34	1861	++	246	O95831-1#5	0	126	ENST00000676436.1	1558	1684	+	126	0	-84	429
O95831-1#5	0	42	42	O95831-1	512	554	+	42	O95831-1	0	613	ENST00000676328.1	56	1892	++	245	O95831-1#5	0	126	ENST00000676328.1	1589	1715	+	126	0	-84	430
O95831-1#5	0	42	42	O95831-1	512	554	+	42	O95831-1	0	613	ENST00000676229.1	223	2050	++	244	O95831-1#5	0	126	ENST00000676229.1	1747	1873	+	126	0	-84	431
O95831-1#5	0	42	42	O95831-1	512	554	+	42	O95831-1	0	613	ENST00000675857.1	82	1915	++	242	O95831-1#5	0	126	ENST00000675857.1	1612	1738	+	126	0	-84	432
O95831-1#5	0	42	42	O95831-1	512	554	+	42	O95831-1	0	613	ENST00000675427.1	89	1925	++	240	O95831-1#5	0	126	ENST00000675427.1	1622	1748	+	126	0	-84	433
O95831-1#5	0	42	42	O95831-1	512	554	+	42	O95831-1	0	524	ENST00000675240.1	169	1741	++	239	O95831-1#5	0	36	ENST00000675240.1	1705	1741	+	36	0	6	434
O95831-1#5	0	42	42	O95831-1	512	554	+	42	O95831-1	0	613	ENST00000675092.1	90	1956	++	238	O95831-1#5	0	126	ENST00000675092.1	1626	1779	+	126	0	-84	435
O95831-1#5	0	42	42	O95831-1	512	554	+	42	O95831-1	0	613	ENST00000675050.1	71	1898	++	237	O95831-1#5	0	126	ENST00000675050.1	1595	1721	+	126	0	-84	436
O95831-1#5	0	42	42	O95831-1	512	554	+	42	O95831-1	338	613	ENST00000674601.1	2	686	++	232	O95831-1#5	0	126	ENST00000674601.1	383	509	+	126	0	-84	437
O95831-1#5	0	42	42	O95831-1	512	554	+	42	O95831-1	0	587	ENST00000674546.1	185	1954	++	230	O95831-1#5	0	126	ENST00000674546.1	1721	1855	+	126	0	-84	438
O95831-1#5	0	42	42	O95831-1	512	554	+	42	O95831-1	339	613	ENST00000460436.6	905	1727	++	106	O95831-1#5	0	126	ENST00000460436.6	1424	1550	+	126	0	-84	439
O95831-1#5	0	42	42	O95831-1	512	554	+	42	O95831-1	0	613	ENST00000346424.6	24	1002	++	35	O95831-1#5	0	126	ENST00000346424.6	699	825	+	126	0	-84	440
O95831-1#5	0	42	42	O95831-1	512	554	+	42	O95831-1	0	613	ENST00000319908.8	174	2007	++	26	O95831-1#5	0	126	ENST00000319908.8	1704	1830	+	126	0	-84	441
O95831-1#5	0	42	42	O95831-1	512	554	+	42	O95831-1	0	613	ENST00000287295.8	185	2024	++	18	O95831-1#5	0	126	ENST00000287295.8	1721	1847	+	126	0	-84	442
O95831-1#6	0	31	31	O95831-1	0	31	+	31	O95831-1	0	613	ENST00000676436.1	34	1861	++	246	O95831-1#6	0	93	ENST00000676436.1	34	127	+	93	0	-62	443
O95831-1#6	0	31	31	O95831-1	0	31	+	31	O95831-1	0	613	ENST00000676328.1	56	1892	++	245	O95831-1#6	0	93	ENST00000676328.1	56	149	+	93	0	-62	444
O95831-1#6	0	31	31	O95831-1	0	31	+	31	O95831-1	0	613	ENST00000676229.1	223	2050	++	244	O95831-1#6	0	93	ENST00000676229.1	223	316	+	93	0	-62	445
O95831-1#6	0	31	31	O95831-1	0	31	+	31	O95831-1	0	613	ENST00000675857.1	82	1915	++	242	O95831-1#6	0	93	ENST00000675857.1	82	175	+	93	0	-62	446
O95831-1#6	0	31	31	O95831-1	0	31	+	31	O95831-1	0	36	ENST00000675774.1	41	149	++	241	O95831-1#6	0	93	ENST00000675774.1	41	134	+	93	0	-62	447
O95831-1#6	0	31	31	O95831-1	0	31	+	31	O95831-1	0	613	ENST00000675427.1	89	1925	++	240	O95831-1#6	0	93	ENST00000675427.1	89	182	+	93	0	-62	448
O95831-1#6	0	31	31	O95831-1	0	31	+	31	O95831-1	0	524	ENST00000675240.1	169	1741	++	239	O95831-1#6	0	93	ENST00000675240.1	169	262	+	93	0	-62	449
O95831-1#6	0	31	31	O95831-1	0	31	+	31	O95831-1	0	613	ENST00000675092.1	90	1956	++	238	O95831-1#6	0	93	ENST00000675092.1	90	183	+	93	0	-62	450
O95831-1#6	0	31	31	O95831-1	0	31	+	31	O95831-1	0	613	ENST00000675050.1	71	1898	++	237	O95831-1#6	0	93	ENST00000675050.1	71	164	+	93	0	-62	451
O95831-1#6	0	31	31	O95831-1	0	31	+	31	O95831-1	0	459	ENST00000675037.1	56	1433	++	236	O95831-1#6	0	93	ENST00000675037.1	56	149	+	93	0	-62	452
O95831-1#6	0	31	31	O95831-1	0	31	+	31	O95831-1	0	36	ENST00000674997.1	0	108	++	235	O95831-1#6	0	93	ENST00000674997.1	0	93	+	93	0	-62	453
O95831-1#6	0	31	31	O95831-1	0	31	+	31	O95831-1	0	238	ENST00000674722.1	13	727	++	233	O95831-1#6	0	93	ENST00000674722.1	13	106	+	93	0	-62	454
O95831-1#6	0	31	31	O95831-1	0	31	+	31	O95831-1	0	91	ENST00000674555.1	57	330	++	231	O95831-1#6	0	93	ENST00000674555.1	57	150	+	93	0	-62	455
O95831-1#6	0	31	31	O95831-1	0	31	+	31	O95831-1	0	587	ENST00000674546.1	185	1954	++	230	O95831-1#6	0	93	ENST00000674546.1	185	278	+	93	0	-62	456
O95831-1#6	0	31	31	O95831-1	0	31	+	31	O95831-1	0	322	ENST00000535724.6	8	974	++	150	O95831-1#6	0	93	ENST00000535724.6	8	101	+	93	0	-62	457
O95831-1#6	0	31	31	O95831-1	0	31	+	31	O95831-1	0	83	ENST00000529877.1	103	352	++	145	O95831-1#6	0	93	ENST00000529877.1	103	196	+	93	0	-62	458
O95831-1#6	0	31	31	O95831-1	0	31	+	31	O95831-1	0	36	ENST00000527892.5	8	116	++	142	O95831-1#6	0	93	ENST00000527892.5	8	101	+	93	0	-62	459
O95831-1#6	0	31	31	O95831-1	0	31	+	31	O95831-1	0	435	ENST00000416073.7	37	1336	++	76	O95831-1#6	0	93	ENST00000416073.7	37	130	+	93	0	-62	460
O95831-1#6	0	31	31	O95831-1	0	31	+	31	O95831-1	0	613	ENST00000346424.6	24	1002	++	35	O95831-1#6	0	93	ENST00000346424.6	24	117	+	93	0	-62	461
O95831-1#6	0	31	31	O95831-1	0	31	+	31	O95831-1	0	613	ENST00000319908.8	174	2007	++	26	O95831-1#6	0	93	ENST00000319908.8	174	267	+	93	0	-62	462
O95831-1#6	0	31	31	O95831-1	0	31	+	31	O95831-1	0	613	ENST00000287295.8	185	2024	++	18	O95831-1#6	0	93	ENST00000287295.8	185	278	+	93	0	-62	463
O95831-1#7	0	27	27	O95831-1	62	89	+	27	O95831-1	0	613	ENST00000676436.1	34	1861	++	246	O95831-1#7	0	81	ENST00000676436.1	220	301	+	81	0	-54	464
O95831-1#7	0	27	27	O95831-1	62	89	+	27	O95831-1	0	613	ENST00000676328.1	56	1892	++	245	O95831-1#7	0	81	ENST00000676328.1	242	323	+	81	0	-54	465
O95831-1#7	0	27	27	O95831-1	62	89	+	27	O95831-1	0	613	ENST00000676229.1	223	2050	++	244	O95831-1#7	0	81	ENST00000676229.1	394	478	+	81	0	-54	466
O95831-1#7	0	27	27	O95831-1	62	89	+	27	O95831-1	0	613	ENST00000675857.1	82	1915	++	242	O95831-1#7	0	81	ENST00000675857.1	268	349	+	81	0	-54	467
O95831-1#7	0	27	27	O95831-1	62	89	+	27	O95831-1	0	613	ENST00000675427.1	89	1925	++	240	O95831-1#7	0	81	ENST00000675427.1	275	356	+	81	0	-54	468
O95831-1#7	0	27	27	O95831-1	62	89	+	27	O95831-1	0	524	ENST00000675240.1	169	1741	++	239	O95831-1#7	0	81	ENST00000675240.1	355	436	+	81	0	-54	469
O95831-1#7	0	27	27	O95831-1	62	89	+	27	O95831-1	0	613	ENST00000675092.1	90	1956	++	238	O95831-1#7	0	81	ENST00000675092.1	276	357	+	81	0	-54	470
O95831-1#7	0	27	27	O95831-1	62	89	+	27	O95831-1	0	613	ENST00000675050.1	71	1898	++	237	O95831-1#7	0	81	ENST00000675050.1	242	326	+	81	0	-54	471
O95831-1#7	0	27	27	O95831-1	62	89	+	27	O95831-1	0	459	ENST00000675037.1	56	1433	++	236	O95831-1#7	0	81	ENST00000675037.1	242	323	+	81	0	-54	472
O95831-1#7	0	27	27	O95831-1	62	89	+	27	O95831-1	0	238	ENST00000674722.1	13	727	++	233	O95831-1#7	0	81	ENST00000674722.1	199	280	+	81	0	-54	473
O95831-1#7	0	27	27	O95831-1	62	89	+	27	O95831-1	0	91	ENST00000674555.1	57	330	++	231	O95831-1#7	0	81	ENST00000674555.1	243	324	+	81	0	-54	474
O95831-1#7	0	27	27	O95831-1	62	89	+	27	O95831-1	0	587	ENST00000674546.1	185	1954	++	230	O95831-1#7	0	81	ENST00000674546.1	371	452	+	81	0	-54	475
O95831-1#7	0	27	27	O95831-1	62	89	+	27	O95831-1	0	322	ENST00000535724.6	8	974	++	150	O95831-1#7	0	81	ENST00000535724.6	194	275	+	81	0	-54	476
O95831-1#7	0	27	27	O95831-1	62	89	+	27	O95831-1	0	83	ENST00000529877.1	103	352	++	145	O95831-1#7	0	63	ENST00000529877.1	289	352	+	63	0	-36	477
O95831-1#7	0	27	27	O95831-1	62	89	+	27	O95831-1	0	435	ENST00000416073.7	37	1336	++	76	O95831-1#7	0	81	ENST00000416073.7	223	304	+	81	0	-54	478
O95831-1#7	0	27	27	O95831-1	62	89	+	27	O95831-1	0	613	ENST00000319908.8	174	2007	++	26	O95831-1#7	0	81	ENST00000319908.8	360	441	+	81	0	-54	479
O95831-1#7	0	27	27	O95831-1	62	89	+	27	O95831-1	0	613	ENST00000287295.8	185	2024	++	18	O95831-1#7	0	81	ENST00000287295.8	371	452	+	81	0	-54	480
O95831-1#8	0	6	6	O95831-1	445	451	+	6	O95831-1	0	613	ENST00000676436.1	34	1861	++	246	O95831-1#8	0	18	ENST00000676436.1	1357	1375	+	18	0	-12	481
O95831-1#8	0	6	6	O95831-1	445	451	+	6	O95831-1	0	613	ENST00000676328.1	56	1892	++	245	O95831-1#8	0	18	ENST00000676328.1	1388	1406	+	18	0	-12	482
O95831-1#8	0	6	6	O95831-1	445	451	+	6	O95831-1	0	613	ENST00000676229.1	223	2050	++	244	O95831-1#8	0	18	ENST00000676229.1	1546	1564	+	18	0	-12	483
O95831-1#8	0	6	6	O95831-1	445	451	+	6	O95831-1	0	613	ENST00000675857.1	82	1915	++	242	O95831-1#8	0	18	ENST00000675857.1	1411	1429	+	18	0	-12	484
O95831-1#8	0	6	6	O95831-1	445	451	+	6	O95831-1	0	613	ENST00000675427.1	89	1925	++	240	O95831-1#8	0	18	ENST00000675427.1	1421	1439	+	18	0	-12	485
O95831-1#8	0	6	6	O95831-1	445	451	+	6	O95831-1	0	524	ENST00000675240.1	169	1741	++	239	O95831-1#8	0	18	ENST00000675240.1	1504	1522	+	18	0	-12	486
O95831-1#8	0	6	6	O95831-1	445	451	+	6	O95831-1	0	613	ENST00000675092.1	90	1956	++	238	O95831-1#8	0	18	ENST00000675092.1	1425	1443	+	18	0	-12	487
O95831-1#8	0	6	6	O95831-1	445	451	+	6	O95831-1	0	613	ENST00000675050.1	71	1898	++	237	O95831-1#8	0	18	ENST00000675050.1	1394	1412	+	18	0	-12	488
O95831-1#8	0	6	6	O95831-1	445	451	+	6	O95831-1	0	459	ENST00000675037.1	56	1433	++	236	O95831-1#8	0	18	ENST00000675037.1	1391	1409	+	18	0	-12	489
O95831-1#8	0	6	6	O95831-1	445	451	+	6	O95831-1	338	613	ENST00000674601.1	2	686	++	232	O95831-1#8	0	18	ENST00000674601.1	182	200	+	18	0	-12	490
O95831-1#8	0	6	6	O95831-1	445	451	+	6	O95831-1	0	587	ENST00000674546.1	185	1954	++	230	O95831-1#8	0	18	ENST00000674546.1	1520	1538	+	18	0	-12	491
O95831-1#8	0	6	6	O95831-1	445	451	+	6	O95831-1	339	613	ENST00000460436.6	905	1727	++	106	O95831-1#8	0	18	ENST00000460436.6	1223	1241	+	18	0	-12	492
O95831-1#8	0	6	6	O95831-1	445	451	+	6	O95831-1	0	613	ENST00000346424.6	24	1002	++	35	O95831-1#8	0	18	ENST00000346424.6	498	516	+	18	0	-12	493
O95831-1#8	0	6	6	O95831-1	445	451	+	6	O95831-1	0	613	ENST00000319908.8	174	2007	++	26	O95831-1#8	0	18	ENST00000319908.8	1506	1524	+	18	0	-12	494
O95831-1#8	0	6	6	O95831-1	445	451	+	6	O95831-1	0	613	ENST00000287295.8	185	2024	++	18	O95831-1#8	0	18	ENST00000287295.8	1520	1538	+	18	0	-12	495
O95831-1#9	0	33	33	O95831-1	513	546	+	33	O95831-1	0	613	ENST00000676436.1	34	1861	++	246	O95831-1#9	0	99	ENST00000676436.1	1561	1660	+	99	0	-66	496
O95831-1#9	0	33	33	O95831-1	513	546	+	33	O95831-1	0	613	ENST00000676328.1	56	1892	++	245	O95831-1#9	0	99	ENST00000676328.1	1592	1691	+	99	0	-66	497
O95831-1#9	0	33	33	O95831-1	513	546	+	33	O95831-1	0	613	ENST00000676229.1	223	2050	++	244	O95831-1#9	0	99	ENST00000676229.1	1750	1849	+	99	0	-66	498
O95831-1#9	0	33	33	O95831-1	513	546	+	33	O95831-1	0	613	ENST00000675857.1	82	1915	++	242	O95831-1#9	0	99	ENST00000675857.1	1615	1714	+	99	0	-66	499
O95831-1#9	0	33	33	O95831-1	513	546	+	33	O95831-1	0	613	ENST00000675427.1	89	1925	++	240	O95831-1#9	0	99	ENST00000675427.1	1625	1724	+	99	0	-66	500
O95831-1#9	0	33	33	O95831-1	513	546	+	33	O95831-1	0	524	ENST00000675240.1	169	1741	++	239	O95831-1#9	0	33	ENST00000675240.1	1708	1741	+	33	0	0	501
O95831-1#9	0	33	33	O95831-1	513	546	+	33	O95831-1	0	613	ENST00000675092.1	90	1956	++	238	O95831-1#9	0	99	ENST00000675092.1	1629	1755	+	99	0	-66	502
O95831-1#9	0	33	33	O95831-1	513	546	+	33	O95831-1	0	613	ENST00000675050.1	71	1898	++	237	O95831-1#9	0	99	ENST00000675050.1	1598	1697	+	99	0	-66	503
O95831-1#9	0	33	33	O95831-1	513	546	+	33	O95831-1	338	613	ENST00000674601.1	2	686	++	232	O95831-1#9	0	99	ENST00000674601.1	386	485	+	99	0	-66	504
O95831-1#9	0	33	33	O95831-1	513	546	+	33	O95831-1	0	587	ENST00000674546.1	185	1954	++	230	O95831-1#9	0	99	ENST00000674546.1	1724	1831	+	99	0	-66	505
O95831-1#9	0	33	33	O95831-1	513	546	+	33	O95831-1	339	613	ENST00000460436.6	905	1727	++	106	O95831-1#9	0	99	ENST00000460436.6	1427	1526	+	99	0	-66	506
O95831-1#9	0	33	33	O95831-1	513	546	+	33	O95831-1	0	613	ENST00000346424.6	24	1002	++	35	O95831-1#9	0	99	ENST00000346424.6	702	801	+	99	0	-66	507
O95831-1#9	0	33	33	O95831-1	513	546	+	33	O95831-1	0	613	ENST00000319908.8	174	2007	++	26	O95831-1#9	0	99	ENST00000319908.8	1707	1806	+	99	0	-66	508
O95831-1#9	0	33	33	O95831-1	513	546	+	33	O95831-1	0	613	ENST00000287295.8	185	2024	++	18	O95831-1#9	0	99	ENST00000287295.8	1724	1823	+	99	0	-66	509
O95831-1#10	0	5	5	O95831-1	137	142	+	5	O95831-1	0	613	ENST00000676436.1	34	1861	++	246	O95831-1#10	0	15	ENST00000676436.1	439	454	+	15	0	-10	510
O95831-1#10	0	5	5	O95831-1	137	142	+	5	O95831-1	0	613	ENST00000676328.1	56	1892	++	245	O95831-1#10	0	15	ENST00000676328.1	467	482	+	15	0	-10	511
O95831-1#10	0	5	5	O95831-1	137	142	+	5	O95831-1	0	613	ENST00000676229.1	223	2050	++	244	O95831-1#10	0	15	ENST00000676229.1	622	637	+	15	0	-10	512
O95831-1#10	0	5	5	O95831-1	137	142	+	5	O95831-1	0	613	ENST00000675857.1	82	1915	++	242	O95831-1#10	0	15	ENST00000675857.1	487	502	+	15	0	-10	513
O95831-1#10	0	5	5	O95831-1	137	142	+	5	O95831-1	0	613	ENST00000675427.1	89	1925	++	240	O95831-1#10	0	15	ENST00000675427.1	500	515	+	15	0	-10	514
O95831-1#10	0	5	5	O95831-1	137	142	+	5	O95831-1	0	524	ENST00000675240.1	169	1741	++	239	O95831-1#10	0	15	ENST00000675240.1	580	595	+	15	0	-10	515
O95831-1#10	0	5	5	O95831-1	137	142	+	5	O95831-1	0	613	ENST00000675092.1	90	1956	++	238	O95831-1#10	0	15	ENST00000675092.1	501	516	+	15	0	-10	516
O95831-1#10	0	5	5	O95831-1	137	142	+	5	O95831-1	0	613	ENST00000675050.1	71	1898	++	237	O95831-1#10	0	15	ENST00000675050.1	470	485	+	15	0	-10	517
O95831-1#10	0	5	5	O95831-1	137	142	+	5	O95831-1	0	459	ENST00000675037.1	56	1433	++	236	O95831-1#10	0	15	ENST00000675037.1	467	482	+	15	0	-10	518
O95831-1#10	0	5	5	O95831-1	137	142	+	5	O95831-1	100	388	ENST00000674957.1	1	865	++	234	O95831-1#10	0	15	ENST00000674957.1	112	127	+	15	0	-10	519
O95831-1#10	0	5	5	O95831-1	137	142	+	5	O95831-1	0	238	ENST00000674722.1	13	727	++	233	O95831-1#10	0	15	ENST00000674722.1	424	439	+	15	0	-10	520
O95831-1#10	0	5	5	O95831-1	137	142	+	5	O95831-1	0	587	ENST00000674546.1	185	1954	++	230	O95831-1#10	0	15	ENST00000674546.1	596	611	+	15	0	-10	521
O95831-1#10	0	5	5	O95831-1	137	142	+	5	O95831-1	0	322	ENST00000535724.6	8	974	++	150	O95831-1#10	0	15	ENST00000535724.6	419	434	+	15	0	-10	522
O95831-1#10	0	5	5	O95831-1	137	142	+	5	O95831-1	0	435	ENST00000416073.7	37	1336	++	76	O95831-1#10	0	15	ENST00000416073.7	442	457	+	15	0	-10	523
O95831-1#10	0	5	5	O95831-1	137	142	+	5	O95831-1	0	613	ENST00000319908.8	174	2007	++	26	O95831-1#10	0	15	ENST00000319908.8	585	600	+	15	0	-10	524
O95831-1#10	0	5	5	O95831-1	137	142	+	5	O95831-1	0	613	ENST00000287295.8	185	2024	++	18	O95831-1#10	0	15	ENST00000287295.8	596	611	+	15	0	-10	525
O95831-1#11	0	2	2	O95831-1	163	165	+	2	O95831-1	0	613	ENST00000676436.1	34	1861	++	246	O95831-1#11	0	6	ENST00000676436.1	517	523	+	6	0	-4	526
O95831-1#11	0	2	2	O95831-1	163	165	+	2	O95831-1	0	613	ENST00000676328.1	56	1892	++	245	O95831-1#11	0	6	ENST00000676328.1	545	551	+	6	0	-4	527
O95831-1#11	0	2	2	O95831-1	163	165	+	2	O95831-1	0	613	ENST00000676229.1	223	2050	++	244	O95831-1#11	0	6	ENST00000676229.1	700	706	+	6	0	-4	528
O95831-1#11	0	2	2	O95831-1	163	165	+	2	O95831-1	0	613	ENST00000675857.1	82	1915	++	242	O95831-1#11	0	6	ENST00000675857.1	565	571	+	6	0	-4	529
O95831-1#11	0	2	2	O95831-1	163	165	+	2	O95831-1	0	613	ENST00000675427.1	89	1925	++	240	O95831-1#11	0	6	ENST00000675427.1	578	584	+	6	0	-4	530
O95831-1#11	0	2	2	O95831-1	163	165	+	2	O95831-1	0	524	ENST00000675240.1	169	1741	++	239	O95831-1#11	0	6	ENST00000675240.1	658	664	+	6	0	-4	531
O95831-1#11	0	2	2	O95831-1	163	165	+	2	O95831-1	0	613	ENST00000675092.1	90	1956	++	238	O95831-1#11	0	6	ENST00000675092.1	579	585	+	6	0	-4	532
O95831-1#11	0	2	2	O95831-1	163	165	+	2	O95831-1	0	613	ENST00000675050.1	71	1898	++	237	O95831-1#11	0	6	ENST00000675050.1	548	554	+	6	0	-4	533
O95831-1#11	0	2	2	O95831-1	163	165	+	2	O95831-1	0	459	ENST00000675037.1	56	1433	++	236	O95831-1#11	0	6	ENST00000675037.1	545	551	+	6	0	-4	534
O95831-1#11	0	2	2	O95831-1	163	165	+	2	O95831-1	100	388	ENST00000674957.1	1	865	++	234	O95831-1#11	0	6	ENST00000674957.1	190	196	+	6	0	-4	535
O95831-1#11	0	2	2	O95831-1	163	165	+	2	O95831-1	0	238	ENST00000674722.1	13	727	++	233	O95831-1#11	0	6	ENST00000674722.1	502	508	+	6	0	-4	536
O95831-1#11	0	2	2	O95831-1	163	165	+	2	O95831-1	0	587	ENST00000674546.1	185	1954	++	230	O95831-1#11	0	6	ENST00000674546.1	674	680	+	6	0	-4	537
O95831-1#11	0	2	2	O95831-1	163	165	+	2	O95831-1	0	322	ENST00000535724.6	8	974	++	150	O95831-1#11	0	6	ENST00000535724.6	497	503	+	6	0	-4	538
O95831-1#11	0	2	2	O95831-1	163	165	+	2	O95831-1	0	435	ENST00000416073.7	37	1336	++	76	O95831-1#11	0	6	ENST00000416073.7	520	526	+	6	0	-4	539
O95831-1#11	0	2	2	O95831-1	163	165	+	2	O95831-1	0	613	ENST00000319908.8	174	2007	++	26	O95831-1#11	0	6	ENST00000319908.8	663	669	+	6	0	-4	540
O95831-1#11	0	2	2	O95831-1	163	165	+	2	O95831-1	0	613	ENST00000287295.8	185	2024	++	18	O95831-1#11	0	6	ENST00000287295.8	674	680	+	6	0	-4	541
O95831-1#12	0	1	1	O95831-1	171	172	+	1	O95831-1	0	613	ENST00000676436.1	34	1861	++	246	O95831-1#12	0	3	ENST00000676436.1	541	544	+	3	0	-2	542
O95831-1#12	0	1	1	O95831-1	171	172	+	1	O95831-1	0	613	ENST00000676328.1	56	1892	++	245	O95831-1#12	0	3	ENST00000676328.1	569	572	+	3	0	-2	543
O95831-1#12	0	1	1	O95831-1	171	172	+	1	O95831-1	0	613	ENST00000676229.1	223	2050	++	244	O95831-1#12	0	3	ENST00000676229.1	724	727	+	3	0	-2	544
O95831-1#12	0	1	1	O95831-1	171	172	+	1	O95831-1	0	613	ENST00000675857.1	82	1915	++	242	O95831-1#12	0	3	ENST00000675857.1	589	592	+	3	0	-2	545
O95831-1#12	0	1	1	O95831-1	171	172	+	1	O95831-1	0	613	ENST00000675427.1	89	1925	++	240	O95831-1#12	0	3	ENST00000675427.1	602	605	+	3	0	-2	546
O95831-1#12	0	1	1	O95831-1	171	172	+	1	O95831-1	0	524	ENST00000675240.1	169	1741	++	239	O95831-1#12	0	3	ENST00000675240.1	682	685	+	3	0	-2	547
O95831-1#12	0	1	1	O95831-1	171	172	+	1	O95831-1	0	613	ENST00000675092.1	90	1956	++	238	O95831-1#12	0	3	ENST00000675092.1	603	606	+	3	0	-2	548
O95831-1#12	0	1	1	O95831-1	171	172	+	1	O95831-1	0	613	ENST00000675050.1	71	1898	++	237	O95831-1#12	0	3	ENST00000675050.1	572	575	+	3	0	-2	549
O95831-1#12	0	1	1	O95831-1	171	172	+	1	O95831-1	0	459	ENST00000675037.1	56	1433	++	236	O95831-1#12	0	3	ENST00000675037.1	569	572	+	3	0	-2	550
O95831-1#12	0	1	1	O95831-1	171	172	+	1	O95831-1	100	388	ENST00000674957.1	1	865	++	234	O95831-1#12	0	3	ENST00000674957.1	214	217	+	3	0	-2	551
O95831-1#12	0	1	1	O95831-1	171	172	+	1	O95831-1	0	238	ENST00000674722.1	13	727	++	233	O95831-1#12	0	3	ENST00000674722.1	526	529	+	3	0	-2	552
O95831-1#12	0	1	1	O95831-1	171	172	+	1	O95831-1	0	587	ENST00000674546.1	185	1954	++	230	O95831-1#12	0	3	ENST00000674546.1	698	701	+	3	0	-2	553
O95831-1#12	0	1	1	O95831-1	171	172	+	1	O95831-1	0	322	ENST00000535724.6	8	974	++	150	O95831-1#12	0	3	ENST00000535724.6	521	524	+	3	0	-2	554
O95831-1#12	0	1	1	O95831-1	171	172	+	1	O95831-1	0	435	ENST00000416073.7	37	1336	++	76	O95831-1#12	0	3	ENST00000416073.7	544	547	+	3	0	-2	555
O95831-1#12	0	1	1	O95831-1	171	172	+	1	O95831-1	0	613	ENST00000319908.8	174	2007	++	26	O95831-1#12	0	3	ENST00000319908.8	687	690	+	3	0	-2	556
O95831-1#12	0	1	1	O95831-1	171	172	+	1	O95831-1	0	613	ENST00000287295.8	185	2024	++	18	O95831-1#12	0	3	ENST00000287295.8	698	701	+	3	0	-2	557
O95831-1#13	0	1	1	O95831-1	176	177	+	1	O95831-1	0	613	ENST00000676436.1	34	1861	++	246	O95831-1#13	0	3	ENST00000676436.1	556	559	+	3	0	-2	558
O95831-1#13	0	1	1	O95831-1	176	177	+	1	O95831-1	0	613	ENST00000676328.1	56	1892	++	245	O95831-1#13	0	3	ENST00000676328.1	584	587	+	3	0	-2	559
O95831-1#13	0	1	1	O95831-1	176	177	+	1	O95831-1	0	613	ENST00000676229.1	223	2050	++	244	O95831-1#13	0	3	ENST00000676229.1	739	742	+	3	0	-2	560
O95831-1#13	0	1	1	O95831-1	176	177	+	1	O95831-1	0	613	ENST00000675857.1	82	1915	++	242	O95831-1#13	0	3	ENST00000675857.1	604	607	+	3	0	-2	561
O95831-1#13	0	1	1	O95831-1	176	177	+	1	O95831-1	0	613	ENST00000675427.1	89	1925	++	240	O95831-1#13	0	3	ENST00000675427.1	617	620	+	3	0	-2	562
O95831-1#13	0	1	1	O95831-1	176	177	+	1	O95831-1	0	524	ENST00000675240.1	169	1741	++	239	O95831-1#13	0	3	ENST00000675240.1	697	700	+	3	0	-2	563
O95831-1#13	0	1	1	O95831-1	176	177	+	1	O95831-1	0	613	ENST00000675092.1	90	1956	++	238	O95831-1#13	0	3	ENST00000675092.1	618	621	+	3	0	-2	564
O95831-1#13	0	1	1	O95831-1	176	177	+	1	O95831-1	0	613	ENST00000675050.1	71	1898	++	237	O95831-1#13	0	3	ENST00000675050.1	587	590	+	3	0	-2	565
O95831-1#13	0	1	1	O95831-1	176	177	+	1	O95831-1	0	459	ENST00000675037.1	56	1433	++	236	O95831-1#13	0	3	ENST00000675037.1	584	587	+	3	0	-2	566
O95831-1#13	0	1	1	O95831-1	176	177	+	1	O95831-1	100	388	ENST00000674957.1	1	865	++	234	O95831-1#13	0	3	ENST00000674957.1	229	232	+	3	0	-2	567
O95831-1#13	0	1	1	O95831-1	176	177	+	1	O95831-1	0	238	ENST00000674722.1	13	727	++	233	O95831-1#13	0	3	ENST00000674722.1	541	544	+	3	0	-2	568
O95831-1#13	0	1	1	O95831-1	176	177	+	1	O95831-1	0	587	ENST00000674546.1	185	1954	++	230	O95831-1#13	0	3	ENST00000674546.1	713	716	+	3	0	-2	569
O95831-1#13	0	1	1	O95831-1	176	177	+	1	O95831-1	0	322	ENST00000535724.6	8	974	++	150	O95831-1#13	0	3	ENST00000535724.6	536	539	+	3	0	-2	570
O95831-1#13	0	1	1	O95831-1	176	177	+	1	O95831-1	0	435	ENST00000416073.7	37	1336	++	76	O95831-1#13	0	3	ENST00000416073.7	559	562	+	3	0	-2	571
O95831-1#13	0	1	1	O95831-1	176	177	+	1	O95831-1	0	613	ENST00000319908.8	174	2007	++	26	O95831-1#13	0	3	ENST00000319908.8	702	705	+	3	0	-2	572
O95831-1#13	0	1	1	O95831-1	176	177	+	1	O95831-1	0	613	ENST00000287295.8	185	2024	++	18	O95831-1#13	0	3	ENST00000287295.8	713	716	+	3	0	-2	573
O95831-1#14	0	1	1	O95831-1	195	196	+	1	O95831-1	0	613	ENST00000676436.1	34	1861	++	246	O95831-1#14	0	3	ENST00000676436.1	613	616	+	3	0	-2	574
O95831-1#14	0	1	1	O95831-1	195	196	+	1	O95831-1	0	613	ENST00000676328.1	56	1892	++	245	O95831-1#14	0	3	ENST00000676328.1	641	644	+	3	0	-2	575
O95831-1#14	0	1	1	O95831-1	195	196	+	1	O95831-1	0	613	ENST00000676229.1	223	2050	++	244	O95831-1#14	0	3	ENST00000676229.1	796	799	+	3	0	-2	576
O95831-1#14	0	1	1	O95831-1	195	196	+	1	O95831-1	0	613	ENST00000675857.1	82	1915	++	242	O95831-1#14	0	3	ENST00000675857.1	661	664	+	3	0	-2	577
O95831-1#14	0	1	1	O95831-1	195	196	+	1	O95831-1	0	613	ENST00000675427.1	89	1925	++	240	O95831-1#14	0	3	ENST00000675427.1	674	677	+	3	0	-2	578
O95831-1#14	0	1	1	O95831-1	195	196	+	1	O95831-1	0	524	ENST00000675240.1	169	1741	++	239	O95831-1#14	0	3	ENST00000675240.1	754	757	+	3	0	-2	579
O95831-1#14	0	1	1	O95831-1	195	196	+	1	O95831-1	0	613	ENST00000675092.1	90	1956	++	238	O95831-1#14	0	3	ENST00000675092.1	675	678	+	3	0	-2	580
O95831-1#14	0	1	1	O95831-1	195	196	+	1	O95831-1	0	613	ENST00000675050.1	71	1898	++	237	O95831-1#14	0	3	ENST00000675050.1	644	647	+	3	0	-2	581
O95831-1#14	0	1	1	O95831-1	195	196	+	1	O95831-1	0	459	ENST00000675037.1	56	1433	++	236	O95831-1#14	0	3	ENST00000675037.1	641	644	+	3	0	-2	582
O95831-1#14	0	1	1	O95831-1	195	196	+	1	O95831-1	100	388	ENST00000674957.1	1	865	++	234	O95831-1#14	0	3	ENST00000674957.1	286	289	+	3	0	-2	583
O95831-1#14	0	1	1	O95831-1	195	196	+	1	O95831-1	0	238	ENST00000674722.1	13	727	++	233	O95831-1#14	0	3	ENST00000674722.1	598	601	+	3	0	-2	584
O95831-1#14	0	1	1	O95831-1	195	196	+	1	O95831-1	0	587	ENST00000674546.1	185	1954	++	230	O95831-1#14	0	3	ENST00000674546.1	770	773	+	3	0	-2	585
O95831-1#14	0	1	1	O95831-1	195	196	+	1	O95831-1	0	322	ENST00000535724.6	8	974	++	150	O95831-1#14	0	3	ENST00000535724.6	593	596	+	3	0	-2	586
O95831-1#14	0	1	1	O95831-1	195	196	+	1	O95831-1	0	435	ENST00000416073.7	37	1336	++	76	O95831-1#14	0	3	ENST00000416073.7	616	619	+	3	0	-2	587
O95831-1#14	0	1	1	O95831-1	195	196	+	1	O95831-1	0	613	ENST00000319908.8	174	2007	++	26	O95831-1#14	0	3	ENST00000319908.8	759	762	+	3	0	-2	588
O95831-1#14	0	1	1	O95831-1	195	196	+	1	O95831-1	0	613	ENST00000287295.8	185	2024	++	18	O95831-1#14	0	3	ENST00000287295.8	770	773	+	3	0	-2	589
O95831-1#15	0	1	1	O95831-1	232	233	+	1	O95831-1	0	613	ENST00000676436.1	34	1861	++	246	O95831-1#15	0	3	ENST00000676436.1	724	727	+	3	0	-2	590
O95831-1#15	0	1	1	O95831-1	232	233	+	1	O95831-1	0	613	ENST00000676328.1	56	1892	++	245	O95831-1#15	0	3	ENST00000676328.1	752	755	+	3	0	-2	591
O95831-1#15	0	1	1	O95831-1	232	233	+	1	O95831-1	0	613	ENST00000676229.1	223	2050	++	244	O95831-1#15	0	3	ENST00000676229.1	907	910	+	3	0	-2	592
O95831-1#15	0	1	1	O95831-1	232	233	+	1	O95831-1	0	613	ENST00000675857.1	82	1915	++	242	O95831-1#15	0	3	ENST00000675857.1	772	775	+	3	0	-2	593
O95831-1#15	0	1	1	O95831-1	232	233	+	1	O95831-1	0	613	ENST00000675427.1	89	1925	++	240	O95831-1#15	0	3	ENST00000675427.1	785	788	+	3	0	-2	594
O95831-1#15	0	1	1	O95831-1	232	233	+	1	O95831-1	0	524	ENST00000675240.1	169	1741	++	239	O95831-1#15	0	3	ENST00000675240.1	865	868	+	3	0	-2	595
O95831-1#15	0	1	1	O95831-1	232	233	+	1	O95831-1	0	613	ENST00000675092.1	90	1956	++	238	O95831-1#15	0	3	ENST00000675092.1	786	789	+	3	0	-2	596
O95831-1#15	0	1	1	O95831-1	232	233	+	1	O95831-1	0	613	ENST00000675050.1	71	1898	++	237	O95831-1#15	0	3	ENST00000675050.1	755	758	+	3	0	-2	597
O95831-1#15	0	1	1	O95831-1	232	233	+	1	O95831-1	0	459	ENST00000675037.1	56	1433	++	236	O95831-1#15	0	3	ENST00000675037.1	752	755	+	3	0	-2	598
O95831-1#15	0	1	1	O95831-1	232	233	+	1	O95831-1	100	388	ENST00000674957.1	1	865	++	234	O95831-1#15	0	3	ENST00000674957.1	397	400	+	3	0	-2	599
O95831-1#15	0	1	1	O95831-1	232	233	+	1	O95831-1	0	238	ENST00000674722.1	13	727	++	233	O95831-1#15	0	3	ENST00000674722.1	709	712	+	3	0	-2	600
O95831-1#15	0	1	1	O95831-1	232	233	+	1	O95831-1	0	587	ENST00000674546.1	185	1954	++	230	O95831-1#15	0	3	ENST00000674546.1	881	884	+	3	0	-2	601
O95831-1#15	0	1	1	O95831-1	232	233	+	1	O95831-1	0	322	ENST00000535724.6	8	974	++	150	O95831-1#15	0	3	ENST00000535724.6	704	707	+	3	0	-2	602
O95831-1#15	0	1	1	O95831-1	232	233	+	1	O95831-1	0	435	ENST00000416073.7	37	1336	++	76	O95831-1#15	0	3	ENST00000416073.7	727	730	+	3	0	-2	603
O95831-1#15	0	1	1	O95831-1	232	233	+	1	O95831-1	0	613	ENST00000319908.8	174	2007	++	26	O95831-1#15	0	3	ENST00000319908.8	870	873	+	3	0	-2	604
O95831-1#15	0	1	1	O95831-1	232	233	+	1	O95831-1	0	613	ENST00000287295.8	185	2024	++	18	O95831-1#15	0	3	ENST00000287295.8	881	884	+	3	0	-2	605
O95831-1#16	0	1	1	O95831-1	284	285	+	1	O95831-1	0	613	ENST00000676436.1	34	1861	++	246	O95831-1#16	0	3	ENST00000676436.1	880	883	+	3	0	-2	606
O95831-1#16	0	1	1	O95831-1	284	285	+	1	O95831-1	0	613	ENST00000676328.1	56	1892	++	245	O95831-1#16	0	3	ENST00000676328.1	905	908	+	3	0	-2	607
O95831-1#16	0	1	1	O95831-1	284	285	+	1	O95831-1	0	613	ENST00000676229.1	223	2050	++	244	O95831-1#16	0	3	ENST00000676229.1	1063	1066	+	3	0	-2	608
O95831-1#16	0	1	1	O95831-1	284	285	+	1	O95831-1	0	613	ENST00000675857.1	82	1915	++	242	O95831-1#16	0	3	ENST00000675857.1	928	931	+	3	0	-2	609
O95831-1#16	0	1	1	O95831-1	284	285	+	1	O95831-1	0	613	ENST00000675427.1	89	1925	++	240	O95831-1#16	0	3	ENST00000675427.1	941	944	+	3	0	-2	610
O95831-1#16	0	1	1	O95831-1	284	285	+	1	O95831-1	0	524	ENST00000675240.1	169	1741	++	239	O95831-1#16	0	3	ENST00000675240.1	1021	1024	+	3	0	-2	611
O95831-1#16	0	1	1	O95831-1	284	285	+	1	O95831-1	0	613	ENST00000675092.1	90	1956	++	238	O95831-1#16	0	3	ENST00000675092.1	942	945	+	3	0	-2	612
O95831-1#16	0	1	1	O95831-1	284	285	+	1	O95831-1	0	613	ENST00000675050.1	71	1898	++	237	O95831-1#16	0	3	ENST00000675050.1	911	914	+	3	0	-2	613
O95831-1#16	0	1	1	O95831-1	284	285	+	1	O95831-1	0	459	ENST00000675037.1	56	1433	++	236	O95831-1#16	0	3	ENST00000675037.1	908	911	+	3	0	-2	614
O95831-1#16	0	1	1	O95831-1	284	285	+	1	O95831-1	100	388	ENST00000674957.1	1	865	++	234	O95831-1#16	0	3	ENST00000674957.1	553	556	+	3	0	-2	615
O95831-1#16	0	1	1	O95831-1	284	285	+	1	O95831-1	0	587	ENST00000674546.1	185	1954	++	230	O95831-1#16	0	3	ENST00000674546.1	1037	1040	+	3	0	-2	616
O95831-1#16	0	1	1	O95831-1	284	285	+	1	O95831-1	0	322	ENST00000535724.6	8	974	++	150	O95831-1#16	0	3	ENST00000535724.6	860	863	+	3	0	-2	617
O95831-1#16	0	1	1	O95831-1	284	285	+	1	O95831-1	0	435	ENST00000416073.7	37	1336	++	76	O95831-1#16	0	3	ENST00000416073.7	883	886	+	3	0	-2	618
O95831-1#16	0	1	1	O95831-1	284	285	+	1	O95831-1	0	613	ENST00000319908.8	174	2007	++	26	O95831-1#16	0	3	ENST00000319908.8	1023	1026	+	3	0	-2	619
O95831-1#16	0	1	1	O95831-1	284	285	+	1	O95831-1	0	613	ENST00000287295.8	185	2024	++	18	O95831-1#16	0	3	ENST00000287295.8	1037	1040	+	3	0	-2	620
O95831-1#17	0	4	4	O95831-1	307	311	+	4	O95831-1	0	613	ENST00000676436.1	34	1861	++	246	O95831-1#17	0	12	ENST00000676436.1	949	961	+	12	0	-8	621
O95831-1#17	0	4	4	O95831-1	307	311	+	4	O95831-1	0	613	ENST00000676328.1	56	1892	++	245	O95831-1#17	0	12	ENST00000676328.1	974	986	+	12	0	-8	622
O95831-1#17	0	4	4	O95831-1	307	311	+	4	O95831-1	0	613	ENST00000676229.1	223	2050	++	244	O95831-1#17	0	12	ENST00000676229.1	1132	1144	+	12	0	-8	623
O95831-1#17	0	4	4	O95831-1	307	311	+	4	O95831-1	0	613	ENST00000675857.1	82	1915	++	242	O95831-1#17	0	12	ENST00000675857.1	997	1009	+	12	0	-8	624
O95831-1#17	0	4	4	O95831-1	307	311	+	4	O95831-1	0	613	ENST00000675427.1	89	1925	++	240	O95831-1#17	0	12	ENST00000675427.1	1010	1022	+	12	0	-8	625
O95831-1#17	0	4	4	O95831-1	307	311	+	4	O95831-1	0	524	ENST00000675240.1	169	1741	++	239	O95831-1#17	0	12	ENST00000675240.1	1090	1102	+	12	0	-8	626
O95831-1#17	0	4	4	O95831-1	307	311	+	4	O95831-1	0	613	ENST00000675092.1	90	1956	++	238	O95831-1#17	0	12	ENST00000675092.1	1011	1023	+	12	0	-8	627
O95831-1#17	0	4	4	O95831-1	307	311	+	4	O95831-1	0	613	ENST00000675050.1	71	1898	++	237	O95831-1#17	0	12	ENST00000675050.1	980	992	+	12	0	-8	628
O95831-1#17	0	4	4	O95831-1	307	311	+	4	O95831-1	0	459	ENST00000675037.1	56	1433	++	236	O95831-1#17	0	12	ENST00000675037.1	977	989	+	12	0	-8	629
O95831-1#17	0	4	4	O95831-1	307	311	+	4	O95831-1	100	388	ENST00000674957.1	1	865	++	234	O95831-1#17	0	12	ENST00000674957.1	622	634	+	12	0	-8	630
O95831-1#17	0	4	4	O95831-1	307	311	+	4	O95831-1	0	587	ENST00000674546.1	185	1954	++	230	O95831-1#17	0	12	ENST00000674546.1	1106	1118	+	12	0	-8	631
O95831-1#17	0	4	4	O95831-1	307	311	+	4	O95831-1	0	322	ENST00000535724.6	8	974	++	150	O95831-1#17	0	12	ENST00000535724.6	929	941	+	12	0	-8	632
O95831-1#17	0	4	4	O95831-1	307	311	+	4	O95831-1	0	435	ENST00000416073.7	37	1336	++	76	O95831-1#17	0	12	ENST00000416073.7	952	964	+	12	0	-8	633
O95831-1#17	0	4	4	O95831-1	307	311	+	4	O95831-1	0	613	ENST00000319908.8	174	2007	++	26	O95831-1#17	0	12	ENST00000319908.8	1092	1104	+	12	0	-8	634
O95831-1#17	0	4	4	O95831-1	307	311	+	4	O95831-1	0	613	ENST00000287295.8	185	2024	++	18	O95831-1#17	0	12	ENST00000287295.8	1106	1118	+	12	0	-8	635
O95831-1#18	0	1	1	O95831-1	335	336	+	1	O95831-1	0	613	ENST00000676436.1	34	1861	++	246	O95831-1#18	0	3	ENST00000676436.1	1027	1030	+	3	0	-2	636
O95831-1#18	0	1	1	O95831-1	335	336	+	1	O95831-1	0	613	ENST00000676328.1	56	1892	++	245	O95831-1#18	0	3	ENST00000676328.1	1058	1061	+	3	0	-2	637
O95831-1#18	0	1	1	O95831-1	335	336	+	1	O95831-1	0	613	ENST00000676229.1	223	2050	++	244	O95831-1#18	0	3	ENST00000676229.1	1216	1219	+	3	0	-2	638
O95831-1#18	0	1	1	O95831-1	335	336	+	1	O95831-1	0	613	ENST00000675857.1	82	1915	++	242	O95831-1#18	0	3	ENST00000675857.1	1081	1084	+	3	0	-2	639
O95831-1#18	0	1	1	O95831-1	335	336	+	1	O95831-1	0	613	ENST00000675427.1	89	1925	++	240	O95831-1#18	0	3	ENST00000675427.1	1094	1097	+	3	0	-2	640
O95831-1#18	0	1	1	O95831-1	335	336	+	1	O95831-1	0	524	ENST00000675240.1	169	1741	++	239	O95831-1#18	0	3	ENST00000675240.1	1174	1177	+	3	0	-2	641
O95831-1#18	0	1	1	O95831-1	335	336	+	1	O95831-1	0	613	ENST00000675092.1	90	1956	++	238	O95831-1#18	0	3	ENST00000675092.1	1095	1098	+	3	0	-2	642
O95831-1#18	0	1	1	O95831-1	335	336	+	1	O95831-1	0	613	ENST00000675050.1	71	1898	++	237	O95831-1#18	0	3	ENST00000675050.1	1064	1067	+	3	0	-2	643
O95831-1#18	0	1	1	O95831-1	335	336	+	1	O95831-1	0	459	ENST00000675037.1	56	1433	++	236	O95831-1#18	0	3	ENST00000675037.1	1061	1064	+	3	0	-2	644
O95831-1#18	0	1	1	O95831-1	335	336	+	1	O95831-1	100	388	ENST00000674957.1	1	865	++	234	O95831-1#18	0	3	ENST00000674957.1	706	709	+	3	0	-2	645
O95831-1#18	0	1	1	O95831-1	335	336	+	1	O95831-1	0	587	ENST00000674546.1	185	1954	++	230	O95831-1#18	0	3	ENST00000674546.1	1190	1193	+	3	0	-2	646
O95831-1#18	0	1	1	O95831-1	335	336	+	1	O95831-1	0	435	ENST00000416073.7	37	1336	++	76	O95831-1#18	0	3	ENST00000416073.7	1036	1039	+	3	0	-2	647
O95831-1#18	0	1	1	O95831-1	335	336	+	1	O95831-1	0	613	ENST00000346424.6	24	1002	++	35	O95831-1#18	0	3	ENST00000346424.6	168	171	+	3	0	-2	648
O95831-1#18	0	1	1	O95831-1	335	336	+	1	O95831-1	0	613	ENST00000319908.8	174	2007	++	26	O95831-1#18	0	3	ENST00000319908.8	1176	1179	+	3	0	-2	649
O95831-1#18	0	1	1	O95831-1	335	336	+	1	O95831-1	0	613	ENST00000287295.8	185	2024	++	18	O95831-1#18	0	3	ENST00000287295.8	1190	1193	+	3	0	-2	650
O95831-1#19	0	1	1	O95831-1	341	342	+	1	O95831-1	0	613	ENST00000676436.1	34	1861	++	246	O95831-1#19	0	3	ENST00000676436.1	1045	1048	+	3	0	-2	651
O95831-1#19	0	1	1	O95831-1	341	342	+	1	O95831-1	0	613	ENST00000676328.1	56	1892	++	245	O95831-1#19	0	3	ENST00000676328.1	1076	1079	+	3	0	-2	652
O95831-1#19	0	1	1	O95831-1	341	342	+	1	O95831-1	0	613	ENST00000676229.1	223	2050	++	244	O95831-1#19	0	3	ENST00000676229.1	1234	1237	+	3	0	-2	653
O95831-1#19	0	1	1	O95831-1	341	342	+	1	O95831-1	0	613	ENST00000675857.1	82	1915	++	242	O95831-1#19	0	3	ENST00000675857.1	1099	1102	+	3	0	-2	654
O95831-1#19	0	1	1	O95831-1	341	342	+	1	O95831-1	0	613	ENST00000675427.1	89	1925	++	240	O95831-1#19	0	3	ENST00000675427.1	1112	1115	+	3	0	-2	655
O95831-1#19	0	1	1	O95831-1	341	342	+	1	O95831-1	0	524	ENST00000675240.1	169	1741	++	239	O95831-1#19	0	3	ENST00000675240.1	1192	1195	+	3	0	-2	656
O95831-1#19	0	1	1	O95831-1	341	342	+	1	O95831-1	0	613	ENST00000675092.1	90	1956	++	238	O95831-1#19	0	3	ENST00000675092.1	1113	1116	+	3	0	-2	657
O95831-1#19	0	1	1	O95831-1	341	342	+	1	O95831-1	0	613	ENST00000675050.1	71	1898	++	237	O95831-1#19	0	3	ENST00000675050.1	1082	1085	+	3	0	-2	658
O95831-1#19	0	1	1	O95831-1	341	342	+	1	O95831-1	0	459	ENST00000675037.1	56	1433	++	236	O95831-1#19	0	3	ENST00000675037.1	1079	1082	+	3	0	-2	659
O95831-1#19	0	1	1	O95831-1	341	342	+	1	O95831-1	100	388	ENST00000674957.1	1	865	++	234	O95831-1#19	0	3	ENST00000674957.1	724	727	+	3	0	-2	660
O95831-1#19	0	1	1	O95831-1	341	342	+	1	O95831-1	338	613	ENST00000674601.1	2	686	++	232	O95831-1#19	0	3	ENST00000674601.1	11	14	+	3	0	-2	661
O95831-1#19	0	1	1	O95831-1	341	342	+	1	O95831-1	0	587	ENST00000674546.1	185	1954	++	230	O95831-1#19	0	3	ENST00000674546.1	1208	1211	+	3	0	-2	662
O95831-1#19	0	1	1	O95831-1	341	342	+	1	O95831-1	339	613	ENST00000460436.6	905	1727	++	106	O95831-1#19	0	3	ENST00000460436.6	911	914	+	3	0	-2	663
O95831-1#19	0	1	1	O95831-1	341	342	+	1	O95831-1	0	435	ENST00000416073.7	37	1336	++	76	O95831-1#19	0	3	ENST00000416073.7	1054	1057	+	3	0	-2	664
O95831-1#19	0	1	1	O95831-1	341	342	+	1	O95831-1	0	613	ENST00000346424.6	24	1002	++	35	O95831-1#19	0	3	ENST00000346424.6	186	189	+	3	0	-2	665
O95831-1#19	0	1	1	O95831-1	341	342	+	1	O95831-1	0	613	ENST00000319908.8	174	2007	++	26	O95831-1#19	0	3	ENST00000319908.8	1194	1197	+	3	0	-2	666
O95831-1#19	0	1	1	O95831-1	341	342	+	1	O95831-1	0	613	ENST00000287295.8	185	2024	++	18	O95831-1#19	0	3	ENST00000287295.8	1208	1211	+	3	0	-2	667
O95831-1#20	0	1	1	O95831-1	398	399	+	1	O95831-1	0	613	ENST00000676436.1	34	1861	++	246	O95831-1#20	0	3	ENST00000676436.1	1216	1219	+	3	0	-2	668
O95831-1#20	0	1	1	O95831-1	398	399	+	1	O95831-1	0	613	ENST00000676328.1	56	1892	++	245	O95831-1#20	0	3	ENST00000676328.1	1247	1250	+	3	0	-2	669
O95831-1#20	0	1	1	O95831-1	398	399	+	1	O95831-1	0	613	ENST00000676229.1	223	2050	++	244	O95831-1#20	0	3	ENST00000676229.1	1405	1408	+	3	0	-2	670
O95831-1#20	0	1	1	O95831-1	398	399	+	1	O95831-1	0	613	ENST00000675857.1	82	1915	++	242	O95831-1#20	0	3	ENST00000675857.1	1270	1273	+	3	0	-2	671
O95831-1#20	0	1	1	O95831-1	398	399	+	1	O95831-1	0	613	ENST00000675427.1	89	1925	++	240	O95831-1#20	0	3	ENST00000675427.1	1283	1286	+	3	0	-2	672
O95831-1#20	0	1	1	O95831-1	398	399	+	1	O95831-1	0	524	ENST00000675240.1	169	1741	++	239	O95831-1#20	0	3	ENST00000675240.1	1363	1366	+	3	0	-2	673
O95831-1#20	0	1	1	O95831-1	398	399	+	1	O95831-1	0	613	ENST00000675092.1	90	1956	++	238	O95831-1#20	0	3	ENST00000675092.1	1284	1287	+	3	0	-2	674
O95831-1#20	0	1	1	O95831-1	398	399	+	1	O95831-1	0	613	ENST00000675050.1	71	1898	++	237	O95831-1#20	0	3	ENST00000675050.1	1253	1256	+	3	0	-2	675
O95831-1#20	0	1	1	O95831-1	398	399	+	1	O95831-1	0	459	ENST00000675037.1	56	1433	++	236	O95831-1#20	0	3	ENST00000675037.1	1250	1253	+	3	0	-2	676
O95831-1#20	0	1	1	O95831-1	398	399	+	1	O95831-1	0	587	ENST00000674546.1	185	1954	++	230	O95831-1#20	0	3	ENST00000674546.1	1379	1382	+	3	0	-2	677
O95831-1#20	0	1	1	O95831-1	398	399	+	1	O95831-1	339	613	ENST00000460436.6	905	1727	++	106	O95831-1#20	0	3	ENST00000460436.6	1082	1085	+	3	0	-2	678
O95831-1#20	0	1	1	O95831-1	398	399	+	1	O95831-1	0	435	ENST00000416073.7	37	1336	++	76	O95831-1#20	0	3	ENST00000416073.7	1225	1228	+	3	0	-2	679
O95831-1#20	0	1	1	O95831-1	398	399	+	1	O95831-1	0	613	ENST00000346424.6	24	1002	++	35	O95831-1#20	0	3	ENST00000346424.6	357	360	+	3	0	-2	680
O95831-1#20	0	1	1	O95831-1	398	399	+	1	O95831-1	0	613	ENST00000319908.8	174	2007	++	26	O95831-1#20	0	3	ENST00000319908.8	1365	1368	+	3	0	-2	681
O95831-1#20	0	1	1	O95831-1	398	399	+	1	O95831-1	0	613	ENST00000287295.8	185	2024	++	18	O95831-1#20	0	3	ENST00000287295.8	1379	1382	+	3	0	-2	682
O95831-1#21	0	1	1	O95831-1	437	438	+	1	O95831-1	0	613	ENST00000676436.1	34	1861	++	246	O95831-1#21	0	3	ENST00000676436.1	1333	1336	+	3	0	-2	683
O95831-1#21	0	1	1	O95831-1	437	438	+	1	O95831-1	0	613	ENST00000676328.1	56	1892	++	245	O95831-1#21	0	3	ENST00000676328.1	1364	1367	+	3	0	-2	684
O95831-1#21	0	1	1	O95831-1	437	438	+	1	O95831-1	0	613	ENST00000676229.1	223	2050	++	244	O95831-1#21	0	3	ENST00000676229.1	1522	1525	+	3	0	-2	685
O95831-1#21	0	1	1	O95831-1	437	438	+	1	O95831-1	0	613	ENST00000675857.1	82	1915	++	242	O95831-1#21	0	3	ENST00000675857.1	1387	1390	+	3	0	-2	686
O95831-1#21	0	1	1	O95831-1	437	438	+	1	O95831-1	0	613	ENST00000675427.1	89	1925	++	240	O95831-1#21	0	3	ENST00000675427.1	1397	1400	+	3	0	-2	687
O95831-1#21	0	1	1	O95831-1	437	438	+	1	O95831-1	0	524	ENST00000675240.1	169	1741	++	239	O95831-1#21	0	3	ENST00000675240.1	1480	1483	+	3	0	-2	688
O95831-1#21	0	1	1	O95831-1	437	438	+	1	O95831-1	0	613	ENST00000675092.1	90	1956	++	238	O95831-1#21	0	3	ENST00000675092.1	1401	1404	+	3	0	-2	689
O95831-1#21	0	1	1	O95831-1	437	438	+	1	O95831-1	0	613	ENST00000675050.1	71	1898	++	237	O95831-1#21	0	3	ENST00000675050.1	1370	1373	+	3	0	-2	690
O95831-1#21	0	1	1	O95831-1	437	438	+	1	O95831-1	0	459	ENST00000675037.1	56	1433	++	236	O95831-1#21	0	3	ENST00000675037.1	1367	1370	+	3	0	-2	691
O95831-1#21	0	1	1	O95831-1	437	438	+	1	O95831-1	338	613	ENST00000674601.1	2	686	++	232	O95831-1#21	0	3	ENST00000674601.1	158	161	+	3	0	-2	692
O95831-1#21	0	1	1	O95831-1	437	438	+	1	O95831-1	0	587	ENST00000674546.1	185	1954	++	230	O95831-1#21	0	3	ENST00000674546.1	1496	1499	+	3	0	-2	693
O95831-1#21	0	1	1	O95831-1	437	438	+	1	O95831-1	339	613	ENST00000460436.6	905	1727	++	106	O95831-1#21	0	3	ENST00000460436.6	1199	1202	+	3	0	-2	694
O95831-1#21	0	1	1	O95831-1	437	438	+	1	O95831-1	0	613	ENST00000346424.6	24	1002	++	35	O95831-1#21	0	3	ENST00000346424.6	474	477	+	3	0	-2	695
O95831-1#21	0	1	1	O95831-1	437	438	+	1	O95831-1	0	613	ENST00000319908.8	174	2007	++	26	O95831-1#21	0	3	ENST00000319908.8	1482	1485	+	3	0	-2	696
O95831-1#21	0	1	1	O95831-1	437	438	+	1	O95831-1	0	613	ENST00000287295.8	185	2024	++	18	O95831-1#21	0	3	ENST00000287295.8	1496	1499	+	3	0	-2	697
O95831-1#22	0	2	2	O95831-1	452	454	+	2	O95831-1	0	613	ENST00000676436.1	34	1861	++	246	O95831-1#22	0	6	ENST00000676436.1	1378	1384	+	6	0	-4	698
O95831-1#22	0	2	2	O95831-1	452	454	+	2	O95831-1	0	613	ENST00000676328.1	56	1892	++	245	O95831-1#22	0	6	ENST00000676328.1	1409	1415	+	6	0	-4	699
O95831-1#22	0	2	2	O95831-1	452	454	+	2	O95831-1	0	613	ENST00000676229.1	223	2050	++	244	O95831-1#22	0	6	ENST00000676229.1	1567	1573	+	6	0	-4	700
O95831-1#22	0	2	2	O95831-1	452	454	+	2	O95831-1	0	613	ENST00000675857.1	82	1915	++	242	O95831-1#22	0	6	ENST00000675857.1	1432	1438	+	6	0	-4	701
O95831-1#22	0	2	2	O95831-1	452	454	+	2	O95831-1	0	613	ENST00000675427.1	89	1925	++	240	O95831-1#22	0	6	ENST00000675427.1	1442	1448	+	6	0	-4	702
O95831-1#22	0	2	2	O95831-1	452	454	+	2	O95831-1	0	524	ENST00000675240.1	169	1741	++	239	O95831-1#22	0	6	ENST00000675240.1	1525	1531	+	6	0	-4	703
O95831-1#22	0	2	2	O95831-1	452	454	+	2	O95831-1	0	613	ENST00000675092.1	90	1956	++	238	O95831-1#22	0	6	ENST00000675092.1	1446	1452	+	6	0	-4	704
O95831-1#22	0	2	2	O95831-1	452	454	+	2	O95831-1	0	613	ENST00000675050.1	71	1898	++	237	O95831-1#22	0	6	ENST00000675050.1	1415	1421	+	6	0	-4	705
O95831-1#22	0	2	2	O95831-1	452	454	+	2	O95831-1	0	459	ENST00000675037.1	56	1433	++	236	O95831-1#22	0	6	ENST00000675037.1	1412	1418	+	6	0	-4	706
O95831-1#22	0	2	2	O95831-1	452	454	+	2	O95831-1	338	613	ENST00000674601.1	2	686	++	232	O95831-1#22	0	6	ENST00000674601.1	203	209	+	6	0	-4	707
O95831-1#22	0	2	2	O95831-1	452	454	+	2	O95831-1	0	587	ENST00000674546.1	185	1954	++	230	O95831-1#22	0	6	ENST00000674546.1	1541	1547	+	6	0	-4	708
O95831-1#22	0	2	2	O95831-1	452	454	+	2	O95831-1	339	613	ENST00000460436.6	905	1727	++	106	O95831-1#22	0	6	ENST00000460436.6	1244	1250	+	6	0	-4	709
O95831-1#22	0	2	2	O95831-1	452	454	+	2	O95831-1	0	613	ENST00000346424.6	24	1002	++	35	O95831-1#22	0	6	ENST00000346424.6	519	525	+	6	0	-4	710
O95831-1#22	0	2	2	O95831-1	452	454	+	2	O95831-1	0	613	ENST00000319908.8	174	2007	++	26	O95831-1#22	0	6	ENST00000319908.8	1527	1533	+	6	0	-4	711
O95831-1#22	0	2	2	O95831-1	452	454	+	2	O95831-1	0	613	ENST00000287295.8	185	2024	++	18	O95831-1#22	0	6	ENST00000287295.8	1541	1547	+	6	0	-4	712
O95831-1#23	0	2	2	O95831-1	453	455	+	2	O95831-1	0	613	ENST00000676436.1	34	1861	++	246	O95831-1#23	0	6	ENST00000676436.1	1381	1387	+	6	0	-4	713
O95831-1#23	0	2	2	O95831-1	453	455	+	2	O95831-1	0	613	ENST00000676328.1	56	1892	++	245	O95831-1#23	0	6	ENST00000676328.1	1412	1418	+	6	0	-4	714
O95831-1#23	0	2	2	O95831-1	453	455	+	2	O95831-1	0	613	ENST00000676229.1	223	2050	++	244	O95831-1#23	0	6	ENST00000676229.1	1570	1576	+	6	0	-4	715
O95831-1#23	0	2	2	O95831-1	453	455	+	2	O95831-1	0	613	ENST00000675857.1	82	1915	++	242	O95831-1#23	0	6	ENST00000675857.1	1435	1441	+	6	0	-4	716
O95831-1#23	0	2	2	O95831-1	453	455	+	2	O95831-1	0	613	ENST00000675427.1	89	1925	++	240	O95831-1#23	0	6	ENST00000675427.1	1445	1451	+	6	0	-4	717
O95831-1#23	0	2	2	O95831-1	453	455	+	2	O95831-1	0	524	ENST00000675240.1	169	1741	++	239	O95831-1#23	0	6	ENST00000675240.1	1528	1534	+	6	0	-4	718
O95831-1#23	0	2	2	O95831-1	453	455	+	2	O95831-1	0	613	ENST00000675092.1	90	1956	++	238	O95831-1#23	0	6	ENST00000675092.1	1449	1455	+	6	0	-4	719
O95831-1#23	0	2	2	O95831-1	453	455	+	2	O95831-1	0	613	ENST00000675050.1	71	1898	++	237	O95831-1#23	0	6	ENST00000675050.1	1418	1424	+	6	0	-4	720
O95831-1#23	0	2	2	O95831-1	453	455	+	2	O95831-1	0	459	ENST00000675037.1	56	1433	++	236	O95831-1#23	0	6	ENST00000675037.1	1415	1421	+	6	0	-4	721
O95831-1#23	0	2	2	O95831-1	453	455	+	2	O95831-1	338	613	ENST00000674601.1	2	686	++	232	O95831-1#23	0	6	ENST00000674601.1	206	212	+	6	0	-4	722
O95831-1#23	0	2	2	O95831-1	453	455	+	2	O95831-1	0	587	ENST00000674546.1	185	1954	++	230	O95831-1#23	0	6	ENST00000674546.1	1544	1550	+	6	0	-4	723
O95831-1#23	0	2	2	O95831-1	453	455	+	2	O95831-1	339	613	ENST00000460436.6	905	1727	++	106	O95831-1#23	0	6	ENST00000460436.6	1247	1253	+	6	0	-4	724
O95831-1#23	0	2	2	O95831-1	453	455	+	2	O95831-1	0	613	ENST00000346424.6	24	1002	++	35	O95831-1#23	0	6	ENST00000346424.6	522	528	+	6	0	-4	725
O95831-1#23	0	2	2	O95831-1	453	455	+	2	O95831-1	0	613	ENST00000319908.8	174	2007	++	26	O95831-1#23	0	6	ENST00000319908.8	1530	1536	+	6	0	-4	726
O95831-1#23	0	2	2	O95831-1	453	455	+	2	O95831-1	0	613	ENST00000287295.8	185	2024	++	18	O95831-1#23	0	6	ENST00000287295.8	1544	1550	+	6	0	-4	727
O95831-1#24	0	1	1	O95831-1	482	483	+	1	O95831-1	0	613	ENST00000676436.1	34	1861	++	246	O95831-1#24	0	3	ENST00000676436.1	1468	1471	+	3	0	-2	728
O95831-1#24	0	1	1	O95831-1	482	483	+	1	O95831-1	0	613	ENST00000676328.1	56	1892	++	245	O95831-1#24	0	3	ENST00000676328.1	1499	1502	+	3	0	-2	729
O95831-1#24	0	1	1	O95831-1	482	483	+	1	O95831-1	0	613	ENST00000676229.1	223	2050	++	244	O95831-1#24	0	3	ENST00000676229.1	1657	1660	+	3	0	-2	730
O95831-1#24	0	1	1	O95831-1	482	483	+	1	O95831-1	0	613	ENST00000675857.1	82	1915	++	242	O95831-1#24	0	3	ENST00000675857.1	1522	1525	+	3	0	-2	731
O95831-1#24	0	1	1	O95831-1	482	483	+	1	O95831-1	0	613	ENST00000675427.1	89	1925	++	240	O95831-1#24	0	3	ENST00000675427.1	1532	1535	+	3	0	-2	732
O95831-1#24	0	1	1	O95831-1	482	483	+	1	O95831-1	0	524	ENST00000675240.1	169	1741	++	239	O95831-1#24	0	3	ENST00000675240.1	1615	1618	+	3	0	-2	733
O95831-1#24	0	1	1	O95831-1	482	483	+	1	O95831-1	0	613	ENST00000675092.1	90	1956	++	238	O95831-1#24	0	3	ENST00000675092.1	1536	1539	+	3	0	-2	734
O95831-1#24	0	1	1	O95831-1	482	483	+	1	O95831-1	0	613	ENST00000675050.1	71	1898	++	237	O95831-1#24	0	3	ENST00000675050.1	1505	1508	+	3	0	-2	735
O95831-1#24	0	1	1	O95831-1	482	483	+	1	O95831-1	338	613	ENST00000674601.1	2	686	++	232	O95831-1#24	0	3	ENST00000674601.1	293	296	+	3	0	-2	736
O95831-1#24	0	1	1	O95831-1	482	483	+	1	O95831-1	0	587	ENST00000674546.1	185	1954	++	230	O95831-1#24	0	3	ENST00000674546.1	1631	1634	+	3	0	-2	737
O95831-1#24	0	1	1	O95831-1	482	483	+	1	O95831-1	339	613	ENST00000460436.6	905	1727	++	106	O95831-1#24	0	3	ENST00000460436.6	1334	1337	+	3	0	-2	738
O95831-1#24	0	1	1	O95831-1	482	483	+	1	O95831-1	0	613	ENST00000346424.6	24	1002	++	35	O95831-1#24	0	3	ENST00000346424.6	609	612	+	3	0	-2	739
O95831-1#24	0	1	1	O95831-1	482	483	+	1	O95831-1	0	613	ENST00000287295.8	185	2024	++	18	O95831-1#24	0	3	ENST00000287295.8	1631	1634	+	3	0	-2	740
O95831-1#25	0	1	1	O95831-1	482	483	+	1	O95831-1	0	613	ENST00000676436.1	34	1861	++	246	O95831-1#25	0	3	ENST00000676436.1	1468	1471	+	3	0	-2	741
O95831-1#25	0	1	1	O95831-1	482	483	+	1	O95831-1	0	613	ENST00000676328.1	56	1892	++	245	O95831-1#25	0	3	ENST00000676328.1	1499	1502	+	3	0	-2	742
O95831-1#25	0	1	1	O95831-1	482	483	+	1	O95831-1	0	613	ENST00000676229.1	223	2050	++	244	O95831-1#25	0	3	ENST00000676229.1	1657	1660	+	3	0	-2	743
O95831-1#25	0	1	1	O95831-1	482	483	+	1	O95831-1	0	613	ENST00000675857.1	82	1915	++	242	O95831-1#25	0	3	ENST00000675857.1	1522	1525	+	3	0	-2	744
O95831-1#25	0	1	1	O95831-1	482	483	+	1	O95831-1	0	613	ENST00000675427.1	89	1925	++	240	O95831-1#25	0	3	ENST00000675427.1	1532	1535	+	3	0	-2	745
O95831-1#25	0	1	1	O95831-1	482	483	+	1	O95831-1	0	524	ENST00000675240.1	169	1741	++	239	O95831-1#25	0	3	ENST00000675240.1	1615	1618	+	3	0	-2	746
O95831-1#25	0	1	1	O95831-1	482	483	+	1	O95831-1	0	613	ENST00000675092.1	90	1956	++	238	O95831-1#25	0	3	ENST00000675092.1	1536	1539	+	3	0	-2	747
O95831-1#25	0	1	1	O95831-1	482	483	+	1	O95831-1	0	613	ENST00000675050.1	71	1898	++	237	O95831-1#25	0	3	ENST00000675050.1	1505	1508	+	3	0	-2	748
O95831-1#25	0	1	1	O95831-1	482	483	+	1	O95831-1	338	613	ENST00000674601.1	2	686	++	232	O95831-1#25	0	3	ENST00000674601.1	293	296	+	3	0	-2	749
O95831-1#25	0	1	1	O95831-1	482	483	+	1	O95831-1	0	587	ENST00000674546.1	185	1954	++	230	O95831-1#25	0	3	ENST00000674546.1	1631	1634	+	3	0	-2	750
O95831-1#25	0	1	1	O95831-1	482	483	+	1	O95831-1	339	613	ENST00000460436.6	905	1727	++	106	O95831-1#25	0	3	ENST00000460436.6	1334	1337	+	3	0	-2	751
O95831-1#25	0	1	1	O95831-1	482	483	+	1	O95831-1	0	613	ENST00000346424.6	24	1002	++	35	O95831-1#25	0	3	ENST00000346424.6	609	612	+	3	0	-2	752
O95831-1#25	0	1	1	O95831-1	482	483	+	1	O95831-1	0	613	ENST00000287295.8	185	2024	++	18	O95831-1#25	0	3	ENST00000287295.8	1631	1634	+	3	0	-2	753
O95831-1#26	0	1	1	O95831-1	492	493	+	1	O95831-1	0	613	ENST00000676436.1	34	1861	++	246	O95831-1#26	0	3	ENST00000676436.1	1498	1501	+	3	0	-2	754
O95831-1#26	0	1	1	O95831-1	492	493	+	1	O95831-1	0	613	ENST00000676328.1	56	1892	++	245	O95831-1#26	0	3	ENST00000676328.1	1529	1532	+	3	0	-2	755
O95831-1#26	0	1	1	O95831-1	492	493	+	1	O95831-1	0	613	ENST00000676229.1	223	2050	++	244	O95831-1#26	0	3	ENST00000676229.1	1687	1690	+	3	0	-2	756
O95831-1#26	0	1	1	O95831-1	492	493	+	1	O95831-1	0	613	ENST00000675857.1	82	1915	++	242	O95831-1#26	0	3	ENST00000675857.1	1552	1555	+	3	0	-2	757
O95831-1#26	0	1	1	O95831-1	492	493	+	1	O95831-1	0	613	ENST00000675427.1	89	1925	++	240	O95831-1#26	0	3	ENST00000675427.1	1562	1565	+	3	0	-2	758
O95831-1#26	0	1	1	O95831-1	492	493	+	1	O95831-1	0	524	ENST00000675240.1	169	1741	++	239	O95831-1#26	0	3	ENST00000675240.1	1645	1648	+	3	0	-2	759
O95831-1#26	0	1	1	O95831-1	492	493	+	1	O95831-1	0	613	ENST00000675092.1	90	1956	++	238	O95831-1#26	0	3	ENST00000675092.1	1566	1569	+	3	0	-2	760
O95831-1#26	0	1	1	O95831-1	492	493	+	1	O95831-1	0	613	ENST00000675050.1	71	1898	++	237	O95831-1#26	0	3	ENST00000675050.1	1535	1538	+	3	0	-2	761
O95831-1#26	0	1	1	O95831-1	492	493	+	1	O95831-1	338	613	ENST00000674601.1	2	686	++	232	O95831-1#26	0	3	ENST00000674601.1	323	326	+	3	0	-2	762
O95831-1#26	0	1	1	O95831-1	492	493	+	1	O95831-1	0	587	ENST00000674546.1	185	1954	++	230	O95831-1#26	0	3	ENST00000674546.1	1661	1664	+	3	0	-2	763
O95831-1#26	0	1	1	O95831-1	492	493	+	1	O95831-1	339	613	ENST00000460436.6	905	1727	++	106	O95831-1#26	0	3	ENST00000460436.6	1364	1367	+	3	0	-2	764
O95831-1#26	0	1	1	O95831-1	492	493	+	1	O95831-1	0	613	ENST00000346424.6	24	1002	++	35	O95831-1#26	0	3	ENST00000346424.6	639	642	+	3	0	-2	765
O95831-1#26	0	1	1	O95831-1	492	493	+	1	O95831-1	0	613	ENST00000319908.8	174	2007	++	26	O95831-1#26	0	3	ENST00000319908.8	1644	1647	+	3	0	-2	766
O95831-1#26	0	1	1	O95831-1	492	493	+	1	O95831-1	0	613	ENST00000287295.8	185	2024	++	18	O95831-1#26	0	3	ENST00000287295.8	1661	1664	+	3	0	-2	767
O95831-1#27	0	1	1	O95831-1	582	583	+	1	O95831-1	0	613	ENST00000676436.1	34	1861	++	246	O95831-1#27	0	3	ENST00000676436.1	1768	1771	+	3	0	-2	768
O95831-1#27	0	1	1	O95831-1	582	583	+	1	O95831-1	0	613	ENST00000676328.1	56	1892	++	245	O95831-1#27	0	3	ENST00000676328.1	1799	1802	+	3	0	-2	769
O95831-1#27	0	1	1	O95831-1	582	583	+	1	O95831-1	0	613	ENST00000676229.1	223	2050	++	244	O95831-1#27	0	3	ENST00000676229.1	1957	1960	+	3	0	-2	770
O95831-1#27	0	1	1	O95831-1	582	583	+	1	O95831-1	0	613	ENST00000675857.1	82	1915	++	242	O95831-1#27	0	3	ENST00000675857.1	1822	1825	+	3	0	-2	771
O95831-1#27	0	1	1	O95831-1	582	583	+	1	O95831-1	0	613	ENST00000675427.1	89	1925	++	240	O95831-1#27	0	3	ENST00000675427.1	1832	1835	+	3	0	-2	772
O95831-1#27	0	1	1	O95831-1	582	583	+	1	O95831-1	0	613	ENST00000675092.1	90	1956	++	238	O95831-1#27	0	3	ENST00000675092.1	1863	1866	+	3	0	-2	773
O95831-1#27	0	1	1	O95831-1	582	583	+	1	O95831-1	0	613	ENST00000675050.1	71	1898	++	237	O95831-1#27	0	3	ENST00000675050.1	1805	1808	+	3	0	-2	774
O95831-1#27	0	1	1	O95831-1	582	583	+	1	O95831-1	338	613	ENST00000674601.1	2	686	++	232	O95831-1#27	0	3	ENST00000674601.1	593	596	+	3	0	-2	775
O95831-1#27	0	1	1	O95831-1	582	583	+	1	O95831-1	0	587	ENST00000674546.1	185	1954	++	230	O95831-1#27	0	3	ENST00000674546.1	1939	1942	+	3	0	-2	776
O95831-1#27	0	1	1	O95831-1	582	583	+	1	O95831-1	339	613	ENST00000460436.6	905	1727	++	106	O95831-1#27	0	3	ENST00000460436.6	1634	1637	+	3	0	-2	777
O95831-1#27	0	1	1	O95831-1	582	583	+	1	O95831-1	0	613	ENST00000346424.6	24	1002	++	35	O95831-1#27	0	3	ENST00000346424.6	909	912	+	3	0	-2	778
O95831-1#27	0	1	1	O95831-1	582	583	+	1	O95831-1	0	613	ENST00000319908.8	174	2007	++	26	O95831-1#27	0	3	ENST00000319908.8	1914	1917	+	3	0	-2	779
O95831-1#27	0	1	1	O95831-1	582	583	+	1	O95831-1	0	613	ENST00000287295.8	185	2024	++	18	O95831-1#27	0	3	ENST00000287295.8	1931	1934	+	3	0	-2	780
O95831-1#28	0	1	1	O95831-1	104	105	+	1	O95831-1	0	613	ENST00000676436.1	34	1861	++	246	O95831-1#28	0	3	ENST00000676436.1	346	349	+	3	0	-2	781
O95831-1#28	0	1	1	O95831-1	104	105	+	1	O95831-1	0	613	ENST00000676328.1	56	1892	++	245	O95831-1#28	0	3	ENST00000676328.1	368	371	+	3	0	-2	782
O95831-1#28	0	1	1	O95831-1	104	105	+	1	O95831-1	0	613	ENST00000676229.1	223	2050	++	244	O95831-1#28	0	3	ENST00000676229.1	523	526	+	3	0	-2	783
O95831-1#28	0	1	1	O95831-1	104	105	+	1	O95831-1	0	613	ENST00000675857.1	82	1915	++	242	O95831-1#28	0	3	ENST00000675857.1	394	397	+	3	0	-2	784
O95831-1#28	0	1	1	O95831-1	104	105	+	1	O95831-1	0	613	ENST00000675427.1	89	1925	++	240	O95831-1#28	0	3	ENST00000675427.1	401	404	+	3	0	-2	785
O95831-1#28	0	1	1	O95831-1	104	105	+	1	O95831-1	0	524	ENST00000675240.1	169	1741	++	239	O95831-1#28	0	3	ENST00000675240.1	481	484	+	3	0	-2	786
O95831-1#28	0	1	1	O95831-1	104	105	+	1	O95831-1	0	613	ENST00000675092.1	90	1956	++	238	O95831-1#28	0	3	ENST00000675092.1	402	405	+	3	0	-2	787
O95831-1#28	0	1	1	O95831-1	104	105	+	1	O95831-1	0	613	ENST00000675050.1	71	1898	++	237	O95831-1#28	0	3	ENST00000675050.1	371	374	+	3	0	-2	788
O95831-1#28	0	1	1	O95831-1	104	105	+	1	O95831-1	0	459	ENST00000675037.1	56	1433	++	236	O95831-1#28	0	3	ENST00000675037.1	368	371	+	3	0	-2	789
O95831-1#28	0	1	1	O95831-1	104	105	+	1	O95831-1	100	388	ENST00000674957.1	1	865	++	234	O95831-1#28	0	3	ENST00000674957.1	13	16	+	3	0	-2	790
O95831-1#28	0	1	1	O95831-1	104	105	+	1	O95831-1	0	238	ENST00000674722.1	13	727	++	233	O95831-1#28	0	3	ENST00000674722.1	325	328	+	3	0	-2	791
O95831-1#28	0	1	1	O95831-1	104	105	+	1	O95831-1	0	587	ENST00000674546.1	185	1954	++	230	O95831-1#28	0	3	ENST00000674546.1	497	500	+	3	0	-2	792
O95831-1#28	0	1	1	O95831-1	104	105	+	1	O95831-1	0	322	ENST00000535724.6	8	974	++	150	O95831-1#28	0	3	ENST00000535724.6	320	323	+	3	0	-2	793
O95831-1#28	0	1	1	O95831-1	104	105	+	1	O95831-1	0	435	ENST00000416073.7	37	1336	++	76	O95831-1#28	0	3	ENST00000416073.7	349	352	+	3	0	-2	794
O95831-1#28	0	1	1	O95831-1	104	105	+	1	O95831-1	0	613	ENST00000319908.8	174	2007	++	26	O95831-1#28	0	3	ENST00000319908.8	486	489	+	3	0	-2	795
O95831-1#28	0	1	1	O95831-1	104	105	+	1	O95831-1	0	613	ENST00000287295.8	185	2024	++	18	O95831-1#28	0	3	ENST00000287295.8	497	500	+	3	0	-2	796
O95831-1#29	0	1	1	O95831-1	108	109	+	1	O95831-1	0	613	ENST00000676436.1	34	1861	++	246	O95831-1#29	0	3	ENST00000676436.1	358	361	+	3	0	-2	797
O95831-1#29	0	1	1	O95831-1	108	109	+	1	O95831-1	0	613	ENST00000676328.1	56	1892	++	245	O95831-1#29	0	3	ENST00000676328.1	380	383	+	3	0	-2	798
O95831-1#29	0	1	1	O95831-1	108	109	+	1	O95831-1	0	613	ENST00000676229.1	223	2050	++	244	O95831-1#29	0	3	ENST00000676229.1	535	538	+	3	0	-2	799
O95831-1#29	0	1	1	O95831-1	108	109	+	1	O95831-1	0	613	ENST00000675857.1	82	1915	++	242	O95831-1#29	0	3	ENST00000675857.1	406	409	+	3	0	-2	800
O95831-1#29	0	1	1	O95831-1	108	109	+	1	O95831-1	0	613	ENST00000675427.1	89	1925	++	240	O95831-1#29	0	3	ENST00000675427.1	413	416	+	3	0	-2	801
O95831-1#29	0	1	1	O95831-1	108	109	+	1	O95831-1	0	524	ENST00000675240.1	169	1741	++	239	O95831-1#29	0	3	ENST00000675240.1	493	496	+	3	0	-2	802
O95831-1#29	0	1	1	O95831-1	108	109	+	1	O95831-1	0	613	ENST00000675092.1	90	1956	++	238	O95831-1#29	0	3	ENST00000675092.1	414	417	+	3	0	-2	803
O95831-1#29	0	1	1	O95831-1	108	109	+	1	O95831-1	0	613	ENST00000675050.1	71	1898	++	237	O95831-1#29	0	3	ENST00000675050.1	383	386	+	3	0	-2	804
O95831-1#29	0	1	1	O95831-1	108	109	+	1	O95831-1	0	459	ENST00000675037.1	56	1433	++	236	O95831-1#29	0	3	ENST00000675037.1	380	383	+	3	0	-2	805
O95831-1#29	0	1	1	O95831-1	108	109	+	1	O95831-1	100	388	ENST00000674957.1	1	865	++	234	O95831-1#29	0	3	ENST00000674957.1	25	28	+	3	0	-2	806
O95831-1#29	0	1	1	O95831-1	108	109	+	1	O95831-1	0	238	ENST00000674722.1	13	727	++	233	O95831-1#29	0	3	ENST00000674722.1	337	340	+	3	0	-2	807
O95831-1#29	0	1	1	O95831-1	108	109	+	1	O95831-1	0	587	ENST00000674546.1	185	1954	++	230	O95831-1#29	0	3	ENST00000674546.1	509	512	+	3	0	-2	808
O95831-1#29	0	1	1	O95831-1	108	109	+	1	O95831-1	0	322	ENST00000535724.6	8	974	++	150	O95831-1#29	0	3	ENST00000535724.6	332	335	+	3	0	-2	809
O95831-1#29	0	1	1	O95831-1	108	109	+	1	O95831-1	0	435	ENST00000416073.7	37	1336	++	76	O95831-1#29	0	3	ENST00000416073.7	361	364	+	3	0	-2	810
O95831-1#29	0	1	1	O95831-1	108	109	+	1	O95831-1	0	613	ENST00000319908.8	174	2007	++	26	O95831-1#29	0	3	ENST00000319908.8	498	501	+	3	0	-2	811
O95831-1#29	0	1	1	O95831-1	108	109	+	1	O95831-1	0	613	ENST00000287295.8	185	2024	++	18	O95831-1#29	0	3	ENST00000287295.8	509	512	+	3	0	-2	812
O95831-1#30	0	1	1	O95831-1	115	116	+	1	O95831-1	0	613	ENST00000676436.1	34	1861	++	246	O95831-1#30	0	3	ENST00000676436.1	379	382	+	3	0	-2	813
O95831-1#30	0	1	1	O95831-1	115	116	+	1	O95831-1	0	613	ENST00000676328.1	56	1892	++	245	O95831-1#30	0	3	ENST00000676328.1	401	404	+	3	0	-2	814
O95831-1#30	0	1	1	O95831-1	115	116	+	1	O95831-1	0	613	ENST00000676229.1	223	2050	++	244	O95831-1#30	0	3	ENST00000676229.1	556	559	+	3	0	-2	815
O95831-1#30	0	1	1	O95831-1	115	116	+	1	O95831-1	109	136	ENST00000676144.1	102	183	++	243	O95831-1#30	0	3	ENST00000676144.1	120	123	+	3	0	-2	816
O95831-1#30	0	1	1	O95831-1	115	116	+	1	O95831-1	0	613	ENST00000675857.1	82	1915	++	242	O95831-1#30	0	3	ENST00000675857.1	427	430	+	3	0	-2	817
O95831-1#30	0	1	1	O95831-1	115	116	+	1	O95831-1	0	613	ENST00000675427.1	89	1925	++	240	O95831-1#30	0	3	ENST00000675427.1	434	437	+	3	0	-2	818
O95831-1#30	0	1	1	O95831-1	115	116	+	1	O95831-1	0	524	ENST00000675240.1	169	1741	++	239	O95831-1#30	0	3	ENST00000675240.1	514	517	+	3	0	-2	819
O95831-1#30	0	1	1	O95831-1	115	116	+	1	O95831-1	0	613	ENST00000675092.1	90	1956	++	238	O95831-1#30	0	3	ENST00000675092.1	435	438	+	3	0	-2	820
O95831-1#30	0	1	1	O95831-1	115	116	+	1	O95831-1	0	613	ENST00000675050.1	71	1898	++	237	O95831-1#30	0	3	ENST00000675050.1	404	407	+	3	0	-2	821
O95831-1#30	0	1	1	O95831-1	115	116	+	1	O95831-1	0	459	ENST00000675037.1	56	1433	++	236	O95831-1#30	0	3	ENST00000675037.1	401	404	+	3	0	-2	822
O95831-1#30	0	1	1	O95831-1	115	116	+	1	O95831-1	100	388	ENST00000674957.1	1	865	++	234	O95831-1#30	0	3	ENST00000674957.1	46	49	+	3	0	-2	823
O95831-1#30	0	1	1	O95831-1	115	116	+	1	O95831-1	0	238	ENST00000674722.1	13	727	++	233	O95831-1#30	0	3	ENST00000674722.1	358	361	+	3	0	-2	824
O95831-1#30	0	1	1	O95831-1	115	116	+	1	O95831-1	0	587	ENST00000674546.1	185	1954	++	230	O95831-1#30	0	3	ENST00000674546.1	530	533	+	3	0	-2	825
O95831-1#30	0	1	1	O95831-1	115	116	+	1	O95831-1	0	322	ENST00000535724.6	8	974	++	150	O95831-1#30	0	3	ENST00000535724.6	353	356	+	3	0	-2	826
O95831-1#30	0	1	1	O95831-1	115	116	+	1	O95831-1	0	435	ENST00000416073.7	37	1336	++	76	O95831-1#30	0	3	ENST00000416073.7	382	385	+	3	0	-2	827
O95831-1#30	0	1	1	O95831-1	115	116	+	1	O95831-1	0	613	ENST00000319908.8	174	2007	++	26	O95831-1#30	0	3	ENST00000319908.8	519	522	+	3	0	-2	828
O95831-1#30	0	1	1	O95831-1	115	116	+	1	O95831-1	0	613	ENST00000287295.8	185	2024	++	18	O95831-1#30	0	3	ENST00000287295.8	530	533	+	3	0	-2	829
O95831-1#31	0	1	1	O95831-1	117	118	+	1	O95831-1	0	613	ENST00000676328.1	56	1892	++	245	O95831-1#31	0	3	ENST00000676328.1	407	410	+	3	0	-2	830
O95831-1#31	0	1	1	O95831-1	117	118	+	1	O95831-1	0	613	ENST00000676229.1	223	2050	++	244	O95831-1#31	0	3	ENST00000676229.1	562	565	+	3	0	-2	831
O95831-1#31	0	1	1	O95831-1	117	118	+	1	O95831-1	109	136	ENST00000676144.1	102	183	++	243	O95831-1#31	0	3	ENST00000676144.1	126	129	+	3	0	-2	832
O95831-1#31	0	1	1	O95831-1	117	118	+	1	O95831-1	0	613	ENST00000675427.1	89	1925	++	240	O95831-1#31	0	3	ENST00000675427.1	440	443	+	3	0	-2	833
O95831-1#31	0	1	1	O95831-1	117	118	+	1	O95831-1	0	524	ENST00000675240.1	169	1741	++	239	O95831-1#31	0	3	ENST00000675240.1	520	523	+	3	0	-2	834
O95831-1#31	0	1	1	O95831-1	117	118	+	1	O95831-1	0	613	ENST00000675092.1	90	1956	++	238	O95831-1#31	0	3	ENST00000675092.1	441	444	+	3	0	-2	835
O95831-1#31	0	1	1	O95831-1	117	118	+	1	O95831-1	0	613	ENST00000675050.1	71	1898	++	237	O95831-1#31	0	3	ENST00000675050.1	410	413	+	3	0	-2	836
O95831-1#31	0	1	1	O95831-1	117	118	+	1	O95831-1	0	459	ENST00000675037.1	56	1433	++	236	O95831-1#31	0	3	ENST00000675037.1	407	410	+	3	0	-2	837
O95831-1#31	0	1	1	O95831-1	117	118	+	1	O95831-1	100	388	ENST00000674957.1	1	865	++	234	O95831-1#31	0	3	ENST00000674957.1	52	55	+	3	0	-2	838
O95831-1#31	0	1	1	O95831-1	117	118	+	1	O95831-1	0	238	ENST00000674722.1	13	727	++	233	O95831-1#31	0	3	ENST00000674722.1	364	367	+	3	0	-2	839
O95831-1#31	0	1	1	O95831-1	117	118	+	1	O95831-1	0	587	ENST00000674546.1	185	1954	++	230	O95831-1#31	0	3	ENST00000674546.1	536	539	+	3	0	-2	840
O95831-1#31	0	1	1	O95831-1	117	118	+	1	O95831-1	0	322	ENST00000535724.6	8	974	++	150	O95831-1#31	0	3	ENST00000535724.6	359	362	+	3	0	-2	841
O95831-1#31	0	1	1	O95831-1	117	118	+	1	O95831-1	0	613	ENST00000319908.8	174	2007	++	26	O95831-1#31	0	3	ENST00000319908.8	525	528	+	3	0	-2	842
O95831-1#31	0	1	1	O95831-1	117	118	+	1	O95831-1	0	613	ENST00000287295.8	185	2024	++	18	O95831-1#31	0	3	ENST00000287295.8	536	539	+	3	0	-2	843
O95831-1#32	0	1	1	O95831-1	267	268	+	1	O95831-1	0	613	ENST00000676436.1	34	1861	++	246	O95831-1#32	0	3	ENST00000676436.1	829	832	+	3	0	-2	844
O95831-1#32	0	1	1	O95831-1	267	268	+	1	O95831-1	0	613	ENST00000676328.1	56	1892	++	245	O95831-1#32	0	3	ENST00000676328.1	854	857	+	3	0	-2	845
O95831-1#32	0	1	1	O95831-1	267	268	+	1	O95831-1	0	613	ENST00000676229.1	223	2050	++	244	O95831-1#32	0	3	ENST00000676229.1	1012	1015	+	3	0	-2	846
O95831-1#32	0	1	1	O95831-1	267	268	+	1	O95831-1	0	613	ENST00000675857.1	82	1915	++	242	O95831-1#32	0	3	ENST00000675857.1	877	880	+	3	0	-2	847
O95831-1#32	0	1	1	O95831-1	267	268	+	1	O95831-1	0	613	ENST00000675427.1	89	1925	++	240	O95831-1#32	0	3	ENST00000675427.1	890	893	+	3	0	-2	848
O95831-1#32	0	1	1	O95831-1	267	268	+	1	O95831-1	0	524	ENST00000675240.1	169	1741	++	239	O95831-1#32	0	3	ENST00000675240.1	970	973	+	3	0	-2	849
O95831-1#32	0	1	1	O95831-1	267	268	+	1	O95831-1	0	613	ENST00000675092.1	90	1956	++	238	O95831-1#32	0	3	ENST00000675092.1	891	894	+	3	0	-2	850
O95831-1#32	0	1	1	O95831-1	267	268	+	1	O95831-1	0	613	ENST00000675050.1	71	1898	++	237	O95831-1#32	0	3	ENST00000675050.1	860	863	+	3	0	-2	851
O95831-1#32	0	1	1	O95831-1	267	268	+	1	O95831-1	0	459	ENST00000675037.1	56	1433	++	236	O95831-1#32	0	3	ENST00000675037.1	857	860	+	3	0	-2	852
O95831-1#32	0	1	1	O95831-1	267	268	+	1	O95831-1	100	388	ENST00000674957.1	1	865	++	234	O95831-1#32	0	3	ENST00000674957.1	502	505	+	3	0	-2	853
O95831-1#32	0	1	1	O95831-1	267	268	+	1	O95831-1	0	587	ENST00000674546.1	185	1954	++	230	O95831-1#32	0	3	ENST00000674546.1	986	989	+	3	0	-2	854
O95831-1#32	0	1	1	O95831-1	267	268	+	1	O95831-1	0	322	ENST00000535724.6	8	974	++	150	O95831-1#32	0	3	ENST00000535724.6	809	812	+	3	0	-2	855
O95831-1#32	0	1	1	O95831-1	267	268	+	1	O95831-1	0	435	ENST00000416073.7	37	1336	++	76	O95831-1#32	0	3	ENST00000416073.7	832	835	+	3	0	-2	856
O95831-1#32	0	1	1	O95831-1	267	268	+	1	O95831-1	0	613	ENST00000319908.8	174	2007	++	26	O95831-1#32	0	3	ENST00000319908.8	972	975	+	3	0	-2	857
O95831-1#32	0	1	1	O95831-1	267	268	+	1	O95831-1	0	613	ENST00000287295.8	185	2024	++	18	O95831-1#32	0	3	ENST00000287295.8	986	989	+	3	0	-2	858
O95831-1#33	0	1	1	O95831-1	291	292	+	1	O95831-1	0	613	ENST00000676436.1	34	1861	++	246	O95831-1#33	0	3	ENST00000676436.1	901	904	+	3	0	-2	859
O95831-1#33	0	1	1	O95831-1	291	292	+	1	O95831-1	0	613	ENST00000676328.1	56	1892	++	245	O95831-1#33	0	3	ENST00000676328.1	926	929	+	3	0	-2	860
O95831-1#33	0	1	1	O95831-1	291	292	+	1	O95831-1	0	613	ENST00000676229.1	223	2050	++	244	O95831-1#33	0	3	ENST00000676229.1	1084	1087	+	3	0	-2	861
O95831-1#33	0	1	1	O95831-1	291	292	+	1	O95831-1	0	613	ENST00000675857.1	82	1915	++	242	O95831-1#33	0	3	ENST00000675857.1	949	952	+	3	0	-2	862
O95831-1#33	0	1	1	O95831-1	291	292	+	1	O95831-1	0	613	ENST00000675427.1	89	1925	++	240	O95831-1#33	0	3	ENST00000675427.1	962	965	+	3	0	-2	863
O95831-1#33	0	1	1	O95831-1	291	292	+	1	O95831-1	0	524	ENST00000675240.1	169	1741	++	239	O95831-1#33	0	3	ENST00000675240.1	1042	1045	+	3	0	-2	864
O95831-1#33	0	1	1	O95831-1	291	292	+	1	O95831-1	0	613	ENST00000675092.1	90	1956	++	238	O95831-1#33	0	3	ENST00000675092.1	963	966	+	3	0	-2	865
O95831-1#33	0	1	1	O95831-1	291	292	+	1	O95831-1	0	613	ENST00000675050.1	71	1898	++	237	O95831-1#33	0	3	ENST00000675050.1	932	935	+	3	0	-2	866
O95831-1#33	0	1	1	O95831-1	291	292	+	1	O95831-1	0	459	ENST00000675037.1	56	1433	++	236	O95831-1#33	0	3	ENST00000675037.1	929	932	+	3	0	-2	867
O95831-1#33	0	1	1	O95831-1	291	292	+	1	O95831-1	100	388	ENST00000674957.1	1	865	++	234	O95831-1#33	0	3	ENST00000674957.1	574	577	+	3	0	-2	868
O95831-1#33	0	1	1	O95831-1	291	292	+	1	O95831-1	0	587	ENST00000674546.1	185	1954	++	230	O95831-1#33	0	3	ENST00000674546.1	1058	1061	+	3	0	-2	869
O95831-1#33	0	1	1	O95831-1	291	292	+	1	O95831-1	0	322	ENST00000535724.6	8	974	++	150	O95831-1#33	0	3	ENST00000535724.6	881	884	+	3	0	-2	870
O95831-1#33	0	1	1	O95831-1	291	292	+	1	O95831-1	0	435	ENST00000416073.7	37	1336	++	76	O95831-1#33	0	3	ENST00000416073.7	904	907	+	3	0	-2	871
O95831-1#33	0	1	1	O95831-1	291	292	+	1	O95831-1	0	613	ENST00000319908.8	174	2007	++	26	O95831-1#33	0	3	ENST00000319908.8	1044	1047	+	3	0	-2	872
O95831-1#33	0	1	1	O95831-1	291	292	+	1	O95831-1	0	613	ENST00000287295.8	185	2024	++	18	O95831-1#33	0	3	ENST00000287295.8	1058	1061	+	3	0	-2	873
O95831-1#34	0	1	1	O95831-1	370	371	+	1	O95831-1	0	613	ENST00000676436.1	34	1861	++	246	O95831-1#34	0	3	ENST00000676436.1	1132	1135	+	3	0	-2	874
O95831-1#34	0	1	1	O95831-1	370	371	+	1	O95831-1	0	613	ENST00000676328.1	56	1892	++	245	O95831-1#34	0	3	ENST00000676328.1	1163	1166	+	3	0	-2	875
O95831-1#34	0	1	1	O95831-1	370	371	+	1	O95831-1	0	613	ENST00000676229.1	223	2050	++	244	O95831-1#34	0	3	ENST00000676229.1	1321	1324	+	3	0	-2	876
O95831-1#34	0	1	1	O95831-1	370	371	+	1	O95831-1	0	613	ENST00000675857.1	82	1915	++	242	O95831-1#34	0	3	ENST00000675857.1	1186	1189	+	3	0	-2	877
O95831-1#34	0	1	1	O95831-1	370	371	+	1	O95831-1	0	613	ENST00000675427.1	89	1925	++	240	O95831-1#34	0	3	ENST00000675427.1	1199	1202	+	3	0	-2	878
O95831-1#34	0	1	1	O95831-1	370	371	+	1	O95831-1	0	524	ENST00000675240.1	169	1741	++	239	O95831-1#34	0	3	ENST00000675240.1	1279	1282	+	3	0	-2	879
O95831-1#34	0	1	1	O95831-1	370	371	+	1	O95831-1	0	613	ENST00000675092.1	90	1956	++	238	O95831-1#34	0	3	ENST00000675092.1	1200	1203	+	3	0	-2	880
O95831-1#34	0	1	1	O95831-1	370	371	+	1	O95831-1	0	613	ENST00000675050.1	71	1898	++	237	O95831-1#34	0	3	ENST00000675050.1	1169	1172	+	3	0	-2	881
O95831-1#34	0	1	1	O95831-1	370	371	+	1	O95831-1	0	459	ENST00000675037.1	56	1433	++	236	O95831-1#34	0	3	ENST00000675037.1	1166	1169	+	3	0	-2	882
O95831-1#34	0	1	1	O95831-1	370	371	+	1	O95831-1	100	388	ENST00000674957.1	1	865	++	234	O95831-1#34	0	3	ENST00000674957.1	811	814	+	3	0	-2	883
O95831-1#34	0	1	1	O95831-1	370	371	+	1	O95831-1	338	613	ENST00000674601.1	2	686	++	232	O95831-1#34	0	3	ENST00000674601.1	98	101	+	3	0	-2	884
O95831-1#34	0	1	1	O95831-1	370	371	+	1	O95831-1	0	587	ENST00000674546.1	185	1954	++	230	O95831-1#34	0	3	ENST00000674546.1	1295	1298	+	3	0	-2	885
O95831-1#34	0	1	1	O95831-1	370	371	+	1	O95831-1	339	613	ENST00000460436.6	905	1727	++	106	O95831-1#34	0	3	ENST00000460436.6	998	1001	+	3	0	-2	886
O95831-1#34	0	1	1	O95831-1	370	371	+	1	O95831-1	0	435	ENST00000416073.7	37	1336	++	76	O95831-1#34	0	3	ENST00000416073.7	1141	1144	+	3	0	-2	887
O95831-1#34	0	1	1	O95831-1	370	371	+	1	O95831-1	0	613	ENST00000346424.6	24	1002	++	35	O95831-1#34	0	3	ENST00000346424.6	273	276	+	3	0	-2	888
O95831-1#34	0	1	1	O95831-1	370	371	+	1	O95831-1	0	613	ENST00000319908.8	174	2007	++	26	O95831-1#34	0	3	ENST00000319908.8	1281	1284	+	3	0	-2	889
O95831-1#34	0	1	1	O95831-1	370	371	+	1	O95831-1	0	613	ENST00000287295.8	185	2024	++	18	O95831-1#34	0	3	ENST00000287295.8	1295	1298	+	3	0	-2	890
O95831-1#35	0	1	1	O95831-1	387	388	+	1	O95831-1	0	613	ENST00000676436.1	34	1861	++	246	O95831-1#35	0	3	ENST00000676436.1	1183	1186	+	3	0	-2	891
O95831-1#35	0	1	1	O95831-1	387	388	+	1	O95831-1	0	613	ENST00000676328.1	56	1892	++	245	O95831-1#35	0	3	ENST00000676328.1	1214	1217	+	3	0	-2	892
O95831-1#35	0	1	1	O95831-1	387	388	+	1	O95831-1	0	613	ENST00000676229.1	223	2050	++	244	O95831-1#35	0	3	ENST00000676229.1	1372	1375	+	3	0	-2	893
O95831-1#35	0	1	1	O95831-1	387	388	+	1	O95831-1	0	613	ENST00000675857.1	82	1915	++	242	O95831-1#35	0	3	ENST00000675857.1	1237	1240	+	3	0	-2	894
O95831-1#35	0	1	1	O95831-1	387	388	+	1	O95831-1	0	613	ENST00000675427.1	89	1925	++	240	O95831-1#35	0	3	ENST00000675427.1	1250	1253	+	3	0	-2	895
O95831-1#35	0	1	1	O95831-1	387	388	+	1	O95831-1	0	524	ENST00000675240.1	169	1741	++	239	O95831-1#35	0	3	ENST00000675240.1	1330	1333	+	3	0	-2	896
O95831-1#35	0	1	1	O95831-1	387	388	+	1	O95831-1	0	613	ENST00000675092.1	90	1956	++	238	O95831-1#35	0	3	ENST00000675092.1	1251	1254	+	3	0	-2	897
O95831-1#35	0	1	1	O95831-1	387	388	+	1	O95831-1	0	613	ENST00000675050.1	71	1898	++	237	O95831-1#35	0	3	ENST00000675050.1	1220	1223	+	3	0	-2	898
O95831-1#35	0	1	1	O95831-1	387	388	+	1	O95831-1	0	459	ENST00000675037.1	56	1433	++	236	O95831-1#35	0	3	ENST00000675037.1	1217	1220	+	3	0	-2	899
O95831-1#35	0	1	1	O95831-1	387	388	+	1	O95831-1	100	388	ENST00000674957.1	1	865	++	234	O95831-1#35	0	3	ENST00000674957.1	862	865	+	3	0	-2	900
O95831-1#35	0	1	1	O95831-1	387	388	+	1	O95831-1	338	613	ENST00000674601.1	2	686	++	232	O95831-1#35	0	3	ENST00000674601.1	149	152	+	3	0	-2	901
O95831-1#35	0	1	1	O95831-1	387	388	+	1	O95831-1	0	587	ENST00000674546.1	185	1954	++	230	O95831-1#35	0	3	ENST00000674546.1	1346	1349	+	3	0	-2	902
O95831-1#35	0	1	1	O95831-1	387	388	+	1	O95831-1	339	613	ENST00000460436.6	905	1727	++	106	O95831-1#35	0	3	ENST00000460436.6	1049	1052	+	3	0	-2	903
O95831-1#35	0	1	1	O95831-1	387	388	+	1	O95831-1	0	435	ENST00000416073.7	37	1336	++	76	O95831-1#35	0	3	ENST00000416073.7	1192	1195	+	3	0	-2	904
O95831-1#35	0	1	1	O95831-1	387	388	+	1	O95831-1	0	613	ENST00000346424.6	24	1002	++	35	O95831-1#35	0	3	ENST00000346424.6	324	327	+	3	0	-2	905
O95831-1#35	0	1	1	O95831-1	387	388	+	1	O95831-1	0	613	ENST00000319908.8	174	2007	++	26	O95831-1#35	0	3	ENST00000319908.8	1332	1335	+	3	0	-2	906
O95831-1#35	0	1	1	O95831-1	387	388	+	1	O95831-1	0	613	ENST00000287295.8	185	2024	++	18	O95831-1#35	0	3	ENST00000287295.8	1346	1349	+	3	0	-2	907
O95831-1#36	0	1	1	O95831-1	520	521	+	1	O95831-1	0	613	ENST00000676436.1	34	1861	++	246	O95831-1#36	0	3	ENST00000676436.1	1582	1585	+	3	0	-2	908
O95831-1#36	0	1	1	O95831-1	520	521	+	1	O95831-1	0	613	ENST00000676328.1	56	1892	++	245	O95831-1#36	0	3	ENST00000676328.1	1613	1616	+	3	0	-2	909
O95831-1#36	0	1	1	O95831-1	520	521	+	1	O95831-1	0	613	ENST00000676229.1	223	2050	++	244	O95831-1#36	0	3	ENST00000676229.1	1771	1774	+	3	0	-2	910
O95831-1#36	0	1	1	O95831-1	520	521	+	1	O95831-1	0	613	ENST00000675857.1	82	1915	++	242	O95831-1#36	0	3	ENST00000675857.1	1636	1639	+	3	0	-2	911
O95831-1#36	0	1	1	O95831-1	520	521	+	1	O95831-1	0	613	ENST00000675427.1	89	1925	++	240	O95831-1#36	0	3	ENST00000675427.1	1646	1649	+	3	0	-2	912
O95831-1#36	0	1	1	O95831-1	520	521	+	1	O95831-1	0	524	ENST00000675240.1	169	1741	++	239	O95831-1#36	0	3	ENST00000675240.1	1729	1732	+	3	0	-2	913
O95831-1#36	0	1	1	O95831-1	520	521	+	1	O95831-1	0	613	ENST00000675092.1	90	1956	++	238	O95831-1#36	0	3	ENST00000675092.1	1650	1653	+	3	0	-2	914
O95831-1#36	0	1	1	O95831-1	520	521	+	1	O95831-1	0	613	ENST00000675050.1	71	1898	++	237	O95831-1#36	0	3	ENST00000675050.1	1619	1622	+	3	0	-2	915
O95831-1#36	0	1	1	O95831-1	520	521	+	1	O95831-1	338	613	ENST00000674601.1	2	686	++	232	O95831-1#36	0	3	ENST00000674601.1	407	410	+	3	0	-2	916
O95831-1#36	0	1	1	O95831-1	520	521	+	1	O95831-1	0	587	ENST00000674546.1	185	1954	++	230	O95831-1#36	0	3	ENST00000674546.1	1745	1748	+	3	0	-2	917
O95831-1#36	0	1	1	O95831-1	520	521	+	1	O95831-1	339	613	ENST00000460436.6	905	1727	++	106	O95831-1#36	0	3	ENST00000460436.6	1448	1451	+	3	0	-2	918
O95831-1#36	0	1	1	O95831-1	520	521	+	1	O95831-1	0	613	ENST00000346424.6	24	1002	++	35	O95831-1#36	0	3	ENST00000346424.6	723	726	+	3	0	-2	919
O95831-1#36	0	1	1	O95831-1	520	521	+	1	O95831-1	0	613	ENST00000319908.8	174	2007	++	26	O95831-1#36	0	3	ENST00000319908.8	1728	1731	+	3	0	-2	920
O95831-1#36	0	1	1	O95831-1	520	521	+	1	O95831-1	0	613	ENST00000287295.8	185	2024	++	18	O95831-1#36	0	3	ENST00000287295.8	1745	1748	+	3	0	-2	921
O95831-1#37	0	1	1	O95831-1	523	524	+	1	O95831-1	0	613	ENST00000676436.1	34	1861	++	246	O95831-1#37	0	3	ENST00000676436.1	1591	1594	+	3	0	-2	922
O95831-1#37	0	1	1	O95831-1	523	524	+	1	O95831-1	0	613	ENST00000676328.1	56	1892	++	245	O95831-1#37	0	3	ENST00000676328.1	1622	1625	+	3	0	-2	923
O95831-1#37	0	1	1	O95831-1	523	524	+	1	O95831-1	0	613	ENST00000676229.1	223	2050	++	244	O95831-1#37	0	3	ENST00000676229.1	1780	1783	+	3	0	-2	924
O95831-1#37	0	1	1	O95831-1	523	524	+	1	O95831-1	0	613	ENST00000675857.1	82	1915	++	242	O95831-1#37	0	3	ENST00000675857.1	1645	1648	+	3	0	-2	925
O95831-1#37	0	1	1	O95831-1	523	524	+	1	O95831-1	0	613	ENST00000675427.1	89	1925	++	240	O95831-1#37	0	3	ENST00000675427.1	1655	1658	+	3	0	-2	926
O95831-1#37	0	1	1	O95831-1	523	524	+	1	O95831-1	0	524	ENST00000675240.1	169	1741	++	239	O95831-1#37	0	3	ENST00000675240.1	1738	1741	+	3	0	-2	927
O95831-1#37	0	1	1	O95831-1	523	524	+	1	O95831-1	0	613	ENST00000675092.1	90	1956	++	238	O95831-1#37	0	3	ENST00000675092.1	1659	1662	+	3	0	-2	928
O95831-1#37	0	1	1	O95831-1	523	524	+	1	O95831-1	0	613	ENST00000675050.1	71	1898	++	237	O95831-1#37	0	3	ENST00000675050.1	1628	1631	+	3	0	-2	929
O95831-1#37	0	1	1	O95831-1	523	524	+	1	O95831-1	338	613	ENST00000674601.1	2	686	++	232	O95831-1#37	0	3	ENST00000674601.1	416	419	+	3	0	-2	930
O95831-1#37	0	1	1	O95831-1	523	524	+	1	O95831-1	0	587	ENST00000674546.1	185	1954	++	230	O95831-1#37	0	3	ENST00000674546.1	1754	1757	+	3	0	-2	931
O95831-1#37	0	1	1	O95831-1	523	524	+	1	O95831-1	339	613	ENST00000460436.6	905	1727	++	106	O95831-1#37	0	3	ENST00000460436.6	1457	1460	+	3	0	-2	932
O95831-1#37	0	1	1	O95831-1	523	524	+	1	O95831-1	0	613	ENST00000346424.6	24	1002	++	35	O95831-1#37	0	3	ENST00000346424.6	732	735	+	3	0	-2	933
O95831-1#37	0	1	1	O95831-1	523	524	+	1	O95831-1	0	613	ENST00000319908.8	174	2007	++	26	O95831-1#37	0	3	ENST00000319908.8	1737	1740	+	3	0	-2	934
O95831-1#37	0	1	1	O95831-1	523	524	+	1	O95831-1	0	613	ENST00000287295.8	185	2024	++	18	O95831-1#37	0	3	ENST00000287295.8	1754	1757	+	3	0	-2	935
O95831-1#38	0	1	1	O95831-1	529	530	+	1	O95831-1	0	613	ENST00000676436.1	34	1861	++	246	O95831-1#38	0	3	ENST00000676436.1	1609	1612	+	3	0	-2	936
O95831-1#38	0	1	1	O95831-1	529	530	+	1	O95831-1	0	613	ENST00000676328.1	56	1892	++	245	O95831-1#38	0	3	ENST00000676328.1	1640	1643	+	3	0	-2	937
O95831-1#38	0	1	1	O95831-1	529	530	+	1	O95831-1	0	613	ENST00000676229.1	223	2050	++	244	O95831-1#38	0	3	ENST00000676229.1	1798	1801	+	3	0	-2	938
O95831-1#38	0	1	1	O95831-1	529	530	+	1	O95831-1	0	613	ENST00000675857.1	82	1915	++	242	O95831-1#38	0	3	ENST00000675857.1	1663	1666	+	3	0	-2	939
O95831-1#38	0	1	1	O95831-1	529	530	+	1	O95831-1	0	613	ENST00000675427.1	89	1925	++	240	O95831-1#38	0	3	ENST00000675427.1	1673	1676	+	3	0	-2	940
O95831-1#38	0	1	1	O95831-1	529	530	+	1	O95831-1	0	613	ENST00000675092.1	90	1956	++	238	O95831-1#38	0	3	ENST00000675092.1	1704	1707	+	3	0	-2	941
O95831-1#38	0	1	1	O95831-1	529	530	+	1	O95831-1	0	613	ENST00000675050.1	71	1898	++	237	O95831-1#38	0	3	ENST00000675050.1	1646	1649	+	3	0	-2	942
O95831-1#38	0	1	1	O95831-1	529	530	+	1	O95831-1	338	613	ENST00000674601.1	2	686	++	232	O95831-1#38	0	3	ENST00000674601.1	434	437	+	3	0	-2	943
O95831-1#38	0	1	1	O95831-1	529	530	+	1	O95831-1	0	587	ENST00000674546.1	185	1954	++	230	O95831-1#38	0	3	ENST00000674546.1	1780	1783	+	3	0	-2	944
O95831-1#38	0	1	1	O95831-1	529	530	+	1	O95831-1	339	613	ENST00000460436.6	905	1727	++	106	O95831-1#38	0	3	ENST00000460436.6	1475	1478	+	3	0	-2	945
O95831-1#38	0	1	1	O95831-1	529	530	+	1	O95831-1	0	613	ENST00000346424.6	24	1002	++	35	O95831-1#38	0	3	ENST00000346424.6	750	753	+	3	0	-2	946
O95831-1#38	0	1	1	O95831-1	529	530	+	1	O95831-1	0	613	ENST00000319908.8	174	2007	++	26	O95831-1#38	0	3	ENST00000319908.8	1755	1758	+	3	0	-2	947
O95831-1#38	0	1	1	O95831-1	529	530	+	1	O95831-1	0	613	ENST00000287295.8	185	2024	++	18	O95831-1#38	0	3	ENST00000287295.8	1772	1775	+	3	0	-2	948
O95831-1#39	0	1	1	O95831-1	592	593	+	1	O95831-1	0	613	ENST00000676436.1	34	1861	++	246	O95831-1#39	0	3	ENST00000676436.1	1798	1801	+	3	0	-2	949
O95831-1#39	0	1	1	O95831-1	592	593	+	1	O95831-1	0	613	ENST00000676328.1	56	1892	++	245	O95831-1#39	0	3	ENST00000676328.1	1829	1832	+	3	0	-2	950
O95831-1#39	0	1	1	O95831-1	592	593	+	1	O95831-1	0	613	ENST00000676229.1	223	2050	++	244	O95831-1#39	0	3	ENST00000676229.1	1987	1990	+	3	0	-2	951
O95831-1#39	0	1	1	O95831-1	592	593	+	1	O95831-1	0	613	ENST00000675857.1	82	1915	++	242	O95831-1#39	0	3	ENST00000675857.1	1852	1855	+	3	0	-2	952
O95831-1#39	0	1	1	O95831-1	592	593	+	1	O95831-1	0	613	ENST00000675427.1	89	1925	++	240	O95831-1#39	0	3	ENST00000675427.1	1862	1865	+	3	0	-2	953
O95831-1#39	0	1	1	O95831-1	592	593	+	1	O95831-1	0	613	ENST00000675092.1	90	1956	++	238	O95831-1#39	0	3	ENST00000675092.1	1893	1896	+	3	0	-2	954
O95831-1#39	0	1	1	O95831-1	592	593	+	1	O95831-1	0	613	ENST00000675050.1	71	1898	++	237	O95831-1#39	0	3	ENST00000675050.1	1835	1838	+	3	0	-2	955
O95831-1#39	0	1	1	O95831-1	592	593	+	1	O95831-1	338	613	ENST00000674601.1	2	686	++	232	O95831-1#39	0	3	ENST00000674601.1	623	626	+	3	0	-2	956
O95831-1#39	0	1	1	O95831-1	592	593	+	1	O95831-1	339	613	ENST00000460436.6	905	1727	++	106	O95831-1#39	0	3	ENST00000460436.6	1664	1667	+	3	0	-2	957
O95831-1#39	0	1	1	O95831-1	592	593	+	1	O95831-1	0	613	ENST00000346424.6	24	1002	++	35	O95831-1#39	0	3	ENST00000346424.6	939	942	+	3	0	-2	958
O95831-1#39	0	1	1	O95831-1	592	593	+	1	O95831-1	0	613	ENST00000319908.8	174	2007	++	26	O95831-1#39	0	3	ENST00000319908.8	1944	1947	+	3	0	-2	959
O95831-1#39	0	1	1	O95831-1	592	593	+	1	O95831-1	0	613	ENST00000287295.8	185	2024	++	18	O95831-1#39	0	3	ENST00000287295.8	1961	1964	+	3	0	-2	960
O95831-1#40	0	1	1	O95831-1	254	255	+	1	O95831-1	0	613	ENST00000676436.1	34	1861	++	246	O95831-1#40	0	3	ENST00000676436.1	790	793	+	3	0	-2	961
O95831-1#40	0	1	1	O95831-1	254	255	+	1	O95831-1	0	613	ENST00000676328.1	56	1892	++	245	O95831-1#40	0	3	ENST00000676328.1	818	821	+	3	0	-2	962
O95831-1#40	0	1	1	O95831-1	254	255	+	1	O95831-1	0	613	ENST00000676229.1	223	2050	++	244	O95831-1#40	0	3	ENST00000676229.1	973	976	+	3	0	-2	963
O95831-1#40	0	1	1	O95831-1	254	255	+	1	O95831-1	0	613	ENST00000675857.1	82	1915	++	242	O95831-1#40	0	3	ENST00000675857.1	838	841	+	3	0	-2	964
O95831-1#40	0	1	1	O95831-1	254	255	+	1	O95831-1	0	613	ENST00000675427.1	89	1925	++	240	O95831-1#40	0	3	ENST00000675427.1	851	854	+	3	0	-2	965
O95831-1#40	0	1	1	O95831-1	254	255	+	1	O95831-1	0	524	ENST00000675240.1	169	1741	++	239	O95831-1#40	0	3	ENST00000675240.1	931	934	+	3	0	-2	966
O95831-1#40	0	1	1	O95831-1	254	255	+	1	O95831-1	0	613	ENST00000675092.1	90	1956	++	238	O95831-1#40	0	3	ENST00000675092.1	852	855	+	3	0	-2	967
O95831-1#40	0	1	1	O95831-1	254	255	+	1	O95831-1	0	613	ENST00000675050.1	71	1898	++	237	O95831-1#40	0	3	ENST00000675050.1	821	824	+	3	0	-2	968
O95831-1#40	0	1	1	O95831-1	254	255	+	1	O95831-1	0	459	ENST00000675037.1	56	1433	++	236	O95831-1#40	0	3	ENST00000675037.1	818	821	+	3	0	-2	969
O95831-1#40	0	1	1	O95831-1	254	255	+	1	O95831-1	100	388	ENST00000674957.1	1	865	++	234	O95831-1#40	0	3	ENST00000674957.1	463	466	+	3	0	-2	970
O95831-1#40	0	1	1	O95831-1	254	255	+	1	O95831-1	0	587	ENST00000674546.1	185	1954	++	230	O95831-1#40	0	3	ENST00000674546.1	947	950	+	3	0	-2	971
O95831-1#40	0	1	1	O95831-1	254	255	+	1	O95831-1	0	322	ENST00000535724.6	8	974	++	150	O95831-1#40	0	3	ENST00000535724.6	770	773	+	3	0	-2	972
O95831-1#40	0	1	1	O95831-1	254	255	+	1	O95831-1	0	435	ENST00000416073.7	37	1336	++	76	O95831-1#40	0	3	ENST00000416073.7	793	796	+	3	0	-2	973
O95831-1#40	0	1	1	O95831-1	254	255	+	1	O95831-1	0	613	ENST00000319908.8	174	2007	++	26	O95831-1#40	0	3	ENST00000319908.8	936	939	+	3	0	-2	974
O95831-1#40	0	1	1	O95831-1	254	255	+	1	O95831-1	0	613	ENST00000287295.8	185	2024	++	18	O95831-1#40	0	3	ENST00000287295.8	947	950	+	3	0	-2	975
O95831-1#41	0	352	352	O95831-1	0	352	+	352	O95831-1	0	613	ENST00000676436.1	34	1861	++	246	O95831-1#41	0	1056	ENST00000676436.1	34	1078	+	1044	0	-704	976
O95831-1#41	0	352	352	O95831-1	0	352	+	352	O95831-1	0	613	ENST00000676328.1	56	1892	++	245	O95831-1#41	0	1056	ENST00000676328.1	56	1109	+	1053	0	-704	977
O95831-1#41	0	352	352	O95831-1	0	352	+	352	O95831-1	0	613	ENST00000676229.1	223	2050	++	244	O95831-1#41	0	1056	ENST00000676229.1	223	1267	+	1041	0	-704	978
O95831-1#41	0	352	352	O95831-1	0	352	+	352	O95831-1	109	136	ENST00000676144.1	102	183	++	243	O95831-1#41	327	408	ENST00000676144.1	102	183	+	81	327	-56	979
O95831-1#41	0	352	352	O95831-1	0	352	+	352	O95831-1	0	613	ENST00000675857.1	82	1915	++	242	O95831-1#41	0	1056	ENST00000675857.1	82	1132	+	1050	0	-704	980
O95831-1#41	0	352	352	O95831-1	0	352	+	352	O95831-1	0	36	ENST00000675774.1	41	149	++	241	O95831-1#41	0	108	ENST00000675774.1	41	149	+	108	0	244	981
O95831-1#41	0	352	352	O95831-1	0	352	+	352	O95831-1	0	613	ENST00000675427.1	89	1925	++	240	O95831-1#41	0	1056	ENST00000675427.1	89	1145	+	1056	0	-704	982
O95831-1#41	0	352	352	O95831-1	0	352	+	352	O95831-1	0	524	ENST00000675240.1	169	1741	++	239	O95831-1#41	0	1056	ENST00000675240.1	169	1225	+	1056	0	-704	983
O95831-1#41	0	352	352	O95831-1	0	352	+	352	O95831-1	0	613	ENST00000675092.1	90	1956	++	238	O95831-1#41	0	1056	ENST00000675092.1	90	1146	+	1056	0	-704	984
O95831-1#41	0	352	352	O95831-1	0	352	+	352	O95831-1	0	613	ENST00000675050.1	71	1898	++	237	O95831-1#41	0	1056	ENST00000675050.1	71	1115	+	1041	0	-704	985
O95831-1#41	0	352	352	O95831-1	0	352	+	352	O95831-1	0	459	ENST00000675037.1	56	1433	++	236	O95831-1#41	0	1056	ENST00000675037.1	56	1112	+	1056	0	-704	986
O95831-1#41	0	352	352	O95831-1	0	352	+	352	O95831-1	0	36	ENST00000674997.1	0	108	++	235	O95831-1#41	0	108	ENST00000674997.1	0	108	+	108	0	244	987
O95831-1#41	0	352	352	O95831-1	0	352	+	352	O95831-1	100	388	ENST00000674957.1	1	865	++	234	O95831-1#41	300	1056	ENST00000674957.1	1	757	+	756	300	-704	988
O95831-1#41	0	352	352	O95831-1	0	352	+	352	O95831-1	0	238	ENST00000674722.1	13	727	++	233	O95831-1#41	0	714	ENST00000674722.1	13	727	+	714	0	-362	989
O95831-1#41	0	352	352	O95831-1	0	352	+	352	O95831-1	338	613	ENST00000674601.1	2	686	++	232	O95831-1#41	1014	1056	ENST00000674601.1	2	44	+	42	1014	-704	990
O95831-1#41	0	352	352	O95831-1	0	352	+	352	O95831-1	0	91	ENST00000674555.1	57	330	++	231	O95831-1#41	0	273	ENST00000674555.1	57	330	+	273	0	79	991
O95831-1#41	0	352	352	O95831-1	0	352	+	352	O95831-1	0	587	ENST00000674546.1	185	1954	++	230	O95831-1#41	0	1056	ENST00000674546.1	185	1241	+	1056	0	-704	992
O95831-1#41	0	352	352	O95831-1	0	352	+	352	O95831-1	0	322	ENST00000535724.6	8	974	++	150	O95831-1#41	0	966	ENST00000535724.6	8	974	+	966	0	-614	993
O95831-1#41	0	352	352	O95831-1	0	352	+	352	O95831-1	0	83	ENST00000529877.1	103	352	++	145	O95831-1#41	0	249	ENST00000529877.1	103	352	+	249	0	103	994
O95831-1#41	0	352	352	O95831-1	0	352	+	352	O95831-1	0	36	ENST00000527892.5	8	116	++	142	O95831-1#41	0	108	ENST00000527892.5	8	116	+	108	0	244	995
O95831-1#41	0	352	352	O95831-1	0	352	+	352	O95831-1	339	613	ENST00000460436.6	905	1727	++	106	O95831-1#41	1017	1056	ENST00000460436.6	905	944	+	39	1017	-704	996
O95831-1#41	0	352	352	O95831-1	0	352	+	352	O95831-1	0	435	ENST00000416073.7	37	1336	++	76	O95831-1#41	0	1056	ENST00000416073.7	37	1087	+	1050	0	-704	997
O95831-1#41	0	352	352	O95831-1	0	352	+	352	O95831-1	0	613	ENST00000346424.6	24	1002	++	35	O95831-1#41	0	1056	ENST00000346424.6	24	219	+	195	0	-704	998
O95831-1#41	0	352	352	O95831-1	0	352	+	352	O95831-1	0	613	ENST00000319908.8	174	2007	++	26	O95831-1#41	0	1056	ENST00000319908.8	174	1227	+	1053	0	-704	999
O95831-1#41	0	352	352	O95831-1	0	352	+	352	O95831-1	0	613	ENST00000287295.8	185	2024	++	18	O95831-1#41	0	1056	ENST00000287295.8	185	1241	+	1056	0	-704	1000
O95831-1#42	0	287	287	O95831-1	35	322	+	287	O95831-1	0	613	ENST00000676436.1	34	1861	++	246	O95831-1#42	0	861	ENST00000676436.1	139	994	+	855	0	-574	1001
O95831-1#42	0	287	287	O95831-1	35	322	+	287	O95831-1	0	613	ENST00000676328.1	56	1892	++	245	O95831-1#42	0	861	ENST00000676328.1	161	1019	+	858	0	-574	1002
O95831-1#42	0	287	287	O95831-1	35	322	+	287	O95831-1	0	613	ENST00000676229.1	223	2050	++	244	O95831-1#42	6	861	ENST00000676229.1	328	1177	+	846	6	-574	1003
O95831-1#42	0	287	287	O95831-1	35	322	+	287	O95831-1	109	136	ENST00000676144.1	102	183	++	243	O95831-1#42	222	303	ENST00000676144.1	102	183	+	81	222	-16	1004
O95831-1#42	0	287	287	O95831-1	35	322	+	287	O95831-1	0	613	ENST00000675857.1	82	1915	++	242	O95831-1#42	0	861	ENST00000675857.1	187	1042	+	855	0	-574	1005
O95831-1#42	0	287	287	O95831-1	35	322	+	287	O95831-1	0	36	ENST00000675774.1	41	149	++	241	O95831-1#42	0	3	ENST00000675774.1	146	149	+	3	0	284	1006
O95831-1#42	0	287	287	O95831-1	35	322	+	287	O95831-1	0	613	ENST00000675427.1	89	1925	++	240	O95831-1#42	0	861	ENST00000675427.1	194	1055	+	861	0	-574	1007
O95831-1#42	0	287	287	O95831-1	35	322	+	287	O95831-1	0	524	ENST00000675240.1	169	1741	++	239	O95831-1#42	0	861	ENST00000675240.1	274	1135	+	861	0	-574	1008
O95831-1#42	0	287	287	O95831-1	35	322	+	287	O95831-1	0	613	ENST00000675092.1	90	1956	++	238	O95831-1#42	0	861	ENST00000675092.1	195	1056	+	861	0	-574	1009
O95831-1#42	0	287	287	O95831-1	35	322	+	287	O95831-1	0	613	ENST00000675050.1	71	1898	++	237	O95831-1#42	6	861	ENST00000675050.1	176	1025	+	846	6	-574	1010
O95831-1#42	0	287	287	O95831-1	35	322	+	287	O95831-1	0	459	ENST00000675037.1	56	1433	++	236	O95831-1#42	0	861	ENST00000675037.1	161	1022	+	861	0	-574	1011
O95831-1#42	0	287	287	O95831-1	35	322	+	287	O95831-1	0	36	ENST00000674997.1	0	108	++	235	O95831-1#42	0	3	ENST00000674997.1	105	108	+	3	0	284	1012
O95831-1#42	0	287	287	O95831-1	35	322	+	287	O95831-1	100	388	ENST00000674957.1	1	865	++	234	O95831-1#42	195	861	ENST00000674957.1	1	667	+	666	195	-574	1013
O95831-1#42	0	287	287	O95831-1	35	322	+	287	O95831-1	0	238	ENST00000674722.1	13	727	++	233	O95831-1#42	0	609	ENST00000674722.1	118	727	+	609	0	-322	1014
O95831-1#42	0	287	287	O95831-1	35	322	+	287	O95831-1	0	91	ENST00000674555.1	57	330	++	231	O95831-1#42	0	168	ENST00000674555.1	162	330	+	168	0	119	1015
O95831-1#42	0	287	287	O95831-1	35	322	+	287	O95831-1	0	587	ENST00000674546.1	185	1954	++	230	O95831-1#42	0	861	ENST00000674546.1	290	1151	+	861	0	-574	1016
O95831-1#42	0	287	287	O95831-1	35	322	+	287	O95831-1	0	322	ENST00000535724.6	8	974	++	150	O95831-1#42	0	861	ENST00000535724.6	113	974	+	861	0	-574	1017
O95831-1#42	0	287	287	O95831-1	35	322	+	287	O95831-1	0	83	ENST00000529877.1	103	352	++	145	O95831-1#42	0	144	ENST00000529877.1	208	352	+	144	0	143	1018
O95831-1#42	0	287	287	O95831-1	35	322	+	287	O95831-1	0	36	ENST00000527892.5	8	116	++	142	O95831-1#42	0	3	ENST00000527892.5	113	116	+	3	0	284	1019
O95831-1#42	0	287	287	O95831-1	35	322	+	287	O95831-1	0	435	ENST00000416073.7	37	1336	++	76	O95831-1#42	0	861	ENST00000416073.7	142	997	+	855	0	-574	1020
O95831-1#42	0	287	287	O95831-1	35	322	+	287	O95831-1	0	613	ENST00000319908.8	174	2007	++	26	O95831-1#42	0	861	ENST00000319908.8	279	1137	+	858	0	-574	1021
O95831-1#42	0	287	287	O95831-1	35	322	+	287	O95831-1	0	613	ENST00000287295.8	185	2024	++	18	O95831-1#42	0	861	ENST00000287295.8	290	1151	+	861	0	-574	1022
O95831-1#43	0	47	47	O95831-1	35	82	+	47	O95831-1	0	613	ENST00000676436.1	34	1861	++	246	O95831-1#43	0	141	ENST00000676436.1	139	280	+	141	0	-94	1023
O95831-1#43	0	47	47	O95831-1	35	82	+	47	O95831-1	0	613	ENST00000676328.1	56	1892	++	245	O95831-1#43	0	141	ENST00000676328.1	161	302	+	141	0	-94	1024
O95831-1#43	0	47	47	O95831-1	35	82	+	47	O95831-1	0	613	ENST00000676229.1	223	2050	++	244	O95831-1#43	6	141	ENST00000676229.1	328	454	+	126	6	-94	1025
O95831-1#43	0	47	47	O95831-1	35	82	+	47	O95831-1	0	613	ENST00000675857.1	82	1915	++	242	O95831-1#43	0	141	ENST00000675857.1	187	328	+	141	0	-94	1026
O95831-1#43	0	47	47	O95831-1	35	82	+	47	O95831-1	0	36	ENST00000675774.1	41	149	++	241	O95831-1#43	0	3	ENST00000675774.1	146	149	+	3	0	44	1027
O95831-1#43	0	47	47	O95831-1	35	82	+	47	O95831-1	0	613	ENST00000675427.1	89	1925	++	240	O95831-1#43	0	141	ENST00000675427.1	194	335	+	141	0	-94	1028
O95831-1#43	0	47	47	O95831-1	35	82	+	47	O95831-1	0	524	ENST00000675240.1	169	1741	++	239	O95831-1#43	0	141	ENST00000675240.1	274	415	+	141	0	-94	1029
O95831-1#43	0	47	47	O95831-1	35	82	+	47	O95831-1	0	613	ENST00000675092.1	90	1956	++	238	O95831-1#43	0	141	ENST00000675092.1	195	336	+	141	0	-94	1030
O95831-1#43	0	47	47	O95831-1	35	82	+	47	O95831-1	0	613	ENST00000675050.1	71	1898	++	237	O95831-1#43	6	141	ENST00000675050.1	176	302	+	126	6	-94	1031
O95831-1#43	0	47	47	O95831-1	35	82	+	47	O95831-1	0	459	ENST00000675037.1	56	1433	++	236	O95831-1#43	0	141	ENST00000675037.1	161	302	+	141	0	-94	1032
O95831-1#43	0	47	47	O95831-1	35	82	+	47	O95831-1	0	36	ENST00000674997.1	0	108	++	235	O95831-1#43	0	3	ENST00000674997.1	105	108	+	3	0	44	1033
O95831-1#43	0	47	47	O95831-1	35	82	+	47	O95831-1	0	238	ENST00000674722.1	13	727	++	233	O95831-1#43	0	141	ENST00000674722.1	118	259	+	141	0	-94	1034
O95831-1#43	0	47	47	O95831-1	35	82	+	47	O95831-1	0	91	ENST00000674555.1	57	330	++	231	O95831-1#43	0	141	ENST00000674555.1	162	303	+	141	0	-94	1035
O95831-1#43	0	47	47	O95831-1	35	82	+	47	O95831-1	0	587	ENST00000674546.1	185	1954	++	230	O95831-1#43	0	141	ENST00000674546.1	290	431	+	141	0	-94	1036
O95831-1#43	0	47	47	O95831-1	35	82	+	47	O95831-1	0	322	ENST00000535724.6	8	974	++	150	O95831-1#43	0	141	ENST00000535724.6	113	254	+	141	0	-94	1037
O95831-1#43	0	47	47	O95831-1	35	82	+	47	O95831-1	0	83	ENST00000529877.1	103	352	++	145	O95831-1#43	0	141	ENST00000529877.1	208	349	+	141	0	-94	1038
O95831-1#43	0	47	47	O95831-1	35	82	+	47	O95831-1	0	36	ENST00000527892.5	8	116	++	142	O95831-1#43	0	3	ENST00000527892.5	113	116	+	3	0	44	1039
O95831-1#43	0	47	47	O95831-1	35	82	+	47	O95831-1	0	435	ENST00000416073.7	37	1336	++	76	O95831-1#43	0	141	ENST00000416073.7	142	283	+	141	0	-94	1040
O95831-1#43	0	47	47	O95831-1	35	82	+	47	O95831-1	0	613	ENST00000319908.8	174	2007	++	26	O95831-1#43	0	141	ENST00000319908.8	279	420	+	141	0	-94	1041
O95831-1#43	0	47	47	O95831-1	35	82	+	47	O95831-1	0	613	ENST00000287295.8	185	2024	++	18	O95831-1#43	0	141	ENST00000287295.8	290	431	+	141	0	-94	1042
O95831-1#44	0	7	7	O95831-1	36	43	+	7	O95831-1	0	613	ENST00000676436.1	34	1861	++	246	O95831-1#44	0	21	ENST00000676436.1	142	163	+	21	0	-14	1043
O95831-1#44	0	7	7	O95831-1	36	43	+	7	O95831-1	0	613	ENST00000676328.1	56	1892	++	245	O95831-1#44	0	21	ENST00000676328.1	164	185	+	21	0	-14	1044
O95831-1#44	0	7	7	O95831-1	36	43	+	7	O95831-1	0	613	ENST00000676229.1	223	2050	++	244	O95831-1#44	3	21	ENST00000676229.1	328	346	+	18	3	-14	1045
O95831-1#44	0	7	7	O95831-1	36	43	+	7	O95831-1	0	613	ENST00000675857.1	82	1915	++	242	O95831-1#44	0	21	ENST00000675857.1	190	211	+	21	0	-14	1046
O95831-1#44	0	7	7	O95831-1	36	43	+	7	O95831-1	0	613	ENST00000675427.1	89	1925	++	240	O95831-1#44	0	21	ENST00000675427.1	197	218	+	21	0	-14	1047
O95831-1#44	0	7	7	O95831-1	36	43	+	7	O95831-1	0	524	ENST00000675240.1	169	1741	++	239	O95831-1#44	0	21	ENST00000675240.1	277	298	+	21	0	-14	1048
O95831-1#44	0	7	7	O95831-1	36	43	+	7	O95831-1	0	613	ENST00000675092.1	90	1956	++	238	O95831-1#44	0	21	ENST00000675092.1	198	219	+	21	0	-14	1049
O95831-1#44	0	7	7	O95831-1	36	43	+	7	O95831-1	0	613	ENST00000675050.1	71	1898	++	237	O95831-1#44	3	21	ENST00000675050.1	176	194	+	18	3	-14	1050
O95831-1#44	0	7	7	O95831-1	36	43	+	7	O95831-1	0	459	ENST00000675037.1	56	1433	++	236	O95831-1#44	0	21	ENST00000675037.1	164	185	+	21	0	-14	1051
O95831-1#44	0	7	7	O95831-1	36	43	+	7	O95831-1	0	238	ENST00000674722.1	13	727	++	233	O95831-1#44	0	21	ENST00000674722.1	121	142	+	21	0	-14	1052
O95831-1#44	0	7	7	O95831-1	36	43	+	7	O95831-1	0	91	ENST00000674555.1	57	330	++	231	O95831-1#44	0	21	ENST00000674555.1	165	186	+	21	0	-14	1053
O95831-1#44	0	7	7	O95831-1	36	43	+	7	O95831-1	0	587	ENST00000674546.1	185	1954	++	230	O95831-1#44	0	21	ENST00000674546.1	293	314	+	21	0	-14	1054
O95831-1#44	0	7	7	O95831-1	36	43	+	7	O95831-1	0	322	ENST00000535724.6	8	974	++	150	O95831-1#44	0	21	ENST00000535724.6	116	137	+	21	0	-14	1055
O95831-1#44	0	7	7	O95831-1	36	43	+	7	O95831-1	0	83	ENST00000529877.1	103	352	++	145	O95831-1#44	0	21	ENST00000529877.1	211	232	+	21	0	-14	1056
O95831-1#44	0	7	7	O95831-1	36	43	+	7	O95831-1	0	435	ENST00000416073.7	37	1336	++	76	O95831-1#44	0	21	ENST00000416073.7	145	166	+	21	0	-14	1057
O95831-1#44	0	7	7	O95831-1	36	43	+	7	O95831-1	0	613	ENST00000319908.8	174	2007	++	26	O95831-1#44	0	21	ENST00000319908.8	282	303	+	21	0	-14	1058
O95831-1#44	0	7	7	O95831-1	36	43	+	7	O95831-1	0	613	ENST00000287295.8	185	2024	++	18	O95831-1#44	0	21	ENST00000287295.8	293	314	+	21	0	-14	1059
O95831-1#45	0	570	570	O95831-1	43	613	+	570	O95831-1	0	613	ENST00000676436.1	34	1861	++	246	O95831-1#45	0	1710	ENST00000676436.1	163	1861	+	1698	0	-1140	1060
O95831-1#45	0	570	570	O95831-1	43	613	+	570	O95831-1	0	613	ENST00000676328.1	56	1892	++	245	O95831-1#45	0	1710	ENST00000676328.1	185	1892	+	1707	0	-1140	1061
O95831-1#45	0	570	570	O95831-1	43	613	+	570	O95831-1	0	613	ENST00000676229.1	223	2050	++	244	O95831-1#45	0	1710	ENST00000676229.1	346	2050	+	1701	0	-1140	1062
O95831-1#45	0	570	570	O95831-1	43	613	+	570	O95831-1	109	136	ENST00000676144.1	102	183	++	243	O95831-1#45	198	279	ENST00000676144.1	102	183	+	81	198	291	1063
O95831-1#45	0	570	570	O95831-1	43	613	+	570	O95831-1	0	613	ENST00000675857.1	82	1915	++	242	O95831-1#45	0	1710	ENST00000675857.1	211	1915	+	1704	0	-1140	1064
O95831-1#45	0	570	570	O95831-1	43	613	+	570	O95831-1	0	613	ENST00000675427.1	89	1925	++	240	O95831-1#45	0	1710	ENST00000675427.1	218	1925	+	1707	0	-1140	1065
O95831-1#45	0	570	570	O95831-1	43	613	+	570	O95831-1	0	524	ENST00000675240.1	169	1741	++	239	O95831-1#45	0	1443	ENST00000675240.1	298	1741	+	1443	0	-873	1066
O95831-1#45	0	570	570	O95831-1	43	613	+	570	O95831-1	0	613	ENST00000675092.1	90	1956	++	238	O95831-1#45	0	1710	ENST00000675092.1	219	1956	+	1710	0	-1140	1067
O95831-1#45	0	570	570	O95831-1	43	613	+	570	O95831-1	0	613	ENST00000675050.1	71	1898	++	237	O95831-1#45	0	1710	ENST00000675050.1	194	1898	+	1701	0	-1140	1068
O95831-1#45	0	570	570	O95831-1	43	613	+	570	O95831-1	0	459	ENST00000675037.1	56	1433	++	236	O95831-1#45	0	1248	ENST00000675037.1	185	1433	+	1248	0	-678	1069
O95831-1#45	0	570	570	O95831-1	43	613	+	570	O95831-1	100	388	ENST00000674957.1	1	865	++	234	O95831-1#45	171	1035	ENST00000674957.1	1	865	+	864	171	-465	1070
O95831-1#45	0	570	570	O95831-1	43	613	+	570	O95831-1	0	238	ENST00000674722.1	13	727	++	233	O95831-1#45	0	585	ENST00000674722.1	142	727	+	585	0	-15	1071
O95831-1#45	0	570	570	O95831-1	43	613	+	570	O95831-1	338	613	ENST00000674601.1	2	686	++	232	O95831-1#45	885	1710	ENST00000674601.1	2	686	+	684	885	-1140	1072
O95831-1#45	0	570	570	O95831-1	43	613	+	570	O95831-1	0	91	ENST00000674555.1	57	330	++	231	O95831-1#45	0	144	ENST00000674555.1	186	330	+	144	0	426	1073
O95831-1#45	0	570	570	O95831-1	43	613	+	570	O95831-1	0	587	ENST00000674546.1	185	1954	++	230	O95831-1#45	0	1632	ENST00000674546.1	314	1954	+	1632	0	-1062	1074
O95831-1#45	0	570	570	O95831-1	43	613	+	570	O95831-1	0	322	ENST00000535724.6	8	974	++	150	O95831-1#45	0	837	ENST00000535724.6	137	974	+	837	0	-267	1075
O95831-1#45	0	570	570	O95831-1	43	613	+	570	O95831-1	0	83	ENST00000529877.1	103	352	++	145	O95831-1#45	0	120	ENST00000529877.1	232	352	+	120	0	450	1076
O95831-1#45	0	570	570	O95831-1	43	613	+	570	O95831-1	339	613	ENST00000460436.6	905	1727	++	106	O95831-1#45	888	1710	ENST00000460436.6	905	1727	+	822	888	-1140	1077
O95831-1#45	0	570	570	O95831-1	43	613	+	570	O95831-1	0	435	ENST00000416073.7	37	1336	++	76	O95831-1#45	0	1176	ENST00000416073.7	166	1336	+	1170	0	-606	1078
O95831-1#45	0	570	570	O95831-1	43	613	+	570	O95831-1	0	613	ENST00000346424.6	24	1002	++	35	O95831-1#45	837	1710	ENST00000346424.6	129	1002	+	873	837	-1140	1079
O95831-1#45	0	570	570	O95831-1	43	613	+	570	O95831-1	0	613	ENST00000319908.8	174	2007	++	26	O95831-1#45	0	1710	ENST00000319908.8	303	2007	+	1704	0	-1140	1080
O95831-1#45	0	570	570	O95831-1	43	613	+	570	O95831-1	0	613	ENST00000287295.8	185	2024	++	18	O95831-1#45	0	1710	ENST00000287295.8	314	2024	+	1710	0	-1140	1081
O95831-1#46	0	2	2	O95831-1	322	324	+	2	O95831-1	0	613	ENST00000676436.1	34	1861	++	246	O95831-1#46	0	3	ENST00000676436.1	994	997	+	3	0	-1	1082
O95831-1#46	0	2	2	O95831-1	322	324	+	2	O95831-1	0	613	ENST00000676328.1	56	1892	++	245	O95831-1#46	0	6	ENST00000676328.1	1019	1025	+	6	0	-4	1083
O95831-1#46	0	2	2	O95831-1	322	324	+	2	O95831-1	0	613	ENST00000676229.1	223	2050	++	244	O95831-1#46	0	6	ENST00000676229.1	1177	1183	+	6	0	-4	1084
O95831-1#46	0	2	2	O95831-1	322	324	+	2	O95831-1	0	613	ENST00000675857.1	82	1915	++	242	O95831-1#46	0	6	ENST00000675857.1	1042	1048	+	6	0	-4	1085
O95831-1#46	0	2	2	O95831-1	322	324	+	2	O95831-1	0	613	ENST00000675427.1	89	1925	++	240	O95831-1#46	0	6	ENST00000675427.1	1055	1061	+	6	0	-4	1086
O95831-1#46	0	2	2	O95831-1	322	324	+	2	O95831-1	0	524	ENST00000675240.1	169	1741	++	239	O95831-1#46	0	6	ENST00000675240.1	1135	1141	+	6	0	-4	1087
O95831-1#46	0	2	2	O95831-1	322	324	+	2	O95831-1	0	613	ENST00000675092.1	90	1956	++	238	O95831-1#46	0	6	ENST00000675092.1	1056	1062	+	6	0	-4	1088
O95831-1#46	0	2	2	O95831-1	322	324	+	2	O95831-1	0	613	ENST00000675050.1	71	1898	++	237	O95831-1#46	0	6	ENST00000675050.1	1025	1031	+	6	0	-4	1089
O95831-1#46	0	2	2	O95831-1	322	324	+	2	O95831-1	0	459	ENST00000675037.1	56	1433	++	236	O95831-1#46	0	6	ENST00000675037.1	1022	1028	+	6	0	-4	1090
O95831-1#46	0	2	2	O95831-1	322	324	+	2	O95831-1	100	388	ENST00000674957.1	1	865	++	234	O95831-1#46	0	6	ENST00000674957.1	667	673	+	6	0	-4	1091
O95831-1#46	0	2	2	O95831-1	322	324	+	2	O95831-1	0	587	ENST00000674546.1	185	1954	++	230	O95831-1#46	0	6	ENST00000674546.1	1151	1157	+	6	0	-4	1092
O95831-1#46	0	2	2	O95831-1	322	324	+	2	O95831-1	0	435	ENST00000416073.7	37	1336	++	76	O95831-1#46	0	6	ENST00000416073.7	997	1003	+	6	0	-4	1093
O95831-1#46	0	2	2	O95831-1	322	324	+	2	O95831-1	0	613	ENST00000346424.6	24	1002	++	35	O95831-1#46	0	6	ENST00000346424.6	129	135	+	6	0	-4	1094
O95831-1#46	0	2	2	O95831-1	322	324	+	2	O95831-1	0	613	ENST00000319908.8	174	2007	++	26	O95831-1#46	0	6	ENST00000319908.8	1137	1143	+	6	0	-4	1095
O95831-1#46	0	2	2	O95831-1	322	324	+	2	O95831-1	0	613	ENST00000287295.8	185	2024	++	18	O95831-1#46	0	6	ENST00000287295.8	1151	1157	+	6	0	-4	1096
O95831-1#47	0	289	289	O95831-1	324	613	+	289	O95831-1	0	613	ENST00000676436.1	34	1861	++	246	O95831-1#47	3	867	ENST00000676436.1	997	1861	+	864	3	-578	1097
O95831-1#47	0	289	289	O95831-1	324	613	+	289	O95831-1	0	613	ENST00000676328.1	56	1892	++	245	O95831-1#47	0	867	ENST00000676328.1	1025	1892	+	867	0	-578	1098
O95831-1#47	0	289	289	O95831-1	324	613	+	289	O95831-1	0	613	ENST00000676229.1	223	2050	++	244	O95831-1#47	0	867	ENST00000676229.1	1183	2050	+	867	0	-578	1099
O95831-1#47	0	289	289	O95831-1	324	613	+	289	O95831-1	0	613	ENST00000675857.1	82	1915	++	242	O95831-1#47	0	867	ENST00000675857.1	1048	1915	+	867	0	-578	1100
O95831-1#47	0	289	289	O95831-1	324	613	+	289	O95831-1	0	613	ENST00000675427.1	89	1925	++	240	O95831-1#47	0	867	ENST00000675427.1	1061	1925	+	864	0	-578	1101
O95831-1#47	0	289	289	O95831-1	324	613	+	289	O95831-1	0	524	ENST00000675240.1	169	1741	++	239	O95831-1#47	0	600	ENST00000675240.1	1141	1741	+	600	0	-311	1102
O95831-1#47	0	289	289	O95831-1	324	613	+	289	O95831-1	0	613	ENST00000675092.1	90	1956	++	238	O95831-1#47	0	867	ENST00000675092.1	1062	1956	+	867	0	-578	1103
O95831-1#47	0	289	289	O95831-1	324	613	+	289	O95831-1	0	613	ENST00000675050.1	71	1898	++	237	O95831-1#47	0	867	ENST00000675050.1	1031	1898	+	867	0	-578	1104
O95831-1#47	0	289	289	O95831-1	324	613	+	289	O95831-1	0	459	ENST00000675037.1	56	1433	++	236	O95831-1#47	0	405	ENST00000675037.1	1028	1433	+	405	0	-116	1105
O95831-1#47	0	289	289	O95831-1	324	613	+	289	O95831-1	100	388	ENST00000674957.1	1	865	++	234	O95831-1#47	0	192	ENST00000674957.1	673	865	+	192	0	97	1106
O95831-1#47	0	289	289	O95831-1	324	613	+	289	O95831-1	338	613	ENST00000674601.1	2	686	++	232	O95831-1#47	42	867	ENST00000674601.1	2	686	+	684	42	-578	1107
O95831-1#47	0	289	289	O95831-1	324	613	+	289	O95831-1	0	587	ENST00000674546.1	185	1954	++	230	O95831-1#47	0	789	ENST00000674546.1	1157	1954	+	789	0	-500	1108
O95831-1#47	0	289	289	O95831-1	324	613	+	289	O95831-1	339	613	ENST00000460436.6	905	1727	++	106	O95831-1#47	45	867	ENST00000460436.6	905	1727	+	822	45	-578	1109
O95831-1#47	0	289	289	O95831-1	324	613	+	289	O95831-1	0	435	ENST00000416073.7	37	1336	++	76	O95831-1#47	0	333	ENST00000416073.7	1003	1336	+	333	0	-44	1110
O95831-1#47	0	289	289	O95831-1	324	613	+	289	O95831-1	0	613	ENST00000346424.6	24	1002	++	35	O95831-1#47	0	867	ENST00000346424.6	135	1002	+	867	0	-578	1111
O95831-1#47	0	289	289	O95831-1	324	613	+	289	O95831-1	0	613	ENST00000319908.8	174	2007	++	26	O95831-1#47	0	867	ENST00000319908.8	1143	2007	+	864	0	-578	1112
O95831-1#47	0	289	289	O95831-1	324	613	+	289	O95831-1	0	613	ENST00000287295.8	185	2024	++	18	O95831-1#47	0	867	ENST00000287295.8	1157	2024	+	867	0	-578	1113
O95831-1#48	0	1	1	O95831-1	200	201	+	1	O95831-1	0	613	ENST00000676436.1	34	1861	++	246	O95831-1#48	0	3	ENST00000676436.1	628	631	+	3	0	-2	1114
O95831-1#48	0	1	1	O95831-1	200	201	+	1	O95831-1	0	613	ENST00000676328.1	56	1892	++	245	O95831-1#48	0	3	ENST00000676328.1	656	659	+	3	0	-2	1115
O95831-1#48	0	1	1	O95831-1	200	201	+	1	O95831-1	0	613	ENST00000676229.1	223	2050	++	244	O95831-1#48	0	3	ENST00000676229.1	811	814	+	3	0	-2	1116
O95831-1#48	0	1	1	O95831-1	200	201	+	1	O95831-1	0	613	ENST00000675857.1	82	1915	++	242	O95831-1#48	0	3	ENST00000675857.1	676	679	+	3	0	-2	1117
O95831-1#48	0	1	1	O95831-1	200	201	+	1	O95831-1	0	613	ENST00000675427.1	89	1925	++	240	O95831-1#48	0	3	ENST00000675427.1	689	692	+	3	0	-2	1118
O95831-1#48	0	1	1	O95831-1	200	201	+	1	O95831-1	0	524	ENST00000675240.1	169	1741	++	239	O95831-1#48	0	3	ENST00000675240.1	769	772	+	3	0	-2	1119
O95831-1#48	0	1	1	O95831-1	200	201	+	1	O95831-1	0	613	ENST00000675092.1	90	1956	++	238	O95831-1#48	0	3	ENST00000675092.1	690	693	+	3	0	-2	1120
O95831-1#48	0	1	1	O95831-1	200	201	+	1	O95831-1	0	613	ENST00000675050.1	71	1898	++	237	O95831-1#48	0	3	ENST00000675050.1	659	662	+	3	0	-2	1121
O95831-1#48	0	1	1	O95831-1	200	201	+	1	O95831-1	0	459	ENST00000675037.1	56	1433	++	236	O95831-1#48	0	3	ENST00000675037.1	656	659	+	3	0	-2	1122
O95831-1#48	0	1	1	O95831-1	200	201	+	1	O95831-1	100	388	ENST00000674957.1	1	865	++	234	O95831-1#48	0	3	ENST00000674957.1	301	304	+	3	0	-2	1123
O95831-1#48	0	1	1	O95831-1	200	201	+	1	O95831-1	0	238	ENST00000674722.1	13	727	++	233	O95831-1#48	0	3	ENST00000674722.1	613	616	+	3	0	-2	1124
O95831-1#48	0	1	1	O95831-1	200	201	+	1	O95831-1	0	587	ENST00000674546.1	185	1954	++	230	O95831-1#48	0	3	ENST00000674546.1	785	788	+	3	0	-2	1125
O95831-1#48	0	1	1	O95831-1	200	201	+	1	O95831-1	0	322	ENST00000535724.6	8	974	++	150	O95831-1#48	0	3	ENST00000535724.6	608	611	+	3	0	-2	1126
O95831-1#48	0	1	1	O95831-1	200	201	+	1	O95831-1	0	435	ENST00000416073.7	37	1336	++	76	O95831-1#48	0	3	ENST00000416073.7	631	634	+	3	0	-2	1127
O95831-1#48	0	1	1	O95831-1	200	201	+	1	O95831-1	0	613	ENST00000319908.8	174	2007	++	26	O95831-1#48	0	3	ENST00000319908.8	774	777	+	3	0	-2	1128
O95831-1#48	0	1	1	O95831-1	200	201	+	1	O95831-1	0	613	ENST00000287295.8	185	2024	++	18	O95831-1#48	0	3	ENST00000287295.8	785	788	+	3	0	-2	1129
O95831-1#49	0	1	1	O95831-1	234	235	+	1	O95831-1	0	613	ENST00000676436.1	34	1861	++	246	O95831-1#49	0	3	ENST00000676436.1	730	733	+	3	0	-2	1130
O95831-1#49	0	1	1	O95831-1	234	235	+	1	O95831-1	0	613	ENST00000676328.1	56	1892	++	245	O95831-1#49	0	3	ENST00000676328.1	758	761	+	3	0	-2	1131
O95831-1#49	0	1	1	O95831-1	234	235	+	1	O95831-1	0	613	ENST00000676229.1	223	2050	++	244	O95831-1#49	0	3	ENST00000676229.1	913	916	+	3	0	-2	1132
O95831-1#49	0	1	1	O95831-1	234	235	+	1	O95831-1	0	613	ENST00000675857.1	82	1915	++	242	O95831-1#49	0	3	ENST00000675857.1	778	781	+	3	0	-2	1133
O95831-1#49	0	1	1	O95831-1	234	235	+	1	O95831-1	0	613	ENST00000675427.1	89	1925	++	240	O95831-1#49	0	3	ENST00000675427.1	791	794	+	3	0	-2	1134
O95831-1#49	0	1	1	O95831-1	234	235	+	1	O95831-1	0	524	ENST00000675240.1	169	1741	++	239	O95831-1#49	0	3	ENST00000675240.1	871	874	+	3	0	-2	1135
O95831-1#49	0	1	1	O95831-1	234	235	+	1	O95831-1	0	613	ENST00000675092.1	90	1956	++	238	O95831-1#49	0	3	ENST00000675092.1	792	795	+	3	0	-2	1136
O95831-1#49	0	1	1	O95831-1	234	235	+	1	O95831-1	0	613	ENST00000675050.1	71	1898	++	237	O95831-1#49	0	3	ENST00000675050.1	761	764	+	3	0	-2	1137
O95831-1#49	0	1	1	O95831-1	234	235	+	1	O95831-1	0	459	ENST00000675037.1	56	1433	++	236	O95831-1#49	0	3	ENST00000675037.1	758	761	+	3	0	-2	1138
O95831-1#49	0	1	1	O95831-1	234	235	+	1	O95831-1	100	388	ENST00000674957.1	1	865	++	234	O95831-1#49	0	3	ENST00000674957.1	403	406	+	3	0	-2	1139
O95831-1#49	0	1	1	O95831-1	234	235	+	1	O95831-1	0	238	ENST00000674722.1	13	727	++	233	O95831-1#49	0	3	ENST00000674722.1	715	718	+	3	0	-2	1140
O95831-1#49	0	1	1	O95831-1	234	235	+	1	O95831-1	0	587	ENST00000674546.1	185	1954	++	230	O95831-1#49	0	3	ENST00000674546.1	887	890	+	3	0	-2	1141
O95831-1#49	0	1	1	O95831-1	234	235	+	1	O95831-1	0	322	ENST00000535724.6	8	974	++	150	O95831-1#49	0	3	ENST00000535724.6	710	713	+	3	0	-2	1142
O95831-1#49	0	1	1	O95831-1	234	235	+	1	O95831-1	0	435	ENST00000416073.7	37	1336	++	76	O95831-1#49	0	3	ENST00000416073.7	733	736	+	3	0	-2	1143
O95831-1#49	0	1	1	O95831-1	234	235	+	1	O95831-1	0	613	ENST00000319908.8	174	2007	++	26	O95831-1#49	0	3	ENST00000319908.8	876	879	+	3	0	-2	1144
O95831-1#49	0	1	1	O95831-1	234	235	+	1	O95831-1	0	613	ENST00000287295.8	185	2024	++	18	O95831-1#49	0	3	ENST00000287295.8	887	890	+	3	0	-2	1145
O95831-1#50	0	1	1	O95831-1	236	237	+	1	O95831-1	0	613	ENST00000676436.1	34	1861	++	246	O95831-1#50	0	3	ENST00000676436.1	736	739	+	3	0	-2	1146
O95831-1#50	0	1	1	O95831-1	236	237	+	1	O95831-1	0	613	ENST00000676328.1	56	1892	++	245	O95831-1#50	0	3	ENST00000676328.1	764	767	+	3	0	-2	1147
O95831-1#50	0	1	1	O95831-1	236	237	+	1	O95831-1	0	613	ENST00000676229.1	223	2050	++	244	O95831-1#50	0	3	ENST00000676229.1	919	922	+	3	0	-2	1148
O95831-1#50	0	1	1	O95831-1	236	237	+	1	O95831-1	0	613	ENST00000675857.1	82	1915	++	242	O95831-1#50	0	3	ENST00000675857.1	784	787	+	3	0	-2	1149
O95831-1#50	0	1	1	O95831-1	236	237	+	1	O95831-1	0	613	ENST00000675427.1	89	1925	++	240	O95831-1#50	0	3	ENST00000675427.1	797	800	+	3	0	-2	1150
O95831-1#50	0	1	1	O95831-1	236	237	+	1	O95831-1	0	524	ENST00000675240.1	169	1741	++	239	O95831-1#50	0	3	ENST00000675240.1	877	880	+	3	0	-2	1151
O95831-1#50	0	1	1	O95831-1	236	237	+	1	O95831-1	0	613	ENST00000675092.1	90	1956	++	238	O95831-1#50	0	3	ENST00000675092.1	798	801	+	3	0	-2	1152
O95831-1#50	0	1	1	O95831-1	236	237	+	1	O95831-1	0	613	ENST00000675050.1	71	1898	++	237	O95831-1#50	0	3	ENST00000675050.1	767	770	+	3	0	-2	1153
O95831-1#50	0	1	1	O95831-1	236	237	+	1	O95831-1	0	459	ENST00000675037.1	56	1433	++	236	O95831-1#50	0	3	ENST00000675037.1	764	767	+	3	0	-2	1154
O95831-1#50	0	1	1	O95831-1	236	237	+	1	O95831-1	100	388	ENST00000674957.1	1	865	++	234	O95831-1#50	0	3	ENST00000674957.1	409	412	+	3	0	-2	1155
O95831-1#50	0	1	1	O95831-1	236	237	+	1	O95831-1	0	238	ENST00000674722.1	13	727	++	233	O95831-1#50	0	3	ENST00000674722.1	721	724	+	3	0	-2	1156
O95831-1#50	0	1	1	O95831-1	236	237	+	1	O95831-1	0	587	ENST00000674546.1	185	1954	++	230	O95831-1#50	0	3	ENST00000674546.1	893	896	+	3	0	-2	1157
O95831-1#50	0	1	1	O95831-1	236	237	+	1	O95831-1	0	322	ENST00000535724.6	8	974	++	150	O95831-1#50	0	3	ENST00000535724.6	716	719	+	3	0	-2	1158
O95831-1#50	0	1	1	O95831-1	236	237	+	1	O95831-1	0	435	ENST00000416073.7	37	1336	++	76	O95831-1#50	0	3	ENST00000416073.7	739	742	+	3	0	-2	1159
O95831-1#50	0	1	1	O95831-1	236	237	+	1	O95831-1	0	613	ENST00000319908.8	174	2007	++	26	O95831-1#50	0	3	ENST00000319908.8	882	885	+	3	0	-2	1160
O95831-1#50	0	1	1	O95831-1	236	237	+	1	O95831-1	0	613	ENST00000287295.8	185	2024	++	18	O95831-1#50	0	3	ENST00000287295.8	893	896	+	3	0	-2	1161
O95831-1#51	0	1	1	O95831-1	236	237	+	1	O95831-1	0	613	ENST00000676436.1	34	1861	++	246	O95831-1#51	0	3	ENST00000676436.1	736	739	+	3	0	-2	1162
O95831-1#51	0	1	1	O95831-1	236	237	+	1	O95831-1	0	613	ENST00000676328.1	56	1892	++	245	O95831-1#51	0	3	ENST00000676328.1	764	767	+	3	0	-2	1163
O95831-1#51	0	1	1	O95831-1	236	237	+	1	O95831-1	0	613	ENST00000676229.1	223	2050	++	244	O95831-1#51	0	3	ENST00000676229.1	919	922	+	3	0	-2	1164
O95831-1#51	0	1	1	O95831-1	236	237	+	1	O95831-1	0	613	ENST00000675857.1	82	1915	++	242	O95831-1#51	0	3	ENST00000675857.1	784	787	+	3	0	-2	1165
O95831-1#51	0	1	1	O95831-1	236	237	+	1	O95831-1	0	613	ENST00000675427.1	89	1925	++	240	O95831-1#51	0	3	ENST00000675427.1	797	800	+	3	0	-2	1166
O95831-1#51	0	1	1	O95831-1	236	237	+	1	O95831-1	0	524	ENST00000675240.1	169	1741	++	239	O95831-1#51	0	3	ENST00000675240.1	877	880	+	3	0	-2	1167
O95831-1#51	0	1	1	O95831-1	236	237	+	1	O95831-1	0	613	ENST00000675092.1	90	1956	++	238	O95831-1#51	0	3	ENST00000675092.1	798	801	+	3	0	-2	1168
O95831-1#51	0	1	1	O95831-1	236	237	+	1	O95831-1	0	613	ENST00000675050.1	71	1898	++	237	O95831-1#51	0	3	ENST00000675050.1	767	770	+	3	0	-2	1169
O95831-1#51	0	1	1	O95831-1	236	237	+	1	O95831-1	0	459	ENST00000675037.1	56	1433	++	236	O95831-1#51	0	3	ENST00000675037.1	764	767	+	3	0	-2	1170
O95831-1#51	0	1	1	O95831-1	236	237	+	1	O95831-1	100	388	ENST00000674957.1	1	865	++	234	O95831-1#51	0	3	ENST00000674957.1	409	412	+	3	0	-2	1171
O95831-1#51	0	1	1	O95831-1	236	237	+	1	O95831-1	0	238	ENST00000674722.1	13	727	++	233	O95831-1#51	0	3	ENST00000674722.1	721	724	+	3	0	-2	1172
O95831-1#51	0	1	1	O95831-1	236	237	+	1	O95831-1	0	587	ENST00000674546.1	185	1954	++	230	O95831-1#51	0	3	ENST00000674546.1	893	896	+	3	0	-2	1173
O95831-1#51	0	1	1	O95831-1	236	237	+	1	O95831-1	0	322	ENST00000535724.6	8	974	++	150	O95831-1#51	0	3	ENST00000535724.6	716	719	+	3	0	-2	1174
O95831-1#51	0	1	1	O95831-1	236	237	+	1	O95831-1	0	435	ENST00000416073.7	37	1336	++	76	O95831-1#51	0	3	ENST00000416073.7	739	742	+	3	0	-2	1175
O95831-1#51	0	1	1	O95831-1	236	237	+	1	O95831-1	0	613	ENST00000319908.8	174	2007	++	26	O95831-1#51	0	3	ENST00000319908.8	882	885	+	3	0	-2	1176
O95831-1#51	0	1	1	O95831-1	236	237	+	1	O95831-1	0	613	ENST00000287295.8	185	2024	++	18	O95831-1#51	0	3	ENST00000287295.8	893	896	+	3	0	-2	1177
O95831-1#52	0	1	1	O95831-1	242	243	+	1	O95831-1	0	613	ENST00000676436.1	34	1861	++	246	O95831-1#52	0	3	ENST00000676436.1	754	757	+	3	0	-2	1178
O95831-1#52	0	1	1	O95831-1	242	243	+	1	O95831-1	0	613	ENST00000676328.1	56	1892	++	245	O95831-1#52	0	3	ENST00000676328.1	782	785	+	3	0	-2	1179
O95831-1#52	0	1	1	O95831-1	242	243	+	1	O95831-1	0	613	ENST00000676229.1	223	2050	++	244	O95831-1#52	0	3	ENST00000676229.1	937	940	+	3	0	-2	1180
O95831-1#52	0	1	1	O95831-1	242	243	+	1	O95831-1	0	613	ENST00000675857.1	82	1915	++	242	O95831-1#52	0	3	ENST00000675857.1	802	805	+	3	0	-2	1181
O95831-1#52	0	1	1	O95831-1	242	243	+	1	O95831-1	0	613	ENST00000675427.1	89	1925	++	240	O95831-1#52	0	3	ENST00000675427.1	815	818	+	3	0	-2	1182
O95831-1#52	0	1	1	O95831-1	242	243	+	1	O95831-1	0	524	ENST00000675240.1	169	1741	++	239	O95831-1#52	0	3	ENST00000675240.1	895	898	+	3	0	-2	1183
O95831-1#52	0	1	1	O95831-1	242	243	+	1	O95831-1	0	613	ENST00000675092.1	90	1956	++	238	O95831-1#52	0	3	ENST00000675092.1	816	819	+	3	0	-2	1184
O95831-1#52	0	1	1	O95831-1	242	243	+	1	O95831-1	0	613	ENST00000675050.1	71	1898	++	237	O95831-1#52	0	3	ENST00000675050.1	785	788	+	3	0	-2	1185
O95831-1#52	0	1	1	O95831-1	242	243	+	1	O95831-1	0	459	ENST00000675037.1	56	1433	++	236	O95831-1#52	0	3	ENST00000675037.1	782	785	+	3	0	-2	1186
O95831-1#52	0	1	1	O95831-1	242	243	+	1	O95831-1	100	388	ENST00000674957.1	1	865	++	234	O95831-1#52	0	3	ENST00000674957.1	427	430	+	3	0	-2	1187
O95831-1#52	0	1	1	O95831-1	242	243	+	1	O95831-1	0	587	ENST00000674546.1	185	1954	++	230	O95831-1#52	0	3	ENST00000674546.1	911	914	+	3	0	-2	1188
O95831-1#52	0	1	1	O95831-1	242	243	+	1	O95831-1	0	322	ENST00000535724.6	8	974	++	150	O95831-1#52	0	3	ENST00000535724.6	734	737	+	3	0	-2	1189
O95831-1#52	0	1	1	O95831-1	242	243	+	1	O95831-1	0	435	ENST00000416073.7	37	1336	++	76	O95831-1#52	0	3	ENST00000416073.7	757	760	+	3	0	-2	1190
O95831-1#52	0	1	1	O95831-1	242	243	+	1	O95831-1	0	613	ENST00000319908.8	174	2007	++	26	O95831-1#52	0	3	ENST00000319908.8	900	903	+	3	0	-2	1191
O95831-1#52	0	1	1	O95831-1	242	243	+	1	O95831-1	0	613	ENST00000287295.8	185	2024	++	18	O95831-1#52	0	3	ENST00000287295.8	911	914	+	3	0	-2	1192
O95831-1#53	0	1	1	O95831-1	259	260	+	1	O95831-1	0	613	ENST00000676436.1	34	1861	++	246	O95831-1#53	0	3	ENST00000676436.1	805	808	+	3	0	-2	1193
O95831-1#53	0	1	1	O95831-1	259	260	+	1	O95831-1	0	613	ENST00000676328.1	56	1892	++	245	O95831-1#53	0	3	ENST00000676328.1	833	836	+	3	0	-2	1194
O95831-1#53	0	1	1	O95831-1	259	260	+	1	O95831-1	0	613	ENST00000676229.1	223	2050	++	244	O95831-1#53	0	3	ENST00000676229.1	988	991	+	3	0	-2	1195
O95831-1#53	0	1	1	O95831-1	259	260	+	1	O95831-1	0	613	ENST00000675857.1	82	1915	++	242	O95831-1#53	0	3	ENST00000675857.1	853	856	+	3	0	-2	1196
O95831-1#53	0	1	1	O95831-1	259	260	+	1	O95831-1	0	613	ENST00000675427.1	89	1925	++	240	O95831-1#53	0	3	ENST00000675427.1	866	869	+	3	0	-2	1197
O95831-1#53	0	1	1	O95831-1	259	260	+	1	O95831-1	0	524	ENST00000675240.1	169	1741	++	239	O95831-1#53	0	3	ENST00000675240.1	946	949	+	3	0	-2	1198
O95831-1#53	0	1	1	O95831-1	259	260	+	1	O95831-1	0	613	ENST00000675092.1	90	1956	++	238	O95831-1#53	0	3	ENST00000675092.1	867	870	+	3	0	-2	1199
O95831-1#53	0	1	1	O95831-1	259	260	+	1	O95831-1	0	613	ENST00000675050.1	71	1898	++	237	O95831-1#53	0	3	ENST00000675050.1	836	839	+	3	0	-2	1200
O95831-1#53	0	1	1	O95831-1	259	260	+	1	O95831-1	0	459	ENST00000675037.1	56	1433	++	236	O95831-1#53	0	3	ENST00000675037.1	833	836	+	3	0	-2	1201
O95831-1#53	0	1	1	O95831-1	259	260	+	1	O95831-1	100	388	ENST00000674957.1	1	865	++	234	O95831-1#53	0	3	ENST00000674957.1	478	481	+	3	0	-2	1202
O95831-1#53	0	1	1	O95831-1	259	260	+	1	O95831-1	0	587	ENST00000674546.1	185	1954	++	230	O95831-1#53	0	3	ENST00000674546.1	962	965	+	3	0	-2	1203
O95831-1#53	0	1	1	O95831-1	259	260	+	1	O95831-1	0	322	ENST00000535724.6	8	974	++	150	O95831-1#53	0	3	ENST00000535724.6	785	788	+	3	0	-2	1204
O95831-1#53	0	1	1	O95831-1	259	260	+	1	O95831-1	0	435	ENST00000416073.7	37	1336	++	76	O95831-1#53	0	3	ENST00000416073.7	808	811	+	3	0	-2	1205
O95831-1#53	0	1	1	O95831-1	259	260	+	1	O95831-1	0	613	ENST00000319908.8	174	2007	++	26	O95831-1#53	0	3	ENST00000319908.8	951	954	+	3	0	-2	1206
O95831-1#53	0	1	1	O95831-1	259	260	+	1	O95831-1	0	613	ENST00000287295.8	185	2024	++	18	O95831-1#53	0	3	ENST00000287295.8	962	965	+	3	0	-2	1207
O95831-1#54	0	1	1	O95831-1	261	262	+	1	O95831-1	0	613	ENST00000676436.1	34	1861	++	246	O95831-1#54	0	3	ENST00000676436.1	811	814	+	3	0	-2	1208
O95831-1#54	0	1	1	O95831-1	261	262	+	1	O95831-1	0	613	ENST00000676229.1	223	2050	++	244	O95831-1#54	0	3	ENST00000676229.1	994	997	+	3	0	-2	1209
O95831-1#54	0	1	1	O95831-1	261	262	+	1	O95831-1	0	613	ENST00000675857.1	82	1915	++	242	O95831-1#54	0	3	ENST00000675857.1	859	862	+	3	0	-2	1210
O95831-1#54	0	1	1	O95831-1	261	262	+	1	O95831-1	0	613	ENST00000675427.1	89	1925	++	240	O95831-1#54	0	3	ENST00000675427.1	872	875	+	3	0	-2	1211
O95831-1#54	0	1	1	O95831-1	261	262	+	1	O95831-1	0	524	ENST00000675240.1	169	1741	++	239	O95831-1#54	0	3	ENST00000675240.1	952	955	+	3	0	-2	1212
O95831-1#54	0	1	1	O95831-1	261	262	+	1	O95831-1	0	613	ENST00000675092.1	90	1956	++	238	O95831-1#54	0	3	ENST00000675092.1	873	876	+	3	0	-2	1213
O95831-1#54	0	1	1	O95831-1	261	262	+	1	O95831-1	0	613	ENST00000675050.1	71	1898	++	237	O95831-1#54	0	3	ENST00000675050.1	842	845	+	3	0	-2	1214
O95831-1#54	0	1	1	O95831-1	261	262	+	1	O95831-1	0	459	ENST00000675037.1	56	1433	++	236	O95831-1#54	0	3	ENST00000675037.1	839	842	+	3	0	-2	1215
O95831-1#54	0	1	1	O95831-1	261	262	+	1	O95831-1	100	388	ENST00000674957.1	1	865	++	234	O95831-1#54	0	3	ENST00000674957.1	484	487	+	3	0	-2	1216
O95831-1#54	0	1	1	O95831-1	261	262	+	1	O95831-1	0	587	ENST00000674546.1	185	1954	++	230	O95831-1#54	0	3	ENST00000674546.1	968	971	+	3	0	-2	1217
O95831-1#54	0	1	1	O95831-1	261	262	+	1	O95831-1	0	322	ENST00000535724.6	8	974	++	150	O95831-1#54	0	3	ENST00000535724.6	791	794	+	3	0	-2	1218
O95831-1#54	0	1	1	O95831-1	261	262	+	1	O95831-1	0	435	ENST00000416073.7	37	1336	++	76	O95831-1#54	0	3	ENST00000416073.7	814	817	+	3	0	-2	1219
O95831-1#54	0	1	1	O95831-1	261	262	+	1	O95831-1	0	613	ENST00000319908.8	174	2007	++	26	O95831-1#54	0	3	ENST00000319908.8	954	957	+	3	0	-2	1220
O95831-1#54	0	1	1	O95831-1	261	262	+	1	O95831-1	0	613	ENST00000287295.8	185	2024	++	18	O95831-1#54	0	3	ENST00000287295.8	968	971	+	3	0	-2	1221
O95831-1#55	0	1	1	O95831-1	307	308	+	1	O95831-1	0	613	ENST00000676436.1	34	1861	++	246	O95831-1#55	0	3	ENST00000676436.1	949	952	+	3	0	-2	1222
O95831-1#55	0	1	1	O95831-1	307	308	+	1	O95831-1	0	613	ENST00000676328.1	56	1892	++	245	O95831-1#55	0	3	ENST00000676328.1	974	977	+	3	0	-2	1223
O95831-1#55	0	1	1	O95831-1	307	308	+	1	O95831-1	0	613	ENST00000676229.1	223	2050	++	244	O95831-1#55	0	3	ENST00000676229.1	1132	1135	+	3	0	-2	1224
O95831-1#55	0	1	1	O95831-1	307	308	+	1	O95831-1	0	613	ENST00000675857.1	82	1915	++	242	O95831-1#55	0	3	ENST00000675857.1	997	1000	+	3	0	-2	1225
O95831-1#55	0	1	1	O95831-1	307	308	+	1	O95831-1	0	613	ENST00000675427.1	89	1925	++	240	O95831-1#55	0	3	ENST00000675427.1	1010	1013	+	3	0	-2	1226
O95831-1#55	0	1	1	O95831-1	307	308	+	1	O95831-1	0	524	ENST00000675240.1	169	1741	++	239	O95831-1#55	0	3	ENST00000675240.1	1090	1093	+	3	0	-2	1227
O95831-1#55	0	1	1	O95831-1	307	308	+	1	O95831-1	0	613	ENST00000675092.1	90	1956	++	238	O95831-1#55	0	3	ENST00000675092.1	1011	1014	+	3	0	-2	1228
O95831-1#55	0	1	1	O95831-1	307	308	+	1	O95831-1	0	613	ENST00000675050.1	71	1898	++	237	O95831-1#55	0	3	ENST00000675050.1	980	983	+	3	0	-2	1229
O95831-1#55	0	1	1	O95831-1	307	308	+	1	O95831-1	0	459	ENST00000675037.1	56	1433	++	236	O95831-1#55	0	3	ENST00000675037.1	977	980	+	3	0	-2	1230
O95831-1#55	0	1	1	O95831-1	307	308	+	1	O95831-1	100	388	ENST00000674957.1	1	865	++	234	O95831-1#55	0	3	ENST00000674957.1	622	625	+	3	0	-2	1231
O95831-1#55	0	1	1	O95831-1	307	308	+	1	O95831-1	0	587	ENST00000674546.1	185	1954	++	230	O95831-1#55	0	3	ENST00000674546.1	1106	1109	+	3	0	-2	1232
O95831-1#55	0	1	1	O95831-1	307	308	+	1	O95831-1	0	322	ENST00000535724.6	8	974	++	150	O95831-1#55	0	3	ENST00000535724.6	929	932	+	3	0	-2	1233
O95831-1#55	0	1	1	O95831-1	307	308	+	1	O95831-1	0	435	ENST00000416073.7	37	1336	++	76	O95831-1#55	0	3	ENST00000416073.7	952	955	+	3	0	-2	1234
O95831-1#55	0	1	1	O95831-1	307	308	+	1	O95831-1	0	613	ENST00000319908.8	174	2007	++	26	O95831-1#55	0	3	ENST00000319908.8	1092	1095	+	3	0	-2	1235
O95831-1#55	0	1	1	O95831-1	307	308	+	1	O95831-1	0	613	ENST00000287295.8	185	2024	++	18	O95831-1#55	0	3	ENST00000287295.8	1106	1109	+	3	0	-2	1236
O95831-1#56	0	1	1	O95831-1	337	338	+	1	O95831-1	0	613	ENST00000676436.1	34	1861	++	246	O95831-1#56	0	3	ENST00000676436.1	1033	1036	+	3	0	-2	1237
O95831-1#56	0	1	1	O95831-1	337	338	+	1	O95831-1	0	613	ENST00000676328.1	56	1892	++	245	O95831-1#56	0	3	ENST00000676328.1	1064	1067	+	3	0	-2	1238
O95831-1#56	0	1	1	O95831-1	337	338	+	1	O95831-1	0	613	ENST00000676229.1	223	2050	++	244	O95831-1#56	0	3	ENST00000676229.1	1222	1225	+	3	0	-2	1239
O95831-1#56	0	1	1	O95831-1	337	338	+	1	O95831-1	0	613	ENST00000675857.1	82	1915	++	242	O95831-1#56	0	3	ENST00000675857.1	1087	1090	+	3	0	-2	1240
O95831-1#56	0	1	1	O95831-1	337	338	+	1	O95831-1	0	613	ENST00000675427.1	89	1925	++	240	O95831-1#56	0	3	ENST00000675427.1	1100	1103	+	3	0	-2	1241
O95831-1#56	0	1	1	O95831-1	337	338	+	1	O95831-1	0	524	ENST00000675240.1	169	1741	++	239	O95831-1#56	0	3	ENST00000675240.1	1180	1183	+	3	0	-2	1242
O95831-1#56	0	1	1	O95831-1	337	338	+	1	O95831-1	0	613	ENST00000675092.1	90	1956	++	238	O95831-1#56	0	3	ENST00000675092.1	1101	1104	+	3	0	-2	1243
O95831-1#56	0	1	1	O95831-1	337	338	+	1	O95831-1	0	613	ENST00000675050.1	71	1898	++	237	O95831-1#56	0	3	ENST00000675050.1	1070	1073	+	3	0	-2	1244
O95831-1#56	0	1	1	O95831-1	337	338	+	1	O95831-1	0	459	ENST00000675037.1	56	1433	++	236	O95831-1#56	0	3	ENST00000675037.1	1067	1070	+	3	0	-2	1245
O95831-1#56	0	1	1	O95831-1	337	338	+	1	O95831-1	100	388	ENST00000674957.1	1	865	++	234	O95831-1#56	0	3	ENST00000674957.1	712	715	+	3	0	-2	1246
O95831-1#56	0	1	1	O95831-1	337	338	+	1	O95831-1	0	587	ENST00000674546.1	185	1954	++	230	O95831-1#56	0	3	ENST00000674546.1	1196	1199	+	3	0	-2	1247
O95831-1#56	0	1	1	O95831-1	337	338	+	1	O95831-1	0	435	ENST00000416073.7	37	1336	++	76	O95831-1#56	0	3	ENST00000416073.7	1042	1045	+	3	0	-2	1248
O95831-1#56	0	1	1	O95831-1	337	338	+	1	O95831-1	0	613	ENST00000346424.6	24	1002	++	35	O95831-1#56	0	3	ENST00000346424.6	174	177	+	3	0	-2	1249
O95831-1#56	0	1	1	O95831-1	337	338	+	1	O95831-1	0	613	ENST00000319908.8	174	2007	++	26	O95831-1#56	0	3	ENST00000319908.8	1182	1185	+	3	0	-2	1250
O95831-1#56	0	1	1	O95831-1	337	338	+	1	O95831-1	0	613	ENST00000287295.8	185	2024	++	18	O95831-1#56	0	3	ENST00000287295.8	1196	1199	+	3	0	-2	1251
O95831-1#57	0	1	1	O95831-1	343	344	+	1	O95831-1	0	613	ENST00000676436.1	34	1861	++	246	O95831-1#57	0	3	ENST00000676436.1	1051	1054	+	3	0	-2	1252
O95831-1#57	0	1	1	O95831-1	343	344	+	1	O95831-1	0	613	ENST00000676328.1	56	1892	++	245	O95831-1#57	0	3	ENST00000676328.1	1082	1085	+	3	0	-2	1253
O95831-1#57	0	1	1	O95831-1	343	344	+	1	O95831-1	0	613	ENST00000676229.1	223	2050	++	244	O95831-1#57	0	3	ENST00000676229.1	1240	1243	+	3	0	-2	1254
O95831-1#57	0	1	1	O95831-1	343	344	+	1	O95831-1	0	613	ENST00000675857.1	82	1915	++	242	O95831-1#57	0	3	ENST00000675857.1	1105	1108	+	3	0	-2	1255
O95831-1#57	0	1	1	O95831-1	343	344	+	1	O95831-1	0	613	ENST00000675427.1	89	1925	++	240	O95831-1#57	0	3	ENST00000675427.1	1118	1121	+	3	0	-2	1256
O95831-1#57	0	1	1	O95831-1	343	344	+	1	O95831-1	0	524	ENST00000675240.1	169	1741	++	239	O95831-1#57	0	3	ENST00000675240.1	1198	1201	+	3	0	-2	1257
O95831-1#57	0	1	1	O95831-1	343	344	+	1	O95831-1	0	613	ENST00000675092.1	90	1956	++	238	O95831-1#57	0	3	ENST00000675092.1	1119	1122	+	3	0	-2	1258
O95831-1#57	0	1	1	O95831-1	343	344	+	1	O95831-1	0	613	ENST00000675050.1	71	1898	++	237	O95831-1#57	0	3	ENST00000675050.1	1088	1091	+	3	0	-2	1259
O95831-1#57	0	1	1	O95831-1	343	344	+	1	O95831-1	0	459	ENST00000675037.1	56	1433	++	236	O95831-1#57	0	3	ENST00000675037.1	1085	1088	+	3	0	-2	1260
O95831-1#57	0	1	1	O95831-1	343	344	+	1	O95831-1	100	388	ENST00000674957.1	1	865	++	234	O95831-1#57	0	3	ENST00000674957.1	730	733	+	3	0	-2	1261
O95831-1#57	0	1	1	O95831-1	343	344	+	1	O95831-1	338	613	ENST00000674601.1	2	686	++	232	O95831-1#57	0	3	ENST00000674601.1	17	20	+	3	0	-2	1262
O95831-1#57	0	1	1	O95831-1	343	344	+	1	O95831-1	0	587	ENST00000674546.1	185	1954	++	230	O95831-1#57	0	3	ENST00000674546.1	1214	1217	+	3	0	-2	1263
O95831-1#57	0	1	1	O95831-1	343	344	+	1	O95831-1	339	613	ENST00000460436.6	905	1727	++	106	O95831-1#57	0	3	ENST00000460436.6	917	920	+	3	0	-2	1264
O95831-1#57	0	1	1	O95831-1	343	344	+	1	O95831-1	0	435	ENST00000416073.7	37	1336	++	76	O95831-1#57	0	3	ENST00000416073.7	1060	1063	+	3	0	-2	1265
O95831-1#57	0	1	1	O95831-1	343	344	+	1	O95831-1	0	613	ENST00000346424.6	24	1002	++	35	O95831-1#57	0	3	ENST00000346424.6	192	195	+	3	0	-2	1266
O95831-1#57	0	1	1	O95831-1	343	344	+	1	O95831-1	0	613	ENST00000319908.8	174	2007	++	26	O95831-1#57	0	3	ENST00000319908.8	1200	1203	+	3	0	-2	1267
O95831-1#57	0	1	1	O95831-1	343	344	+	1	O95831-1	0	613	ENST00000287295.8	185	2024	++	18	O95831-1#57	0	3	ENST00000287295.8	1214	1217	+	3	0	-2	1268
O95831-1#58	0	1	1	O95831-1	359	360	+	1	O95831-1	0	613	ENST00000676436.1	34	1861	++	246	O95831-1#58	0	3	ENST00000676436.1	1099	1102	+	3	0	-2	1269
O95831-1#58	0	1	1	O95831-1	359	360	+	1	O95831-1	0	613	ENST00000676328.1	56	1892	++	245	O95831-1#58	0	3	ENST00000676328.1	1130	1133	+	3	0	-2	1270
O95831-1#58	0	1	1	O95831-1	359	360	+	1	O95831-1	0	613	ENST00000676229.1	223	2050	++	244	O95831-1#58	0	3	ENST00000676229.1	1288	1291	+	3	0	-2	1271
O95831-1#58	0	1	1	O95831-1	359	360	+	1	O95831-1	0	613	ENST00000675857.1	82	1915	++	242	O95831-1#58	0	3	ENST00000675857.1	1153	1156	+	3	0	-2	1272
O95831-1#58	0	1	1	O95831-1	359	360	+	1	O95831-1	0	613	ENST00000675427.1	89	1925	++	240	O95831-1#58	0	3	ENST00000675427.1	1166	1169	+	3	0	-2	1273
O95831-1#58	0	1	1	O95831-1	359	360	+	1	O95831-1	0	524	ENST00000675240.1	169	1741	++	239	O95831-1#58	0	3	ENST00000675240.1	1246	1249	+	3	0	-2	1274
O95831-1#58	0	1	1	O95831-1	359	360	+	1	O95831-1	0	613	ENST00000675092.1	90	1956	++	238	O95831-1#58	0	3	ENST00000675092.1	1167	1170	+	3	0	-2	1275
O95831-1#58	0	1	1	O95831-1	359	360	+	1	O95831-1	0	613	ENST00000675050.1	71	1898	++	237	O95831-1#58	0	3	ENST00000675050.1	1136	1139	+	3	0	-2	1276
O95831-1#58	0	1	1	O95831-1	359	360	+	1	O95831-1	0	459	ENST00000675037.1	56	1433	++	236	O95831-1#58	0	3	ENST00000675037.1	1133	1136	+	3	0	-2	1277
O95831-1#58	0	1	1	O95831-1	359	360	+	1	O95831-1	100	388	ENST00000674957.1	1	865	++	234	O95831-1#58	0	3	ENST00000674957.1	778	781	+	3	0	-2	1278
O95831-1#58	0	1	1	O95831-1	359	360	+	1	O95831-1	338	613	ENST00000674601.1	2	686	++	232	O95831-1#58	0	3	ENST00000674601.1	65	68	+	3	0	-2	1279
O95831-1#58	0	1	1	O95831-1	359	360	+	1	O95831-1	0	587	ENST00000674546.1	185	1954	++	230	O95831-1#58	0	3	ENST00000674546.1	1262	1265	+	3	0	-2	1280
O95831-1#58	0	1	1	O95831-1	359	360	+	1	O95831-1	339	613	ENST00000460436.6	905	1727	++	106	O95831-1#58	0	3	ENST00000460436.6	965	968	+	3	0	-2	1281
O95831-1#58	0	1	1	O95831-1	359	360	+	1	O95831-1	0	435	ENST00000416073.7	37	1336	++	76	O95831-1#58	0	3	ENST00000416073.7	1108	1111	+	3	0	-2	1282
O95831-1#58	0	1	1	O95831-1	359	360	+	1	O95831-1	0	613	ENST00000346424.6	24	1002	++	35	O95831-1#58	0	3	ENST00000346424.6	240	243	+	3	0	-2	1283
O95831-1#58	0	1	1	O95831-1	359	360	+	1	O95831-1	0	613	ENST00000319908.8	174	2007	++	26	O95831-1#58	0	3	ENST00000319908.8	1248	1251	+	3	0	-2	1284
O95831-1#58	0	1	1	O95831-1	359	360	+	1	O95831-1	0	613	ENST00000287295.8	185	2024	++	18	O95831-1#58	0	3	ENST00000287295.8	1262	1265	+	3	0	-2	1285
O95831-1#59	0	1	1	O95831-1	421	422	+	1	O95831-1	0	613	ENST00000676436.1	34	1861	++	246	O95831-1#59	0	3	ENST00000676436.1	1285	1288	+	3	0	-2	1286
O95831-1#59	0	1	1	O95831-1	421	422	+	1	O95831-1	0	613	ENST00000676328.1	56	1892	++	245	O95831-1#59	0	3	ENST00000676328.1	1316	1319	+	3	0	-2	1287
O95831-1#59	0	1	1	O95831-1	421	422	+	1	O95831-1	0	613	ENST00000676229.1	223	2050	++	244	O95831-1#59	0	3	ENST00000676229.1	1474	1477	+	3	0	-2	1288
O95831-1#59	0	1	1	O95831-1	421	422	+	1	O95831-1	0	613	ENST00000675857.1	82	1915	++	242	O95831-1#59	0	3	ENST00000675857.1	1339	1342	+	3	0	-2	1289
O95831-1#59	0	1	1	O95831-1	421	422	+	1	O95831-1	0	613	ENST00000675427.1	89	1925	++	240	O95831-1#59	0	3	ENST00000675427.1	1352	1355	+	3	0	-2	1290
O95831-1#59	0	1	1	O95831-1	421	422	+	1	O95831-1	0	524	ENST00000675240.1	169	1741	++	239	O95831-1#59	0	3	ENST00000675240.1	1432	1435	+	3	0	-2	1291
O95831-1#59	0	1	1	O95831-1	421	422	+	1	O95831-1	0	613	ENST00000675092.1	90	1956	++	238	O95831-1#59	0	3	ENST00000675092.1	1353	1356	+	3	0	-2	1292
O95831-1#59	0	1	1	O95831-1	421	422	+	1	O95831-1	0	613	ENST00000675050.1	71	1898	++	237	O95831-1#59	0	3	ENST00000675050.1	1322	1325	+	3	0	-2	1293
O95831-1#59	0	1	1	O95831-1	421	422	+	1	O95831-1	0	459	ENST00000675037.1	56	1433	++	236	O95831-1#59	0	3	ENST00000675037.1	1319	1322	+	3	0	-2	1294
O95831-1#59	0	1	1	O95831-1	421	422	+	1	O95831-1	0	587	ENST00000674546.1	185	1954	++	230	O95831-1#59	0	3	ENST00000674546.1	1448	1451	+	3	0	-2	1295
O95831-1#59	0	1	1	O95831-1	421	422	+	1	O95831-1	339	613	ENST00000460436.6	905	1727	++	106	O95831-1#59	0	3	ENST00000460436.6	1151	1154	+	3	0	-2	1296
O95831-1#59	0	1	1	O95831-1	421	422	+	1	O95831-1	0	435	ENST00000416073.7	37	1336	++	76	O95831-1#59	0	3	ENST00000416073.7	1294	1297	+	3	0	-2	1297
O95831-1#59	0	1	1	O95831-1	421	422	+	1	O95831-1	0	613	ENST00000346424.6	24	1002	++	35	O95831-1#59	0	3	ENST00000346424.6	426	429	+	3	0	-2	1298
O95831-1#59	0	1	1	O95831-1	421	422	+	1	O95831-1	0	613	ENST00000319908.8	174	2007	++	26	O95831-1#59	0	3	ENST00000319908.8	1434	1437	+	3	0	-2	1299
O95831-1#59	0	1	1	O95831-1	421	422	+	1	O95831-1	0	613	ENST00000287295.8	185	2024	++	18	O95831-1#59	0	3	ENST00000287295.8	1448	1451	+	3	0	-2	1300
O95831-1#60	0	1	1	O95831-1	421	422	+	1	O95831-1	0	613	ENST00000676436.1	34	1861	++	246	O95831-1#60	0	3	ENST00000676436.1	1285	1288	+	3	0	-2	1301
O95831-1#60	0	1	1	O95831-1	421	422	+	1	O95831-1	0	613	ENST00000676328.1	56	1892	++	245	O95831-1#60	0	3	ENST00000676328.1	1316	1319	+	3	0	-2	1302
O95831-1#60	0	1	1	O95831-1	421	422	+	1	O95831-1	0	613	ENST00000676229.1	223	2050	++	244	O95831-1#60	0	3	ENST00000676229.1	1474	1477	+	3	0	-2	1303
O95831-1#60	0	1	1	O95831-1	421	422	+	1	O95831-1	0	613	ENST00000675857.1	82	1915	++	242	O95831-1#60	0	3	ENST00000675857.1	1339	1342	+	3	0	-2	1304
O95831-1#60	0	1	1	O95831-1	421	422	+	1	O95831-1	0	613	ENST00000675427.1	89	1925	++	240	O95831-1#60	0	3	ENST00000675427.1	1352	1355	+	3	0	-2	1305
O95831-1#60	0	1	1	O95831-1	421	422	+	1	O95831-1	0	524	ENST00000675240.1	169	1741	++	239	O95831-1#60	0	3	ENST00000675240.1	1432	1435	+	3	0	-2	1306
O95831-1#60	0	1	1	O95831-1	421	422	+	1	O95831-1	0	613	ENST00000675092.1	90	1956	++	238	O95831-1#60	0	3	ENST00000675092.1	1353	1356	+	3	0	-2	1307
O95831-1#60	0	1	1	O95831-1	421	422	+	1	O95831-1	0	613	ENST00000675050.1	71	1898	++	237	O95831-1#60	0	3	ENST00000675050.1	1322	1325	+	3	0	-2	1308
O95831-1#60	0	1	1	O95831-1	421	422	+	1	O95831-1	0	459	ENST00000675037.1	56	1433	++	236	O95831-1#60	0	3	ENST00000675037.1	1319	1322	+	3	0	-2	1309
O95831-1#60	0	1	1	O95831-1	421	422	+	1	O95831-1	0	587	ENST00000674546.1	185	1954	++	230	O95831-1#60	0	3	ENST00000674546.1	1448	1451	+	3	0	-2	1310
O95831-1#60	0	1	1	O95831-1	421	422	+	1	O95831-1	339	613	ENST00000460436.6	905	1727	++	106	O95831-1#60	0	3	ENST00000460436.6	1151	1154	+	3	0	-2	1311
O95831-1#60	0	1	1	O95831-1	421	422	+	1	O95831-1	0	435	ENST00000416073.7	37	1336	++	76	O95831-1#60	0	3	ENST00000416073.7	1294	1297	+	3	0	-2	1312
O95831-1#60	0	1	1	O95831-1	421	422	+	1	O95831-1	0	613	ENST00000346424.6	24	1002	++	35	O95831-1#60	0	3	ENST00000346424.6	426	429	+	3	0	-2	1313
O95831-1#60	0	1	1	O95831-1	421	422	+	1	O95831-1	0	613	ENST00000319908.8	174	2007	++	26	O95831-1#60	0	3	ENST00000319908.8	1434	1437	+	3	0	-2	1314
O95831-1#60	0	1	1	O95831-1	421	422	+	1	O95831-1	0	613	ENST00000287295.8	185	2024	++	18	O95831-1#60	0	3	ENST00000287295.8	1448	1451	+	3	0	-2	1315
O95831-1#61	0	1	1	O95831-1	429	430	+	1	O95831-1	0	613	ENST00000676436.1	34	1861	++	246	O95831-1#61	0	3	ENST00000676436.1	1309	1312	+	3	0	-2	1316
O95831-1#61	0	1	1	O95831-1	429	430	+	1	O95831-1	0	613	ENST00000676328.1	56	1892	++	245	O95831-1#61	0	3	ENST00000676328.1	1340	1343	+	3	0	-2	1317
O95831-1#61	0	1	1	O95831-1	429	430	+	1	O95831-1	0	613	ENST00000676229.1	223	2050	++	244	O95831-1#61	0	3	ENST00000676229.1	1498	1501	+	3	0	-2	1318
O95831-1#61	0	1	1	O95831-1	429	430	+	1	O95831-1	0	613	ENST00000675857.1	82	1915	++	242	O95831-1#61	0	3	ENST00000675857.1	1363	1366	+	3	0	-2	1319
O95831-1#61	0	1	1	O95831-1	429	430	+	1	O95831-1	0	613	ENST00000675427.1	89	1925	++	240	O95831-1#61	0	3	ENST00000675427.1	1376	1379	+	3	0	-2	1320
O95831-1#61	0	1	1	O95831-1	429	430	+	1	O95831-1	0	524	ENST00000675240.1	169	1741	++	239	O95831-1#61	0	3	ENST00000675240.1	1456	1459	+	3	0	-2	1321
O95831-1#61	0	1	1	O95831-1	429	430	+	1	O95831-1	0	613	ENST00000675092.1	90	1956	++	238	O95831-1#61	0	3	ENST00000675092.1	1377	1380	+	3	0	-2	1322
O95831-1#61	0	1	1	O95831-1	429	430	+	1	O95831-1	0	613	ENST00000675050.1	71	1898	++	237	O95831-1#61	0	3	ENST00000675050.1	1346	1349	+	3	0	-2	1323
O95831-1#61	0	1	1	O95831-1	429	430	+	1	O95831-1	0	459	ENST00000675037.1	56	1433	++	236	O95831-1#61	0	3	ENST00000675037.1	1343	1346	+	3	0	-2	1324
O95831-1#61	0	1	1	O95831-1	429	430	+	1	O95831-1	0	587	ENST00000674546.1	185	1954	++	230	O95831-1#61	0	3	ENST00000674546.1	1472	1475	+	3	0	-2	1325
O95831-1#61	0	1	1	O95831-1	429	430	+	1	O95831-1	339	613	ENST00000460436.6	905	1727	++	106	O95831-1#61	0	3	ENST00000460436.6	1175	1178	+	3	0	-2	1326
O95831-1#61	0	1	1	O95831-1	429	430	+	1	O95831-1	0	435	ENST00000416073.7	37	1336	++	76	O95831-1#61	0	3	ENST00000416073.7	1318	1321	+	3	0	-2	1327
O95831-1#61	0	1	1	O95831-1	429	430	+	1	O95831-1	0	613	ENST00000346424.6	24	1002	++	35	O95831-1#61	0	3	ENST00000346424.6	450	453	+	3	0	-2	1328
O95831-1#61	0	1	1	O95831-1	429	430	+	1	O95831-1	0	613	ENST00000319908.8	174	2007	++	26	O95831-1#61	0	3	ENST00000319908.8	1458	1461	+	3	0	-2	1329
O95831-1#61	0	1	1	O95831-1	429	430	+	1	O95831-1	0	613	ENST00000287295.8	185	2024	++	18	O95831-1#61	0	3	ENST00000287295.8	1472	1475	+	3	0	-2	1330
O95831-1#62	0	1	1	O95831-1	450	451	+	1	O95831-1	0	613	ENST00000676436.1	34	1861	++	246	O95831-1#62	0	3	ENST00000676436.1	1372	1375	+	3	0	-2	1331
O95831-1#62	0	1	1	O95831-1	450	451	+	1	O95831-1	0	613	ENST00000676328.1	56	1892	++	245	O95831-1#62	0	3	ENST00000676328.1	1403	1406	+	3	0	-2	1332
O95831-1#62	0	1	1	O95831-1	450	451	+	1	O95831-1	0	613	ENST00000676229.1	223	2050	++	244	O95831-1#62	0	3	ENST00000676229.1	1561	1564	+	3	0	-2	1333
O95831-1#62	0	1	1	O95831-1	450	451	+	1	O95831-1	0	613	ENST00000675857.1	82	1915	++	242	O95831-1#62	0	3	ENST00000675857.1	1426	1429	+	3	0	-2	1334
O95831-1#62	0	1	1	O95831-1	450	451	+	1	O95831-1	0	613	ENST00000675427.1	89	1925	++	240	O95831-1#62	0	3	ENST00000675427.1	1436	1439	+	3	0	-2	1335
O95831-1#62	0	1	1	O95831-1	450	451	+	1	O95831-1	0	524	ENST00000675240.1	169	1741	++	239	O95831-1#62	0	3	ENST00000675240.1	1519	1522	+	3	0	-2	1336
O95831-1#62	0	1	1	O95831-1	450	451	+	1	O95831-1	0	613	ENST00000675092.1	90	1956	++	238	O95831-1#62	0	3	ENST00000675092.1	1440	1443	+	3	0	-2	1337
O95831-1#62	0	1	1	O95831-1	450	451	+	1	O95831-1	0	613	ENST00000675050.1	71	1898	++	237	O95831-1#62	0	3	ENST00000675050.1	1409	1412	+	3	0	-2	1338
O95831-1#62	0	1	1	O95831-1	450	451	+	1	O95831-1	0	459	ENST00000675037.1	56	1433	++	236	O95831-1#62	0	3	ENST00000675037.1	1406	1409	+	3	0	-2	1339
O95831-1#62	0	1	1	O95831-1	450	451	+	1	O95831-1	338	613	ENST00000674601.1	2	686	++	232	O95831-1#62	0	3	ENST00000674601.1	197	200	+	3	0	-2	1340
O95831-1#62	0	1	1	O95831-1	450	451	+	1	O95831-1	0	587	ENST00000674546.1	185	1954	++	230	O95831-1#62	0	3	ENST00000674546.1	1535	1538	+	3	0	-2	1341
O95831-1#62	0	1	1	O95831-1	450	451	+	1	O95831-1	339	613	ENST00000460436.6	905	1727	++	106	O95831-1#62	0	3	ENST00000460436.6	1238	1241	+	3	0	-2	1342
O95831-1#62	0	1	1	O95831-1	450	451	+	1	O95831-1	0	613	ENST00000346424.6	24	1002	++	35	O95831-1#62	0	3	ENST00000346424.6	513	516	+	3	0	-2	1343
O95831-1#62	0	1	1	O95831-1	450	451	+	1	O95831-1	0	613	ENST00000319908.8	174	2007	++	26	O95831-1#62	0	3	ENST00000319908.8	1521	1524	+	3	0	-2	1344
O95831-1#62	0	1	1	O95831-1	450	451	+	1	O95831-1	0	613	ENST00000287295.8	185	2024	++	18	O95831-1#62	0	3	ENST00000287295.8	1535	1538	+	3	0	-2	1345
O95831-1#63	0	1	1	O95831-1	471	472	+	1	O95831-1	0	613	ENST00000676436.1	34	1861	++	246	O95831-1#63	0	3	ENST00000676436.1	1435	1438	+	3	0	-2	1346
O95831-1#63	0	1	1	O95831-1	471	472	+	1	O95831-1	0	613	ENST00000676328.1	56	1892	++	245	O95831-1#63	0	3	ENST00000676328.1	1466	1469	+	3	0	-2	1347
O95831-1#63	0	1	1	O95831-1	471	472	+	1	O95831-1	0	613	ENST00000676229.1	223	2050	++	244	O95831-1#63	0	3	ENST00000676229.1	1624	1627	+	3	0	-2	1348
O95831-1#63	0	1	1	O95831-1	471	472	+	1	O95831-1	0	613	ENST00000675857.1	82	1915	++	242	O95831-1#63	0	3	ENST00000675857.1	1489	1492	+	3	0	-2	1349
O95831-1#63	0	1	1	O95831-1	471	472	+	1	O95831-1	0	613	ENST00000675427.1	89	1925	++	240	O95831-1#63	0	3	ENST00000675427.1	1499	1502	+	3	0	-2	1350
O95831-1#63	0	1	1	O95831-1	471	472	+	1	O95831-1	0	524	ENST00000675240.1	169	1741	++	239	O95831-1#63	0	3	ENST00000675240.1	1582	1585	+	3	0	-2	1351
O95831-1#63	0	1	1	O95831-1	471	472	+	1	O95831-1	0	613	ENST00000675092.1	90	1956	++	238	O95831-1#63	0	3	ENST00000675092.1	1503	1506	+	3	0	-2	1352
O95831-1#63	0	1	1	O95831-1	471	472	+	1	O95831-1	0	613	ENST00000675050.1	71	1898	++	237	O95831-1#63	0	3	ENST00000675050.1	1472	1475	+	3	0	-2	1353
O95831-1#63	0	1	1	O95831-1	471	472	+	1	O95831-1	338	613	ENST00000674601.1	2	686	++	232	O95831-1#63	0	3	ENST00000674601.1	260	263	+	3	0	-2	1354
O95831-1#63	0	1	1	O95831-1	471	472	+	1	O95831-1	0	587	ENST00000674546.1	185	1954	++	230	O95831-1#63	0	3	ENST00000674546.1	1598	1601	+	3	0	-2	1355
O95831-1#63	0	1	1	O95831-1	471	472	+	1	O95831-1	339	613	ENST00000460436.6	905	1727	++	106	O95831-1#63	0	3	ENST00000460436.6	1301	1304	+	3	0	-2	1356
O95831-1#63	0	1	1	O95831-1	471	472	+	1	O95831-1	0	613	ENST00000346424.6	24	1002	++	35	O95831-1#63	0	3	ENST00000346424.6	576	579	+	3	0	-2	1357
O95831-1#63	0	1	1	O95831-1	471	472	+	1	O95831-1	0	613	ENST00000319908.8	174	2007	++	26	O95831-1#63	0	3	ENST00000319908.8	1584	1587	+	3	0	-2	1358
O95831-1#63	0	1	1	O95831-1	471	472	+	1	O95831-1	0	613	ENST00000287295.8	185	2024	++	18	O95831-1#63	0	3	ENST00000287295.8	1598	1601	+	3	0	-2	1359
O95831-1#64	0	1	1	O95831-1	474	475	+	1	O95831-1	0	613	ENST00000676436.1	34	1861	++	246	O95831-1#64	0	3	ENST00000676436.1	1444	1447	+	3	0	-2	1360
O95831-1#64	0	1	1	O95831-1	474	475	+	1	O95831-1	0	613	ENST00000676328.1	56	1892	++	245	O95831-1#64	0	3	ENST00000676328.1	1475	1478	+	3	0	-2	1361
O95831-1#64	0	1	1	O95831-1	474	475	+	1	O95831-1	0	613	ENST00000676229.1	223	2050	++	244	O95831-1#64	0	3	ENST00000676229.1	1633	1636	+	3	0	-2	1362
O95831-1#64	0	1	1	O95831-1	474	475	+	1	O95831-1	0	613	ENST00000675857.1	82	1915	++	242	O95831-1#64	0	3	ENST00000675857.1	1498	1501	+	3	0	-2	1363
O95831-1#64	0	1	1	O95831-1	474	475	+	1	O95831-1	0	613	ENST00000675427.1	89	1925	++	240	O95831-1#64	0	3	ENST00000675427.1	1508	1511	+	3	0	-2	1364
O95831-1#64	0	1	1	O95831-1	474	475	+	1	O95831-1	0	524	ENST00000675240.1	169	1741	++	239	O95831-1#64	0	3	ENST00000675240.1	1591	1594	+	3	0	-2	1365
O95831-1#64	0	1	1	O95831-1	474	475	+	1	O95831-1	0	613	ENST00000675092.1	90	1956	++	238	O95831-1#64	0	3	ENST00000675092.1	1512	1515	+	3	0	-2	1366
O95831-1#64	0	1	1	O95831-1	474	475	+	1	O95831-1	0	613	ENST00000675050.1	71	1898	++	237	O95831-1#64	0	3	ENST00000675050.1	1481	1484	+	3	0	-2	1367
O95831-1#64	0	1	1	O95831-1	474	475	+	1	O95831-1	338	613	ENST00000674601.1	2	686	++	232	O95831-1#64	0	3	ENST00000674601.1	269	272	+	3	0	-2	1368
O95831-1#64	0	1	1	O95831-1	474	475	+	1	O95831-1	0	587	ENST00000674546.1	185	1954	++	230	O95831-1#64	0	3	ENST00000674546.1	1607	1610	+	3	0	-2	1369
O95831-1#64	0	1	1	O95831-1	474	475	+	1	O95831-1	339	613	ENST00000460436.6	905	1727	++	106	O95831-1#64	0	3	ENST00000460436.6	1310	1313	+	3	0	-2	1370
O95831-1#64	0	1	1	O95831-1	474	475	+	1	O95831-1	0	613	ENST00000346424.6	24	1002	++	35	O95831-1#64	0	3	ENST00000346424.6	585	588	+	3	0	-2	1371
O95831-1#64	0	1	1	O95831-1	474	475	+	1	O95831-1	0	613	ENST00000319908.8	174	2007	++	26	O95831-1#64	0	3	ENST00000319908.8	1593	1596	+	3	0	-2	1372
O95831-1#64	0	1	1	O95831-1	474	475	+	1	O95831-1	0	613	ENST00000287295.8	185	2024	++	18	O95831-1#64	0	3	ENST00000287295.8	1607	1610	+	3	0	-2	1373
O95831-1#65	0	1	1	O95831-1	492	493	+	1	O95831-1	0	613	ENST00000676436.1	34	1861	++	246	O95831-1#65	0	3	ENST00000676436.1	1498	1501	+	3	0	-2	1374
O95831-1#65	0	1	1	O95831-1	492	493	+	1	O95831-1	0	613	ENST00000676328.1	56	1892	++	245	O95831-1#65	0	3	ENST00000676328.1	1529	1532	+	3	0	-2	1375
O95831-1#65	0	1	1	O95831-1	492	493	+	1	O95831-1	0	613	ENST00000676229.1	223	2050	++	244	O95831-1#65	0	3	ENST00000676229.1	1687	1690	+	3	0	-2	1376
O95831-1#65	0	1	1	O95831-1	492	493	+	1	O95831-1	0	613	ENST00000675857.1	82	1915	++	242	O95831-1#65	0	3	ENST00000675857.1	1552	1555	+	3	0	-2	1377
O95831-1#65	0	1	1	O95831-1	492	493	+	1	O95831-1	0	613	ENST00000675427.1	89	1925	++	240	O95831-1#65	0	3	ENST00000675427.1	1562	1565	+	3	0	-2	1378
O95831-1#65	0	1	1	O95831-1	492	493	+	1	O95831-1	0	524	ENST00000675240.1	169	1741	++	239	O95831-1#65	0	3	ENST00000675240.1	1645	1648	+	3	0	-2	1379
O95831-1#65	0	1	1	O95831-1	492	493	+	1	O95831-1	0	613	ENST00000675092.1	90	1956	++	238	O95831-1#65	0	3	ENST00000675092.1	1566	1569	+	3	0	-2	1380
O95831-1#65	0	1	1	O95831-1	492	493	+	1	O95831-1	0	613	ENST00000675050.1	71	1898	++	237	O95831-1#65	0	3	ENST00000675050.1	1535	1538	+	3	0	-2	1381
O95831-1#65	0	1	1	O95831-1	492	493	+	1	O95831-1	338	613	ENST00000674601.1	2	686	++	232	O95831-1#65	0	3	ENST00000674601.1	323	326	+	3	0	-2	1382
O95831-1#65	0	1	1	O95831-1	492	493	+	1	O95831-1	0	587	ENST00000674546.1	185	1954	++	230	O95831-1#65	0	3	ENST00000674546.1	1661	1664	+	3	0	-2	1383
O95831-1#65	0	1	1	O95831-1	492	493	+	1	O95831-1	339	613	ENST00000460436.6	905	1727	++	106	O95831-1#65	0	3	ENST00000460436.6	1364	1367	+	3	0	-2	1384
O95831-1#65	0	1	1	O95831-1	492	493	+	1	O95831-1	0	613	ENST00000346424.6	24	1002	++	35	O95831-1#65	0	3	ENST00000346424.6	639	642	+	3	0	-2	1385
O95831-1#65	0	1	1	O95831-1	492	493	+	1	O95831-1	0	613	ENST00000319908.8	174	2007	++	26	O95831-1#65	0	3	ENST00000319908.8	1644	1647	+	3	0	-2	1386
O95831-1#65	0	1	1	O95831-1	492	493	+	1	O95831-1	0	613	ENST00000287295.8	185	2024	++	18	O95831-1#65	0	3	ENST00000287295.8	1661	1664	+	3	0	-2	1387
O95831-1#66	0	1	1	O95831-1	497	498	+	1	O95831-1	0	613	ENST00000676436.1	34	1861	++	246	O95831-1#66	0	3	ENST00000676436.1	1513	1516	+	3	0	-2	1388
O95831-1#66	0	1	1	O95831-1	497	498	+	1	O95831-1	0	613	ENST00000676328.1	56	1892	++	245	O95831-1#66	0	3	ENST00000676328.1	1544	1547	+	3	0	-2	1389
O95831-1#66	0	1	1	O95831-1	497	498	+	1	O95831-1	0	613	ENST00000676229.1	223	2050	++	244	O95831-1#66	0	3	ENST00000676229.1	1702	1705	+	3	0	-2	1390
O95831-1#66	0	1	1	O95831-1	497	498	+	1	O95831-1	0	613	ENST00000675857.1	82	1915	++	242	O95831-1#66	0	3	ENST00000675857.1	1567	1570	+	3	0	-2	1391
O95831-1#66	0	1	1	O95831-1	497	498	+	1	O95831-1	0	613	ENST00000675427.1	89	1925	++	240	O95831-1#66	0	3	ENST00000675427.1	1577	1580	+	3	0	-2	1392
O95831-1#66	0	1	1	O95831-1	497	498	+	1	O95831-1	0	524	ENST00000675240.1	169	1741	++	239	O95831-1#66	0	3	ENST00000675240.1	1660	1663	+	3	0	-2	1393
O95831-1#66	0	1	1	O95831-1	497	498	+	1	O95831-1	0	613	ENST00000675092.1	90	1956	++	238	O95831-1#66	0	3	ENST00000675092.1	1581	1584	+	3	0	-2	1394
O95831-1#66	0	1	1	O95831-1	497	498	+	1	O95831-1	0	613	ENST00000675050.1	71	1898	++	237	O95831-1#66	0	3	ENST00000675050.1	1550	1553	+	3	0	-2	1395
O95831-1#66	0	1	1	O95831-1	497	498	+	1	O95831-1	338	613	ENST00000674601.1	2	686	++	232	O95831-1#66	0	3	ENST00000674601.1	338	341	+	3	0	-2	1396
O95831-1#66	0	1	1	O95831-1	497	498	+	1	O95831-1	0	587	ENST00000674546.1	185	1954	++	230	O95831-1#66	0	3	ENST00000674546.1	1676	1679	+	3	0	-2	1397
O95831-1#66	0	1	1	O95831-1	497	498	+	1	O95831-1	339	613	ENST00000460436.6	905	1727	++	106	O95831-1#66	0	3	ENST00000460436.6	1379	1382	+	3	0	-2	1398
O95831-1#66	0	1	1	O95831-1	497	498	+	1	O95831-1	0	613	ENST00000346424.6	24	1002	++	35	O95831-1#66	0	3	ENST00000346424.6	654	657	+	3	0	-2	1399
O95831-1#66	0	1	1	O95831-1	497	498	+	1	O95831-1	0	613	ENST00000319908.8	174	2007	++	26	O95831-1#66	0	3	ENST00000319908.8	1659	1662	+	3	0	-2	1400
O95831-1#66	0	1	1	O95831-1	497	498	+	1	O95831-1	0	613	ENST00000287295.8	185	2024	++	18	O95831-1#66	0	3	ENST00000287295.8	1676	1679	+	3	0	-2	1401
O95831-1#67	0	1	1	O95831-1	590	591	+	1	O95831-1	0	613	ENST00000676436.1	34	1861	++	246	O95831-1#67	0	3	ENST00000676436.1	1792	1795	+	3	0	-2	1402
O95831-1#67	0	1	1	O95831-1	590	591	+	1	O95831-1	0	613	ENST00000676328.1	56	1892	++	245	O95831-1#67	0	3	ENST00000676328.1	1823	1826	+	3	0	-2	1403
O95831-1#67	0	1	1	O95831-1	590	591	+	1	O95831-1	0	613	ENST00000676229.1	223	2050	++	244	O95831-1#67	0	3	ENST00000676229.1	1981	1984	+	3	0	-2	1404
O95831-1#67	0	1	1	O95831-1	590	591	+	1	O95831-1	0	613	ENST00000675857.1	82	1915	++	242	O95831-1#67	0	3	ENST00000675857.1	1846	1849	+	3	0	-2	1405
O95831-1#67	0	1	1	O95831-1	590	591	+	1	O95831-1	0	613	ENST00000675427.1	89	1925	++	240	O95831-1#67	0	3	ENST00000675427.1	1856	1859	+	3	0	-2	1406
O95831-1#67	0	1	1	O95831-1	590	591	+	1	O95831-1	0	613	ENST00000675092.1	90	1956	++	238	O95831-1#67	0	3	ENST00000675092.1	1887	1890	+	3	0	-2	1407
O95831-1#67	0	1	1	O95831-1	590	591	+	1	O95831-1	0	613	ENST00000675050.1	71	1898	++	237	O95831-1#67	0	3	ENST00000675050.1	1829	1832	+	3	0	-2	1408
O95831-1#67	0	1	1	O95831-1	590	591	+	1	O95831-1	338	613	ENST00000674601.1	2	686	++	232	O95831-1#67	0	3	ENST00000674601.1	617	620	+	3	0	-2	1409
O95831-1#67	0	1	1	O95831-1	590	591	+	1	O95831-1	339	613	ENST00000460436.6	905	1727	++	106	O95831-1#67	0	3	ENST00000460436.6	1658	1661	+	3	0	-2	1410
O95831-1#67	0	1	1	O95831-1	590	591	+	1	O95831-1	0	613	ENST00000346424.6	24	1002	++	35	O95831-1#67	0	3	ENST00000346424.6	933	936	+	3	0	-2	1411
O95831-1#67	0	1	1	O95831-1	590	591	+	1	O95831-1	0	613	ENST00000319908.8	174	2007	++	26	O95831-1#67	0	3	ENST00000319908.8	1938	1941	+	3	0	-2	1412
O95831-1#67	0	1	1	O95831-1	590	591	+	1	O95831-1	0	613	ENST00000287295.8	185	2024	++	18	O95831-1#67	0	3	ENST00000287295.8	1955	1958	+	3	0	-2	1413
O95831-1#68	0	1	1	O95831-1	195	196	+	1	O95831-1	0	613	ENST00000676436.1	34	1861	++	246	O95831-1#68	0	3	ENST00000676436.1	613	616	+	3	0	-2	1414
O95831-1#68	0	1	1	O95831-1	195	196	+	1	O95831-1	0	613	ENST00000676328.1	56	1892	++	245	O95831-1#68	0	3	ENST00000676328.1	641	644	+	3	0	-2	1415
O95831-1#68	0	1	1	O95831-1	195	196	+	1	O95831-1	0	613	ENST00000676229.1	223	2050	++	244	O95831-1#68	0	3	ENST00000676229.1	796	799	+	3	0	-2	1416
O95831-1#68	0	1	1	O95831-1	195	196	+	1	O95831-1	0	613	ENST00000675857.1	82	1915	++	242	O95831-1#68	0	3	ENST00000675857.1	661	664	+	3	0	-2	1417
O95831-1#68	0	1	1	O95831-1	195	196	+	1	O95831-1	0	613	ENST00000675427.1	89	1925	++	240	O95831-1#68	0	3	ENST00000675427.1	674	677	+	3	0	-2	1418
O95831-1#68	0	1	1	O95831-1	195	196	+	1	O95831-1	0	524	ENST00000675240.1	169	1741	++	239	O95831-1#68	0	3	ENST00000675240.1	754	757	+	3	0	-2	1419
O95831-1#68	0	1	1	O95831-1	195	196	+	1	O95831-1	0	613	ENST00000675092.1	90	1956	++	238	O95831-1#68	0	3	ENST00000675092.1	675	678	+	3	0	-2	1420
O95831-1#68	0	1	1	O95831-1	195	196	+	1	O95831-1	0	613	ENST00000675050.1	71	1898	++	237	O95831-1#68	0	3	ENST00000675050.1	644	647	+	3	0	-2	1421
O95831-1#68	0	1	1	O95831-1	195	196	+	1	O95831-1	0	459	ENST00000675037.1	56	1433	++	236	O95831-1#68	0	3	ENST00000675037.1	641	644	+	3	0	-2	1422
O95831-1#68	0	1	1	O95831-1	195	196	+	1	O95831-1	100	388	ENST00000674957.1	1	865	++	234	O95831-1#68	0	3	ENST00000674957.1	286	289	+	3	0	-2	1423
O95831-1#68	0	1	1	O95831-1	195	196	+	1	O95831-1	0	238	ENST00000674722.1	13	727	++	233	O95831-1#68	0	3	ENST00000674722.1	598	601	+	3	0	-2	1424
O95831-1#68	0	1	1	O95831-1	195	196	+	1	O95831-1	0	587	ENST00000674546.1	185	1954	++	230	O95831-1#68	0	3	ENST00000674546.1	770	773	+	3	0	-2	1425
O95831-1#68	0	1	1	O95831-1	195	196	+	1	O95831-1	0	322	ENST00000535724.6	8	974	++	150	O95831-1#68	0	3	ENST00000535724.6	593	596	+	3	0	-2	1426
O95831-1#68	0	1	1	O95831-1	195	196	+	1	O95831-1	0	435	ENST00000416073.7	37	1336	++	76	O95831-1#68	0	3	ENST00000416073.7	616	619	+	3	0	-2	1427
O95831-1#68	0	1	1	O95831-1	195	196	+	1	O95831-1	0	613	ENST00000319908.8	174	2007	++	26	O95831-1#68	0	3	ENST00000319908.8	759	762	+	3	0	-2	1428
O95831-1#68	0	1	1	O95831-1	195	196	+	1	O95831-1	0	613	ENST00000287295.8	185	2024	++	18	O95831-1#68	0	3	ENST00000287295.8	770	773	+	3	0	-2	1429
O95831-1#69	0	18	18	O95831-1	412	430	+	18	O95831-1	0	613	ENST00000676436.1	34	1861	++	246	O95831-1#69	0	54	ENST00000676436.1	1258	1312	+	54	0	-36	1430
O95831-1#69	0	18	18	O95831-1	412	430	+	18	O95831-1	0	613	ENST00000676328.1	56	1892	++	245	O95831-1#69	0	54	ENST00000676328.1	1289	1343	+	54	0	-36	1431
O95831-1#69	0	18	18	O95831-1	412	430	+	18	O95831-1	0	613	ENST00000676229.1	223	2050	++	244	O95831-1#69	0	54	ENST00000676229.1	1447	1501	+	54	0	-36	1432
O95831-1#69	0	18	18	O95831-1	412	430	+	18	O95831-1	0	613	ENST00000675857.1	82	1915	++	242	O95831-1#69	0	54	ENST00000675857.1	1312	1366	+	54	0	-36	1433
O95831-1#69	0	18	18	O95831-1	412	430	+	18	O95831-1	0	613	ENST00000675427.1	89	1925	++	240	O95831-1#69	0	54	ENST00000675427.1	1325	1379	+	54	0	-36	1434
O95831-1#69	0	18	18	O95831-1	412	430	+	18	O95831-1	0	524	ENST00000675240.1	169	1741	++	239	O95831-1#69	0	54	ENST00000675240.1	1405	1459	+	54	0	-36	1435
O95831-1#69	0	18	18	O95831-1	412	430	+	18	O95831-1	0	613	ENST00000675092.1	90	1956	++	238	O95831-1#69	0	54	ENST00000675092.1	1326	1380	+	54	0	-36	1436
O95831-1#69	0	18	18	O95831-1	412	430	+	18	O95831-1	0	613	ENST00000675050.1	71	1898	++	237	O95831-1#69	0	54	ENST00000675050.1	1295	1349	+	54	0	-36	1437
O95831-1#69	0	18	18	O95831-1	412	430	+	18	O95831-1	0	459	ENST00000675037.1	56	1433	++	236	O95831-1#69	0	54	ENST00000675037.1	1292	1346	+	54	0	-36	1438
O95831-1#69	0	18	18	O95831-1	412	430	+	18	O95831-1	0	587	ENST00000674546.1	185	1954	++	230	O95831-1#69	0	54	ENST00000674546.1	1421	1475	+	54	0	-36	1439
O95831-1#69	0	18	18	O95831-1	412	430	+	18	O95831-1	339	613	ENST00000460436.6	905	1727	++	106	O95831-1#69	0	54	ENST00000460436.6	1124	1178	+	54	0	-36	1440
O95831-1#69	0	18	18	O95831-1	412	430	+	18	O95831-1	0	435	ENST00000416073.7	37	1336	++	76	O95831-1#69	0	54	ENST00000416073.7	1267	1321	+	54	0	-36	1441
O95831-1#69	0	18	18	O95831-1	412	430	+	18	O95831-1	0	613	ENST00000346424.6	24	1002	++	35	O95831-1#69	0	54	ENST00000346424.6	399	453	+	54	0	-36	1442
O95831-1#69	0	18	18	O95831-1	412	430	+	18	O95831-1	0	613	ENST00000319908.8	174	2007	++	26	O95831-1#69	0	54	ENST00000319908.8	1407	1461	+	54	0	-36	1443
O95831-1#69	0	18	18	O95831-1	412	430	+	18	O95831-1	0	613	ENST00000287295.8	185	2024	++	18	O95831-1#69	0	54	ENST00000287295.8	1421	1475	+	54	0	-36	1444
O95831-1#70	0	3	3	O95831-1	442	445	+	3	O95831-1	0	613	ENST00000676436.1	34	1861	++	246	O95831-1#70	0	9	ENST00000676436.1	1348	1357	+	9	0	-6	1445
O95831-1#70	0	3	3	O95831-1	442	445	+	3	O95831-1	0	613	ENST00000676328.1	56	1892	++	245	O95831-1#70	0	9	ENST00000676328.1	1379	1388	+	9	0	-6	1446
O95831-1#70	0	3	3	O95831-1	442	445	+	3	O95831-1	0	613	ENST00000676229.1	223	2050	++	244	O95831-1#70	0	9	ENST00000676229.1	1537	1546	+	9	0	-6	1447
O95831-1#70	0	3	3	O95831-1	442	445	+	3	O95831-1	0	613	ENST00000675857.1	82	1915	++	242	O95831-1#70	0	9	ENST00000675857.1	1402	1411	+	9	0	-6	1448
O95831-1#70	0	3	3	O95831-1	442	445	+	3	O95831-1	0	613	ENST00000675427.1	89	1925	++	240	O95831-1#70	0	9	ENST00000675427.1	1412	1421	+	9	0	-6	1449
O95831-1#70	0	3	3	O95831-1	442	445	+	3	O95831-1	0	524	ENST00000675240.1	169	1741	++	239	O95831-1#70	0	9	ENST00000675240.1	1495	1504	+	9	0	-6	1450
O95831-1#70	0	3	3	O95831-1	442	445	+	3	O95831-1	0	613	ENST00000675092.1	90	1956	++	238	O95831-1#70	0	9	ENST00000675092.1	1416	1425	+	9	0	-6	1451
O95831-1#70	0	3	3	O95831-1	442	445	+	3	O95831-1	0	613	ENST00000675050.1	71	1898	++	237	O95831-1#70	0	9	ENST00000675050.1	1385	1394	+	9	0	-6	1452
O95831-1#70	0	3	3	O95831-1	442	445	+	3	O95831-1	0	459	ENST00000675037.1	56	1433	++	236	O95831-1#70	0	9	ENST00000675037.1	1382	1391	+	9	0	-6	1453
O95831-1#70	0	3	3	O95831-1	442	445	+	3	O95831-1	338	613	ENST00000674601.1	2	686	++	232	O95831-1#70	0	9	ENST00000674601.1	173	182	+	9	0	-6	1454
O95831-1#70	0	3	3	O95831-1	442	445	+	3	O95831-1	0	587	ENST00000674546.1	185	1954	++	230	O95831-1#70	0	9	ENST00000674546.1	1511	1520	+	9	0	-6	1455
O95831-1#70	0	3	3	O95831-1	442	445	+	3	O95831-1	339	613	ENST00000460436.6	905	1727	++	106	O95831-1#70	0	9	ENST00000460436.6	1214	1223	+	9	0	-6	1456
O95831-1#70	0	3	3	O95831-1	442	445	+	3	O95831-1	0	613	ENST00000346424.6	24	1002	++	35	O95831-1#70	0	9	ENST00000346424.6	489	498	+	9	0	-6	1457
O95831-1#70	0	3	3	O95831-1	442	445	+	3	O95831-1	0	613	ENST00000319908.8	174	2007	++	26	O95831-1#70	0	9	ENST00000319908.8	1497	1506	+	9	0	-6	1458
O95831-1#70	0	3	3	O95831-1	442	445	+	3	O95831-1	0	613	ENST00000287295.8	185	2024	++	18	O95831-1#70	0	9	ENST00000287295.8	1511	1520	+	9	0	-6	1459
O95831-1#71	0	1	1	O95831-1	453	454	+	1	O95831-1	0	613	ENST00000676436.1	34	1861	++	246	O95831-1#71	0	3	ENST00000676436.1	1381	1384	+	3	0	-2	1460
O95831-1#71	0	1	1	O95831-1	453	454	+	1	O95831-1	0	613	ENST00000676328.1	56	1892	++	245	O95831-1#71	0	3	ENST00000676328.1	1412	1415	+	3	0	-2	1461
O95831-1#71	0	1	1	O95831-1	453	454	+	1	O95831-1	0	613	ENST00000676229.1	223	2050	++	244	O95831-1#71	0	3	ENST00000676229.1	1570	1573	+	3	0	-2	1462
O95831-1#71	0	1	1	O95831-1	453	454	+	1	O95831-1	0	613	ENST00000675857.1	82	1915	++	242	O95831-1#71	0	3	ENST00000675857.1	1435	1438	+	3	0	-2	1463
O95831-1#71	0	1	1	O95831-1	453	454	+	1	O95831-1	0	613	ENST00000675427.1	89	1925	++	240	O95831-1#71	0	3	ENST00000675427.1	1445	1448	+	3	0	-2	1464
O95831-1#71	0	1	1	O95831-1	453	454	+	1	O95831-1	0	524	ENST00000675240.1	169	1741	++	239	O95831-1#71	0	3	ENST00000675240.1	1528	1531	+	3	0	-2	1465
O95831-1#71	0	1	1	O95831-1	453	454	+	1	O95831-1	0	613	ENST00000675092.1	90	1956	++	238	O95831-1#71	0	3	ENST00000675092.1	1449	1452	+	3	0	-2	1466
O95831-1#71	0	1	1	O95831-1	453	454	+	1	O95831-1	0	613	ENST00000675050.1	71	1898	++	237	O95831-1#71	0	3	ENST00000675050.1	1418	1421	+	3	0	-2	1467
O95831-1#71	0	1	1	O95831-1	453	454	+	1	O95831-1	0	459	ENST00000675037.1	56	1433	++	236	O95831-1#71	0	3	ENST00000675037.1	1415	1418	+	3	0	-2	1468
O95831-1#71	0	1	1	O95831-1	453	454	+	1	O95831-1	338	613	ENST00000674601.1	2	686	++	232	O95831-1#71	0	3	ENST00000674601.1	206	209	+	3	0	-2	1469
O95831-1#71	0	1	1	O95831-1	453	454	+	1	O95831-1	0	587	ENST00000674546.1	185	1954	++	230	O95831-1#71	0	3	ENST00000674546.1	1544	1547	+	3	0	-2	1470
O95831-1#71	0	1	1	O95831-1	453	454	+	1	O95831-1	339	613	ENST00000460436.6	905	1727	++	106	O95831-1#71	0	3	ENST00000460436.6	1247	1250	+	3	0	-2	1471
O95831-1#71	0	1	1	O95831-1	453	454	+	1	O95831-1	0	613	ENST00000346424.6	24	1002	++	35	O95831-1#71	0	3	ENST00000346424.6	522	525	+	3	0	-2	1472
O95831-1#71	0	1	1	O95831-1	453	454	+	1	O95831-1	0	613	ENST00000319908.8	174	2007	++	26	O95831-1#71	0	3	ENST00000319908.8	1530	1533	+	3	0	-2	1473
O95831-1#71	0	1	1	O95831-1	453	454	+	1	O95831-1	0	613	ENST00000287295.8	185	2024	++	18	O95831-1#71	0	3	ENST00000287295.8	1544	1547	+	3	0	-2	1474
O95831-1#72	0	1	1	O95831-1	476	477	+	1	O95831-1	0	613	ENST00000676436.1	34	1861	++	246	O95831-1#72	0	3	ENST00000676436.1	1450	1453	+	3	0	-2	1475
O95831-1#72	0	1	1	O95831-1	476	477	+	1	O95831-1	0	613	ENST00000676328.1	56	1892	++	245	O95831-1#72	0	3	ENST00000676328.1	1481	1484	+	3	0	-2	1476
O95831-1#72	0	1	1	O95831-1	476	477	+	1	O95831-1	0	613	ENST00000676229.1	223	2050	++	244	O95831-1#72	0	3	ENST00000676229.1	1639	1642	+	3	0	-2	1477
O95831-1#72	0	1	1	O95831-1	476	477	+	1	O95831-1	0	613	ENST00000675857.1	82	1915	++	242	O95831-1#72	0	3	ENST00000675857.1	1504	1507	+	3	0	-2	1478
O95831-1#72	0	1	1	O95831-1	476	477	+	1	O95831-1	0	613	ENST00000675427.1	89	1925	++	240	O95831-1#72	0	3	ENST00000675427.1	1514	1517	+	3	0	-2	1479
O95831-1#72	0	1	1	O95831-1	476	477	+	1	O95831-1	0	524	ENST00000675240.1	169	1741	++	239	O95831-1#72	0	3	ENST00000675240.1	1597	1600	+	3	0	-2	1480
O95831-1#72	0	1	1	O95831-1	476	477	+	1	O95831-1	0	613	ENST00000675092.1	90	1956	++	238	O95831-1#72	0	3	ENST00000675092.1	1518	1521	+	3	0	-2	1481
O95831-1#72	0	1	1	O95831-1	476	477	+	1	O95831-1	0	613	ENST00000675050.1	71	1898	++	237	O95831-1#72	0	3	ENST00000675050.1	1487	1490	+	3	0	-2	1482
O95831-1#72	0	1	1	O95831-1	476	477	+	1	O95831-1	338	613	ENST00000674601.1	2	686	++	232	O95831-1#72	0	3	ENST00000674601.1	275	278	+	3	0	-2	1483
O95831-1#72	0	1	1	O95831-1	476	477	+	1	O95831-1	0	587	ENST00000674546.1	185	1954	++	230	O95831-1#72	0	3	ENST00000674546.1	1613	1616	+	3	0	-2	1484
O95831-1#72	0	1	1	O95831-1	476	477	+	1	O95831-1	339	613	ENST00000460436.6	905	1727	++	106	O95831-1#72	0	3	ENST00000460436.6	1316	1319	+	3	0	-2	1485
O95831-1#72	0	1	1	O95831-1	476	477	+	1	O95831-1	0	613	ENST00000346424.6	24	1002	++	35	O95831-1#72	0	3	ENST00000346424.6	591	594	+	3	0	-2	1486
O95831-1#72	0	1	1	O95831-1	476	477	+	1	O95831-1	0	613	ENST00000319908.8	174	2007	++	26	O95831-1#72	0	3	ENST00000319908.8	1599	1602	+	3	0	-2	1487
O95831-1#72	0	1	1	O95831-1	476	477	+	1	O95831-1	0	613	ENST00000287295.8	185	2024	++	18	O95831-1#72	0	3	ENST00000287295.8	1613	1616	+	3	0	-2	1488
O95831-1#73	0	1	1	O95831-1	479	480	+	1	O95831-1	0	613	ENST00000676436.1	34	1861	++	246	O95831-1#73	0	3	ENST00000676436.1	1459	1462	+	3	0	-2	1489
O95831-1#73	0	1	1	O95831-1	479	480	+	1	O95831-1	0	613	ENST00000676328.1	56	1892	++	245	O95831-1#73	0	3	ENST00000676328.1	1490	1493	+	3	0	-2	1490
O95831-1#73	0	1	1	O95831-1	479	480	+	1	O95831-1	0	613	ENST00000676229.1	223	2050	++	244	O95831-1#73	0	3	ENST00000676229.1	1648	1651	+	3	0	-2	1491
O95831-1#73	0	1	1	O95831-1	479	480	+	1	O95831-1	0	613	ENST00000675857.1	82	1915	++	242	O95831-1#73	0	3	ENST00000675857.1	1513	1516	+	3	0	-2	1492
O95831-1#73	0	1	1	O95831-1	479	480	+	1	O95831-1	0	613	ENST00000675427.1	89	1925	++	240	O95831-1#73	0	3	ENST00000675427.1	1523	1526	+	3	0	-2	1493
O95831-1#73	0	1	1	O95831-1	479	480	+	1	O95831-1	0	524	ENST00000675240.1	169	1741	++	239	O95831-1#73	0	3	ENST00000675240.1	1606	1609	+	3	0	-2	1494
O95831-1#73	0	1	1	O95831-1	479	480	+	1	O95831-1	0	613	ENST00000675092.1	90	1956	++	238	O95831-1#73	0	3	ENST00000675092.1	1527	1530	+	3	0	-2	1495
O95831-1#73	0	1	1	O95831-1	479	480	+	1	O95831-1	0	613	ENST00000675050.1	71	1898	++	237	O95831-1#73	0	3	ENST00000675050.1	1496	1499	+	3	0	-2	1496
O95831-1#73	0	1	1	O95831-1	479	480	+	1	O95831-1	338	613	ENST00000674601.1	2	686	++	232	O95831-1#73	0	3	ENST00000674601.1	284	287	+	3	0	-2	1497
O95831-1#73	0	1	1	O95831-1	479	480	+	1	O95831-1	0	587	ENST00000674546.1	185	1954	++	230	O95831-1#73	0	3	ENST00000674546.1	1622	1625	+	3	0	-2	1498
O95831-1#73	0	1	1	O95831-1	479	480	+	1	O95831-1	339	613	ENST00000460436.6	905	1727	++	106	O95831-1#73	0	3	ENST00000460436.6	1325	1328	+	3	0	-2	1499
O95831-1#73	0	1	1	O95831-1	479	480	+	1	O95831-1	0	613	ENST00000346424.6	24	1002	++	35	O95831-1#73	0	3	ENST00000346424.6	600	603	+	3	0	-2	1500
O95831-1#73	0	1	1	O95831-1	479	480	+	1	O95831-1	0	613	ENST00000319908.8	174	2007	++	26	O95831-1#73	0	3	ENST00000319908.8	1608	1611	+	3	0	-2	1501
O95831-1#73	0	1	1	O95831-1	479	480	+	1	O95831-1	0	613	ENST00000287295.8	185	2024	++	18	O95831-1#73	0	3	ENST00000287295.8	1622	1625	+	3	0	-2	1502
O95831-1#74	0	1	1	O95831-1	484	485	+	1	O95831-1	0	613	ENST00000676436.1	34	1861	++	246	O95831-1#74	0	3	ENST00000676436.1	1474	1477	+	3	0	-2	1503
O95831-1#74	0	1	1	O95831-1	484	485	+	1	O95831-1	0	613	ENST00000676328.1	56	1892	++	245	O95831-1#74	0	3	ENST00000676328.1	1505	1508	+	3	0	-2	1504
O95831-1#74	0	1	1	O95831-1	484	485	+	1	O95831-1	0	613	ENST00000676229.1	223	2050	++	244	O95831-1#74	0	3	ENST00000676229.1	1663	1666	+	3	0	-2	1505
O95831-1#74	0	1	1	O95831-1	484	485	+	1	O95831-1	0	613	ENST00000675857.1	82	1915	++	242	O95831-1#74	0	3	ENST00000675857.1	1528	1531	+	3	0	-2	1506
O95831-1#74	0	1	1	O95831-1	484	485	+	1	O95831-1	0	613	ENST00000675427.1	89	1925	++	240	O95831-1#74	0	3	ENST00000675427.1	1538	1541	+	3	0	-2	1507
O95831-1#74	0	1	1	O95831-1	484	485	+	1	O95831-1	0	524	ENST00000675240.1	169	1741	++	239	O95831-1#74	0	3	ENST00000675240.1	1621	1624	+	3	0	-2	1508
O95831-1#74	0	1	1	O95831-1	484	485	+	1	O95831-1	0	613	ENST00000675092.1	90	1956	++	238	O95831-1#74	0	3	ENST00000675092.1	1542	1545	+	3	0	-2	1509
O95831-1#74	0	1	1	O95831-1	484	485	+	1	O95831-1	0	613	ENST00000675050.1	71	1898	++	237	O95831-1#74	0	3	ENST00000675050.1	1511	1514	+	3	0	-2	1510
O95831-1#74	0	1	1	O95831-1	484	485	+	1	O95831-1	338	613	ENST00000674601.1	2	686	++	232	O95831-1#74	0	3	ENST00000674601.1	299	302	+	3	0	-2	1511
O95831-1#74	0	1	1	O95831-1	484	485	+	1	O95831-1	0	587	ENST00000674546.1	185	1954	++	230	O95831-1#74	0	3	ENST00000674546.1	1637	1640	+	3	0	-2	1512
O95831-1#74	0	1	1	O95831-1	484	485	+	1	O95831-1	339	613	ENST00000460436.6	905	1727	++	106	O95831-1#74	0	3	ENST00000460436.6	1340	1343	+	3	0	-2	1513
O95831-1#74	0	1	1	O95831-1	484	485	+	1	O95831-1	0	613	ENST00000346424.6	24	1002	++	35	O95831-1#74	0	3	ENST00000346424.6	615	618	+	3	0	-2	1514
O95831-1#74	0	1	1	O95831-1	484	485	+	1	O95831-1	0	613	ENST00000319908.8	174	2007	++	26	O95831-1#74	0	3	ENST00000319908.8	1620	1623	+	3	0	-2	1515
O95831-1#74	0	1	1	O95831-1	484	485	+	1	O95831-1	0	613	ENST00000287295.8	185	2024	++	18	O95831-1#74	0	3	ENST00000287295.8	1637	1640	+	3	0	-2	1516
O95831-1#75	0	1	1	O95831-1	528	529	+	1	O95831-1	0	613	ENST00000676436.1	34	1861	++	246	O95831-1#75	0	3	ENST00000676436.1	1606	1609	+	3	0	-2	1517
O95831-1#75	0	1	1	O95831-1	528	529	+	1	O95831-1	0	613	ENST00000676328.1	56	1892	++	245	O95831-1#75	0	3	ENST00000676328.1	1637	1640	+	3	0	-2	1518
O95831-1#75	0	1	1	O95831-1	528	529	+	1	O95831-1	0	613	ENST00000676229.1	223	2050	++	244	O95831-1#75	0	3	ENST00000676229.1	1795	1798	+	3	0	-2	1519
O95831-1#75	0	1	1	O95831-1	528	529	+	1	O95831-1	0	613	ENST00000675857.1	82	1915	++	242	O95831-1#75	0	3	ENST00000675857.1	1660	1663	+	3	0	-2	1520
O95831-1#75	0	1	1	O95831-1	528	529	+	1	O95831-1	0	613	ENST00000675427.1	89	1925	++	240	O95831-1#75	0	3	ENST00000675427.1	1670	1673	+	3	0	-2	1521
O95831-1#75	0	1	1	O95831-1	528	529	+	1	O95831-1	0	613	ENST00000675092.1	90	1956	++	238	O95831-1#75	0	3	ENST00000675092.1	1701	1704	+	3	0	-2	1522
O95831-1#75	0	1	1	O95831-1	528	529	+	1	O95831-1	0	613	ENST00000675050.1	71	1898	++	237	O95831-1#75	0	3	ENST00000675050.1	1643	1646	+	3	0	-2	1523
O95831-1#75	0	1	1	O95831-1	528	529	+	1	O95831-1	338	613	ENST00000674601.1	2	686	++	232	O95831-1#75	0	3	ENST00000674601.1	431	434	+	3	0	-2	1524
O95831-1#75	0	1	1	O95831-1	528	529	+	1	O95831-1	0	587	ENST00000674546.1	185	1954	++	230	O95831-1#75	0	3	ENST00000674546.1	1777	1780	+	3	0	-2	1525
O95831-1#75	0	1	1	O95831-1	528	529	+	1	O95831-1	339	613	ENST00000460436.6	905	1727	++	106	O95831-1#75	0	3	ENST00000460436.6	1472	1475	+	3	0	-2	1526
O95831-1#75	0	1	1	O95831-1	528	529	+	1	O95831-1	0	613	ENST00000346424.6	24	1002	++	35	O95831-1#75	0	3	ENST00000346424.6	747	750	+	3	0	-2	1527
O95831-1#75	0	1	1	O95831-1	528	529	+	1	O95831-1	0	613	ENST00000319908.8	174	2007	++	26	O95831-1#75	0	3	ENST00000319908.8	1752	1755	+	3	0	-2	1528
O95831-1#75	0	1	1	O95831-1	528	529	+	1	O95831-1	0	613	ENST00000287295.8	185	2024	++	18	O95831-1#75	0	3	ENST00000287295.8	1769	1772	+	3	0	-2	1529
O95831-1#76	0	1	1	O95831-1	530	531	+	1	O95831-1	0	613	ENST00000676436.1	34	1861	++	246	O95831-1#76	0	3	ENST00000676436.1	1612	1615	+	3	0	-2	1530
O95831-1#76	0	1	1	O95831-1	530	531	+	1	O95831-1	0	613	ENST00000676328.1	56	1892	++	245	O95831-1#76	0	3	ENST00000676328.1	1643	1646	+	3	0	-2	1531
O95831-1#76	0	1	1	O95831-1	530	531	+	1	O95831-1	0	613	ENST00000676229.1	223	2050	++	244	O95831-1#76	0	3	ENST00000676229.1	1801	1804	+	3	0	-2	1532
O95831-1#76	0	1	1	O95831-1	530	531	+	1	O95831-1	0	613	ENST00000675857.1	82	1915	++	242	O95831-1#76	0	3	ENST00000675857.1	1666	1669	+	3	0	-2	1533
O95831-1#76	0	1	1	O95831-1	530	531	+	1	O95831-1	0	613	ENST00000675427.1	89	1925	++	240	O95831-1#76	0	3	ENST00000675427.1	1676	1679	+	3	0	-2	1534
O95831-1#76	0	1	1	O95831-1	530	531	+	1	O95831-1	0	613	ENST00000675092.1	90	1956	++	238	O95831-1#76	0	3	ENST00000675092.1	1707	1710	+	3	0	-2	1535
O95831-1#76	0	1	1	O95831-1	530	531	+	1	O95831-1	0	613	ENST00000675050.1	71	1898	++	237	O95831-1#76	0	3	ENST00000675050.1	1649	1652	+	3	0	-2	1536
O95831-1#76	0	1	1	O95831-1	530	531	+	1	O95831-1	338	613	ENST00000674601.1	2	686	++	232	O95831-1#76	0	3	ENST00000674601.1	437	440	+	3	0	-2	1537
O95831-1#76	0	1	1	O95831-1	530	531	+	1	O95831-1	0	587	ENST00000674546.1	185	1954	++	230	O95831-1#76	0	3	ENST00000674546.1	1783	1786	+	3	0	-2	1538
O95831-1#76	0	1	1	O95831-1	530	531	+	1	O95831-1	339	613	ENST00000460436.6	905	1727	++	106	O95831-1#76	0	3	ENST00000460436.6	1478	1481	+	3	0	-2	1539
O95831-1#76	0	1	1	O95831-1	530	531	+	1	O95831-1	0	613	ENST00000346424.6	24	1002	++	35	O95831-1#76	0	3	ENST00000346424.6	753	756	+	3	0	-2	1540
O95831-1#76	0	1	1	O95831-1	530	531	+	1	O95831-1	0	613	ENST00000319908.8	174	2007	++	26	O95831-1#76	0	3	ENST00000319908.8	1758	1761	+	3	0	-2	1541
O95831-1#76	0	1	1	O95831-1	530	531	+	1	O95831-1	0	613	ENST00000287295.8	185	2024	++	18	O95831-1#76	0	3	ENST00000287295.8	1775	1778	+	3	0	-2	1542
O95831-1#77	0	1	1	O95831-1	532	533	+	1	O95831-1	0	613	ENST00000676436.1	34	1861	++	246	O95831-1#77	0	3	ENST00000676436.1	1618	1621	+	3	0	-2	1543
O95831-1#77	0	1	1	O95831-1	532	533	+	1	O95831-1	0	613	ENST00000676328.1	56	1892	++	245	O95831-1#77	0	3	ENST00000676328.1	1649	1652	+	3	0	-2	1544
O95831-1#77	0	1	1	O95831-1	532	533	+	1	O95831-1	0	613	ENST00000676229.1	223	2050	++	244	O95831-1#77	0	3	ENST00000676229.1	1807	1810	+	3	0	-2	1545
O95831-1#77	0	1	1	O95831-1	532	533	+	1	O95831-1	0	613	ENST00000675857.1	82	1915	++	242	O95831-1#77	0	3	ENST00000675857.1	1672	1675	+	3	0	-2	1546
O95831-1#77	0	1	1	O95831-1	532	533	+	1	O95831-1	0	613	ENST00000675427.1	89	1925	++	240	O95831-1#77	0	3	ENST00000675427.1	1682	1685	+	3	0	-2	1547
O95831-1#77	0	1	1	O95831-1	532	533	+	1	O95831-1	0	613	ENST00000675092.1	90	1956	++	238	O95831-1#77	0	3	ENST00000675092.1	1713	1716	+	3	0	-2	1548
O95831-1#77	0	1	1	O95831-1	532	533	+	1	O95831-1	0	613	ENST00000675050.1	71	1898	++	237	O95831-1#77	0	3	ENST00000675050.1	1655	1658	+	3	0	-2	1549
O95831-1#77	0	1	1	O95831-1	532	533	+	1	O95831-1	338	613	ENST00000674601.1	2	686	++	232	O95831-1#77	0	3	ENST00000674601.1	443	446	+	3	0	-2	1550
O95831-1#77	0	1	1	O95831-1	532	533	+	1	O95831-1	0	587	ENST00000674546.1	185	1954	++	230	O95831-1#77	0	3	ENST00000674546.1	1789	1792	+	3	0	-2	1551
O95831-1#77	0	1	1	O95831-1	532	533	+	1	O95831-1	339	613	ENST00000460436.6	905	1727	++	106	O95831-1#77	0	3	ENST00000460436.6	1484	1487	+	3	0	-2	1552
O95831-1#77	0	1	1	O95831-1	532	533	+	1	O95831-1	0	613	ENST00000346424.6	24	1002	++	35	O95831-1#77	0	3	ENST00000346424.6	759	762	+	3	0	-2	1553
O95831-1#77	0	1	1	O95831-1	532	533	+	1	O95831-1	0	613	ENST00000319908.8	174	2007	++	26	O95831-1#77	0	3	ENST00000319908.8	1764	1767	+	3	0	-2	1554
O95831-1#77	0	1	1	O95831-1	532	533	+	1	O95831-1	0	613	ENST00000287295.8	185	2024	++	18	O95831-1#77	0	3	ENST00000287295.8	1781	1784	+	3	0	-2	1555
O95831-1#78	0	1	1	O95831-1	534	535	+	1	O95831-1	0	613	ENST00000676436.1	34	1861	++	246	O95831-1#78	0	3	ENST00000676436.1	1624	1627	+	3	0	-2	1556
O95831-1#78	0	1	1	O95831-1	534	535	+	1	O95831-1	0	613	ENST00000676328.1	56	1892	++	245	O95831-1#78	0	3	ENST00000676328.1	1655	1658	+	3	0	-2	1557
O95831-1#78	0	1	1	O95831-1	534	535	+	1	O95831-1	0	613	ENST00000676229.1	223	2050	++	244	O95831-1#78	0	3	ENST00000676229.1	1813	1816	+	3	0	-2	1558
O95831-1#78	0	1	1	O95831-1	534	535	+	1	O95831-1	0	613	ENST00000675857.1	82	1915	++	242	O95831-1#78	0	3	ENST00000675857.1	1678	1681	+	3	0	-2	1559
O95831-1#78	0	1	1	O95831-1	534	535	+	1	O95831-1	0	613	ENST00000675427.1	89	1925	++	240	O95831-1#78	0	3	ENST00000675427.1	1688	1691	+	3	0	-2	1560
O95831-1#78	0	1	1	O95831-1	534	535	+	1	O95831-1	0	613	ENST00000675092.1	90	1956	++	238	O95831-1#78	0	3	ENST00000675092.1	1719	1722	+	3	0	-2	1561
O95831-1#78	0	1	1	O95831-1	534	535	+	1	O95831-1	0	613	ENST00000675050.1	71	1898	++	237	O95831-1#78	0	3	ENST00000675050.1	1661	1664	+	3	0	-2	1562
O95831-1#78	0	1	1	O95831-1	534	535	+	1	O95831-1	338	613	ENST00000674601.1	2	686	++	232	O95831-1#78	0	3	ENST00000674601.1	449	452	+	3	0	-2	1563
O95831-1#78	0	1	1	O95831-1	534	535	+	1	O95831-1	0	587	ENST00000674546.1	185	1954	++	230	O95831-1#78	0	3	ENST00000674546.1	1795	1798	+	3	0	-2	1564
O95831-1#78	0	1	1	O95831-1	534	535	+	1	O95831-1	339	613	ENST00000460436.6	905	1727	++	106	O95831-1#78	0	3	ENST00000460436.6	1490	1493	+	3	0	-2	1565
O95831-1#78	0	1	1	O95831-1	534	535	+	1	O95831-1	0	613	ENST00000346424.6	24	1002	++	35	O95831-1#78	0	3	ENST00000346424.6	765	768	+	3	0	-2	1566
O95831-1#78	0	1	1	O95831-1	534	535	+	1	O95831-1	0	613	ENST00000319908.8	174	2007	++	26	O95831-1#78	0	3	ENST00000319908.8	1770	1773	+	3	0	-2	1567
O95831-1#78	0	1	1	O95831-1	534	535	+	1	O95831-1	0	613	ENST00000287295.8	185	2024	++	18	O95831-1#78	0	3	ENST00000287295.8	1787	1790	+	3	0	-2	1568
O95831-1#79	0	9	9	O95831-1	129	138	+	9	O95831-1	0	613	ENST00000676436.1	34	1861	++	246	O95831-1#79	0	27	ENST00000676436.1	415	442	+	27	0	-18	1569
O95831-1#79	0	9	9	O95831-1	129	138	+	9	O95831-1	0	613	ENST00000676328.1	56	1892	++	245	O95831-1#79	0	27	ENST00000676328.1	443	470	+	27	0	-18	1570
O95831-1#79	0	9	9	O95831-1	129	138	+	9	O95831-1	0	613	ENST00000676229.1	223	2050	++	244	O95831-1#79	0	27	ENST00000676229.1	598	625	+	27	0	-18	1571
O95831-1#79	0	9	9	O95831-1	129	138	+	9	O95831-1	109	136	ENST00000676144.1	102	183	++	243	O95831-1#79	0	21	ENST00000676144.1	162	183	+	21	0	-12	1572
O95831-1#79	0	9	9	O95831-1	129	138	+	9	O95831-1	0	613	ENST00000675857.1	82	1915	++	242	O95831-1#79	0	27	ENST00000675857.1	463	490	+	27	0	-18	1573
O95831-1#79	0	9	9	O95831-1	129	138	+	9	O95831-1	0	613	ENST00000675427.1	89	1925	++	240	O95831-1#79	0	27	ENST00000675427.1	476	503	+	27	0	-18	1574
O95831-1#79	0	9	9	O95831-1	129	138	+	9	O95831-1	0	524	ENST00000675240.1	169	1741	++	239	O95831-1#79	0	27	ENST00000675240.1	556	583	+	27	0	-18	1575
O95831-1#79	0	9	9	O95831-1	129	138	+	9	O95831-1	0	613	ENST00000675092.1	90	1956	++	238	O95831-1#79	0	27	ENST00000675092.1	477	504	+	27	0	-18	1576
O95831-1#79	0	9	9	O95831-1	129	138	+	9	O95831-1	0	613	ENST00000675050.1	71	1898	++	237	O95831-1#79	0	27	ENST00000675050.1	446	473	+	27	0	-18	1577
O95831-1#79	0	9	9	O95831-1	129	138	+	9	O95831-1	0	459	ENST00000675037.1	56	1433	++	236	O95831-1#79	0	27	ENST00000675037.1	443	470	+	27	0	-18	1578
O95831-1#79	0	9	9	O95831-1	129	138	+	9	O95831-1	100	388	ENST00000674957.1	1	865	++	234	O95831-1#79	0	27	ENST00000674957.1	88	115	+	27	0	-18	1579
O95831-1#79	0	9	9	O95831-1	129	138	+	9	O95831-1	0	238	ENST00000674722.1	13	727	++	233	O95831-1#79	0	27	ENST00000674722.1	400	427	+	27	0	-18	1580
O95831-1#79	0	9	9	O95831-1	129	138	+	9	O95831-1	0	587	ENST00000674546.1	185	1954	++	230	O95831-1#79	0	27	ENST00000674546.1	572	599	+	27	0	-18	1581
O95831-1#79	0	9	9	O95831-1	129	138	+	9	O95831-1	0	322	ENST00000535724.6	8	974	++	150	O95831-1#79	0	27	ENST00000535724.6	395	422	+	27	0	-18	1582
O95831-1#79	0	9	9	O95831-1	129	138	+	9	O95831-1	0	435	ENST00000416073.7	37	1336	++	76	O95831-1#79	0	27	ENST00000416073.7	418	445	+	27	0	-18	1583
O95831-1#79	0	9	9	O95831-1	129	138	+	9	O95831-1	0	613	ENST00000319908.8	174	2007	++	26	O95831-1#79	0	27	ENST00000319908.8	561	588	+	27	0	-18	1584
O95831-1#79	0	9	9	O95831-1	129	138	+	9	O95831-1	0	613	ENST00000287295.8	185	2024	++	18	O95831-1#79	0	27	ENST00000287295.8	572	599	+	27	0	-18	1585
O95831-1#80	0	13	13	O95831-1	140	153	+	13	O95831-1	0	613	ENST00000676436.1	34	1861	++	246	O95831-1#80	0	39	ENST00000676436.1	448	487	+	39	0	-26	1586
O95831-1#80	0	13	13	O95831-1	140	153	+	13	O95831-1	0	613	ENST00000676328.1	56	1892	++	245	O95831-1#80	0	39	ENST00000676328.1	476	515	+	39	0	-26	1587
O95831-1#80	0	13	13	O95831-1	140	153	+	13	O95831-1	0	613	ENST00000676229.1	223	2050	++	244	O95831-1#80	0	39	ENST00000676229.1	631	670	+	39	0	-26	1588
O95831-1#80	0	13	13	O95831-1	140	153	+	13	O95831-1	0	613	ENST00000675857.1	82	1915	++	242	O95831-1#80	0	39	ENST00000675857.1	496	535	+	39	0	-26	1589
O95831-1#80	0	13	13	O95831-1	140	153	+	13	O95831-1	0	613	ENST00000675427.1	89	1925	++	240	O95831-1#80	0	39	ENST00000675427.1	509	548	+	39	0	-26	1590
O95831-1#80	0	13	13	O95831-1	140	153	+	13	O95831-1	0	524	ENST00000675240.1	169	1741	++	239	O95831-1#80	0	39	ENST00000675240.1	589	628	+	39	0	-26	1591
O95831-1#80	0	13	13	O95831-1	140	153	+	13	O95831-1	0	613	ENST00000675092.1	90	1956	++	238	O95831-1#80	0	39	ENST00000675092.1	510	549	+	39	0	-26	1592
O95831-1#80	0	13	13	O95831-1	140	153	+	13	O95831-1	0	613	ENST00000675050.1	71	1898	++	237	O95831-1#80	0	39	ENST00000675050.1	479	518	+	39	0	-26	1593
O95831-1#80	0	13	13	O95831-1	140	153	+	13	O95831-1	0	459	ENST00000675037.1	56	1433	++	236	O95831-1#80	0	39	ENST00000675037.1	476	515	+	39	0	-26	1594
O95831-1#80	0	13	13	O95831-1	140	153	+	13	O95831-1	100	388	ENST00000674957.1	1	865	++	234	O95831-1#80	0	39	ENST00000674957.1	121	160	+	39	0	-26	1595
O95831-1#80	0	13	13	O95831-1	140	153	+	13	O95831-1	0	238	ENST00000674722.1	13	727	++	233	O95831-1#80	0	39	ENST00000674722.1	433	472	+	39	0	-26	1596
O95831-1#80	0	13	13	O95831-1	140	153	+	13	O95831-1	0	587	ENST00000674546.1	185	1954	++	230	O95831-1#80	0	39	ENST00000674546.1	605	644	+	39	0	-26	1597
O95831-1#80	0	13	13	O95831-1	140	153	+	13	O95831-1	0	322	ENST00000535724.6	8	974	++	150	O95831-1#80	0	39	ENST00000535724.6	428	467	+	39	0	-26	1598
O95831-1#80	0	13	13	O95831-1	140	153	+	13	O95831-1	0	435	ENST00000416073.7	37	1336	++	76	O95831-1#80	0	39	ENST00000416073.7	451	490	+	39	0	-26	1599
O95831-1#80	0	13	13	O95831-1	140	153	+	13	O95831-1	0	613	ENST00000319908.8	174	2007	++	26	O95831-1#80	0	39	ENST00000319908.8	594	633	+	39	0	-26	1600
O95831-1#80	0	13	13	O95831-1	140	153	+	13	O95831-1	0	613	ENST00000287295.8	185	2024	++	18	O95831-1#80	0	39	ENST00000287295.8	605	644	+	39	0	-26	1601
O95831-1#81	0	5	5	O95831-1	157	162	+	5	O95831-1	0	613	ENST00000676436.1	34	1861	++	246	O95831-1#81	0	15	ENST00000676436.1	499	514	+	15	0	-10	1602
O95831-1#81	0	5	5	O95831-1	157	162	+	5	O95831-1	0	613	ENST00000676328.1	56	1892	++	245	O95831-1#81	0	15	ENST00000676328.1	527	542	+	15	0	-10	1603
O95831-1#81	0	5	5	O95831-1	157	162	+	5	O95831-1	0	613	ENST00000676229.1	223	2050	++	244	O95831-1#81	0	15	ENST00000676229.1	682	697	+	15	0	-10	1604
O95831-1#81	0	5	5	O95831-1	157	162	+	5	O95831-1	0	613	ENST00000675857.1	82	1915	++	242	O95831-1#81	0	15	ENST00000675857.1	547	562	+	15	0	-10	1605
O95831-1#81	0	5	5	O95831-1	157	162	+	5	O95831-1	0	613	ENST00000675427.1	89	1925	++	240	O95831-1#81	0	15	ENST00000675427.1	560	575	+	15	0	-10	1606
O95831-1#81	0	5	5	O95831-1	157	162	+	5	O95831-1	0	524	ENST00000675240.1	169	1741	++	239	O95831-1#81	0	15	ENST00000675240.1	640	655	+	15	0	-10	1607
O95831-1#81	0	5	5	O95831-1	157	162	+	5	O95831-1	0	613	ENST00000675092.1	90	1956	++	238	O95831-1#81	0	15	ENST00000675092.1	561	576	+	15	0	-10	1608
O95831-1#81	0	5	5	O95831-1	157	162	+	5	O95831-1	0	613	ENST00000675050.1	71	1898	++	237	O95831-1#81	0	15	ENST00000675050.1	530	545	+	15	0	-10	1609
O95831-1#81	0	5	5	O95831-1	157	162	+	5	O95831-1	0	459	ENST00000675037.1	56	1433	++	236	O95831-1#81	0	15	ENST00000675037.1	527	542	+	15	0	-10	1610
O95831-1#81	0	5	5	O95831-1	157	162	+	5	O95831-1	100	388	ENST00000674957.1	1	865	++	234	O95831-1#81	0	15	ENST00000674957.1	172	187	+	15	0	-10	1611
O95831-1#81	0	5	5	O95831-1	157	162	+	5	O95831-1	0	238	ENST00000674722.1	13	727	++	233	O95831-1#81	0	15	ENST00000674722.1	484	499	+	15	0	-10	1612
O95831-1#81	0	5	5	O95831-1	157	162	+	5	O95831-1	0	587	ENST00000674546.1	185	1954	++	230	O95831-1#81	0	15	ENST00000674546.1	656	671	+	15	0	-10	1613
O95831-1#81	0	5	5	O95831-1	157	162	+	5	O95831-1	0	322	ENST00000535724.6	8	974	++	150	O95831-1#81	0	15	ENST00000535724.6	479	494	+	15	0	-10	1614
O95831-1#81	0	5	5	O95831-1	157	162	+	5	O95831-1	0	435	ENST00000416073.7	37	1336	++	76	O95831-1#81	0	15	ENST00000416073.7	502	517	+	15	0	-10	1615
O95831-1#81	0	5	5	O95831-1	157	162	+	5	O95831-1	0	613	ENST00000319908.8	174	2007	++	26	O95831-1#81	0	15	ENST00000319908.8	645	660	+	15	0	-10	1616
O95831-1#81	0	5	5	O95831-1	157	162	+	5	O95831-1	0	613	ENST00000287295.8	185	2024	++	18	O95831-1#81	0	15	ENST00000287295.8	656	671	+	15	0	-10	1617
O95831-1#82	0	4	4	O95831-1	163	167	+	4	O95831-1	0	613	ENST00000676436.1	34	1861	++	246	O95831-1#82	0	12	ENST00000676436.1	517	529	+	12	0	-8	1618
O95831-1#82	0	4	4	O95831-1	163	167	+	4	O95831-1	0	613	ENST00000676328.1	56	1892	++	245	O95831-1#82	0	12	ENST00000676328.1	545	557	+	12	0	-8	1619
O95831-1#82	0	4	4	O95831-1	163	167	+	4	O95831-1	0	613	ENST00000676229.1	223	2050	++	244	O95831-1#82	0	12	ENST00000676229.1	700	712	+	12	0	-8	1620
O95831-1#82	0	4	4	O95831-1	163	167	+	4	O95831-1	0	613	ENST00000675857.1	82	1915	++	242	O95831-1#82	0	12	ENST00000675857.1	565	577	+	12	0	-8	1621
O95831-1#82	0	4	4	O95831-1	163	167	+	4	O95831-1	0	613	ENST00000675427.1	89	1925	++	240	O95831-1#82	0	12	ENST00000675427.1	578	590	+	12	0	-8	1622
O95831-1#82	0	4	4	O95831-1	163	167	+	4	O95831-1	0	524	ENST00000675240.1	169	1741	++	239	O95831-1#82	0	12	ENST00000675240.1	658	670	+	12	0	-8	1623
O95831-1#82	0	4	4	O95831-1	163	167	+	4	O95831-1	0	613	ENST00000675092.1	90	1956	++	238	O95831-1#82	0	12	ENST00000675092.1	579	591	+	12	0	-8	1624
O95831-1#82	0	4	4	O95831-1	163	167	+	4	O95831-1	0	613	ENST00000675050.1	71	1898	++	237	O95831-1#82	0	12	ENST00000675050.1	548	560	+	12	0	-8	1625
O95831-1#82	0	4	4	O95831-1	163	167	+	4	O95831-1	0	459	ENST00000675037.1	56	1433	++	236	O95831-1#82	0	12	ENST00000675037.1	545	557	+	12	0	-8	1626
O95831-1#82	0	4	4	O95831-1	163	167	+	4	O95831-1	100	388	ENST00000674957.1	1	865	++	234	O95831-1#82	0	12	ENST00000674957.1	190	202	+	12	0	-8	1627
O95831-1#82	0	4	4	O95831-1	163	167	+	4	O95831-1	0	238	ENST00000674722.1	13	727	++	233	O95831-1#82	0	12	ENST00000674722.1	502	514	+	12	0	-8	1628
O95831-1#82	0	4	4	O95831-1	163	167	+	4	O95831-1	0	587	ENST00000674546.1	185	1954	++	230	O95831-1#82	0	12	ENST00000674546.1	674	686	+	12	0	-8	1629
O95831-1#82	0	4	4	O95831-1	163	167	+	4	O95831-1	0	322	ENST00000535724.6	8	974	++	150	O95831-1#82	0	12	ENST00000535724.6	497	509	+	12	0	-8	1630
O95831-1#82	0	4	4	O95831-1	163	167	+	4	O95831-1	0	435	ENST00000416073.7	37	1336	++	76	O95831-1#82	0	12	ENST00000416073.7	520	532	+	12	0	-8	1631
O95831-1#82	0	4	4	O95831-1	163	167	+	4	O95831-1	0	613	ENST00000319908.8	174	2007	++	26	O95831-1#82	0	12	ENST00000319908.8	663	675	+	12	0	-8	1632
O95831-1#82	0	4	4	O95831-1	163	167	+	4	O95831-1	0	613	ENST00000287295.8	185	2024	++	18	O95831-1#82	0	12	ENST00000287295.8	674	686	+	12	0	-8	1633
O95831-1#83	0	4	4	O95831-1	172	176	+	4	O95831-1	0	613	ENST00000676436.1	34	1861	++	246	O95831-1#83	0	12	ENST00000676436.1	544	556	+	12	0	-8	1634
O95831-1#83	0	4	4	O95831-1	172	176	+	4	O95831-1	0	613	ENST00000676328.1	56	1892	++	245	O95831-1#83	0	12	ENST00000676328.1	572	584	+	12	0	-8	1635
O95831-1#83	0	4	4	O95831-1	172	176	+	4	O95831-1	0	613	ENST00000676229.1	223	2050	++	244	O95831-1#83	0	12	ENST00000676229.1	727	739	+	12	0	-8	1636
O95831-1#83	0	4	4	O95831-1	172	176	+	4	O95831-1	0	613	ENST00000675857.1	82	1915	++	242	O95831-1#83	0	12	ENST00000675857.1	592	604	+	12	0	-8	1637
O95831-1#83	0	4	4	O95831-1	172	176	+	4	O95831-1	0	613	ENST00000675427.1	89	1925	++	240	O95831-1#83	0	12	ENST00000675427.1	605	617	+	12	0	-8	1638
O95831-1#83	0	4	4	O95831-1	172	176	+	4	O95831-1	0	524	ENST00000675240.1	169	1741	++	239	O95831-1#83	0	12	ENST00000675240.1	685	697	+	12	0	-8	1639
O95831-1#83	0	4	4	O95831-1	172	176	+	4	O95831-1	0	613	ENST00000675092.1	90	1956	++	238	O95831-1#83	0	12	ENST00000675092.1	606	618	+	12	0	-8	1640
O95831-1#83	0	4	4	O95831-1	172	176	+	4	O95831-1	0	613	ENST00000675050.1	71	1898	++	237	O95831-1#83	0	12	ENST00000675050.1	575	587	+	12	0	-8	1641
O95831-1#83	0	4	4	O95831-1	172	176	+	4	O95831-1	0	459	ENST00000675037.1	56	1433	++	236	O95831-1#83	0	12	ENST00000675037.1	572	584	+	12	0	-8	1642
O95831-1#83	0	4	4	O95831-1	172	176	+	4	O95831-1	100	388	ENST00000674957.1	1	865	++	234	O95831-1#83	0	12	ENST00000674957.1	217	229	+	12	0	-8	1643
O95831-1#83	0	4	4	O95831-1	172	176	+	4	O95831-1	0	238	ENST00000674722.1	13	727	++	233	O95831-1#83	0	12	ENST00000674722.1	529	541	+	12	0	-8	1644
O95831-1#83	0	4	4	O95831-1	172	176	+	4	O95831-1	0	587	ENST00000674546.1	185	1954	++	230	O95831-1#83	0	12	ENST00000674546.1	701	713	+	12	0	-8	1645
O95831-1#83	0	4	4	O95831-1	172	176	+	4	O95831-1	0	322	ENST00000535724.6	8	974	++	150	O95831-1#83	0	12	ENST00000535724.6	524	536	+	12	0	-8	1646
O95831-1#83	0	4	4	O95831-1	172	176	+	4	O95831-1	0	435	ENST00000416073.7	37	1336	++	76	O95831-1#83	0	12	ENST00000416073.7	547	559	+	12	0	-8	1647
O95831-1#83	0	4	4	O95831-1	172	176	+	4	O95831-1	0	613	ENST00000319908.8	174	2007	++	26	O95831-1#83	0	12	ENST00000319908.8	690	702	+	12	0	-8	1648
O95831-1#83	0	4	4	O95831-1	172	176	+	4	O95831-1	0	613	ENST00000287295.8	185	2024	++	18	O95831-1#83	0	12	ENST00000287295.8	701	713	+	12	0	-8	1649
O95831-1#84	0	3	3	O95831-1	177	180	+	3	O95831-1	0	613	ENST00000676436.1	34	1861	++	246	O95831-1#84	0	9	ENST00000676436.1	559	568	+	9	0	-6	1650
O95831-1#84	0	3	3	O95831-1	177	180	+	3	O95831-1	0	613	ENST00000676328.1	56	1892	++	245	O95831-1#84	0	9	ENST00000676328.1	587	596	+	9	0	-6	1651
O95831-1#84	0	3	3	O95831-1	177	180	+	3	O95831-1	0	613	ENST00000676229.1	223	2050	++	244	O95831-1#84	0	9	ENST00000676229.1	742	751	+	9	0	-6	1652
O95831-1#84	0	3	3	O95831-1	177	180	+	3	O95831-1	0	613	ENST00000675857.1	82	1915	++	242	O95831-1#84	0	9	ENST00000675857.1	607	616	+	9	0	-6	1653
O95831-1#84	0	3	3	O95831-1	177	180	+	3	O95831-1	0	613	ENST00000675427.1	89	1925	++	240	O95831-1#84	0	9	ENST00000675427.1	620	629	+	9	0	-6	1654
O95831-1#84	0	3	3	O95831-1	177	180	+	3	O95831-1	0	524	ENST00000675240.1	169	1741	++	239	O95831-1#84	0	9	ENST00000675240.1	700	709	+	9	0	-6	1655
O95831-1#84	0	3	3	O95831-1	177	180	+	3	O95831-1	0	613	ENST00000675092.1	90	1956	++	238	O95831-1#84	0	9	ENST00000675092.1	621	630	+	9	0	-6	1656
O95831-1#84	0	3	3	O95831-1	177	180	+	3	O95831-1	0	613	ENST00000675050.1	71	1898	++	237	O95831-1#84	0	9	ENST00000675050.1	590	599	+	9	0	-6	1657
O95831-1#84	0	3	3	O95831-1	177	180	+	3	O95831-1	0	459	ENST00000675037.1	56	1433	++	236	O95831-1#84	0	9	ENST00000675037.1	587	596	+	9	0	-6	1658
O95831-1#84	0	3	3	O95831-1	177	180	+	3	O95831-1	100	388	ENST00000674957.1	1	865	++	234	O95831-1#84	0	9	ENST00000674957.1	232	241	+	9	0	-6	1659
O95831-1#84	0	3	3	O95831-1	177	180	+	3	O95831-1	0	238	ENST00000674722.1	13	727	++	233	O95831-1#84	0	9	ENST00000674722.1	544	553	+	9	0	-6	1660
O95831-1#84	0	3	3	O95831-1	177	180	+	3	O95831-1	0	587	ENST00000674546.1	185	1954	++	230	O95831-1#84	0	9	ENST00000674546.1	716	725	+	9	0	-6	1661
O95831-1#84	0	3	3	O95831-1	177	180	+	3	O95831-1	0	322	ENST00000535724.6	8	974	++	150	O95831-1#84	0	9	ENST00000535724.6	539	548	+	9	0	-6	1662
O95831-1#84	0	3	3	O95831-1	177	180	+	3	O95831-1	0	435	ENST00000416073.7	37	1336	++	76	O95831-1#84	0	9	ENST00000416073.7	562	571	+	9	0	-6	1663
O95831-1#84	0	3	3	O95831-1	177	180	+	3	O95831-1	0	613	ENST00000319908.8	174	2007	++	26	O95831-1#84	0	9	ENST00000319908.8	705	714	+	9	0	-6	1664
O95831-1#84	0	3	3	O95831-1	177	180	+	3	O95831-1	0	613	ENST00000287295.8	185	2024	++	18	O95831-1#84	0	9	ENST00000287295.8	716	725	+	9	0	-6	1665
O95831-1#85	0	4	4	O95831-1	186	190	+	4	O95831-1	0	613	ENST00000676436.1	34	1861	++	246	O95831-1#85	0	12	ENST00000676436.1	586	598	+	12	0	-8	1666
O95831-1#85	0	4	4	O95831-1	186	190	+	4	O95831-1	0	613	ENST00000676328.1	56	1892	++	245	O95831-1#85	0	12	ENST00000676328.1	614	626	+	12	0	-8	1667
O95831-1#85	0	4	4	O95831-1	186	190	+	4	O95831-1	0	613	ENST00000676229.1	223	2050	++	244	O95831-1#85	0	12	ENST00000676229.1	769	781	+	12	0	-8	1668
O95831-1#85	0	4	4	O95831-1	186	190	+	4	O95831-1	0	613	ENST00000675857.1	82	1915	++	242	O95831-1#85	0	12	ENST00000675857.1	634	646	+	12	0	-8	1669
O95831-1#85	0	4	4	O95831-1	186	190	+	4	O95831-1	0	613	ENST00000675427.1	89	1925	++	240	O95831-1#85	0	12	ENST00000675427.1	647	659	+	12	0	-8	1670
O95831-1#85	0	4	4	O95831-1	186	190	+	4	O95831-1	0	524	ENST00000675240.1	169	1741	++	239	O95831-1#85	0	12	ENST00000675240.1	727	739	+	12	0	-8	1671
O95831-1#85	0	4	4	O95831-1	186	190	+	4	O95831-1	0	613	ENST00000675092.1	90	1956	++	238	O95831-1#85	0	12	ENST00000675092.1	648	660	+	12	0	-8	1672
O95831-1#85	0	4	4	O95831-1	186	190	+	4	O95831-1	0	613	ENST00000675050.1	71	1898	++	237	O95831-1#85	0	12	ENST00000675050.1	617	629	+	12	0	-8	1673
O95831-1#85	0	4	4	O95831-1	186	190	+	4	O95831-1	0	459	ENST00000675037.1	56	1433	++	236	O95831-1#85	0	12	ENST00000675037.1	614	626	+	12	0	-8	1674
O95831-1#85	0	4	4	O95831-1	186	190	+	4	O95831-1	100	388	ENST00000674957.1	1	865	++	234	O95831-1#85	0	12	ENST00000674957.1	259	271	+	12	0	-8	1675
O95831-1#85	0	4	4	O95831-1	186	190	+	4	O95831-1	0	238	ENST00000674722.1	13	727	++	233	O95831-1#85	0	12	ENST00000674722.1	571	583	+	12	0	-8	1676
O95831-1#85	0	4	4	O95831-1	186	190	+	4	O95831-1	0	587	ENST00000674546.1	185	1954	++	230	O95831-1#85	0	12	ENST00000674546.1	743	755	+	12	0	-8	1677
O95831-1#85	0	4	4	O95831-1	186	190	+	4	O95831-1	0	322	ENST00000535724.6	8	974	++	150	O95831-1#85	0	12	ENST00000535724.6	566	578	+	12	0	-8	1678
O95831-1#85	0	4	4	O95831-1	186	190	+	4	O95831-1	0	435	ENST00000416073.7	37	1336	++	76	O95831-1#85	0	12	ENST00000416073.7	589	601	+	12	0	-8	1679
O95831-1#85	0	4	4	O95831-1	186	190	+	4	O95831-1	0	613	ENST00000319908.8	174	2007	++	26	O95831-1#85	0	12	ENST00000319908.8	732	744	+	12	0	-8	1680
O95831-1#85	0	4	4	O95831-1	186	190	+	4	O95831-1	0	613	ENST00000287295.8	185	2024	++	18	O95831-1#85	0	12	ENST00000287295.8	743	755	+	12	0	-8	1681
O95831-1#86	0	3	3	O95831-1	191	194	+	3	O95831-1	0	613	ENST00000676436.1	34	1861	++	246	O95831-1#86	0	9	ENST00000676436.1	601	610	+	9	0	-6	1682
O95831-1#86	0	3	3	O95831-1	191	194	+	3	O95831-1	0	613	ENST00000676328.1	56	1892	++	245	O95831-1#86	0	9	ENST00000676328.1	629	638	+	9	0	-6	1683
O95831-1#86	0	3	3	O95831-1	191	194	+	3	O95831-1	0	613	ENST00000676229.1	223	2050	++	244	O95831-1#86	0	9	ENST00000676229.1	784	793	+	9	0	-6	1684
O95831-1#86	0	3	3	O95831-1	191	194	+	3	O95831-1	0	613	ENST00000675857.1	82	1915	++	242	O95831-1#86	0	9	ENST00000675857.1	649	658	+	9	0	-6	1685
O95831-1#86	0	3	3	O95831-1	191	194	+	3	O95831-1	0	613	ENST00000675427.1	89	1925	++	240	O95831-1#86	0	9	ENST00000675427.1	662	671	+	9	0	-6	1686
O95831-1#86	0	3	3	O95831-1	191	194	+	3	O95831-1	0	524	ENST00000675240.1	169	1741	++	239	O95831-1#86	0	9	ENST00000675240.1	742	751	+	9	0	-6	1687
O95831-1#86	0	3	3	O95831-1	191	194	+	3	O95831-1	0	613	ENST00000675092.1	90	1956	++	238	O95831-1#86	0	9	ENST00000675092.1	663	672	+	9	0	-6	1688
O95831-1#86	0	3	3	O95831-1	191	194	+	3	O95831-1	0	613	ENST00000675050.1	71	1898	++	237	O95831-1#86	0	9	ENST00000675050.1	632	641	+	9	0	-6	1689
O95831-1#86	0	3	3	O95831-1	191	194	+	3	O95831-1	0	459	ENST00000675037.1	56	1433	++	236	O95831-1#86	0	9	ENST00000675037.1	629	638	+	9	0	-6	1690
O95831-1#86	0	3	3	O95831-1	191	194	+	3	O95831-1	100	388	ENST00000674957.1	1	865	++	234	O95831-1#86	0	9	ENST00000674957.1	274	283	+	9	0	-6	1691
O95831-1#86	0	3	3	O95831-1	191	194	+	3	O95831-1	0	238	ENST00000674722.1	13	727	++	233	O95831-1#86	0	9	ENST00000674722.1	586	595	+	9	0	-6	1692
O95831-1#86	0	3	3	O95831-1	191	194	+	3	O95831-1	0	587	ENST00000674546.1	185	1954	++	230	O95831-1#86	0	9	ENST00000674546.1	758	767	+	9	0	-6	1693
O95831-1#86	0	3	3	O95831-1	191	194	+	3	O95831-1	0	322	ENST00000535724.6	8	974	++	150	O95831-1#86	0	9	ENST00000535724.6	581	590	+	9	0	-6	1694
O95831-1#86	0	3	3	O95831-1	191	194	+	3	O95831-1	0	435	ENST00000416073.7	37	1336	++	76	O95831-1#86	0	9	ENST00000416073.7	604	613	+	9	0	-6	1695
O95831-1#86	0	3	3	O95831-1	191	194	+	3	O95831-1	0	613	ENST00000319908.8	174	2007	++	26	O95831-1#86	0	9	ENST00000319908.8	747	756	+	9	0	-6	1696
O95831-1#86	0	3	3	O95831-1	191	194	+	3	O95831-1	0	613	ENST00000287295.8	185	2024	++	18	O95831-1#86	0	9	ENST00000287295.8	758	767	+	9	0	-6	1697
O95831-1#87	0	7	7	O95831-1	199	206	+	7	O95831-1	0	613	ENST00000676436.1	34	1861	++	246	O95831-1#87	0	21	ENST00000676436.1	625	646	+	21	0	-14	1698
O95831-1#87	0	7	7	O95831-1	199	206	+	7	O95831-1	0	613	ENST00000676328.1	56	1892	++	245	O95831-1#87	0	21	ENST00000676328.1	653	674	+	21	0	-14	1699
O95831-1#87	0	7	7	O95831-1	199	206	+	7	O95831-1	0	613	ENST00000676229.1	223	2050	++	244	O95831-1#87	0	21	ENST00000676229.1	808	829	+	21	0	-14	1700
O95831-1#87	0	7	7	O95831-1	199	206	+	7	O95831-1	0	613	ENST00000675857.1	82	1915	++	242	O95831-1#87	0	21	ENST00000675857.1	673	694	+	21	0	-14	1701
O95831-1#87	0	7	7	O95831-1	199	206	+	7	O95831-1	0	613	ENST00000675427.1	89	1925	++	240	O95831-1#87	0	21	ENST00000675427.1	686	707	+	21	0	-14	1702
O95831-1#87	0	7	7	O95831-1	199	206	+	7	O95831-1	0	524	ENST00000675240.1	169	1741	++	239	O95831-1#87	0	21	ENST00000675240.1	766	787	+	21	0	-14	1703
O95831-1#87	0	7	7	O95831-1	199	206	+	7	O95831-1	0	613	ENST00000675092.1	90	1956	++	238	O95831-1#87	0	21	ENST00000675092.1	687	708	+	21	0	-14	1704
O95831-1#87	0	7	7	O95831-1	199	206	+	7	O95831-1	0	613	ENST00000675050.1	71	1898	++	237	O95831-1#87	0	21	ENST00000675050.1	656	677	+	21	0	-14	1705
O95831-1#87	0	7	7	O95831-1	199	206	+	7	O95831-1	0	459	ENST00000675037.1	56	1433	++	236	O95831-1#87	0	21	ENST00000675037.1	653	674	+	21	0	-14	1706
O95831-1#87	0	7	7	O95831-1	199	206	+	7	O95831-1	100	388	ENST00000674957.1	1	865	++	234	O95831-1#87	0	21	ENST00000674957.1	298	319	+	21	0	-14	1707
O95831-1#87	0	7	7	O95831-1	199	206	+	7	O95831-1	0	238	ENST00000674722.1	13	727	++	233	O95831-1#87	0	21	ENST00000674722.1	610	631	+	21	0	-14	1708
O95831-1#87	0	7	7	O95831-1	199	206	+	7	O95831-1	0	587	ENST00000674546.1	185	1954	++	230	O95831-1#87	0	21	ENST00000674546.1	782	803	+	21	0	-14	1709
O95831-1#87	0	7	7	O95831-1	199	206	+	7	O95831-1	0	322	ENST00000535724.6	8	974	++	150	O95831-1#87	0	21	ENST00000535724.6	605	626	+	21	0	-14	1710
O95831-1#87	0	7	7	O95831-1	199	206	+	7	O95831-1	0	435	ENST00000416073.7	37	1336	++	76	O95831-1#87	0	21	ENST00000416073.7	628	649	+	21	0	-14	1711
O95831-1#87	0	7	7	O95831-1	199	206	+	7	O95831-1	0	613	ENST00000319908.8	174	2007	++	26	O95831-1#87	0	21	ENST00000319908.8	771	792	+	21	0	-14	1712
O95831-1#87	0	7	7	O95831-1	199	206	+	7	O95831-1	0	613	ENST00000287295.8	185	2024	++	18	O95831-1#87	0	21	ENST00000287295.8	782	803	+	21	0	-14	1713
O95831-1#88	0	3	3	O95831-1	207	210	+	3	O95831-1	0	613	ENST00000676436.1	34	1861	++	246	O95831-1#88	0	9	ENST00000676436.1	649	658	+	9	0	-6	1714
O95831-1#88	0	3	3	O95831-1	207	210	+	3	O95831-1	0	613	ENST00000676328.1	56	1892	++	245	O95831-1#88	0	9	ENST00000676328.1	677	686	+	9	0	-6	1715
O95831-1#88	0	3	3	O95831-1	207	210	+	3	O95831-1	0	613	ENST00000676229.1	223	2050	++	244	O95831-1#88	0	9	ENST00000676229.1	832	841	+	9	0	-6	1716
O95831-1#88	0	3	3	O95831-1	207	210	+	3	O95831-1	0	613	ENST00000675857.1	82	1915	++	242	O95831-1#88	0	9	ENST00000675857.1	697	706	+	9	0	-6	1717
O95831-1#88	0	3	3	O95831-1	207	210	+	3	O95831-1	0	613	ENST00000675427.1	89	1925	++	240	O95831-1#88	0	9	ENST00000675427.1	710	719	+	9	0	-6	1718
O95831-1#88	0	3	3	O95831-1	207	210	+	3	O95831-1	0	524	ENST00000675240.1	169	1741	++	239	O95831-1#88	0	9	ENST00000675240.1	790	799	+	9	0	-6	1719
O95831-1#88	0	3	3	O95831-1	207	210	+	3	O95831-1	0	613	ENST00000675092.1	90	1956	++	238	O95831-1#88	0	9	ENST00000675092.1	711	720	+	9	0	-6	1720
O95831-1#88	0	3	3	O95831-1	207	210	+	3	O95831-1	0	613	ENST00000675050.1	71	1898	++	237	O95831-1#88	0	9	ENST00000675050.1	680	689	+	9	0	-6	1721
O95831-1#88	0	3	3	O95831-1	207	210	+	3	O95831-1	0	459	ENST00000675037.1	56	1433	++	236	O95831-1#88	0	9	ENST00000675037.1	677	686	+	9	0	-6	1722
O95831-1#88	0	3	3	O95831-1	207	210	+	3	O95831-1	100	388	ENST00000674957.1	1	865	++	234	O95831-1#88	0	9	ENST00000674957.1	322	331	+	9	0	-6	1723
O95831-1#88	0	3	3	O95831-1	207	210	+	3	O95831-1	0	238	ENST00000674722.1	13	727	++	233	O95831-1#88	0	9	ENST00000674722.1	634	643	+	9	0	-6	1724
O95831-1#88	0	3	3	O95831-1	207	210	+	3	O95831-1	0	587	ENST00000674546.1	185	1954	++	230	O95831-1#88	0	9	ENST00000674546.1	806	815	+	9	0	-6	1725
O95831-1#88	0	3	3	O95831-1	207	210	+	3	O95831-1	0	322	ENST00000535724.6	8	974	++	150	O95831-1#88	0	9	ENST00000535724.6	629	638	+	9	0	-6	1726
O95831-1#88	0	3	3	O95831-1	207	210	+	3	O95831-1	0	435	ENST00000416073.7	37	1336	++	76	O95831-1#88	0	9	ENST00000416073.7	652	661	+	9	0	-6	1727
O95831-1#88	0	3	3	O95831-1	207	210	+	3	O95831-1	0	613	ENST00000319908.8	174	2007	++	26	O95831-1#88	0	9	ENST00000319908.8	795	804	+	9	0	-6	1728
O95831-1#88	0	3	3	O95831-1	207	210	+	3	O95831-1	0	613	ENST00000287295.8	185	2024	++	18	O95831-1#88	0	9	ENST00000287295.8	806	815	+	9	0	-6	1729
O95831-1#89	0	6	6	O95831-1	213	219	+	6	O95831-1	0	613	ENST00000676436.1	34	1861	++	246	O95831-1#89	0	18	ENST00000676436.1	667	685	+	18	0	-12	1730
O95831-1#89	0	6	6	O95831-1	213	219	+	6	O95831-1	0	613	ENST00000676328.1	56	1892	++	245	O95831-1#89	0	18	ENST00000676328.1	695	713	+	18	0	-12	1731
O95831-1#89	0	6	6	O95831-1	213	219	+	6	O95831-1	0	613	ENST00000676229.1	223	2050	++	244	O95831-1#89	0	18	ENST00000676229.1	850	868	+	18	0	-12	1732
O95831-1#89	0	6	6	O95831-1	213	219	+	6	O95831-1	0	613	ENST00000675857.1	82	1915	++	242	O95831-1#89	0	18	ENST00000675857.1	715	733	+	18	0	-12	1733
O95831-1#89	0	6	6	O95831-1	213	219	+	6	O95831-1	0	613	ENST00000675427.1	89	1925	++	240	O95831-1#89	0	18	ENST00000675427.1	728	746	+	18	0	-12	1734
O95831-1#89	0	6	6	O95831-1	213	219	+	6	O95831-1	0	524	ENST00000675240.1	169	1741	++	239	O95831-1#89	0	18	ENST00000675240.1	808	826	+	18	0	-12	1735
O95831-1#89	0	6	6	O95831-1	213	219	+	6	O95831-1	0	613	ENST00000675092.1	90	1956	++	238	O95831-1#89	0	18	ENST00000675092.1	729	747	+	18	0	-12	1736
O95831-1#89	0	6	6	O95831-1	213	219	+	6	O95831-1	0	613	ENST00000675050.1	71	1898	++	237	O95831-1#89	0	18	ENST00000675050.1	698	716	+	18	0	-12	1737
O95831-1#89	0	6	6	O95831-1	213	219	+	6	O95831-1	0	459	ENST00000675037.1	56	1433	++	236	O95831-1#89	0	18	ENST00000675037.1	695	713	+	18	0	-12	1738
O95831-1#89	0	6	6	O95831-1	213	219	+	6	O95831-1	100	388	ENST00000674957.1	1	865	++	234	O95831-1#89	0	18	ENST00000674957.1	340	358	+	18	0	-12	1739
O95831-1#89	0	6	6	O95831-1	213	219	+	6	O95831-1	0	238	ENST00000674722.1	13	727	++	233	O95831-1#89	0	18	ENST00000674722.1	652	670	+	18	0	-12	1740
O95831-1#89	0	6	6	O95831-1	213	219	+	6	O95831-1	0	587	ENST00000674546.1	185	1954	++	230	O95831-1#89	0	18	ENST00000674546.1	824	842	+	18	0	-12	1741
O95831-1#89	0	6	6	O95831-1	213	219	+	6	O95831-1	0	322	ENST00000535724.6	8	974	++	150	O95831-1#89	0	18	ENST00000535724.6	647	665	+	18	0	-12	1742
O95831-1#89	0	6	6	O95831-1	213	219	+	6	O95831-1	0	435	ENST00000416073.7	37	1336	++	76	O95831-1#89	0	18	ENST00000416073.7	670	688	+	18	0	-12	1743
O95831-1#89	0	6	6	O95831-1	213	219	+	6	O95831-1	0	613	ENST00000319908.8	174	2007	++	26	O95831-1#89	0	18	ENST00000319908.8	813	831	+	18	0	-12	1744
O95831-1#89	0	6	6	O95831-1	213	219	+	6	O95831-1	0	613	ENST00000287295.8	185	2024	++	18	O95831-1#89	0	18	ENST00000287295.8	824	842	+	18	0	-12	1745
O95831-1#90	0	5	5	O95831-1	223	228	+	5	O95831-1	0	613	ENST00000676436.1	34	1861	++	246	O95831-1#90	0	15	ENST00000676436.1	697	712	+	15	0	-10	1746
O95831-1#90	0	5	5	O95831-1	223	228	+	5	O95831-1	0	613	ENST00000676328.1	56	1892	++	245	O95831-1#90	0	15	ENST00000676328.1	725	740	+	15	0	-10	1747
O95831-1#90	0	5	5	O95831-1	223	228	+	5	O95831-1	0	613	ENST00000676229.1	223	2050	++	244	O95831-1#90	0	15	ENST00000676229.1	880	895	+	15	0	-10	1748
O95831-1#90	0	5	5	O95831-1	223	228	+	5	O95831-1	0	613	ENST00000675857.1	82	1915	++	242	O95831-1#90	0	15	ENST00000675857.1	745	760	+	15	0	-10	1749
O95831-1#90	0	5	5	O95831-1	223	228	+	5	O95831-1	0	613	ENST00000675427.1	89	1925	++	240	O95831-1#90	0	15	ENST00000675427.1	758	773	+	15	0	-10	1750
O95831-1#90	0	5	5	O95831-1	223	228	+	5	O95831-1	0	524	ENST00000675240.1	169	1741	++	239	O95831-1#90	0	15	ENST00000675240.1	838	853	+	15	0	-10	1751
O95831-1#90	0	5	5	O95831-1	223	228	+	5	O95831-1	0	613	ENST00000675092.1	90	1956	++	238	O95831-1#90	0	15	ENST00000675092.1	759	774	+	15	0	-10	1752
O95831-1#90	0	5	5	O95831-1	223	228	+	5	O95831-1	0	613	ENST00000675050.1	71	1898	++	237	O95831-1#90	0	15	ENST00000675050.1	728	743	+	15	0	-10	1753
O95831-1#90	0	5	5	O95831-1	223	228	+	5	O95831-1	0	459	ENST00000675037.1	56	1433	++	236	O95831-1#90	0	15	ENST00000675037.1	725	740	+	15	0	-10	1754
O95831-1#90	0	5	5	O95831-1	223	228	+	5	O95831-1	100	388	ENST00000674957.1	1	865	++	234	O95831-1#90	0	15	ENST00000674957.1	370	385	+	15	0	-10	1755
O95831-1#90	0	5	5	O95831-1	223	228	+	5	O95831-1	0	238	ENST00000674722.1	13	727	++	233	O95831-1#90	0	15	ENST00000674722.1	682	697	+	15	0	-10	1756
O95831-1#90	0	5	5	O95831-1	223	228	+	5	O95831-1	0	587	ENST00000674546.1	185	1954	++	230	O95831-1#90	0	15	ENST00000674546.1	854	869	+	15	0	-10	1757
O95831-1#90	0	5	5	O95831-1	223	228	+	5	O95831-1	0	322	ENST00000535724.6	8	974	++	150	O95831-1#90	0	15	ENST00000535724.6	677	692	+	15	0	-10	1758
O95831-1#90	0	5	5	O95831-1	223	228	+	5	O95831-1	0	435	ENST00000416073.7	37	1336	++	76	O95831-1#90	0	15	ENST00000416073.7	700	715	+	15	0	-10	1759
O95831-1#90	0	5	5	O95831-1	223	228	+	5	O95831-1	0	613	ENST00000319908.8	174	2007	++	26	O95831-1#90	0	15	ENST00000319908.8	843	858	+	15	0	-10	1760
O95831-1#90	0	5	5	O95831-1	223	228	+	5	O95831-1	0	613	ENST00000287295.8	185	2024	++	18	O95831-1#90	0	15	ENST00000287295.8	854	869	+	15	0	-10	1761
O95831-1#91	0	5	5	O95831-1	232	237	+	5	O95831-1	0	613	ENST00000676436.1	34	1861	++	246	O95831-1#91	0	15	ENST00000676436.1	724	739	+	15	0	-10	1762
O95831-1#91	0	5	5	O95831-1	232	237	+	5	O95831-1	0	613	ENST00000676328.1	56	1892	++	245	O95831-1#91	0	15	ENST00000676328.1	752	767	+	15	0	-10	1763
O95831-1#91	0	5	5	O95831-1	232	237	+	5	O95831-1	0	613	ENST00000676229.1	223	2050	++	244	O95831-1#91	0	15	ENST00000676229.1	907	922	+	15	0	-10	1764
O95831-1#91	0	5	5	O95831-1	232	237	+	5	O95831-1	0	613	ENST00000675857.1	82	1915	++	242	O95831-1#91	0	15	ENST00000675857.1	772	787	+	15	0	-10	1765
O95831-1#91	0	5	5	O95831-1	232	237	+	5	O95831-1	0	613	ENST00000675427.1	89	1925	++	240	O95831-1#91	0	15	ENST00000675427.1	785	800	+	15	0	-10	1766
O95831-1#91	0	5	5	O95831-1	232	237	+	5	O95831-1	0	524	ENST00000675240.1	169	1741	++	239	O95831-1#91	0	15	ENST00000675240.1	865	880	+	15	0	-10	1767
O95831-1#91	0	5	5	O95831-1	232	237	+	5	O95831-1	0	613	ENST00000675092.1	90	1956	++	238	O95831-1#91	0	15	ENST00000675092.1	786	801	+	15	0	-10	1768
O95831-1#91	0	5	5	O95831-1	232	237	+	5	O95831-1	0	613	ENST00000675050.1	71	1898	++	237	O95831-1#91	0	15	ENST00000675050.1	755	770	+	15	0	-10	1769
O95831-1#91	0	5	5	O95831-1	232	237	+	5	O95831-1	0	459	ENST00000675037.1	56	1433	++	236	O95831-1#91	0	15	ENST00000675037.1	752	767	+	15	0	-10	1770
O95831-1#91	0	5	5	O95831-1	232	237	+	5	O95831-1	100	388	ENST00000674957.1	1	865	++	234	O95831-1#91	0	15	ENST00000674957.1	397	412	+	15	0	-10	1771
O95831-1#91	0	5	5	O95831-1	232	237	+	5	O95831-1	0	238	ENST00000674722.1	13	727	++	233	O95831-1#91	0	15	ENST00000674722.1	709	724	+	15	0	-10	1772
O95831-1#91	0	5	5	O95831-1	232	237	+	5	O95831-1	0	587	ENST00000674546.1	185	1954	++	230	O95831-1#91	0	15	ENST00000674546.1	881	896	+	15	0	-10	1773
O95831-1#91	0	5	5	O95831-1	232	237	+	5	O95831-1	0	322	ENST00000535724.6	8	974	++	150	O95831-1#91	0	15	ENST00000535724.6	704	719	+	15	0	-10	1774
O95831-1#91	0	5	5	O95831-1	232	237	+	5	O95831-1	0	435	ENST00000416073.7	37	1336	++	76	O95831-1#91	0	15	ENST00000416073.7	727	742	+	15	0	-10	1775
O95831-1#91	0	5	5	O95831-1	232	237	+	5	O95831-1	0	613	ENST00000319908.8	174	2007	++	26	O95831-1#91	0	15	ENST00000319908.8	870	885	+	15	0	-10	1776
O95831-1#91	0	5	5	O95831-1	232	237	+	5	O95831-1	0	613	ENST00000287295.8	185	2024	++	18	O95831-1#91	0	15	ENST00000287295.8	881	896	+	15	0	-10	1777
O95831-1#92	0	4	4	O95831-1	237	241	+	4	O95831-1	0	613	ENST00000676436.1	34	1861	++	246	O95831-1#92	0	12	ENST00000676436.1	739	751	+	12	0	-8	1778
O95831-1#92	0	4	4	O95831-1	237	241	+	4	O95831-1	0	613	ENST00000676328.1	56	1892	++	245	O95831-1#92	0	12	ENST00000676328.1	767	779	+	12	0	-8	1779
O95831-1#92	0	4	4	O95831-1	237	241	+	4	O95831-1	0	613	ENST00000676229.1	223	2050	++	244	O95831-1#92	0	12	ENST00000676229.1	922	934	+	12	0	-8	1780
O95831-1#92	0	4	4	O95831-1	237	241	+	4	O95831-1	0	613	ENST00000675857.1	82	1915	++	242	O95831-1#92	0	12	ENST00000675857.1	787	799	+	12	0	-8	1781
O95831-1#92	0	4	4	O95831-1	237	241	+	4	O95831-1	0	613	ENST00000675427.1	89	1925	++	240	O95831-1#92	0	12	ENST00000675427.1	800	812	+	12	0	-8	1782
O95831-1#92	0	4	4	O95831-1	237	241	+	4	O95831-1	0	524	ENST00000675240.1	169	1741	++	239	O95831-1#92	0	12	ENST00000675240.1	880	892	+	12	0	-8	1783
O95831-1#92	0	4	4	O95831-1	237	241	+	4	O95831-1	0	613	ENST00000675092.1	90	1956	++	238	O95831-1#92	0	12	ENST00000675092.1	801	813	+	12	0	-8	1784
O95831-1#92	0	4	4	O95831-1	237	241	+	4	O95831-1	0	613	ENST00000675050.1	71	1898	++	237	O95831-1#92	0	12	ENST00000675050.1	770	782	+	12	0	-8	1785
O95831-1#92	0	4	4	O95831-1	237	241	+	4	O95831-1	0	459	ENST00000675037.1	56	1433	++	236	O95831-1#92	0	12	ENST00000675037.1	767	779	+	12	0	-8	1786
O95831-1#92	0	4	4	O95831-1	237	241	+	4	O95831-1	100	388	ENST00000674957.1	1	865	++	234	O95831-1#92	0	12	ENST00000674957.1	412	424	+	12	0	-8	1787
O95831-1#92	0	4	4	O95831-1	237	241	+	4	O95831-1	0	238	ENST00000674722.1	13	727	++	233	O95831-1#92	0	3	ENST00000674722.1	724	727	+	3	0	1	1788
O95831-1#92	0	4	4	O95831-1	237	241	+	4	O95831-1	0	587	ENST00000674546.1	185	1954	++	230	O95831-1#92	0	12	ENST00000674546.1	896	908	+	12	0	-8	1789
O95831-1#92	0	4	4	O95831-1	237	241	+	4	O95831-1	0	322	ENST00000535724.6	8	974	++	150	O95831-1#92	0	12	ENST00000535724.6	719	731	+	12	0	-8	1790
O95831-1#92	0	4	4	O95831-1	237	241	+	4	O95831-1	0	435	ENST00000416073.7	37	1336	++	76	O95831-1#92	0	12	ENST00000416073.7	742	754	+	12	0	-8	1791
O95831-1#92	0	4	4	O95831-1	237	241	+	4	O95831-1	0	613	ENST00000319908.8	174	2007	++	26	O95831-1#92	0	12	ENST00000319908.8	885	897	+	12	0	-8	1792
O95831-1#92	0	4	4	O95831-1	237	241	+	4	O95831-1	0	613	ENST00000287295.8	185	2024	++	18	O95831-1#92	0	12	ENST00000287295.8	896	908	+	12	0	-8	1793
O95831-1#93	0	4	4	O95831-1	241	245	+	4	O95831-1	0	613	ENST00000676436.1	34	1861	++	246	O95831-1#93	0	12	ENST00000676436.1	751	763	+	12	0	-8	1794
O95831-1#93	0	4	4	O95831-1	241	245	+	4	O95831-1	0	613	ENST00000676328.1	56	1892	++	245	O95831-1#93	0	12	ENST00000676328.1	779	791	+	12	0	-8	1795
O95831-1#93	0	4	4	O95831-1	241	245	+	4	O95831-1	0	613	ENST00000676229.1	223	2050	++	244	O95831-1#93	0	12	ENST00000676229.1	934	946	+	12	0	-8	1796
O95831-1#93	0	4	4	O95831-1	241	245	+	4	O95831-1	0	613	ENST00000675857.1	82	1915	++	242	O95831-1#93	0	12	ENST00000675857.1	799	811	+	12	0	-8	1797
O95831-1#93	0	4	4	O95831-1	241	245	+	4	O95831-1	0	613	ENST00000675427.1	89	1925	++	240	O95831-1#93	0	12	ENST00000675427.1	812	824	+	12	0	-8	1798
O95831-1#93	0	4	4	O95831-1	241	245	+	4	O95831-1	0	524	ENST00000675240.1	169	1741	++	239	O95831-1#93	0	12	ENST00000675240.1	892	904	+	12	0	-8	1799
O95831-1#93	0	4	4	O95831-1	241	245	+	4	O95831-1	0	613	ENST00000675092.1	90	1956	++	238	O95831-1#93	0	12	ENST00000675092.1	813	825	+	12	0	-8	1800
O95831-1#93	0	4	4	O95831-1	241	245	+	4	O95831-1	0	613	ENST00000675050.1	71	1898	++	237	O95831-1#93	0	12	ENST00000675050.1	782	794	+	12	0	-8	1801
O95831-1#93	0	4	4	O95831-1	241	245	+	4	O95831-1	0	459	ENST00000675037.1	56	1433	++	236	O95831-1#93	0	12	ENST00000675037.1	779	791	+	12	0	-8	1802
O95831-1#93	0	4	4	O95831-1	241	245	+	4	O95831-1	100	388	ENST00000674957.1	1	865	++	234	O95831-1#93	0	12	ENST00000674957.1	424	436	+	12	0	-8	1803
O95831-1#93	0	4	4	O95831-1	241	245	+	4	O95831-1	0	587	ENST00000674546.1	185	1954	++	230	O95831-1#93	0	12	ENST00000674546.1	908	920	+	12	0	-8	1804
O95831-1#93	0	4	4	O95831-1	241	245	+	4	O95831-1	0	322	ENST00000535724.6	8	974	++	150	O95831-1#93	0	12	ENST00000535724.6	731	743	+	12	0	-8	1805
O95831-1#93	0	4	4	O95831-1	241	245	+	4	O95831-1	0	435	ENST00000416073.7	37	1336	++	76	O95831-1#93	0	12	ENST00000416073.7	754	766	+	12	0	-8	1806
O95831-1#93	0	4	4	O95831-1	241	245	+	4	O95831-1	0	613	ENST00000319908.8	174	2007	++	26	O95831-1#93	0	12	ENST00000319908.8	897	909	+	12	0	-8	1807
O95831-1#93	0	4	4	O95831-1	241	245	+	4	O95831-1	0	613	ENST00000287295.8	185	2024	++	18	O95831-1#93	0	12	ENST00000287295.8	908	920	+	12	0	-8	1808
O95831-1#94	0	9	9	O95831-1	249	258	+	9	O95831-1	0	613	ENST00000676436.1	34	1861	++	246	O95831-1#94	0	27	ENST00000676436.1	775	802	+	27	0	-18	1809
O95831-1#94	0	9	9	O95831-1	249	258	+	9	O95831-1	0	613	ENST00000676328.1	56	1892	++	245	O95831-1#94	0	27	ENST00000676328.1	803	830	+	27	0	-18	1810
O95831-1#94	0	9	9	O95831-1	249	258	+	9	O95831-1	0	613	ENST00000676229.1	223	2050	++	244	O95831-1#94	0	27	ENST00000676229.1	958	985	+	27	0	-18	1811
O95831-1#94	0	9	9	O95831-1	249	258	+	9	O95831-1	0	613	ENST00000675857.1	82	1915	++	242	O95831-1#94	0	27	ENST00000675857.1	823	850	+	27	0	-18	1812
O95831-1#94	0	9	9	O95831-1	249	258	+	9	O95831-1	0	613	ENST00000675427.1	89	1925	++	240	O95831-1#94	0	27	ENST00000675427.1	836	863	+	27	0	-18	1813
O95831-1#94	0	9	9	O95831-1	249	258	+	9	O95831-1	0	524	ENST00000675240.1	169	1741	++	239	O95831-1#94	0	27	ENST00000675240.1	916	943	+	27	0	-18	1814
O95831-1#94	0	9	9	O95831-1	249	258	+	9	O95831-1	0	613	ENST00000675092.1	90	1956	++	238	O95831-1#94	0	27	ENST00000675092.1	837	864	+	27	0	-18	1815
O95831-1#94	0	9	9	O95831-1	249	258	+	9	O95831-1	0	613	ENST00000675050.1	71	1898	++	237	O95831-1#94	0	27	ENST00000675050.1	806	833	+	27	0	-18	1816
O95831-1#94	0	9	9	O95831-1	249	258	+	9	O95831-1	0	459	ENST00000675037.1	56	1433	++	236	O95831-1#94	0	27	ENST00000675037.1	803	830	+	27	0	-18	1817
O95831-1#94	0	9	9	O95831-1	249	258	+	9	O95831-1	100	388	ENST00000674957.1	1	865	++	234	O95831-1#94	0	27	ENST00000674957.1	448	475	+	27	0	-18	1818
O95831-1#94	0	9	9	O95831-1	249	258	+	9	O95831-1	0	587	ENST00000674546.1	185	1954	++	230	O95831-1#94	0	27	ENST00000674546.1	932	959	+	27	0	-18	1819
O95831-1#94	0	9	9	O95831-1	249	258	+	9	O95831-1	0	322	ENST00000535724.6	8	974	++	150	O95831-1#94	0	27	ENST00000535724.6	755	782	+	27	0	-18	1820
O95831-1#94	0	9	9	O95831-1	249	258	+	9	O95831-1	0	435	ENST00000416073.7	37	1336	++	76	O95831-1#94	0	27	ENST00000416073.7	778	805	+	27	0	-18	1821
O95831-1#94	0	9	9	O95831-1	249	258	+	9	O95831-1	0	613	ENST00000319908.8	174	2007	++	26	O95831-1#94	0	27	ENST00000319908.8	921	948	+	27	0	-18	1822
O95831-1#94	0	9	9	O95831-1	249	258	+	9	O95831-1	0	613	ENST00000287295.8	185	2024	++	18	O95831-1#94	0	27	ENST00000287295.8	932	959	+	27	0	-18	1823
O95831-1#95	0	3	3	O95831-1	261	264	+	3	O95831-1	0	613	ENST00000676436.1	34	1861	++	246	O95831-1#95	0	9	ENST00000676436.1	811	820	+	9	0	-6	1824
O95831-1#95	0	3	3	O95831-1	261	264	+	3	O95831-1	0	613	ENST00000676328.1	56	1892	++	245	O95831-1#95	3	9	ENST00000676328.1	839	845	+	6	3	-6	1825
O95831-1#95	0	3	3	O95831-1	261	264	+	3	O95831-1	0	613	ENST00000676229.1	223	2050	++	244	O95831-1#95	0	9	ENST00000676229.1	994	1003	+	9	0	-6	1826
O95831-1#95	0	3	3	O95831-1	261	264	+	3	O95831-1	0	613	ENST00000675857.1	82	1915	++	242	O95831-1#95	0	9	ENST00000675857.1	859	868	+	9	0	-6	1827
O95831-1#95	0	3	3	O95831-1	261	264	+	3	O95831-1	0	613	ENST00000675427.1	89	1925	++	240	O95831-1#95	0	9	ENST00000675427.1	872	881	+	9	0	-6	1828
O95831-1#95	0	3	3	O95831-1	261	264	+	3	O95831-1	0	524	ENST00000675240.1	169	1741	++	239	O95831-1#95	0	9	ENST00000675240.1	952	961	+	9	0	-6	1829
O95831-1#95	0	3	3	O95831-1	261	264	+	3	O95831-1	0	613	ENST00000675092.1	90	1956	++	238	O95831-1#95	0	9	ENST00000675092.1	873	882	+	9	0	-6	1830
O95831-1#95	0	3	3	O95831-1	261	264	+	3	O95831-1	0	613	ENST00000675050.1	71	1898	++	237	O95831-1#95	0	9	ENST00000675050.1	842	851	+	9	0	-6	1831
O95831-1#95	0	3	3	O95831-1	261	264	+	3	O95831-1	0	459	ENST00000675037.1	56	1433	++	236	O95831-1#95	0	9	ENST00000675037.1	839	848	+	9	0	-6	1832
O95831-1#95	0	3	3	O95831-1	261	264	+	3	O95831-1	100	388	ENST00000674957.1	1	865	++	234	O95831-1#95	0	9	ENST00000674957.1	484	493	+	9	0	-6	1833
O95831-1#95	0	3	3	O95831-1	261	264	+	3	O95831-1	0	587	ENST00000674546.1	185	1954	++	230	O95831-1#95	0	9	ENST00000674546.1	968	977	+	9	0	-6	1834
O95831-1#95	0	3	3	O95831-1	261	264	+	3	O95831-1	0	322	ENST00000535724.6	8	974	++	150	O95831-1#95	0	9	ENST00000535724.6	791	800	+	9	0	-6	1835
O95831-1#95	0	3	3	O95831-1	261	264	+	3	O95831-1	0	435	ENST00000416073.7	37	1336	++	76	O95831-1#95	0	9	ENST00000416073.7	814	823	+	9	0	-6	1836
O95831-1#95	0	3	3	O95831-1	261	264	+	3	O95831-1	0	613	ENST00000319908.8	174	2007	++	26	O95831-1#95	0	9	ENST00000319908.8	954	963	+	9	0	-6	1837
O95831-1#95	0	3	3	O95831-1	261	264	+	3	O95831-1	0	613	ENST00000287295.8	185	2024	++	18	O95831-1#95	0	9	ENST00000287295.8	968	977	+	9	0	-6	1838
O95831-1#96	0	4	4	O95831-1	267	271	+	4	O95831-1	0	613	ENST00000676436.1	34	1861	++	246	O95831-1#96	0	12	ENST00000676436.1	829	841	+	12	0	-8	1839
O95831-1#96	0	4	4	O95831-1	267	271	+	4	O95831-1	0	613	ENST00000676328.1	56	1892	++	245	O95831-1#96	0	12	ENST00000676328.1	854	866	+	12	0	-8	1840
O95831-1#96	0	4	4	O95831-1	267	271	+	4	O95831-1	0	613	ENST00000676229.1	223	2050	++	244	O95831-1#96	0	12	ENST00000676229.1	1012	1024	+	12	0	-8	1841
O95831-1#96	0	4	4	O95831-1	267	271	+	4	O95831-1	0	613	ENST00000675857.1	82	1915	++	242	O95831-1#96	0	12	ENST00000675857.1	877	889	+	12	0	-8	1842
O95831-1#96	0	4	4	O95831-1	267	271	+	4	O95831-1	0	613	ENST00000675427.1	89	1925	++	240	O95831-1#96	0	12	ENST00000675427.1	890	902	+	12	0	-8	1843
O95831-1#96	0	4	4	O95831-1	267	271	+	4	O95831-1	0	524	ENST00000675240.1	169	1741	++	239	O95831-1#96	0	12	ENST00000675240.1	970	982	+	12	0	-8	1844
O95831-1#96	0	4	4	O95831-1	267	271	+	4	O95831-1	0	613	ENST00000675092.1	90	1956	++	238	O95831-1#96	0	12	ENST00000675092.1	891	903	+	12	0	-8	1845
O95831-1#96	0	4	4	O95831-1	267	271	+	4	O95831-1	0	613	ENST00000675050.1	71	1898	++	237	O95831-1#96	0	12	ENST00000675050.1	860	872	+	12	0	-8	1846
O95831-1#96	0	4	4	O95831-1	267	271	+	4	O95831-1	0	459	ENST00000675037.1	56	1433	++	236	O95831-1#96	0	12	ENST00000675037.1	857	869	+	12	0	-8	1847
O95831-1#96	0	4	4	O95831-1	267	271	+	4	O95831-1	100	388	ENST00000674957.1	1	865	++	234	O95831-1#96	0	12	ENST00000674957.1	502	514	+	12	0	-8	1848
O95831-1#96	0	4	4	O95831-1	267	271	+	4	O95831-1	0	587	ENST00000674546.1	185	1954	++	230	O95831-1#96	0	12	ENST00000674546.1	986	998	+	12	0	-8	1849
O95831-1#96	0	4	4	O95831-1	267	271	+	4	O95831-1	0	322	ENST00000535724.6	8	974	++	150	O95831-1#96	0	12	ENST00000535724.6	809	821	+	12	0	-8	1850
O95831-1#96	0	4	4	O95831-1	267	271	+	4	O95831-1	0	435	ENST00000416073.7	37	1336	++	76	O95831-1#96	0	12	ENST00000416073.7	832	844	+	12	0	-8	1851
O95831-1#96	0	4	4	O95831-1	267	271	+	4	O95831-1	0	613	ENST00000319908.8	174	2007	++	26	O95831-1#96	0	12	ENST00000319908.8	972	984	+	12	0	-8	1852
O95831-1#96	0	4	4	O95831-1	267	271	+	4	O95831-1	0	613	ENST00000287295.8	185	2024	++	18	O95831-1#96	0	12	ENST00000287295.8	986	998	+	12	0	-8	1853
O95831-1#97	0	5	5	O95831-1	274	279	+	5	O95831-1	0	613	ENST00000676436.1	34	1861	++	246	O95831-1#97	0	15	ENST00000676436.1	850	865	+	15	0	-10	1854
O95831-1#97	0	5	5	O95831-1	274	279	+	5	O95831-1	0	613	ENST00000676328.1	56	1892	++	245	O95831-1#97	0	15	ENST00000676328.1	875	890	+	15	0	-10	1855
O95831-1#97	0	5	5	O95831-1	274	279	+	5	O95831-1	0	613	ENST00000676229.1	223	2050	++	244	O95831-1#97	0	15	ENST00000676229.1	1033	1048	+	15	0	-10	1856
O95831-1#97	0	5	5	O95831-1	274	279	+	5	O95831-1	0	613	ENST00000675857.1	82	1915	++	242	O95831-1#97	0	15	ENST00000675857.1	898	913	+	15	0	-10	1857
O95831-1#97	0	5	5	O95831-1	274	279	+	5	O95831-1	0	613	ENST00000675427.1	89	1925	++	240	O95831-1#97	0	15	ENST00000675427.1	911	926	+	15	0	-10	1858
O95831-1#97	0	5	5	O95831-1	274	279	+	5	O95831-1	0	524	ENST00000675240.1	169	1741	++	239	O95831-1#97	0	15	ENST00000675240.1	991	1006	+	15	0	-10	1859
O95831-1#97	0	5	5	O95831-1	274	279	+	5	O95831-1	0	613	ENST00000675092.1	90	1956	++	238	O95831-1#97	0	15	ENST00000675092.1	912	927	+	15	0	-10	1860
O95831-1#97	0	5	5	O95831-1	274	279	+	5	O95831-1	0	613	ENST00000675050.1	71	1898	++	237	O95831-1#97	0	15	ENST00000675050.1	881	896	+	15	0	-10	1861
O95831-1#97	0	5	5	O95831-1	274	279	+	5	O95831-1	0	459	ENST00000675037.1	56	1433	++	236	O95831-1#97	0	15	ENST00000675037.1	878	893	+	15	0	-10	1862
O95831-1#97	0	5	5	O95831-1	274	279	+	5	O95831-1	100	388	ENST00000674957.1	1	865	++	234	O95831-1#97	0	15	ENST00000674957.1	523	538	+	15	0	-10	1863
O95831-1#97	0	5	5	O95831-1	274	279	+	5	O95831-1	0	587	ENST00000674546.1	185	1954	++	230	O95831-1#97	0	15	ENST00000674546.1	1007	1022	+	15	0	-10	1864
O95831-1#97	0	5	5	O95831-1	274	279	+	5	O95831-1	0	322	ENST00000535724.6	8	974	++	150	O95831-1#97	0	15	ENST00000535724.6	830	845	+	15	0	-10	1865
O95831-1#97	0	5	5	O95831-1	274	279	+	5	O95831-1	0	435	ENST00000416073.7	37	1336	++	76	O95831-1#97	0	15	ENST00000416073.7	853	868	+	15	0	-10	1866
O95831-1#97	0	5	5	O95831-1	274	279	+	5	O95831-1	0	613	ENST00000319908.8	174	2007	++	26	O95831-1#97	0	15	ENST00000319908.8	993	1008	+	15	0	-10	1867
O95831-1#97	0	5	5	O95831-1	274	279	+	5	O95831-1	0	613	ENST00000287295.8	185	2024	++	18	O95831-1#97	0	15	ENST00000287295.8	1007	1022	+	15	0	-10	1868
O95831-1#98	0	3	3	O95831-1	280	283	+	3	O95831-1	0	613	ENST00000676436.1	34	1861	++	246	O95831-1#98	0	9	ENST00000676436.1	868	877	+	9	0	-6	1869
O95831-1#98	0	3	3	O95831-1	280	283	+	3	O95831-1	0	613	ENST00000676328.1	56	1892	++	245	O95831-1#98	0	9	ENST00000676328.1	893	902	+	9	0	-6	1870
O95831-1#98	0	3	3	O95831-1	280	283	+	3	O95831-1	0	613	ENST00000676229.1	223	2050	++	244	O95831-1#98	0	9	ENST00000676229.1	1051	1060	+	9	0	-6	1871
O95831-1#98	0	3	3	O95831-1	280	283	+	3	O95831-1	0	613	ENST00000675857.1	82	1915	++	242	O95831-1#98	0	9	ENST00000675857.1	916	925	+	9	0	-6	1872
O95831-1#98	0	3	3	O95831-1	280	283	+	3	O95831-1	0	613	ENST00000675427.1	89	1925	++	240	O95831-1#98	0	9	ENST00000675427.1	929	938	+	9	0	-6	1873
O95831-1#98	0	3	3	O95831-1	280	283	+	3	O95831-1	0	524	ENST00000675240.1	169	1741	++	239	O95831-1#98	0	9	ENST00000675240.1	1009	1018	+	9	0	-6	1874
O95831-1#98	0	3	3	O95831-1	280	283	+	3	O95831-1	0	613	ENST00000675092.1	90	1956	++	238	O95831-1#98	0	9	ENST00000675092.1	930	939	+	9	0	-6	1875
O95831-1#98	0	3	3	O95831-1	280	283	+	3	O95831-1	0	613	ENST00000675050.1	71	1898	++	237	O95831-1#98	0	9	ENST00000675050.1	899	908	+	9	0	-6	1876
O95831-1#98	0	3	3	O95831-1	280	283	+	3	O95831-1	0	459	ENST00000675037.1	56	1433	++	236	O95831-1#98	0	9	ENST00000675037.1	896	905	+	9	0	-6	1877
O95831-1#98	0	3	3	O95831-1	280	283	+	3	O95831-1	100	388	ENST00000674957.1	1	865	++	234	O95831-1#98	0	9	ENST00000674957.1	541	550	+	9	0	-6	1878
O95831-1#98	0	3	3	O95831-1	280	283	+	3	O95831-1	0	587	ENST00000674546.1	185	1954	++	230	O95831-1#98	0	9	ENST00000674546.1	1025	1034	+	9	0	-6	1879
O95831-1#98	0	3	3	O95831-1	280	283	+	3	O95831-1	0	322	ENST00000535724.6	8	974	++	150	O95831-1#98	0	9	ENST00000535724.6	848	857	+	9	0	-6	1880
O95831-1#98	0	3	3	O95831-1	280	283	+	3	O95831-1	0	435	ENST00000416073.7	37	1336	++	76	O95831-1#98	0	9	ENST00000416073.7	871	880	+	9	0	-6	1881
O95831-1#98	0	3	3	O95831-1	280	283	+	3	O95831-1	0	613	ENST00000319908.8	174	2007	++	26	O95831-1#98	0	9	ENST00000319908.8	1011	1020	+	9	0	-6	1882
O95831-1#98	0	3	3	O95831-1	280	283	+	3	O95831-1	0	613	ENST00000287295.8	185	2024	++	18	O95831-1#98	0	9	ENST00000287295.8	1025	1034	+	9	0	-6	1883
O95831-1#99	0	13	13	O95831-1	286	299	+	13	O95831-1	0	613	ENST00000676436.1	34	1861	++	246	O95831-1#99	0	39	ENST00000676436.1	886	925	+	39	0	-26	1884
O95831-1#99	0	13	13	O95831-1	286	299	+	13	O95831-1	0	613	ENST00000676328.1	56	1892	++	245	O95831-1#99	0	39	ENST00000676328.1	911	950	+	39	0	-26	1885
O95831-1#99	0	13	13	O95831-1	286	299	+	13	O95831-1	0	613	ENST00000676229.1	223	2050	++	244	O95831-1#99	0	39	ENST00000676229.1	1069	1108	+	39	0	-26	1886
O95831-1#99	0	13	13	O95831-1	286	299	+	13	O95831-1	0	613	ENST00000675857.1	82	1915	++	242	O95831-1#99	0	39	ENST00000675857.1	934	973	+	39	0	-26	1887
O95831-1#99	0	13	13	O95831-1	286	299	+	13	O95831-1	0	613	ENST00000675427.1	89	1925	++	240	O95831-1#99	0	39	ENST00000675427.1	947	986	+	39	0	-26	1888
O95831-1#99	0	13	13	O95831-1	286	299	+	13	O95831-1	0	524	ENST00000675240.1	169	1741	++	239	O95831-1#99	0	39	ENST00000675240.1	1027	1066	+	39	0	-26	1889
O95831-1#99	0	13	13	O95831-1	286	299	+	13	O95831-1	0	613	ENST00000675092.1	90	1956	++	238	O95831-1#99	0	39	ENST00000675092.1	948	987	+	39	0	-26	1890
O95831-1#99	0	13	13	O95831-1	286	299	+	13	O95831-1	0	613	ENST00000675050.1	71	1898	++	237	O95831-1#99	0	39	ENST00000675050.1	917	956	+	39	0	-26	1891
O95831-1#99	0	13	13	O95831-1	286	299	+	13	O95831-1	0	459	ENST00000675037.1	56	1433	++	236	O95831-1#99	0	39	ENST00000675037.1	914	953	+	39	0	-26	1892
O95831-1#99	0	13	13	O95831-1	286	299	+	13	O95831-1	100	388	ENST00000674957.1	1	865	++	234	O95831-1#99	0	39	ENST00000674957.1	559	598	+	39	0	-26	1893
O95831-1#99	0	13	13	O95831-1	286	299	+	13	O95831-1	0	587	ENST00000674546.1	185	1954	++	230	O95831-1#99	0	39	ENST00000674546.1	1043	1082	+	39	0	-26	1894
O95831-1#99	0	13	13	O95831-1	286	299	+	13	O95831-1	0	322	ENST00000535724.6	8	974	++	150	O95831-1#99	0	39	ENST00000535724.6	866	905	+	39	0	-26	1895
O95831-1#99	0	13	13	O95831-1	286	299	+	13	O95831-1	0	435	ENST00000416073.7	37	1336	++	76	O95831-1#99	0	39	ENST00000416073.7	889	928	+	39	0	-26	1896
O95831-1#99	0	13	13	O95831-1	286	299	+	13	O95831-1	0	613	ENST00000319908.8	174	2007	++	26	O95831-1#99	0	39	ENST00000319908.8	1029	1068	+	39	0	-26	1897
O95831-1#99	0	13	13	O95831-1	286	299	+	13	O95831-1	0	613	ENST00000287295.8	185	2024	++	18	O95831-1#99	0	39	ENST00000287295.8	1043	1082	+	39	0	-26	1898
O95831-1#100	0	6	6	O95831-1	300	306	+	6	O95831-1	0	613	ENST00000676436.1	34	1861	++	246	O95831-1#100	0	18	ENST00000676436.1	928	946	+	18	0	-12	1899
O95831-1#100	0	6	6	O95831-1	300	306	+	6	O95831-1	0	613	ENST00000676328.1	56	1892	++	245	O95831-1#100	0	18	ENST00000676328.1	953	971	+	18	0	-12	1900
O95831-1#100	0	6	6	O95831-1	300	306	+	6	O95831-1	0	613	ENST00000676229.1	223	2050	++	244	O95831-1#100	0	18	ENST00000676229.1	1111	1129	+	18	0	-12	1901
O95831-1#100	0	6	6	O95831-1	300	306	+	6	O95831-1	0	613	ENST00000675857.1	82	1915	++	242	O95831-1#100	0	18	ENST00000675857.1	976	994	+	18	0	-12	1902
O95831-1#100	0	6	6	O95831-1	300	306	+	6	O95831-1	0	613	ENST00000675427.1	89	1925	++	240	O95831-1#100	0	18	ENST00000675427.1	989	1007	+	18	0	-12	1903
O95831-1#100	0	6	6	O95831-1	300	306	+	6	O95831-1	0	524	ENST00000675240.1	169	1741	++	239	O95831-1#100	0	18	ENST00000675240.1	1069	1087	+	18	0	-12	1904
O95831-1#100	0	6	6	O95831-1	300	306	+	6	O95831-1	0	613	ENST00000675092.1	90	1956	++	238	O95831-1#100	0	18	ENST00000675092.1	990	1008	+	18	0	-12	1905
O95831-1#100	0	6	6	O95831-1	300	306	+	6	O95831-1	0	613	ENST00000675050.1	71	1898	++	237	O95831-1#100	0	18	ENST00000675050.1	959	977	+	18	0	-12	1906
O95831-1#100	0	6	6	O95831-1	300	306	+	6	O95831-1	0	459	ENST00000675037.1	56	1433	++	236	O95831-1#100	0	18	ENST00000675037.1	956	974	+	18	0	-12	1907
O95831-1#100	0	6	6	O95831-1	300	306	+	6	O95831-1	100	388	ENST00000674957.1	1	865	++	234	O95831-1#100	0	18	ENST00000674957.1	601	619	+	18	0	-12	1908
O95831-1#100	0	6	6	O95831-1	300	306	+	6	O95831-1	0	587	ENST00000674546.1	185	1954	++	230	O95831-1#100	0	18	ENST00000674546.1	1085	1103	+	18	0	-12	1909
O95831-1#100	0	6	6	O95831-1	300	306	+	6	O95831-1	0	322	ENST00000535724.6	8	974	++	150	O95831-1#100	0	18	ENST00000535724.6	908	926	+	18	0	-12	1910
O95831-1#100	0	6	6	O95831-1	300	306	+	6	O95831-1	0	435	ENST00000416073.7	37	1336	++	76	O95831-1#100	0	18	ENST00000416073.7	931	949	+	18	0	-12	1911
O95831-1#100	0	6	6	O95831-1	300	306	+	6	O95831-1	0	613	ENST00000319908.8	174	2007	++	26	O95831-1#100	0	18	ENST00000319908.8	1071	1089	+	18	0	-12	1912
O95831-1#100	0	6	6	O95831-1	300	306	+	6	O95831-1	0	613	ENST00000287295.8	185	2024	++	18	O95831-1#100	0	18	ENST00000287295.8	1085	1103	+	18	0	-12	1913
O95831-1#101	0	17	17	O95831-1	309	326	+	17	O95831-1	0	613	ENST00000676436.1	34	1861	++	246	O95831-1#101	0	51	ENST00000676436.1	955	1000	+	45	0	-34	1914
O95831-1#101	0	17	17	O95831-1	309	326	+	17	O95831-1	0	613	ENST00000676328.1	56	1892	++	245	O95831-1#101	0	51	ENST00000676328.1	980	1031	+	51	0	-34	1915
O95831-1#101	0	17	17	O95831-1	309	326	+	17	O95831-1	0	613	ENST00000676229.1	223	2050	++	244	O95831-1#101	0	51	ENST00000676229.1	1138	1189	+	51	0	-34	1916
O95831-1#101	0	17	17	O95831-1	309	326	+	17	O95831-1	0	613	ENST00000675857.1	82	1915	++	242	O95831-1#101	0	51	ENST00000675857.1	1003	1054	+	51	0	-34	1917
O95831-1#101	0	17	17	O95831-1	309	326	+	17	O95831-1	0	613	ENST00000675427.1	89	1925	++	240	O95831-1#101	0	51	ENST00000675427.1	1016	1067	+	51	0	-34	1918
O95831-1#101	0	17	17	O95831-1	309	326	+	17	O95831-1	0	524	ENST00000675240.1	169	1741	++	239	O95831-1#101	0	51	ENST00000675240.1	1096	1147	+	51	0	-34	1919
O95831-1#101	0	17	17	O95831-1	309	326	+	17	O95831-1	0	613	ENST00000675092.1	90	1956	++	238	O95831-1#101	0	51	ENST00000675092.1	1017	1068	+	51	0	-34	1920
O95831-1#101	0	17	17	O95831-1	309	326	+	17	O95831-1	0	613	ENST00000675050.1	71	1898	++	237	O95831-1#101	0	51	ENST00000675050.1	986	1037	+	51	0	-34	1921
O95831-1#101	0	17	17	O95831-1	309	326	+	17	O95831-1	0	459	ENST00000675037.1	56	1433	++	236	O95831-1#101	0	51	ENST00000675037.1	983	1034	+	51	0	-34	1922
O95831-1#101	0	17	17	O95831-1	309	326	+	17	O95831-1	100	388	ENST00000674957.1	1	865	++	234	O95831-1#101	0	51	ENST00000674957.1	628	679	+	51	0	-34	1923
O95831-1#101	0	17	17	O95831-1	309	326	+	17	O95831-1	0	587	ENST00000674546.1	185	1954	++	230	O95831-1#101	0	51	ENST00000674546.1	1112	1163	+	51	0	-34	1924
O95831-1#101	0	17	17	O95831-1	309	326	+	17	O95831-1	0	322	ENST00000535724.6	8	974	++	150	O95831-1#101	0	39	ENST00000535724.6	935	974	+	39	0	-22	1925
O95831-1#101	0	17	17	O95831-1	309	326	+	17	O95831-1	0	435	ENST00000416073.7	37	1336	++	76	O95831-1#101	0	51	ENST00000416073.7	958	1009	+	51	0	-34	1926
O95831-1#101	0	17	17	O95831-1	309	326	+	17	O95831-1	0	613	ENST00000346424.6	24	1002	++	35	O95831-1#101	39	51	ENST00000346424.6	129	141	+	12	39	-34	1927
O95831-1#101	0	17	17	O95831-1	309	326	+	17	O95831-1	0	613	ENST00000319908.8	174	2007	++	26	O95831-1#101	0	51	ENST00000319908.8	1098	1149	+	51	0	-34	1928
O95831-1#101	0	17	17	O95831-1	309	326	+	17	O95831-1	0	613	ENST00000287295.8	185	2024	++	18	O95831-1#101	0	51	ENST00000287295.8	1112	1163	+	51	0	-34	1929
O95831-1#102	0	5	5	O95831-1	328	333	+	5	O95831-1	0	613	ENST00000676436.1	34	1861	++	246	O95831-1#102	0	15	ENST00000676436.1	1006	1021	+	15	0	-10	1930
O95831-1#102	0	5	5	O95831-1	328	333	+	5	O95831-1	0	613	ENST00000676328.1	56	1892	++	245	O95831-1#102	0	15	ENST00000676328.1	1037	1052	+	15	0	-10	1931
O95831-1#102	0	5	5	O95831-1	328	333	+	5	O95831-1	0	613	ENST00000676229.1	223	2050	++	244	O95831-1#102	0	15	ENST00000676229.1	1195	1210	+	15	0	-10	1932
O95831-1#102	0	5	5	O95831-1	328	333	+	5	O95831-1	0	613	ENST00000675857.1	82	1915	++	242	O95831-1#102	0	15	ENST00000675857.1	1060	1075	+	15	0	-10	1933
O95831-1#102	0	5	5	O95831-1	328	333	+	5	O95831-1	0	613	ENST00000675427.1	89	1925	++	240	O95831-1#102	0	15	ENST00000675427.1	1073	1088	+	15	0	-10	1934
O95831-1#102	0	5	5	O95831-1	328	333	+	5	O95831-1	0	524	ENST00000675240.1	169	1741	++	239	O95831-1#102	0	15	ENST00000675240.1	1153	1168	+	15	0	-10	1935
O95831-1#102	0	5	5	O95831-1	328	333	+	5	O95831-1	0	613	ENST00000675092.1	90	1956	++	238	O95831-1#102	0	15	ENST00000675092.1	1074	1089	+	15	0	-10	1936
O95831-1#102	0	5	5	O95831-1	328	333	+	5	O95831-1	0	613	ENST00000675050.1	71	1898	++	237	O95831-1#102	0	15	ENST00000675050.1	1043	1058	+	15	0	-10	1937
O95831-1#102	0	5	5	O95831-1	328	333	+	5	O95831-1	0	459	ENST00000675037.1	56	1433	++	236	O95831-1#102	0	15	ENST00000675037.1	1040	1055	+	15	0	-10	1938
O95831-1#102	0	5	5	O95831-1	328	333	+	5	O95831-1	100	388	ENST00000674957.1	1	865	++	234	O95831-1#102	0	15	ENST00000674957.1	685	700	+	15	0	-10	1939
O95831-1#102	0	5	5	O95831-1	328	333	+	5	O95831-1	0	587	ENST00000674546.1	185	1954	++	230	O95831-1#102	0	15	ENST00000674546.1	1169	1184	+	15	0	-10	1940
O95831-1#102	0	5	5	O95831-1	328	333	+	5	O95831-1	0	435	ENST00000416073.7	37	1336	++	76	O95831-1#102	0	15	ENST00000416073.7	1015	1030	+	15	0	-10	1941
O95831-1#102	0	5	5	O95831-1	328	333	+	5	O95831-1	0	613	ENST00000346424.6	24	1002	++	35	O95831-1#102	0	15	ENST00000346424.6	147	162	+	15	0	-10	1942
O95831-1#102	0	5	5	O95831-1	328	333	+	5	O95831-1	0	613	ENST00000319908.8	174	2007	++	26	O95831-1#102	0	15	ENST00000319908.8	1155	1170	+	15	0	-10	1943
O95831-1#102	0	5	5	O95831-1	328	333	+	5	O95831-1	0	613	ENST00000287295.8	185	2024	++	18	O95831-1#102	0	15	ENST00000287295.8	1169	1184	+	15	0	-10	1944
O95831-1#103	0	4	4	O95831-1	334	338	+	4	O95831-1	0	613	ENST00000676436.1	34	1861	++	246	O95831-1#103	0	12	ENST00000676436.1	1024	1036	+	12	0	-8	1945
O95831-1#103	0	4	4	O95831-1	334	338	+	4	O95831-1	0	613	ENST00000676328.1	56	1892	++	245	O95831-1#103	0	12	ENST00000676328.1	1055	1067	+	12	0	-8	1946
O95831-1#103	0	4	4	O95831-1	334	338	+	4	O95831-1	0	613	ENST00000676229.1	223	2050	++	244	O95831-1#103	0	12	ENST00000676229.1	1213	1225	+	12	0	-8	1947
O95831-1#103	0	4	4	O95831-1	334	338	+	4	O95831-1	0	613	ENST00000675857.1	82	1915	++	242	O95831-1#103	0	12	ENST00000675857.1	1078	1090	+	12	0	-8	1948
O95831-1#103	0	4	4	O95831-1	334	338	+	4	O95831-1	0	613	ENST00000675427.1	89	1925	++	240	O95831-1#103	0	12	ENST00000675427.1	1091	1103	+	12	0	-8	1949
O95831-1#103	0	4	4	O95831-1	334	338	+	4	O95831-1	0	524	ENST00000675240.1	169	1741	++	239	O95831-1#103	0	12	ENST00000675240.1	1171	1183	+	12	0	-8	1950
O95831-1#103	0	4	4	O95831-1	334	338	+	4	O95831-1	0	613	ENST00000675092.1	90	1956	++	238	O95831-1#103	0	12	ENST00000675092.1	1092	1104	+	12	0	-8	1951
O95831-1#103	0	4	4	O95831-1	334	338	+	4	O95831-1	0	613	ENST00000675050.1	71	1898	++	237	O95831-1#103	0	12	ENST00000675050.1	1061	1073	+	12	0	-8	1952
O95831-1#103	0	4	4	O95831-1	334	338	+	4	O95831-1	0	459	ENST00000675037.1	56	1433	++	236	O95831-1#103	0	12	ENST00000675037.1	1058	1070	+	12	0	-8	1953
O95831-1#103	0	4	4	O95831-1	334	338	+	4	O95831-1	100	388	ENST00000674957.1	1	865	++	234	O95831-1#103	0	12	ENST00000674957.1	703	715	+	12	0	-8	1954
O95831-1#103	0	4	4	O95831-1	334	338	+	4	O95831-1	0	587	ENST00000674546.1	185	1954	++	230	O95831-1#103	0	12	ENST00000674546.1	1187	1199	+	12	0	-8	1955
O95831-1#103	0	4	4	O95831-1	334	338	+	4	O95831-1	0	435	ENST00000416073.7	37	1336	++	76	O95831-1#103	0	12	ENST00000416073.7	1033	1045	+	12	0	-8	1956
O95831-1#103	0	4	4	O95831-1	334	338	+	4	O95831-1	0	613	ENST00000346424.6	24	1002	++	35	O95831-1#103	0	12	ENST00000346424.6	165	177	+	12	0	-8	1957
O95831-1#103	0	4	4	O95831-1	334	338	+	4	O95831-1	0	613	ENST00000319908.8	174	2007	++	26	O95831-1#103	0	12	ENST00000319908.8	1173	1185	+	12	0	-8	1958
O95831-1#103	0	4	4	O95831-1	334	338	+	4	O95831-1	0	613	ENST00000287295.8	185	2024	++	18	O95831-1#103	0	12	ENST00000287295.8	1187	1199	+	12	0	-8	1959
O95831-1#104	0	5	5	O95831-1	338	343	+	5	O95831-1	0	613	ENST00000676436.1	34	1861	++	246	O95831-1#104	0	15	ENST00000676436.1	1036	1051	+	15	0	-10	1960
O95831-1#104	0	5	5	O95831-1	338	343	+	5	O95831-1	0	613	ENST00000676328.1	56	1892	++	245	O95831-1#104	0	15	ENST00000676328.1	1067	1082	+	15	0	-10	1961
O95831-1#104	0	5	5	O95831-1	338	343	+	5	O95831-1	0	613	ENST00000676229.1	223	2050	++	244	O95831-1#104	0	15	ENST00000676229.1	1225	1240	+	15	0	-10	1962
O95831-1#104	0	5	5	O95831-1	338	343	+	5	O95831-1	0	613	ENST00000675857.1	82	1915	++	242	O95831-1#104	0	15	ENST00000675857.1	1090	1105	+	15	0	-10	1963
O95831-1#104	0	5	5	O95831-1	338	343	+	5	O95831-1	0	613	ENST00000675427.1	89	1925	++	240	O95831-1#104	0	15	ENST00000675427.1	1103	1118	+	15	0	-10	1964
O95831-1#104	0	5	5	O95831-1	338	343	+	5	O95831-1	0	524	ENST00000675240.1	169	1741	++	239	O95831-1#104	0	15	ENST00000675240.1	1183	1198	+	15	0	-10	1965
O95831-1#104	0	5	5	O95831-1	338	343	+	5	O95831-1	0	613	ENST00000675092.1	90	1956	++	238	O95831-1#104	0	15	ENST00000675092.1	1104	1119	+	15	0	-10	1966
O95831-1#104	0	5	5	O95831-1	338	343	+	5	O95831-1	0	613	ENST00000675050.1	71	1898	++	237	O95831-1#104	0	15	ENST00000675050.1	1073	1088	+	15	0	-10	1967
O95831-1#104	0	5	5	O95831-1	338	343	+	5	O95831-1	0	459	ENST00000675037.1	56	1433	++	236	O95831-1#104	0	15	ENST00000675037.1	1070	1085	+	15	0	-10	1968
O95831-1#104	0	5	5	O95831-1	338	343	+	5	O95831-1	100	388	ENST00000674957.1	1	865	++	234	O95831-1#104	0	15	ENST00000674957.1	715	730	+	15	0	-10	1969
O95831-1#104	0	5	5	O95831-1	338	343	+	5	O95831-1	338	613	ENST00000674601.1	2	686	++	232	O95831-1#104	0	15	ENST00000674601.1	2	17	+	15	0	-10	1970
O95831-1#104	0	5	5	O95831-1	338	343	+	5	O95831-1	0	587	ENST00000674546.1	185	1954	++	230	O95831-1#104	0	15	ENST00000674546.1	1199	1214	+	15	0	-10	1971
O95831-1#104	0	5	5	O95831-1	338	343	+	5	O95831-1	339	613	ENST00000460436.6	905	1727	++	106	O95831-1#104	3	15	ENST00000460436.6	905	917	+	12	3	-10	1972
O95831-1#104	0	5	5	O95831-1	338	343	+	5	O95831-1	0	435	ENST00000416073.7	37	1336	++	76	O95831-1#104	0	15	ENST00000416073.7	1045	1060	+	15	0	-10	1973
O95831-1#104	0	5	5	O95831-1	338	343	+	5	O95831-1	0	613	ENST00000346424.6	24	1002	++	35	O95831-1#104	0	15	ENST00000346424.6	177	192	+	15	0	-10	1974
O95831-1#104	0	5	5	O95831-1	338	343	+	5	O95831-1	0	613	ENST00000319908.8	174	2007	++	26	O95831-1#104	0	15	ENST00000319908.8	1185	1200	+	15	0	-10	1975
O95831-1#104	0	5	5	O95831-1	338	343	+	5	O95831-1	0	613	ENST00000287295.8	185	2024	++	18	O95831-1#104	0	15	ENST00000287295.8	1199	1214	+	15	0	-10	1976
O95831-1#105	0	13	13	O95831-1	345	358	+	13	O95831-1	0	613	ENST00000676436.1	34	1861	++	246	O95831-1#105	0	39	ENST00000676436.1	1057	1096	+	39	0	-26	1977
O95831-1#105	0	13	13	O95831-1	345	358	+	13	O95831-1	0	613	ENST00000676328.1	56	1892	++	245	O95831-1#105	0	39	ENST00000676328.1	1088	1127	+	39	0	-26	1978
O95831-1#105	0	13	13	O95831-1	345	358	+	13	O95831-1	0	613	ENST00000676229.1	223	2050	++	244	O95831-1#105	0	39	ENST00000676229.1	1246	1285	+	39	0	-26	1979
O95831-1#105	0	13	13	O95831-1	345	358	+	13	O95831-1	0	613	ENST00000675857.1	82	1915	++	242	O95831-1#105	0	39	ENST00000675857.1	1111	1150	+	39	0	-26	1980
O95831-1#105	0	13	13	O95831-1	345	358	+	13	O95831-1	0	613	ENST00000675427.1	89	1925	++	240	O95831-1#105	0	39	ENST00000675427.1	1124	1163	+	39	0	-26	1981
O95831-1#105	0	13	13	O95831-1	345	358	+	13	O95831-1	0	524	ENST00000675240.1	169	1741	++	239	O95831-1#105	0	39	ENST00000675240.1	1204	1243	+	39	0	-26	1982
O95831-1#105	0	13	13	O95831-1	345	358	+	13	O95831-1	0	613	ENST00000675092.1	90	1956	++	238	O95831-1#105	0	39	ENST00000675092.1	1125	1164	+	39	0	-26	1983
O95831-1#105	0	13	13	O95831-1	345	358	+	13	O95831-1	0	613	ENST00000675050.1	71	1898	++	237	O95831-1#105	0	39	ENST00000675050.1	1094	1133	+	39	0	-26	1984
O95831-1#105	0	13	13	O95831-1	345	358	+	13	O95831-1	0	459	ENST00000675037.1	56	1433	++	236	O95831-1#105	0	39	ENST00000675037.1	1091	1130	+	39	0	-26	1985
O95831-1#105	0	13	13	O95831-1	345	358	+	13	O95831-1	100	388	ENST00000674957.1	1	865	++	234	O95831-1#105	0	39	ENST00000674957.1	736	775	+	39	0	-26	1986
O95831-1#105	0	13	13	O95831-1	345	358	+	13	O95831-1	338	613	ENST00000674601.1	2	686	++	232	O95831-1#105	0	39	ENST00000674601.1	23	62	+	39	0	-26	1987
O95831-1#105	0	13	13	O95831-1	345	358	+	13	O95831-1	0	587	ENST00000674546.1	185	1954	++	230	O95831-1#105	0	39	ENST00000674546.1	1220	1259	+	39	0	-26	1988
O95831-1#105	0	13	13	O95831-1	345	358	+	13	O95831-1	339	613	ENST00000460436.6	905	1727	++	106	O95831-1#105	0	39	ENST00000460436.6	923	962	+	39	0	-26	1989
O95831-1#105	0	13	13	O95831-1	345	358	+	13	O95831-1	0	435	ENST00000416073.7	37	1336	++	76	O95831-1#105	0	39	ENST00000416073.7	1066	1105	+	39	0	-26	1990
O95831-1#105	0	13	13	O95831-1	345	358	+	13	O95831-1	0	613	ENST00000346424.6	24	1002	++	35	O95831-1#105	0	39	ENST00000346424.6	198	237	+	39	0	-26	1991
O95831-1#105	0	13	13	O95831-1	345	358	+	13	O95831-1	0	613	ENST00000319908.8	174	2007	++	26	O95831-1#105	0	39	ENST00000319908.8	1206	1245	+	39	0	-26	1992
O95831-1#105	0	13	13	O95831-1	345	358	+	13	O95831-1	0	613	ENST00000287295.8	185	2024	++	18	O95831-1#105	0	39	ENST00000287295.8	1220	1259	+	39	0	-26	1993
O95831-1#106	0	3	3	O95831-1	361	364	+	3	O95831-1	0	613	ENST00000676436.1	34	1861	++	246	O95831-1#106	0	9	ENST00000676436.1	1105	1114	+	9	0	-6	1994
O95831-1#106	0	3	3	O95831-1	361	364	+	3	O95831-1	0	613	ENST00000676328.1	56	1892	++	245	O95831-1#106	0	9	ENST00000676328.1	1136	1145	+	9	0	-6	1995
O95831-1#106	0	3	3	O95831-1	361	364	+	3	O95831-1	0	613	ENST00000676229.1	223	2050	++	244	O95831-1#106	0	9	ENST00000676229.1	1294	1303	+	9	0	-6	1996
O95831-1#106	0	3	3	O95831-1	361	364	+	3	O95831-1	0	613	ENST00000675857.1	82	1915	++	242	O95831-1#106	0	9	ENST00000675857.1	1159	1168	+	9	0	-6	1997
O95831-1#106	0	3	3	O95831-1	361	364	+	3	O95831-1	0	613	ENST00000675427.1	89	1925	++	240	O95831-1#106	0	9	ENST00000675427.1	1172	1181	+	9	0	-6	1998
O95831-1#106	0	3	3	O95831-1	361	364	+	3	O95831-1	0	524	ENST00000675240.1	169	1741	++	239	O95831-1#106	0	9	ENST00000675240.1	1252	1261	+	9	0	-6	1999
O95831-1#106	0	3	3	O95831-1	361	364	+	3	O95831-1	0	613	ENST00000675092.1	90	1956	++	238	O95831-1#106	0	9	ENST00000675092.1	1173	1182	+	9	0	-6	2000
O95831-1#106	0	3	3	O95831-1	361	364	+	3	O95831-1	0	613	ENST00000675050.1	71	1898	++	237	O95831-1#106	0	9	ENST00000675050.1	1142	1151	+	9	0	-6	2001
O95831-1#106	0	3	3	O95831-1	361	364	+	3	O95831-1	0	459	ENST00000675037.1	56	1433	++	236	O95831-1#106	0	9	ENST00000675037.1	1139	1148	+	9	0	-6	2002
O95831-1#106	0	3	3	O95831-1	361	364	+	3	O95831-1	100	388	ENST00000674957.1	1	865	++	234	O95831-1#106	0	9	ENST00000674957.1	784	793	+	9	0	-6	2003
O95831-1#106	0	3	3	O95831-1	361	364	+	3	O95831-1	338	613	ENST00000674601.1	2	686	++	232	O95831-1#106	0	9	ENST00000674601.1	71	80	+	9	0	-6	2004
O95831-1#106	0	3	3	O95831-1	361	364	+	3	O95831-1	0	587	ENST00000674546.1	185	1954	++	230	O95831-1#106	0	9	ENST00000674546.1	1268	1277	+	9	0	-6	2005
O95831-1#106	0	3	3	O95831-1	361	364	+	3	O95831-1	339	613	ENST00000460436.6	905	1727	++	106	O95831-1#106	0	9	ENST00000460436.6	971	980	+	9	0	-6	2006
O95831-1#106	0	3	3	O95831-1	361	364	+	3	O95831-1	0	435	ENST00000416073.7	37	1336	++	76	O95831-1#106	0	9	ENST00000416073.7	1114	1123	+	9	0	-6	2007
O95831-1#106	0	3	3	O95831-1	361	364	+	3	O95831-1	0	613	ENST00000346424.6	24	1002	++	35	O95831-1#106	0	9	ENST00000346424.6	246	255	+	9	0	-6	2008
O95831-1#106	0	3	3	O95831-1	361	364	+	3	O95831-1	0	613	ENST00000319908.8	174	2007	++	26	O95831-1#106	0	9	ENST00000319908.8	1254	1263	+	9	0	-6	2009
O95831-1#106	0	3	3	O95831-1	361	364	+	3	O95831-1	0	613	ENST00000287295.8	185	2024	++	18	O95831-1#106	0	9	ENST00000287295.8	1268	1277	+	9	0	-6	2010
O95831-1#107	0	7	7	O95831-1	368	375	+	7	O95831-1	0	613	ENST00000676436.1	34	1861	++	246	O95831-1#107	0	21	ENST00000676436.1	1126	1147	+	21	0	-14	2011
O95831-1#107	0	7	7	O95831-1	368	375	+	7	O95831-1	0	613	ENST00000676328.1	56	1892	++	245	O95831-1#107	0	21	ENST00000676328.1	1157	1178	+	21	0	-14	2012
O95831-1#107	0	7	7	O95831-1	368	375	+	7	O95831-1	0	613	ENST00000676229.1	223	2050	++	244	O95831-1#107	0	21	ENST00000676229.1	1315	1336	+	21	0	-14	2013
O95831-1#107	0	7	7	O95831-1	368	375	+	7	O95831-1	0	613	ENST00000675857.1	82	1915	++	242	O95831-1#107	0	21	ENST00000675857.1	1180	1201	+	21	0	-14	2014
O95831-1#107	0	7	7	O95831-1	368	375	+	7	O95831-1	0	613	ENST00000675427.1	89	1925	++	240	O95831-1#107	0	21	ENST00000675427.1	1193	1214	+	21	0	-14	2015
O95831-1#107	0	7	7	O95831-1	368	375	+	7	O95831-1	0	524	ENST00000675240.1	169	1741	++	239	O95831-1#107	0	21	ENST00000675240.1	1273	1294	+	21	0	-14	2016
O95831-1#107	0	7	7	O95831-1	368	375	+	7	O95831-1	0	613	ENST00000675092.1	90	1956	++	238	O95831-1#107	0	21	ENST00000675092.1	1194	1215	+	21	0	-14	2017
O95831-1#107	0	7	7	O95831-1	368	375	+	7	O95831-1	0	613	ENST00000675050.1	71	1898	++	237	O95831-1#107	0	21	ENST00000675050.1	1163	1184	+	21	0	-14	2018
O95831-1#107	0	7	7	O95831-1	368	375	+	7	O95831-1	0	459	ENST00000675037.1	56	1433	++	236	O95831-1#107	0	21	ENST00000675037.1	1160	1181	+	21	0	-14	2019
O95831-1#107	0	7	7	O95831-1	368	375	+	7	O95831-1	100	388	ENST00000674957.1	1	865	++	234	O95831-1#107	0	21	ENST00000674957.1	805	826	+	21	0	-14	2020
O95831-1#107	0	7	7	O95831-1	368	375	+	7	O95831-1	338	613	ENST00000674601.1	2	686	++	232	O95831-1#107	0	21	ENST00000674601.1	92	113	+	21	0	-14	2021
O95831-1#107	0	7	7	O95831-1	368	375	+	7	O95831-1	0	587	ENST00000674546.1	185	1954	++	230	O95831-1#107	0	21	ENST00000674546.1	1289	1310	+	21	0	-14	2022
O95831-1#107	0	7	7	O95831-1	368	375	+	7	O95831-1	339	613	ENST00000460436.6	905	1727	++	106	O95831-1#107	0	21	ENST00000460436.6	992	1013	+	21	0	-14	2023
O95831-1#107	0	7	7	O95831-1	368	375	+	7	O95831-1	0	435	ENST00000416073.7	37	1336	++	76	O95831-1#107	0	21	ENST00000416073.7	1135	1156	+	21	0	-14	2024
O95831-1#107	0	7	7	O95831-1	368	375	+	7	O95831-1	0	613	ENST00000346424.6	24	1002	++	35	O95831-1#107	0	21	ENST00000346424.6	267	288	+	21	0	-14	2025
O95831-1#107	0	7	7	O95831-1	368	375	+	7	O95831-1	0	613	ENST00000319908.8	174	2007	++	26	O95831-1#107	0	21	ENST00000319908.8	1275	1296	+	21	0	-14	2026
O95831-1#107	0	7	7	O95831-1	368	375	+	7	O95831-1	0	613	ENST00000287295.8	185	2024	++	18	O95831-1#107	0	21	ENST00000287295.8	1289	1310	+	21	0	-14	2027
O95831-1#108	0	6	6	O95831-1	377	383	+	6	O95831-1	0	613	ENST00000676436.1	34	1861	++	246	O95831-1#108	0	18	ENST00000676436.1	1153	1171	+	18	0	-12	2028
O95831-1#108	0	6	6	O95831-1	377	383	+	6	O95831-1	0	613	ENST00000676328.1	56	1892	++	245	O95831-1#108	0	18	ENST00000676328.1	1184	1202	+	18	0	-12	2029
O95831-1#108	0	6	6	O95831-1	377	383	+	6	O95831-1	0	613	ENST00000676229.1	223	2050	++	244	O95831-1#108	0	18	ENST00000676229.1	1342	1360	+	18	0	-12	2030
O95831-1#108	0	6	6	O95831-1	377	383	+	6	O95831-1	0	613	ENST00000675857.1	82	1915	++	242	O95831-1#108	0	18	ENST00000675857.1	1207	1225	+	18	0	-12	2031
O95831-1#108	0	6	6	O95831-1	377	383	+	6	O95831-1	0	613	ENST00000675427.1	89	1925	++	240	O95831-1#108	0	18	ENST00000675427.1	1220	1238	+	18	0	-12	2032
O95831-1#108	0	6	6	O95831-1	377	383	+	6	O95831-1	0	524	ENST00000675240.1	169	1741	++	239	O95831-1#108	0	18	ENST00000675240.1	1300	1318	+	18	0	-12	2033
O95831-1#108	0	6	6	O95831-1	377	383	+	6	O95831-1	0	613	ENST00000675092.1	90	1956	++	238	O95831-1#108	0	18	ENST00000675092.1	1221	1239	+	18	0	-12	2034
O95831-1#108	0	6	6	O95831-1	377	383	+	6	O95831-1	0	613	ENST00000675050.1	71	1898	++	237	O95831-1#108	0	18	ENST00000675050.1	1190	1208	+	18	0	-12	2035
O95831-1#108	0	6	6	O95831-1	377	383	+	6	O95831-1	0	459	ENST00000675037.1	56	1433	++	236	O95831-1#108	0	18	ENST00000675037.1	1187	1205	+	18	0	-12	2036
O95831-1#108	0	6	6	O95831-1	377	383	+	6	O95831-1	100	388	ENST00000674957.1	1	865	++	234	O95831-1#108	0	18	ENST00000674957.1	832	850	+	18	0	-12	2037
O95831-1#108	0	6	6	O95831-1	377	383	+	6	O95831-1	338	613	ENST00000674601.1	2	686	++	232	O95831-1#108	0	18	ENST00000674601.1	119	137	+	18	0	-12	2038
O95831-1#108	0	6	6	O95831-1	377	383	+	6	O95831-1	0	587	ENST00000674546.1	185	1954	++	230	O95831-1#108	0	18	ENST00000674546.1	1316	1334	+	18	0	-12	2039
O95831-1#108	0	6	6	O95831-1	377	383	+	6	O95831-1	339	613	ENST00000460436.6	905	1727	++	106	O95831-1#108	0	18	ENST00000460436.6	1019	1037	+	18	0	-12	2040
O95831-1#108	0	6	6	O95831-1	377	383	+	6	O95831-1	0	435	ENST00000416073.7	37	1336	++	76	O95831-1#108	0	18	ENST00000416073.7	1162	1180	+	18	0	-12	2041
O95831-1#108	0	6	6	O95831-1	377	383	+	6	O95831-1	0	613	ENST00000346424.6	24	1002	++	35	O95831-1#108	0	18	ENST00000346424.6	294	312	+	18	0	-12	2042
O95831-1#108	0	6	6	O95831-1	377	383	+	6	O95831-1	0	613	ENST00000319908.8	174	2007	++	26	O95831-1#108	0	18	ENST00000319908.8	1302	1320	+	18	0	-12	2043
O95831-1#108	0	6	6	O95831-1	377	383	+	6	O95831-1	0	613	ENST00000287295.8	185	2024	++	18	O95831-1#108	0	18	ENST00000287295.8	1316	1334	+	18	0	-12	2044
O95831-1#109	0	9	9	O95831-1	387	396	+	9	O95831-1	0	613	ENST00000676436.1	34	1861	++	246	O95831-1#109	0	27	ENST00000676436.1	1183	1210	+	27	0	-18	2045
O95831-1#109	0	9	9	O95831-1	387	396	+	9	O95831-1	0	613	ENST00000676328.1	56	1892	++	245	O95831-1#109	0	27	ENST00000676328.1	1214	1241	+	27	0	-18	2046
O95831-1#109	0	9	9	O95831-1	387	396	+	9	O95831-1	0	613	ENST00000676229.1	223	2050	++	244	O95831-1#109	0	27	ENST00000676229.1	1372	1399	+	27	0	-18	2047
O95831-1#109	0	9	9	O95831-1	387	396	+	9	O95831-1	0	613	ENST00000675857.1	82	1915	++	242	O95831-1#109	0	27	ENST00000675857.1	1237	1264	+	27	0	-18	2048
O95831-1#109	0	9	9	O95831-1	387	396	+	9	O95831-1	0	613	ENST00000675427.1	89	1925	++	240	O95831-1#109	0	27	ENST00000675427.1	1250	1277	+	27	0	-18	2049
O95831-1#109	0	9	9	O95831-1	387	396	+	9	O95831-1	0	524	ENST00000675240.1	169	1741	++	239	O95831-1#109	0	27	ENST00000675240.1	1330	1357	+	27	0	-18	2050
O95831-1#109	0	9	9	O95831-1	387	396	+	9	O95831-1	0	613	ENST00000675092.1	90	1956	++	238	O95831-1#109	0	27	ENST00000675092.1	1251	1278	+	27	0	-18	2051
O95831-1#109	0	9	9	O95831-1	387	396	+	9	O95831-1	0	613	ENST00000675050.1	71	1898	++	237	O95831-1#109	0	27	ENST00000675050.1	1220	1247	+	27	0	-18	2052
O95831-1#109	0	9	9	O95831-1	387	396	+	9	O95831-1	0	459	ENST00000675037.1	56	1433	++	236	O95831-1#109	0	27	ENST00000675037.1	1217	1244	+	27	0	-18	2053
O95831-1#109	0	9	9	O95831-1	387	396	+	9	O95831-1	100	388	ENST00000674957.1	1	865	++	234	O95831-1#109	0	3	ENST00000674957.1	862	865	+	3	0	6	2054
O95831-1#109	0	9	9	O95831-1	387	396	+	9	O95831-1	338	613	ENST00000674601.1	2	686	++	232	O95831-1#109	0	3	ENST00000674601.1	149	152	+	3	0	6	2055
O95831-1#109	0	9	9	O95831-1	387	396	+	9	O95831-1	0	587	ENST00000674546.1	185	1954	++	230	O95831-1#109	0	27	ENST00000674546.1	1346	1373	+	27	0	-18	2056
O95831-1#109	0	9	9	O95831-1	387	396	+	9	O95831-1	339	613	ENST00000460436.6	905	1727	++	106	O95831-1#109	0	27	ENST00000460436.6	1049	1076	+	27	0	-18	2057
O95831-1#109	0	9	9	O95831-1	387	396	+	9	O95831-1	0	435	ENST00000416073.7	37	1336	++	76	O95831-1#109	0	27	ENST00000416073.7	1192	1219	+	27	0	-18	2058
O95831-1#109	0	9	9	O95831-1	387	396	+	9	O95831-1	0	613	ENST00000346424.6	24	1002	++	35	O95831-1#109	0	27	ENST00000346424.6	324	351	+	27	0	-18	2059
O95831-1#109	0	9	9	O95831-1	387	396	+	9	O95831-1	0	613	ENST00000319908.8	174	2007	++	26	O95831-1#109	0	27	ENST00000319908.8	1332	1359	+	27	0	-18	2060
O95831-1#109	0	9	9	O95831-1	387	396	+	9	O95831-1	0	613	ENST00000287295.8	185	2024	++	18	O95831-1#109	0	27	ENST00000287295.8	1346	1373	+	27	0	-18	2061
O95831-1#110	0	3	3	O95831-1	399	402	+	3	O95831-1	0	613	ENST00000676436.1	34	1861	++	246	O95831-1#110	0	9	ENST00000676436.1	1219	1228	+	9	0	-6	2062
O95831-1#110	0	3	3	O95831-1	399	402	+	3	O95831-1	0	613	ENST00000676328.1	56	1892	++	245	O95831-1#110	0	9	ENST00000676328.1	1250	1259	+	9	0	-6	2063
O95831-1#110	0	3	3	O95831-1	399	402	+	3	O95831-1	0	613	ENST00000676229.1	223	2050	++	244	O95831-1#110	0	9	ENST00000676229.1	1408	1417	+	9	0	-6	2064
O95831-1#110	0	3	3	O95831-1	399	402	+	3	O95831-1	0	613	ENST00000675857.1	82	1915	++	242	O95831-1#110	0	9	ENST00000675857.1	1273	1282	+	9	0	-6	2065
O95831-1#110	0	3	3	O95831-1	399	402	+	3	O95831-1	0	613	ENST00000675427.1	89	1925	++	240	O95831-1#110	0	9	ENST00000675427.1	1286	1295	+	9	0	-6	2066
O95831-1#110	0	3	3	O95831-1	399	402	+	3	O95831-1	0	524	ENST00000675240.1	169	1741	++	239	O95831-1#110	0	9	ENST00000675240.1	1366	1375	+	9	0	-6	2067
O95831-1#110	0	3	3	O95831-1	399	402	+	3	O95831-1	0	613	ENST00000675092.1	90	1956	++	238	O95831-1#110	0	9	ENST00000675092.1	1287	1296	+	9	0	-6	2068
O95831-1#110	0	3	3	O95831-1	399	402	+	3	O95831-1	0	613	ENST00000675050.1	71	1898	++	237	O95831-1#110	0	9	ENST00000675050.1	1256	1265	+	9	0	-6	2069
O95831-1#110	0	3	3	O95831-1	399	402	+	3	O95831-1	0	459	ENST00000675037.1	56	1433	++	236	O95831-1#110	0	9	ENST00000675037.1	1253	1262	+	9	0	-6	2070
O95831-1#110	0	3	3	O95831-1	399	402	+	3	O95831-1	0	587	ENST00000674546.1	185	1954	++	230	O95831-1#110	0	9	ENST00000674546.1	1382	1391	+	9	0	-6	2071
O95831-1#110	0	3	3	O95831-1	399	402	+	3	O95831-1	339	613	ENST00000460436.6	905	1727	++	106	O95831-1#110	0	9	ENST00000460436.6	1085	1094	+	9	0	-6	2072
O95831-1#110	0	3	3	O95831-1	399	402	+	3	O95831-1	0	435	ENST00000416073.7	37	1336	++	76	O95831-1#110	0	9	ENST00000416073.7	1228	1237	+	9	0	-6	2073
O95831-1#110	0	3	3	O95831-1	399	402	+	3	O95831-1	0	613	ENST00000346424.6	24	1002	++	35	O95831-1#110	0	9	ENST00000346424.6	360	369	+	9	0	-6	2074
O95831-1#110	0	3	3	O95831-1	399	402	+	3	O95831-1	0	613	ENST00000319908.8	174	2007	++	26	O95831-1#110	0	9	ENST00000319908.8	1368	1377	+	9	0	-6	2075
O95831-1#110	0	3	3	O95831-1	399	402	+	3	O95831-1	0	613	ENST00000287295.8	185	2024	++	18	O95831-1#110	0	9	ENST00000287295.8	1382	1391	+	9	0	-6	2076
O95831-1#111	0	4	4	O95831-1	406	410	+	4	O95831-1	0	613	ENST00000676436.1	34	1861	++	246	O95831-1#111	0	12	ENST00000676436.1	1240	1252	+	12	0	-8	2077
O95831-1#111	0	4	4	O95831-1	406	410	+	4	O95831-1	0	613	ENST00000676328.1	56	1892	++	245	O95831-1#111	0	12	ENST00000676328.1	1271	1283	+	12	0	-8	2078
O95831-1#111	0	4	4	O95831-1	406	410	+	4	O95831-1	0	613	ENST00000676229.1	223	2050	++	244	O95831-1#111	0	12	ENST00000676229.1	1429	1441	+	12	0	-8	2079
O95831-1#111	0	4	4	O95831-1	406	410	+	4	O95831-1	0	613	ENST00000675857.1	82	1915	++	242	O95831-1#111	0	12	ENST00000675857.1	1294	1306	+	12	0	-8	2080
O95831-1#111	0	4	4	O95831-1	406	410	+	4	O95831-1	0	613	ENST00000675427.1	89	1925	++	240	O95831-1#111	0	12	ENST00000675427.1	1307	1319	+	12	0	-8	2081
O95831-1#111	0	4	4	O95831-1	406	410	+	4	O95831-1	0	524	ENST00000675240.1	169	1741	++	239	O95831-1#111	0	12	ENST00000675240.1	1387	1399	+	12	0	-8	2082
O95831-1#111	0	4	4	O95831-1	406	410	+	4	O95831-1	0	613	ENST00000675092.1	90	1956	++	238	O95831-1#111	0	12	ENST00000675092.1	1308	1320	+	12	0	-8	2083
O95831-1#111	0	4	4	O95831-1	406	410	+	4	O95831-1	0	613	ENST00000675050.1	71	1898	++	237	O95831-1#111	0	12	ENST00000675050.1	1277	1289	+	12	0	-8	2084
O95831-1#111	0	4	4	O95831-1	406	410	+	4	O95831-1	0	459	ENST00000675037.1	56	1433	++	236	O95831-1#111	0	12	ENST00000675037.1	1274	1286	+	12	0	-8	2085
O95831-1#111	0	4	4	O95831-1	406	410	+	4	O95831-1	0	587	ENST00000674546.1	185	1954	++	230	O95831-1#111	0	12	ENST00000674546.1	1403	1415	+	12	0	-8	2086
O95831-1#111	0	4	4	O95831-1	406	410	+	4	O95831-1	339	613	ENST00000460436.6	905	1727	++	106	O95831-1#111	0	12	ENST00000460436.6	1106	1118	+	12	0	-8	2087
O95831-1#111	0	4	4	O95831-1	406	410	+	4	O95831-1	0	435	ENST00000416073.7	37	1336	++	76	O95831-1#111	0	12	ENST00000416073.7	1249	1261	+	12	0	-8	2088
O95831-1#111	0	4	4	O95831-1	406	410	+	4	O95831-1	0	613	ENST00000346424.6	24	1002	++	35	O95831-1#111	0	12	ENST00000346424.6	381	393	+	12	0	-8	2089
O95831-1#111	0	4	4	O95831-1	406	410	+	4	O95831-1	0	613	ENST00000319908.8	174	2007	++	26	O95831-1#111	0	12	ENST00000319908.8	1389	1401	+	12	0	-8	2090
O95831-1#111	0	4	4	O95831-1	406	410	+	4	O95831-1	0	613	ENST00000287295.8	185	2024	++	18	O95831-1#111	0	12	ENST00000287295.8	1403	1415	+	12	0	-8	2091
O95831-1#112	0	3	3	O95831-1	415	418	+	3	O95831-1	0	613	ENST00000676436.1	34	1861	++	246	O95831-1#112	0	9	ENST00000676436.1	1267	1276	+	9	0	-6	2092
O95831-1#112	0	3	3	O95831-1	415	418	+	3	O95831-1	0	613	ENST00000676328.1	56	1892	++	245	O95831-1#112	0	9	ENST00000676328.1	1298	1307	+	9	0	-6	2093
O95831-1#112	0	3	3	O95831-1	415	418	+	3	O95831-1	0	613	ENST00000676229.1	223	2050	++	244	O95831-1#112	0	9	ENST00000676229.1	1456	1465	+	9	0	-6	2094
O95831-1#112	0	3	3	O95831-1	415	418	+	3	O95831-1	0	613	ENST00000675857.1	82	1915	++	242	O95831-1#112	0	9	ENST00000675857.1	1321	1330	+	9	0	-6	2095
O95831-1#112	0	3	3	O95831-1	415	418	+	3	O95831-1	0	613	ENST00000675427.1	89	1925	++	240	O95831-1#112	0	9	ENST00000675427.1	1334	1343	+	9	0	-6	2096
O95831-1#112	0	3	3	O95831-1	415	418	+	3	O95831-1	0	524	ENST00000675240.1	169	1741	++	239	O95831-1#112	0	9	ENST00000675240.1	1414	1423	+	9	0	-6	2097
O95831-1#112	0	3	3	O95831-1	415	418	+	3	O95831-1	0	613	ENST00000675092.1	90	1956	++	238	O95831-1#112	0	9	ENST00000675092.1	1335	1344	+	9	0	-6	2098
O95831-1#112	0	3	3	O95831-1	415	418	+	3	O95831-1	0	613	ENST00000675050.1	71	1898	++	237	O95831-1#112	0	9	ENST00000675050.1	1304	1313	+	9	0	-6	2099
O95831-1#112	0	3	3	O95831-1	415	418	+	3	O95831-1	0	459	ENST00000675037.1	56	1433	++	236	O95831-1#112	0	9	ENST00000675037.1	1301	1310	+	9	0	-6	2100
O95831-1#112	0	3	3	O95831-1	415	418	+	3	O95831-1	0	587	ENST00000674546.1	185	1954	++	230	O95831-1#112	0	9	ENST00000674546.1	1430	1439	+	9	0	-6	2101
O95831-1#112	0	3	3	O95831-1	415	418	+	3	O95831-1	339	613	ENST00000460436.6	905	1727	++	106	O95831-1#112	0	9	ENST00000460436.6	1133	1142	+	9	0	-6	2102
O95831-1#112	0	3	3	O95831-1	415	418	+	3	O95831-1	0	435	ENST00000416073.7	37	1336	++	76	O95831-1#112	0	9	ENST00000416073.7	1276	1285	+	9	0	-6	2103
O95831-1#112	0	3	3	O95831-1	415	418	+	3	O95831-1	0	613	ENST00000346424.6	24	1002	++	35	O95831-1#112	0	9	ENST00000346424.6	408	417	+	9	0	-6	2104
O95831-1#112	0	3	3	O95831-1	415	418	+	3	O95831-1	0	613	ENST00000319908.8	174	2007	++	26	O95831-1#112	0	9	ENST00000319908.8	1416	1425	+	9	0	-6	2105
O95831-1#112	0	3	3	O95831-1	415	418	+	3	O95831-1	0	613	ENST00000287295.8	185	2024	++	18	O95831-1#112	0	9	ENST00000287295.8	1430	1439	+	9	0	-6	2106
O95831-1#113	0	3	3	O95831-1	419	422	+	3	O95831-1	0	613	ENST00000676436.1	34	1861	++	246	O95831-1#113	0	9	ENST00000676436.1	1279	1288	+	9	0	-6	2107
O95831-1#113	0	3	3	O95831-1	419	422	+	3	O95831-1	0	613	ENST00000676328.1	56	1892	++	245	O95831-1#113	0	9	ENST00000676328.1	1310	1319	+	9	0	-6	2108
O95831-1#113	0	3	3	O95831-1	419	422	+	3	O95831-1	0	613	ENST00000676229.1	223	2050	++	244	O95831-1#113	0	9	ENST00000676229.1	1468	1477	+	9	0	-6	2109
O95831-1#113	0	3	3	O95831-1	419	422	+	3	O95831-1	0	613	ENST00000675857.1	82	1915	++	242	O95831-1#113	0	9	ENST00000675857.1	1333	1342	+	9	0	-6	2110
O95831-1#113	0	3	3	O95831-1	419	422	+	3	O95831-1	0	613	ENST00000675427.1	89	1925	++	240	O95831-1#113	0	9	ENST00000675427.1	1346	1355	+	9	0	-6	2111
O95831-1#113	0	3	3	O95831-1	419	422	+	3	O95831-1	0	524	ENST00000675240.1	169	1741	++	239	O95831-1#113	0	9	ENST00000675240.1	1426	1435	+	9	0	-6	2112
O95831-1#113	0	3	3	O95831-1	419	422	+	3	O95831-1	0	613	ENST00000675092.1	90	1956	++	238	O95831-1#113	0	9	ENST00000675092.1	1347	1356	+	9	0	-6	2113
O95831-1#113	0	3	3	O95831-1	419	422	+	3	O95831-1	0	613	ENST00000675050.1	71	1898	++	237	O95831-1#113	0	9	ENST00000675050.1	1316	1325	+	9	0	-6	2114
O95831-1#113	0	3	3	O95831-1	419	422	+	3	O95831-1	0	459	ENST00000675037.1	56	1433	++	236	O95831-1#113	0	9	ENST00000675037.1	1313	1322	+	9	0	-6	2115
O95831-1#113	0	3	3	O95831-1	419	422	+	3	O95831-1	0	587	ENST00000674546.1	185	1954	++	230	O95831-1#113	0	9	ENST00000674546.1	1442	1451	+	9	0	-6	2116
O95831-1#113	0	3	3	O95831-1	419	422	+	3	O95831-1	339	613	ENST00000460436.6	905	1727	++	106	O95831-1#113	0	9	ENST00000460436.6	1145	1154	+	9	0	-6	2117
O95831-1#113	0	3	3	O95831-1	419	422	+	3	O95831-1	0	435	ENST00000416073.7	37	1336	++	76	O95831-1#113	0	9	ENST00000416073.7	1288	1297	+	9	0	-6	2118
O95831-1#113	0	3	3	O95831-1	419	422	+	3	O95831-1	0	613	ENST00000346424.6	24	1002	++	35	O95831-1#113	0	9	ENST00000346424.6	420	429	+	9	0	-6	2119
O95831-1#113	0	3	3	O95831-1	419	422	+	3	O95831-1	0	613	ENST00000319908.8	174	2007	++	26	O95831-1#113	0	9	ENST00000319908.8	1428	1437	+	9	0	-6	2120
O95831-1#113	0	3	3	O95831-1	419	422	+	3	O95831-1	0	613	ENST00000287295.8	185	2024	++	18	O95831-1#113	0	9	ENST00000287295.8	1442	1451	+	9	0	-6	2121
O95831-1#114	0	4	4	O95831-1	426	430	+	4	O95831-1	0	613	ENST00000676436.1	34	1861	++	246	O95831-1#114	0	12	ENST00000676436.1	1300	1312	+	12	0	-8	2122
O95831-1#114	0	4	4	O95831-1	426	430	+	4	O95831-1	0	613	ENST00000676328.1	56	1892	++	245	O95831-1#114	0	12	ENST00000676328.1	1331	1343	+	12	0	-8	2123
O95831-1#114	0	4	4	O95831-1	426	430	+	4	O95831-1	0	613	ENST00000676229.1	223	2050	++	244	O95831-1#114	0	12	ENST00000676229.1	1489	1501	+	12	0	-8	2124
O95831-1#114	0	4	4	O95831-1	426	430	+	4	O95831-1	0	613	ENST00000675857.1	82	1915	++	242	O95831-1#114	0	12	ENST00000675857.1	1354	1366	+	12	0	-8	2125
O95831-1#114	0	4	4	O95831-1	426	430	+	4	O95831-1	0	613	ENST00000675427.1	89	1925	++	240	O95831-1#114	0	12	ENST00000675427.1	1367	1379	+	12	0	-8	2126
O95831-1#114	0	4	4	O95831-1	426	430	+	4	O95831-1	0	524	ENST00000675240.1	169	1741	++	239	O95831-1#114	0	12	ENST00000675240.1	1447	1459	+	12	0	-8	2127
O95831-1#114	0	4	4	O95831-1	426	430	+	4	O95831-1	0	613	ENST00000675092.1	90	1956	++	238	O95831-1#114	0	12	ENST00000675092.1	1368	1380	+	12	0	-8	2128
O95831-1#114	0	4	4	O95831-1	426	430	+	4	O95831-1	0	613	ENST00000675050.1	71	1898	++	237	O95831-1#114	0	12	ENST00000675050.1	1337	1349	+	12	0	-8	2129
O95831-1#114	0	4	4	O95831-1	426	430	+	4	O95831-1	0	459	ENST00000675037.1	56	1433	++	236	O95831-1#114	0	12	ENST00000675037.1	1334	1346	+	12	0	-8	2130
O95831-1#114	0	4	4	O95831-1	426	430	+	4	O95831-1	0	587	ENST00000674546.1	185	1954	++	230	O95831-1#114	0	12	ENST00000674546.1	1463	1475	+	12	0	-8	2131
O95831-1#114	0	4	4	O95831-1	426	430	+	4	O95831-1	339	613	ENST00000460436.6	905	1727	++	106	O95831-1#114	0	12	ENST00000460436.6	1166	1178	+	12	0	-8	2132
O95831-1#114	0	4	4	O95831-1	426	430	+	4	O95831-1	0	435	ENST00000416073.7	37	1336	++	76	O95831-1#114	0	12	ENST00000416073.7	1309	1321	+	12	0	-8	2133
O95831-1#114	0	4	4	O95831-1	426	430	+	4	O95831-1	0	613	ENST00000346424.6	24	1002	++	35	O95831-1#114	0	12	ENST00000346424.6	441	453	+	12	0	-8	2134
O95831-1#114	0	4	4	O95831-1	426	430	+	4	O95831-1	0	613	ENST00000319908.8	174	2007	++	26	O95831-1#114	0	12	ENST00000319908.8	1449	1461	+	12	0	-8	2135
O95831-1#114	0	4	4	O95831-1	426	430	+	4	O95831-1	0	613	ENST00000287295.8	185	2024	++	18	O95831-1#114	0	12	ENST00000287295.8	1463	1475	+	12	0	-8	2136
O95831-1#115	0	3	3	O95831-1	432	435	+	3	O95831-1	0	613	ENST00000676436.1	34	1861	++	246	O95831-1#115	0	9	ENST00000676436.1	1318	1327	+	9	0	-6	2137
O95831-1#115	0	3	3	O95831-1	432	435	+	3	O95831-1	0	613	ENST00000676328.1	56	1892	++	245	O95831-1#115	0	9	ENST00000676328.1	1349	1358	+	9	0	-6	2138
O95831-1#115	0	3	3	O95831-1	432	435	+	3	O95831-1	0	613	ENST00000676229.1	223	2050	++	244	O95831-1#115	0	9	ENST00000676229.1	1507	1516	+	9	0	-6	2139
O95831-1#115	0	3	3	O95831-1	432	435	+	3	O95831-1	0	613	ENST00000675857.1	82	1915	++	242	O95831-1#115	0	9	ENST00000675857.1	1372	1381	+	9	0	-6	2140
O95831-1#115	0	3	3	O95831-1	432	435	+	3	O95831-1	0	613	ENST00000675427.1	89	1925	++	240	O95831-1#115	0	6	ENST00000675427.1	1385	1391	+	6	0	-3	2141
O95831-1#115	0	3	3	O95831-1	432	435	+	3	O95831-1	0	524	ENST00000675240.1	169	1741	++	239	O95831-1#115	0	9	ENST00000675240.1	1465	1474	+	9	0	-6	2142
O95831-1#115	0	3	3	O95831-1	432	435	+	3	O95831-1	0	613	ENST00000675092.1	90	1956	++	238	O95831-1#115	0	9	ENST00000675092.1	1386	1395	+	9	0	-6	2143
O95831-1#115	0	3	3	O95831-1	432	435	+	3	O95831-1	0	613	ENST00000675050.1	71	1898	++	237	O95831-1#115	0	9	ENST00000675050.1	1355	1364	+	9	0	-6	2144
O95831-1#115	0	3	3	O95831-1	432	435	+	3	O95831-1	0	459	ENST00000675037.1	56	1433	++	236	O95831-1#115	0	9	ENST00000675037.1	1352	1361	+	9	0	-6	2145
O95831-1#115	0	3	3	O95831-1	432	435	+	3	O95831-1	0	587	ENST00000674546.1	185	1954	++	230	O95831-1#115	0	9	ENST00000674546.1	1481	1490	+	9	0	-6	2146
O95831-1#115	0	3	3	O95831-1	432	435	+	3	O95831-1	339	613	ENST00000460436.6	905	1727	++	106	O95831-1#115	0	9	ENST00000460436.6	1184	1193	+	9	0	-6	2147
O95831-1#115	0	3	3	O95831-1	432	435	+	3	O95831-1	0	435	ENST00000416073.7	37	1336	++	76	O95831-1#115	0	9	ENST00000416073.7	1327	1336	+	9	0	-6	2148
O95831-1#115	0	3	3	O95831-1	432	435	+	3	O95831-1	0	613	ENST00000346424.6	24	1002	++	35	O95831-1#115	0	9	ENST00000346424.6	459	468	+	9	0	-6	2149
O95831-1#115	0	3	3	O95831-1	432	435	+	3	O95831-1	0	613	ENST00000319908.8	174	2007	++	26	O95831-1#115	0	9	ENST00000319908.8	1467	1476	+	9	0	-6	2150
O95831-1#115	0	3	3	O95831-1	432	435	+	3	O95831-1	0	613	ENST00000287295.8	185	2024	++	18	O95831-1#115	0	9	ENST00000287295.8	1481	1490	+	9	0	-6	2151
O95831-1#116	0	3	3	O95831-1	436	439	+	3	O95831-1	0	613	ENST00000676436.1	34	1861	++	246	O95831-1#116	0	9	ENST00000676436.1	1330	1339	+	9	0	-6	2152
O95831-1#116	0	3	3	O95831-1	436	439	+	3	O95831-1	0	613	ENST00000676328.1	56	1892	++	245	O95831-1#116	0	9	ENST00000676328.1	1361	1370	+	9	0	-6	2153
O95831-1#116	0	3	3	O95831-1	436	439	+	3	O95831-1	0	613	ENST00000676229.1	223	2050	++	244	O95831-1#116	0	9	ENST00000676229.1	1519	1528	+	9	0	-6	2154
O95831-1#116	0	3	3	O95831-1	436	439	+	3	O95831-1	0	613	ENST00000675857.1	82	1915	++	242	O95831-1#116	0	9	ENST00000675857.1	1384	1393	+	9	0	-6	2155
O95831-1#116	0	3	3	O95831-1	436	439	+	3	O95831-1	0	613	ENST00000675427.1	89	1925	++	240	O95831-1#116	0	9	ENST00000675427.1	1394	1403	+	9	0	-6	2156
O95831-1#116	0	3	3	O95831-1	436	439	+	3	O95831-1	0	524	ENST00000675240.1	169	1741	++	239	O95831-1#116	0	9	ENST00000675240.1	1477	1486	+	9	0	-6	2157
O95831-1#116	0	3	3	O95831-1	436	439	+	3	O95831-1	0	613	ENST00000675092.1	90	1956	++	238	O95831-1#116	0	9	ENST00000675092.1	1398	1407	+	9	0	-6	2158
O95831-1#116	0	3	3	O95831-1	436	439	+	3	O95831-1	0	613	ENST00000675050.1	71	1898	++	237	O95831-1#116	0	9	ENST00000675050.1	1367	1376	+	9	0	-6	2159
O95831-1#116	0	3	3	O95831-1	436	439	+	3	O95831-1	0	459	ENST00000675037.1	56	1433	++	236	O95831-1#116	0	9	ENST00000675037.1	1364	1373	+	9	0	-6	2160
O95831-1#116	0	3	3	O95831-1	436	439	+	3	O95831-1	338	613	ENST00000674601.1	2	686	++	232	O95831-1#116	0	9	ENST00000674601.1	155	164	+	9	0	-6	2161
O95831-1#116	0	3	3	O95831-1	436	439	+	3	O95831-1	0	587	ENST00000674546.1	185	1954	++	230	O95831-1#116	0	9	ENST00000674546.1	1493	1502	+	9	0	-6	2162
O95831-1#116	0	3	3	O95831-1	436	439	+	3	O95831-1	339	613	ENST00000460436.6	905	1727	++	106	O95831-1#116	0	9	ENST00000460436.6	1196	1205	+	9	0	-6	2163
O95831-1#116	0	3	3	O95831-1	436	439	+	3	O95831-1	0	613	ENST00000346424.6	24	1002	++	35	O95831-1#116	0	9	ENST00000346424.6	471	480	+	9	0	-6	2164
O95831-1#116	0	3	3	O95831-1	436	439	+	3	O95831-1	0	613	ENST00000319908.8	174	2007	++	26	O95831-1#116	0	9	ENST00000319908.8	1479	1488	+	9	0	-6	2165
O95831-1#116	0	3	3	O95831-1	436	439	+	3	O95831-1	0	613	ENST00000287295.8	185	2024	++	18	O95831-1#116	0	9	ENST00000287295.8	1493	1502	+	9	0	-6	2166
O95831-1#117	0	5	5	O95831-1	439	444	+	5	O95831-1	0	613	ENST00000676436.1	34	1861	++	246	O95831-1#117	0	15	ENST00000676436.1	1339	1354	+	15	0	-10	2167
O95831-1#117	0	5	5	O95831-1	439	444	+	5	O95831-1	0	613	ENST00000676328.1	56	1892	++	245	O95831-1#117	0	15	ENST00000676328.1	1370	1385	+	15	0	-10	2168
O95831-1#117	0	5	5	O95831-1	439	444	+	5	O95831-1	0	613	ENST00000676229.1	223	2050	++	244	O95831-1#117	0	15	ENST00000676229.1	1528	1543	+	15	0	-10	2169
O95831-1#117	0	5	5	O95831-1	439	444	+	5	O95831-1	0	613	ENST00000675857.1	82	1915	++	242	O95831-1#117	0	15	ENST00000675857.1	1393	1408	+	15	0	-10	2170
O95831-1#117	0	5	5	O95831-1	439	444	+	5	O95831-1	0	613	ENST00000675427.1	89	1925	++	240	O95831-1#117	0	15	ENST00000675427.1	1403	1418	+	15	0	-10	2171
O95831-1#117	0	5	5	O95831-1	439	444	+	5	O95831-1	0	524	ENST00000675240.1	169	1741	++	239	O95831-1#117	0	15	ENST00000675240.1	1486	1501	+	15	0	-10	2172
O95831-1#117	0	5	5	O95831-1	439	444	+	5	O95831-1	0	613	ENST00000675092.1	90	1956	++	238	O95831-1#117	0	15	ENST00000675092.1	1407	1422	+	15	0	-10	2173
O95831-1#117	0	5	5	O95831-1	439	444	+	5	O95831-1	0	613	ENST00000675050.1	71	1898	++	237	O95831-1#117	0	15	ENST00000675050.1	1376	1391	+	15	0	-10	2174
O95831-1#117	0	5	5	O95831-1	439	444	+	5	O95831-1	0	459	ENST00000675037.1	56	1433	++	236	O95831-1#117	0	15	ENST00000675037.1	1373	1388	+	15	0	-10	2175
O95831-1#117	0	5	5	O95831-1	439	444	+	5	O95831-1	338	613	ENST00000674601.1	2	686	++	232	O95831-1#117	0	15	ENST00000674601.1	164	179	+	15	0	-10	2176
O95831-1#117	0	5	5	O95831-1	439	444	+	5	O95831-1	0	587	ENST00000674546.1	185	1954	++	230	O95831-1#117	0	15	ENST00000674546.1	1502	1517	+	15	0	-10	2177
O95831-1#117	0	5	5	O95831-1	439	444	+	5	O95831-1	339	613	ENST00000460436.6	905	1727	++	106	O95831-1#117	0	15	ENST00000460436.6	1205	1220	+	15	0	-10	2178
O95831-1#117	0	5	5	O95831-1	439	444	+	5	O95831-1	0	613	ENST00000346424.6	24	1002	++	35	O95831-1#117	0	15	ENST00000346424.6	480	495	+	15	0	-10	2179
O95831-1#117	0	5	5	O95831-1	439	444	+	5	O95831-1	0	613	ENST00000319908.8	174	2007	++	26	O95831-1#117	0	15	ENST00000319908.8	1488	1503	+	15	0	-10	2180
O95831-1#117	0	5	5	O95831-1	439	444	+	5	O95831-1	0	613	ENST00000287295.8	185	2024	++	18	O95831-1#117	0	15	ENST00000287295.8	1502	1517	+	15	0	-10	2181
O95831-1#118	0	3	3	O95831-1	444	447	+	3	O95831-1	0	613	ENST00000676436.1	34	1861	++	246	O95831-1#118	0	9	ENST00000676436.1	1354	1363	+	9	0	-6	2182
O95831-1#118	0	3	3	O95831-1	444	447	+	3	O95831-1	0	613	ENST00000676328.1	56	1892	++	245	O95831-1#118	0	9	ENST00000676328.1	1385	1394	+	9	0	-6	2183
O95831-1#118	0	3	3	O95831-1	444	447	+	3	O95831-1	0	613	ENST00000676229.1	223	2050	++	244	O95831-1#118	0	9	ENST00000676229.1	1543	1552	+	9	0	-6	2184
O95831-1#118	0	3	3	O95831-1	444	447	+	3	O95831-1	0	613	ENST00000675857.1	82	1915	++	242	O95831-1#118	0	9	ENST00000675857.1	1408	1417	+	9	0	-6	2185
O95831-1#118	0	3	3	O95831-1	444	447	+	3	O95831-1	0	613	ENST00000675427.1	89	1925	++	240	O95831-1#118	0	9	ENST00000675427.1	1418	1427	+	9	0	-6	2186
O95831-1#118	0	3	3	O95831-1	444	447	+	3	O95831-1	0	524	ENST00000675240.1	169	1741	++	239	O95831-1#118	0	9	ENST00000675240.1	1501	1510	+	9	0	-6	2187
O95831-1#118	0	3	3	O95831-1	444	447	+	3	O95831-1	0	613	ENST00000675092.1	90	1956	++	238	O95831-1#118	0	9	ENST00000675092.1	1422	1431	+	9	0	-6	2188
O95831-1#118	0	3	3	O95831-1	444	447	+	3	O95831-1	0	613	ENST00000675050.1	71	1898	++	237	O95831-1#118	0	9	ENST00000675050.1	1391	1400	+	9	0	-6	2189
O95831-1#118	0	3	3	O95831-1	444	447	+	3	O95831-1	0	459	ENST00000675037.1	56	1433	++	236	O95831-1#118	0	9	ENST00000675037.1	1388	1397	+	9	0	-6	2190
O95831-1#118	0	3	3	O95831-1	444	447	+	3	O95831-1	338	613	ENST00000674601.1	2	686	++	232	O95831-1#118	0	9	ENST00000674601.1	179	188	+	9	0	-6	2191
O95831-1#118	0	3	3	O95831-1	444	447	+	3	O95831-1	0	587	ENST00000674546.1	185	1954	++	230	O95831-1#118	0	9	ENST00000674546.1	1517	1526	+	9	0	-6	2192
O95831-1#118	0	3	3	O95831-1	444	447	+	3	O95831-1	339	613	ENST00000460436.6	905	1727	++	106	O95831-1#118	0	9	ENST00000460436.6	1220	1229	+	9	0	-6	2193
O95831-1#118	0	3	3	O95831-1	444	447	+	3	O95831-1	0	613	ENST00000346424.6	24	1002	++	35	O95831-1#118	0	9	ENST00000346424.6	495	504	+	9	0	-6	2194
O95831-1#118	0	3	3	O95831-1	444	447	+	3	O95831-1	0	613	ENST00000319908.8	174	2007	++	26	O95831-1#118	0	9	ENST00000319908.8	1503	1512	+	9	0	-6	2195
O95831-1#118	0	3	3	O95831-1	444	447	+	3	O95831-1	0	613	ENST00000287295.8	185	2024	++	18	O95831-1#118	0	9	ENST00000287295.8	1517	1526	+	9	0	-6	2196
O95831-1#119	0	3	3	O95831-1	447	450	+	3	O95831-1	0	613	ENST00000676436.1	34	1861	++	246	O95831-1#119	0	9	ENST00000676436.1	1363	1372	+	9	0	-6	2197
O95831-1#119	0	3	3	O95831-1	447	450	+	3	O95831-1	0	613	ENST00000676328.1	56	1892	++	245	O95831-1#119	0	9	ENST00000676328.1	1394	1403	+	9	0	-6	2198
O95831-1#119	0	3	3	O95831-1	447	450	+	3	O95831-1	0	613	ENST00000676229.1	223	2050	++	244	O95831-1#119	0	9	ENST00000676229.1	1552	1561	+	9	0	-6	2199
O95831-1#119	0	3	3	O95831-1	447	450	+	3	O95831-1	0	613	ENST00000675857.1	82	1915	++	242	O95831-1#119	0	9	ENST00000675857.1	1417	1426	+	9	0	-6	2200
O95831-1#119	0	3	3	O95831-1	447	450	+	3	O95831-1	0	613	ENST00000675427.1	89	1925	++	240	O95831-1#119	0	9	ENST00000675427.1	1427	1436	+	9	0	-6	2201
O95831-1#119	0	3	3	O95831-1	447	450	+	3	O95831-1	0	524	ENST00000675240.1	169	1741	++	239	O95831-1#119	0	9	ENST00000675240.1	1510	1519	+	9	0	-6	2202
O95831-1#119	0	3	3	O95831-1	447	450	+	3	O95831-1	0	613	ENST00000675092.1	90	1956	++	238	O95831-1#119	0	9	ENST00000675092.1	1431	1440	+	9	0	-6	2203
O95831-1#119	0	3	3	O95831-1	447	450	+	3	O95831-1	0	613	ENST00000675050.1	71	1898	++	237	O95831-1#119	0	9	ENST00000675050.1	1400	1409	+	9	0	-6	2204
O95831-1#119	0	3	3	O95831-1	447	450	+	3	O95831-1	0	459	ENST00000675037.1	56	1433	++	236	O95831-1#119	0	9	ENST00000675037.1	1397	1406	+	9	0	-6	2205
O95831-1#119	0	3	3	O95831-1	447	450	+	3	O95831-1	338	613	ENST00000674601.1	2	686	++	232	O95831-1#119	0	9	ENST00000674601.1	188	197	+	9	0	-6	2206
O95831-1#119	0	3	3	O95831-1	447	450	+	3	O95831-1	0	587	ENST00000674546.1	185	1954	++	230	O95831-1#119	0	9	ENST00000674546.1	1526	1535	+	9	0	-6	2207
O95831-1#119	0	3	3	O95831-1	447	450	+	3	O95831-1	339	613	ENST00000460436.6	905	1727	++	106	O95831-1#119	0	9	ENST00000460436.6	1229	1238	+	9	0	-6	2208
O95831-1#119	0	3	3	O95831-1	447	450	+	3	O95831-1	0	613	ENST00000346424.6	24	1002	++	35	O95831-1#119	0	9	ENST00000346424.6	504	513	+	9	0	-6	2209
O95831-1#119	0	3	3	O95831-1	447	450	+	3	O95831-1	0	613	ENST00000319908.8	174	2007	++	26	O95831-1#119	0	9	ENST00000319908.8	1512	1521	+	9	0	-6	2210
O95831-1#119	0	3	3	O95831-1	447	450	+	3	O95831-1	0	613	ENST00000287295.8	185	2024	++	18	O95831-1#119	0	9	ENST00000287295.8	1526	1535	+	9	0	-6	2211
O95831-1#120	0	14	14	O95831-1	454	468	+	14	O95831-1	0	613	ENST00000676436.1	34	1861	++	246	O95831-1#120	0	42	ENST00000676436.1	1384	1426	+	42	0	-28	2212
O95831-1#120	0	14	14	O95831-1	454	468	+	14	O95831-1	0	613	ENST00000676328.1	56	1892	++	245	O95831-1#120	0	42	ENST00000676328.1	1415	1457	+	42	0	-28	2213
O95831-1#120	0	14	14	O95831-1	454	468	+	14	O95831-1	0	613	ENST00000676229.1	223	2050	++	244	O95831-1#120	0	42	ENST00000676229.1	1573	1615	+	42	0	-28	2214
O95831-1#120	0	14	14	O95831-1	454	468	+	14	O95831-1	0	613	ENST00000675857.1	82	1915	++	242	O95831-1#120	0	42	ENST00000675857.1	1438	1480	+	42	0	-28	2215
O95831-1#120	0	14	14	O95831-1	454	468	+	14	O95831-1	0	613	ENST00000675427.1	89	1925	++	240	O95831-1#120	0	42	ENST00000675427.1	1448	1490	+	42	0	-28	2216
O95831-1#120	0	14	14	O95831-1	454	468	+	14	O95831-1	0	524	ENST00000675240.1	169	1741	++	239	O95831-1#120	0	42	ENST00000675240.1	1531	1573	+	42	0	-28	2217
O95831-1#120	0	14	14	O95831-1	454	468	+	14	O95831-1	0	613	ENST00000675092.1	90	1956	++	238	O95831-1#120	0	42	ENST00000675092.1	1452	1494	+	42	0	-28	2218
O95831-1#120	0	14	14	O95831-1	454	468	+	14	O95831-1	0	613	ENST00000675050.1	71	1898	++	237	O95831-1#120	0	42	ENST00000675050.1	1421	1463	+	42	0	-28	2219
O95831-1#120	0	14	14	O95831-1	454	468	+	14	O95831-1	0	459	ENST00000675037.1	56	1433	++	236	O95831-1#120	0	15	ENST00000675037.1	1418	1433	+	15	0	-1	2220
O95831-1#120	0	14	14	O95831-1	454	468	+	14	O95831-1	338	613	ENST00000674601.1	2	686	++	232	O95831-1#120	0	42	ENST00000674601.1	209	251	+	42	0	-28	2221
O95831-1#120	0	14	14	O95831-1	454	468	+	14	O95831-1	0	587	ENST00000674546.1	185	1954	++	230	O95831-1#120	0	42	ENST00000674546.1	1547	1589	+	42	0	-28	2222
O95831-1#120	0	14	14	O95831-1	454	468	+	14	O95831-1	339	613	ENST00000460436.6	905	1727	++	106	O95831-1#120	0	42	ENST00000460436.6	1250	1292	+	42	0	-28	2223
O95831-1#120	0	14	14	O95831-1	454	468	+	14	O95831-1	0	613	ENST00000346424.6	24	1002	++	35	O95831-1#120	0	42	ENST00000346424.6	525	567	+	42	0	-28	2224
O95831-1#120	0	14	14	O95831-1	454	468	+	14	O95831-1	0	613	ENST00000319908.8	174	2007	++	26	O95831-1#120	0	42	ENST00000319908.8	1533	1575	+	42	0	-28	2225
O95831-1#120	0	14	14	O95831-1	454	468	+	14	O95831-1	0	613	ENST00000287295.8	185	2024	++	18	O95831-1#120	0	42	ENST00000287295.8	1547	1589	+	42	0	-28	2226
O95831-1#121	0	3	3	O95831-1	468	471	+	3	O95831-1	0	613	ENST00000676436.1	34	1861	++	246	O95831-1#121	0	9	ENST00000676436.1	1426	1435	+	9	0	-6	2227
O95831-1#121	0	3	3	O95831-1	468	471	+	3	O95831-1	0	613	ENST00000676328.1	56	1892	++	245	O95831-1#121	0	9	ENST00000676328.1	1457	1466	+	9	0	-6	2228
O95831-1#121	0	3	3	O95831-1	468	471	+	3	O95831-1	0	613	ENST00000676229.1	223	2050	++	244	O95831-1#121	0	9	ENST00000676229.1	1615	1624	+	9	0	-6	2229
O95831-1#121	0	3	3	O95831-1	468	471	+	3	O95831-1	0	613	ENST00000675857.1	82	1915	++	242	O95831-1#121	0	9	ENST00000675857.1	1480	1489	+	9	0	-6	2230
O95831-1#121	0	3	3	O95831-1	468	471	+	3	O95831-1	0	613	ENST00000675427.1	89	1925	++	240	O95831-1#121	0	9	ENST00000675427.1	1490	1499	+	9	0	-6	2231
O95831-1#121	0	3	3	O95831-1	468	471	+	3	O95831-1	0	524	ENST00000675240.1	169	1741	++	239	O95831-1#121	0	9	ENST00000675240.1	1573	1582	+	9	0	-6	2232
O95831-1#121	0	3	3	O95831-1	468	471	+	3	O95831-1	0	613	ENST00000675092.1	90	1956	++	238	O95831-1#121	0	9	ENST00000675092.1	1494	1503	+	9	0	-6	2233
O95831-1#121	0	3	3	O95831-1	468	471	+	3	O95831-1	0	613	ENST00000675050.1	71	1898	++	237	O95831-1#121	0	9	ENST00000675050.1	1463	1472	+	9	0	-6	2234
O95831-1#121	0	3	3	O95831-1	468	471	+	3	O95831-1	338	613	ENST00000674601.1	2	686	++	232	O95831-1#121	0	9	ENST00000674601.1	251	260	+	9	0	-6	2235
O95831-1#121	0	3	3	O95831-1	468	471	+	3	O95831-1	0	587	ENST00000674546.1	185	1954	++	230	O95831-1#121	0	9	ENST00000674546.1	1589	1598	+	9	0	-6	2236
O95831-1#121	0	3	3	O95831-1	468	471	+	3	O95831-1	339	613	ENST00000460436.6	905	1727	++	106	O95831-1#121	0	9	ENST00000460436.6	1292	1301	+	9	0	-6	2237
O95831-1#121	0	3	3	O95831-1	468	471	+	3	O95831-1	0	613	ENST00000346424.6	24	1002	++	35	O95831-1#121	0	9	ENST00000346424.6	567	576	+	9	0	-6	2238
O95831-1#121	0	3	3	O95831-1	468	471	+	3	O95831-1	0	613	ENST00000319908.8	174	2007	++	26	O95831-1#121	0	9	ENST00000319908.8	1575	1584	+	9	0	-6	2239
O95831-1#121	0	3	3	O95831-1	468	471	+	3	O95831-1	0	613	ENST00000287295.8	185	2024	++	18	O95831-1#121	0	9	ENST00000287295.8	1589	1598	+	9	0	-6	2240
O95831-1#122	0	7	7	O95831-1	480	487	+	7	O95831-1	0	613	ENST00000676436.1	34	1861	++	246	O95831-1#122	0	21	ENST00000676436.1	1462	1483	+	21	0	-14	2241
O95831-1#122	0	7	7	O95831-1	480	487	+	7	O95831-1	0	613	ENST00000676328.1	56	1892	++	245	O95831-1#122	0	21	ENST00000676328.1	1493	1514	+	21	0	-14	2242
O95831-1#122	0	7	7	O95831-1	480	487	+	7	O95831-1	0	613	ENST00000676229.1	223	2050	++	244	O95831-1#122	0	21	ENST00000676229.1	1651	1672	+	21	0	-14	2243
O95831-1#122	0	7	7	O95831-1	480	487	+	7	O95831-1	0	613	ENST00000675857.1	82	1915	++	242	O95831-1#122	0	21	ENST00000675857.1	1516	1537	+	21	0	-14	2244
O95831-1#122	0	7	7	O95831-1	480	487	+	7	O95831-1	0	613	ENST00000675427.1	89	1925	++	240	O95831-1#122	0	21	ENST00000675427.1	1526	1547	+	21	0	-14	2245
O95831-1#122	0	7	7	O95831-1	480	487	+	7	O95831-1	0	524	ENST00000675240.1	169	1741	++	239	O95831-1#122	0	21	ENST00000675240.1	1609	1630	+	21	0	-14	2246
O95831-1#122	0	7	7	O95831-1	480	487	+	7	O95831-1	0	613	ENST00000675092.1	90	1956	++	238	O95831-1#122	0	21	ENST00000675092.1	1530	1551	+	21	0	-14	2247
O95831-1#122	0	7	7	O95831-1	480	487	+	7	O95831-1	0	613	ENST00000675050.1	71	1898	++	237	O95831-1#122	0	21	ENST00000675050.1	1499	1520	+	21	0	-14	2248
O95831-1#122	0	7	7	O95831-1	480	487	+	7	O95831-1	338	613	ENST00000674601.1	2	686	++	232	O95831-1#122	0	21	ENST00000674601.1	287	308	+	21	0	-14	2249
O95831-1#122	0	7	7	O95831-1	480	487	+	7	O95831-1	0	587	ENST00000674546.1	185	1954	++	230	O95831-1#122	0	21	ENST00000674546.1	1625	1646	+	21	0	-14	2250
O95831-1#122	0	7	7	O95831-1	480	487	+	7	O95831-1	339	613	ENST00000460436.6	905	1727	++	106	O95831-1#122	0	21	ENST00000460436.6	1328	1349	+	21	0	-14	2251
O95831-1#122	0	7	7	O95831-1	480	487	+	7	O95831-1	0	613	ENST00000346424.6	24	1002	++	35	O95831-1#122	0	21	ENST00000346424.6	603	624	+	21	0	-14	2252
O95831-1#122	0	7	7	O95831-1	480	487	+	7	O95831-1	0	613	ENST00000319908.8	174	2007	++	26	O95831-1#122	0	21	ENST00000319908.8	1611	1629	+	18	0	-14	2253
O95831-1#122	0	7	7	O95831-1	480	487	+	7	O95831-1	0	613	ENST00000287295.8	185	2024	++	18	O95831-1#122	0	21	ENST00000287295.8	1625	1646	+	21	0	-14	2254
O95831-1#123	0	6	6	O95831-1	490	496	+	6	O95831-1	0	613	ENST00000676436.1	34	1861	++	246	O95831-1#123	0	18	ENST00000676436.1	1492	1510	+	18	0	-12	2255
O95831-1#123	0	6	6	O95831-1	490	496	+	6	O95831-1	0	613	ENST00000676328.1	56	1892	++	245	O95831-1#123	0	18	ENST00000676328.1	1523	1541	+	18	0	-12	2256
O95831-1#123	0	6	6	O95831-1	490	496	+	6	O95831-1	0	613	ENST00000676229.1	223	2050	++	244	O95831-1#123	0	18	ENST00000676229.1	1681	1699	+	18	0	-12	2257
O95831-1#123	0	6	6	O95831-1	490	496	+	6	O95831-1	0	613	ENST00000675857.1	82	1915	++	242	O95831-1#123	0	18	ENST00000675857.1	1546	1564	+	18	0	-12	2258
O95831-1#123	0	6	6	O95831-1	490	496	+	6	O95831-1	0	613	ENST00000675427.1	89	1925	++	240	O95831-1#123	0	18	ENST00000675427.1	1556	1574	+	18	0	-12	2259
O95831-1#123	0	6	6	O95831-1	490	496	+	6	O95831-1	0	524	ENST00000675240.1	169	1741	++	239	O95831-1#123	0	18	ENST00000675240.1	1639	1657	+	18	0	-12	2260
O95831-1#123	0	6	6	O95831-1	490	496	+	6	O95831-1	0	613	ENST00000675092.1	90	1956	++	238	O95831-1#123	0	18	ENST00000675092.1	1560	1578	+	18	0	-12	2261
O95831-1#123	0	6	6	O95831-1	490	496	+	6	O95831-1	0	613	ENST00000675050.1	71	1898	++	237	O95831-1#123	0	18	ENST00000675050.1	1529	1547	+	18	0	-12	2262
O95831-1#123	0	6	6	O95831-1	490	496	+	6	O95831-1	338	613	ENST00000674601.1	2	686	++	232	O95831-1#123	0	18	ENST00000674601.1	317	335	+	18	0	-12	2263
O95831-1#123	0	6	6	O95831-1	490	496	+	6	O95831-1	0	587	ENST00000674546.1	185	1954	++	230	O95831-1#123	0	18	ENST00000674546.1	1655	1673	+	18	0	-12	2264
O95831-1#123	0	6	6	O95831-1	490	496	+	6	O95831-1	339	613	ENST00000460436.6	905	1727	++	106	O95831-1#123	0	18	ENST00000460436.6	1358	1376	+	18	0	-12	2265
O95831-1#123	0	6	6	O95831-1	490	496	+	6	O95831-1	0	613	ENST00000346424.6	24	1002	++	35	O95831-1#123	0	18	ENST00000346424.6	633	651	+	18	0	-12	2266
O95831-1#123	0	6	6	O95831-1	490	496	+	6	O95831-1	0	613	ENST00000319908.8	174	2007	++	26	O95831-1#123	0	18	ENST00000319908.8	1638	1656	+	18	0	-12	2267
O95831-1#123	0	6	6	O95831-1	490	496	+	6	O95831-1	0	613	ENST00000287295.8	185	2024	++	18	O95831-1#123	0	18	ENST00000287295.8	1655	1673	+	18	0	-12	2268
O95831-1#124	0	6	6	O95831-1	503	509	+	6	O95831-1	0	613	ENST00000676436.1	34	1861	++	246	O95831-1#124	0	18	ENST00000676436.1	1531	1549	+	18	0	-12	2269
O95831-1#124	0	6	6	O95831-1	503	509	+	6	O95831-1	0	613	ENST00000676328.1	56	1892	++	245	O95831-1#124	0	18	ENST00000676328.1	1562	1580	+	18	0	-12	2270
O95831-1#124	0	6	6	O95831-1	503	509	+	6	O95831-1	0	613	ENST00000676229.1	223	2050	++	244	O95831-1#124	0	18	ENST00000676229.1	1720	1738	+	18	0	-12	2271
O95831-1#124	0	6	6	O95831-1	503	509	+	6	O95831-1	0	613	ENST00000675857.1	82	1915	++	242	O95831-1#124	0	18	ENST00000675857.1	1585	1603	+	18	0	-12	2272
O95831-1#124	0	6	6	O95831-1	503	509	+	6	O95831-1	0	613	ENST00000675427.1	89	1925	++	240	O95831-1#124	0	18	ENST00000675427.1	1595	1613	+	18	0	-12	2273
O95831-1#124	0	6	6	O95831-1	503	509	+	6	O95831-1	0	524	ENST00000675240.1	169	1741	++	239	O95831-1#124	0	18	ENST00000675240.1	1678	1696	+	18	0	-12	2274
O95831-1#124	0	6	6	O95831-1	503	509	+	6	O95831-1	0	613	ENST00000675092.1	90	1956	++	238	O95831-1#124	0	18	ENST00000675092.1	1599	1617	+	18	0	-12	2275
O95831-1#124	0	6	6	O95831-1	503	509	+	6	O95831-1	0	613	ENST00000675050.1	71	1898	++	237	O95831-1#124	0	18	ENST00000675050.1	1568	1586	+	18	0	-12	2276
O95831-1#124	0	6	6	O95831-1	503	509	+	6	O95831-1	338	613	ENST00000674601.1	2	686	++	232	O95831-1#124	0	18	ENST00000674601.1	356	374	+	18	0	-12	2277
O95831-1#124	0	6	6	O95831-1	503	509	+	6	O95831-1	0	587	ENST00000674546.1	185	1954	++	230	O95831-1#124	0	18	ENST00000674546.1	1694	1712	+	18	0	-12	2278
O95831-1#124	0	6	6	O95831-1	503	509	+	6	O95831-1	339	613	ENST00000460436.6	905	1727	++	106	O95831-1#124	0	18	ENST00000460436.6	1397	1415	+	18	0	-12	2279
O95831-1#124	0	6	6	O95831-1	503	509	+	6	O95831-1	0	613	ENST00000346424.6	24	1002	++	35	O95831-1#124	0	18	ENST00000346424.6	672	690	+	18	0	-12	2280
O95831-1#124	0	6	6	O95831-1	503	509	+	6	O95831-1	0	613	ENST00000319908.8	174	2007	++	26	O95831-1#124	0	18	ENST00000319908.8	1677	1695	+	18	0	-12	2281
O95831-1#124	0	6	6	O95831-1	503	509	+	6	O95831-1	0	613	ENST00000287295.8	185	2024	++	18	O95831-1#124	0	18	ENST00000287295.8	1694	1712	+	18	0	-12	2282
O95831-1#125	0	3	3	O95831-1	512	515	+	3	O95831-1	0	613	ENST00000676436.1	34	1861	++	246	O95831-1#125	0	9	ENST00000676436.1	1558	1567	+	9	0	-6	2283
O95831-1#125	0	3	3	O95831-1	512	515	+	3	O95831-1	0	613	ENST00000676328.1	56	1892	++	245	O95831-1#125	0	9	ENST00000676328.1	1589	1598	+	9	0	-6	2284
O95831-1#125	0	3	3	O95831-1	512	515	+	3	O95831-1	0	613	ENST00000676229.1	223	2050	++	244	O95831-1#125	0	9	ENST00000676229.1	1747	1756	+	9	0	-6	2285
O95831-1#125	0	3	3	O95831-1	512	515	+	3	O95831-1	0	613	ENST00000675857.1	82	1915	++	242	O95831-1#125	0	9	ENST00000675857.1	1612	1621	+	9	0	-6	2286
O95831-1#125	0	3	3	O95831-1	512	515	+	3	O95831-1	0	613	ENST00000675427.1	89	1925	++	240	O95831-1#125	0	9	ENST00000675427.1	1622	1631	+	9	0	-6	2287
O95831-1#125	0	3	3	O95831-1	512	515	+	3	O95831-1	0	524	ENST00000675240.1	169	1741	++	239	O95831-1#125	0	9	ENST00000675240.1	1705	1714	+	9	0	-6	2288
O95831-1#125	0	3	3	O95831-1	512	515	+	3	O95831-1	0	613	ENST00000675092.1	90	1956	++	238	O95831-1#125	0	9	ENST00000675092.1	1626	1635	+	9	0	-6	2289
O95831-1#125	0	3	3	O95831-1	512	515	+	3	O95831-1	0	613	ENST00000675050.1	71	1898	++	237	O95831-1#125	0	9	ENST00000675050.1	1595	1604	+	9	0	-6	2290
O95831-1#125	0	3	3	O95831-1	512	515	+	3	O95831-1	338	613	ENST00000674601.1	2	686	++	232	O95831-1#125	0	9	ENST00000674601.1	383	392	+	9	0	-6	2291
O95831-1#125	0	3	3	O95831-1	512	515	+	3	O95831-1	0	587	ENST00000674546.1	185	1954	++	230	O95831-1#125	0	9	ENST00000674546.1	1721	1730	+	9	0	-6	2292
O95831-1#125	0	3	3	O95831-1	512	515	+	3	O95831-1	339	613	ENST00000460436.6	905	1727	++	106	O95831-1#125	0	9	ENST00000460436.6	1424	1433	+	9	0	-6	2293
O95831-1#125	0	3	3	O95831-1	512	515	+	3	O95831-1	0	613	ENST00000346424.6	24	1002	++	35	O95831-1#125	0	9	ENST00000346424.6	699	708	+	9	0	-6	2294
O95831-1#125	0	3	3	O95831-1	512	515	+	3	O95831-1	0	613	ENST00000319908.8	174	2007	++	26	O95831-1#125	0	9	ENST00000319908.8	1704	1713	+	9	0	-6	2295
O95831-1#125	0	3	3	O95831-1	512	515	+	3	O95831-1	0	613	ENST00000287295.8	185	2024	++	18	O95831-1#125	0	9	ENST00000287295.8	1721	1730	+	9	0	-6	2296
O95831-1#126	0	8	8	O95831-1	516	524	+	8	O95831-1	0	613	ENST00000676436.1	34	1861	++	246	O95831-1#126	0	24	ENST00000676436.1	1570	1594	+	24	0	-16	2297
O95831-1#126	0	8	8	O95831-1	516	524	+	8	O95831-1	0	613	ENST00000676328.1	56	1892	++	245	O95831-1#126	0	24	ENST00000676328.1	1601	1625	+	24	0	-16	2298
O95831-1#126	0	8	8	O95831-1	516	524	+	8	O95831-1	0	613	ENST00000676229.1	223	2050	++	244	O95831-1#126	0	24	ENST00000676229.1	1759	1783	+	24	0	-16	2299
O95831-1#126	0	8	8	O95831-1	516	524	+	8	O95831-1	0	613	ENST00000675857.1	82	1915	++	242	O95831-1#126	0	24	ENST00000675857.1	1624	1648	+	24	0	-16	2300
O95831-1#126	0	8	8	O95831-1	516	524	+	8	O95831-1	0	613	ENST00000675427.1	89	1925	++	240	O95831-1#126	0	24	ENST00000675427.1	1634	1658	+	24	0	-16	2301
O95831-1#126	0	8	8	O95831-1	516	524	+	8	O95831-1	0	524	ENST00000675240.1	169	1741	++	239	O95831-1#126	0	24	ENST00000675240.1	1717	1741	+	24	0	-16	2302
O95831-1#126	0	8	8	O95831-1	516	524	+	8	O95831-1	0	613	ENST00000675092.1	90	1956	++	238	O95831-1#126	0	24	ENST00000675092.1	1638	1662	+	24	0	-16	2303
O95831-1#126	0	8	8	O95831-1	516	524	+	8	O95831-1	0	613	ENST00000675050.1	71	1898	++	237	O95831-1#126	0	24	ENST00000675050.1	1607	1631	+	24	0	-16	2304
O95831-1#126	0	8	8	O95831-1	516	524	+	8	O95831-1	338	613	ENST00000674601.1	2	686	++	232	O95831-1#126	0	24	ENST00000674601.1	395	419	+	24	0	-16	2305
O95831-1#126	0	8	8	O95831-1	516	524	+	8	O95831-1	0	587	ENST00000674546.1	185	1954	++	230	O95831-1#126	0	24	ENST00000674546.1	1733	1757	+	24	0	-16	2306
O95831-1#126	0	8	8	O95831-1	516	524	+	8	O95831-1	339	613	ENST00000460436.6	905	1727	++	106	O95831-1#126	0	24	ENST00000460436.6	1436	1460	+	24	0	-16	2307
O95831-1#126	0	8	8	O95831-1	516	524	+	8	O95831-1	0	613	ENST00000346424.6	24	1002	++	35	O95831-1#126	0	24	ENST00000346424.6	711	735	+	24	0	-16	2308
O95831-1#126	0	8	8	O95831-1	516	524	+	8	O95831-1	0	613	ENST00000319908.8	174	2007	++	26	O95831-1#126	0	24	ENST00000319908.8	1716	1740	+	24	0	-16	2309
O95831-1#126	0	8	8	O95831-1	516	524	+	8	O95831-1	0	613	ENST00000287295.8	185	2024	++	18	O95831-1#126	0	24	ENST00000287295.8	1733	1757	+	24	0	-16	2310
O95831-1#127	0	5	5	O95831-1	528	533	+	5	O95831-1	0	613	ENST00000676436.1	34	1861	++	246	O95831-1#127	0	15	ENST00000676436.1	1606	1621	+	15	0	-10	2311
O95831-1#127	0	5	5	O95831-1	528	533	+	5	O95831-1	0	613	ENST00000676328.1	56	1892	++	245	O95831-1#127	0	15	ENST00000676328.1	1637	1652	+	15	0	-10	2312
O95831-1#127	0	5	5	O95831-1	528	533	+	5	O95831-1	0	613	ENST00000676229.1	223	2050	++	244	O95831-1#127	0	15	ENST00000676229.1	1795	1810	+	15	0	-10	2313
O95831-1#127	0	5	5	O95831-1	528	533	+	5	O95831-1	0	613	ENST00000675857.1	82	1915	++	242	O95831-1#127	0	15	ENST00000675857.1	1660	1675	+	15	0	-10	2314
O95831-1#127	0	5	5	O95831-1	528	533	+	5	O95831-1	0	613	ENST00000675427.1	89	1925	++	240	O95831-1#127	0	15	ENST00000675427.1	1670	1685	+	15	0	-10	2315
O95831-1#127	0	5	5	O95831-1	528	533	+	5	O95831-1	0	613	ENST00000675092.1	90	1956	++	238	O95831-1#127	0	15	ENST00000675092.1	1701	1716	+	15	0	-10	2316
O95831-1#127	0	5	5	O95831-1	528	533	+	5	O95831-1	0	613	ENST00000675050.1	71	1898	++	237	O95831-1#127	0	15	ENST00000675050.1	1643	1658	+	15	0	-10	2317
O95831-1#127	0	5	5	O95831-1	528	533	+	5	O95831-1	338	613	ENST00000674601.1	2	686	++	232	O95831-1#127	0	15	ENST00000674601.1	431	446	+	15	0	-10	2318
O95831-1#127	0	5	5	O95831-1	528	533	+	5	O95831-1	0	587	ENST00000674546.1	185	1954	++	230	O95831-1#127	0	15	ENST00000674546.1	1777	1792	+	15	0	-10	2319
O95831-1#127	0	5	5	O95831-1	528	533	+	5	O95831-1	339	613	ENST00000460436.6	905	1727	++	106	O95831-1#127	0	15	ENST00000460436.6	1472	1487	+	15	0	-10	2320
O95831-1#127	0	5	5	O95831-1	528	533	+	5	O95831-1	0	613	ENST00000346424.6	24	1002	++	35	O95831-1#127	0	15	ENST00000346424.6	747	762	+	15	0	-10	2321
O95831-1#127	0	5	5	O95831-1	528	533	+	5	O95831-1	0	613	ENST00000319908.8	174	2007	++	26	O95831-1#127	0	15	ENST00000319908.8	1752	1767	+	15	0	-10	2322
O95831-1#127	0	5	5	O95831-1	528	533	+	5	O95831-1	0	613	ENST00000287295.8	185	2024	++	18	O95831-1#127	0	15	ENST00000287295.8	1769	1784	+	15	0	-10	2323
O95831-1#128	0	5	5	O95831-1	537	542	+	5	O95831-1	0	613	ENST00000676436.1	34	1861	++	246	O95831-1#128	0	15	ENST00000676436.1	1633	1648	+	15	0	-10	2324
O95831-1#128	0	5	5	O95831-1	537	542	+	5	O95831-1	0	613	ENST00000676328.1	56	1892	++	245	O95831-1#128	0	15	ENST00000676328.1	1664	1679	+	15	0	-10	2325
O95831-1#128	0	5	5	O95831-1	537	542	+	5	O95831-1	0	613	ENST00000676229.1	223	2050	++	244	O95831-1#128	0	15	ENST00000676229.1	1822	1837	+	15	0	-10	2326
O95831-1#128	0	5	5	O95831-1	537	542	+	5	O95831-1	0	613	ENST00000675857.1	82	1915	++	242	O95831-1#128	0	15	ENST00000675857.1	1687	1702	+	15	0	-10	2327
O95831-1#128	0	5	5	O95831-1	537	542	+	5	O95831-1	0	613	ENST00000675427.1	89	1925	++	240	O95831-1#128	0	15	ENST00000675427.1	1697	1712	+	15	0	-10	2328
O95831-1#128	0	5	5	O95831-1	537	542	+	5	O95831-1	0	613	ENST00000675092.1	90	1956	++	238	O95831-1#128	0	15	ENST00000675092.1	1728	1743	+	15	0	-10	2329
O95831-1#128	0	5	5	O95831-1	537	542	+	5	O95831-1	0	613	ENST00000675050.1	71	1898	++	237	O95831-1#128	0	15	ENST00000675050.1	1670	1685	+	15	0	-10	2330
O95831-1#128	0	5	5	O95831-1	537	542	+	5	O95831-1	338	613	ENST00000674601.1	2	686	++	232	O95831-1#128	0	15	ENST00000674601.1	458	473	+	15	0	-10	2331
O95831-1#128	0	5	5	O95831-1	537	542	+	5	O95831-1	0	587	ENST00000674546.1	185	1954	++	230	O95831-1#128	0	15	ENST00000674546.1	1804	1819	+	15	0	-10	2332
O95831-1#128	0	5	5	O95831-1	537	542	+	5	O95831-1	339	613	ENST00000460436.6	905	1727	++	106	O95831-1#128	0	15	ENST00000460436.6	1499	1514	+	15	0	-10	2333
O95831-1#128	0	5	5	O95831-1	537	542	+	5	O95831-1	0	613	ENST00000346424.6	24	1002	++	35	O95831-1#128	0	15	ENST00000346424.6	774	789	+	15	0	-10	2334
O95831-1#128	0	5	5	O95831-1	537	542	+	5	O95831-1	0	613	ENST00000319908.8	174	2007	++	26	O95831-1#128	0	15	ENST00000319908.8	1779	1794	+	15	0	-10	2335
O95831-1#128	0	5	5	O95831-1	537	542	+	5	O95831-1	0	613	ENST00000287295.8	185	2024	++	18	O95831-1#128	0	15	ENST00000287295.8	1796	1811	+	15	0	-10	2336
O95831-1#129	0	8	8	O95831-1	561	569	+	8	O95831-1	0	613	ENST00000676436.1	34	1861	++	246	O95831-1#129	0	24	ENST00000676436.1	1705	1729	+	24	0	-16	2337
O95831-1#129	0	8	8	O95831-1	561	569	+	8	O95831-1	0	613	ENST00000676328.1	56	1892	++	245	O95831-1#129	0	24	ENST00000676328.1	1736	1760	+	24	0	-16	2338
O95831-1#129	0	8	8	O95831-1	561	569	+	8	O95831-1	0	613	ENST00000676229.1	223	2050	++	244	O95831-1#129	0	24	ENST00000676229.1	1894	1918	+	24	0	-16	2339
O95831-1#129	0	8	8	O95831-1	561	569	+	8	O95831-1	0	613	ENST00000675857.1	82	1915	++	242	O95831-1#129	0	24	ENST00000675857.1	1759	1783	+	24	0	-16	2340
O95831-1#129	0	8	8	O95831-1	561	569	+	8	O95831-1	0	613	ENST00000675427.1	89	1925	++	240	O95831-1#129	0	24	ENST00000675427.1	1769	1793	+	24	0	-16	2341
O95831-1#129	0	8	8	O95831-1	561	569	+	8	O95831-1	0	613	ENST00000675092.1	90	1956	++	238	O95831-1#129	0	24	ENST00000675092.1	1800	1824	+	24	0	-16	2342
O95831-1#129	0	8	8	O95831-1	561	569	+	8	O95831-1	0	613	ENST00000675050.1	71	1898	++	237	O95831-1#129	0	24	ENST00000675050.1	1742	1766	+	24	0	-16	2343
O95831-1#129	0	8	8	O95831-1	561	569	+	8	O95831-1	338	613	ENST00000674601.1	2	686	++	232	O95831-1#129	0	24	ENST00000674601.1	530	554	+	24	0	-16	2344
O95831-1#129	0	8	8	O95831-1	561	569	+	8	O95831-1	0	587	ENST00000674546.1	185	1954	++	230	O95831-1#129	0	24	ENST00000674546.1	1876	1900	+	24	0	-16	2345
O95831-1#129	0	8	8	O95831-1	561	569	+	8	O95831-1	339	613	ENST00000460436.6	905	1727	++	106	O95831-1#129	0	24	ENST00000460436.6	1571	1595	+	24	0	-16	2346
O95831-1#129	0	8	8	O95831-1	561	569	+	8	O95831-1	0	613	ENST00000346424.6	24	1002	++	35	O95831-1#129	0	24	ENST00000346424.6	846	870	+	24	0	-16	2347
O95831-1#129	0	8	8	O95831-1	561	569	+	8	O95831-1	0	613	ENST00000319908.8	174	2007	++	26	O95831-1#129	0	24	ENST00000319908.8	1851	1875	+	24	0	-16	2348
O95831-1#129	0	8	8	O95831-1	561	569	+	8	O95831-1	0	613	ENST00000287295.8	185	2024	++	18	O95831-1#129	0	24	ENST00000287295.8	1868	1892	+	24	0	-16	2349
O95831-1#130	0	9	9	O95831-1	571	580	+	9	O95831-1	0	613	ENST00000676436.1	34	1861	++	246	O95831-1#130	0	27	ENST00000676436.1	1735	1762	+	27	0	-18	2350
O95831-1#130	0	9	9	O95831-1	571	580	+	9	O95831-1	0	613	ENST00000676328.1	56	1892	++	245	O95831-1#130	0	27	ENST00000676328.1	1766	1793	+	27	0	-18	2351
O95831-1#130	0	9	9	O95831-1	571	580	+	9	O95831-1	0	613	ENST00000676229.1	223	2050	++	244	O95831-1#130	0	27	ENST00000676229.1	1924	1951	+	27	0	-18	2352
O95831-1#130	0	9	9	O95831-1	571	580	+	9	O95831-1	0	613	ENST00000675857.1	82	1915	++	242	O95831-1#130	0	27	ENST00000675857.1	1789	1816	+	27	0	-18	2353
O95831-1#130	0	9	9	O95831-1	571	580	+	9	O95831-1	0	613	ENST00000675427.1	89	1925	++	240	O95831-1#130	0	27	ENST00000675427.1	1799	1826	+	27	0	-18	2354
O95831-1#130	0	9	9	O95831-1	571	580	+	9	O95831-1	0	613	ENST00000675092.1	90	1956	++	238	O95831-1#130	0	27	ENST00000675092.1	1830	1857	+	27	0	-18	2355
O95831-1#130	0	9	9	O95831-1	571	580	+	9	O95831-1	0	613	ENST00000675050.1	71	1898	++	237	O95831-1#130	0	27	ENST00000675050.1	1772	1799	+	27	0	-18	2356
O95831-1#130	0	9	9	O95831-1	571	580	+	9	O95831-1	338	613	ENST00000674601.1	2	686	++	232	O95831-1#130	0	27	ENST00000674601.1	560	587	+	27	0	-18	2357
O95831-1#130	0	9	9	O95831-1	571	580	+	9	O95831-1	0	587	ENST00000674546.1	185	1954	++	230	O95831-1#130	0	27	ENST00000674546.1	1906	1933	+	27	0	-18	2358
O95831-1#130	0	9	9	O95831-1	571	580	+	9	O95831-1	339	613	ENST00000460436.6	905	1727	++	106	O95831-1#130	0	27	ENST00000460436.6	1601	1628	+	27	0	-18	2359
O95831-1#130	0	9	9	O95831-1	571	580	+	9	O95831-1	0	613	ENST00000346424.6	24	1002	++	35	O95831-1#130	0	27	ENST00000346424.6	876	903	+	27	0	-18	2360
O95831-1#130	0	9	9	O95831-1	571	580	+	9	O95831-1	0	613	ENST00000319908.8	174	2007	++	26	O95831-1#130	0	27	ENST00000319908.8	1881	1908	+	27	0	-18	2361
O95831-1#130	0	9	9	O95831-1	571	580	+	9	O95831-1	0	613	ENST00000287295.8	185	2024	++	18	O95831-1#130	0	27	ENST00000287295.8	1898	1925	+	27	0	-18	2362
O95831-1#131	0	10	10	O95831-1	584	594	+	10	O95831-1	0	613	ENST00000676436.1	34	1861	++	246	O95831-1#131	0	30	ENST00000676436.1	1774	1804	+	30	0	-20	2363
O95831-1#131	0	10	10	O95831-1	584	594	+	10	O95831-1	0	613	ENST00000676328.1	56	1892	++	245	O95831-1#131	0	30	ENST00000676328.1	1805	1835	+	30	0	-20	2364
O95831-1#131	0	10	10	O95831-1	584	594	+	10	O95831-1	0	613	ENST00000676229.1	223	2050	++	244	O95831-1#131	0	30	ENST00000676229.1	1963	1993	+	30	0	-20	2365
O95831-1#131	0	10	10	O95831-1	584	594	+	10	O95831-1	0	613	ENST00000675857.1	82	1915	++	242	O95831-1#131	0	30	ENST00000675857.1	1828	1858	+	30	0	-20	2366
O95831-1#131	0	10	10	O95831-1	584	594	+	10	O95831-1	0	613	ENST00000675427.1	89	1925	++	240	O95831-1#131	0	30	ENST00000675427.1	1838	1868	+	30	0	-20	2367
O95831-1#131	0	10	10	O95831-1	584	594	+	10	O95831-1	0	613	ENST00000675092.1	90	1956	++	238	O95831-1#131	0	30	ENST00000675092.1	1869	1899	+	30	0	-20	2368
O95831-1#131	0	10	10	O95831-1	584	594	+	10	O95831-1	0	613	ENST00000675050.1	71	1898	++	237	O95831-1#131	0	30	ENST00000675050.1	1811	1841	+	30	0	-20	2369
O95831-1#131	0	10	10	O95831-1	584	594	+	10	O95831-1	338	613	ENST00000674601.1	2	686	++	232	O95831-1#131	0	30	ENST00000674601.1	599	629	+	30	0	-20	2370
O95831-1#131	0	10	10	O95831-1	584	594	+	10	O95831-1	0	587	ENST00000674546.1	185	1954	++	230	O95831-1#131	0	9	ENST00000674546.1	1945	1954	+	9	0	1	2371
O95831-1#131	0	10	10	O95831-1	584	594	+	10	O95831-1	339	613	ENST00000460436.6	905	1727	++	106	O95831-1#131	0	30	ENST00000460436.6	1640	1670	+	30	0	-20	2372
O95831-1#131	0	10	10	O95831-1	584	594	+	10	O95831-1	0	613	ENST00000346424.6	24	1002	++	35	O95831-1#131	0	30	ENST00000346424.6	915	945	+	30	0	-20	2373
O95831-1#131	0	10	10	O95831-1	584	594	+	10	O95831-1	0	613	ENST00000319908.8	174	2007	++	26	O95831-1#131	0	30	ENST00000319908.8	1920	1950	+	30	0	-20	2374
O95831-1#131	0	10	10	O95831-1	584	594	+	10	O95831-1	0	613	ENST00000287295.8	185	2024	++	18	O95831-1#131	0	30	ENST00000287295.8	1937	1967	+	30	0	-20	2375
O95831-1#132	0	5	5	O95831-1	600	605	+	5	O95831-1	0	613	ENST00000676436.1	34	1861	++	246	O95831-1#132	0	15	ENST00000676436.1	1822	1837	+	15	0	-10	2376
O95831-1#132	0	5	5	O95831-1	600	605	+	5	O95831-1	0	613	ENST00000676328.1	56	1892	++	245	O95831-1#132	0	15	ENST00000676328.1	1853	1868	+	15	0	-10	2377
O95831-1#132	0	5	5	O95831-1	600	605	+	5	O95831-1	0	613	ENST00000676229.1	223	2050	++	244	O95831-1#132	0	15	ENST00000676229.1	2011	2026	+	15	0	-10	2378
O95831-1#132	0	5	5	O95831-1	600	605	+	5	O95831-1	0	613	ENST00000675857.1	82	1915	++	242	O95831-1#132	0	15	ENST00000675857.1	1876	1891	+	15	0	-10	2379
O95831-1#132	0	5	5	O95831-1	600	605	+	5	O95831-1	0	613	ENST00000675427.1	89	1925	++	240	O95831-1#132	0	15	ENST00000675427.1	1886	1901	+	15	0	-10	2380
O95831-1#132	0	5	5	O95831-1	600	605	+	5	O95831-1	0	613	ENST00000675092.1	90	1956	++	238	O95831-1#132	0	15	ENST00000675092.1	1917	1932	+	15	0	-10	2381
O95831-1#132	0	5	5	O95831-1	600	605	+	5	O95831-1	0	613	ENST00000675050.1	71	1898	++	237	O95831-1#132	0	15	ENST00000675050.1	1859	1874	+	15	0	-10	2382
O95831-1#132	0	5	5	O95831-1	600	605	+	5	O95831-1	338	613	ENST00000674601.1	2	686	++	232	O95831-1#132	0	15	ENST00000674601.1	647	662	+	15	0	-10	2383
O95831-1#132	0	5	5	O95831-1	600	605	+	5	O95831-1	339	613	ENST00000460436.6	905	1727	++	106	O95831-1#132	0	15	ENST00000460436.6	1688	1703	+	15	0	-10	2384
O95831-1#132	0	5	5	O95831-1	600	605	+	5	O95831-1	0	613	ENST00000346424.6	24	1002	++	35	O95831-1#132	0	15	ENST00000346424.6	963	978	+	15	0	-10	2385
O95831-1#132	0	5	5	O95831-1	600	605	+	5	O95831-1	0	613	ENST00000319908.8	174	2007	++	26	O95831-1#132	0	15	ENST00000319908.8	1968	1983	+	15	0	-10	2386
O95831-1#132	0	5	5	O95831-1	600	605	+	5	O95831-1	0	613	ENST00000287295.8	185	2024	++	18	O95831-1#132	0	15	ENST00000287295.8	1985	2000	+	15	0	-10	2387
O95831-1#133	0	3	3	O95831-1	605	608	+	3	O95831-1	0	613	ENST00000676436.1	34	1861	++	246	O95831-1#133	0	9	ENST00000676436.1	1837	1846	+	9	0	-6	2388
O95831-1#133	0	3	3	O95831-1	605	608	+	3	O95831-1	0	613	ENST00000676328.1	56	1892	++	245	O95831-1#133	0	9	ENST00000676328.1	1868	1877	+	9	0	-6	2389
O95831-1#133	0	3	3	O95831-1	605	608	+	3	O95831-1	0	613	ENST00000676229.1	223	2050	++	244	O95831-1#133	0	9	ENST00000676229.1	2026	2035	+	9	0	-6	2390
O95831-1#133	0	3	3	O95831-1	605	608	+	3	O95831-1	0	613	ENST00000675857.1	82	1915	++	242	O95831-1#133	0	9	ENST00000675857.1	1891	1900	+	9	0	-6	2391
O95831-1#133	0	3	3	O95831-1	605	608	+	3	O95831-1	0	613	ENST00000675427.1	89	1925	++	240	O95831-1#133	0	9	ENST00000675427.1	1901	1910	+	9	0	-6	2392
O95831-1#133	0	3	3	O95831-1	605	608	+	3	O95831-1	0	613	ENST00000675092.1	90	1956	++	238	O95831-1#133	0	9	ENST00000675092.1	1932	1941	+	9	0	-6	2393
O95831-1#133	0	3	3	O95831-1	605	608	+	3	O95831-1	0	613	ENST00000675050.1	71	1898	++	237	O95831-1#133	0	9	ENST00000675050.1	1874	1883	+	9	0	-6	2394
O95831-1#133	0	3	3	O95831-1	605	608	+	3	O95831-1	338	613	ENST00000674601.1	2	686	++	232	O95831-1#133	0	9	ENST00000674601.1	662	671	+	9	0	-6	2395
O95831-1#133	0	3	3	O95831-1	605	608	+	3	O95831-1	339	613	ENST00000460436.6	905	1727	++	106	O95831-1#133	0	9	ENST00000460436.6	1703	1712	+	9	0	-6	2396
O95831-1#133	0	3	3	O95831-1	605	608	+	3	O95831-1	0	613	ENST00000346424.6	24	1002	++	35	O95831-1#133	0	9	ENST00000346424.6	978	987	+	9	0	-6	2397
O95831-1#133	0	3	3	O95831-1	605	608	+	3	O95831-1	0	613	ENST00000319908.8	174	2007	++	26	O95831-1#133	0	9	ENST00000319908.8	1983	1992	+	9	0	-6	2398
O95831-1#133	0	3	3	O95831-1	605	608	+	3	O95831-1	0	613	ENST00000287295.8	185	2024	++	18	O95831-1#133	0	9	ENST00000287295.8	2000	2009	+	9	0	-6	2399
P14060#0	0	1	1	P14060	0	1	+	1	P14060	0	81	ENST00000531340.5	107	350	++	148	P14060#0	0	3	ENST00000531340.5	107	110	+	3	0	-2	2400
P14060#0	0	1	1	P14060	0	1	+	1	P14060	0	373	ENST00000528909.1	159	1278	++	143	P14060#0	0	3	ENST00000528909.1	159	162	+	3	0	-2	2401
P14060#0	0	1	1	P14060	0	1	+	1	P14060	0	373	ENST00000369413.8	138	1257	++	43	P14060#0	0	3	ENST00000369413.8	138	141	+	3	0	-2	2402
P14060#1	0	372	372	P14060	1	373	+	372	P14060	0	81	ENST00000531340.5	107	350	++	148	P14060#1	0	240	ENST00000531340.5	110	350	+	240	0	132	2403
P14060#1	0	372	372	P14060	1	373	+	372	P14060	0	373	ENST00000528909.1	159	1278	++	143	P14060#1	0	1116	ENST00000528909.1	162	1278	+	1116	0	-744	2404
P14060#1	0	372	372	P14060	1	373	+	372	P14060	0	373	ENST00000369413.8	138	1257	++	43	P14060#1	0	1116	ENST00000369413.8	141	1257	+	1116	0	-744	2405
P14060#2	0	21	21	P14060	287	308	+	21	P14060	0	373	ENST00000528909.1	159	1278	++	143	P14060#2	0	63	ENST00000528909.1	1020	1083	+	63	0	-42	2406
P14060#2	0	21	21	P14060	287	308	+	21	P14060	0	373	ENST00000369413.8	138	1257	++	43	P14060#2	0	63	ENST00000369413.8	999	1062	+	63	0	-42	2407
P14060#3	0	1	1	P14060	158	159	+	1	P14060	0	373	ENST00000528909.1	159	1278	++	143	P14060#3	0	3	ENST00000528909.1	633	636	+	3	0	-2	2408
P14060#3	0	1	1	P14060	158	159	+	1	P14060	0	373	ENST00000369413.8	138	1257	++	43	P14060#3	0	3	ENST00000369413.8	612	615	+	3	0	-2	2409
P14060#4	0	6	6	P14060	9	15	+	6	P14060	0	81	ENST00000531340.5	107	350	++	148	P14060#4	0	18	ENST00000531340.5	134	152	+	18	0	-12	2410
P14060#4	0	6	6	P14060	9	15	+	6	P14060	0	373	ENST00000528909.1	159	1278	++	143	P14060#4	0	18	ENST00000528909.1	186	204	+	18	0	-12	2411
P14060#4	0	6	6	P14060	9	15	+	6	P14060	0	373	ENST00000369413.8	138	1257	++	43	P14060#4	0	18	ENST00000369413.8	165	183	+	18	0	-12	2412
P14060#5	0	1	1	P14060	154	155	+	1	P14060	0	373	ENST00000528909.1	159	1278	++	143	P14060#5	0	3	ENST00000528909.1	621	624	+	3	0	-2	2413
P14060#5	0	1	1	P14060	154	155	+	1	P14060	0	373	ENST00000369413.8	138	1257	++	43	P14060#5	0	3	ENST00000369413.8	600	603	+	3	0	-2	2414
P14060#6	0	1	1	P14060	158	159	+	1	P14060	0	373	ENST00000528909.1	159	1278	++	143	P14060#6	0	3	ENST00000528909.1	633	636	+	3	0	-2	2415
P14060#6	0	1	1	P14060	158	159	+	1	P14060	0	373	ENST00000369413.8	138	1257	++	43	P14060#6	0	3	ENST00000369413.8	612	615	+	3	0	-2	2416
P14060#7	0	1	1	P14060	53	54	+	1	P14060	0	81	ENST00000531340.5	107	350	++	148	P14060#7	0	3	ENST00000531340.5	266	269	+	3	0	-2	2417
P14060#7	0	1	1	P14060	53	54	+	1	P14060	0	373	ENST00000528909.1	159	1278	++	143	P14060#7	0	3	ENST00000528909.1	318	321	+	3	0	-2	2418
P14060#7	0	1	1	P14060	53	54	+	1	P14060	0	373	ENST00000369413.8	138	1257	++	43	P14060#7	0	3	ENST00000369413.8	297	300	+	3	0	-2	2419
P14060#8	0	1	1	P14060	70	71	+	1	P14060	0	81	ENST00000531340.5	107	350	++	148	P14060#8	0	3	ENST00000531340.5	317	320	+	3	0	-2	2420
P14060#8	0	1	1	P14060	70	71	+	1	P14060	0	373	ENST00000528909.1	159	1278	++	143	P14060#8	0	3	ENST00000528909.1	369	372	+	3	0	-2	2421
P14060#8	0	1	1	P14060	70	71	+	1	P14060	0	373	ENST00000369413.8	138	1257	++	43	P14060#8	0	3	ENST00000369413.8	348	351	+	3	0	-2	2422
P14060#9	0	1	1	P14060	78	79	+	1	P14060	0	81	ENST00000531340.5	107	350	++	148	P14060#9	0	3	ENST00000531340.5	341	344	+	3	0	-2	2423
P14060#9	0	1	1	P14060	78	79	+	1	P14060	0	373	ENST00000528909.1	159	1278	++	143	P14060#9	0	3	ENST00000528909.1	393	396	+	3	0	-2	2424
P14060#9	0	1	1	P14060	78	79	+	1	P14060	0	373	ENST00000369413.8	138	1257	++	43	P14060#9	0	3	ENST00000369413.8	372	375	+	3	0	-2	2425
P14060#10	0	1	1	P14060	89	90	+	1	P14060	0	373	ENST00000528909.1	159	1278	++	143	P14060#10	0	3	ENST00000528909.1	426	429	+	3	0	-2	2426
P14060#10	0	1	1	P14060	89	90	+	1	P14060	0	373	ENST00000369413.8	138	1257	++	43	P14060#10	0	3	ENST00000369413.8	405	408	+	3	0	-2	2427
P14060#11	0	1	1	P14060	285	286	+	1	P14060	0	373	ENST00000528909.1	159	1278	++	143	P14060#11	0	3	ENST00000528909.1	1014	1017	+	3	0	-2	2428
P14060#11	0	1	1	P14060	285	286	+	1	P14060	0	373	ENST00000369413.8	138	1257	++	43	P14060#11	0	3	ENST00000369413.8	993	996	+	3	0	-2	2429
P14060#12	0	1	1	P14060	366	367	+	1	P14060	0	373	ENST00000528909.1	159	1278	++	143	P14060#12	0	3	ENST00000528909.1	1257	1260	+	3	0	-2	2430
P14060#12	0	1	1	P14060	366	367	+	1	P14060	0	373	ENST00000369413.8	138	1257	++	43	P14060#12	0	3	ENST00000369413.8	1236	1239	+	3	0	-2	2431
P26439-1#0	0	372	372	P26439-1	0	372	+	372	P26439-1	0	372	ENST00000543831.5	249	1365	++	156	P26439-1#0	0	1116	ENST00000543831.5	249	1365	+	1116	0	-744	2432
P26439-1#0	0	372	372	P26439-1	0	372	+	372	P26439-1	0	195	ENST00000433745.5	130	715	++	82	P26439-1#0	0	585	ENST00000433745.5	130	715	+	585	0	-213	2433
P26439-1#0	0	372	372	P26439-1	0	372	+	372	P26439-1	0	372	ENST00000369416.4	142	1258	++	44	P26439-1#0	0	1116	ENST00000369416.4	142	1258	+	1116	0	-744	2434
P26439-1#1	0	21	21	P26439-1	286	307	+	21	P26439-1	0	372	ENST00000543831.5	249	1365	++	156	P26439-1#1	0	63	ENST00000543831.5	1107	1170	+	63	0	-42	2435
P26439-1#1	0	21	21	P26439-1	286	307	+	21	P26439-1	0	372	ENST00000369416.4	142	1258	++	44	P26439-1#1	0	63	ENST00000369416.4	1000	1063	+	63	0	-42	2436
P26439-1#2	0	1	1	P26439-1	153	154	+	1	P26439-1	0	372	ENST00000543831.5	249	1365	++	156	P26439-1#2	0	3	ENST00000543831.5	708	711	+	3	0	-2	2437
P26439-1#2	0	1	1	P26439-1	153	154	+	1	P26439-1	0	195	ENST00000433745.5	130	715	++	82	P26439-1#2	0	3	ENST00000433745.5	589	592	+	3	0	-2	2438
P26439-1#2	0	1	1	P26439-1	153	154	+	1	P26439-1	0	372	ENST00000369416.4	142	1258	++	44	P26439-1#2	0	3	ENST00000369416.4	601	604	+	3	0	-2	2439
P26439-1#3	0	1	1	P26439-1	157	158	+	1	P26439-1	0	372	ENST00000543831.5	249	1365	++	156	P26439-1#3	0	3	ENST00000543831.5	720	723	+	3	0	-2	2440
P26439-1#3	0	1	1	P26439-1	157	158	+	1	P26439-1	0	195	ENST00000433745.5	130	715	++	82	P26439-1#3	0	3	ENST00000433745.5	601	604	+	3	0	-2	2441
P26439-1#3	0	1	1	P26439-1	157	158	+	1	P26439-1	0	372	ENST00000369416.4	142	1258	++	44	P26439-1#3	0	3	ENST00000369416.4	613	616	+	3	0	-2	2442
P26439-1#4	0	120	120	P26439-1	102	222	+	120	P26439-1	0	372	ENST00000543831.5	249	1365	++	156	P26439-1#4	0	360	ENST00000543831.5	555	915	+	360	0	-240	2443
P26439-1#4	0	120	120	P26439-1	102	222	+	120	P26439-1	0	195	ENST00000433745.5	130	715	++	82	P26439-1#4	0	279	ENST00000433745.5	436	715	+	279	0	-159	2444
P26439-1#4	0	120	120	P26439-1	102	222	+	120	P26439-1	0	372	ENST00000369416.4	142	1258	++	44	P26439-1#4	0	360	ENST00000369416.4	448	808	+	360	0	-240	2445
P26439-1#5	0	150	150	P26439-1	222	372	+	150	P26439-1	0	372	ENST00000543831.5	249	1365	++	156	P26439-1#5	0	450	ENST00000543831.5	915	1365	+	450	0	-300	2446
P26439-1#5	0	150	150	P26439-1	222	372	+	150	P26439-1	0	372	ENST00000369416.4	142	1258	++	44	P26439-1#5	0	450	ENST00000369416.4	808	1258	+	450	0	-300	2447
P26439-1#6	0	1	1	P26439-1	9	10	+	1	P26439-1	0	372	ENST00000543831.5	249	1365	++	156	P26439-1#6	0	3	ENST00000543831.5	276	279	+	3	0	-2	2448
P26439-1#6	0	1	1	P26439-1	9	10	+	1	P26439-1	0	195	ENST00000433745.5	130	715	++	82	P26439-1#6	0	3	ENST00000433745.5	157	160	+	3	0	-2	2449
P26439-1#6	0	1	1	P26439-1	9	10	+	1	P26439-1	0	372	ENST00000369416.4	142	1258	++	44	P26439-1#6	0	3	ENST00000369416.4	169	172	+	3	0	-2	2450
P26439-1#7	0	1	1	P26439-1	9	10	+	1	P26439-1	0	372	ENST00000543831.5	249	1365	++	156	P26439-1#7	0	3	ENST00000543831.5	276	279	+	3	0	-2	2451
P26439-1#7	0	1	1	P26439-1	9	10	+	1	P26439-1	0	195	ENST00000433745.5	130	715	++	82	P26439-1#7	0	3	ENST00000433745.5	157	160	+	3	0	-2	2452
P26439-1#7	0	1	1	P26439-1	9	10	+	1	P26439-1	0	372	ENST00000369416.4	142	1258	++	44	P26439-1#7	0	3	ENST00000369416.4	169	172	+	3	0	-2	2453
P26439-1#8	0	1	1	P26439-1	14	15	+	1	P26439-1	0	372	ENST00000543831.5	249	1365	++	156	P26439-1#8	0	3	ENST00000543831.5	291	294	+	3	0	-2	2454
P26439-1#8	0	1	1	P26439-1	14	15	+	1	P26439-1	0	195	ENST00000433745.5	130	715	++	82	P26439-1#8	0	3	ENST00000433745.5	172	175	+	3	0	-2	2455
P26439-1#8	0	1	1	P26439-1	14	15	+	1	P26439-1	0	372	ENST00000369416.4	142	1258	++	44	P26439-1#8	0	3	ENST00000369416.4	184	187	+	3	0	-2	2456
P26439-1#9	0	1	1	P26439-1	73	74	+	1	P26439-1	0	372	ENST00000543831.5	249	1365	++	156	P26439-1#9	0	3	ENST00000543831.5	468	471	+	3	0	-2	2457
P26439-1#9	0	1	1	P26439-1	73	74	+	1	P26439-1	0	195	ENST00000433745.5	130	715	++	82	P26439-1#9	0	3	ENST00000433745.5	349	352	+	3	0	-2	2458
P26439-1#9	0	1	1	P26439-1	73	74	+	1	P26439-1	0	372	ENST00000369416.4	142	1258	++	44	P26439-1#9	0	3	ENST00000369416.4	361	364	+	3	0	-2	2459
P26439-1#10	0	1	1	P26439-1	81	82	+	1	P26439-1	0	372	ENST00000543831.5	249	1365	++	156	P26439-1#10	0	3	ENST00000543831.5	492	495	+	3	0	-2	2460
P26439-1#10	0	1	1	P26439-1	81	82	+	1	P26439-1	0	195	ENST00000433745.5	130	715	++	82	P26439-1#10	0	3	ENST00000433745.5	373	376	+	3	0	-2	2461
P26439-1#10	0	1	1	P26439-1	81	82	+	1	P26439-1	0	372	ENST00000369416.4	142	1258	++	44	P26439-1#10	0	3	ENST00000369416.4	385	388	+	3	0	-2	2462
P26439-1#11	0	1	1	P26439-1	81	82	+	1	P26439-1	0	372	ENST00000543831.5	249	1365	++	156	P26439-1#11	0	3	ENST00000543831.5	492	495	+	3	0	-2	2463
P26439-1#11	0	1	1	P26439-1	81	82	+	1	P26439-1	0	195	ENST00000433745.5	130	715	++	82	P26439-1#11	0	3	ENST00000433745.5	373	376	+	3	0	-2	2464
P26439-1#11	0	1	1	P26439-1	81	82	+	1	P26439-1	0	372	ENST00000369416.4	142	1258	++	44	P26439-1#11	0	3	ENST00000369416.4	385	388	+	3	0	-2	2465
P26439-1#12	0	1	1	P26439-1	93	94	+	1	P26439-1	0	372	ENST00000543831.5	249	1365	++	156	P26439-1#12	0	3	ENST00000543831.5	528	531	+	3	0	-2	2466
P26439-1#12	0	1	1	P26439-1	93	94	+	1	P26439-1	0	195	ENST00000433745.5	130	715	++	82	P26439-1#12	0	3	ENST00000433745.5	409	412	+	3	0	-2	2467
P26439-1#12	0	1	1	P26439-1	93	94	+	1	P26439-1	0	372	ENST00000369416.4	142	1258	++	44	P26439-1#12	0	3	ENST00000369416.4	421	424	+	3	0	-2	2468
P26439-1#13	0	1	1	P26439-1	99	100	+	1	P26439-1	0	372	ENST00000543831.5	249	1365	++	156	P26439-1#13	0	3	ENST00000543831.5	546	549	+	3	0	-2	2469
P26439-1#13	0	1	1	P26439-1	99	100	+	1	P26439-1	0	195	ENST00000433745.5	130	715	++	82	P26439-1#13	0	3	ENST00000433745.5	427	430	+	3	0	-2	2470
P26439-1#13	0	1	1	P26439-1	99	100	+	1	P26439-1	0	372	ENST00000369416.4	142	1258	++	44	P26439-1#13	0	3	ENST00000369416.4	439	442	+	3	0	-2	2471
P26439-1#14	0	1	1	P26439-1	107	108	+	1	P26439-1	0	372	ENST00000543831.5	249	1365	++	156	P26439-1#14	0	3	ENST00000543831.5	570	573	+	3	0	-2	2472
P26439-1#14	0	1	1	P26439-1	107	108	+	1	P26439-1	0	195	ENST00000433745.5	130	715	++	82	P26439-1#14	0	3	ENST00000433745.5	451	454	+	3	0	-2	2473
P26439-1#14	0	1	1	P26439-1	107	108	+	1	P26439-1	0	372	ENST00000369416.4	142	1258	++	44	P26439-1#14	0	3	ENST00000369416.4	463	466	+	3	0	-2	2474
P26439-1#15	0	1	1	P26439-1	128	129	+	1	P26439-1	0	372	ENST00000543831.5	249	1365	++	156	P26439-1#15	0	3	ENST00000543831.5	633	636	+	3	0	-2	2475
P26439-1#15	0	1	1	P26439-1	128	129	+	1	P26439-1	0	195	ENST00000433745.5	130	715	++	82	P26439-1#15	0	3	ENST00000433745.5	514	517	+	3	0	-2	2476
P26439-1#15	0	1	1	P26439-1	128	129	+	1	P26439-1	0	372	ENST00000369416.4	142	1258	++	44	P26439-1#15	0	3	ENST00000369416.4	526	529	+	3	0	-2	2477
P26439-1#16	0	1	1	P26439-1	141	142	+	1	P26439-1	0	372	ENST00000543831.5	249	1365	++	156	P26439-1#16	0	3	ENST00000543831.5	672	675	+	3	0	-2	2478
P26439-1#16	0	1	1	P26439-1	141	142	+	1	P26439-1	0	195	ENST00000433745.5	130	715	++	82	P26439-1#16	0	3	ENST00000433745.5	553	556	+	3	0	-2	2479
P26439-1#16	0	1	1	P26439-1	141	142	+	1	P26439-1	0	372	ENST00000369416.4	142	1258	++	44	P26439-1#16	0	3	ENST00000369416.4	565	568	+	3	0	-2	2480
P26439-1#17	0	1	1	P26439-1	154	155	+	1	P26439-1	0	372	ENST00000543831.5	249	1365	++	156	P26439-1#17	0	3	ENST00000543831.5	711	714	+	3	0	-2	2481
P26439-1#17	0	1	1	P26439-1	154	155	+	1	P26439-1	0	195	ENST00000433745.5	130	715	++	82	P26439-1#17	0	3	ENST00000433745.5	592	595	+	3	0	-2	2482
P26439-1#17	0	1	1	P26439-1	154	155	+	1	P26439-1	0	372	ENST00000369416.4	142	1258	++	44	P26439-1#17	0	3	ENST00000369416.4	604	607	+	3	0	-2	2483
P26439-1#18	0	1	1	P26439-1	166	167	+	1	P26439-1	0	372	ENST00000543831.5	249	1365	++	156	P26439-1#18	0	3	ENST00000543831.5	747	750	+	3	0	-2	2484
P26439-1#18	0	1	1	P26439-1	166	167	+	1	P26439-1	0	195	ENST00000433745.5	130	715	++	82	P26439-1#18	0	3	ENST00000433745.5	628	631	+	3	0	-2	2485
P26439-1#18	0	1	1	P26439-1	166	167	+	1	P26439-1	0	372	ENST00000369416.4	142	1258	++	44	P26439-1#18	0	3	ENST00000369416.4	640	643	+	3	0	-2	2486
P26439-1#19	0	1	1	P26439-1	172	173	+	1	P26439-1	0	372	ENST00000543831.5	249	1365	++	156	P26439-1#19	0	3	ENST00000543831.5	765	768	+	3	0	-2	2487
P26439-1#19	0	1	1	P26439-1	172	173	+	1	P26439-1	0	195	ENST00000433745.5	130	715	++	82	P26439-1#19	0	3	ENST00000433745.5	646	649	+	3	0	-2	2488
P26439-1#19	0	1	1	P26439-1	172	173	+	1	P26439-1	0	372	ENST00000369416.4	142	1258	++	44	P26439-1#19	0	3	ENST00000369416.4	658	661	+	3	0	-2	2489
P26439-1#20	0	1	1	P26439-1	185	186	+	1	P26439-1	0	372	ENST00000543831.5	249	1365	++	156	P26439-1#20	0	3	ENST00000543831.5	804	807	+	3	0	-2	2490
P26439-1#20	0	1	1	P26439-1	185	186	+	1	P26439-1	0	195	ENST00000433745.5	130	715	++	82	P26439-1#20	0	3	ENST00000433745.5	685	688	+	3	0	-2	2491
P26439-1#20	0	1	1	P26439-1	185	186	+	1	P26439-1	0	372	ENST00000369416.4	142	1258	++	44	P26439-1#20	0	3	ENST00000369416.4	697	700	+	3	0	-2	2492
P26439-1#21	0	1	1	P26439-1	204	205	+	1	P26439-1	0	372	ENST00000543831.5	249	1365	++	156	P26439-1#21	0	3	ENST00000543831.5	861	864	+	3	0	-2	2493
P26439-1#21	0	1	1	P26439-1	204	205	+	1	P26439-1	0	372	ENST00000369416.4	142	1258	++	44	P26439-1#21	0	3	ENST00000369416.4	754	757	+	3	0	-2	2494
P26439-1#22	0	1	1	P26439-1	212	213	+	1	P26439-1	0	372	ENST00000543831.5	249	1365	++	156	P26439-1#22	0	3	ENST00000543831.5	885	888	+	3	0	-2	2495
P26439-1#22	0	1	1	P26439-1	212	213	+	1	P26439-1	0	372	ENST00000369416.4	142	1258	++	44	P26439-1#22	0	3	ENST00000369416.4	778	781	+	3	0	-2	2496
P26439-1#23	0	1	1	P26439-1	215	216	+	1	P26439-1	0	372	ENST00000543831.5	249	1365	++	156	P26439-1#23	0	3	ENST00000543831.5	894	897	+	3	0	-2	2497
P26439-1#23	0	1	1	P26439-1	215	216	+	1	P26439-1	0	372	ENST00000369416.4	142	1258	++	44	P26439-1#23	0	3	ENST00000369416.4	787	790	+	3	0	-2	2498
P26439-1#24	0	1	1	P26439-1	221	222	+	1	P26439-1	0	372	ENST00000543831.5	249	1365	++	156	P26439-1#24	0	3	ENST00000543831.5	912	915	+	3	0	-2	2499
P26439-1#24	0	1	1	P26439-1	221	222	+	1	P26439-1	0	372	ENST00000369416.4	142	1258	++	44	P26439-1#24	0	3	ENST00000369416.4	805	808	+	3	0	-2	2500
P26439-1#25	0	1	1	P26439-1	221	222	+	1	P26439-1	0	372	ENST00000543831.5	249	1365	++	156	P26439-1#25	0	3	ENST00000543831.5	912	915	+	3	0	-2	2501
P26439-1#25	0	1	1	P26439-1	221	222	+	1	P26439-1	0	372	ENST00000369416.4	142	1258	++	44	P26439-1#25	0	3	ENST00000369416.4	805	808	+	3	0	-2	2502
P26439-1#26	0	1	1	P26439-1	221	222	+	1	P26439-1	0	372	ENST00000543831.5	249	1365	++	156	P26439-1#26	0	3	ENST00000543831.5	912	915	+	3	0	-2	2503
P26439-1#26	0	1	1	P26439-1	221	222	+	1	P26439-1	0	372	ENST00000369416.4	142	1258	++	44	P26439-1#26	0	3	ENST00000369416.4	805	808	+	3	0	-2	2504
P26439-1#27	0	8	8	P26439-1	230	238	+	8	P26439-1	0	372	ENST00000543831.5	249	1365	++	156	P26439-1#27	0	24	ENST00000543831.5	939	963	+	24	0	-16	2505
P26439-1#27	0	8	8	P26439-1	230	238	+	8	P26439-1	0	372	ENST00000369416.4	142	1258	++	44	P26439-1#27	0	24	ENST00000369416.4	832	856	+	24	0	-16	2506
P26439-1#28	0	1	1	P26439-1	235	236	+	1	P26439-1	0	372	ENST00000543831.5	249	1365	++	156	P26439-1#28	0	3	ENST00000543831.5	954	957	+	3	0	-2	2507
P26439-1#28	0	1	1	P26439-1	235	236	+	1	P26439-1	0	372	ENST00000369416.4	142	1258	++	44	P26439-1#28	0	3	ENST00000369416.4	847	850	+	3	0	-2	2508
P26439-1#29	0	1	1	P26439-1	244	245	+	1	P26439-1	0	372	ENST00000543831.5	249	1365	++	156	P26439-1#29	0	3	ENST00000543831.5	981	984	+	3	0	-2	2509
P26439-1#29	0	1	1	P26439-1	244	245	+	1	P26439-1	0	372	ENST00000369416.4	142	1258	++	44	P26439-1#29	0	3	ENST00000369416.4	874	877	+	3	0	-2	2510
P26439-1#30	0	1	1	P26439-1	249	250	+	1	P26439-1	0	372	ENST00000543831.5	249	1365	++	156	P26439-1#30	0	3	ENST00000543831.5	996	999	+	3	0	-2	2511
P26439-1#30	0	1	1	P26439-1	249	250	+	1	P26439-1	0	372	ENST00000369416.4	142	1258	++	44	P26439-1#30	0	3	ENST00000369416.4	889	892	+	3	0	-2	2512
P26439-1#31	0	1	1	P26439-1	252	253	+	1	P26439-1	0	372	ENST00000543831.5	249	1365	++	156	P26439-1#31	0	3	ENST00000543831.5	1005	1008	+	3	0	-2	2513
P26439-1#31	0	1	1	P26439-1	252	253	+	1	P26439-1	0	372	ENST00000369416.4	142	1258	++	44	P26439-1#31	0	3	ENST00000369416.4	898	901	+	3	0	-2	2514
P26439-1#32	0	1	1	P26439-1	253	254	+	1	P26439-1	0	372	ENST00000543831.5	249	1365	++	156	P26439-1#32	0	3	ENST00000543831.5	1008	1011	+	3	0	-2	2515
P26439-1#32	0	1	1	P26439-1	253	254	+	1	P26439-1	0	372	ENST00000369416.4	142	1258	++	44	P26439-1#32	0	3	ENST00000369416.4	901	904	+	3	0	-2	2516
P26439-1#33	0	1	1	P26439-1	258	259	+	1	P26439-1	0	372	ENST00000543831.5	249	1365	++	156	P26439-1#33	0	3	ENST00000543831.5	1023	1026	+	3	0	-2	2517
P26439-1#33	0	1	1	P26439-1	258	259	+	1	P26439-1	0	372	ENST00000369416.4	142	1258	++	44	P26439-1#33	0	3	ENST00000369416.4	916	919	+	3	0	-2	2518
P26439-1#34	0	1	1	P26439-1	258	259	+	1	P26439-1	0	372	ENST00000543831.5	249	1365	++	156	P26439-1#34	0	3	ENST00000543831.5	1023	1026	+	3	0	-2	2519
P26439-1#34	0	1	1	P26439-1	258	259	+	1	P26439-1	0	372	ENST00000369416.4	142	1258	++	44	P26439-1#34	0	3	ENST00000369416.4	916	919	+	3	0	-2	2520
P26439-1#35	0	1	1	P26439-1	293	294	+	1	P26439-1	0	372	ENST00000543831.5	249	1365	++	156	P26439-1#35	0	3	ENST00000543831.5	1128	1131	+	3	0	-2	2521
P26439-1#35	0	1	1	P26439-1	293	294	+	1	P26439-1	0	372	ENST00000369416.4	142	1258	++	44	P26439-1#35	0	3	ENST00000369416.4	1021	1024	+	3	0	-2	2522
P26439-1#36	0	1	1	P26439-1	340	341	+	1	P26439-1	0	372	ENST00000543831.5	249	1365	++	156	P26439-1#36	0	3	ENST00000543831.5	1269	1272	+	3	0	-2	2523
P26439-1#36	0	1	1	P26439-1	340	341	+	1	P26439-1	0	372	ENST00000369416.4	142	1258	++	44	P26439-1#36	0	3	ENST00000369416.4	1162	1165	+	3	0	-2	2524
P26439-1#37	0	2	2	P26439-1	51	53	+	2	P26439-1	0	372	ENST00000543831.5	249	1365	++	156	P26439-1#37	0	6	ENST00000543831.5	402	408	+	6	0	-4	2525
P26439-1#37	0	2	2	P26439-1	51	53	+	2	P26439-1	0	195	ENST00000433745.5	130	715	++	82	P26439-1#37	0	6	ENST00000433745.5	283	289	+	6	0	-4	2526
P26439-1#37	0	2	2	P26439-1	51	53	+	2	P26439-1	0	372	ENST00000369416.4	142	1258	++	44	P26439-1#37	0	6	ENST00000369416.4	295	301	+	6	0	-4	2527
P26439-1#38	0	3	3	P26439-1	91	94	+	3	P26439-1	0	372	ENST00000543831.5	249	1365	++	156	P26439-1#38	0	9	ENST00000543831.5	522	531	+	9	0	-6	2528
P26439-1#38	0	3	3	P26439-1	91	94	+	3	P26439-1	0	195	ENST00000433745.5	130	715	++	82	P26439-1#38	0	9	ENST00000433745.5	403	412	+	9	0	-6	2529
P26439-1#38	0	3	3	P26439-1	91	94	+	3	P26439-1	0	372	ENST00000369416.4	142	1258	++	44	P26439-1#38	0	9	ENST00000369416.4	415	424	+	9	0	-6	2530
P26439-1#39	0	1	1	P26439-1	231	232	+	1	P26439-1	0	372	ENST00000543831.5	249	1365	++	156	P26439-1#39	0	3	ENST00000543831.5	942	945	+	3	0	-2	2531
P26439-1#39	0	1	1	P26439-1	231	232	+	1	P26439-1	0	372	ENST00000369416.4	142	1258	++	44	P26439-1#39	0	3	ENST00000369416.4	835	838	+	3	0	-2	2532
Q9GZX5#0	0	532	532	Q9GZX5	0	532	+	532	Q9GZX5	36	199	ENST00000601430.5	380	869	++	215	Q9GZX5#0	108	597	ENST00000601430.5	380	869	+	489	108	-65	2533
Q9GZX5#0	0	532	532	Q9GZX5	0	532	+	532	Q9GZX5	0	62	ENST00000597788.5	347	533	++	205	Q9GZX5#0	0	186	ENST00000597788.5	347	533	+	186	0	346	2534
Q9GZX5#0	0	532	532	Q9GZX5	0	532	+	532	Q9GZX5	0	67	ENST00000594929.5	351	552	++	199	Q9GZX5#0	0	201	ENST00000594929.5	351	552	+	201	0	331	2535
Q9GZX5#0	0	532	532	Q9GZX5	0	532	+	532	Q9GZX5	0	52	ENST00000593596.1	332	488	++	194	Q9GZX5#0	0	156	ENST00000593596.1	332	488	+	156	0	376	2536
Q9GZX5#0	0	532	532	Q9GZX5	0	532	+	532	Q9GZX5	0	532	ENST00000243644.9	242	1838	++	4	Q9GZX5#0	0	1596	ENST00000243644.9	242	1838	+	1596	0	-1064	2537
Q9GZX5#1	0	72	72	Q9GZX5	7	79	+	72	Q9GZX5	36	199	ENST00000601430.5	380	869	++	215	Q9GZX5#1	87	216	ENST00000601430.5	380	509	+	129	87	-144	2538
Q9GZX5#1	0	72	72	Q9GZX5	7	79	+	72	Q9GZX5	0	62	ENST00000597788.5	347	533	++	205	Q9GZX5#1	0	165	ENST00000597788.5	368	533	+	165	0	-93	2539
Q9GZX5#1	0	72	72	Q9GZX5	7	79	+	72	Q9GZX5	0	67	ENST00000594929.5	351	552	++	199	Q9GZX5#1	0	180	ENST00000594929.5	372	552	+	180	0	-108	2540
Q9GZX5#1	0	72	72	Q9GZX5	7	79	+	72	Q9GZX5	0	52	ENST00000593596.1	332	488	++	194	Q9GZX5#1	0	135	ENST00000593596.1	353	488	+	135	0	-63	2541
Q9GZX5#1	0	72	72	Q9GZX5	7	79	+	72	Q9GZX5	0	532	ENST00000243644.9	242	1838	++	4	Q9GZX5#1	0	216	ENST00000243644.9	263	479	+	216	0	-144	2542
Q9GZX5#2	0	23	23	Q9GZX5	205	228	+	23	Q9GZX5	0	532	ENST00000243644.9	242	1838	++	4	Q9GZX5#2	0	69	ENST00000243644.9	857	926	+	69	0	-46	2543
Q9GZX5#3	0	23	23	Q9GZX5	233	256	+	23	Q9GZX5	0	532	ENST00000243644.9	242	1838	++	4	Q9GZX5#3	0	69	ENST00000243644.9	941	1010	+	69	0	-46	2544
Q9GZX5#4	0	23	23	Q9GZX5	261	284	+	23	Q9GZX5	0	532	ENST00000243644.9	242	1838	++	4	Q9GZX5#4	0	69	ENST00000243644.9	1025	1094	+	69	0	-46	2545
Q9GZX5#5	0	23	23	Q9GZX5	289	312	+	23	Q9GZX5	0	532	ENST00000243644.9	242	1838	++	4	Q9GZX5#5	0	69	ENST00000243644.9	1109	1178	+	69	0	-46	2546
Q9GZX5#6	0	23	23	Q9GZX5	317	340	+	23	Q9GZX5	0	532	ENST00000243644.9	242	1838	++	4	Q9GZX5#6	0	69	ENST00000243644.9	1193	1262	+	69	0	-46	2547
Q9GZX5#7	0	23	23	Q9GZX5	345	368	+	23	Q9GZX5	0	532	ENST00000243644.9	242	1838	++	4	Q9GZX5#7	0	69	ENST00000243644.9	1277	1346	+	69	0	-46	2548
Q9GZX5#8	0	23	23	Q9GZX5	373	396	+	23	Q9GZX5	0	532	ENST00000243644.9	242	1838	++	4	Q9GZX5#8	0	69	ENST00000243644.9	1361	1430	+	69	0	-46	2549
Q9GZX5#9	0	23	23	Q9GZX5	401	424	+	23	Q9GZX5	0	532	ENST00000243644.9	242	1838	++	4	Q9GZX5#9	0	69	ENST00000243644.9	1445	1514	+	69	0	-46	2550
Q9GZX5#10	0	39	39	Q9GZX5	426	465	+	39	Q9GZX5	0	532	ENST00000243644.9	242	1838	++	4	Q9GZX5#10	0	117	ENST00000243644.9	1520	1637	+	117	0	-78	2551
Q9GZX5#11	0	22	22	Q9GZX5	426	448	+	22	Q9GZX5	0	532	ENST00000243644.9	242	1838	++	4	Q9GZX5#11	0	66	ENST00000243644.9	1520	1586	+	66	0	-44	2552
Q9GZX5#12	0	17	17	Q9GZX5	448	465	+	17	Q9GZX5	0	532	ENST00000243644.9	242	1838	++	4	Q9GZX5#12	0	51	ENST00000243644.9	1586	1637	+	51	0	-34	2553
Q9GZX5#13	0	1	1	Q9GZX5	36	37	+	1	Q9GZX5	36	199	ENST00000601430.5	380	869	++	215	Q9GZX5#13	0	3	ENST00000601430.5	380	383	+	3	0	-2	2554
Q9GZX5#13	0	1	1	Q9GZX5	36	37	+	1	Q9GZX5	0	62	ENST00000597788.5	347	533	++	205	Q9GZX5#13	0	3	ENST00000597788.5	455	458	+	3	0	-2	2555
Q9GZX5#13	0	1	1	Q9GZX5	36	37	+	1	Q9GZX5	0	67	ENST00000594929.5	351	552	++	199	Q9GZX5#13	0	3	ENST00000594929.5	459	462	+	3	0	-2	2556
Q9GZX5#13	0	1	1	Q9GZX5	36	37	+	1	Q9GZX5	0	52	ENST00000593596.1	332	488	++	194	Q9GZX5#13	0	3	ENST00000593596.1	440	443	+	3	0	-2	2557
Q9GZX5#13	0	1	1	Q9GZX5	36	37	+	1	Q9GZX5	0	532	ENST00000243644.9	242	1838	++	4	Q9GZX5#13	0	3	ENST00000243644.9	350	353	+	3	0	-2	2558
Q9GZX5#14	0	1	1	Q9GZX5	65	66	+	1	Q9GZX5	36	199	ENST00000601430.5	380	869	++	215	Q9GZX5#14	0	3	ENST00000601430.5	467	470	+	3	0	-2	2559
Q9GZX5#14	0	1	1	Q9GZX5	65	66	+	1	Q9GZX5	0	67	ENST00000594929.5	351	552	++	199	Q9GZX5#14	0	3	ENST00000594929.5	546	549	+	3	0	-2	2560
Q9GZX5#14	0	1	1	Q9GZX5	65	66	+	1	Q9GZX5	0	532	ENST00000243644.9	242	1838	++	4	Q9GZX5#14	0	3	ENST00000243644.9	437	440	+	3	0	-2	2561
Q9GZX5#15	0	1	1	Q9GZX5	68	69	+	1	Q9GZX5	36	199	ENST00000601430.5	380	869	++	215	Q9GZX5#15	0	3	ENST00000601430.5	476	479	+	3	0	-2	2562
Q9GZX5#15	0	1	1	Q9GZX5	68	69	+	1	Q9GZX5	0	532	ENST00000243644.9	242	1838	++	4	Q9GZX5#15	0	3	ENST00000243644.9	446	449	+	3	0	-2	2563
Q9GZX5#16	0	1	1	Q9GZX5	131	132	+	1	Q9GZX5	36	199	ENST00000601430.5	380	869	++	215	Q9GZX5#16	0	3	ENST00000601430.5	665	668	+	3	0	-2	2564
Q9GZX5#16	0	1	1	Q9GZX5	131	132	+	1	Q9GZX5	0	532	ENST00000243644.9	242	1838	++	4	Q9GZX5#16	0	3	ENST00000243644.9	635	638	+	3	0	-2	2565
Q9GZX5#17	0	1	1	Q9GZX5	405	406	+	1	Q9GZX5	0	532	ENST00000243644.9	242	1838	++	4	Q9GZX5#17	0	3	ENST00000243644.9	1457	1460	+	3	0	-2	2566
Q9GZX5#18	0	1	1	Q9GZX5	471	472	+	1	Q9GZX5	0	532	ENST00000243644.9	242	1838	++	4	Q9GZX5#18	0	3	ENST00000243644.9	1655	1658	+	3	0	-2	2567
Q9GZX5#19	0	1	1	Q9GZX5	500	501	+	1	Q9GZX5	0	532	ENST00000243644.9	242	1838	++	4	Q9GZX5#19	0	3	ENST00000243644.9	1742	1745	+	3	0	-2	2568
Q9GZX5#20	0	1	1	Q9GZX5	523	524	+	1	Q9GZX5	0	532	ENST00000243644.9	242	1838	++	4	Q9GZX5#20	0	3	ENST00000243644.9	1811	1814	+	3	0	-2	2569
P01009-1#0	0	24	24	P01009-1	0	24	+	24	P01009-1	0	418	ENST00000636712.1	152	1406	++	227	P01009-1#0	0	72	ENST00000636712.1	152	224	+	72	0	-48	2570
P01009-1#0	0	24	24	P01009-1	0	24	+	24	P01009-1	0	144	ENST00000557492.5	517	949	++	169	P01009-1#0	0	72	ENST00000557492.5	517	589	+	72	0	-48	2571
P01009-1#0	0	24	24	P01009-1	0	24	+	24	P01009-1	0	22	ENST00000557118.5	516	582	++	168	P01009-1#0	0	66	ENST00000557118.5	516	582	+	66	0	-42	2572
P01009-1#0	0	24	24	P01009-1	0	24	+	24	P01009-1	0	117	ENST00000556955.5	220	571	++	167	P01009-1#0	0	72	ENST00000556955.5	220	292	+	72	0	-48	2573
P01009-1#0	0	24	24	P01009-1	0	24	+	24	P01009-1	0	156	ENST00000556091.1	174	642	++	166	P01009-1#0	0	72	ENST00000556091.1	174	246	+	72	0	-48	2574
P01009-1#0	0	24	24	P01009-1	0	24	+	24	P01009-1	0	92	ENST00000553327.5	303	579	++	164	P01009-1#0	0	72	ENST00000553327.5	303	375	+	72	0	-48	2575
P01009-1#0	0	24	24	P01009-1	0	24	+	24	P01009-1	0	306	ENST00000489769.1	9	927	++	120	P01009-1#0	0	72	ENST00000489769.1	9	81	+	72	0	-48	2576
P01009-1#0	0	24	24	P01009-1	0	24	+	24	P01009-1	0	418	ENST00000449399.7	302	1556	++	100	P01009-1#0	0	72	ENST00000449399.7	302	374	+	72	0	-48	2577
P01009-1#0	0	24	24	P01009-1	0	24	+	24	P01009-1	0	418	ENST00000448921.5	573	1827	++	98	P01009-1#0	0	72	ENST00000448921.5	573	645	+	72	0	-48	2578
P01009-1#0	0	24	24	P01009-1	0	24	+	24	P01009-1	0	418	ENST00000440909.5	185	1439	++	91	P01009-1#0	0	72	ENST00000440909.5	185	257	+	72	0	-48	2579
P01009-1#0	0	24	24	P01009-1	0	24	+	24	P01009-1	0	418	ENST00000437397.5	381	1635	++	89	P01009-1#0	0	72	ENST00000437397.5	381	453	+	72	0	-48	2580
P01009-1#0	0	24	24	P01009-1	0	24	+	24	P01009-1	0	418	ENST00000404814.8	311	1565	++	67	P01009-1#0	0	72	ENST00000404814.8	311	383	+	72	0	-48	2581
P01009-1#0	0	24	24	P01009-1	0	24	+	24	P01009-1	0	355	ENST00000402629.1	34	1099	++	66	P01009-1#0	0	72	ENST00000402629.1	34	106	+	72	0	-48	2582
P01009-1#0	0	24	24	P01009-1	0	24	+	24	P01009-1	0	418	ENST00000393088.8	555	1809	++	62	P01009-1#0	0	72	ENST00000393088.8	555	627	+	72	0	-48	2583
P01009-1#0	0	24	24	P01009-1	0	24	+	24	P01009-1	0	418	ENST00000393087.9	47	1301	++	61	P01009-1#0	0	72	ENST00000393087.9	47	119	+	72	0	-48	2584
P01009-1#0	0	24	24	P01009-1	0	24	+	24	P01009-1	0	418	ENST00000355814.8	277	1531	++	37	P01009-1#0	0	72	ENST00000355814.8	277	349	+	72	0	-48	2585
P01009-1#1	0	394	394	P01009-1	24	418	+	394	P01009-1	0	418	ENST00000636712.1	152	1406	++	227	P01009-1#1	0	1182	ENST00000636712.1	224	1406	+	1182	0	-788	2586
P01009-1#1	0	394	394	P01009-1	24	418	+	394	P01009-1	0	144	ENST00000557492.5	517	949	++	169	P01009-1#1	0	360	ENST00000557492.5	589	949	+	360	0	34	2587
P01009-1#1	0	394	394	P01009-1	24	418	+	394	P01009-1	0	117	ENST00000556955.5	220	571	++	167	P01009-1#1	0	279	ENST00000556955.5	292	571	+	279	0	115	2588
P01009-1#1	0	394	394	P01009-1	24	418	+	394	P01009-1	0	156	ENST00000556091.1	174	642	++	166	P01009-1#1	0	396	ENST00000556091.1	246	642	+	396	0	-2	2589
P01009-1#1	0	394	394	P01009-1	24	418	+	394	P01009-1	86	191	ENST00000554720.1	129	444	++	165	P01009-1#1	186	501	ENST00000554720.1	129	444	+	315	186	-107	2590
P01009-1#1	0	394	394	P01009-1	24	418	+	394	P01009-1	0	92	ENST00000553327.5	303	579	++	164	P01009-1#1	0	204	ENST00000553327.5	375	579	+	204	0	190	2591
P01009-1#1	0	394	394	P01009-1	24	418	+	394	P01009-1	0	306	ENST00000489769.1	9	927	++	120	P01009-1#1	0	846	ENST00000489769.1	81	927	+	846	0	-452	2592
P01009-1#1	0	394	394	P01009-1	24	418	+	394	P01009-1	0	418	ENST00000449399.7	302	1556	++	100	P01009-1#1	0	1182	ENST00000449399.7	374	1556	+	1182	0	-788	2593
P01009-1#1	0	394	394	P01009-1	24	418	+	394	P01009-1	0	418	ENST00000448921.5	573	1827	++	98	P01009-1#1	0	1182	ENST00000448921.5	645	1827	+	1182	0	-788	2594
P01009-1#1	0	394	394	P01009-1	24	418	+	394	P01009-1	0	418	ENST00000440909.5	185	1439	++	91	P01009-1#1	0	1182	ENST00000440909.5	257	1439	+	1182	0	-788	2595
P01009-1#1	0	394	394	P01009-1	24	418	+	394	P01009-1	0	418	ENST00000437397.5	381	1635	++	89	P01009-1#1	0	1182	ENST00000437397.5	453	1635	+	1182	0	-788	2596
P01009-1#1	0	394	394	P01009-1	24	418	+	394	P01009-1	0	418	ENST00000404814.8	311	1565	++	67	P01009-1#1	0	1182	ENST00000404814.8	383	1565	+	1182	0	-788	2597
P01009-1#1	0	394	394	P01009-1	24	418	+	394	P01009-1	0	355	ENST00000402629.1	34	1099	++	66	P01009-1#1	0	993	ENST00000402629.1	106	1099	+	993	0	-599	2598
P01009-1#1	0	394	394	P01009-1	24	418	+	394	P01009-1	0	418	ENST00000393088.8	555	1809	++	62	P01009-1#1	0	1182	ENST00000393088.8	627	1809	+	1182	0	-788	2599
P01009-1#1	0	394	394	P01009-1	24	418	+	394	P01009-1	0	418	ENST00000393087.9	47	1301	++	61	P01009-1#1	0	1182	ENST00000393087.9	119	1301	+	1182	0	-788	2600
P01009-1#1	0	394	394	P01009-1	24	418	+	394	P01009-1	0	418	ENST00000355814.8	277	1531	++	37	P01009-1#1	0	1182	ENST00000355814.8	349	1531	+	1182	0	-788	2601
P01009-1#2	0	44	44	P01009-1	374	418	+	44	P01009-1	0	418	ENST00000636712.1	152	1406	++	227	P01009-1#2	0	132	ENST00000636712.1	1274	1406	+	132	0	-88	2602
P01009-1#2	0	44	44	P01009-1	374	418	+	44	P01009-1	0	418	ENST00000449399.7	302	1556	++	100	P01009-1#2	0	132	ENST00000449399.7	1424	1556	+	132	0	-88	2603
P01009-1#2	0	44	44	P01009-1	374	418	+	44	P01009-1	0	418	ENST00000448921.5	573	1827	++	98	P01009-1#2	0	132	ENST00000448921.5	1695	1827	+	132	0	-88	2604
P01009-1#2	0	44	44	P01009-1	374	418	+	44	P01009-1	0	418	ENST00000440909.5	185	1439	++	91	P01009-1#2	0	132	ENST00000440909.5	1307	1439	+	132	0	-88	2605
P01009-1#2	0	44	44	P01009-1	374	418	+	44	P01009-1	0	418	ENST00000437397.5	381	1635	++	89	P01009-1#2	0	132	ENST00000437397.5	1503	1635	+	132	0	-88	2606
P01009-1#2	0	44	44	P01009-1	374	418	+	44	P01009-1	0	418	ENST00000404814.8	311	1565	++	67	P01009-1#2	0	132	ENST00000404814.8	1433	1565	+	132	0	-88	2607
P01009-1#2	0	44	44	P01009-1	374	418	+	44	P01009-1	0	418	ENST00000393088.8	555	1809	++	62	P01009-1#2	0	132	ENST00000393088.8	1677	1809	+	132	0	-88	2608
P01009-1#2	0	44	44	P01009-1	374	418	+	44	P01009-1	0	418	ENST00000393087.9	47	1301	++	61	P01009-1#2	0	132	ENST00000393087.9	1169	1301	+	132	0	-88	2609
P01009-1#2	0	44	44	P01009-1	374	418	+	44	P01009-1	0	418	ENST00000355814.8	277	1531	++	37	P01009-1#2	0	132	ENST00000355814.8	1399	1531	+	132	0	-88	2610
P01009-1#3	0	25	25	P01009-1	367	392	+	25	P01009-1	0	418	ENST00000636712.1	152	1406	++	227	P01009-1#3	0	75	ENST00000636712.1	1253	1328	+	75	0	-50	2611
P01009-1#3	0	25	25	P01009-1	367	392	+	25	P01009-1	0	418	ENST00000449399.7	302	1556	++	100	P01009-1#3	0	75	ENST00000449399.7	1403	1478	+	75	0	-50	2612
P01009-1#3	0	25	25	P01009-1	367	392	+	25	P01009-1	0	418	ENST00000448921.5	573	1827	++	98	P01009-1#3	0	75	ENST00000448921.5	1674	1749	+	75	0	-50	2613
P01009-1#3	0	25	25	P01009-1	367	392	+	25	P01009-1	0	418	ENST00000440909.5	185	1439	++	91	P01009-1#3	0	75	ENST00000440909.5	1286	1361	+	75	0	-50	2614
P01009-1#3	0	25	25	P01009-1	367	392	+	25	P01009-1	0	418	ENST00000437397.5	381	1635	++	89	P01009-1#3	0	75	ENST00000437397.5	1482	1557	+	75	0	-50	2615
P01009-1#3	0	25	25	P01009-1	367	392	+	25	P01009-1	0	418	ENST00000404814.8	311	1565	++	67	P01009-1#3	0	75	ENST00000404814.8	1412	1487	+	75	0	-50	2616
P01009-1#3	0	25	25	P01009-1	367	392	+	25	P01009-1	0	418	ENST00000393088.8	555	1809	++	62	P01009-1#3	0	75	ENST00000393088.8	1656	1731	+	75	0	-50	2617
P01009-1#3	0	25	25	P01009-1	367	392	+	25	P01009-1	0	418	ENST00000393087.9	47	1301	++	61	P01009-1#3	0	75	ENST00000393087.9	1148	1223	+	75	0	-50	2618
P01009-1#3	0	25	25	P01009-1	367	392	+	25	P01009-1	0	418	ENST00000355814.8	277	1531	++	37	P01009-1#3	0	75	ENST00000355814.8	1378	1453	+	75	0	-50	2619
P01009-1#4	0	2	2	P01009-1	351	353	+	2	P01009-1	0	418	ENST00000636712.1	152	1406	++	227	P01009-1#4	0	6	ENST00000636712.1	1205	1211	+	6	0	-4	2620
P01009-1#4	0	2	2	P01009-1	351	353	+	2	P01009-1	0	418	ENST00000449399.7	302	1556	++	100	P01009-1#4	0	6	ENST00000449399.7	1355	1361	+	6	0	-4	2621
P01009-1#4	0	2	2	P01009-1	351	353	+	2	P01009-1	0	418	ENST00000448921.5	573	1827	++	98	P01009-1#4	0	6	ENST00000448921.5	1626	1632	+	6	0	-4	2622
P01009-1#4	0	2	2	P01009-1	351	353	+	2	P01009-1	0	418	ENST00000440909.5	185	1439	++	91	P01009-1#4	0	6	ENST00000440909.5	1238	1244	+	6	0	-4	2623
P01009-1#4	0	2	2	P01009-1	351	353	+	2	P01009-1	0	418	ENST00000437397.5	381	1635	++	89	P01009-1#4	0	6	ENST00000437397.5	1434	1440	+	6	0	-4	2624
P01009-1#4	0	2	2	P01009-1	351	353	+	2	P01009-1	0	418	ENST00000404814.8	311	1565	++	67	P01009-1#4	0	6	ENST00000404814.8	1364	1370	+	6	0	-4	2625
P01009-1#4	0	2	2	P01009-1	351	353	+	2	P01009-1	0	355	ENST00000402629.1	34	1099	++	66	P01009-1#4	0	6	ENST00000402629.1	1087	1093	+	6	0	-4	2626
P01009-1#4	0	2	2	P01009-1	351	353	+	2	P01009-1	0	418	ENST00000393088.8	555	1809	++	62	P01009-1#4	0	6	ENST00000393088.8	1608	1614	+	6	0	-4	2627
P01009-1#4	0	2	2	P01009-1	351	353	+	2	P01009-1	0	418	ENST00000393087.9	47	1301	++	61	P01009-1#4	0	6	ENST00000393087.9	1100	1106	+	6	0	-4	2628
P01009-1#4	0	2	2	P01009-1	351	353	+	2	P01009-1	0	418	ENST00000355814.8	277	1531	++	37	P01009-1#4	0	6	ENST00000355814.8	1330	1336	+	6	0	-4	2629
P01009-1#5	0	2	2	P01009-1	353	355	+	2	P01009-1	0	418	ENST00000636712.1	152	1406	++	227	P01009-1#5	0	6	ENST00000636712.1	1211	1217	+	6	0	-4	2630
P01009-1#5	0	2	2	P01009-1	353	355	+	2	P01009-1	0	418	ENST00000449399.7	302	1556	++	100	P01009-1#5	0	6	ENST00000449399.7	1361	1367	+	6	0	-4	2631
P01009-1#5	0	2	2	P01009-1	353	355	+	2	P01009-1	0	418	ENST00000448921.5	573	1827	++	98	P01009-1#5	0	6	ENST00000448921.5	1632	1638	+	6	0	-4	2632
P01009-1#5	0	2	2	P01009-1	353	355	+	2	P01009-1	0	418	ENST00000440909.5	185	1439	++	91	P01009-1#5	0	6	ENST00000440909.5	1244	1250	+	6	0	-4	2633
P01009-1#5	0	2	2	P01009-1	353	355	+	2	P01009-1	0	418	ENST00000437397.5	381	1635	++	89	P01009-1#5	0	6	ENST00000437397.5	1440	1446	+	6	0	-4	2634
P01009-1#5	0	2	2	P01009-1	353	355	+	2	P01009-1	0	418	ENST00000404814.8	311	1565	++	67	P01009-1#5	0	6	ENST00000404814.8	1370	1376	+	6	0	-4	2635
P01009-1#5	0	2	2	P01009-1	353	355	+	2	P01009-1	0	355	ENST00000402629.1	34	1099	++	66	P01009-1#5	0	6	ENST00000402629.1	1093	1099	+	6	0	-4	2636
P01009-1#5	0	2	2	P01009-1	353	355	+	2	P01009-1	0	418	ENST00000393088.8	555	1809	++	62	P01009-1#5	0	6	ENST00000393088.8	1614	1620	+	6	0	-4	2637
P01009-1#5	0	2	2	P01009-1	353	355	+	2	P01009-1	0	418	ENST00000393087.9	47	1301	++	61	P01009-1#5	0	6	ENST00000393087.9	1106	1112	+	6	0	-4	2638
P01009-1#5	0	2	2	P01009-1	353	355	+	2	P01009-1	0	418	ENST00000355814.8	277	1531	++	37	P01009-1#5	0	6	ENST00000355814.8	1336	1342	+	6	0	-4	2639
P01009-1#6	0	2	2	P01009-1	381	383	+	2	P01009-1	0	418	ENST00000636712.1	152	1406	++	227	P01009-1#6	0	6	ENST00000636712.1	1295	1301	+	6	0	-4	2640
P01009-1#6	0	2	2	P01009-1	381	383	+	2	P01009-1	0	418	ENST00000449399.7	302	1556	++	100	P01009-1#6	0	6	ENST00000449399.7	1445	1451	+	6	0	-4	2641
P01009-1#6	0	2	2	P01009-1	381	383	+	2	P01009-1	0	418	ENST00000448921.5	573	1827	++	98	P01009-1#6	0	6	ENST00000448921.5	1716	1722	+	6	0	-4	2642
P01009-1#6	0	2	2	P01009-1	381	383	+	2	P01009-1	0	418	ENST00000440909.5	185	1439	++	91	P01009-1#6	0	6	ENST00000440909.5	1328	1334	+	6	0	-4	2643
P01009-1#6	0	2	2	P01009-1	381	383	+	2	P01009-1	0	418	ENST00000437397.5	381	1635	++	89	P01009-1#6	0	6	ENST00000437397.5	1524	1530	+	6	0	-4	2644
P01009-1#6	0	2	2	P01009-1	381	383	+	2	P01009-1	0	418	ENST00000404814.8	311	1565	++	67	P01009-1#6	0	6	ENST00000404814.8	1454	1460	+	6	0	-4	2645
P01009-1#6	0	2	2	P01009-1	381	383	+	2	P01009-1	0	418	ENST00000393088.8	555	1809	++	62	P01009-1#6	0	6	ENST00000393088.8	1698	1704	+	6	0	-4	2646
P01009-1#6	0	2	2	P01009-1	381	383	+	2	P01009-1	0	418	ENST00000393087.9	47	1301	++	61	P01009-1#6	0	6	ENST00000393087.9	1190	1196	+	6	0	-4	2647
P01009-1#6	0	2	2	P01009-1	381	383	+	2	P01009-1	0	418	ENST00000355814.8	277	1531	++	37	P01009-1#6	0	6	ENST00000355814.8	1420	1426	+	6	0	-4	2648
P01009-1#7	0	1	1	P01009-1	37	38	+	1	P01009-1	0	418	ENST00000636712.1	152	1406	++	227	P01009-1#7	0	3	ENST00000636712.1	263	266	+	3	0	-2	2649
P01009-1#7	0	1	1	P01009-1	37	38	+	1	P01009-1	0	144	ENST00000557492.5	517	949	++	169	P01009-1#7	0	3	ENST00000557492.5	628	631	+	3	0	-2	2650
P01009-1#7	0	1	1	P01009-1	37	38	+	1	P01009-1	0	117	ENST00000556955.5	220	571	++	167	P01009-1#7	0	3	ENST00000556955.5	331	334	+	3	0	-2	2651
P01009-1#7	0	1	1	P01009-1	37	38	+	1	P01009-1	0	156	ENST00000556091.1	174	642	++	166	P01009-1#7	0	3	ENST00000556091.1	285	288	+	3	0	-2	2652
P01009-1#7	0	1	1	P01009-1	37	38	+	1	P01009-1	0	92	ENST00000553327.5	303	579	++	164	P01009-1#7	0	3	ENST00000553327.5	414	417	+	3	0	-2	2653
P01009-1#7	0	1	1	P01009-1	37	38	+	1	P01009-1	0	306	ENST00000489769.1	9	927	++	120	P01009-1#7	0	3	ENST00000489769.1	120	123	+	3	0	-2	2654
P01009-1#7	0	1	1	P01009-1	37	38	+	1	P01009-1	0	418	ENST00000449399.7	302	1556	++	100	P01009-1#7	0	3	ENST00000449399.7	413	416	+	3	0	-2	2655
P01009-1#7	0	1	1	P01009-1	37	38	+	1	P01009-1	0	418	ENST00000448921.5	573	1827	++	98	P01009-1#7	0	3	ENST00000448921.5	684	687	+	3	0	-2	2656
P01009-1#7	0	1	1	P01009-1	37	38	+	1	P01009-1	0	418	ENST00000440909.5	185	1439	++	91	P01009-1#7	0	3	ENST00000440909.5	296	299	+	3	0	-2	2657
P01009-1#7	0	1	1	P01009-1	37	38	+	1	P01009-1	0	418	ENST00000437397.5	381	1635	++	89	P01009-1#7	0	3	ENST00000437397.5	492	495	+	3	0	-2	2658
P01009-1#7	0	1	1	P01009-1	37	38	+	1	P01009-1	0	418	ENST00000404814.8	311	1565	++	67	P01009-1#7	0	3	ENST00000404814.8	422	425	+	3	0	-2	2659
P01009-1#7	0	1	1	P01009-1	37	38	+	1	P01009-1	0	355	ENST00000402629.1	34	1099	++	66	P01009-1#7	0	3	ENST00000402629.1	145	148	+	3	0	-2	2660
P01009-1#7	0	1	1	P01009-1	37	38	+	1	P01009-1	0	418	ENST00000393088.8	555	1809	++	62	P01009-1#7	0	3	ENST00000393088.8	666	669	+	3	0	-2	2661
P01009-1#7	0	1	1	P01009-1	37	38	+	1	P01009-1	0	418	ENST00000393087.9	47	1301	++	61	P01009-1#7	0	3	ENST00000393087.9	158	161	+	3	0	-2	2662
P01009-1#7	0	1	1	P01009-1	37	38	+	1	P01009-1	0	418	ENST00000355814.8	277	1531	++	37	P01009-1#7	0	3	ENST00000355814.8	388	391	+	3	0	-2	2663
P01009-1#8	0	1	1	P01009-1	255	256	+	1	P01009-1	0	418	ENST00000636712.1	152	1406	++	227	P01009-1#8	0	3	ENST00000636712.1	917	920	+	3	0	-2	2664
P01009-1#8	0	1	1	P01009-1	255	256	+	1	P01009-1	0	306	ENST00000489769.1	9	927	++	120	P01009-1#8	0	3	ENST00000489769.1	774	777	+	3	0	-2	2665
P01009-1#8	0	1	1	P01009-1	255	256	+	1	P01009-1	0	418	ENST00000449399.7	302	1556	++	100	P01009-1#8	0	3	ENST00000449399.7	1067	1070	+	3	0	-2	2666
P01009-1#8	0	1	1	P01009-1	255	256	+	1	P01009-1	0	418	ENST00000448921.5	573	1827	++	98	P01009-1#8	0	3	ENST00000448921.5	1338	1341	+	3	0	-2	2667
P01009-1#8	0	1	1	P01009-1	255	256	+	1	P01009-1	0	418	ENST00000440909.5	185	1439	++	91	P01009-1#8	0	3	ENST00000440909.5	950	953	+	3	0	-2	2668
P01009-1#8	0	1	1	P01009-1	255	256	+	1	P01009-1	0	418	ENST00000437397.5	381	1635	++	89	P01009-1#8	0	3	ENST00000437397.5	1146	1149	+	3	0	-2	2669
P01009-1#8	0	1	1	P01009-1	255	256	+	1	P01009-1	0	418	ENST00000404814.8	311	1565	++	67	P01009-1#8	0	3	ENST00000404814.8	1076	1079	+	3	0	-2	2670
P01009-1#8	0	1	1	P01009-1	255	256	+	1	P01009-1	0	355	ENST00000402629.1	34	1099	++	66	P01009-1#8	0	3	ENST00000402629.1	799	802	+	3	0	-2	2671
P01009-1#8	0	1	1	P01009-1	255	256	+	1	P01009-1	0	418	ENST00000393088.8	555	1809	++	62	P01009-1#8	0	3	ENST00000393088.8	1320	1323	+	3	0	-2	2672
P01009-1#8	0	1	1	P01009-1	255	256	+	1	P01009-1	0	418	ENST00000393087.9	47	1301	++	61	P01009-1#8	0	3	ENST00000393087.9	812	815	+	3	0	-2	2673
P01009-1#8	0	1	1	P01009-1	255	256	+	1	P01009-1	0	418	ENST00000355814.8	277	1531	++	37	P01009-1#8	0	3	ENST00000355814.8	1042	1045	+	3	0	-2	2674
P01009-1#9	0	1	1	P01009-1	382	383	+	1	P01009-1	0	418	ENST00000636712.1	152	1406	++	227	P01009-1#9	0	3	ENST00000636712.1	1298	1301	+	3	0	-2	2675
P01009-1#9	0	1	1	P01009-1	382	383	+	1	P01009-1	0	418	ENST00000449399.7	302	1556	++	100	P01009-1#9	0	3	ENST00000449399.7	1448	1451	+	3	0	-2	2676
P01009-1#9	0	1	1	P01009-1	382	383	+	1	P01009-1	0	418	ENST00000448921.5	573	1827	++	98	P01009-1#9	0	3	ENST00000448921.5	1719	1722	+	3	0	-2	2677
P01009-1#9	0	1	1	P01009-1	382	383	+	1	P01009-1	0	418	ENST00000440909.5	185	1439	++	91	P01009-1#9	0	3	ENST00000440909.5	1331	1334	+	3	0	-2	2678
P01009-1#9	0	1	1	P01009-1	382	383	+	1	P01009-1	0	418	ENST00000437397.5	381	1635	++	89	P01009-1#9	0	3	ENST00000437397.5	1527	1530	+	3	0	-2	2679
P01009-1#9	0	1	1	P01009-1	382	383	+	1	P01009-1	0	418	ENST00000404814.8	311	1565	++	67	P01009-1#9	0	3	ENST00000404814.8	1457	1460	+	3	0	-2	2680
P01009-1#9	0	1	1	P01009-1	382	383	+	1	P01009-1	0	418	ENST00000393088.8	555	1809	++	62	P01009-1#9	0	3	ENST00000393088.8	1701	1704	+	3	0	-2	2681
P01009-1#9	0	1	1	P01009-1	382	383	+	1	P01009-1	0	418	ENST00000393087.9	47	1301	++	61	P01009-1#9	0	3	ENST00000393087.9	1193	1196	+	3	0	-2	2682
P01009-1#9	0	1	1	P01009-1	382	383	+	1	P01009-1	0	418	ENST00000355814.8	277	1531	++	37	P01009-1#9	0	3	ENST00000355814.8	1423	1426	+	3	0	-2	2683
P01009-1#10	0	1	1	P01009-1	69	70	+	1	P01009-1	0	418	ENST00000636712.1	152	1406	++	227	P01009-1#10	0	3	ENST00000636712.1	359	362	+	3	0	-2	2684
P01009-1#10	0	1	1	P01009-1	69	70	+	1	P01009-1	0	144	ENST00000557492.5	517	949	++	169	P01009-1#10	0	3	ENST00000557492.5	724	727	+	3	0	-2	2685
P01009-1#10	0	1	1	P01009-1	69	70	+	1	P01009-1	0	117	ENST00000556955.5	220	571	++	167	P01009-1#10	0	3	ENST00000556955.5	427	430	+	3	0	-2	2686
P01009-1#10	0	1	1	P01009-1	69	70	+	1	P01009-1	0	156	ENST00000556091.1	174	642	++	166	P01009-1#10	0	3	ENST00000556091.1	381	384	+	3	0	-2	2687
P01009-1#10	0	1	1	P01009-1	69	70	+	1	P01009-1	0	92	ENST00000553327.5	303	579	++	164	P01009-1#10	0	3	ENST00000553327.5	510	513	+	3	0	-2	2688
P01009-1#10	0	1	1	P01009-1	69	70	+	1	P01009-1	0	306	ENST00000489769.1	9	927	++	120	P01009-1#10	0	3	ENST00000489769.1	216	219	+	3	0	-2	2689
P01009-1#10	0	1	1	P01009-1	69	70	+	1	P01009-1	0	418	ENST00000449399.7	302	1556	++	100	P01009-1#10	0	3	ENST00000449399.7	509	512	+	3	0	-2	2690
P01009-1#10	0	1	1	P01009-1	69	70	+	1	P01009-1	0	418	ENST00000448921.5	573	1827	++	98	P01009-1#10	0	3	ENST00000448921.5	780	783	+	3	0	-2	2691
P01009-1#10	0	1	1	P01009-1	69	70	+	1	P01009-1	0	418	ENST00000440909.5	185	1439	++	91	P01009-1#10	0	3	ENST00000440909.5	392	395	+	3	0	-2	2692
P01009-1#10	0	1	1	P01009-1	69	70	+	1	P01009-1	0	418	ENST00000437397.5	381	1635	++	89	P01009-1#10	0	3	ENST00000437397.5	588	591	+	3	0	-2	2693
P01009-1#10	0	1	1	P01009-1	69	70	+	1	P01009-1	0	418	ENST00000404814.8	311	1565	++	67	P01009-1#10	0	3	ENST00000404814.8	518	521	+	3	0	-2	2694
P01009-1#10	0	1	1	P01009-1	69	70	+	1	P01009-1	0	355	ENST00000402629.1	34	1099	++	66	P01009-1#10	0	3	ENST00000402629.1	241	244	+	3	0	-2	2695
P01009-1#10	0	1	1	P01009-1	69	70	+	1	P01009-1	0	418	ENST00000393088.8	555	1809	++	62	P01009-1#10	0	3	ENST00000393088.8	762	765	+	3	0	-2	2696
P01009-1#10	0	1	1	P01009-1	69	70	+	1	P01009-1	0	418	ENST00000393087.9	47	1301	++	61	P01009-1#10	0	3	ENST00000393087.9	254	257	+	3	0	-2	2697
P01009-1#10	0	1	1	P01009-1	69	70	+	1	P01009-1	0	418	ENST00000355814.8	277	1531	++	37	P01009-1#10	0	3	ENST00000355814.8	484	487	+	3	0	-2	2698
P01009-1#11	0	1	1	P01009-1	106	107	+	1	P01009-1	0	418	ENST00000636712.1	152	1406	++	227	P01009-1#11	0	3	ENST00000636712.1	470	473	+	3	0	-2	2699
P01009-1#11	0	1	1	P01009-1	106	107	+	1	P01009-1	0	144	ENST00000557492.5	517	949	++	169	P01009-1#11	0	3	ENST00000557492.5	835	838	+	3	0	-2	2700
P01009-1#11	0	1	1	P01009-1	106	107	+	1	P01009-1	0	117	ENST00000556955.5	220	571	++	167	P01009-1#11	0	3	ENST00000556955.5	538	541	+	3	0	-2	2701
P01009-1#11	0	1	1	P01009-1	106	107	+	1	P01009-1	0	156	ENST00000556091.1	174	642	++	166	P01009-1#11	0	3	ENST00000556091.1	492	495	+	3	0	-2	2702
P01009-1#11	0	1	1	P01009-1	106	107	+	1	P01009-1	86	191	ENST00000554720.1	129	444	++	165	P01009-1#11	0	3	ENST00000554720.1	189	192	+	3	0	-2	2703
P01009-1#11	0	1	1	P01009-1	106	107	+	1	P01009-1	0	306	ENST00000489769.1	9	927	++	120	P01009-1#11	0	3	ENST00000489769.1	327	330	+	3	0	-2	2704
P01009-1#11	0	1	1	P01009-1	106	107	+	1	P01009-1	0	418	ENST00000449399.7	302	1556	++	100	P01009-1#11	0	3	ENST00000449399.7	620	623	+	3	0	-2	2705
P01009-1#11	0	1	1	P01009-1	106	107	+	1	P01009-1	0	418	ENST00000448921.5	573	1827	++	98	P01009-1#11	0	3	ENST00000448921.5	891	894	+	3	0	-2	2706
P01009-1#11	0	1	1	P01009-1	106	107	+	1	P01009-1	0	418	ENST00000440909.5	185	1439	++	91	P01009-1#11	0	3	ENST00000440909.5	503	506	+	3	0	-2	2707
P01009-1#11	0	1	1	P01009-1	106	107	+	1	P01009-1	0	418	ENST00000437397.5	381	1635	++	89	P01009-1#11	0	3	ENST00000437397.5	699	702	+	3	0	-2	2708
P01009-1#11	0	1	1	P01009-1	106	107	+	1	P01009-1	0	418	ENST00000404814.8	311	1565	++	67	P01009-1#11	0	3	ENST00000404814.8	629	632	+	3	0	-2	2709
P01009-1#11	0	1	1	P01009-1	106	107	+	1	P01009-1	0	355	ENST00000402629.1	34	1099	++	66	P01009-1#11	0	3	ENST00000402629.1	352	355	+	3	0	-2	2710
P01009-1#11	0	1	1	P01009-1	106	107	+	1	P01009-1	0	418	ENST00000393088.8	555	1809	++	62	P01009-1#11	0	3	ENST00000393088.8	873	876	+	3	0	-2	2711
P01009-1#11	0	1	1	P01009-1	106	107	+	1	P01009-1	0	418	ENST00000393087.9	47	1301	++	61	P01009-1#11	0	3	ENST00000393087.9	365	368	+	3	0	-2	2712
P01009-1#11	0	1	1	P01009-1	106	107	+	1	P01009-1	0	418	ENST00000355814.8	277	1531	++	37	P01009-1#11	0	3	ENST00000355814.8	595	598	+	3	0	-2	2713
P01009-1#12	0	1	1	P01009-1	270	271	+	1	P01009-1	0	418	ENST00000636712.1	152	1406	++	227	P01009-1#12	0	3	ENST00000636712.1	962	965	+	3	0	-2	2714
P01009-1#12	0	1	1	P01009-1	270	271	+	1	P01009-1	0	306	ENST00000489769.1	9	927	++	120	P01009-1#12	0	3	ENST00000489769.1	819	822	+	3	0	-2	2715
P01009-1#12	0	1	1	P01009-1	270	271	+	1	P01009-1	0	418	ENST00000449399.7	302	1556	++	100	P01009-1#12	0	3	ENST00000449399.7	1112	1115	+	3	0	-2	2716
P01009-1#12	0	1	1	P01009-1	270	271	+	1	P01009-1	0	418	ENST00000448921.5	573	1827	++	98	P01009-1#12	0	3	ENST00000448921.5	1383	1386	+	3	0	-2	2717
P01009-1#12	0	1	1	P01009-1	270	271	+	1	P01009-1	0	418	ENST00000440909.5	185	1439	++	91	P01009-1#12	0	3	ENST00000440909.5	995	998	+	3	0	-2	2718
P01009-1#12	0	1	1	P01009-1	270	271	+	1	P01009-1	0	418	ENST00000437397.5	381	1635	++	89	P01009-1#12	0	3	ENST00000437397.5	1191	1194	+	3	0	-2	2719
P01009-1#12	0	1	1	P01009-1	270	271	+	1	P01009-1	0	418	ENST00000404814.8	311	1565	++	67	P01009-1#12	0	3	ENST00000404814.8	1121	1124	+	3	0	-2	2720
P01009-1#12	0	1	1	P01009-1	270	271	+	1	P01009-1	0	355	ENST00000402629.1	34	1099	++	66	P01009-1#12	0	3	ENST00000402629.1	844	847	+	3	0	-2	2721
P01009-1#12	0	1	1	P01009-1	270	271	+	1	P01009-1	0	418	ENST00000393088.8	555	1809	++	62	P01009-1#12	0	3	ENST00000393088.8	1365	1368	+	3	0	-2	2722
P01009-1#12	0	1	1	P01009-1	270	271	+	1	P01009-1	0	418	ENST00000393087.9	47	1301	++	61	P01009-1#12	0	3	ENST00000393087.9	857	860	+	3	0	-2	2723
P01009-1#12	0	1	1	P01009-1	270	271	+	1	P01009-1	0	418	ENST00000355814.8	277	1531	++	37	P01009-1#12	0	3	ENST00000355814.8	1087	1090	+	3	0	-2	2724
P01009-1#13	0	112	112	P01009-1	306	418	+	112	P01009-1	0	418	ENST00000636712.1	152	1406	++	227	P01009-1#13	0	336	ENST00000636712.1	1070	1406	+	336	0	-224	2725
P01009-1#13	0	112	112	P01009-1	306	418	+	112	P01009-1	0	418	ENST00000449399.7	302	1556	++	100	P01009-1#13	0	336	ENST00000449399.7	1220	1556	+	336	0	-224	2726
P01009-1#13	0	112	112	P01009-1	306	418	+	112	P01009-1	0	418	ENST00000448921.5	573	1827	++	98	P01009-1#13	0	336	ENST00000448921.5	1491	1827	+	336	0	-224	2727
P01009-1#13	0	112	112	P01009-1	306	418	+	112	P01009-1	0	418	ENST00000440909.5	185	1439	++	91	P01009-1#13	0	336	ENST00000440909.5	1103	1439	+	336	0	-224	2728
P01009-1#13	0	112	112	P01009-1	306	418	+	112	P01009-1	0	418	ENST00000437397.5	381	1635	++	89	P01009-1#13	0	336	ENST00000437397.5	1299	1635	+	336	0	-224	2729
P01009-1#13	0	112	112	P01009-1	306	418	+	112	P01009-1	0	418	ENST00000404814.8	311	1565	++	67	P01009-1#13	0	336	ENST00000404814.8	1229	1565	+	336	0	-224	2730
P01009-1#13	0	112	112	P01009-1	306	418	+	112	P01009-1	0	355	ENST00000402629.1	34	1099	++	66	P01009-1#13	0	147	ENST00000402629.1	952	1099	+	147	0	-35	2731
P01009-1#13	0	112	112	P01009-1	306	418	+	112	P01009-1	0	418	ENST00000393088.8	555	1809	++	62	P01009-1#13	0	336	ENST00000393088.8	1473	1809	+	336	0	-224	2732
P01009-1#13	0	112	112	P01009-1	306	418	+	112	P01009-1	0	418	ENST00000393087.9	47	1301	++	61	P01009-1#13	0	336	ENST00000393087.9	965	1301	+	336	0	-224	2733
P01009-1#13	0	112	112	P01009-1	306	418	+	112	P01009-1	0	418	ENST00000355814.8	277	1531	++	37	P01009-1#13	0	336	ENST00000355814.8	1195	1531	+	336	0	-224	2734
P01009-1#14	0	63	63	P01009-1	355	418	+	63	P01009-1	0	418	ENST00000636712.1	152	1406	++	227	P01009-1#14	0	189	ENST00000636712.1	1217	1406	+	189	0	-126	2735
P01009-1#14	0	63	63	P01009-1	355	418	+	63	P01009-1	0	418	ENST00000449399.7	302	1556	++	100	P01009-1#14	0	189	ENST00000449399.7	1367	1556	+	189	0	-126	2736
P01009-1#14	0	63	63	P01009-1	355	418	+	63	P01009-1	0	418	ENST00000448921.5	573	1827	++	98	P01009-1#14	0	189	ENST00000448921.5	1638	1827	+	189	0	-126	2737
P01009-1#14	0	63	63	P01009-1	355	418	+	63	P01009-1	0	418	ENST00000440909.5	185	1439	++	91	P01009-1#14	0	189	ENST00000440909.5	1250	1439	+	189	0	-126	2738
P01009-1#14	0	63	63	P01009-1	355	418	+	63	P01009-1	0	418	ENST00000437397.5	381	1635	++	89	P01009-1#14	0	189	ENST00000437397.5	1446	1635	+	189	0	-126	2739
P01009-1#14	0	63	63	P01009-1	355	418	+	63	P01009-1	0	418	ENST00000404814.8	311	1565	++	67	P01009-1#14	0	189	ENST00000404814.8	1376	1565	+	189	0	-126	2740
P01009-1#14	0	63	63	P01009-1	355	418	+	63	P01009-1	0	418	ENST00000393088.8	555	1809	++	62	P01009-1#14	0	189	ENST00000393088.8	1620	1809	+	189	0	-126	2741
P01009-1#14	0	63	63	P01009-1	355	418	+	63	P01009-1	0	418	ENST00000393087.9	47	1301	++	61	P01009-1#14	0	189	ENST00000393087.9	1112	1301	+	189	0	-126	2742
P01009-1#14	0	63	63	P01009-1	355	418	+	63	P01009-1	0	418	ENST00000355814.8	277	1531	++	37	P01009-1#14	0	189	ENST00000355814.8	1342	1531	+	189	0	-126	2743
P01009-1#15	0	1	1	P01009-1	3	4	+	1	P01009-1	0	418	ENST00000636712.1	152	1406	++	227	P01009-1#15	0	3	ENST00000636712.1	161	164	+	3	0	-2	2744
P01009-1#15	0	1	1	P01009-1	3	4	+	1	P01009-1	0	144	ENST00000557492.5	517	949	++	169	P01009-1#15	0	3	ENST00000557492.5	526	529	+	3	0	-2	2745
P01009-1#15	0	1	1	P01009-1	3	4	+	1	P01009-1	0	22	ENST00000557118.5	516	582	++	168	P01009-1#15	0	3	ENST00000557118.5	525	528	+	3	0	-2	2746
P01009-1#15	0	1	1	P01009-1	3	4	+	1	P01009-1	0	117	ENST00000556955.5	220	571	++	167	P01009-1#15	0	3	ENST00000556955.5	229	232	+	3	0	-2	2747
P01009-1#15	0	1	1	P01009-1	3	4	+	1	P01009-1	0	156	ENST00000556091.1	174	642	++	166	P01009-1#15	0	3	ENST00000556091.1	183	186	+	3	0	-2	2748
P01009-1#15	0	1	1	P01009-1	3	4	+	1	P01009-1	0	92	ENST00000553327.5	303	579	++	164	P01009-1#15	0	3	ENST00000553327.5	312	315	+	3	0	-2	2749
P01009-1#15	0	1	1	P01009-1	3	4	+	1	P01009-1	0	306	ENST00000489769.1	9	927	++	120	P01009-1#15	0	3	ENST00000489769.1	18	21	+	3	0	-2	2750
P01009-1#15	0	1	1	P01009-1	3	4	+	1	P01009-1	0	418	ENST00000449399.7	302	1556	++	100	P01009-1#15	0	3	ENST00000449399.7	311	314	+	3	0	-2	2751
P01009-1#15	0	1	1	P01009-1	3	4	+	1	P01009-1	0	418	ENST00000448921.5	573	1827	++	98	P01009-1#15	0	3	ENST00000448921.5	582	585	+	3	0	-2	2752
P01009-1#15	0	1	1	P01009-1	3	4	+	1	P01009-1	0	418	ENST00000440909.5	185	1439	++	91	P01009-1#15	0	3	ENST00000440909.5	194	197	+	3	0	-2	2753
P01009-1#15	0	1	1	P01009-1	3	4	+	1	P01009-1	0	418	ENST00000437397.5	381	1635	++	89	P01009-1#15	0	3	ENST00000437397.5	390	393	+	3	0	-2	2754
P01009-1#15	0	1	1	P01009-1	3	4	+	1	P01009-1	0	418	ENST00000404814.8	311	1565	++	67	P01009-1#15	0	3	ENST00000404814.8	320	323	+	3	0	-2	2755
P01009-1#15	0	1	1	P01009-1	3	4	+	1	P01009-1	0	355	ENST00000402629.1	34	1099	++	66	P01009-1#15	0	3	ENST00000402629.1	43	46	+	3	0	-2	2756
P01009-1#15	0	1	1	P01009-1	3	4	+	1	P01009-1	0	418	ENST00000393088.8	555	1809	++	62	P01009-1#15	0	3	ENST00000393088.8	564	567	+	3	0	-2	2757
P01009-1#15	0	1	1	P01009-1	3	4	+	1	P01009-1	0	418	ENST00000393087.9	47	1301	++	61	P01009-1#15	0	3	ENST00000393087.9	56	59	+	3	0	-2	2758
P01009-1#15	0	1	1	P01009-1	3	4	+	1	P01009-1	0	418	ENST00000355814.8	277	1531	++	37	P01009-1#15	0	3	ENST00000355814.8	286	289	+	3	0	-2	2759
P01009-1#16	0	1	1	P01009-1	25	26	+	1	P01009-1	0	418	ENST00000636712.1	152	1406	++	227	P01009-1#16	0	3	ENST00000636712.1	227	230	+	3	0	-2	2760
P01009-1#16	0	1	1	P01009-1	25	26	+	1	P01009-1	0	144	ENST00000557492.5	517	949	++	169	P01009-1#16	0	3	ENST00000557492.5	592	595	+	3	0	-2	2761
P01009-1#16	0	1	1	P01009-1	25	26	+	1	P01009-1	0	117	ENST00000556955.5	220	571	++	167	P01009-1#16	0	3	ENST00000556955.5	295	298	+	3	0	-2	2762
P01009-1#16	0	1	1	P01009-1	25	26	+	1	P01009-1	0	156	ENST00000556091.1	174	642	++	166	P01009-1#16	0	3	ENST00000556091.1	249	252	+	3	0	-2	2763
P01009-1#16	0	1	1	P01009-1	25	26	+	1	P01009-1	0	92	ENST00000553327.5	303	579	++	164	P01009-1#16	0	3	ENST00000553327.5	378	381	+	3	0	-2	2764
P01009-1#16	0	1	1	P01009-1	25	26	+	1	P01009-1	0	306	ENST00000489769.1	9	927	++	120	P01009-1#16	0	3	ENST00000489769.1	84	87	+	3	0	-2	2765
P01009-1#16	0	1	1	P01009-1	25	26	+	1	P01009-1	0	418	ENST00000449399.7	302	1556	++	100	P01009-1#16	0	3	ENST00000449399.7	377	380	+	3	0	-2	2766
P01009-1#16	0	1	1	P01009-1	25	26	+	1	P01009-1	0	418	ENST00000448921.5	573	1827	++	98	P01009-1#16	0	3	ENST00000448921.5	648	651	+	3	0	-2	2767
P01009-1#16	0	1	1	P01009-1	25	26	+	1	P01009-1	0	418	ENST00000440909.5	185	1439	++	91	P01009-1#16	0	3	ENST00000440909.5	260	263	+	3	0	-2	2768
P01009-1#16	0	1	1	P01009-1	25	26	+	1	P01009-1	0	418	ENST00000437397.5	381	1635	++	89	P01009-1#16	0	3	ENST00000437397.5	456	459	+	3	0	-2	2769
P01009-1#16	0	1	1	P01009-1	25	26	+	1	P01009-1	0	418	ENST00000404814.8	311	1565	++	67	P01009-1#16	0	3	ENST00000404814.8	386	389	+	3	0	-2	2770
P01009-1#16	0	1	1	P01009-1	25	26	+	1	P01009-1	0	355	ENST00000402629.1	34	1099	++	66	P01009-1#16	0	3	ENST00000402629.1	109	112	+	3	0	-2	2771
P01009-1#16	0	1	1	P01009-1	25	26	+	1	P01009-1	0	418	ENST00000393088.8	555	1809	++	62	P01009-1#16	0	3	ENST00000393088.8	630	633	+	3	0	-2	2772
P01009-1#16	0	1	1	P01009-1	25	26	+	1	P01009-1	0	418	ENST00000393087.9	47	1301	++	61	P01009-1#16	0	3	ENST00000393087.9	122	125	+	3	0	-2	2773
P01009-1#16	0	1	1	P01009-1	25	26	+	1	P01009-1	0	418	ENST00000355814.8	277	1531	++	37	P01009-1#16	0	3	ENST00000355814.8	352	355	+	3	0	-2	2774
P01009-1#17	0	1	1	P01009-1	36	37	+	1	P01009-1	0	418	ENST00000636712.1	152	1406	++	227	P01009-1#17	0	3	ENST00000636712.1	260	263	+	3	0	-2	2775
P01009-1#17	0	1	1	P01009-1	36	37	+	1	P01009-1	0	144	ENST00000557492.5	517	949	++	169	P01009-1#17	0	3	ENST00000557492.5	625	628	+	3	0	-2	2776
P01009-1#17	0	1	1	P01009-1	36	37	+	1	P01009-1	0	117	ENST00000556955.5	220	571	++	167	P01009-1#17	0	3	ENST00000556955.5	328	331	+	3	0	-2	2777
P01009-1#17	0	1	1	P01009-1	36	37	+	1	P01009-1	0	156	ENST00000556091.1	174	642	++	166	P01009-1#17	0	3	ENST00000556091.1	282	285	+	3	0	-2	2778
P01009-1#17	0	1	1	P01009-1	36	37	+	1	P01009-1	0	92	ENST00000553327.5	303	579	++	164	P01009-1#17	0	3	ENST00000553327.5	411	414	+	3	0	-2	2779
P01009-1#17	0	1	1	P01009-1	36	37	+	1	P01009-1	0	306	ENST00000489769.1	9	927	++	120	P01009-1#17	0	3	ENST00000489769.1	117	120	+	3	0	-2	2780
P01009-1#17	0	1	1	P01009-1	36	37	+	1	P01009-1	0	418	ENST00000449399.7	302	1556	++	100	P01009-1#17	0	3	ENST00000449399.7	410	413	+	3	0	-2	2781
P01009-1#17	0	1	1	P01009-1	36	37	+	1	P01009-1	0	418	ENST00000448921.5	573	1827	++	98	P01009-1#17	0	3	ENST00000448921.5	681	684	+	3	0	-2	2782
P01009-1#17	0	1	1	P01009-1	36	37	+	1	P01009-1	0	418	ENST00000440909.5	185	1439	++	91	P01009-1#17	0	3	ENST00000440909.5	293	296	+	3	0	-2	2783
P01009-1#17	0	1	1	P01009-1	36	37	+	1	P01009-1	0	418	ENST00000437397.5	381	1635	++	89	P01009-1#17	0	3	ENST00000437397.5	489	492	+	3	0	-2	2784
P01009-1#17	0	1	1	P01009-1	36	37	+	1	P01009-1	0	418	ENST00000404814.8	311	1565	++	67	P01009-1#17	0	3	ENST00000404814.8	419	422	+	3	0	-2	2785
P01009-1#17	0	1	1	P01009-1	36	37	+	1	P01009-1	0	355	ENST00000402629.1	34	1099	++	66	P01009-1#17	0	3	ENST00000402629.1	142	145	+	3	0	-2	2786
P01009-1#17	0	1	1	P01009-1	36	37	+	1	P01009-1	0	418	ENST00000393088.8	555	1809	++	62	P01009-1#17	0	3	ENST00000393088.8	663	666	+	3	0	-2	2787
P01009-1#17	0	1	1	P01009-1	36	37	+	1	P01009-1	0	418	ENST00000393087.9	47	1301	++	61	P01009-1#17	0	3	ENST00000393087.9	155	158	+	3	0	-2	2788
P01009-1#17	0	1	1	P01009-1	36	37	+	1	P01009-1	0	418	ENST00000355814.8	277	1531	++	37	P01009-1#17	0	3	ENST00000355814.8	385	388	+	3	0	-2	2789
P01009-1#18	0	1	1	P01009-1	57	58	+	1	P01009-1	0	418	ENST00000636712.1	152	1406	++	227	P01009-1#18	0	3	ENST00000636712.1	323	326	+	3	0	-2	2790
P01009-1#18	0	1	1	P01009-1	57	58	+	1	P01009-1	0	144	ENST00000557492.5	517	949	++	169	P01009-1#18	0	3	ENST00000557492.5	688	691	+	3	0	-2	2791
P01009-1#18	0	1	1	P01009-1	57	58	+	1	P01009-1	0	117	ENST00000556955.5	220	571	++	167	P01009-1#18	0	3	ENST00000556955.5	391	394	+	3	0	-2	2792
P01009-1#18	0	1	1	P01009-1	57	58	+	1	P01009-1	0	156	ENST00000556091.1	174	642	++	166	P01009-1#18	0	3	ENST00000556091.1	345	348	+	3	0	-2	2793
P01009-1#18	0	1	1	P01009-1	57	58	+	1	P01009-1	0	92	ENST00000553327.5	303	579	++	164	P01009-1#18	0	3	ENST00000553327.5	474	477	+	3	0	-2	2794
P01009-1#18	0	1	1	P01009-1	57	58	+	1	P01009-1	0	306	ENST00000489769.1	9	927	++	120	P01009-1#18	0	3	ENST00000489769.1	180	183	+	3	0	-2	2795
P01009-1#18	0	1	1	P01009-1	57	58	+	1	P01009-1	0	418	ENST00000449399.7	302	1556	++	100	P01009-1#18	0	3	ENST00000449399.7	473	476	+	3	0	-2	2796
P01009-1#18	0	1	1	P01009-1	57	58	+	1	P01009-1	0	418	ENST00000448921.5	573	1827	++	98	P01009-1#18	0	3	ENST00000448921.5	744	747	+	3	0	-2	2797
P01009-1#18	0	1	1	P01009-1	57	58	+	1	P01009-1	0	418	ENST00000440909.5	185	1439	++	91	P01009-1#18	0	3	ENST00000440909.5	356	359	+	3	0	-2	2798
P01009-1#18	0	1	1	P01009-1	57	58	+	1	P01009-1	0	418	ENST00000437397.5	381	1635	++	89	P01009-1#18	0	3	ENST00000437397.5	552	555	+	3	0	-2	2799
P01009-1#18	0	1	1	P01009-1	57	58	+	1	P01009-1	0	418	ENST00000404814.8	311	1565	++	67	P01009-1#18	0	3	ENST00000404814.8	482	485	+	3	0	-2	2800
P01009-1#18	0	1	1	P01009-1	57	58	+	1	P01009-1	0	355	ENST00000402629.1	34	1099	++	66	P01009-1#18	0	3	ENST00000402629.1	205	208	+	3	0	-2	2801
P01009-1#18	0	1	1	P01009-1	57	58	+	1	P01009-1	0	418	ENST00000393088.8	555	1809	++	62	P01009-1#18	0	3	ENST00000393088.8	726	729	+	3	0	-2	2802
P01009-1#18	0	1	1	P01009-1	57	58	+	1	P01009-1	0	418	ENST00000393087.9	47	1301	++	61	P01009-1#18	0	3	ENST00000393087.9	218	221	+	3	0	-2	2803
P01009-1#18	0	1	1	P01009-1	57	58	+	1	P01009-1	0	418	ENST00000355814.8	277	1531	++	37	P01009-1#18	0	3	ENST00000355814.8	448	451	+	3	0	-2	2804
P01009-1#19	0	1	1	P01009-1	62	63	+	1	P01009-1	0	418	ENST00000636712.1	152	1406	++	227	P01009-1#19	0	3	ENST00000636712.1	338	341	+	3	0	-2	2805
P01009-1#19	0	1	1	P01009-1	62	63	+	1	P01009-1	0	144	ENST00000557492.5	517	949	++	169	P01009-1#19	0	3	ENST00000557492.5	703	706	+	3	0	-2	2806
P01009-1#19	0	1	1	P01009-1	62	63	+	1	P01009-1	0	117	ENST00000556955.5	220	571	++	167	P01009-1#19	0	3	ENST00000556955.5	406	409	+	3	0	-2	2807
P01009-1#19	0	1	1	P01009-1	62	63	+	1	P01009-1	0	156	ENST00000556091.1	174	642	++	166	P01009-1#19	0	3	ENST00000556091.1	360	363	+	3	0	-2	2808
P01009-1#19	0	1	1	P01009-1	62	63	+	1	P01009-1	0	92	ENST00000553327.5	303	579	++	164	P01009-1#19	0	3	ENST00000553327.5	489	492	+	3	0	-2	2809
P01009-1#19	0	1	1	P01009-1	62	63	+	1	P01009-1	0	306	ENST00000489769.1	9	927	++	120	P01009-1#19	0	3	ENST00000489769.1	195	198	+	3	0	-2	2810
P01009-1#19	0	1	1	P01009-1	62	63	+	1	P01009-1	0	418	ENST00000449399.7	302	1556	++	100	P01009-1#19	0	3	ENST00000449399.7	488	491	+	3	0	-2	2811
P01009-1#19	0	1	1	P01009-1	62	63	+	1	P01009-1	0	418	ENST00000448921.5	573	1827	++	98	P01009-1#19	0	3	ENST00000448921.5	759	762	+	3	0	-2	2812
P01009-1#19	0	1	1	P01009-1	62	63	+	1	P01009-1	0	418	ENST00000440909.5	185	1439	++	91	P01009-1#19	0	3	ENST00000440909.5	371	374	+	3	0	-2	2813
P01009-1#19	0	1	1	P01009-1	62	63	+	1	P01009-1	0	418	ENST00000437397.5	381	1635	++	89	P01009-1#19	0	3	ENST00000437397.5	567	570	+	3	0	-2	2814
P01009-1#19	0	1	1	P01009-1	62	63	+	1	P01009-1	0	418	ENST00000404814.8	311	1565	++	67	P01009-1#19	0	3	ENST00000404814.8	497	500	+	3	0	-2	2815
P01009-1#19	0	1	1	P01009-1	62	63	+	1	P01009-1	0	355	ENST00000402629.1	34	1099	++	66	P01009-1#19	0	3	ENST00000402629.1	220	223	+	3	0	-2	2816
P01009-1#19	0	1	1	P01009-1	62	63	+	1	P01009-1	0	418	ENST00000393088.8	555	1809	++	62	P01009-1#19	0	3	ENST00000393088.8	741	744	+	3	0	-2	2817
P01009-1#19	0	1	1	P01009-1	62	63	+	1	P01009-1	0	418	ENST00000393087.9	47	1301	++	61	P01009-1#19	0	3	ENST00000393087.9	233	236	+	3	0	-2	2818
P01009-1#19	0	1	1	P01009-1	62	63	+	1	P01009-1	0	418	ENST00000355814.8	277	1531	++	37	P01009-1#19	0	3	ENST00000355814.8	463	466	+	3	0	-2	2819
P01009-1#20	0	1	1	P01009-1	64	65	+	1	P01009-1	0	418	ENST00000636712.1	152	1406	++	227	P01009-1#20	0	3	ENST00000636712.1	344	347	+	3	0	-2	2820
P01009-1#20	0	1	1	P01009-1	64	65	+	1	P01009-1	0	144	ENST00000557492.5	517	949	++	169	P01009-1#20	0	3	ENST00000557492.5	709	712	+	3	0	-2	2821
P01009-1#20	0	1	1	P01009-1	64	65	+	1	P01009-1	0	117	ENST00000556955.5	220	571	++	167	P01009-1#20	0	3	ENST00000556955.5	412	415	+	3	0	-2	2822
P01009-1#20	0	1	1	P01009-1	64	65	+	1	P01009-1	0	156	ENST00000556091.1	174	642	++	166	P01009-1#20	0	3	ENST00000556091.1	366	369	+	3	0	-2	2823
P01009-1#20	0	1	1	P01009-1	64	65	+	1	P01009-1	0	92	ENST00000553327.5	303	579	++	164	P01009-1#20	0	3	ENST00000553327.5	495	498	+	3	0	-2	2824
P01009-1#20	0	1	1	P01009-1	64	65	+	1	P01009-1	0	306	ENST00000489769.1	9	927	++	120	P01009-1#20	0	3	ENST00000489769.1	201	204	+	3	0	-2	2825
P01009-1#20	0	1	1	P01009-1	64	65	+	1	P01009-1	0	418	ENST00000449399.7	302	1556	++	100	P01009-1#20	0	3	ENST00000449399.7	494	497	+	3	0	-2	2826
P01009-1#20	0	1	1	P01009-1	64	65	+	1	P01009-1	0	418	ENST00000448921.5	573	1827	++	98	P01009-1#20	0	3	ENST00000448921.5	765	768	+	3	0	-2	2827
P01009-1#20	0	1	1	P01009-1	64	65	+	1	P01009-1	0	418	ENST00000440909.5	185	1439	++	91	P01009-1#20	0	3	ENST00000440909.5	377	380	+	3	0	-2	2828
P01009-1#20	0	1	1	P01009-1	64	65	+	1	P01009-1	0	418	ENST00000437397.5	381	1635	++	89	P01009-1#20	0	3	ENST00000437397.5	573	576	+	3	0	-2	2829
P01009-1#20	0	1	1	P01009-1	64	65	+	1	P01009-1	0	418	ENST00000404814.8	311	1565	++	67	P01009-1#20	0	3	ENST00000404814.8	503	506	+	3	0	-2	2830
P01009-1#20	0	1	1	P01009-1	64	65	+	1	P01009-1	0	355	ENST00000402629.1	34	1099	++	66	P01009-1#20	0	3	ENST00000402629.1	226	229	+	3	0	-2	2831
P01009-1#20	0	1	1	P01009-1	64	65	+	1	P01009-1	0	418	ENST00000393088.8	555	1809	++	62	P01009-1#20	0	3	ENST00000393088.8	747	750	+	3	0	-2	2832
P01009-1#20	0	1	1	P01009-1	64	65	+	1	P01009-1	0	418	ENST00000393087.9	47	1301	++	61	P01009-1#20	0	3	ENST00000393087.9	239	242	+	3	0	-2	2833
P01009-1#20	0	1	1	P01009-1	64	65	+	1	P01009-1	0	418	ENST00000355814.8	277	1531	++	37	P01009-1#20	0	3	ENST00000355814.8	469	472	+	3	0	-2	2834
P01009-1#21	0	1	1	P01009-1	68	69	+	1	P01009-1	0	418	ENST00000636712.1	152	1406	++	227	P01009-1#21	0	3	ENST00000636712.1	356	359	+	3	0	-2	2835
P01009-1#21	0	1	1	P01009-1	68	69	+	1	P01009-1	0	144	ENST00000557492.5	517	949	++	169	P01009-1#21	0	3	ENST00000557492.5	721	724	+	3	0	-2	2836
P01009-1#21	0	1	1	P01009-1	68	69	+	1	P01009-1	0	117	ENST00000556955.5	220	571	++	167	P01009-1#21	0	3	ENST00000556955.5	424	427	+	3	0	-2	2837
P01009-1#21	0	1	1	P01009-1	68	69	+	1	P01009-1	0	156	ENST00000556091.1	174	642	++	166	P01009-1#21	0	3	ENST00000556091.1	378	381	+	3	0	-2	2838
P01009-1#21	0	1	1	P01009-1	68	69	+	1	P01009-1	0	92	ENST00000553327.5	303	579	++	164	P01009-1#21	0	3	ENST00000553327.5	507	510	+	3	0	-2	2839
P01009-1#21	0	1	1	P01009-1	68	69	+	1	P01009-1	0	306	ENST00000489769.1	9	927	++	120	P01009-1#21	0	3	ENST00000489769.1	213	216	+	3	0	-2	2840
P01009-1#21	0	1	1	P01009-1	68	69	+	1	P01009-1	0	418	ENST00000449399.7	302	1556	++	100	P01009-1#21	0	3	ENST00000449399.7	506	509	+	3	0	-2	2841
P01009-1#21	0	1	1	P01009-1	68	69	+	1	P01009-1	0	418	ENST00000448921.5	573	1827	++	98	P01009-1#21	0	3	ENST00000448921.5	777	780	+	3	0	-2	2842
P01009-1#21	0	1	1	P01009-1	68	69	+	1	P01009-1	0	418	ENST00000440909.5	185	1439	++	91	P01009-1#21	0	3	ENST00000440909.5	389	392	+	3	0	-2	2843
P01009-1#21	0	1	1	P01009-1	68	69	+	1	P01009-1	0	418	ENST00000437397.5	381	1635	++	89	P01009-1#21	0	3	ENST00000437397.5	585	588	+	3	0	-2	2844
P01009-1#21	0	1	1	P01009-1	68	69	+	1	P01009-1	0	418	ENST00000404814.8	311	1565	++	67	P01009-1#21	0	3	ENST00000404814.8	515	518	+	3	0	-2	2845
P01009-1#21	0	1	1	P01009-1	68	69	+	1	P01009-1	0	355	ENST00000402629.1	34	1099	++	66	P01009-1#21	0	3	ENST00000402629.1	238	241	+	3	0	-2	2846
P01009-1#21	0	1	1	P01009-1	68	69	+	1	P01009-1	0	418	ENST00000393088.8	555	1809	++	62	P01009-1#21	0	3	ENST00000393088.8	759	762	+	3	0	-2	2847
P01009-1#21	0	1	1	P01009-1	68	69	+	1	P01009-1	0	418	ENST00000393087.9	47	1301	++	61	P01009-1#21	0	3	ENST00000393087.9	251	254	+	3	0	-2	2848
P01009-1#21	0	1	1	P01009-1	68	69	+	1	P01009-1	0	418	ENST00000355814.8	277	1531	++	37	P01009-1#21	0	3	ENST00000355814.8	481	484	+	3	0	-2	2849
P01009-1#22	0	1	1	P01009-1	74	75	+	1	P01009-1	0	418	ENST00000636712.1	152	1406	++	227	P01009-1#22	0	3	ENST00000636712.1	374	377	+	3	0	-2	2850
P01009-1#22	0	1	1	P01009-1	74	75	+	1	P01009-1	0	144	ENST00000557492.5	517	949	++	169	P01009-1#22	0	3	ENST00000557492.5	739	742	+	3	0	-2	2851
P01009-1#22	0	1	1	P01009-1	74	75	+	1	P01009-1	0	117	ENST00000556955.5	220	571	++	167	P01009-1#22	0	3	ENST00000556955.5	442	445	+	3	0	-2	2852
P01009-1#22	0	1	1	P01009-1	74	75	+	1	P01009-1	0	156	ENST00000556091.1	174	642	++	166	P01009-1#22	0	3	ENST00000556091.1	396	399	+	3	0	-2	2853
P01009-1#22	0	1	1	P01009-1	74	75	+	1	P01009-1	0	92	ENST00000553327.5	303	579	++	164	P01009-1#22	0	3	ENST00000553327.5	525	528	+	3	0	-2	2854
P01009-1#22	0	1	1	P01009-1	74	75	+	1	P01009-1	0	306	ENST00000489769.1	9	927	++	120	P01009-1#22	0	3	ENST00000489769.1	231	234	+	3	0	-2	2855
P01009-1#22	0	1	1	P01009-1	74	75	+	1	P01009-1	0	418	ENST00000449399.7	302	1556	++	100	P01009-1#22	0	3	ENST00000449399.7	524	527	+	3	0	-2	2856
P01009-1#22	0	1	1	P01009-1	74	75	+	1	P01009-1	0	418	ENST00000448921.5	573	1827	++	98	P01009-1#22	0	3	ENST00000448921.5	795	798	+	3	0	-2	2857
P01009-1#22	0	1	1	P01009-1	74	75	+	1	P01009-1	0	418	ENST00000440909.5	185	1439	++	91	P01009-1#22	0	3	ENST00000440909.5	407	410	+	3	0	-2	2858
P01009-1#22	0	1	1	P01009-1	74	75	+	1	P01009-1	0	418	ENST00000437397.5	381	1635	++	89	P01009-1#22	0	3	ENST00000437397.5	603	606	+	3	0	-2	2859
P01009-1#22	0	1	1	P01009-1	74	75	+	1	P01009-1	0	418	ENST00000404814.8	311	1565	++	67	P01009-1#22	0	3	ENST00000404814.8	533	536	+	3	0	-2	2860
P01009-1#22	0	1	1	P01009-1	74	75	+	1	P01009-1	0	355	ENST00000402629.1	34	1099	++	66	P01009-1#22	0	3	ENST00000402629.1	256	259	+	3	0	-2	2861
P01009-1#22	0	1	1	P01009-1	74	75	+	1	P01009-1	0	418	ENST00000393088.8	555	1809	++	62	P01009-1#22	0	3	ENST00000393088.8	777	780	+	3	0	-2	2862
P01009-1#22	0	1	1	P01009-1	74	75	+	1	P01009-1	0	418	ENST00000393087.9	47	1301	++	61	P01009-1#22	0	3	ENST00000393087.9	269	272	+	3	0	-2	2863
P01009-1#22	0	1	1	P01009-1	74	75	+	1	P01009-1	0	418	ENST00000355814.8	277	1531	++	37	P01009-1#22	0	3	ENST00000355814.8	499	502	+	3	0	-2	2864
P01009-1#23	0	1	1	P01009-1	76	77	+	1	P01009-1	0	418	ENST00000636712.1	152	1406	++	227	P01009-1#23	0	3	ENST00000636712.1	380	383	+	3	0	-2	2865
P01009-1#23	0	1	1	P01009-1	76	77	+	1	P01009-1	0	144	ENST00000557492.5	517	949	++	169	P01009-1#23	0	3	ENST00000557492.5	745	748	+	3	0	-2	2866
P01009-1#23	0	1	1	P01009-1	76	77	+	1	P01009-1	0	117	ENST00000556955.5	220	571	++	167	P01009-1#23	0	3	ENST00000556955.5	448	451	+	3	0	-2	2867
P01009-1#23	0	1	1	P01009-1	76	77	+	1	P01009-1	0	156	ENST00000556091.1	174	642	++	166	P01009-1#23	0	3	ENST00000556091.1	402	405	+	3	0	-2	2868
P01009-1#23	0	1	1	P01009-1	76	77	+	1	P01009-1	0	92	ENST00000553327.5	303	579	++	164	P01009-1#23	0	3	ENST00000553327.5	531	534	+	3	0	-2	2869
P01009-1#23	0	1	1	P01009-1	76	77	+	1	P01009-1	0	306	ENST00000489769.1	9	927	++	120	P01009-1#23	0	3	ENST00000489769.1	237	240	+	3	0	-2	2870
P01009-1#23	0	1	1	P01009-1	76	77	+	1	P01009-1	0	418	ENST00000449399.7	302	1556	++	100	P01009-1#23	0	3	ENST00000449399.7	530	533	+	3	0	-2	2871
P01009-1#23	0	1	1	P01009-1	76	77	+	1	P01009-1	0	418	ENST00000448921.5	573	1827	++	98	P01009-1#23	0	3	ENST00000448921.5	801	804	+	3	0	-2	2872
P01009-1#23	0	1	1	P01009-1	76	77	+	1	P01009-1	0	418	ENST00000440909.5	185	1439	++	91	P01009-1#23	0	3	ENST00000440909.5	413	416	+	3	0	-2	2873
P01009-1#23	0	1	1	P01009-1	76	77	+	1	P01009-1	0	418	ENST00000437397.5	381	1635	++	89	P01009-1#23	0	3	ENST00000437397.5	609	612	+	3	0	-2	2874
P01009-1#23	0	1	1	P01009-1	76	77	+	1	P01009-1	0	418	ENST00000404814.8	311	1565	++	67	P01009-1#23	0	3	ENST00000404814.8	539	542	+	3	0	-2	2875
P01009-1#23	0	1	1	P01009-1	76	77	+	1	P01009-1	0	355	ENST00000402629.1	34	1099	++	66	P01009-1#23	0	3	ENST00000402629.1	262	265	+	3	0	-2	2876
P01009-1#23	0	1	1	P01009-1	76	77	+	1	P01009-1	0	418	ENST00000393088.8	555	1809	++	62	P01009-1#23	0	3	ENST00000393088.8	783	786	+	3	0	-2	2877
P01009-1#23	0	1	1	P01009-1	76	77	+	1	P01009-1	0	418	ENST00000393087.9	47	1301	++	61	P01009-1#23	0	3	ENST00000393087.9	275	278	+	3	0	-2	2878
P01009-1#23	0	1	1	P01009-1	76	77	+	1	P01009-1	0	418	ENST00000355814.8	277	1531	++	37	P01009-1#23	0	3	ENST00000355814.8	505	508	+	3	0	-2	2879
P01009-1#24	0	1	1	P01009-1	83	84	+	1	P01009-1	0	418	ENST00000636712.1	152	1406	++	227	P01009-1#24	0	3	ENST00000636712.1	401	404	+	3	0	-2	2880
P01009-1#24	0	1	1	P01009-1	83	84	+	1	P01009-1	0	144	ENST00000557492.5	517	949	++	169	P01009-1#24	0	3	ENST00000557492.5	766	769	+	3	0	-2	2881
P01009-1#24	0	1	1	P01009-1	83	84	+	1	P01009-1	0	117	ENST00000556955.5	220	571	++	167	P01009-1#24	0	3	ENST00000556955.5	469	472	+	3	0	-2	2882
P01009-1#24	0	1	1	P01009-1	83	84	+	1	P01009-1	0	156	ENST00000556091.1	174	642	++	166	P01009-1#24	0	3	ENST00000556091.1	423	426	+	3	0	-2	2883
P01009-1#24	0	1	1	P01009-1	83	84	+	1	P01009-1	0	92	ENST00000553327.5	303	579	++	164	P01009-1#24	0	3	ENST00000553327.5	552	555	+	3	0	-2	2884
P01009-1#24	0	1	1	P01009-1	83	84	+	1	P01009-1	0	306	ENST00000489769.1	9	927	++	120	P01009-1#24	0	3	ENST00000489769.1	258	261	+	3	0	-2	2885
P01009-1#24	0	1	1	P01009-1	83	84	+	1	P01009-1	0	418	ENST00000449399.7	302	1556	++	100	P01009-1#24	0	3	ENST00000449399.7	551	554	+	3	0	-2	2886
P01009-1#24	0	1	1	P01009-1	83	84	+	1	P01009-1	0	418	ENST00000448921.5	573	1827	++	98	P01009-1#24	0	3	ENST00000448921.5	822	825	+	3	0	-2	2887
P01009-1#24	0	1	1	P01009-1	83	84	+	1	P01009-1	0	418	ENST00000440909.5	185	1439	++	91	P01009-1#24	0	3	ENST00000440909.5	434	437	+	3	0	-2	2888
P01009-1#24	0	1	1	P01009-1	83	84	+	1	P01009-1	0	418	ENST00000437397.5	381	1635	++	89	P01009-1#24	0	3	ENST00000437397.5	630	633	+	3	0	-2	2889
P01009-1#24	0	1	1	P01009-1	83	84	+	1	P01009-1	0	418	ENST00000404814.8	311	1565	++	67	P01009-1#24	0	3	ENST00000404814.8	560	563	+	3	0	-2	2890
P01009-1#24	0	1	1	P01009-1	83	84	+	1	P01009-1	0	355	ENST00000402629.1	34	1099	++	66	P01009-1#24	0	3	ENST00000402629.1	283	286	+	3	0	-2	2891
P01009-1#24	0	1	1	P01009-1	83	84	+	1	P01009-1	0	418	ENST00000393088.8	555	1809	++	62	P01009-1#24	0	3	ENST00000393088.8	804	807	+	3	0	-2	2892
P01009-1#24	0	1	1	P01009-1	83	84	+	1	P01009-1	0	418	ENST00000393087.9	47	1301	++	61	P01009-1#24	0	3	ENST00000393087.9	296	299	+	3	0	-2	2893
P01009-1#24	0	1	1	P01009-1	83	84	+	1	P01009-1	0	418	ENST00000355814.8	277	1531	++	37	P01009-1#24	0	3	ENST00000355814.8	526	529	+	3	0	-2	2894
P01009-1#25	0	1	1	P01009-1	90	91	+	1	P01009-1	0	418	ENST00000636712.1	152	1406	++	227	P01009-1#25	0	3	ENST00000636712.1	422	425	+	3	0	-2	2895
P01009-1#25	0	1	1	P01009-1	90	91	+	1	P01009-1	0	144	ENST00000557492.5	517	949	++	169	P01009-1#25	0	3	ENST00000557492.5	787	790	+	3	0	-2	2896
P01009-1#25	0	1	1	P01009-1	90	91	+	1	P01009-1	0	117	ENST00000556955.5	220	571	++	167	P01009-1#25	0	3	ENST00000556955.5	490	493	+	3	0	-2	2897
P01009-1#25	0	1	1	P01009-1	90	91	+	1	P01009-1	0	156	ENST00000556091.1	174	642	++	166	P01009-1#25	0	3	ENST00000556091.1	444	447	+	3	0	-2	2898
P01009-1#25	0	1	1	P01009-1	90	91	+	1	P01009-1	86	191	ENST00000554720.1	129	444	++	165	P01009-1#25	0	3	ENST00000554720.1	141	144	+	3	0	-2	2899
P01009-1#25	0	1	1	P01009-1	90	91	+	1	P01009-1	0	92	ENST00000553327.5	303	579	++	164	P01009-1#25	0	3	ENST00000553327.5	573	576	+	3	0	-2	2900
P01009-1#25	0	1	1	P01009-1	90	91	+	1	P01009-1	0	306	ENST00000489769.1	9	927	++	120	P01009-1#25	0	3	ENST00000489769.1	279	282	+	3	0	-2	2901
P01009-1#25	0	1	1	P01009-1	90	91	+	1	P01009-1	0	418	ENST00000449399.7	302	1556	++	100	P01009-1#25	0	3	ENST00000449399.7	572	575	+	3	0	-2	2902
P01009-1#25	0	1	1	P01009-1	90	91	+	1	P01009-1	0	418	ENST00000448921.5	573	1827	++	98	P01009-1#25	0	3	ENST00000448921.5	843	846	+	3	0	-2	2903
P01009-1#25	0	1	1	P01009-1	90	91	+	1	P01009-1	0	418	ENST00000440909.5	185	1439	++	91	P01009-1#25	0	3	ENST00000440909.5	455	458	+	3	0	-2	2904
P01009-1#25	0	1	1	P01009-1	90	91	+	1	P01009-1	0	418	ENST00000437397.5	381	1635	++	89	P01009-1#25	0	3	ENST00000437397.5	651	654	+	3	0	-2	2905
P01009-1#25	0	1	1	P01009-1	90	91	+	1	P01009-1	0	418	ENST00000404814.8	311	1565	++	67	P01009-1#25	0	3	ENST00000404814.8	581	584	+	3	0	-2	2906
P01009-1#25	0	1	1	P01009-1	90	91	+	1	P01009-1	0	355	ENST00000402629.1	34	1099	++	66	P01009-1#25	0	3	ENST00000402629.1	304	307	+	3	0	-2	2907
P01009-1#25	0	1	1	P01009-1	90	91	+	1	P01009-1	0	418	ENST00000393088.8	555	1809	++	62	P01009-1#25	0	3	ENST00000393088.8	825	828	+	3	0	-2	2908
P01009-1#25	0	1	1	P01009-1	90	91	+	1	P01009-1	0	418	ENST00000393087.9	47	1301	++	61	P01009-1#25	0	3	ENST00000393087.9	317	320	+	3	0	-2	2909
P01009-1#25	0	1	1	P01009-1	90	91	+	1	P01009-1	0	418	ENST00000355814.8	277	1531	++	37	P01009-1#25	0	3	ENST00000355814.8	547	550	+	3	0	-2	2910
P01009-1#26	0	1	1	P01009-1	91	92	+	1	P01009-1	0	418	ENST00000636712.1	152	1406	++	227	P01009-1#26	0	3	ENST00000636712.1	425	428	+	3	0	-2	2911
P01009-1#26	0	1	1	P01009-1	91	92	+	1	P01009-1	0	144	ENST00000557492.5	517	949	++	169	P01009-1#26	0	3	ENST00000557492.5	790	793	+	3	0	-2	2912
P01009-1#26	0	1	1	P01009-1	91	92	+	1	P01009-1	0	117	ENST00000556955.5	220	571	++	167	P01009-1#26	0	3	ENST00000556955.5	493	496	+	3	0	-2	2913
P01009-1#26	0	1	1	P01009-1	91	92	+	1	P01009-1	0	156	ENST00000556091.1	174	642	++	166	P01009-1#26	0	3	ENST00000556091.1	447	450	+	3	0	-2	2914
P01009-1#26	0	1	1	P01009-1	91	92	+	1	P01009-1	86	191	ENST00000554720.1	129	444	++	165	P01009-1#26	0	3	ENST00000554720.1	144	147	+	3	0	-2	2915
P01009-1#26	0	1	1	P01009-1	91	92	+	1	P01009-1	0	92	ENST00000553327.5	303	579	++	164	P01009-1#26	0	3	ENST00000553327.5	576	579	+	3	0	-2	2916
P01009-1#26	0	1	1	P01009-1	91	92	+	1	P01009-1	0	306	ENST00000489769.1	9	927	++	120	P01009-1#26	0	3	ENST00000489769.1	282	285	+	3	0	-2	2917
P01009-1#26	0	1	1	P01009-1	91	92	+	1	P01009-1	0	418	ENST00000449399.7	302	1556	++	100	P01009-1#26	0	3	ENST00000449399.7	575	578	+	3	0	-2	2918
P01009-1#26	0	1	1	P01009-1	91	92	+	1	P01009-1	0	418	ENST00000448921.5	573	1827	++	98	P01009-1#26	0	3	ENST00000448921.5	846	849	+	3	0	-2	2919
P01009-1#26	0	1	1	P01009-1	91	92	+	1	P01009-1	0	418	ENST00000440909.5	185	1439	++	91	P01009-1#26	0	3	ENST00000440909.5	458	461	+	3	0	-2	2920
P01009-1#26	0	1	1	P01009-1	91	92	+	1	P01009-1	0	418	ENST00000437397.5	381	1635	++	89	P01009-1#26	0	3	ENST00000437397.5	654	657	+	3	0	-2	2921
P01009-1#26	0	1	1	P01009-1	91	92	+	1	P01009-1	0	418	ENST00000404814.8	311	1565	++	67	P01009-1#26	0	3	ENST00000404814.8	584	587	+	3	0	-2	2922
P01009-1#26	0	1	1	P01009-1	91	92	+	1	P01009-1	0	355	ENST00000402629.1	34	1099	++	66	P01009-1#26	0	3	ENST00000402629.1	307	310	+	3	0	-2	2923
P01009-1#26	0	1	1	P01009-1	91	92	+	1	P01009-1	0	418	ENST00000393088.8	555	1809	++	62	P01009-1#26	0	3	ENST00000393088.8	828	831	+	3	0	-2	2924
P01009-1#26	0	1	1	P01009-1	91	92	+	1	P01009-1	0	418	ENST00000393087.9	47	1301	++	61	P01009-1#26	0	3	ENST00000393087.9	320	323	+	3	0	-2	2925
P01009-1#26	0	1	1	P01009-1	91	92	+	1	P01009-1	0	418	ENST00000355814.8	277	1531	++	37	P01009-1#26	0	3	ENST00000355814.8	550	553	+	3	0	-2	2926
P01009-1#27	0	1	1	P01009-1	108	109	+	1	P01009-1	0	418	ENST00000636712.1	152	1406	++	227	P01009-1#27	0	3	ENST00000636712.1	476	479	+	3	0	-2	2927
P01009-1#27	0	1	1	P01009-1	108	109	+	1	P01009-1	0	144	ENST00000557492.5	517	949	++	169	P01009-1#27	0	3	ENST00000557492.5	841	844	+	3	0	-2	2928
P01009-1#27	0	1	1	P01009-1	108	109	+	1	P01009-1	0	117	ENST00000556955.5	220	571	++	167	P01009-1#27	0	3	ENST00000556955.5	544	547	+	3	0	-2	2929
P01009-1#27	0	1	1	P01009-1	108	109	+	1	P01009-1	0	156	ENST00000556091.1	174	642	++	166	P01009-1#27	0	3	ENST00000556091.1	498	501	+	3	0	-2	2930
P01009-1#27	0	1	1	P01009-1	108	109	+	1	P01009-1	86	191	ENST00000554720.1	129	444	++	165	P01009-1#27	0	3	ENST00000554720.1	195	198	+	3	0	-2	2931
P01009-1#27	0	1	1	P01009-1	108	109	+	1	P01009-1	0	306	ENST00000489769.1	9	927	++	120	P01009-1#27	0	3	ENST00000489769.1	333	336	+	3	0	-2	2932
P01009-1#27	0	1	1	P01009-1	108	109	+	1	P01009-1	0	418	ENST00000449399.7	302	1556	++	100	P01009-1#27	0	3	ENST00000449399.7	626	629	+	3	0	-2	2933
P01009-1#27	0	1	1	P01009-1	108	109	+	1	P01009-1	0	418	ENST00000448921.5	573	1827	++	98	P01009-1#27	0	3	ENST00000448921.5	897	900	+	3	0	-2	2934
P01009-1#27	0	1	1	P01009-1	108	109	+	1	P01009-1	0	418	ENST00000440909.5	185	1439	++	91	P01009-1#27	0	3	ENST00000440909.5	509	512	+	3	0	-2	2935
P01009-1#27	0	1	1	P01009-1	108	109	+	1	P01009-1	0	418	ENST00000437397.5	381	1635	++	89	P01009-1#27	0	3	ENST00000437397.5	705	708	+	3	0	-2	2936
P01009-1#27	0	1	1	P01009-1	108	109	+	1	P01009-1	0	418	ENST00000404814.8	311	1565	++	67	P01009-1#27	0	3	ENST00000404814.8	635	638	+	3	0	-2	2937
P01009-1#27	0	1	1	P01009-1	108	109	+	1	P01009-1	0	355	ENST00000402629.1	34	1099	++	66	P01009-1#27	0	3	ENST00000402629.1	358	361	+	3	0	-2	2938
P01009-1#27	0	1	1	P01009-1	108	109	+	1	P01009-1	0	418	ENST00000393088.8	555	1809	++	62	P01009-1#27	0	3	ENST00000393088.8	879	882	+	3	0	-2	2939
P01009-1#27	0	1	1	P01009-1	108	109	+	1	P01009-1	0	418	ENST00000393087.9	47	1301	++	61	P01009-1#27	0	3	ENST00000393087.9	371	374	+	3	0	-2	2940
P01009-1#27	0	1	1	P01009-1	108	109	+	1	P01009-1	0	418	ENST00000355814.8	277	1531	++	37	P01009-1#27	0	3	ENST00000355814.8	601	604	+	3	0	-2	2941
P01009-1#28	0	1	1	P01009-1	111	112	+	1	P01009-1	0	418	ENST00000636712.1	152	1406	++	227	P01009-1#28	0	3	ENST00000636712.1	485	488	+	3	0	-2	2942
P01009-1#28	0	1	1	P01009-1	111	112	+	1	P01009-1	0	144	ENST00000557492.5	517	949	++	169	P01009-1#28	0	3	ENST00000557492.5	850	853	+	3	0	-2	2943
P01009-1#28	0	1	1	P01009-1	111	112	+	1	P01009-1	0	117	ENST00000556955.5	220	571	++	167	P01009-1#28	0	3	ENST00000556955.5	553	556	+	3	0	-2	2944
P01009-1#28	0	1	1	P01009-1	111	112	+	1	P01009-1	0	156	ENST00000556091.1	174	642	++	166	P01009-1#28	0	3	ENST00000556091.1	507	510	+	3	0	-2	2945
P01009-1#28	0	1	1	P01009-1	111	112	+	1	P01009-1	86	191	ENST00000554720.1	129	444	++	165	P01009-1#28	0	3	ENST00000554720.1	204	207	+	3	0	-2	2946
P01009-1#28	0	1	1	P01009-1	111	112	+	1	P01009-1	0	306	ENST00000489769.1	9	927	++	120	P01009-1#28	0	3	ENST00000489769.1	342	345	+	3	0	-2	2947
P01009-1#28	0	1	1	P01009-1	111	112	+	1	P01009-1	0	418	ENST00000449399.7	302	1556	++	100	P01009-1#28	0	3	ENST00000449399.7	635	638	+	3	0	-2	2948
P01009-1#28	0	1	1	P01009-1	111	112	+	1	P01009-1	0	418	ENST00000448921.5	573	1827	++	98	P01009-1#28	0	3	ENST00000448921.5	906	909	+	3	0	-2	2949
P01009-1#28	0	1	1	P01009-1	111	112	+	1	P01009-1	0	418	ENST00000440909.5	185	1439	++	91	P01009-1#28	0	3	ENST00000440909.5	518	521	+	3	0	-2	2950
P01009-1#28	0	1	1	P01009-1	111	112	+	1	P01009-1	0	418	ENST00000437397.5	381	1635	++	89	P01009-1#28	0	3	ENST00000437397.5	714	717	+	3	0	-2	2951
P01009-1#28	0	1	1	P01009-1	111	112	+	1	P01009-1	0	418	ENST00000404814.8	311	1565	++	67	P01009-1#28	0	3	ENST00000404814.8	644	647	+	3	0	-2	2952
P01009-1#28	0	1	1	P01009-1	111	112	+	1	P01009-1	0	355	ENST00000402629.1	34	1099	++	66	P01009-1#28	0	3	ENST00000402629.1	367	370	+	3	0	-2	2953
P01009-1#28	0	1	1	P01009-1	111	112	+	1	P01009-1	0	418	ENST00000393088.8	555	1809	++	62	P01009-1#28	0	3	ENST00000393088.8	888	891	+	3	0	-2	2954
P01009-1#28	0	1	1	P01009-1	111	112	+	1	P01009-1	0	418	ENST00000393087.9	47	1301	++	61	P01009-1#28	0	3	ENST00000393087.9	380	383	+	3	0	-2	2955
P01009-1#28	0	1	1	P01009-1	111	112	+	1	P01009-1	0	418	ENST00000355814.8	277	1531	++	37	P01009-1#28	0	3	ENST00000355814.8	610	613	+	3	0	-2	2956
P01009-1#29	0	1	1	P01009-1	115	116	+	1	P01009-1	0	418	ENST00000636712.1	152	1406	++	227	P01009-1#29	0	3	ENST00000636712.1	497	500	+	3	0	-2	2957
P01009-1#29	0	1	1	P01009-1	115	116	+	1	P01009-1	0	144	ENST00000557492.5	517	949	++	169	P01009-1#29	0	3	ENST00000557492.5	862	865	+	3	0	-2	2958
P01009-1#29	0	1	1	P01009-1	115	116	+	1	P01009-1	0	117	ENST00000556955.5	220	571	++	167	P01009-1#29	0	3	ENST00000556955.5	565	568	+	3	0	-2	2959
P01009-1#29	0	1	1	P01009-1	115	116	+	1	P01009-1	0	156	ENST00000556091.1	174	642	++	166	P01009-1#29	0	3	ENST00000556091.1	519	522	+	3	0	-2	2960
P01009-1#29	0	1	1	P01009-1	115	116	+	1	P01009-1	86	191	ENST00000554720.1	129	444	++	165	P01009-1#29	0	3	ENST00000554720.1	216	219	+	3	0	-2	2961
P01009-1#29	0	1	1	P01009-1	115	116	+	1	P01009-1	0	306	ENST00000489769.1	9	927	++	120	P01009-1#29	0	3	ENST00000489769.1	354	357	+	3	0	-2	2962
P01009-1#29	0	1	1	P01009-1	115	116	+	1	P01009-1	0	418	ENST00000449399.7	302	1556	++	100	P01009-1#29	0	3	ENST00000449399.7	647	650	+	3	0	-2	2963
P01009-1#29	0	1	1	P01009-1	115	116	+	1	P01009-1	0	418	ENST00000448921.5	573	1827	++	98	P01009-1#29	0	3	ENST00000448921.5	918	921	+	3	0	-2	2964
P01009-1#29	0	1	1	P01009-1	115	116	+	1	P01009-1	0	418	ENST00000440909.5	185	1439	++	91	P01009-1#29	0	3	ENST00000440909.5	530	533	+	3	0	-2	2965
P01009-1#29	0	1	1	P01009-1	115	116	+	1	P01009-1	0	418	ENST00000437397.5	381	1635	++	89	P01009-1#29	0	3	ENST00000437397.5	726	729	+	3	0	-2	2966
P01009-1#29	0	1	1	P01009-1	115	116	+	1	P01009-1	0	418	ENST00000404814.8	311	1565	++	67	P01009-1#29	0	3	ENST00000404814.8	656	659	+	3	0	-2	2967
P01009-1#29	0	1	1	P01009-1	115	116	+	1	P01009-1	0	355	ENST00000402629.1	34	1099	++	66	P01009-1#29	0	3	ENST00000402629.1	379	382	+	3	0	-2	2968
P01009-1#29	0	1	1	P01009-1	115	116	+	1	P01009-1	0	418	ENST00000393088.8	555	1809	++	62	P01009-1#29	0	3	ENST00000393088.8	900	903	+	3	0	-2	2969
P01009-1#29	0	1	1	P01009-1	115	116	+	1	P01009-1	0	418	ENST00000393087.9	47	1301	++	61	P01009-1#29	0	3	ENST00000393087.9	392	395	+	3	0	-2	2970
P01009-1#29	0	1	1	P01009-1	115	116	+	1	P01009-1	0	418	ENST00000355814.8	277	1531	++	37	P01009-1#29	0	3	ENST00000355814.8	622	625	+	3	0	-2	2971
P01009-1#30	0	1	1	P01009-1	124	125	+	1	P01009-1	0	418	ENST00000636712.1	152	1406	++	227	P01009-1#30	0	3	ENST00000636712.1	524	527	+	3	0	-2	2972
P01009-1#30	0	1	1	P01009-1	124	125	+	1	P01009-1	0	144	ENST00000557492.5	517	949	++	169	P01009-1#30	0	3	ENST00000557492.5	889	892	+	3	0	-2	2973
P01009-1#30	0	1	1	P01009-1	124	125	+	1	P01009-1	0	156	ENST00000556091.1	174	642	++	166	P01009-1#30	0	3	ENST00000556091.1	546	549	+	3	0	-2	2974
P01009-1#30	0	1	1	P01009-1	124	125	+	1	P01009-1	86	191	ENST00000554720.1	129	444	++	165	P01009-1#30	0	3	ENST00000554720.1	243	246	+	3	0	-2	2975
P01009-1#30	0	1	1	P01009-1	124	125	+	1	P01009-1	0	306	ENST00000489769.1	9	927	++	120	P01009-1#30	0	3	ENST00000489769.1	381	384	+	3	0	-2	2976
P01009-1#30	0	1	1	P01009-1	124	125	+	1	P01009-1	0	418	ENST00000449399.7	302	1556	++	100	P01009-1#30	0	3	ENST00000449399.7	674	677	+	3	0	-2	2977
P01009-1#30	0	1	1	P01009-1	124	125	+	1	P01009-1	0	418	ENST00000448921.5	573	1827	++	98	P01009-1#30	0	3	ENST00000448921.5	945	948	+	3	0	-2	2978
P01009-1#30	0	1	1	P01009-1	124	125	+	1	P01009-1	0	418	ENST00000440909.5	185	1439	++	91	P01009-1#30	0	3	ENST00000440909.5	557	560	+	3	0	-2	2979
P01009-1#30	0	1	1	P01009-1	124	125	+	1	P01009-1	0	418	ENST00000437397.5	381	1635	++	89	P01009-1#30	0	3	ENST00000437397.5	753	756	+	3	0	-2	2980
P01009-1#30	0	1	1	P01009-1	124	125	+	1	P01009-1	0	418	ENST00000404814.8	311	1565	++	67	P01009-1#30	0	3	ENST00000404814.8	683	686	+	3	0	-2	2981
P01009-1#30	0	1	1	P01009-1	124	125	+	1	P01009-1	0	355	ENST00000402629.1	34	1099	++	66	P01009-1#30	0	3	ENST00000402629.1	406	409	+	3	0	-2	2982
P01009-1#30	0	1	1	P01009-1	124	125	+	1	P01009-1	0	418	ENST00000393088.8	555	1809	++	62	P01009-1#30	0	3	ENST00000393088.8	927	930	+	3	0	-2	2983
P01009-1#30	0	1	1	P01009-1	124	125	+	1	P01009-1	0	418	ENST00000393087.9	47	1301	++	61	P01009-1#30	0	3	ENST00000393087.9	419	422	+	3	0	-2	2984
P01009-1#30	0	1	1	P01009-1	124	125	+	1	P01009-1	0	418	ENST00000355814.8	277	1531	++	37	P01009-1#30	0	3	ENST00000355814.8	649	652	+	3	0	-2	2985
P01009-1#31	0	1	1	P01009-1	138	139	+	1	P01009-1	0	418	ENST00000636712.1	152	1406	++	227	P01009-1#31	0	3	ENST00000636712.1	566	569	+	3	0	-2	2986
P01009-1#31	0	1	1	P01009-1	138	139	+	1	P01009-1	0	144	ENST00000557492.5	517	949	++	169	P01009-1#31	0	3	ENST00000557492.5	931	934	+	3	0	-2	2987
P01009-1#31	0	1	1	P01009-1	138	139	+	1	P01009-1	0	156	ENST00000556091.1	174	642	++	166	P01009-1#31	0	3	ENST00000556091.1	588	591	+	3	0	-2	2988
P01009-1#31	0	1	1	P01009-1	138	139	+	1	P01009-1	86	191	ENST00000554720.1	129	444	++	165	P01009-1#31	0	3	ENST00000554720.1	285	288	+	3	0	-2	2989
P01009-1#31	0	1	1	P01009-1	138	139	+	1	P01009-1	0	306	ENST00000489769.1	9	927	++	120	P01009-1#31	0	3	ENST00000489769.1	423	426	+	3	0	-2	2990
P01009-1#31	0	1	1	P01009-1	138	139	+	1	P01009-1	0	418	ENST00000449399.7	302	1556	++	100	P01009-1#31	0	3	ENST00000449399.7	716	719	+	3	0	-2	2991
P01009-1#31	0	1	1	P01009-1	138	139	+	1	P01009-1	0	418	ENST00000448921.5	573	1827	++	98	P01009-1#31	0	3	ENST00000448921.5	987	990	+	3	0	-2	2992
P01009-1#31	0	1	1	P01009-1	138	139	+	1	P01009-1	0	418	ENST00000440909.5	185	1439	++	91	P01009-1#31	0	3	ENST00000440909.5	599	602	+	3	0	-2	2993
P01009-1#31	0	1	1	P01009-1	138	139	+	1	P01009-1	0	418	ENST00000437397.5	381	1635	++	89	P01009-1#31	0	3	ENST00000437397.5	795	798	+	3	0	-2	2994
P01009-1#31	0	1	1	P01009-1	138	139	+	1	P01009-1	0	418	ENST00000404814.8	311	1565	++	67	P01009-1#31	0	3	ENST00000404814.8	725	728	+	3	0	-2	2995
P01009-1#31	0	1	1	P01009-1	138	139	+	1	P01009-1	0	355	ENST00000402629.1	34	1099	++	66	P01009-1#31	0	3	ENST00000402629.1	448	451	+	3	0	-2	2996
P01009-1#31	0	1	1	P01009-1	138	139	+	1	P01009-1	0	418	ENST00000393088.8	555	1809	++	62	P01009-1#31	0	3	ENST00000393088.8	969	972	+	3	0	-2	2997
P01009-1#31	0	1	1	P01009-1	138	139	+	1	P01009-1	0	418	ENST00000393087.9	47	1301	++	61	P01009-1#31	0	3	ENST00000393087.9	461	464	+	3	0	-2	2998
P01009-1#31	0	1	1	P01009-1	138	139	+	1	P01009-1	0	418	ENST00000355814.8	277	1531	++	37	P01009-1#31	0	3	ENST00000355814.8	691	694	+	3	0	-2	2999
P01009-1#32	0	1	1	P01009-1	171	172	+	1	P01009-1	0	418	ENST00000636712.1	152	1406	++	227	P01009-1#32	0	3	ENST00000636712.1	665	668	+	3	0	-2	3000
P01009-1#32	0	1	1	P01009-1	171	172	+	1	P01009-1	86	191	ENST00000554720.1	129	444	++	165	P01009-1#32	0	3	ENST00000554720.1	384	387	+	3	0	-2	3001
P01009-1#32	0	1	1	P01009-1	171	172	+	1	P01009-1	0	306	ENST00000489769.1	9	927	++	120	P01009-1#32	0	3	ENST00000489769.1	522	525	+	3	0	-2	3002
P01009-1#32	0	1	1	P01009-1	171	172	+	1	P01009-1	0	418	ENST00000449399.7	302	1556	++	100	P01009-1#32	0	3	ENST00000449399.7	815	818	+	3	0	-2	3003
P01009-1#32	0	1	1	P01009-1	171	172	+	1	P01009-1	0	418	ENST00000448921.5	573	1827	++	98	P01009-1#32	0	3	ENST00000448921.5	1086	1089	+	3	0	-2	3004
P01009-1#32	0	1	1	P01009-1	171	172	+	1	P01009-1	0	418	ENST00000440909.5	185	1439	++	91	P01009-1#32	0	3	ENST00000440909.5	698	701	+	3	0	-2	3005
P01009-1#32	0	1	1	P01009-1	171	172	+	1	P01009-1	0	418	ENST00000437397.5	381	1635	++	89	P01009-1#32	0	3	ENST00000437397.5	894	897	+	3	0	-2	3006
P01009-1#32	0	1	1	P01009-1	171	172	+	1	P01009-1	0	418	ENST00000404814.8	311	1565	++	67	P01009-1#32	0	3	ENST00000404814.8	824	827	+	3	0	-2	3007
P01009-1#32	0	1	1	P01009-1	171	172	+	1	P01009-1	0	355	ENST00000402629.1	34	1099	++	66	P01009-1#32	0	3	ENST00000402629.1	547	550	+	3	0	-2	3008
P01009-1#32	0	1	1	P01009-1	171	172	+	1	P01009-1	0	418	ENST00000393088.8	555	1809	++	62	P01009-1#32	0	3	ENST00000393088.8	1068	1071	+	3	0	-2	3009
P01009-1#32	0	1	1	P01009-1	171	172	+	1	P01009-1	0	418	ENST00000393087.9	47	1301	++	61	P01009-1#32	0	3	ENST00000393087.9	560	563	+	3	0	-2	3010
P01009-1#32	0	1	1	P01009-1	171	172	+	1	P01009-1	0	418	ENST00000355814.8	277	1531	++	37	P01009-1#32	0	3	ENST00000355814.8	790	793	+	3	0	-2	3011
P01009-1#33	0	1	1	P01009-1	171	172	+	1	P01009-1	0	418	ENST00000636712.1	152	1406	++	227	P01009-1#33	0	3	ENST00000636712.1	665	668	+	3	0	-2	3012
P01009-1#33	0	1	1	P01009-1	171	172	+	1	P01009-1	86	191	ENST00000554720.1	129	444	++	165	P01009-1#33	0	3	ENST00000554720.1	384	387	+	3	0	-2	3013
P01009-1#33	0	1	1	P01009-1	171	172	+	1	P01009-1	0	306	ENST00000489769.1	9	927	++	120	P01009-1#33	0	3	ENST00000489769.1	522	525	+	3	0	-2	3014
P01009-1#33	0	1	1	P01009-1	171	172	+	1	P01009-1	0	418	ENST00000449399.7	302	1556	++	100	P01009-1#33	0	3	ENST00000449399.7	815	818	+	3	0	-2	3015
P01009-1#33	0	1	1	P01009-1	171	172	+	1	P01009-1	0	418	ENST00000448921.5	573	1827	++	98	P01009-1#33	0	3	ENST00000448921.5	1086	1089	+	3	0	-2	3016
P01009-1#33	0	1	1	P01009-1	171	172	+	1	P01009-1	0	418	ENST00000440909.5	185	1439	++	91	P01009-1#33	0	3	ENST00000440909.5	698	701	+	3	0	-2	3017
P01009-1#33	0	1	1	P01009-1	171	172	+	1	P01009-1	0	418	ENST00000437397.5	381	1635	++	89	P01009-1#33	0	3	ENST00000437397.5	894	897	+	3	0	-2	3018
P01009-1#33	0	1	1	P01009-1	171	172	+	1	P01009-1	0	418	ENST00000404814.8	311	1565	++	67	P01009-1#33	0	3	ENST00000404814.8	824	827	+	3	0	-2	3019
P01009-1#33	0	1	1	P01009-1	171	172	+	1	P01009-1	0	355	ENST00000402629.1	34	1099	++	66	P01009-1#33	0	3	ENST00000402629.1	547	550	+	3	0	-2	3020
P01009-1#33	0	1	1	P01009-1	171	172	+	1	P01009-1	0	418	ENST00000393088.8	555	1809	++	62	P01009-1#33	0	3	ENST00000393088.8	1068	1071	+	3	0	-2	3021
P01009-1#33	0	1	1	P01009-1	171	172	+	1	P01009-1	0	418	ENST00000393087.9	47	1301	++	61	P01009-1#33	0	3	ENST00000393087.9	560	563	+	3	0	-2	3022
P01009-1#33	0	1	1	P01009-1	171	172	+	1	P01009-1	0	418	ENST00000355814.8	277	1531	++	37	P01009-1#33	0	3	ENST00000355814.8	790	793	+	3	0	-2	3023
P01009-1#34	0	1	1	P01009-1	179	180	+	1	P01009-1	0	418	ENST00000636712.1	152	1406	++	227	P01009-1#34	0	3	ENST00000636712.1	689	692	+	3	0	-2	3024
P01009-1#34	0	1	1	P01009-1	179	180	+	1	P01009-1	86	191	ENST00000554720.1	129	444	++	165	P01009-1#34	0	3	ENST00000554720.1	408	411	+	3	0	-2	3025
P01009-1#34	0	1	1	P01009-1	179	180	+	1	P01009-1	0	306	ENST00000489769.1	9	927	++	120	P01009-1#34	0	3	ENST00000489769.1	546	549	+	3	0	-2	3026
P01009-1#34	0	1	1	P01009-1	179	180	+	1	P01009-1	0	418	ENST00000449399.7	302	1556	++	100	P01009-1#34	0	3	ENST00000449399.7	839	842	+	3	0	-2	3027
P01009-1#34	0	1	1	P01009-1	179	180	+	1	P01009-1	0	418	ENST00000448921.5	573	1827	++	98	P01009-1#34	0	3	ENST00000448921.5	1110	1113	+	3	0	-2	3028
P01009-1#34	0	1	1	P01009-1	179	180	+	1	P01009-1	0	418	ENST00000440909.5	185	1439	++	91	P01009-1#34	0	3	ENST00000440909.5	722	725	+	3	0	-2	3029
P01009-1#34	0	1	1	P01009-1	179	180	+	1	P01009-1	0	418	ENST00000437397.5	381	1635	++	89	P01009-1#34	0	3	ENST00000437397.5	918	921	+	3	0	-2	3030
P01009-1#34	0	1	1	P01009-1	179	180	+	1	P01009-1	0	418	ENST00000404814.8	311	1565	++	67	P01009-1#34	0	3	ENST00000404814.8	848	851	+	3	0	-2	3031
P01009-1#34	0	1	1	P01009-1	179	180	+	1	P01009-1	0	355	ENST00000402629.1	34	1099	++	66	P01009-1#34	0	3	ENST00000402629.1	571	574	+	3	0	-2	3032
P01009-1#34	0	1	1	P01009-1	179	180	+	1	P01009-1	0	418	ENST00000393088.8	555	1809	++	62	P01009-1#34	0	3	ENST00000393088.8	1092	1095	+	3	0	-2	3033
P01009-1#34	0	1	1	P01009-1	179	180	+	1	P01009-1	0	418	ENST00000393087.9	47	1301	++	61	P01009-1#34	0	3	ENST00000393087.9	584	587	+	3	0	-2	3034
P01009-1#34	0	1	1	P01009-1	179	180	+	1	P01009-1	0	418	ENST00000355814.8	277	1531	++	37	P01009-1#34	0	3	ENST00000355814.8	814	817	+	3	0	-2	3035
P01009-1#35	0	9	9	P01009-1	189	198	+	9	P01009-1	0	418	ENST00000636712.1	152	1406	++	227	P01009-1#35	0	27	ENST00000636712.1	719	746	+	27	0	-18	3036
P01009-1#35	0	9	9	P01009-1	189	198	+	9	P01009-1	86	191	ENST00000554720.1	129	444	++	165	P01009-1#35	0	6	ENST00000554720.1	438	444	+	6	0	3	3037
P01009-1#35	0	9	9	P01009-1	189	198	+	9	P01009-1	0	306	ENST00000489769.1	9	927	++	120	P01009-1#35	0	27	ENST00000489769.1	576	603	+	27	0	-18	3038
P01009-1#35	0	9	9	P01009-1	189	198	+	9	P01009-1	0	418	ENST00000449399.7	302	1556	++	100	P01009-1#35	0	27	ENST00000449399.7	869	896	+	27	0	-18	3039
P01009-1#35	0	9	9	P01009-1	189	198	+	9	P01009-1	0	418	ENST00000448921.5	573	1827	++	98	P01009-1#35	0	27	ENST00000448921.5	1140	1167	+	27	0	-18	3040
P01009-1#35	0	9	9	P01009-1	189	198	+	9	P01009-1	0	418	ENST00000440909.5	185	1439	++	91	P01009-1#35	0	27	ENST00000440909.5	752	779	+	27	0	-18	3041
P01009-1#35	0	9	9	P01009-1	189	198	+	9	P01009-1	0	418	ENST00000437397.5	381	1635	++	89	P01009-1#35	0	27	ENST00000437397.5	948	975	+	27	0	-18	3042
P01009-1#35	0	9	9	P01009-1	189	198	+	9	P01009-1	0	418	ENST00000404814.8	311	1565	++	67	P01009-1#35	0	27	ENST00000404814.8	878	905	+	27	0	-18	3043
P01009-1#35	0	9	9	P01009-1	189	198	+	9	P01009-1	0	355	ENST00000402629.1	34	1099	++	66	P01009-1#35	0	27	ENST00000402629.1	601	628	+	27	0	-18	3044
P01009-1#35	0	9	9	P01009-1	189	198	+	9	P01009-1	0	418	ENST00000393088.8	555	1809	++	62	P01009-1#35	0	27	ENST00000393088.8	1122	1149	+	27	0	-18	3045
P01009-1#35	0	9	9	P01009-1	189	198	+	9	P01009-1	0	418	ENST00000393087.9	47	1301	++	61	P01009-1#35	0	27	ENST00000393087.9	614	641	+	27	0	-18	3046
P01009-1#35	0	9	9	P01009-1	189	198	+	9	P01009-1	0	418	ENST00000355814.8	277	1531	++	37	P01009-1#35	0	27	ENST00000355814.8	844	871	+	27	0	-18	3047
P01009-1#36	0	1	1	P01009-1	227	228	+	1	P01009-1	0	418	ENST00000636712.1	152	1406	++	227	P01009-1#36	0	3	ENST00000636712.1	833	836	+	3	0	-2	3048
P01009-1#36	0	1	1	P01009-1	227	228	+	1	P01009-1	0	306	ENST00000489769.1	9	927	++	120	P01009-1#36	0	3	ENST00000489769.1	690	693	+	3	0	-2	3049
P01009-1#36	0	1	1	P01009-1	227	228	+	1	P01009-1	0	418	ENST00000449399.7	302	1556	++	100	P01009-1#36	0	3	ENST00000449399.7	983	986	+	3	0	-2	3050
P01009-1#36	0	1	1	P01009-1	227	228	+	1	P01009-1	0	418	ENST00000448921.5	573	1827	++	98	P01009-1#36	0	3	ENST00000448921.5	1254	1257	+	3	0	-2	3051
P01009-1#36	0	1	1	P01009-1	227	228	+	1	P01009-1	0	418	ENST00000440909.5	185	1439	++	91	P01009-1#36	0	3	ENST00000440909.5	866	869	+	3	0	-2	3052
P01009-1#36	0	1	1	P01009-1	227	228	+	1	P01009-1	0	418	ENST00000437397.5	381	1635	++	89	P01009-1#36	0	3	ENST00000437397.5	1062	1065	+	3	0	-2	3053
P01009-1#36	0	1	1	P01009-1	227	228	+	1	P01009-1	0	418	ENST00000404814.8	311	1565	++	67	P01009-1#36	0	3	ENST00000404814.8	992	995	+	3	0	-2	3054
P01009-1#36	0	1	1	P01009-1	227	228	+	1	P01009-1	0	355	ENST00000402629.1	34	1099	++	66	P01009-1#36	0	3	ENST00000402629.1	715	718	+	3	0	-2	3055
P01009-1#36	0	1	1	P01009-1	227	228	+	1	P01009-1	0	418	ENST00000393088.8	555	1809	++	62	P01009-1#36	0	3	ENST00000393088.8	1236	1239	+	3	0	-2	3056
P01009-1#36	0	1	1	P01009-1	227	228	+	1	P01009-1	0	418	ENST00000393087.9	47	1301	++	61	P01009-1#36	0	3	ENST00000393087.9	728	731	+	3	0	-2	3057
P01009-1#36	0	1	1	P01009-1	227	228	+	1	P01009-1	0	418	ENST00000355814.8	277	1531	++	37	P01009-1#36	0	3	ENST00000355814.8	958	961	+	3	0	-2	3058
P01009-1#37	0	1	1	P01009-1	236	237	+	1	P01009-1	0	418	ENST00000636712.1	152	1406	++	227	P01009-1#37	0	3	ENST00000636712.1	860	863	+	3	0	-2	3059
P01009-1#37	0	1	1	P01009-1	236	237	+	1	P01009-1	0	306	ENST00000489769.1	9	927	++	120	P01009-1#37	0	3	ENST00000489769.1	717	720	+	3	0	-2	3060
P01009-1#37	0	1	1	P01009-1	236	237	+	1	P01009-1	0	418	ENST00000449399.7	302	1556	++	100	P01009-1#37	0	3	ENST00000449399.7	1010	1013	+	3	0	-2	3061
P01009-1#37	0	1	1	P01009-1	236	237	+	1	P01009-1	0	418	ENST00000448921.5	573	1827	++	98	P01009-1#37	0	3	ENST00000448921.5	1281	1284	+	3	0	-2	3062
P01009-1#37	0	1	1	P01009-1	236	237	+	1	P01009-1	0	418	ENST00000440909.5	185	1439	++	91	P01009-1#37	0	3	ENST00000440909.5	893	896	+	3	0	-2	3063
P01009-1#37	0	1	1	P01009-1	236	237	+	1	P01009-1	0	418	ENST00000437397.5	381	1635	++	89	P01009-1#37	0	3	ENST00000437397.5	1089	1092	+	3	0	-2	3064
P01009-1#37	0	1	1	P01009-1	236	237	+	1	P01009-1	0	418	ENST00000404814.8	311	1565	++	67	P01009-1#37	0	3	ENST00000404814.8	1019	1022	+	3	0	-2	3065
P01009-1#37	0	1	1	P01009-1	236	237	+	1	P01009-1	0	355	ENST00000402629.1	34	1099	++	66	P01009-1#37	0	3	ENST00000402629.1	742	745	+	3	0	-2	3066
P01009-1#37	0	1	1	P01009-1	236	237	+	1	P01009-1	0	418	ENST00000393088.8	555	1809	++	62	P01009-1#37	0	3	ENST00000393088.8	1263	1266	+	3	0	-2	3067
P01009-1#37	0	1	1	P01009-1	236	237	+	1	P01009-1	0	418	ENST00000393087.9	47	1301	++	61	P01009-1#37	0	3	ENST00000393087.9	755	758	+	3	0	-2	3068
P01009-1#37	0	1	1	P01009-1	236	237	+	1	P01009-1	0	418	ENST00000355814.8	277	1531	++	37	P01009-1#37	0	3	ENST00000355814.8	985	988	+	3	0	-2	3069
P01009-1#38	0	1	1	P01009-1	246	247	+	1	P01009-1	0	418	ENST00000636712.1	152	1406	++	227	P01009-1#38	0	3	ENST00000636712.1	890	893	+	3	0	-2	3070
P01009-1#38	0	1	1	P01009-1	246	247	+	1	P01009-1	0	306	ENST00000489769.1	9	927	++	120	P01009-1#38	0	3	ENST00000489769.1	747	750	+	3	0	-2	3071
P01009-1#38	0	1	1	P01009-1	246	247	+	1	P01009-1	0	418	ENST00000449399.7	302	1556	++	100	P01009-1#38	0	3	ENST00000449399.7	1040	1043	+	3	0	-2	3072
P01009-1#38	0	1	1	P01009-1	246	247	+	1	P01009-1	0	418	ENST00000448921.5	573	1827	++	98	P01009-1#38	0	3	ENST00000448921.5	1311	1314	+	3	0	-2	3073
P01009-1#38	0	1	1	P01009-1	246	247	+	1	P01009-1	0	418	ENST00000440909.5	185	1439	++	91	P01009-1#38	0	3	ENST00000440909.5	923	926	+	3	0	-2	3074
P01009-1#38	0	1	1	P01009-1	246	247	+	1	P01009-1	0	418	ENST00000437397.5	381	1635	++	89	P01009-1#38	0	3	ENST00000437397.5	1119	1122	+	3	0	-2	3075
P01009-1#38	0	1	1	P01009-1	246	247	+	1	P01009-1	0	418	ENST00000404814.8	311	1565	++	67	P01009-1#38	0	3	ENST00000404814.8	1049	1052	+	3	0	-2	3076
P01009-1#38	0	1	1	P01009-1	246	247	+	1	P01009-1	0	355	ENST00000402629.1	34	1099	++	66	P01009-1#38	0	3	ENST00000402629.1	772	775	+	3	0	-2	3077
P01009-1#38	0	1	1	P01009-1	246	247	+	1	P01009-1	0	418	ENST00000393088.8	555	1809	++	62	P01009-1#38	0	3	ENST00000393088.8	1293	1296	+	3	0	-2	3078
P01009-1#38	0	1	1	P01009-1	246	247	+	1	P01009-1	0	418	ENST00000393087.9	47	1301	++	61	P01009-1#38	0	3	ENST00000393087.9	785	788	+	3	0	-2	3079
P01009-1#38	0	1	1	P01009-1	246	247	+	1	P01009-1	0	418	ENST00000355814.8	277	1531	++	37	P01009-1#38	0	3	ENST00000355814.8	1015	1018	+	3	0	-2	3080
P01009-1#39	0	1	1	P01009-1	279	280	+	1	P01009-1	0	418	ENST00000636712.1	152	1406	++	227	P01009-1#39	0	3	ENST00000636712.1	989	992	+	3	0	-2	3081
P01009-1#39	0	1	1	P01009-1	279	280	+	1	P01009-1	0	306	ENST00000489769.1	9	927	++	120	P01009-1#39	0	3	ENST00000489769.1	846	849	+	3	0	-2	3082
P01009-1#39	0	1	1	P01009-1	279	280	+	1	P01009-1	0	418	ENST00000449399.7	302	1556	++	100	P01009-1#39	0	3	ENST00000449399.7	1139	1142	+	3	0	-2	3083
P01009-1#39	0	1	1	P01009-1	279	280	+	1	P01009-1	0	418	ENST00000448921.5	573	1827	++	98	P01009-1#39	0	3	ENST00000448921.5	1410	1413	+	3	0	-2	3084
P01009-1#39	0	1	1	P01009-1	279	280	+	1	P01009-1	0	418	ENST00000440909.5	185	1439	++	91	P01009-1#39	0	3	ENST00000440909.5	1022	1025	+	3	0	-2	3085
P01009-1#39	0	1	1	P01009-1	279	280	+	1	P01009-1	0	418	ENST00000437397.5	381	1635	++	89	P01009-1#39	0	3	ENST00000437397.5	1218	1221	+	3	0	-2	3086
P01009-1#39	0	1	1	P01009-1	279	280	+	1	P01009-1	0	418	ENST00000404814.8	311	1565	++	67	P01009-1#39	0	3	ENST00000404814.8	1148	1151	+	3	0	-2	3087
P01009-1#39	0	1	1	P01009-1	279	280	+	1	P01009-1	0	355	ENST00000402629.1	34	1099	++	66	P01009-1#39	0	3	ENST00000402629.1	871	874	+	3	0	-2	3088
P01009-1#39	0	1	1	P01009-1	279	280	+	1	P01009-1	0	418	ENST00000393088.8	555	1809	++	62	P01009-1#39	0	3	ENST00000393088.8	1392	1395	+	3	0	-2	3089
P01009-1#39	0	1	1	P01009-1	279	280	+	1	P01009-1	0	418	ENST00000393087.9	47	1301	++	61	P01009-1#39	0	3	ENST00000393087.9	884	887	+	3	0	-2	3090
P01009-1#39	0	1	1	P01009-1	279	280	+	1	P01009-1	0	418	ENST00000355814.8	277	1531	++	37	P01009-1#39	0	3	ENST00000355814.8	1114	1117	+	3	0	-2	3091
P01009-1#40	0	1	1	P01009-1	287	288	+	1	P01009-1	0	418	ENST00000636712.1	152	1406	++	227	P01009-1#40	0	3	ENST00000636712.1	1013	1016	+	3	0	-2	3092
P01009-1#40	0	1	1	P01009-1	287	288	+	1	P01009-1	0	306	ENST00000489769.1	9	927	++	120	P01009-1#40	0	3	ENST00000489769.1	870	873	+	3	0	-2	3093
P01009-1#40	0	1	1	P01009-1	287	288	+	1	P01009-1	0	418	ENST00000449399.7	302	1556	++	100	P01009-1#40	0	3	ENST00000449399.7	1163	1166	+	3	0	-2	3094
P01009-1#40	0	1	1	P01009-1	287	288	+	1	P01009-1	0	418	ENST00000448921.5	573	1827	++	98	P01009-1#40	0	3	ENST00000448921.5	1434	1437	+	3	0	-2	3095
P01009-1#40	0	1	1	P01009-1	287	288	+	1	P01009-1	0	418	ENST00000440909.5	185	1439	++	91	P01009-1#40	0	3	ENST00000440909.5	1046	1049	+	3	0	-2	3096
P01009-1#40	0	1	1	P01009-1	287	288	+	1	P01009-1	0	418	ENST00000437397.5	381	1635	++	89	P01009-1#40	0	3	ENST00000437397.5	1242	1245	+	3	0	-2	3097
P01009-1#40	0	1	1	P01009-1	287	288	+	1	P01009-1	0	418	ENST00000404814.8	311	1565	++	67	P01009-1#40	0	3	ENST00000404814.8	1172	1175	+	3	0	-2	3098
P01009-1#40	0	1	1	P01009-1	287	288	+	1	P01009-1	0	355	ENST00000402629.1	34	1099	++	66	P01009-1#40	0	3	ENST00000402629.1	895	898	+	3	0	-2	3099
P01009-1#40	0	1	1	P01009-1	287	288	+	1	P01009-1	0	418	ENST00000393088.8	555	1809	++	62	P01009-1#40	0	3	ENST00000393088.8	1416	1419	+	3	0	-2	3100
P01009-1#40	0	1	1	P01009-1	287	288	+	1	P01009-1	0	418	ENST00000393087.9	47	1301	++	61	P01009-1#40	0	3	ENST00000393087.9	908	911	+	3	0	-2	3101
P01009-1#40	0	1	1	P01009-1	287	288	+	1	P01009-1	0	418	ENST00000355814.8	277	1531	++	37	P01009-1#40	0	3	ENST00000355814.8	1138	1141	+	3	0	-2	3102
P01009-1#41	0	1	1	P01009-1	304	305	+	1	P01009-1	0	418	ENST00000636712.1	152	1406	++	227	P01009-1#41	0	3	ENST00000636712.1	1064	1067	+	3	0	-2	3103
P01009-1#41	0	1	1	P01009-1	304	305	+	1	P01009-1	0	306	ENST00000489769.1	9	927	++	120	P01009-1#41	0	3	ENST00000489769.1	921	924	+	3	0	-2	3104
P01009-1#41	0	1	1	P01009-1	304	305	+	1	P01009-1	0	418	ENST00000449399.7	302	1556	++	100	P01009-1#41	0	3	ENST00000449399.7	1214	1217	+	3	0	-2	3105
P01009-1#41	0	1	1	P01009-1	304	305	+	1	P01009-1	0	418	ENST00000448921.5	573	1827	++	98	P01009-1#41	0	3	ENST00000448921.5	1485	1488	+	3	0	-2	3106
P01009-1#41	0	1	1	P01009-1	304	305	+	1	P01009-1	0	418	ENST00000440909.5	185	1439	++	91	P01009-1#41	0	3	ENST00000440909.5	1097	1100	+	3	0	-2	3107
P01009-1#41	0	1	1	P01009-1	304	305	+	1	P01009-1	0	418	ENST00000437397.5	381	1635	++	89	P01009-1#41	0	3	ENST00000437397.5	1293	1296	+	3	0	-2	3108
P01009-1#41	0	1	1	P01009-1	304	305	+	1	P01009-1	0	418	ENST00000404814.8	311	1565	++	67	P01009-1#41	0	3	ENST00000404814.8	1223	1226	+	3	0	-2	3109
P01009-1#41	0	1	1	P01009-1	304	305	+	1	P01009-1	0	355	ENST00000402629.1	34	1099	++	66	P01009-1#41	0	3	ENST00000402629.1	946	949	+	3	0	-2	3110
P01009-1#41	0	1	1	P01009-1	304	305	+	1	P01009-1	0	418	ENST00000393088.8	555	1809	++	62	P01009-1#41	0	3	ENST00000393088.8	1467	1470	+	3	0	-2	3111
P01009-1#41	0	1	1	P01009-1	304	305	+	1	P01009-1	0	418	ENST00000393087.9	47	1301	++	61	P01009-1#41	0	3	ENST00000393087.9	959	962	+	3	0	-2	3112
P01009-1#41	0	1	1	P01009-1	304	305	+	1	P01009-1	0	418	ENST00000355814.8	277	1531	++	37	P01009-1#41	0	3	ENST00000355814.8	1189	1192	+	3	0	-2	3113
P01009-1#42	0	1	1	P01009-1	353	354	+	1	P01009-1	0	418	ENST00000636712.1	152	1406	++	227	P01009-1#42	0	3	ENST00000636712.1	1211	1214	+	3	0	-2	3114
P01009-1#42	0	1	1	P01009-1	353	354	+	1	P01009-1	0	418	ENST00000449399.7	302	1556	++	100	P01009-1#42	0	3	ENST00000449399.7	1361	1364	+	3	0	-2	3115
P01009-1#42	0	1	1	P01009-1	353	354	+	1	P01009-1	0	418	ENST00000448921.5	573	1827	++	98	P01009-1#42	0	3	ENST00000448921.5	1632	1635	+	3	0	-2	3116
P01009-1#42	0	1	1	P01009-1	353	354	+	1	P01009-1	0	418	ENST00000440909.5	185	1439	++	91	P01009-1#42	0	3	ENST00000440909.5	1244	1247	+	3	0	-2	3117
P01009-1#42	0	1	1	P01009-1	353	354	+	1	P01009-1	0	418	ENST00000437397.5	381	1635	++	89	P01009-1#42	0	3	ENST00000437397.5	1440	1443	+	3	0	-2	3118
P01009-1#42	0	1	1	P01009-1	353	354	+	1	P01009-1	0	418	ENST00000404814.8	311	1565	++	67	P01009-1#42	0	3	ENST00000404814.8	1370	1373	+	3	0	-2	3119
P01009-1#42	0	1	1	P01009-1	353	354	+	1	P01009-1	0	355	ENST00000402629.1	34	1099	++	66	P01009-1#42	0	3	ENST00000402629.1	1093	1096	+	3	0	-2	3120
P01009-1#42	0	1	1	P01009-1	353	354	+	1	P01009-1	0	418	ENST00000393088.8	555	1809	++	62	P01009-1#42	0	3	ENST00000393088.8	1614	1617	+	3	0	-2	3121
P01009-1#42	0	1	1	P01009-1	353	354	+	1	P01009-1	0	418	ENST00000393087.9	47	1301	++	61	P01009-1#42	0	3	ENST00000393087.9	1106	1109	+	3	0	-2	3122
P01009-1#42	0	1	1	P01009-1	353	354	+	1	P01009-1	0	418	ENST00000355814.8	277	1531	++	37	P01009-1#42	0	3	ENST00000355814.8	1336	1339	+	3	0	-2	3123
P01009-1#43	0	1	1	P01009-1	359	360	+	1	P01009-1	0	418	ENST00000636712.1	152	1406	++	227	P01009-1#43	0	3	ENST00000636712.1	1229	1232	+	3	0	-2	3124
P01009-1#43	0	1	1	P01009-1	359	360	+	1	P01009-1	0	418	ENST00000449399.7	302	1556	++	100	P01009-1#43	0	3	ENST00000449399.7	1379	1382	+	3	0	-2	3125
P01009-1#43	0	1	1	P01009-1	359	360	+	1	P01009-1	0	418	ENST00000448921.5	573	1827	++	98	P01009-1#43	0	3	ENST00000448921.5	1650	1653	+	3	0	-2	3126
P01009-1#43	0	1	1	P01009-1	359	360	+	1	P01009-1	0	418	ENST00000440909.5	185	1439	++	91	P01009-1#43	0	3	ENST00000440909.5	1262	1265	+	3	0	-2	3127
P01009-1#43	0	1	1	P01009-1	359	360	+	1	P01009-1	0	418	ENST00000437397.5	381	1635	++	89	P01009-1#43	0	3	ENST00000437397.5	1458	1461	+	3	0	-2	3128
P01009-1#43	0	1	1	P01009-1	359	360	+	1	P01009-1	0	418	ENST00000404814.8	311	1565	++	67	P01009-1#43	0	3	ENST00000404814.8	1388	1391	+	3	0	-2	3129
P01009-1#43	0	1	1	P01009-1	359	360	+	1	P01009-1	0	418	ENST00000393088.8	555	1809	++	62	P01009-1#43	0	3	ENST00000393088.8	1632	1635	+	3	0	-2	3130
P01009-1#43	0	1	1	P01009-1	359	360	+	1	P01009-1	0	418	ENST00000393087.9	47	1301	++	61	P01009-1#43	0	3	ENST00000393087.9	1124	1127	+	3	0	-2	3131
P01009-1#43	0	1	1	P01009-1	359	360	+	1	P01009-1	0	418	ENST00000355814.8	277	1531	++	37	P01009-1#43	0	3	ENST00000355814.8	1354	1357	+	3	0	-2	3132
P01009-1#44	0	1	1	P01009-1	364	365	+	1	P01009-1	0	418	ENST00000636712.1	152	1406	++	227	P01009-1#44	0	3	ENST00000636712.1	1244	1247	+	3	0	-2	3133
P01009-1#44	0	1	1	P01009-1	364	365	+	1	P01009-1	0	418	ENST00000449399.7	302	1556	++	100	P01009-1#44	0	3	ENST00000449399.7	1394	1397	+	3	0	-2	3134
P01009-1#44	0	1	1	P01009-1	364	365	+	1	P01009-1	0	418	ENST00000448921.5	573	1827	++	98	P01009-1#44	0	3	ENST00000448921.5	1665	1668	+	3	0	-2	3135
P01009-1#44	0	1	1	P01009-1	364	365	+	1	P01009-1	0	418	ENST00000440909.5	185	1439	++	91	P01009-1#44	0	3	ENST00000440909.5	1277	1280	+	3	0	-2	3136
P01009-1#44	0	1	1	P01009-1	364	365	+	1	P01009-1	0	418	ENST00000437397.5	381	1635	++	89	P01009-1#44	0	3	ENST00000437397.5	1473	1476	+	3	0	-2	3137
P01009-1#44	0	1	1	P01009-1	364	365	+	1	P01009-1	0	418	ENST00000404814.8	311	1565	++	67	P01009-1#44	0	3	ENST00000404814.8	1403	1406	+	3	0	-2	3138
P01009-1#44	0	1	1	P01009-1	364	365	+	1	P01009-1	0	418	ENST00000393088.8	555	1809	++	62	P01009-1#44	0	3	ENST00000393088.8	1647	1650	+	3	0	-2	3139
P01009-1#44	0	1	1	P01009-1	364	365	+	1	P01009-1	0	418	ENST00000393087.9	47	1301	++	61	P01009-1#44	0	3	ENST00000393087.9	1139	1142	+	3	0	-2	3140
P01009-1#44	0	1	1	P01009-1	364	365	+	1	P01009-1	0	418	ENST00000355814.8	277	1531	++	37	P01009-1#44	0	3	ENST00000355814.8	1369	1372	+	3	0	-2	3141
P01009-1#45	0	1	1	P01009-1	365	366	+	1	P01009-1	0	418	ENST00000636712.1	152	1406	++	227	P01009-1#45	0	3	ENST00000636712.1	1247	1250	+	3	0	-2	3142
P01009-1#45	0	1	1	P01009-1	365	366	+	1	P01009-1	0	418	ENST00000449399.7	302	1556	++	100	P01009-1#45	0	3	ENST00000449399.7	1397	1400	+	3	0	-2	3143
P01009-1#45	0	1	1	P01009-1	365	366	+	1	P01009-1	0	418	ENST00000448921.5	573	1827	++	98	P01009-1#45	0	3	ENST00000448921.5	1668	1671	+	3	0	-2	3144
P01009-1#45	0	1	1	P01009-1	365	366	+	1	P01009-1	0	418	ENST00000440909.5	185	1439	++	91	P01009-1#45	0	3	ENST00000440909.5	1280	1283	+	3	0	-2	3145
P01009-1#45	0	1	1	P01009-1	365	366	+	1	P01009-1	0	418	ENST00000437397.5	381	1635	++	89	P01009-1#45	0	3	ENST00000437397.5	1476	1479	+	3	0	-2	3146
P01009-1#45	0	1	1	P01009-1	365	366	+	1	P01009-1	0	418	ENST00000404814.8	311	1565	++	67	P01009-1#45	0	3	ENST00000404814.8	1406	1409	+	3	0	-2	3147
P01009-1#45	0	1	1	P01009-1	365	366	+	1	P01009-1	0	418	ENST00000393088.8	555	1809	++	62	P01009-1#45	0	3	ENST00000393088.8	1650	1653	+	3	0	-2	3148
P01009-1#45	0	1	1	P01009-1	365	366	+	1	P01009-1	0	418	ENST00000393087.9	47	1301	++	61	P01009-1#45	0	3	ENST00000393087.9	1142	1145	+	3	0	-2	3149
P01009-1#45	0	1	1	P01009-1	365	366	+	1	P01009-1	0	418	ENST00000355814.8	277	1531	++	37	P01009-1#45	0	3	ENST00000355814.8	1372	1375	+	3	0	-2	3150
P01009-1#46	0	1	1	P01009-1	381	382	+	1	P01009-1	0	418	ENST00000636712.1	152	1406	++	227	P01009-1#46	0	3	ENST00000636712.1	1295	1298	+	3	0	-2	3151
P01009-1#46	0	1	1	P01009-1	381	382	+	1	P01009-1	0	418	ENST00000449399.7	302	1556	++	100	P01009-1#46	0	3	ENST00000449399.7	1445	1448	+	3	0	-2	3152
P01009-1#46	0	1	1	P01009-1	381	382	+	1	P01009-1	0	418	ENST00000448921.5	573	1827	++	98	P01009-1#46	0	3	ENST00000448921.5	1716	1719	+	3	0	-2	3153
P01009-1#46	0	1	1	P01009-1	381	382	+	1	P01009-1	0	418	ENST00000440909.5	185	1439	++	91	P01009-1#46	0	3	ENST00000440909.5	1328	1331	+	3	0	-2	3154
P01009-1#46	0	1	1	P01009-1	381	382	+	1	P01009-1	0	418	ENST00000437397.5	381	1635	++	89	P01009-1#46	0	3	ENST00000437397.5	1524	1527	+	3	0	-2	3155
P01009-1#46	0	1	1	P01009-1	381	382	+	1	P01009-1	0	418	ENST00000404814.8	311	1565	++	67	P01009-1#46	0	3	ENST00000404814.8	1454	1457	+	3	0	-2	3156
P01009-1#46	0	1	1	P01009-1	381	382	+	1	P01009-1	0	418	ENST00000393088.8	555	1809	++	62	P01009-1#46	0	3	ENST00000393088.8	1698	1701	+	3	0	-2	3157
P01009-1#46	0	1	1	P01009-1	381	382	+	1	P01009-1	0	418	ENST00000393087.9	47	1301	++	61	P01009-1#46	0	3	ENST00000393087.9	1190	1193	+	3	0	-2	3158
P01009-1#46	0	1	1	P01009-1	381	382	+	1	P01009-1	0	418	ENST00000355814.8	277	1531	++	37	P01009-1#46	0	3	ENST00000355814.8	1420	1423	+	3	0	-2	3159
P01009-1#47	0	1	1	P01009-1	385	386	+	1	P01009-1	0	418	ENST00000636712.1	152	1406	++	227	P01009-1#47	0	3	ENST00000636712.1	1307	1310	+	3	0	-2	3160
P01009-1#47	0	1	1	P01009-1	385	386	+	1	P01009-1	0	418	ENST00000449399.7	302	1556	++	100	P01009-1#47	0	3	ENST00000449399.7	1457	1460	+	3	0	-2	3161
P01009-1#47	0	1	1	P01009-1	385	386	+	1	P01009-1	0	418	ENST00000448921.5	573	1827	++	98	P01009-1#47	0	3	ENST00000448921.5	1728	1731	+	3	0	-2	3162
P01009-1#47	0	1	1	P01009-1	385	386	+	1	P01009-1	0	418	ENST00000440909.5	185	1439	++	91	P01009-1#47	0	3	ENST00000440909.5	1340	1343	+	3	0	-2	3163
P01009-1#47	0	1	1	P01009-1	385	386	+	1	P01009-1	0	418	ENST00000437397.5	381	1635	++	89	P01009-1#47	0	3	ENST00000437397.5	1536	1539	+	3	0	-2	3164
P01009-1#47	0	1	1	P01009-1	385	386	+	1	P01009-1	0	418	ENST00000404814.8	311	1565	++	67	P01009-1#47	0	3	ENST00000404814.8	1466	1469	+	3	0	-2	3165
P01009-1#47	0	1	1	P01009-1	385	386	+	1	P01009-1	0	418	ENST00000393088.8	555	1809	++	62	P01009-1#47	0	3	ENST00000393088.8	1710	1713	+	3	0	-2	3166
P01009-1#47	0	1	1	P01009-1	385	386	+	1	P01009-1	0	418	ENST00000393087.9	47	1301	++	61	P01009-1#47	0	3	ENST00000393087.9	1202	1205	+	3	0	-2	3167
P01009-1#47	0	1	1	P01009-1	385	386	+	1	P01009-1	0	418	ENST00000355814.8	277	1531	++	37	P01009-1#47	0	3	ENST00000355814.8	1432	1435	+	3	0	-2	3168
P01009-1#48	0	1	1	P01009-1	385	386	+	1	P01009-1	0	418	ENST00000636712.1	152	1406	++	227	P01009-1#48	0	3	ENST00000636712.1	1307	1310	+	3	0	-2	3169
P01009-1#48	0	1	1	P01009-1	385	386	+	1	P01009-1	0	418	ENST00000449399.7	302	1556	++	100	P01009-1#48	0	3	ENST00000449399.7	1457	1460	+	3	0	-2	3170
P01009-1#48	0	1	1	P01009-1	385	386	+	1	P01009-1	0	418	ENST00000448921.5	573	1827	++	98	P01009-1#48	0	3	ENST00000448921.5	1728	1731	+	3	0	-2	3171
P01009-1#48	0	1	1	P01009-1	385	386	+	1	P01009-1	0	418	ENST00000440909.5	185	1439	++	91	P01009-1#48	0	3	ENST00000440909.5	1340	1343	+	3	0	-2	3172
P01009-1#48	0	1	1	P01009-1	385	386	+	1	P01009-1	0	418	ENST00000437397.5	381	1635	++	89	P01009-1#48	0	3	ENST00000437397.5	1536	1539	+	3	0	-2	3173
P01009-1#48	0	1	1	P01009-1	385	386	+	1	P01009-1	0	418	ENST00000404814.8	311	1565	++	67	P01009-1#48	0	3	ENST00000404814.8	1466	1469	+	3	0	-2	3174
P01009-1#48	0	1	1	P01009-1	385	386	+	1	P01009-1	0	418	ENST00000393088.8	555	1809	++	62	P01009-1#48	0	3	ENST00000393088.8	1710	1713	+	3	0	-2	3175
P01009-1#48	0	1	1	P01009-1	385	386	+	1	P01009-1	0	418	ENST00000393087.9	47	1301	++	61	P01009-1#48	0	3	ENST00000393087.9	1202	1205	+	3	0	-2	3176
P01009-1#48	0	1	1	P01009-1	385	386	+	1	P01009-1	0	418	ENST00000355814.8	277	1531	++	37	P01009-1#48	0	3	ENST00000355814.8	1432	1435	+	3	0	-2	3177
P01009-1#49	0	1	1	P01009-1	386	387	+	1	P01009-1	0	418	ENST00000636712.1	152	1406	++	227	P01009-1#49	0	3	ENST00000636712.1	1310	1313	+	3	0	-2	3178
P01009-1#49	0	1	1	P01009-1	386	387	+	1	P01009-1	0	418	ENST00000449399.7	302	1556	++	100	P01009-1#49	0	3	ENST00000449399.7	1460	1463	+	3	0	-2	3179
P01009-1#49	0	1	1	P01009-1	386	387	+	1	P01009-1	0	418	ENST00000448921.5	573	1827	++	98	P01009-1#49	0	3	ENST00000448921.5	1731	1734	+	3	0	-2	3180
P01009-1#49	0	1	1	P01009-1	386	387	+	1	P01009-1	0	418	ENST00000440909.5	185	1439	++	91	P01009-1#49	0	3	ENST00000440909.5	1343	1346	+	3	0	-2	3181
P01009-1#49	0	1	1	P01009-1	386	387	+	1	P01009-1	0	418	ENST00000437397.5	381	1635	++	89	P01009-1#49	0	3	ENST00000437397.5	1539	1542	+	3	0	-2	3182
P01009-1#49	0	1	1	P01009-1	386	387	+	1	P01009-1	0	418	ENST00000404814.8	311	1565	++	67	P01009-1#49	0	3	ENST00000404814.8	1469	1472	+	3	0	-2	3183
P01009-1#49	0	1	1	P01009-1	386	387	+	1	P01009-1	0	418	ENST00000393088.8	555	1809	++	62	P01009-1#49	0	3	ENST00000393088.8	1713	1716	+	3	0	-2	3184
P01009-1#49	0	1	1	P01009-1	386	387	+	1	P01009-1	0	418	ENST00000393087.9	47	1301	++	61	P01009-1#49	0	3	ENST00000393087.9	1205	1208	+	3	0	-2	3185
P01009-1#49	0	1	1	P01009-1	386	387	+	1	P01009-1	0	418	ENST00000355814.8	277	1531	++	37	P01009-1#49	0	3	ENST00000355814.8	1435	1438	+	3	0	-2	3186
P01009-1#50	0	1	1	P01009-1	392	393	+	1	P01009-1	0	418	ENST00000636712.1	152	1406	++	227	P01009-1#50	0	3	ENST00000636712.1	1328	1331	+	3	0	-2	3187
P01009-1#50	0	1	1	P01009-1	392	393	+	1	P01009-1	0	418	ENST00000449399.7	302	1556	++	100	P01009-1#50	0	3	ENST00000449399.7	1478	1481	+	3	0	-2	3188
P01009-1#50	0	1	1	P01009-1	392	393	+	1	P01009-1	0	418	ENST00000448921.5	573	1827	++	98	P01009-1#50	0	3	ENST00000448921.5	1749	1752	+	3	0	-2	3189
P01009-1#50	0	1	1	P01009-1	392	393	+	1	P01009-1	0	418	ENST00000440909.5	185	1439	++	91	P01009-1#50	0	3	ENST00000440909.5	1361	1364	+	3	0	-2	3190
P01009-1#50	0	1	1	P01009-1	392	393	+	1	P01009-1	0	418	ENST00000437397.5	381	1635	++	89	P01009-1#50	0	3	ENST00000437397.5	1557	1560	+	3	0	-2	3191
P01009-1#50	0	1	1	P01009-1	392	393	+	1	P01009-1	0	418	ENST00000404814.8	311	1565	++	67	P01009-1#50	0	3	ENST00000404814.8	1487	1490	+	3	0	-2	3192
P01009-1#50	0	1	1	P01009-1	392	393	+	1	P01009-1	0	418	ENST00000393088.8	555	1809	++	62	P01009-1#50	0	3	ENST00000393088.8	1731	1734	+	3	0	-2	3193
P01009-1#50	0	1	1	P01009-1	392	393	+	1	P01009-1	0	418	ENST00000393087.9	47	1301	++	61	P01009-1#50	0	3	ENST00000393087.9	1223	1226	+	3	0	-2	3194
P01009-1#50	0	1	1	P01009-1	392	393	+	1	P01009-1	0	418	ENST00000355814.8	277	1531	++	37	P01009-1#50	0	3	ENST00000355814.8	1453	1456	+	3	0	-2	3195
P01009-1#51	0	1	1	P01009-1	399	400	+	1	P01009-1	0	418	ENST00000636712.1	152	1406	++	227	P01009-1#51	0	3	ENST00000636712.1	1349	1352	+	3	0	-2	3196
P01009-1#51	0	1	1	P01009-1	399	400	+	1	P01009-1	0	418	ENST00000449399.7	302	1556	++	100	P01009-1#51	0	3	ENST00000449399.7	1499	1502	+	3	0	-2	3197
P01009-1#51	0	1	1	P01009-1	399	400	+	1	P01009-1	0	418	ENST00000448921.5	573	1827	++	98	P01009-1#51	0	3	ENST00000448921.5	1770	1773	+	3	0	-2	3198
P01009-1#51	0	1	1	P01009-1	399	400	+	1	P01009-1	0	418	ENST00000440909.5	185	1439	++	91	P01009-1#51	0	3	ENST00000440909.5	1382	1385	+	3	0	-2	3199
P01009-1#51	0	1	1	P01009-1	399	400	+	1	P01009-1	0	418	ENST00000437397.5	381	1635	++	89	P01009-1#51	0	3	ENST00000437397.5	1578	1581	+	3	0	-2	3200
P01009-1#51	0	1	1	P01009-1	399	400	+	1	P01009-1	0	418	ENST00000404814.8	311	1565	++	67	P01009-1#51	0	3	ENST00000404814.8	1508	1511	+	3	0	-2	3201
P01009-1#51	0	1	1	P01009-1	399	400	+	1	P01009-1	0	418	ENST00000393088.8	555	1809	++	62	P01009-1#51	0	3	ENST00000393088.8	1752	1755	+	3	0	-2	3202
P01009-1#51	0	1	1	P01009-1	399	400	+	1	P01009-1	0	418	ENST00000393087.9	47	1301	++	61	P01009-1#51	0	3	ENST00000393087.9	1244	1247	+	3	0	-2	3203
P01009-1#51	0	1	1	P01009-1	399	400	+	1	P01009-1	0	418	ENST00000355814.8	277	1531	++	37	P01009-1#51	0	3	ENST00000355814.8	1474	1477	+	3	0	-2	3204
P01009-1#52	0	1	1	P01009-1	414	415	+	1	P01009-1	0	418	ENST00000636712.1	152	1406	++	227	P01009-1#52	0	3	ENST00000636712.1	1394	1397	+	3	0	-2	3205
P01009-1#52	0	1	1	P01009-1	414	415	+	1	P01009-1	0	418	ENST00000449399.7	302	1556	++	100	P01009-1#52	0	3	ENST00000449399.7	1544	1547	+	3	0	-2	3206
P01009-1#52	0	1	1	P01009-1	414	415	+	1	P01009-1	0	418	ENST00000448921.5	573	1827	++	98	P01009-1#52	0	3	ENST00000448921.5	1815	1818	+	3	0	-2	3207
P01009-1#52	0	1	1	P01009-1	414	415	+	1	P01009-1	0	418	ENST00000440909.5	185	1439	++	91	P01009-1#52	0	3	ENST00000440909.5	1427	1430	+	3	0	-2	3208
P01009-1#52	0	1	1	P01009-1	414	415	+	1	P01009-1	0	418	ENST00000437397.5	381	1635	++	89	P01009-1#52	0	3	ENST00000437397.5	1623	1626	+	3	0	-2	3209
P01009-1#52	0	1	1	P01009-1	414	415	+	1	P01009-1	0	418	ENST00000404814.8	311	1565	++	67	P01009-1#52	0	3	ENST00000404814.8	1553	1556	+	3	0	-2	3210
P01009-1#52	0	1	1	P01009-1	414	415	+	1	P01009-1	0	418	ENST00000393088.8	555	1809	++	62	P01009-1#52	0	3	ENST00000393088.8	1797	1800	+	3	0	-2	3211
P01009-1#52	0	1	1	P01009-1	414	415	+	1	P01009-1	0	418	ENST00000393087.9	47	1301	++	61	P01009-1#52	0	3	ENST00000393087.9	1289	1292	+	3	0	-2	3212
P01009-1#52	0	1	1	P01009-1	414	415	+	1	P01009-1	0	418	ENST00000355814.8	277	1531	++	37	P01009-1#52	0	3	ENST00000355814.8	1519	1522	+	3	0	-2	3213
P01009-1#53	0	1	1	P01009-1	381	382	+	1	P01009-1	0	418	ENST00000636712.1	152	1406	++	227	P01009-1#53	0	3	ENST00000636712.1	1295	1298	+	3	0	-2	3214
P01009-1#53	0	1	1	P01009-1	381	382	+	1	P01009-1	0	418	ENST00000449399.7	302	1556	++	100	P01009-1#53	0	3	ENST00000449399.7	1445	1448	+	3	0	-2	3215
P01009-1#53	0	1	1	P01009-1	381	382	+	1	P01009-1	0	418	ENST00000448921.5	573	1827	++	98	P01009-1#53	0	3	ENST00000448921.5	1716	1719	+	3	0	-2	3216
P01009-1#53	0	1	1	P01009-1	381	382	+	1	P01009-1	0	418	ENST00000440909.5	185	1439	++	91	P01009-1#53	0	3	ENST00000440909.5	1328	1331	+	3	0	-2	3217
P01009-1#53	0	1	1	P01009-1	381	382	+	1	P01009-1	0	418	ENST00000437397.5	381	1635	++	89	P01009-1#53	0	3	ENST00000437397.5	1524	1527	+	3	0	-2	3218
P01009-1#53	0	1	1	P01009-1	381	382	+	1	P01009-1	0	418	ENST00000404814.8	311	1565	++	67	P01009-1#53	0	3	ENST00000404814.8	1454	1457	+	3	0	-2	3219
P01009-1#53	0	1	1	P01009-1	381	382	+	1	P01009-1	0	418	ENST00000393088.8	555	1809	++	62	P01009-1#53	0	3	ENST00000393088.8	1698	1701	+	3	0	-2	3220
P01009-1#53	0	1	1	P01009-1	381	382	+	1	P01009-1	0	418	ENST00000393087.9	47	1301	++	61	P01009-1#53	0	3	ENST00000393087.9	1190	1193	+	3	0	-2	3221
P01009-1#53	0	1	1	P01009-1	381	382	+	1	P01009-1	0	418	ENST00000355814.8	277	1531	++	37	P01009-1#53	0	3	ENST00000355814.8	1420	1423	+	3	0	-2	3222
P01009-1#54	0	1	1	P01009-1	11	12	+	1	P01009-1	0	418	ENST00000636712.1	152	1406	++	227	P01009-1#54	0	3	ENST00000636712.1	185	188	+	3	0	-2	3223
P01009-1#54	0	1	1	P01009-1	11	12	+	1	P01009-1	0	144	ENST00000557492.5	517	949	++	169	P01009-1#54	0	3	ENST00000557492.5	550	553	+	3	0	-2	3224
P01009-1#54	0	1	1	P01009-1	11	12	+	1	P01009-1	0	22	ENST00000557118.5	516	582	++	168	P01009-1#54	0	3	ENST00000557118.5	549	552	+	3	0	-2	3225
P01009-1#54	0	1	1	P01009-1	11	12	+	1	P01009-1	0	117	ENST00000556955.5	220	571	++	167	P01009-1#54	0	3	ENST00000556955.5	253	256	+	3	0	-2	3226
P01009-1#54	0	1	1	P01009-1	11	12	+	1	P01009-1	0	156	ENST00000556091.1	174	642	++	166	P01009-1#54	0	3	ENST00000556091.1	207	210	+	3	0	-2	3227
P01009-1#54	0	1	1	P01009-1	11	12	+	1	P01009-1	0	92	ENST00000553327.5	303	579	++	164	P01009-1#54	0	3	ENST00000553327.5	336	339	+	3	0	-2	3228
P01009-1#54	0	1	1	P01009-1	11	12	+	1	P01009-1	0	306	ENST00000489769.1	9	927	++	120	P01009-1#54	0	3	ENST00000489769.1	42	45	+	3	0	-2	3229
P01009-1#54	0	1	1	P01009-1	11	12	+	1	P01009-1	0	418	ENST00000449399.7	302	1556	++	100	P01009-1#54	0	3	ENST00000449399.7	335	338	+	3	0	-2	3230
P01009-1#54	0	1	1	P01009-1	11	12	+	1	P01009-1	0	418	ENST00000448921.5	573	1827	++	98	P01009-1#54	0	3	ENST00000448921.5	606	609	+	3	0	-2	3231
P01009-1#54	0	1	1	P01009-1	11	12	+	1	P01009-1	0	418	ENST00000440909.5	185	1439	++	91	P01009-1#54	0	3	ENST00000440909.5	218	221	+	3	0	-2	3232
P01009-1#54	0	1	1	P01009-1	11	12	+	1	P01009-1	0	418	ENST00000437397.5	381	1635	++	89	P01009-1#54	0	3	ENST00000437397.5	414	417	+	3	0	-2	3233
P01009-1#54	0	1	1	P01009-1	11	12	+	1	P01009-1	0	418	ENST00000404814.8	311	1565	++	67	P01009-1#54	0	3	ENST00000404814.8	344	347	+	3	0	-2	3234
P01009-1#54	0	1	1	P01009-1	11	12	+	1	P01009-1	0	355	ENST00000402629.1	34	1099	++	66	P01009-1#54	0	3	ENST00000402629.1	67	70	+	3	0	-2	3235
P01009-1#54	0	1	1	P01009-1	11	12	+	1	P01009-1	0	418	ENST00000393088.8	555	1809	++	62	P01009-1#54	0	3	ENST00000393088.8	588	591	+	3	0	-2	3236
P01009-1#54	0	1	1	P01009-1	11	12	+	1	P01009-1	0	418	ENST00000393087.9	47	1301	++	61	P01009-1#54	0	3	ENST00000393087.9	80	83	+	3	0	-2	3237
P01009-1#54	0	1	1	P01009-1	11	12	+	1	P01009-1	0	418	ENST00000355814.8	277	1531	++	37	P01009-1#54	0	3	ENST00000355814.8	310	313	+	3	0	-2	3238
P01009-1#55	0	1	1	P01009-1	22	23	+	1	P01009-1	0	418	ENST00000636712.1	152	1406	++	227	P01009-1#55	0	3	ENST00000636712.1	218	221	+	3	0	-2	3239
P01009-1#55	0	1	1	P01009-1	22	23	+	1	P01009-1	0	144	ENST00000557492.5	517	949	++	169	P01009-1#55	0	3	ENST00000557492.5	583	586	+	3	0	-2	3240
P01009-1#55	0	1	1	P01009-1	22	23	+	1	P01009-1	0	117	ENST00000556955.5	220	571	++	167	P01009-1#55	0	3	ENST00000556955.5	286	289	+	3	0	-2	3241
P01009-1#55	0	1	1	P01009-1	22	23	+	1	P01009-1	0	156	ENST00000556091.1	174	642	++	166	P01009-1#55	0	3	ENST00000556091.1	240	243	+	3	0	-2	3242
P01009-1#55	0	1	1	P01009-1	22	23	+	1	P01009-1	0	92	ENST00000553327.5	303	579	++	164	P01009-1#55	0	3	ENST00000553327.5	369	372	+	3	0	-2	3243
P01009-1#55	0	1	1	P01009-1	22	23	+	1	P01009-1	0	306	ENST00000489769.1	9	927	++	120	P01009-1#55	0	3	ENST00000489769.1	75	78	+	3	0	-2	3244
P01009-1#55	0	1	1	P01009-1	22	23	+	1	P01009-1	0	418	ENST00000449399.7	302	1556	++	100	P01009-1#55	0	3	ENST00000449399.7	368	371	+	3	0	-2	3245
P01009-1#55	0	1	1	P01009-1	22	23	+	1	P01009-1	0	418	ENST00000448921.5	573	1827	++	98	P01009-1#55	0	3	ENST00000448921.5	639	642	+	3	0	-2	3246
P01009-1#55	0	1	1	P01009-1	22	23	+	1	P01009-1	0	418	ENST00000440909.5	185	1439	++	91	P01009-1#55	0	3	ENST00000440909.5	251	254	+	3	0	-2	3247
P01009-1#55	0	1	1	P01009-1	22	23	+	1	P01009-1	0	418	ENST00000437397.5	381	1635	++	89	P01009-1#55	0	3	ENST00000437397.5	447	450	+	3	0	-2	3248
P01009-1#55	0	1	1	P01009-1	22	23	+	1	P01009-1	0	418	ENST00000404814.8	311	1565	++	67	P01009-1#55	0	3	ENST00000404814.8	377	380	+	3	0	-2	3249
P01009-1#55	0	1	1	P01009-1	22	23	+	1	P01009-1	0	355	ENST00000402629.1	34	1099	++	66	P01009-1#55	0	3	ENST00000402629.1	100	103	+	3	0	-2	3250
P01009-1#55	0	1	1	P01009-1	22	23	+	1	P01009-1	0	418	ENST00000393088.8	555	1809	++	62	P01009-1#55	0	3	ENST00000393088.8	621	624	+	3	0	-2	3251
P01009-1#55	0	1	1	P01009-1	22	23	+	1	P01009-1	0	418	ENST00000393087.9	47	1301	++	61	P01009-1#55	0	3	ENST00000393087.9	113	116	+	3	0	-2	3252
P01009-1#55	0	1	1	P01009-1	22	23	+	1	P01009-1	0	418	ENST00000355814.8	277	1531	++	37	P01009-1#55	0	3	ENST00000355814.8	343	346	+	3	0	-2	3253
P01009-1#56	0	1	1	P01009-1	25	26	+	1	P01009-1	0	418	ENST00000636712.1	152	1406	++	227	P01009-1#56	0	3	ENST00000636712.1	227	230	+	3	0	-2	3254
P01009-1#56	0	1	1	P01009-1	25	26	+	1	P01009-1	0	144	ENST00000557492.5	517	949	++	169	P01009-1#56	0	3	ENST00000557492.5	592	595	+	3	0	-2	3255
P01009-1#56	0	1	1	P01009-1	25	26	+	1	P01009-1	0	117	ENST00000556955.5	220	571	++	167	P01009-1#56	0	3	ENST00000556955.5	295	298	+	3	0	-2	3256
P01009-1#56	0	1	1	P01009-1	25	26	+	1	P01009-1	0	156	ENST00000556091.1	174	642	++	166	P01009-1#56	0	3	ENST00000556091.1	249	252	+	3	0	-2	3257
P01009-1#56	0	1	1	P01009-1	25	26	+	1	P01009-1	0	92	ENST00000553327.5	303	579	++	164	P01009-1#56	0	3	ENST00000553327.5	378	381	+	3	0	-2	3258
P01009-1#56	0	1	1	P01009-1	25	26	+	1	P01009-1	0	306	ENST00000489769.1	9	927	++	120	P01009-1#56	0	3	ENST00000489769.1	84	87	+	3	0	-2	3259
P01009-1#56	0	1	1	P01009-1	25	26	+	1	P01009-1	0	418	ENST00000449399.7	302	1556	++	100	P01009-1#56	0	3	ENST00000449399.7	377	380	+	3	0	-2	3260
P01009-1#56	0	1	1	P01009-1	25	26	+	1	P01009-1	0	418	ENST00000448921.5	573	1827	++	98	P01009-1#56	0	3	ENST00000448921.5	648	651	+	3	0	-2	3261
P01009-1#56	0	1	1	P01009-1	25	26	+	1	P01009-1	0	418	ENST00000440909.5	185	1439	++	91	P01009-1#56	0	3	ENST00000440909.5	260	263	+	3	0	-2	3262
P01009-1#56	0	1	1	P01009-1	25	26	+	1	P01009-1	0	418	ENST00000437397.5	381	1635	++	89	P01009-1#56	0	3	ENST00000437397.5	456	459	+	3	0	-2	3263
P01009-1#56	0	1	1	P01009-1	25	26	+	1	P01009-1	0	418	ENST00000404814.8	311	1565	++	67	P01009-1#56	0	3	ENST00000404814.8	386	389	+	3	0	-2	3264
P01009-1#56	0	1	1	P01009-1	25	26	+	1	P01009-1	0	355	ENST00000402629.1	34	1099	++	66	P01009-1#56	0	3	ENST00000402629.1	109	112	+	3	0	-2	3265
P01009-1#56	0	1	1	P01009-1	25	26	+	1	P01009-1	0	418	ENST00000393088.8	555	1809	++	62	P01009-1#56	0	3	ENST00000393088.8	630	633	+	3	0	-2	3266
P01009-1#56	0	1	1	P01009-1	25	26	+	1	P01009-1	0	418	ENST00000393087.9	47	1301	++	61	P01009-1#56	0	3	ENST00000393087.9	122	125	+	3	0	-2	3267
P01009-1#56	0	1	1	P01009-1	25	26	+	1	P01009-1	0	418	ENST00000355814.8	277	1531	++	37	P01009-1#56	0	3	ENST00000355814.8	352	355	+	3	0	-2	3268
P01009-1#57	0	1	1	P01009-1	38	39	+	1	P01009-1	0	418	ENST00000636712.1	152	1406	++	227	P01009-1#57	0	3	ENST00000636712.1	266	269	+	3	0	-2	3269
P01009-1#57	0	1	1	P01009-1	38	39	+	1	P01009-1	0	144	ENST00000557492.5	517	949	++	169	P01009-1#57	0	3	ENST00000557492.5	631	634	+	3	0	-2	3270
P01009-1#57	0	1	1	P01009-1	38	39	+	1	P01009-1	0	117	ENST00000556955.5	220	571	++	167	P01009-1#57	0	3	ENST00000556955.5	334	337	+	3	0	-2	3271
P01009-1#57	0	1	1	P01009-1	38	39	+	1	P01009-1	0	156	ENST00000556091.1	174	642	++	166	P01009-1#57	0	3	ENST00000556091.1	288	291	+	3	0	-2	3272
P01009-1#57	0	1	1	P01009-1	38	39	+	1	P01009-1	0	92	ENST00000553327.5	303	579	++	164	P01009-1#57	0	3	ENST00000553327.5	417	420	+	3	0	-2	3273
P01009-1#57	0	1	1	P01009-1	38	39	+	1	P01009-1	0	306	ENST00000489769.1	9	927	++	120	P01009-1#57	0	3	ENST00000489769.1	123	126	+	3	0	-2	3274
P01009-1#57	0	1	1	P01009-1	38	39	+	1	P01009-1	0	418	ENST00000449399.7	302	1556	++	100	P01009-1#57	0	3	ENST00000449399.7	416	419	+	3	0	-2	3275
P01009-1#57	0	1	1	P01009-1	38	39	+	1	P01009-1	0	418	ENST00000448921.5	573	1827	++	98	P01009-1#57	0	3	ENST00000448921.5	687	690	+	3	0	-2	3276
P01009-1#57	0	1	1	P01009-1	38	39	+	1	P01009-1	0	418	ENST00000440909.5	185	1439	++	91	P01009-1#57	0	3	ENST00000440909.5	299	302	+	3	0	-2	3277
P01009-1#57	0	1	1	P01009-1	38	39	+	1	P01009-1	0	418	ENST00000437397.5	381	1635	++	89	P01009-1#57	0	3	ENST00000437397.5	495	498	+	3	0	-2	3278
P01009-1#57	0	1	1	P01009-1	38	39	+	1	P01009-1	0	418	ENST00000404814.8	311	1565	++	67	P01009-1#57	0	3	ENST00000404814.8	425	428	+	3	0	-2	3279
P01009-1#57	0	1	1	P01009-1	38	39	+	1	P01009-1	0	355	ENST00000402629.1	34	1099	++	66	P01009-1#57	0	3	ENST00000402629.1	148	151	+	3	0	-2	3280
P01009-1#57	0	1	1	P01009-1	38	39	+	1	P01009-1	0	418	ENST00000393088.8	555	1809	++	62	P01009-1#57	0	3	ENST00000393088.8	669	672	+	3	0	-2	3281
P01009-1#57	0	1	1	P01009-1	38	39	+	1	P01009-1	0	418	ENST00000393087.9	47	1301	++	61	P01009-1#57	0	3	ENST00000393087.9	161	164	+	3	0	-2	3282
P01009-1#57	0	1	1	P01009-1	38	39	+	1	P01009-1	0	418	ENST00000355814.8	277	1531	++	37	P01009-1#57	0	3	ENST00000355814.8	391	394	+	3	0	-2	3283
P01009-1#58	0	1	1	P01009-1	60	61	+	1	P01009-1	0	418	ENST00000636712.1	152	1406	++	227	P01009-1#58	0	3	ENST00000636712.1	332	335	+	3	0	-2	3284
P01009-1#58	0	1	1	P01009-1	60	61	+	1	P01009-1	0	144	ENST00000557492.5	517	949	++	169	P01009-1#58	0	3	ENST00000557492.5	697	700	+	3	0	-2	3285
P01009-1#58	0	1	1	P01009-1	60	61	+	1	P01009-1	0	117	ENST00000556955.5	220	571	++	167	P01009-1#58	0	3	ENST00000556955.5	400	403	+	3	0	-2	3286
P01009-1#58	0	1	1	P01009-1	60	61	+	1	P01009-1	0	156	ENST00000556091.1	174	642	++	166	P01009-1#58	0	3	ENST00000556091.1	354	357	+	3	0	-2	3287
P01009-1#58	0	1	1	P01009-1	60	61	+	1	P01009-1	0	92	ENST00000553327.5	303	579	++	164	P01009-1#58	0	3	ENST00000553327.5	483	486	+	3	0	-2	3288
P01009-1#58	0	1	1	P01009-1	60	61	+	1	P01009-1	0	306	ENST00000489769.1	9	927	++	120	P01009-1#58	0	3	ENST00000489769.1	189	192	+	3	0	-2	3289
P01009-1#58	0	1	1	P01009-1	60	61	+	1	P01009-1	0	418	ENST00000449399.7	302	1556	++	100	P01009-1#58	0	3	ENST00000449399.7	482	485	+	3	0	-2	3290
P01009-1#58	0	1	1	P01009-1	60	61	+	1	P01009-1	0	418	ENST00000448921.5	573	1827	++	98	P01009-1#58	0	3	ENST00000448921.5	753	756	+	3	0	-2	3291
P01009-1#58	0	1	1	P01009-1	60	61	+	1	P01009-1	0	418	ENST00000440909.5	185	1439	++	91	P01009-1#58	0	3	ENST00000440909.5	365	368	+	3	0	-2	3292
P01009-1#58	0	1	1	P01009-1	60	61	+	1	P01009-1	0	418	ENST00000437397.5	381	1635	++	89	P01009-1#58	0	3	ENST00000437397.5	561	564	+	3	0	-2	3293
P01009-1#58	0	1	1	P01009-1	60	61	+	1	P01009-1	0	418	ENST00000404814.8	311	1565	++	67	P01009-1#58	0	3	ENST00000404814.8	491	494	+	3	0	-2	3294
P01009-1#58	0	1	1	P01009-1	60	61	+	1	P01009-1	0	355	ENST00000402629.1	34	1099	++	66	P01009-1#58	0	3	ENST00000402629.1	214	217	+	3	0	-2	3295
P01009-1#58	0	1	1	P01009-1	60	61	+	1	P01009-1	0	418	ENST00000393088.8	555	1809	++	62	P01009-1#58	0	3	ENST00000393088.8	735	738	+	3	0	-2	3296
P01009-1#58	0	1	1	P01009-1	60	61	+	1	P01009-1	0	418	ENST00000393087.9	47	1301	++	61	P01009-1#58	0	3	ENST00000393087.9	227	230	+	3	0	-2	3297
P01009-1#58	0	1	1	P01009-1	60	61	+	1	P01009-1	0	418	ENST00000355814.8	277	1531	++	37	P01009-1#58	0	3	ENST00000355814.8	457	460	+	3	0	-2	3298
P01009-1#59	0	1	1	P01009-1	95	96	+	1	P01009-1	0	418	ENST00000636712.1	152	1406	++	227	P01009-1#59	0	3	ENST00000636712.1	437	440	+	3	0	-2	3299
P01009-1#59	0	1	1	P01009-1	95	96	+	1	P01009-1	0	144	ENST00000557492.5	517	949	++	169	P01009-1#59	0	3	ENST00000557492.5	802	805	+	3	0	-2	3300
P01009-1#59	0	1	1	P01009-1	95	96	+	1	P01009-1	0	117	ENST00000556955.5	220	571	++	167	P01009-1#59	0	3	ENST00000556955.5	505	508	+	3	0	-2	3301
P01009-1#59	0	1	1	P01009-1	95	96	+	1	P01009-1	0	156	ENST00000556091.1	174	642	++	166	P01009-1#59	0	3	ENST00000556091.1	459	462	+	3	0	-2	3302
P01009-1#59	0	1	1	P01009-1	95	96	+	1	P01009-1	86	191	ENST00000554720.1	129	444	++	165	P01009-1#59	0	3	ENST00000554720.1	156	159	+	3	0	-2	3303
P01009-1#59	0	1	1	P01009-1	95	96	+	1	P01009-1	0	306	ENST00000489769.1	9	927	++	120	P01009-1#59	0	3	ENST00000489769.1	294	297	+	3	0	-2	3304
P01009-1#59	0	1	1	P01009-1	95	96	+	1	P01009-1	0	418	ENST00000449399.7	302	1556	++	100	P01009-1#59	0	3	ENST00000449399.7	587	590	+	3	0	-2	3305
P01009-1#59	0	1	1	P01009-1	95	96	+	1	P01009-1	0	418	ENST00000448921.5	573	1827	++	98	P01009-1#59	0	3	ENST00000448921.5	858	861	+	3	0	-2	3306
P01009-1#59	0	1	1	P01009-1	95	96	+	1	P01009-1	0	418	ENST00000440909.5	185	1439	++	91	P01009-1#59	0	3	ENST00000440909.5	470	473	+	3	0	-2	3307
P01009-1#59	0	1	1	P01009-1	95	96	+	1	P01009-1	0	418	ENST00000437397.5	381	1635	++	89	P01009-1#59	0	3	ENST00000437397.5	666	669	+	3	0	-2	3308
P01009-1#59	0	1	1	P01009-1	95	96	+	1	P01009-1	0	418	ENST00000404814.8	311	1565	++	67	P01009-1#59	0	3	ENST00000404814.8	596	599	+	3	0	-2	3309
P01009-1#59	0	1	1	P01009-1	95	96	+	1	P01009-1	0	355	ENST00000402629.1	34	1099	++	66	P01009-1#59	0	3	ENST00000402629.1	319	322	+	3	0	-2	3310
P01009-1#59	0	1	1	P01009-1	95	96	+	1	P01009-1	0	418	ENST00000393088.8	555	1809	++	62	P01009-1#59	0	3	ENST00000393088.8	840	843	+	3	0	-2	3311
P01009-1#59	0	1	1	P01009-1	95	96	+	1	P01009-1	0	418	ENST00000393087.9	47	1301	++	61	P01009-1#59	0	3	ENST00000393087.9	332	335	+	3	0	-2	3312
P01009-1#59	0	1	1	P01009-1	95	96	+	1	P01009-1	0	418	ENST00000355814.8	277	1531	++	37	P01009-1#59	0	3	ENST00000355814.8	562	565	+	3	0	-2	3313
P01009-1#60	0	2	2	P01009-1	138	140	+	2	P01009-1	0	418	ENST00000636712.1	152	1406	++	227	P01009-1#60	0	6	ENST00000636712.1	566	572	+	6	0	-4	3314
P01009-1#60	0	2	2	P01009-1	138	140	+	2	P01009-1	0	144	ENST00000557492.5	517	949	++	169	P01009-1#60	0	6	ENST00000557492.5	931	937	+	6	0	-4	3315
P01009-1#60	0	2	2	P01009-1	138	140	+	2	P01009-1	0	156	ENST00000556091.1	174	642	++	166	P01009-1#60	0	6	ENST00000556091.1	588	594	+	6	0	-4	3316
P01009-1#60	0	2	2	P01009-1	138	140	+	2	P01009-1	86	191	ENST00000554720.1	129	444	++	165	P01009-1#60	0	6	ENST00000554720.1	285	291	+	6	0	-4	3317
P01009-1#60	0	2	2	P01009-1	138	140	+	2	P01009-1	0	306	ENST00000489769.1	9	927	++	120	P01009-1#60	0	6	ENST00000489769.1	423	429	+	6	0	-4	3318
P01009-1#60	0	2	2	P01009-1	138	140	+	2	P01009-1	0	418	ENST00000449399.7	302	1556	++	100	P01009-1#60	0	6	ENST00000449399.7	716	722	+	6	0	-4	3319
P01009-1#60	0	2	2	P01009-1	138	140	+	2	P01009-1	0	418	ENST00000448921.5	573	1827	++	98	P01009-1#60	0	6	ENST00000448921.5	987	993	+	6	0	-4	3320
P01009-1#60	0	2	2	P01009-1	138	140	+	2	P01009-1	0	418	ENST00000440909.5	185	1439	++	91	P01009-1#60	0	6	ENST00000440909.5	599	605	+	6	0	-4	3321
P01009-1#60	0	2	2	P01009-1	138	140	+	2	P01009-1	0	418	ENST00000437397.5	381	1635	++	89	P01009-1#60	0	6	ENST00000437397.5	795	801	+	6	0	-4	3322
P01009-1#60	0	2	2	P01009-1	138	140	+	2	P01009-1	0	418	ENST00000404814.8	311	1565	++	67	P01009-1#60	0	6	ENST00000404814.8	725	731	+	6	0	-4	3323
P01009-1#60	0	2	2	P01009-1	138	140	+	2	P01009-1	0	355	ENST00000402629.1	34	1099	++	66	P01009-1#60	0	6	ENST00000402629.1	448	454	+	6	0	-4	3324
P01009-1#60	0	2	2	P01009-1	138	140	+	2	P01009-1	0	418	ENST00000393088.8	555	1809	++	62	P01009-1#60	0	6	ENST00000393088.8	969	975	+	6	0	-4	3325
P01009-1#60	0	2	2	P01009-1	138	140	+	2	P01009-1	0	418	ENST00000393087.9	47	1301	++	61	P01009-1#60	0	6	ENST00000393087.9	461	467	+	6	0	-4	3326
P01009-1#60	0	2	2	P01009-1	138	140	+	2	P01009-1	0	418	ENST00000355814.8	277	1531	++	37	P01009-1#60	0	6	ENST00000355814.8	691	697	+	6	0	-4	3327
P01009-1#61	0	1	1	P01009-1	173	174	+	1	P01009-1	0	418	ENST00000636712.1	152	1406	++	227	P01009-1#61	0	3	ENST00000636712.1	671	674	+	3	0	-2	3328
P01009-1#61	0	1	1	P01009-1	173	174	+	1	P01009-1	86	191	ENST00000554720.1	129	444	++	165	P01009-1#61	0	3	ENST00000554720.1	390	393	+	3	0	-2	3329
P01009-1#61	0	1	1	P01009-1	173	174	+	1	P01009-1	0	306	ENST00000489769.1	9	927	++	120	P01009-1#61	0	3	ENST00000489769.1	528	531	+	3	0	-2	3330
P01009-1#61	0	1	1	P01009-1	173	174	+	1	P01009-1	0	418	ENST00000449399.7	302	1556	++	100	P01009-1#61	0	3	ENST00000449399.7	821	824	+	3	0	-2	3331
P01009-1#61	0	1	1	P01009-1	173	174	+	1	P01009-1	0	418	ENST00000448921.5	573	1827	++	98	P01009-1#61	0	3	ENST00000448921.5	1092	1095	+	3	0	-2	3332
P01009-1#61	0	1	1	P01009-1	173	174	+	1	P01009-1	0	418	ENST00000440909.5	185	1439	++	91	P01009-1#61	0	3	ENST00000440909.5	704	707	+	3	0	-2	3333
P01009-1#61	0	1	1	P01009-1	173	174	+	1	P01009-1	0	418	ENST00000437397.5	381	1635	++	89	P01009-1#61	0	3	ENST00000437397.5	900	903	+	3	0	-2	3334
P01009-1#61	0	1	1	P01009-1	173	174	+	1	P01009-1	0	418	ENST00000404814.8	311	1565	++	67	P01009-1#61	0	3	ENST00000404814.8	830	833	+	3	0	-2	3335
P01009-1#61	0	1	1	P01009-1	173	174	+	1	P01009-1	0	355	ENST00000402629.1	34	1099	++	66	P01009-1#61	0	3	ENST00000402629.1	553	556	+	3	0	-2	3336
P01009-1#61	0	1	1	P01009-1	173	174	+	1	P01009-1	0	418	ENST00000393088.8	555	1809	++	62	P01009-1#61	0	3	ENST00000393088.8	1074	1077	+	3	0	-2	3337
P01009-1#61	0	1	1	P01009-1	173	174	+	1	P01009-1	0	418	ENST00000393087.9	47	1301	++	61	P01009-1#61	0	3	ENST00000393087.9	566	569	+	3	0	-2	3338
P01009-1#61	0	1	1	P01009-1	173	174	+	1	P01009-1	0	418	ENST00000355814.8	277	1531	++	37	P01009-1#61	0	3	ENST00000355814.8	796	799	+	3	0	-2	3339
P01009-1#62	0	1	1	P01009-1	228	229	+	1	P01009-1	0	418	ENST00000636712.1	152	1406	++	227	P01009-1#62	0	3	ENST00000636712.1	836	839	+	3	0	-2	3340
P01009-1#62	0	1	1	P01009-1	228	229	+	1	P01009-1	0	306	ENST00000489769.1	9	927	++	120	P01009-1#62	0	3	ENST00000489769.1	693	696	+	3	0	-2	3341
P01009-1#62	0	1	1	P01009-1	228	229	+	1	P01009-1	0	418	ENST00000449399.7	302	1556	++	100	P01009-1#62	0	3	ENST00000449399.7	986	989	+	3	0	-2	3342
P01009-1#62	0	1	1	P01009-1	228	229	+	1	P01009-1	0	418	ENST00000448921.5	573	1827	++	98	P01009-1#62	0	3	ENST00000448921.5	1257	1260	+	3	0	-2	3343
P01009-1#62	0	1	1	P01009-1	228	229	+	1	P01009-1	0	418	ENST00000440909.5	185	1439	++	91	P01009-1#62	0	3	ENST00000440909.5	869	872	+	3	0	-2	3344
P01009-1#62	0	1	1	P01009-1	228	229	+	1	P01009-1	0	418	ENST00000437397.5	381	1635	++	89	P01009-1#62	0	3	ENST00000437397.5	1065	1068	+	3	0	-2	3345
P01009-1#62	0	1	1	P01009-1	228	229	+	1	P01009-1	0	418	ENST00000404814.8	311	1565	++	67	P01009-1#62	0	3	ENST00000404814.8	995	998	+	3	0	-2	3346
P01009-1#62	0	1	1	P01009-1	228	229	+	1	P01009-1	0	355	ENST00000402629.1	34	1099	++	66	P01009-1#62	0	3	ENST00000402629.1	718	721	+	3	0	-2	3347
P01009-1#62	0	1	1	P01009-1	228	229	+	1	P01009-1	0	418	ENST00000393088.8	555	1809	++	62	P01009-1#62	0	3	ENST00000393088.8	1239	1242	+	3	0	-2	3348
P01009-1#62	0	1	1	P01009-1	228	229	+	1	P01009-1	0	418	ENST00000393087.9	47	1301	++	61	P01009-1#62	0	3	ENST00000393087.9	731	734	+	3	0	-2	3349
P01009-1#62	0	1	1	P01009-1	228	229	+	1	P01009-1	0	418	ENST00000355814.8	277	1531	++	37	P01009-1#62	0	3	ENST00000355814.8	961	964	+	3	0	-2	3350
P01009-1#63	0	1	1	P01009-1	272	273	+	1	P01009-1	0	418	ENST00000636712.1	152	1406	++	227	P01009-1#63	0	3	ENST00000636712.1	968	971	+	3	0	-2	3351
P01009-1#63	0	1	1	P01009-1	272	273	+	1	P01009-1	0	306	ENST00000489769.1	9	927	++	120	P01009-1#63	0	3	ENST00000489769.1	825	828	+	3	0	-2	3352
P01009-1#63	0	1	1	P01009-1	272	273	+	1	P01009-1	0	418	ENST00000449399.7	302	1556	++	100	P01009-1#63	0	3	ENST00000449399.7	1118	1121	+	3	0	-2	3353
P01009-1#63	0	1	1	P01009-1	272	273	+	1	P01009-1	0	418	ENST00000448921.5	573	1827	++	98	P01009-1#63	0	3	ENST00000448921.5	1389	1392	+	3	0	-2	3354
P01009-1#63	0	1	1	P01009-1	272	273	+	1	P01009-1	0	418	ENST00000440909.5	185	1439	++	91	P01009-1#63	0	3	ENST00000440909.5	1001	1004	+	3	0	-2	3355
P01009-1#63	0	1	1	P01009-1	272	273	+	1	P01009-1	0	418	ENST00000437397.5	381	1635	++	89	P01009-1#63	0	3	ENST00000437397.5	1197	1200	+	3	0	-2	3356
P01009-1#63	0	1	1	P01009-1	272	273	+	1	P01009-1	0	418	ENST00000404814.8	311	1565	++	67	P01009-1#63	0	3	ENST00000404814.8	1127	1130	+	3	0	-2	3357
P01009-1#63	0	1	1	P01009-1	272	273	+	1	P01009-1	0	355	ENST00000402629.1	34	1099	++	66	P01009-1#63	0	3	ENST00000402629.1	850	853	+	3	0	-2	3358
P01009-1#63	0	1	1	P01009-1	272	273	+	1	P01009-1	0	418	ENST00000393088.8	555	1809	++	62	P01009-1#63	0	3	ENST00000393088.8	1371	1374	+	3	0	-2	3359
P01009-1#63	0	1	1	P01009-1	272	273	+	1	P01009-1	0	418	ENST00000393087.9	47	1301	++	61	P01009-1#63	0	3	ENST00000393087.9	863	866	+	3	0	-2	3360
P01009-1#63	0	1	1	P01009-1	272	273	+	1	P01009-1	0	418	ENST00000355814.8	277	1531	++	37	P01009-1#63	0	3	ENST00000355814.8	1093	1096	+	3	0	-2	3361
P01009-1#64	0	1	1	P01009-1	279	280	+	1	P01009-1	0	418	ENST00000636712.1	152	1406	++	227	P01009-1#64	0	3	ENST00000636712.1	989	992	+	3	0	-2	3362
P01009-1#64	0	1	1	P01009-1	279	280	+	1	P01009-1	0	306	ENST00000489769.1	9	927	++	120	P01009-1#64	0	3	ENST00000489769.1	846	849	+	3	0	-2	3363
P01009-1#64	0	1	1	P01009-1	279	280	+	1	P01009-1	0	418	ENST00000449399.7	302	1556	++	100	P01009-1#64	0	3	ENST00000449399.7	1139	1142	+	3	0	-2	3364
P01009-1#64	0	1	1	P01009-1	279	280	+	1	P01009-1	0	418	ENST00000448921.5	573	1827	++	98	P01009-1#64	0	3	ENST00000448921.5	1410	1413	+	3	0	-2	3365
P01009-1#64	0	1	1	P01009-1	279	280	+	1	P01009-1	0	418	ENST00000440909.5	185	1439	++	91	P01009-1#64	0	3	ENST00000440909.5	1022	1025	+	3	0	-2	3366
P01009-1#64	0	1	1	P01009-1	279	280	+	1	P01009-1	0	418	ENST00000437397.5	381	1635	++	89	P01009-1#64	0	3	ENST00000437397.5	1218	1221	+	3	0	-2	3367
P01009-1#64	0	1	1	P01009-1	279	280	+	1	P01009-1	0	418	ENST00000404814.8	311	1565	++	67	P01009-1#64	0	3	ENST00000404814.8	1148	1151	+	3	0	-2	3368
P01009-1#64	0	1	1	P01009-1	279	280	+	1	P01009-1	0	355	ENST00000402629.1	34	1099	++	66	P01009-1#64	0	3	ENST00000402629.1	871	874	+	3	0	-2	3369
P01009-1#64	0	1	1	P01009-1	279	280	+	1	P01009-1	0	418	ENST00000393088.8	555	1809	++	62	P01009-1#64	0	3	ENST00000393088.8	1392	1395	+	3	0	-2	3370
P01009-1#64	0	1	1	P01009-1	279	280	+	1	P01009-1	0	418	ENST00000393087.9	47	1301	++	61	P01009-1#64	0	3	ENST00000393087.9	884	887	+	3	0	-2	3371
P01009-1#64	0	1	1	P01009-1	279	280	+	1	P01009-1	0	418	ENST00000355814.8	277	1531	++	37	P01009-1#64	0	3	ENST00000355814.8	1114	1117	+	3	0	-2	3372
P01009-1#65	0	1	1	P01009-1	325	326	+	1	P01009-1	0	418	ENST00000636712.1	152	1406	++	227	P01009-1#65	0	3	ENST00000636712.1	1127	1130	+	3	0	-2	3373
P01009-1#65	0	1	1	P01009-1	325	326	+	1	P01009-1	0	418	ENST00000449399.7	302	1556	++	100	P01009-1#65	0	3	ENST00000449399.7	1277	1280	+	3	0	-2	3374
P01009-1#65	0	1	1	P01009-1	325	326	+	1	P01009-1	0	418	ENST00000448921.5	573	1827	++	98	P01009-1#65	0	3	ENST00000448921.5	1548	1551	+	3	0	-2	3375
P01009-1#65	0	1	1	P01009-1	325	326	+	1	P01009-1	0	418	ENST00000440909.5	185	1439	++	91	P01009-1#65	0	3	ENST00000440909.5	1160	1163	+	3	0	-2	3376
P01009-1#65	0	1	1	P01009-1	325	326	+	1	P01009-1	0	418	ENST00000437397.5	381	1635	++	89	P01009-1#65	0	3	ENST00000437397.5	1356	1359	+	3	0	-2	3377
P01009-1#65	0	1	1	P01009-1	325	326	+	1	P01009-1	0	418	ENST00000404814.8	311	1565	++	67	P01009-1#65	0	3	ENST00000404814.8	1286	1289	+	3	0	-2	3378
P01009-1#65	0	1	1	P01009-1	325	326	+	1	P01009-1	0	355	ENST00000402629.1	34	1099	++	66	P01009-1#65	0	3	ENST00000402629.1	1009	1012	+	3	0	-2	3379
P01009-1#65	0	1	1	P01009-1	325	326	+	1	P01009-1	0	418	ENST00000393088.8	555	1809	++	62	P01009-1#65	0	3	ENST00000393088.8	1530	1533	+	3	0	-2	3380
P01009-1#65	0	1	1	P01009-1	325	326	+	1	P01009-1	0	418	ENST00000393087.9	47	1301	++	61	P01009-1#65	0	3	ENST00000393087.9	1022	1025	+	3	0	-2	3381
P01009-1#65	0	1	1	P01009-1	325	326	+	1	P01009-1	0	418	ENST00000355814.8	277	1531	++	37	P01009-1#65	0	3	ENST00000355814.8	1252	1255	+	3	0	-2	3382
P01009-1#66	0	1	1	P01009-1	409	410	+	1	P01009-1	0	418	ENST00000636712.1	152	1406	++	227	P01009-1#66	0	3	ENST00000636712.1	1379	1382	+	3	0	-2	3383
P01009-1#66	0	1	1	P01009-1	409	410	+	1	P01009-1	0	418	ENST00000449399.7	302	1556	++	100	P01009-1#66	0	3	ENST00000449399.7	1529	1532	+	3	0	-2	3384
P01009-1#66	0	1	1	P01009-1	409	410	+	1	P01009-1	0	418	ENST00000448921.5	573	1827	++	98	P01009-1#66	0	3	ENST00000448921.5	1800	1803	+	3	0	-2	3385
P01009-1#66	0	1	1	P01009-1	409	410	+	1	P01009-1	0	418	ENST00000440909.5	185	1439	++	91	P01009-1#66	0	3	ENST00000440909.5	1412	1415	+	3	0	-2	3386
P01009-1#66	0	1	1	P01009-1	409	410	+	1	P01009-1	0	418	ENST00000437397.5	381	1635	++	89	P01009-1#66	0	3	ENST00000437397.5	1608	1611	+	3	0	-2	3387
P01009-1#66	0	1	1	P01009-1	409	410	+	1	P01009-1	0	418	ENST00000404814.8	311	1565	++	67	P01009-1#66	0	3	ENST00000404814.8	1538	1541	+	3	0	-2	3388
P01009-1#66	0	1	1	P01009-1	409	410	+	1	P01009-1	0	418	ENST00000393088.8	555	1809	++	62	P01009-1#66	0	3	ENST00000393088.8	1782	1785	+	3	0	-2	3389
P01009-1#66	0	1	1	P01009-1	409	410	+	1	P01009-1	0	418	ENST00000393087.9	47	1301	++	61	P01009-1#66	0	3	ENST00000393087.9	1274	1277	+	3	0	-2	3390
P01009-1#66	0	1	1	P01009-1	409	410	+	1	P01009-1	0	418	ENST00000355814.8	277	1531	++	37	P01009-1#66	0	3	ENST00000355814.8	1504	1507	+	3	0	-2	3391
P01009-1#67	0	1	1	P01009-1	413	414	+	1	P01009-1	0	418	ENST00000636712.1	152	1406	++	227	P01009-1#67	0	3	ENST00000636712.1	1391	1394	+	3	0	-2	3392
P01009-1#67	0	1	1	P01009-1	413	414	+	1	P01009-1	0	418	ENST00000449399.7	302	1556	++	100	P01009-1#67	0	3	ENST00000449399.7	1541	1544	+	3	0	-2	3393
P01009-1#67	0	1	1	P01009-1	413	414	+	1	P01009-1	0	418	ENST00000448921.5	573	1827	++	98	P01009-1#67	0	3	ENST00000448921.5	1812	1815	+	3	0	-2	3394
P01009-1#67	0	1	1	P01009-1	413	414	+	1	P01009-1	0	418	ENST00000440909.5	185	1439	++	91	P01009-1#67	0	3	ENST00000440909.5	1424	1427	+	3	0	-2	3395
P01009-1#67	0	1	1	P01009-1	413	414	+	1	P01009-1	0	418	ENST00000437397.5	381	1635	++	89	P01009-1#67	0	3	ENST00000437397.5	1620	1623	+	3	0	-2	3396
P01009-1#67	0	1	1	P01009-1	413	414	+	1	P01009-1	0	418	ENST00000404814.8	311	1565	++	67	P01009-1#67	0	3	ENST00000404814.8	1550	1553	+	3	0	-2	3397
P01009-1#67	0	1	1	P01009-1	413	414	+	1	P01009-1	0	418	ENST00000393088.8	555	1809	++	62	P01009-1#67	0	3	ENST00000393088.8	1794	1797	+	3	0	-2	3398
P01009-1#67	0	1	1	P01009-1	413	414	+	1	P01009-1	0	418	ENST00000393087.9	47	1301	++	61	P01009-1#67	0	3	ENST00000393087.9	1286	1289	+	3	0	-2	3399
P01009-1#67	0	1	1	P01009-1	413	414	+	1	P01009-1	0	418	ENST00000355814.8	277	1531	++	37	P01009-1#67	0	3	ENST00000355814.8	1516	1519	+	3	0	-2	3400
P01009-1#68	0	3	3	P01009-1	47	50	+	3	P01009-1	0	418	ENST00000636712.1	152	1406	++	227	P01009-1#68	0	9	ENST00000636712.1	293	302	+	9	0	-6	3401
P01009-1#68	0	3	3	P01009-1	47	50	+	3	P01009-1	0	144	ENST00000557492.5	517	949	++	169	P01009-1#68	0	9	ENST00000557492.5	658	667	+	9	0	-6	3402
P01009-1#68	0	3	3	P01009-1	47	50	+	3	P01009-1	0	117	ENST00000556955.5	220	571	++	167	P01009-1#68	0	9	ENST00000556955.5	361	370	+	9	0	-6	3403
P01009-1#68	0	3	3	P01009-1	47	50	+	3	P01009-1	0	156	ENST00000556091.1	174	642	++	166	P01009-1#68	0	9	ENST00000556091.1	315	324	+	9	0	-6	3404
P01009-1#68	0	3	3	P01009-1	47	50	+	3	P01009-1	0	92	ENST00000553327.5	303	579	++	164	P01009-1#68	0	9	ENST00000553327.5	444	453	+	9	0	-6	3405
P01009-1#68	0	3	3	P01009-1	47	50	+	3	P01009-1	0	306	ENST00000489769.1	9	927	++	120	P01009-1#68	0	9	ENST00000489769.1	150	159	+	9	0	-6	3406
P01009-1#68	0	3	3	P01009-1	47	50	+	3	P01009-1	0	418	ENST00000449399.7	302	1556	++	100	P01009-1#68	0	9	ENST00000449399.7	443	452	+	9	0	-6	3407
P01009-1#68	0	3	3	P01009-1	47	50	+	3	P01009-1	0	418	ENST00000448921.5	573	1827	++	98	P01009-1#68	0	9	ENST00000448921.5	714	723	+	9	0	-6	3408
P01009-1#68	0	3	3	P01009-1	47	50	+	3	P01009-1	0	418	ENST00000440909.5	185	1439	++	91	P01009-1#68	0	9	ENST00000440909.5	326	335	+	9	0	-6	3409
P01009-1#68	0	3	3	P01009-1	47	50	+	3	P01009-1	0	418	ENST00000437397.5	381	1635	++	89	P01009-1#68	0	9	ENST00000437397.5	522	531	+	9	0	-6	3410
P01009-1#68	0	3	3	P01009-1	47	50	+	3	P01009-1	0	418	ENST00000404814.8	311	1565	++	67	P01009-1#68	0	9	ENST00000404814.8	452	461	+	9	0	-6	3411
P01009-1#68	0	3	3	P01009-1	47	50	+	3	P01009-1	0	355	ENST00000402629.1	34	1099	++	66	P01009-1#68	0	9	ENST00000402629.1	175	184	+	9	0	-6	3412
P01009-1#68	0	3	3	P01009-1	47	50	+	3	P01009-1	0	418	ENST00000393088.8	555	1809	++	62	P01009-1#68	0	9	ENST00000393088.8	696	705	+	9	0	-6	3413
P01009-1#68	0	3	3	P01009-1	47	50	+	3	P01009-1	0	418	ENST00000393087.9	47	1301	++	61	P01009-1#68	0	9	ENST00000393087.9	188	197	+	9	0	-6	3414
P01009-1#68	0	3	3	P01009-1	47	50	+	3	P01009-1	0	418	ENST00000355814.8	277	1531	++	37	P01009-1#68	0	9	ENST00000355814.8	418	427	+	9	0	-6	3415
P01009-1#69	0	18	18	P01009-1	50	68	+	18	P01009-1	0	418	ENST00000636712.1	152	1406	++	227	P01009-1#69	0	54	ENST00000636712.1	302	356	+	54	0	-36	3416
P01009-1#69	0	18	18	P01009-1	50	68	+	18	P01009-1	0	144	ENST00000557492.5	517	949	++	169	P01009-1#69	0	54	ENST00000557492.5	667	721	+	54	0	-36	3417
P01009-1#69	0	18	18	P01009-1	50	68	+	18	P01009-1	0	117	ENST00000556955.5	220	571	++	167	P01009-1#69	0	54	ENST00000556955.5	370	424	+	54	0	-36	3418
P01009-1#69	0	18	18	P01009-1	50	68	+	18	P01009-1	0	156	ENST00000556091.1	174	642	++	166	P01009-1#69	0	54	ENST00000556091.1	324	378	+	54	0	-36	3419
P01009-1#69	0	18	18	P01009-1	50	68	+	18	P01009-1	0	92	ENST00000553327.5	303	579	++	164	P01009-1#69	0	54	ENST00000553327.5	453	507	+	54	0	-36	3420
P01009-1#69	0	18	18	P01009-1	50	68	+	18	P01009-1	0	306	ENST00000489769.1	9	927	++	120	P01009-1#69	0	54	ENST00000489769.1	159	213	+	54	0	-36	3421
P01009-1#69	0	18	18	P01009-1	50	68	+	18	P01009-1	0	418	ENST00000449399.7	302	1556	++	100	P01009-1#69	0	54	ENST00000449399.7	452	506	+	54	0	-36	3422
P01009-1#69	0	18	18	P01009-1	50	68	+	18	P01009-1	0	418	ENST00000448921.5	573	1827	++	98	P01009-1#69	0	54	ENST00000448921.5	723	777	+	54	0	-36	3423
P01009-1#69	0	18	18	P01009-1	50	68	+	18	P01009-1	0	418	ENST00000440909.5	185	1439	++	91	P01009-1#69	0	54	ENST00000440909.5	335	389	+	54	0	-36	3424
P01009-1#69	0	18	18	P01009-1	50	68	+	18	P01009-1	0	418	ENST00000437397.5	381	1635	++	89	P01009-1#69	0	54	ENST00000437397.5	531	585	+	54	0	-36	3425
P01009-1#69	0	18	18	P01009-1	50	68	+	18	P01009-1	0	418	ENST00000404814.8	311	1565	++	67	P01009-1#69	0	54	ENST00000404814.8	461	515	+	54	0	-36	3426
P01009-1#69	0	18	18	P01009-1	50	68	+	18	P01009-1	0	355	ENST00000402629.1	34	1099	++	66	P01009-1#69	0	54	ENST00000402629.1	184	238	+	54	0	-36	3427
P01009-1#69	0	18	18	P01009-1	50	68	+	18	P01009-1	0	418	ENST00000393088.8	555	1809	++	62	P01009-1#69	0	54	ENST00000393088.8	705	759	+	54	0	-36	3428
P01009-1#69	0	18	18	P01009-1	50	68	+	18	P01009-1	0	418	ENST00000393087.9	47	1301	++	61	P01009-1#69	0	54	ENST00000393087.9	197	251	+	54	0	-36	3429
P01009-1#69	0	18	18	P01009-1	50	68	+	18	P01009-1	0	418	ENST00000355814.8	277	1531	++	37	P01009-1#69	0	54	ENST00000355814.8	427	481	+	54	0	-36	3430
P01009-1#70	0	3	3	P01009-1	69	72	+	3	P01009-1	0	418	ENST00000636712.1	152	1406	++	227	P01009-1#70	0	9	ENST00000636712.1	359	368	+	9	0	-6	3431
P01009-1#70	0	3	3	P01009-1	69	72	+	3	P01009-1	0	144	ENST00000557492.5	517	949	++	169	P01009-1#70	0	9	ENST00000557492.5	724	733	+	9	0	-6	3432
P01009-1#70	0	3	3	P01009-1	69	72	+	3	P01009-1	0	117	ENST00000556955.5	220	571	++	167	P01009-1#70	0	9	ENST00000556955.5	427	436	+	9	0	-6	3433
P01009-1#70	0	3	3	P01009-1	69	72	+	3	P01009-1	0	156	ENST00000556091.1	174	642	++	166	P01009-1#70	0	9	ENST00000556091.1	381	390	+	9	0	-6	3434
P01009-1#70	0	3	3	P01009-1	69	72	+	3	P01009-1	0	92	ENST00000553327.5	303	579	++	164	P01009-1#70	0	9	ENST00000553327.5	510	519	+	9	0	-6	3435
P01009-1#70	0	3	3	P01009-1	69	72	+	3	P01009-1	0	306	ENST00000489769.1	9	927	++	120	P01009-1#70	0	9	ENST00000489769.1	216	225	+	9	0	-6	3436
P01009-1#70	0	3	3	P01009-1	69	72	+	3	P01009-1	0	418	ENST00000449399.7	302	1556	++	100	P01009-1#70	0	9	ENST00000449399.7	509	518	+	9	0	-6	3437
P01009-1#70	0	3	3	P01009-1	69	72	+	3	P01009-1	0	418	ENST00000448921.5	573	1827	++	98	P01009-1#70	0	9	ENST00000448921.5	780	789	+	9	0	-6	3438
P01009-1#70	0	3	3	P01009-1	69	72	+	3	P01009-1	0	418	ENST00000440909.5	185	1439	++	91	P01009-1#70	0	9	ENST00000440909.5	392	401	+	9	0	-6	3439
P01009-1#70	0	3	3	P01009-1	69	72	+	3	P01009-1	0	418	ENST00000437397.5	381	1635	++	89	P01009-1#70	0	9	ENST00000437397.5	588	597	+	9	0	-6	3440
P01009-1#70	0	3	3	P01009-1	69	72	+	3	P01009-1	0	418	ENST00000404814.8	311	1565	++	67	P01009-1#70	0	9	ENST00000404814.8	518	527	+	9	0	-6	3441
P01009-1#70	0	3	3	P01009-1	69	72	+	3	P01009-1	0	355	ENST00000402629.1	34	1099	++	66	P01009-1#70	0	9	ENST00000402629.1	241	250	+	9	0	-6	3442
P01009-1#70	0	3	3	P01009-1	69	72	+	3	P01009-1	0	418	ENST00000393088.8	555	1809	++	62	P01009-1#70	0	9	ENST00000393088.8	762	771	+	9	0	-6	3443
P01009-1#70	0	3	3	P01009-1	69	72	+	3	P01009-1	0	418	ENST00000393087.9	47	1301	++	61	P01009-1#70	0	9	ENST00000393087.9	254	263	+	9	0	-6	3444
P01009-1#70	0	3	3	P01009-1	69	72	+	3	P01009-1	0	418	ENST00000355814.8	277	1531	++	37	P01009-1#70	0	9	ENST00000355814.8	484	493	+	9	0	-6	3445
P01009-1#71	0	3	3	P01009-1	73	76	+	3	P01009-1	0	418	ENST00000636712.1	152	1406	++	227	P01009-1#71	0	9	ENST00000636712.1	371	380	+	9	0	-6	3446
P01009-1#71	0	3	3	P01009-1	73	76	+	3	P01009-1	0	144	ENST00000557492.5	517	949	++	169	P01009-1#71	0	9	ENST00000557492.5	736	745	+	9	0	-6	3447
P01009-1#71	0	3	3	P01009-1	73	76	+	3	P01009-1	0	117	ENST00000556955.5	220	571	++	167	P01009-1#71	0	9	ENST00000556955.5	439	448	+	9	0	-6	3448
P01009-1#71	0	3	3	P01009-1	73	76	+	3	P01009-1	0	156	ENST00000556091.1	174	642	++	166	P01009-1#71	0	9	ENST00000556091.1	393	402	+	9	0	-6	3449
P01009-1#71	0	3	3	P01009-1	73	76	+	3	P01009-1	0	92	ENST00000553327.5	303	579	++	164	P01009-1#71	0	9	ENST00000553327.5	522	531	+	9	0	-6	3450
P01009-1#71	0	3	3	P01009-1	73	76	+	3	P01009-1	0	306	ENST00000489769.1	9	927	++	120	P01009-1#71	0	9	ENST00000489769.1	228	237	+	9	0	-6	3451
P01009-1#71	0	3	3	P01009-1	73	76	+	3	P01009-1	0	418	ENST00000449399.7	302	1556	++	100	P01009-1#71	0	9	ENST00000449399.7	521	530	+	9	0	-6	3452
P01009-1#71	0	3	3	P01009-1	73	76	+	3	P01009-1	0	418	ENST00000448921.5	573	1827	++	98	P01009-1#71	0	9	ENST00000448921.5	792	801	+	9	0	-6	3453
P01009-1#71	0	3	3	P01009-1	73	76	+	3	P01009-1	0	418	ENST00000440909.5	185	1439	++	91	P01009-1#71	0	9	ENST00000440909.5	404	413	+	9	0	-6	3454
P01009-1#71	0	3	3	P01009-1	73	76	+	3	P01009-1	0	418	ENST00000437397.5	381	1635	++	89	P01009-1#71	0	9	ENST00000437397.5	600	609	+	9	0	-6	3455
P01009-1#71	0	3	3	P01009-1	73	76	+	3	P01009-1	0	418	ENST00000404814.8	311	1565	++	67	P01009-1#71	0	9	ENST00000404814.8	530	539	+	9	0	-6	3456
P01009-1#71	0	3	3	P01009-1	73	76	+	3	P01009-1	0	355	ENST00000402629.1	34	1099	++	66	P01009-1#71	0	9	ENST00000402629.1	253	262	+	9	0	-6	3457
P01009-1#71	0	3	3	P01009-1	73	76	+	3	P01009-1	0	418	ENST00000393088.8	555	1809	++	62	P01009-1#71	0	9	ENST00000393088.8	774	783	+	9	0	-6	3458
P01009-1#71	0	3	3	P01009-1	73	76	+	3	P01009-1	0	418	ENST00000393087.9	47	1301	++	61	P01009-1#71	0	9	ENST00000393087.9	266	275	+	9	0	-6	3459
P01009-1#71	0	3	3	P01009-1	73	76	+	3	P01009-1	0	418	ENST00000355814.8	277	1531	++	37	P01009-1#71	0	9	ENST00000355814.8	496	505	+	9	0	-6	3460
P01009-1#72	0	12	12	P01009-1	77	89	+	12	P01009-1	0	418	ENST00000636712.1	152	1406	++	227	P01009-1#72	0	36	ENST00000636712.1	383	419	+	36	0	-24	3461
P01009-1#72	0	12	12	P01009-1	77	89	+	12	P01009-1	0	144	ENST00000557492.5	517	949	++	169	P01009-1#72	0	36	ENST00000557492.5	748	784	+	36	0	-24	3462
P01009-1#72	0	12	12	P01009-1	77	89	+	12	P01009-1	0	117	ENST00000556955.5	220	571	++	167	P01009-1#72	0	36	ENST00000556955.5	451	487	+	36	0	-24	3463
P01009-1#72	0	12	12	P01009-1	77	89	+	12	P01009-1	0	156	ENST00000556091.1	174	642	++	166	P01009-1#72	0	36	ENST00000556091.1	405	441	+	36	0	-24	3464
P01009-1#72	0	12	12	P01009-1	77	89	+	12	P01009-1	86	191	ENST00000554720.1	129	444	++	165	P01009-1#72	27	36	ENST00000554720.1	129	138	+	9	27	-24	3465
P01009-1#72	0	12	12	P01009-1	77	89	+	12	P01009-1	0	92	ENST00000553327.5	303	579	++	164	P01009-1#72	0	36	ENST00000553327.5	534	570	+	36	0	-24	3466
P01009-1#72	0	12	12	P01009-1	77	89	+	12	P01009-1	0	306	ENST00000489769.1	9	927	++	120	P01009-1#72	0	36	ENST00000489769.1	240	276	+	36	0	-24	3467
P01009-1#72	0	12	12	P01009-1	77	89	+	12	P01009-1	0	418	ENST00000449399.7	302	1556	++	100	P01009-1#72	0	36	ENST00000449399.7	533	569	+	36	0	-24	3468
P01009-1#72	0	12	12	P01009-1	77	89	+	12	P01009-1	0	418	ENST00000448921.5	573	1827	++	98	P01009-1#72	0	36	ENST00000448921.5	804	840	+	36	0	-24	3469
P01009-1#72	0	12	12	P01009-1	77	89	+	12	P01009-1	0	418	ENST00000440909.5	185	1439	++	91	P01009-1#72	0	36	ENST00000440909.5	416	452	+	36	0	-24	3470
P01009-1#72	0	12	12	P01009-1	77	89	+	12	P01009-1	0	418	ENST00000437397.5	381	1635	++	89	P01009-1#72	0	36	ENST00000437397.5	612	648	+	36	0	-24	3471
P01009-1#72	0	12	12	P01009-1	77	89	+	12	P01009-1	0	418	ENST00000404814.8	311	1565	++	67	P01009-1#72	0	36	ENST00000404814.8	542	578	+	36	0	-24	3472
P01009-1#72	0	12	12	P01009-1	77	89	+	12	P01009-1	0	355	ENST00000402629.1	34	1099	++	66	P01009-1#72	0	36	ENST00000402629.1	265	301	+	36	0	-24	3473
P01009-1#72	0	12	12	P01009-1	77	89	+	12	P01009-1	0	418	ENST00000393088.8	555	1809	++	62	P01009-1#72	0	36	ENST00000393088.8	786	822	+	36	0	-24	3474
P01009-1#72	0	12	12	P01009-1	77	89	+	12	P01009-1	0	418	ENST00000393087.9	47	1301	++	61	P01009-1#72	0	36	ENST00000393087.9	278	314	+	36	0	-24	3475
P01009-1#72	0	12	12	P01009-1	77	89	+	12	P01009-1	0	418	ENST00000355814.8	277	1531	++	37	P01009-1#72	0	36	ENST00000355814.8	508	544	+	36	0	-24	3476
P01009-1#73	0	10	10	P01009-1	93	103	+	10	P01009-1	0	418	ENST00000636712.1	152	1406	++	227	P01009-1#73	0	30	ENST00000636712.1	431	461	+	30	0	-20	3477
P01009-1#73	0	10	10	P01009-1	93	103	+	10	P01009-1	0	144	ENST00000557492.5	517	949	++	169	P01009-1#73	0	30	ENST00000557492.5	796	826	+	30	0	-20	3478
P01009-1#73	0	10	10	P01009-1	93	103	+	10	P01009-1	0	117	ENST00000556955.5	220	571	++	167	P01009-1#73	0	30	ENST00000556955.5	499	529	+	30	0	-20	3479
P01009-1#73	0	10	10	P01009-1	93	103	+	10	P01009-1	0	156	ENST00000556091.1	174	642	++	166	P01009-1#73	0	30	ENST00000556091.1	453	483	+	30	0	-20	3480
P01009-1#73	0	10	10	P01009-1	93	103	+	10	P01009-1	86	191	ENST00000554720.1	129	444	++	165	P01009-1#73	0	30	ENST00000554720.1	150	180	+	30	0	-20	3481
P01009-1#73	0	10	10	P01009-1	93	103	+	10	P01009-1	0	306	ENST00000489769.1	9	927	++	120	P01009-1#73	0	30	ENST00000489769.1	288	318	+	30	0	-20	3482
P01009-1#73	0	10	10	P01009-1	93	103	+	10	P01009-1	0	418	ENST00000449399.7	302	1556	++	100	P01009-1#73	0	30	ENST00000449399.7	581	611	+	30	0	-20	3483
P01009-1#73	0	10	10	P01009-1	93	103	+	10	P01009-1	0	418	ENST00000448921.5	573	1827	++	98	P01009-1#73	0	30	ENST00000448921.5	852	882	+	30	0	-20	3484
P01009-1#73	0	10	10	P01009-1	93	103	+	10	P01009-1	0	418	ENST00000440909.5	185	1439	++	91	P01009-1#73	0	30	ENST00000440909.5	464	494	+	30	0	-20	3485
P01009-1#73	0	10	10	P01009-1	93	103	+	10	P01009-1	0	418	ENST00000437397.5	381	1635	++	89	P01009-1#73	0	30	ENST00000437397.5	660	690	+	30	0	-20	3486
P01009-1#73	0	10	10	P01009-1	93	103	+	10	P01009-1	0	418	ENST00000404814.8	311	1565	++	67	P01009-1#73	0	30	ENST00000404814.8	590	620	+	30	0	-20	3487
P01009-1#73	0	10	10	P01009-1	93	103	+	10	P01009-1	0	355	ENST00000402629.1	34	1099	++	66	P01009-1#73	0	30	ENST00000402629.1	313	343	+	30	0	-20	3488
P01009-1#73	0	10	10	P01009-1	93	103	+	10	P01009-1	0	418	ENST00000393088.8	555	1809	++	62	P01009-1#73	0	30	ENST00000393088.8	834	864	+	30	0	-20	3489
P01009-1#73	0	10	10	P01009-1	93	103	+	10	P01009-1	0	418	ENST00000393087.9	47	1301	++	61	P01009-1#73	0	30	ENST00000393087.9	326	356	+	30	0	-20	3490
P01009-1#73	0	10	10	P01009-1	93	103	+	10	P01009-1	0	418	ENST00000355814.8	277	1531	++	37	P01009-1#73	0	30	ENST00000355814.8	556	586	+	30	0	-20	3491
P01009-1#74	0	3	3	P01009-1	107	110	+	3	P01009-1	0	418	ENST00000636712.1	152	1406	++	227	P01009-1#74	0	9	ENST00000636712.1	473	482	+	9	0	-6	3492
P01009-1#74	0	3	3	P01009-1	107	110	+	3	P01009-1	0	144	ENST00000557492.5	517	949	++	169	P01009-1#74	0	9	ENST00000557492.5	838	847	+	9	0	-6	3493
P01009-1#74	0	3	3	P01009-1	107	110	+	3	P01009-1	0	117	ENST00000556955.5	220	571	++	167	P01009-1#74	0	9	ENST00000556955.5	541	550	+	9	0	-6	3494
P01009-1#74	0	3	3	P01009-1	107	110	+	3	P01009-1	0	156	ENST00000556091.1	174	642	++	166	P01009-1#74	0	9	ENST00000556091.1	495	504	+	9	0	-6	3495
P01009-1#74	0	3	3	P01009-1	107	110	+	3	P01009-1	86	191	ENST00000554720.1	129	444	++	165	P01009-1#74	0	9	ENST00000554720.1	192	201	+	9	0	-6	3496
P01009-1#74	0	3	3	P01009-1	107	110	+	3	P01009-1	0	306	ENST00000489769.1	9	927	++	120	P01009-1#74	0	9	ENST00000489769.1	330	339	+	9	0	-6	3497
P01009-1#74	0	3	3	P01009-1	107	110	+	3	P01009-1	0	418	ENST00000449399.7	302	1556	++	100	P01009-1#74	0	9	ENST00000449399.7	623	632	+	9	0	-6	3498
P01009-1#74	0	3	3	P01009-1	107	110	+	3	P01009-1	0	418	ENST00000448921.5	573	1827	++	98	P01009-1#74	0	9	ENST00000448921.5	894	903	+	9	0	-6	3499
P01009-1#74	0	3	3	P01009-1	107	110	+	3	P01009-1	0	418	ENST00000440909.5	185	1439	++	91	P01009-1#74	0	9	ENST00000440909.5	506	515	+	9	0	-6	3500
P01009-1#74	0	3	3	P01009-1	107	110	+	3	P01009-1	0	418	ENST00000437397.5	381	1635	++	89	P01009-1#74	0	9	ENST00000437397.5	702	711	+	9	0	-6	3501
P01009-1#74	0	3	3	P01009-1	107	110	+	3	P01009-1	0	418	ENST00000404814.8	311	1565	++	67	P01009-1#74	0	9	ENST00000404814.8	632	641	+	9	0	-6	3502
P01009-1#74	0	3	3	P01009-1	107	110	+	3	P01009-1	0	355	ENST00000402629.1	34	1099	++	66	P01009-1#74	0	9	ENST00000402629.1	355	364	+	9	0	-6	3503
P01009-1#74	0	3	3	P01009-1	107	110	+	3	P01009-1	0	418	ENST00000393088.8	555	1809	++	62	P01009-1#74	0	9	ENST00000393088.8	876	885	+	9	0	-6	3504
P01009-1#74	0	3	3	P01009-1	107	110	+	3	P01009-1	0	418	ENST00000393087.9	47	1301	++	61	P01009-1#74	0	9	ENST00000393087.9	368	377	+	9	0	-6	3505
P01009-1#74	0	3	3	P01009-1	107	110	+	3	P01009-1	0	418	ENST00000355814.8	277	1531	++	37	P01009-1#74	0	9	ENST00000355814.8	598	607	+	9	0	-6	3506
P01009-1#75	0	15	15	P01009-1	112	127	+	15	P01009-1	0	418	ENST00000636712.1	152	1406	++	227	P01009-1#75	0	45	ENST00000636712.1	488	533	+	45	0	-30	3507
P01009-1#75	0	15	15	P01009-1	112	127	+	15	P01009-1	0	144	ENST00000557492.5	517	949	++	169	P01009-1#75	0	45	ENST00000557492.5	853	898	+	45	0	-30	3508
P01009-1#75	0	15	15	P01009-1	112	127	+	15	P01009-1	0	117	ENST00000556955.5	220	571	++	167	P01009-1#75	0	15	ENST00000556955.5	556	571	+	15	0	0	3509
P01009-1#75	0	15	15	P01009-1	112	127	+	15	P01009-1	0	156	ENST00000556091.1	174	642	++	166	P01009-1#75	0	45	ENST00000556091.1	510	555	+	45	0	-30	3510
P01009-1#75	0	15	15	P01009-1	112	127	+	15	P01009-1	86	191	ENST00000554720.1	129	444	++	165	P01009-1#75	0	45	ENST00000554720.1	207	252	+	45	0	-30	3511
P01009-1#75	0	15	15	P01009-1	112	127	+	15	P01009-1	0	306	ENST00000489769.1	9	927	++	120	P01009-1#75	0	45	ENST00000489769.1	345	390	+	45	0	-30	3512
P01009-1#75	0	15	15	P01009-1	112	127	+	15	P01009-1	0	418	ENST00000449399.7	302	1556	++	100	P01009-1#75	0	45	ENST00000449399.7	638	683	+	45	0	-30	3513
P01009-1#75	0	15	15	P01009-1	112	127	+	15	P01009-1	0	418	ENST00000448921.5	573	1827	++	98	P01009-1#75	0	45	ENST00000448921.5	909	954	+	45	0	-30	3514
P01009-1#75	0	15	15	P01009-1	112	127	+	15	P01009-1	0	418	ENST00000440909.5	185	1439	++	91	P01009-1#75	0	45	ENST00000440909.5	521	566	+	45	0	-30	3515
P01009-1#75	0	15	15	P01009-1	112	127	+	15	P01009-1	0	418	ENST00000437397.5	381	1635	++	89	P01009-1#75	0	45	ENST00000437397.5	717	762	+	45	0	-30	3516
P01009-1#75	0	15	15	P01009-1	112	127	+	15	P01009-1	0	418	ENST00000404814.8	311	1565	++	67	P01009-1#75	0	45	ENST00000404814.8	647	692	+	45	0	-30	3517
P01009-1#75	0	15	15	P01009-1	112	127	+	15	P01009-1	0	355	ENST00000402629.1	34	1099	++	66	P01009-1#75	0	45	ENST00000402629.1	370	415	+	45	0	-30	3518
P01009-1#75	0	15	15	P01009-1	112	127	+	15	P01009-1	0	418	ENST00000393088.8	555	1809	++	62	P01009-1#75	0	45	ENST00000393088.8	891	936	+	45	0	-30	3519
P01009-1#75	0	15	15	P01009-1	112	127	+	15	P01009-1	0	418	ENST00000393087.9	47	1301	++	61	P01009-1#75	0	45	ENST00000393087.9	383	428	+	45	0	-30	3520
P01009-1#75	0	15	15	P01009-1	112	127	+	15	P01009-1	0	418	ENST00000355814.8	277	1531	++	37	P01009-1#75	0	45	ENST00000355814.8	613	658	+	45	0	-30	3521
P01009-1#76	0	4	4	P01009-1	129	133	+	4	P01009-1	0	418	ENST00000636712.1	152	1406	++	227	P01009-1#76	0	12	ENST00000636712.1	539	551	+	12	0	-8	3522
P01009-1#76	0	4	4	P01009-1	129	133	+	4	P01009-1	0	144	ENST00000557492.5	517	949	++	169	P01009-1#76	0	12	ENST00000557492.5	904	916	+	12	0	-8	3523
P01009-1#76	0	4	4	P01009-1	129	133	+	4	P01009-1	0	156	ENST00000556091.1	174	642	++	166	P01009-1#76	0	12	ENST00000556091.1	561	573	+	12	0	-8	3524
P01009-1#76	0	4	4	P01009-1	129	133	+	4	P01009-1	86	191	ENST00000554720.1	129	444	++	165	P01009-1#76	0	12	ENST00000554720.1	258	270	+	12	0	-8	3525
P01009-1#76	0	4	4	P01009-1	129	133	+	4	P01009-1	0	306	ENST00000489769.1	9	927	++	120	P01009-1#76	0	12	ENST00000489769.1	396	408	+	12	0	-8	3526
P01009-1#76	0	4	4	P01009-1	129	133	+	4	P01009-1	0	418	ENST00000449399.7	302	1556	++	100	P01009-1#76	0	12	ENST00000449399.7	689	701	+	12	0	-8	3527
P01009-1#76	0	4	4	P01009-1	129	133	+	4	P01009-1	0	418	ENST00000448921.5	573	1827	++	98	P01009-1#76	0	12	ENST00000448921.5	960	972	+	12	0	-8	3528
P01009-1#76	0	4	4	P01009-1	129	133	+	4	P01009-1	0	418	ENST00000440909.5	185	1439	++	91	P01009-1#76	0	12	ENST00000440909.5	572	584	+	12	0	-8	3529
P01009-1#76	0	4	4	P01009-1	129	133	+	4	P01009-1	0	418	ENST00000437397.5	381	1635	++	89	P01009-1#76	0	12	ENST00000437397.5	768	780	+	12	0	-8	3530
P01009-1#76	0	4	4	P01009-1	129	133	+	4	P01009-1	0	418	ENST00000404814.8	311	1565	++	67	P01009-1#76	0	12	ENST00000404814.8	698	710	+	12	0	-8	3531
P01009-1#76	0	4	4	P01009-1	129	133	+	4	P01009-1	0	355	ENST00000402629.1	34	1099	++	66	P01009-1#76	0	12	ENST00000402629.1	421	433	+	12	0	-8	3532
P01009-1#76	0	4	4	P01009-1	129	133	+	4	P01009-1	0	418	ENST00000393088.8	555	1809	++	62	P01009-1#76	0	12	ENST00000393088.8	942	954	+	12	0	-8	3533
P01009-1#76	0	4	4	P01009-1	129	133	+	4	P01009-1	0	418	ENST00000393087.9	47	1301	++	61	P01009-1#76	0	12	ENST00000393087.9	434	446	+	12	0	-8	3534
P01009-1#76	0	4	4	P01009-1	129	133	+	4	P01009-1	0	418	ENST00000355814.8	277	1531	++	37	P01009-1#76	0	12	ENST00000355814.8	664	676	+	12	0	-8	3535
P01009-1#77	0	11	11	P01009-1	134	145	+	11	P01009-1	0	418	ENST00000636712.1	152	1406	++	227	P01009-1#77	0	33	ENST00000636712.1	554	587	+	33	0	-22	3536
P01009-1#77	0	11	11	P01009-1	134	145	+	11	P01009-1	0	144	ENST00000557492.5	517	949	++	169	P01009-1#77	0	30	ENST00000557492.5	919	949	+	30	0	-19	3537
P01009-1#77	0	11	11	P01009-1	134	145	+	11	P01009-1	0	156	ENST00000556091.1	174	642	++	166	P01009-1#77	0	33	ENST00000556091.1	576	609	+	33	0	-22	3538
P01009-1#77	0	11	11	P01009-1	134	145	+	11	P01009-1	86	191	ENST00000554720.1	129	444	++	165	P01009-1#77	0	33	ENST00000554720.1	273	306	+	33	0	-22	3539
P01009-1#77	0	11	11	P01009-1	134	145	+	11	P01009-1	0	306	ENST00000489769.1	9	927	++	120	P01009-1#77	0	33	ENST00000489769.1	411	444	+	33	0	-22	3540
P01009-1#77	0	11	11	P01009-1	134	145	+	11	P01009-1	0	418	ENST00000449399.7	302	1556	++	100	P01009-1#77	0	33	ENST00000449399.7	704	737	+	33	0	-22	3541
P01009-1#77	0	11	11	P01009-1	134	145	+	11	P01009-1	0	418	ENST00000448921.5	573	1827	++	98	P01009-1#77	0	33	ENST00000448921.5	975	1008	+	33	0	-22	3542
P01009-1#77	0	11	11	P01009-1	134	145	+	11	P01009-1	0	418	ENST00000440909.5	185	1439	++	91	P01009-1#77	0	33	ENST00000440909.5	587	620	+	33	0	-22	3543
P01009-1#77	0	11	11	P01009-1	134	145	+	11	P01009-1	0	418	ENST00000437397.5	381	1635	++	89	P01009-1#77	0	33	ENST00000437397.5	783	816	+	33	0	-22	3544
P01009-1#77	0	11	11	P01009-1	134	145	+	11	P01009-1	0	418	ENST00000404814.8	311	1565	++	67	P01009-1#77	0	33	ENST00000404814.8	713	746	+	33	0	-22	3545
P01009-1#77	0	11	11	P01009-1	134	145	+	11	P01009-1	0	355	ENST00000402629.1	34	1099	++	66	P01009-1#77	0	33	ENST00000402629.1	436	469	+	33	0	-22	3546
P01009-1#77	0	11	11	P01009-1	134	145	+	11	P01009-1	0	418	ENST00000393088.8	555	1809	++	62	P01009-1#77	0	33	ENST00000393088.8	957	990	+	33	0	-22	3547
P01009-1#77	0	11	11	P01009-1	134	145	+	11	P01009-1	0	418	ENST00000393087.9	47	1301	++	61	P01009-1#77	0	33	ENST00000393087.9	449	482	+	33	0	-22	3548
P01009-1#77	0	11	11	P01009-1	134	145	+	11	P01009-1	0	418	ENST00000355814.8	277	1531	++	37	P01009-1#77	0	33	ENST00000355814.8	679	712	+	33	0	-22	3549
P01009-1#78	0	3	3	P01009-1	145	148	+	3	P01009-1	0	418	ENST00000636712.1	152	1406	++	227	P01009-1#78	0	9	ENST00000636712.1	587	596	+	9	0	-6	3550
P01009-1#78	0	3	3	P01009-1	145	148	+	3	P01009-1	0	156	ENST00000556091.1	174	642	++	166	P01009-1#78	0	9	ENST00000556091.1	609	618	+	9	0	-6	3551
P01009-1#78	0	3	3	P01009-1	145	148	+	3	P01009-1	86	191	ENST00000554720.1	129	444	++	165	P01009-1#78	0	9	ENST00000554720.1	306	315	+	9	0	-6	3552
P01009-1#78	0	3	3	P01009-1	145	148	+	3	P01009-1	0	306	ENST00000489769.1	9	927	++	120	P01009-1#78	0	9	ENST00000489769.1	444	453	+	9	0	-6	3553
P01009-1#78	0	3	3	P01009-1	145	148	+	3	P01009-1	0	418	ENST00000449399.7	302	1556	++	100	P01009-1#78	0	9	ENST00000449399.7	737	746	+	9	0	-6	3554
P01009-1#78	0	3	3	P01009-1	145	148	+	3	P01009-1	0	418	ENST00000448921.5	573	1827	++	98	P01009-1#78	0	9	ENST00000448921.5	1008	1017	+	9	0	-6	3555
P01009-1#78	0	3	3	P01009-1	145	148	+	3	P01009-1	0	418	ENST00000440909.5	185	1439	++	91	P01009-1#78	0	9	ENST00000440909.5	620	629	+	9	0	-6	3556
P01009-1#78	0	3	3	P01009-1	145	148	+	3	P01009-1	0	418	ENST00000437397.5	381	1635	++	89	P01009-1#78	0	9	ENST00000437397.5	816	825	+	9	0	-6	3557
P01009-1#78	0	3	3	P01009-1	145	148	+	3	P01009-1	0	418	ENST00000404814.8	311	1565	++	67	P01009-1#78	0	9	ENST00000404814.8	746	755	+	9	0	-6	3558
P01009-1#78	0	3	3	P01009-1	145	148	+	3	P01009-1	0	355	ENST00000402629.1	34	1099	++	66	P01009-1#78	0	9	ENST00000402629.1	469	478	+	9	0	-6	3559
P01009-1#78	0	3	3	P01009-1	145	148	+	3	P01009-1	0	418	ENST00000393088.8	555	1809	++	62	P01009-1#78	0	9	ENST00000393088.8	990	999	+	9	0	-6	3560
P01009-1#78	0	3	3	P01009-1	145	148	+	3	P01009-1	0	418	ENST00000393087.9	47	1301	++	61	P01009-1#78	0	9	ENST00000393087.9	482	491	+	9	0	-6	3561
P01009-1#78	0	3	3	P01009-1	145	148	+	3	P01009-1	0	418	ENST00000355814.8	277	1531	++	37	P01009-1#78	0	9	ENST00000355814.8	712	721	+	9	0	-6	3562
P01009-1#79	0	11	11	P01009-1	151	162	+	11	P01009-1	0	418	ENST00000636712.1	152	1406	++	227	P01009-1#79	0	33	ENST00000636712.1	605	638	+	33	0	-22	3563
P01009-1#79	0	11	11	P01009-1	151	162	+	11	P01009-1	0	156	ENST00000556091.1	174	642	++	166	P01009-1#79	0	15	ENST00000556091.1	627	642	+	15	0	-4	3564
P01009-1#79	0	11	11	P01009-1	151	162	+	11	P01009-1	86	191	ENST00000554720.1	129	444	++	165	P01009-1#79	0	33	ENST00000554720.1	324	357	+	33	0	-22	3565
P01009-1#79	0	11	11	P01009-1	151	162	+	11	P01009-1	0	306	ENST00000489769.1	9	927	++	120	P01009-1#79	0	33	ENST00000489769.1	462	495	+	33	0	-22	3566
P01009-1#79	0	11	11	P01009-1	151	162	+	11	P01009-1	0	418	ENST00000449399.7	302	1556	++	100	P01009-1#79	0	33	ENST00000449399.7	755	788	+	33	0	-22	3567
P01009-1#79	0	11	11	P01009-1	151	162	+	11	P01009-1	0	418	ENST00000448921.5	573	1827	++	98	P01009-1#79	0	33	ENST00000448921.5	1026	1059	+	33	0	-22	3568
P01009-1#79	0	11	11	P01009-1	151	162	+	11	P01009-1	0	418	ENST00000440909.5	185	1439	++	91	P01009-1#79	0	33	ENST00000440909.5	638	671	+	33	0	-22	3569
P01009-1#79	0	11	11	P01009-1	151	162	+	11	P01009-1	0	418	ENST00000437397.5	381	1635	++	89	P01009-1#79	0	33	ENST00000437397.5	834	867	+	33	0	-22	3570
P01009-1#79	0	11	11	P01009-1	151	162	+	11	P01009-1	0	418	ENST00000404814.8	311	1565	++	67	P01009-1#79	0	33	ENST00000404814.8	764	797	+	33	0	-22	3571
P01009-1#79	0	11	11	P01009-1	151	162	+	11	P01009-1	0	355	ENST00000402629.1	34	1099	++	66	P01009-1#79	0	33	ENST00000402629.1	487	520	+	33	0	-22	3572
P01009-1#79	0	11	11	P01009-1	151	162	+	11	P01009-1	0	418	ENST00000393088.8	555	1809	++	62	P01009-1#79	0	33	ENST00000393088.8	1008	1041	+	33	0	-22	3573
P01009-1#79	0	11	11	P01009-1	151	162	+	11	P01009-1	0	418	ENST00000393087.9	47	1301	++	61	P01009-1#79	0	33	ENST00000393087.9	500	533	+	33	0	-22	3574
P01009-1#79	0	11	11	P01009-1	151	162	+	11	P01009-1	0	418	ENST00000355814.8	277	1531	++	37	P01009-1#79	0	33	ENST00000355814.8	730	763	+	33	0	-22	3575
P01009-1#80	0	6	6	P01009-1	163	169	+	6	P01009-1	0	418	ENST00000636712.1	152	1406	++	227	P01009-1#80	0	18	ENST00000636712.1	641	659	+	18	0	-12	3576
P01009-1#80	0	6	6	P01009-1	163	169	+	6	P01009-1	86	191	ENST00000554720.1	129	444	++	165	P01009-1#80	0	18	ENST00000554720.1	360	378	+	18	0	-12	3577
P01009-1#80	0	6	6	P01009-1	163	169	+	6	P01009-1	0	306	ENST00000489769.1	9	927	++	120	P01009-1#80	0	18	ENST00000489769.1	498	516	+	18	0	-12	3578
P01009-1#80	0	6	6	P01009-1	163	169	+	6	P01009-1	0	418	ENST00000449399.7	302	1556	++	100	P01009-1#80	0	18	ENST00000449399.7	791	809	+	18	0	-12	3579
P01009-1#80	0	6	6	P01009-1	163	169	+	6	P01009-1	0	418	ENST00000448921.5	573	1827	++	98	P01009-1#80	0	18	ENST00000448921.5	1062	1080	+	18	0	-12	3580
P01009-1#80	0	6	6	P01009-1	163	169	+	6	P01009-1	0	418	ENST00000440909.5	185	1439	++	91	P01009-1#80	0	18	ENST00000440909.5	674	692	+	18	0	-12	3581
P01009-1#80	0	6	6	P01009-1	163	169	+	6	P01009-1	0	418	ENST00000437397.5	381	1635	++	89	P01009-1#80	0	18	ENST00000437397.5	870	888	+	18	0	-12	3582
P01009-1#80	0	6	6	P01009-1	163	169	+	6	P01009-1	0	418	ENST00000404814.8	311	1565	++	67	P01009-1#80	0	18	ENST00000404814.8	800	818	+	18	0	-12	3583
P01009-1#80	0	6	6	P01009-1	163	169	+	6	P01009-1	0	355	ENST00000402629.1	34	1099	++	66	P01009-1#80	0	18	ENST00000402629.1	523	541	+	18	0	-12	3584
P01009-1#80	0	6	6	P01009-1	163	169	+	6	P01009-1	0	418	ENST00000393088.8	555	1809	++	62	P01009-1#80	0	18	ENST00000393088.8	1044	1062	+	18	0	-12	3585
P01009-1#80	0	6	6	P01009-1	163	169	+	6	P01009-1	0	418	ENST00000393087.9	47	1301	++	61	P01009-1#80	0	18	ENST00000393087.9	536	554	+	18	0	-12	3586
P01009-1#80	0	6	6	P01009-1	163	169	+	6	P01009-1	0	418	ENST00000355814.8	277	1531	++	37	P01009-1#80	0	18	ENST00000355814.8	766	784	+	18	0	-12	3587
P01009-1#81	0	3	3	P01009-1	170	173	+	3	P01009-1	0	418	ENST00000636712.1	152	1406	++	227	P01009-1#81	0	9	ENST00000636712.1	662	671	+	9	0	-6	3588
P01009-1#81	0	3	3	P01009-1	170	173	+	3	P01009-1	86	191	ENST00000554720.1	129	444	++	165	P01009-1#81	0	9	ENST00000554720.1	381	390	+	9	0	-6	3589
P01009-1#81	0	3	3	P01009-1	170	173	+	3	P01009-1	0	306	ENST00000489769.1	9	927	++	120	P01009-1#81	0	9	ENST00000489769.1	519	528	+	9	0	-6	3590
P01009-1#81	0	3	3	P01009-1	170	173	+	3	P01009-1	0	418	ENST00000449399.7	302	1556	++	100	P01009-1#81	0	9	ENST00000449399.7	812	821	+	9	0	-6	3591
P01009-1#81	0	3	3	P01009-1	170	173	+	3	P01009-1	0	418	ENST00000448921.5	573	1827	++	98	P01009-1#81	0	9	ENST00000448921.5	1083	1092	+	9	0	-6	3592
P01009-1#81	0	3	3	P01009-1	170	173	+	3	P01009-1	0	418	ENST00000440909.5	185	1439	++	91	P01009-1#81	0	9	ENST00000440909.5	695	704	+	9	0	-6	3593
P01009-1#81	0	3	3	P01009-1	170	173	+	3	P01009-1	0	418	ENST00000437397.5	381	1635	++	89	P01009-1#81	0	9	ENST00000437397.5	891	900	+	9	0	-6	3594
P01009-1#81	0	3	3	P01009-1	170	173	+	3	P01009-1	0	418	ENST00000404814.8	311	1565	++	67	P01009-1#81	0	9	ENST00000404814.8	821	830	+	9	0	-6	3595
P01009-1#81	0	3	3	P01009-1	170	173	+	3	P01009-1	0	355	ENST00000402629.1	34	1099	++	66	P01009-1#81	0	9	ENST00000402629.1	544	553	+	9	0	-6	3596
P01009-1#81	0	3	3	P01009-1	170	173	+	3	P01009-1	0	418	ENST00000393088.8	555	1809	++	62	P01009-1#81	0	9	ENST00000393088.8	1065	1074	+	9	0	-6	3597
P01009-1#81	0	3	3	P01009-1	170	173	+	3	P01009-1	0	418	ENST00000393087.9	47	1301	++	61	P01009-1#81	0	9	ENST00000393087.9	557	566	+	9	0	-6	3598
P01009-1#81	0	3	3	P01009-1	170	173	+	3	P01009-1	0	418	ENST00000355814.8	277	1531	++	37	P01009-1#81	0	9	ENST00000355814.8	787	796	+	9	0	-6	3599
P01009-1#82	0	15	15	P01009-1	173	188	+	15	P01009-1	0	418	ENST00000636712.1	152	1406	++	227	P01009-1#82	0	45	ENST00000636712.1	671	716	+	45	0	-30	3600
P01009-1#82	0	15	15	P01009-1	173	188	+	15	P01009-1	86	191	ENST00000554720.1	129	444	++	165	P01009-1#82	0	45	ENST00000554720.1	390	435	+	45	0	-30	3601
P01009-1#82	0	15	15	P01009-1	173	188	+	15	P01009-1	0	306	ENST00000489769.1	9	927	++	120	P01009-1#82	0	45	ENST00000489769.1	528	573	+	45	0	-30	3602
P01009-1#82	0	15	15	P01009-1	173	188	+	15	P01009-1	0	418	ENST00000449399.7	302	1556	++	100	P01009-1#82	0	45	ENST00000449399.7	821	866	+	45	0	-30	3603
P01009-1#82	0	15	15	P01009-1	173	188	+	15	P01009-1	0	418	ENST00000448921.5	573	1827	++	98	P01009-1#82	0	45	ENST00000448921.5	1092	1137	+	45	0	-30	3604
P01009-1#82	0	15	15	P01009-1	173	188	+	15	P01009-1	0	418	ENST00000440909.5	185	1439	++	91	P01009-1#82	0	45	ENST00000440909.5	704	749	+	45	0	-30	3605
P01009-1#82	0	15	15	P01009-1	173	188	+	15	P01009-1	0	418	ENST00000437397.5	381	1635	++	89	P01009-1#82	0	45	ENST00000437397.5	900	945	+	45	0	-30	3606
P01009-1#82	0	15	15	P01009-1	173	188	+	15	P01009-1	0	418	ENST00000404814.8	311	1565	++	67	P01009-1#82	0	45	ENST00000404814.8	830	875	+	45	0	-30	3607
P01009-1#82	0	15	15	P01009-1	173	188	+	15	P01009-1	0	355	ENST00000402629.1	34	1099	++	66	P01009-1#82	0	45	ENST00000402629.1	553	598	+	45	0	-30	3608
P01009-1#82	0	15	15	P01009-1	173	188	+	15	P01009-1	0	418	ENST00000393088.8	555	1809	++	62	P01009-1#82	0	45	ENST00000393088.8	1074	1119	+	45	0	-30	3609
P01009-1#82	0	15	15	P01009-1	173	188	+	15	P01009-1	0	418	ENST00000393087.9	47	1301	++	61	P01009-1#82	0	45	ENST00000393087.9	566	611	+	45	0	-30	3610
P01009-1#82	0	15	15	P01009-1	173	188	+	15	P01009-1	0	418	ENST00000355814.8	277	1531	++	37	P01009-1#82	0	45	ENST00000355814.8	796	841	+	45	0	-30	3611
P01009-1#83	0	3	3	P01009-1	188	191	+	3	P01009-1	0	418	ENST00000636712.1	152	1406	++	227	P01009-1#83	0	9	ENST00000636712.1	716	725	+	9	0	-6	3612
P01009-1#83	0	3	3	P01009-1	188	191	+	3	P01009-1	86	191	ENST00000554720.1	129	444	++	165	P01009-1#83	0	9	ENST00000554720.1	435	444	+	9	0	-6	3613
P01009-1#83	0	3	3	P01009-1	188	191	+	3	P01009-1	0	306	ENST00000489769.1	9	927	++	120	P01009-1#83	0	9	ENST00000489769.1	573	582	+	9	0	-6	3614
P01009-1#83	0	3	3	P01009-1	188	191	+	3	P01009-1	0	418	ENST00000449399.7	302	1556	++	100	P01009-1#83	0	9	ENST00000449399.7	866	875	+	9	0	-6	3615
P01009-1#83	0	3	3	P01009-1	188	191	+	3	P01009-1	0	418	ENST00000448921.5	573	1827	++	98	P01009-1#83	0	9	ENST00000448921.5	1137	1146	+	9	0	-6	3616
P01009-1#83	0	3	3	P01009-1	188	191	+	3	P01009-1	0	418	ENST00000440909.5	185	1439	++	91	P01009-1#83	0	9	ENST00000440909.5	749	758	+	9	0	-6	3617
P01009-1#83	0	3	3	P01009-1	188	191	+	3	P01009-1	0	418	ENST00000437397.5	381	1635	++	89	P01009-1#83	0	9	ENST00000437397.5	945	954	+	9	0	-6	3618
P01009-1#83	0	3	3	P01009-1	188	191	+	3	P01009-1	0	418	ENST00000404814.8	311	1565	++	67	P01009-1#83	0	9	ENST00000404814.8	875	884	+	9	0	-6	3619
P01009-1#83	0	3	3	P01009-1	188	191	+	3	P01009-1	0	355	ENST00000402629.1	34	1099	++	66	P01009-1#83	0	9	ENST00000402629.1	598	607	+	9	0	-6	3620
P01009-1#83	0	3	3	P01009-1	188	191	+	3	P01009-1	0	418	ENST00000393088.8	555	1809	++	62	P01009-1#83	0	9	ENST00000393088.8	1119	1128	+	9	0	-6	3621
P01009-1#83	0	3	3	P01009-1	188	191	+	3	P01009-1	0	418	ENST00000393087.9	47	1301	++	61	P01009-1#83	0	9	ENST00000393087.9	611	620	+	9	0	-6	3622
P01009-1#83	0	3	3	P01009-1	188	191	+	3	P01009-1	0	418	ENST00000355814.8	277	1531	++	37	P01009-1#83	0	9	ENST00000355814.8	841	850	+	9	0	-6	3623
P01009-1#84	0	15	15	P01009-1	205	220	+	15	P01009-1	0	418	ENST00000636712.1	152	1406	++	227	P01009-1#84	0	45	ENST00000636712.1	767	812	+	45	0	-30	3624
P01009-1#84	0	15	15	P01009-1	205	220	+	15	P01009-1	0	306	ENST00000489769.1	9	927	++	120	P01009-1#84	0	45	ENST00000489769.1	624	669	+	45	0	-30	3625
P01009-1#84	0	15	15	P01009-1	205	220	+	15	P01009-1	0	418	ENST00000449399.7	302	1556	++	100	P01009-1#84	0	45	ENST00000449399.7	917	962	+	45	0	-30	3626
P01009-1#84	0	15	15	P01009-1	205	220	+	15	P01009-1	0	418	ENST00000448921.5	573	1827	++	98	P01009-1#84	0	45	ENST00000448921.5	1188	1233	+	45	0	-30	3627
P01009-1#84	0	15	15	P01009-1	205	220	+	15	P01009-1	0	418	ENST00000440909.5	185	1439	++	91	P01009-1#84	0	45	ENST00000440909.5	800	845	+	45	0	-30	3628
P01009-1#84	0	15	15	P01009-1	205	220	+	15	P01009-1	0	418	ENST00000437397.5	381	1635	++	89	P01009-1#84	0	45	ENST00000437397.5	996	1041	+	45	0	-30	3629
P01009-1#84	0	15	15	P01009-1	205	220	+	15	P01009-1	0	418	ENST00000404814.8	311	1565	++	67	P01009-1#84	0	45	ENST00000404814.8	926	971	+	45	0	-30	3630
P01009-1#84	0	15	15	P01009-1	205	220	+	15	P01009-1	0	355	ENST00000402629.1	34	1099	++	66	P01009-1#84	0	45	ENST00000402629.1	649	694	+	45	0	-30	3631
P01009-1#84	0	15	15	P01009-1	205	220	+	15	P01009-1	0	418	ENST00000393088.8	555	1809	++	62	P01009-1#84	0	45	ENST00000393088.8	1170	1215	+	45	0	-30	3632
P01009-1#84	0	15	15	P01009-1	205	220	+	15	P01009-1	0	418	ENST00000393087.9	47	1301	++	61	P01009-1#84	0	45	ENST00000393087.9	662	707	+	45	0	-30	3633
P01009-1#84	0	15	15	P01009-1	205	220	+	15	P01009-1	0	418	ENST00000355814.8	277	1531	++	37	P01009-1#84	0	45	ENST00000355814.8	892	937	+	45	0	-30	3634
P01009-1#85	0	3	3	P01009-1	223	226	+	3	P01009-1	0	418	ENST00000636712.1	152	1406	++	227	P01009-1#85	0	9	ENST00000636712.1	821	830	+	9	0	-6	3635
P01009-1#85	0	3	3	P01009-1	223	226	+	3	P01009-1	0	306	ENST00000489769.1	9	927	++	120	P01009-1#85	0	9	ENST00000489769.1	678	687	+	9	0	-6	3636
P01009-1#85	0	3	3	P01009-1	223	226	+	3	P01009-1	0	418	ENST00000449399.7	302	1556	++	100	P01009-1#85	0	9	ENST00000449399.7	971	980	+	9	0	-6	3637
P01009-1#85	0	3	3	P01009-1	223	226	+	3	P01009-1	0	418	ENST00000448921.5	573	1827	++	98	P01009-1#85	0	9	ENST00000448921.5	1242	1251	+	9	0	-6	3638
P01009-1#85	0	3	3	P01009-1	223	226	+	3	P01009-1	0	418	ENST00000440909.5	185	1439	++	91	P01009-1#85	0	9	ENST00000440909.5	854	863	+	9	0	-6	3639
P01009-1#85	0	3	3	P01009-1	223	226	+	3	P01009-1	0	418	ENST00000437397.5	381	1635	++	89	P01009-1#85	0	9	ENST00000437397.5	1050	1059	+	9	0	-6	3640
P01009-1#85	0	3	3	P01009-1	223	226	+	3	P01009-1	0	418	ENST00000404814.8	311	1565	++	67	P01009-1#85	0	9	ENST00000404814.8	980	989	+	9	0	-6	3641
P01009-1#85	0	3	3	P01009-1	223	226	+	3	P01009-1	0	355	ENST00000402629.1	34	1099	++	66	P01009-1#85	0	9	ENST00000402629.1	703	712	+	9	0	-6	3642
P01009-1#85	0	3	3	P01009-1	223	226	+	3	P01009-1	0	418	ENST00000393088.8	555	1809	++	62	P01009-1#85	0	9	ENST00000393088.8	1224	1233	+	9	0	-6	3643
P01009-1#85	0	3	3	P01009-1	223	226	+	3	P01009-1	0	418	ENST00000393087.9	47	1301	++	61	P01009-1#85	0	9	ENST00000393087.9	716	725	+	9	0	-6	3644
P01009-1#85	0	3	3	P01009-1	223	226	+	3	P01009-1	0	418	ENST00000355814.8	277	1531	++	37	P01009-1#85	0	9	ENST00000355814.8	946	955	+	9	0	-6	3645
P01009-1#86	0	8	8	P01009-1	227	235	+	8	P01009-1	0	418	ENST00000636712.1	152	1406	++	227	P01009-1#86	0	24	ENST00000636712.1	833	857	+	24	0	-16	3646
P01009-1#86	0	8	8	P01009-1	227	235	+	8	P01009-1	0	306	ENST00000489769.1	9	927	++	120	P01009-1#86	0	24	ENST00000489769.1	690	714	+	24	0	-16	3647
P01009-1#86	0	8	8	P01009-1	227	235	+	8	P01009-1	0	418	ENST00000449399.7	302	1556	++	100	P01009-1#86	0	24	ENST00000449399.7	983	1007	+	24	0	-16	3648
P01009-1#86	0	8	8	P01009-1	227	235	+	8	P01009-1	0	418	ENST00000448921.5	573	1827	++	98	P01009-1#86	0	24	ENST00000448921.5	1254	1278	+	24	0	-16	3649
P01009-1#86	0	8	8	P01009-1	227	235	+	8	P01009-1	0	418	ENST00000440909.5	185	1439	++	91	P01009-1#86	0	24	ENST00000440909.5	866	890	+	24	0	-16	3650
P01009-1#86	0	8	8	P01009-1	227	235	+	8	P01009-1	0	418	ENST00000437397.5	381	1635	++	89	P01009-1#86	0	24	ENST00000437397.5	1062	1086	+	24	0	-16	3651
P01009-1#86	0	8	8	P01009-1	227	235	+	8	P01009-1	0	418	ENST00000404814.8	311	1565	++	67	P01009-1#86	0	24	ENST00000404814.8	992	1016	+	24	0	-16	3652
P01009-1#86	0	8	8	P01009-1	227	235	+	8	P01009-1	0	355	ENST00000402629.1	34	1099	++	66	P01009-1#86	0	24	ENST00000402629.1	715	739	+	24	0	-16	3653
P01009-1#86	0	8	8	P01009-1	227	235	+	8	P01009-1	0	418	ENST00000393088.8	555	1809	++	62	P01009-1#86	0	24	ENST00000393088.8	1236	1260	+	24	0	-16	3654
P01009-1#86	0	8	8	P01009-1	227	235	+	8	P01009-1	0	418	ENST00000393087.9	47	1301	++	61	P01009-1#86	0	24	ENST00000393087.9	728	752	+	24	0	-16	3655
P01009-1#86	0	8	8	P01009-1	227	235	+	8	P01009-1	0	418	ENST00000355814.8	277	1531	++	37	P01009-1#86	0	24	ENST00000355814.8	958	982	+	24	0	-16	3656
P01009-1#87	0	19	19	P01009-1	237	256	+	19	P01009-1	0	418	ENST00000636712.1	152	1406	++	227	P01009-1#87	0	57	ENST00000636712.1	863	920	+	57	0	-38	3657
P01009-1#87	0	19	19	P01009-1	237	256	+	19	P01009-1	0	306	ENST00000489769.1	9	927	++	120	P01009-1#87	0	57	ENST00000489769.1	720	777	+	57	0	-38	3658
P01009-1#87	0	19	19	P01009-1	237	256	+	19	P01009-1	0	418	ENST00000449399.7	302	1556	++	100	P01009-1#87	0	57	ENST00000449399.7	1013	1070	+	57	0	-38	3659
P01009-1#87	0	19	19	P01009-1	237	256	+	19	P01009-1	0	418	ENST00000448921.5	573	1827	++	98	P01009-1#87	0	57	ENST00000448921.5	1284	1341	+	57	0	-38	3660
P01009-1#87	0	19	19	P01009-1	237	256	+	19	P01009-1	0	418	ENST00000440909.5	185	1439	++	91	P01009-1#87	0	57	ENST00000440909.5	896	953	+	57	0	-38	3661
P01009-1#87	0	19	19	P01009-1	237	256	+	19	P01009-1	0	418	ENST00000437397.5	381	1635	++	89	P01009-1#87	0	57	ENST00000437397.5	1092	1149	+	57	0	-38	3662
P01009-1#87	0	19	19	P01009-1	237	256	+	19	P01009-1	0	418	ENST00000404814.8	311	1565	++	67	P01009-1#87	0	57	ENST00000404814.8	1022	1079	+	57	0	-38	3663
P01009-1#87	0	19	19	P01009-1	237	256	+	19	P01009-1	0	355	ENST00000402629.1	34	1099	++	66	P01009-1#87	0	57	ENST00000402629.1	745	802	+	57	0	-38	3664
P01009-1#87	0	19	19	P01009-1	237	256	+	19	P01009-1	0	418	ENST00000393088.8	555	1809	++	62	P01009-1#87	0	57	ENST00000393088.8	1266	1323	+	57	0	-38	3665
P01009-1#87	0	19	19	P01009-1	237	256	+	19	P01009-1	0	418	ENST00000393087.9	47	1301	++	61	P01009-1#87	0	57	ENST00000393087.9	758	815	+	57	0	-38	3666
P01009-1#87	0	19	19	P01009-1	237	256	+	19	P01009-1	0	418	ENST00000355814.8	277	1531	++	37	P01009-1#87	0	57	ENST00000355814.8	988	1045	+	57	0	-38	3667
P01009-1#88	0	4	4	P01009-1	256	260	+	4	P01009-1	0	418	ENST00000636712.1	152	1406	++	227	P01009-1#88	0	12	ENST00000636712.1	920	932	+	12	0	-8	3668
P01009-1#88	0	4	4	P01009-1	256	260	+	4	P01009-1	0	306	ENST00000489769.1	9	927	++	120	P01009-1#88	0	12	ENST00000489769.1	777	789	+	12	0	-8	3669
P01009-1#88	0	4	4	P01009-1	256	260	+	4	P01009-1	0	418	ENST00000449399.7	302	1556	++	100	P01009-1#88	0	12	ENST00000449399.7	1070	1082	+	12	0	-8	3670
P01009-1#88	0	4	4	P01009-1	256	260	+	4	P01009-1	0	418	ENST00000448921.5	573	1827	++	98	P01009-1#88	0	12	ENST00000448921.5	1341	1353	+	12	0	-8	3671
P01009-1#88	0	4	4	P01009-1	256	260	+	4	P01009-1	0	418	ENST00000440909.5	185	1439	++	91	P01009-1#88	0	12	ENST00000440909.5	953	965	+	12	0	-8	3672
P01009-1#88	0	4	4	P01009-1	256	260	+	4	P01009-1	0	418	ENST00000437397.5	381	1635	++	89	P01009-1#88	0	12	ENST00000437397.5	1149	1161	+	12	0	-8	3673
P01009-1#88	0	4	4	P01009-1	256	260	+	4	P01009-1	0	418	ENST00000404814.8	311	1565	++	67	P01009-1#88	0	12	ENST00000404814.8	1079	1091	+	12	0	-8	3674
P01009-1#88	0	4	4	P01009-1	256	260	+	4	P01009-1	0	355	ENST00000402629.1	34	1099	++	66	P01009-1#88	0	12	ENST00000402629.1	802	814	+	12	0	-8	3675
P01009-1#88	0	4	4	P01009-1	256	260	+	4	P01009-1	0	418	ENST00000393088.8	555	1809	++	62	P01009-1#88	0	12	ENST00000393088.8	1323	1335	+	12	0	-8	3676
P01009-1#88	0	4	4	P01009-1	256	260	+	4	P01009-1	0	418	ENST00000393087.9	47	1301	++	61	P01009-1#88	0	12	ENST00000393087.9	815	827	+	12	0	-8	3677
P01009-1#88	0	4	4	P01009-1	256	260	+	4	P01009-1	0	418	ENST00000355814.8	277	1531	++	37	P01009-1#88	0	12	ENST00000355814.8	1045	1057	+	12	0	-8	3678
P01009-1#89	0	19	19	P01009-1	260	279	+	19	P01009-1	0	418	ENST00000636712.1	152	1406	++	227	P01009-1#89	0	57	ENST00000636712.1	932	989	+	57	0	-38	3679
P01009-1#89	0	19	19	P01009-1	260	279	+	19	P01009-1	0	306	ENST00000489769.1	9	927	++	120	P01009-1#89	0	57	ENST00000489769.1	789	846	+	57	0	-38	3680
P01009-1#89	0	19	19	P01009-1	260	279	+	19	P01009-1	0	418	ENST00000449399.7	302	1556	++	100	P01009-1#89	0	57	ENST00000449399.7	1082	1139	+	57	0	-38	3681
P01009-1#89	0	19	19	P01009-1	260	279	+	19	P01009-1	0	418	ENST00000448921.5	573	1827	++	98	P01009-1#89	0	57	ENST00000448921.5	1353	1410	+	57	0	-38	3682
P01009-1#89	0	19	19	P01009-1	260	279	+	19	P01009-1	0	418	ENST00000440909.5	185	1439	++	91	P01009-1#89	0	57	ENST00000440909.5	965	1022	+	57	0	-38	3683
P01009-1#89	0	19	19	P01009-1	260	279	+	19	P01009-1	0	418	ENST00000437397.5	381	1635	++	89	P01009-1#89	0	57	ENST00000437397.5	1161	1218	+	57	0	-38	3684
P01009-1#89	0	19	19	P01009-1	260	279	+	19	P01009-1	0	418	ENST00000404814.8	311	1565	++	67	P01009-1#89	0	57	ENST00000404814.8	1091	1148	+	57	0	-38	3685
P01009-1#89	0	19	19	P01009-1	260	279	+	19	P01009-1	0	355	ENST00000402629.1	34	1099	++	66	P01009-1#89	0	57	ENST00000402629.1	814	871	+	57	0	-38	3686
P01009-1#89	0	19	19	P01009-1	260	279	+	19	P01009-1	0	418	ENST00000393088.8	555	1809	++	62	P01009-1#89	0	57	ENST00000393088.8	1335	1392	+	57	0	-38	3687
P01009-1#89	0	19	19	P01009-1	260	279	+	19	P01009-1	0	418	ENST00000393087.9	47	1301	++	61	P01009-1#89	0	57	ENST00000393087.9	827	884	+	57	0	-38	3688
P01009-1#89	0	19	19	P01009-1	260	279	+	19	P01009-1	0	418	ENST00000355814.8	277	1531	++	37	P01009-1#89	0	57	ENST00000355814.8	1057	1114	+	57	0	-38	3689
P01009-1#90	0	3	3	P01009-1	279	282	+	3	P01009-1	0	418	ENST00000636712.1	152	1406	++	227	P01009-1#90	0	9	ENST00000636712.1	989	998	+	9	0	-6	3690
P01009-1#90	0	3	3	P01009-1	279	282	+	3	P01009-1	0	306	ENST00000489769.1	9	927	++	120	P01009-1#90	0	9	ENST00000489769.1	846	855	+	9	0	-6	3691
P01009-1#90	0	3	3	P01009-1	279	282	+	3	P01009-1	0	418	ENST00000449399.7	302	1556	++	100	P01009-1#90	0	9	ENST00000449399.7	1139	1148	+	9	0	-6	3692
P01009-1#90	0	3	3	P01009-1	279	282	+	3	P01009-1	0	418	ENST00000448921.5	573	1827	++	98	P01009-1#90	0	9	ENST00000448921.5	1410	1419	+	9	0	-6	3693
P01009-1#90	0	3	3	P01009-1	279	282	+	3	P01009-1	0	418	ENST00000440909.5	185	1439	++	91	P01009-1#90	0	9	ENST00000440909.5	1022	1031	+	9	0	-6	3694
P01009-1#90	0	3	3	P01009-1	279	282	+	3	P01009-1	0	418	ENST00000437397.5	381	1635	++	89	P01009-1#90	0	9	ENST00000437397.5	1218	1227	+	9	0	-6	3695
P01009-1#90	0	3	3	P01009-1	279	282	+	3	P01009-1	0	418	ENST00000404814.8	311	1565	++	67	P01009-1#90	0	9	ENST00000404814.8	1148	1157	+	9	0	-6	3696
P01009-1#90	0	3	3	P01009-1	279	282	+	3	P01009-1	0	355	ENST00000402629.1	34	1099	++	66	P01009-1#90	0	9	ENST00000402629.1	871	880	+	9	0	-6	3697
P01009-1#90	0	3	3	P01009-1	279	282	+	3	P01009-1	0	418	ENST00000393088.8	555	1809	++	62	P01009-1#90	0	9	ENST00000393088.8	1392	1401	+	9	0	-6	3698
P01009-1#90	0	3	3	P01009-1	279	282	+	3	P01009-1	0	418	ENST00000393087.9	47	1301	++	61	P01009-1#90	0	9	ENST00000393087.9	884	893	+	9	0	-6	3699
P01009-1#90	0	3	3	P01009-1	279	282	+	3	P01009-1	0	418	ENST00000355814.8	277	1531	++	37	P01009-1#90	0	9	ENST00000355814.8	1114	1123	+	9	0	-6	3700
P01009-1#91	0	7	7	P01009-1	283	290	+	7	P01009-1	0	418	ENST00000636712.1	152	1406	++	227	P01009-1#91	0	21	ENST00000636712.1	1001	1022	+	21	0	-14	3701
P01009-1#91	0	7	7	P01009-1	283	290	+	7	P01009-1	0	306	ENST00000489769.1	9	927	++	120	P01009-1#91	0	21	ENST00000489769.1	858	879	+	21	0	-14	3702
P01009-1#91	0	7	7	P01009-1	283	290	+	7	P01009-1	0	418	ENST00000449399.7	302	1556	++	100	P01009-1#91	0	21	ENST00000449399.7	1151	1172	+	21	0	-14	3703
P01009-1#91	0	7	7	P01009-1	283	290	+	7	P01009-1	0	418	ENST00000448921.5	573	1827	++	98	P01009-1#91	0	21	ENST00000448921.5	1422	1443	+	21	0	-14	3704
P01009-1#91	0	7	7	P01009-1	283	290	+	7	P01009-1	0	418	ENST00000440909.5	185	1439	++	91	P01009-1#91	0	21	ENST00000440909.5	1034	1055	+	21	0	-14	3705
P01009-1#91	0	7	7	P01009-1	283	290	+	7	P01009-1	0	418	ENST00000437397.5	381	1635	++	89	P01009-1#91	0	21	ENST00000437397.5	1230	1251	+	21	0	-14	3706
P01009-1#91	0	7	7	P01009-1	283	290	+	7	P01009-1	0	418	ENST00000404814.8	311	1565	++	67	P01009-1#91	0	21	ENST00000404814.8	1160	1181	+	21	0	-14	3707
P01009-1#91	0	7	7	P01009-1	283	290	+	7	P01009-1	0	355	ENST00000402629.1	34	1099	++	66	P01009-1#91	0	21	ENST00000402629.1	883	904	+	21	0	-14	3708
P01009-1#91	0	7	7	P01009-1	283	290	+	7	P01009-1	0	418	ENST00000393088.8	555	1809	++	62	P01009-1#91	0	21	ENST00000393088.8	1404	1425	+	21	0	-14	3709
P01009-1#91	0	7	7	P01009-1	283	290	+	7	P01009-1	0	418	ENST00000393087.9	47	1301	++	61	P01009-1#91	0	21	ENST00000393087.9	896	917	+	21	0	-14	3710
P01009-1#91	0	7	7	P01009-1	283	290	+	7	P01009-1	0	418	ENST00000355814.8	277	1531	++	37	P01009-1#91	0	21	ENST00000355814.8	1126	1147	+	21	0	-14	3711
P01009-1#92	0	9	9	P01009-1	292	301	+	9	P01009-1	0	418	ENST00000636712.1	152	1406	++	227	P01009-1#92	0	27	ENST00000636712.1	1028	1055	+	27	0	-18	3712
P01009-1#92	0	9	9	P01009-1	292	301	+	9	P01009-1	0	306	ENST00000489769.1	9	927	++	120	P01009-1#92	0	27	ENST00000489769.1	885	912	+	27	0	-18	3713
P01009-1#92	0	9	9	P01009-1	292	301	+	9	P01009-1	0	418	ENST00000449399.7	302	1556	++	100	P01009-1#92	0	27	ENST00000449399.7	1178	1205	+	27	0	-18	3714
P01009-1#92	0	9	9	P01009-1	292	301	+	9	P01009-1	0	418	ENST00000448921.5	573	1827	++	98	P01009-1#92	0	27	ENST00000448921.5	1449	1476	+	27	0	-18	3715
P01009-1#92	0	9	9	P01009-1	292	301	+	9	P01009-1	0	418	ENST00000440909.5	185	1439	++	91	P01009-1#92	0	27	ENST00000440909.5	1061	1088	+	27	0	-18	3716
P01009-1#92	0	9	9	P01009-1	292	301	+	9	P01009-1	0	418	ENST00000437397.5	381	1635	++	89	P01009-1#92	0	27	ENST00000437397.5	1257	1284	+	27	0	-18	3717
P01009-1#92	0	9	9	P01009-1	292	301	+	9	P01009-1	0	418	ENST00000404814.8	311	1565	++	67	P01009-1#92	0	27	ENST00000404814.8	1187	1214	+	27	0	-18	3718
P01009-1#92	0	9	9	P01009-1	292	301	+	9	P01009-1	0	355	ENST00000402629.1	34	1099	++	66	P01009-1#92	0	27	ENST00000402629.1	910	937	+	27	0	-18	3719
P01009-1#92	0	9	9	P01009-1	292	301	+	9	P01009-1	0	418	ENST00000393088.8	555	1809	++	62	P01009-1#92	0	27	ENST00000393088.8	1431	1458	+	27	0	-18	3720
P01009-1#92	0	9	9	P01009-1	292	301	+	9	P01009-1	0	418	ENST00000393087.9	47	1301	++	61	P01009-1#92	0	27	ENST00000393087.9	923	950	+	27	0	-18	3721
P01009-1#92	0	9	9	P01009-1	292	301	+	9	P01009-1	0	418	ENST00000355814.8	277	1531	++	37	P01009-1#92	0	27	ENST00000355814.8	1153	1180	+	27	0	-18	3722
P01009-1#93	0	8	8	P01009-1	305	313	+	8	P01009-1	0	418	ENST00000636712.1	152	1406	++	227	P01009-1#93	0	24	ENST00000636712.1	1067	1091	+	24	0	-16	3723
P01009-1#93	0	8	8	P01009-1	305	313	+	8	P01009-1	0	306	ENST00000489769.1	9	927	++	120	P01009-1#93	0	3	ENST00000489769.1	924	927	+	3	0	5	3724
P01009-1#93	0	8	8	P01009-1	305	313	+	8	P01009-1	0	418	ENST00000449399.7	302	1556	++	100	P01009-1#93	0	24	ENST00000449399.7	1217	1241	+	24	0	-16	3725
P01009-1#93	0	8	8	P01009-1	305	313	+	8	P01009-1	0	418	ENST00000448921.5	573	1827	++	98	P01009-1#93	0	24	ENST00000448921.5	1488	1512	+	24	0	-16	3726
P01009-1#93	0	8	8	P01009-1	305	313	+	8	P01009-1	0	418	ENST00000440909.5	185	1439	++	91	P01009-1#93	0	24	ENST00000440909.5	1100	1124	+	24	0	-16	3727
P01009-1#93	0	8	8	P01009-1	305	313	+	8	P01009-1	0	418	ENST00000437397.5	381	1635	++	89	P01009-1#93	0	24	ENST00000437397.5	1296	1320	+	24	0	-16	3728
P01009-1#93	0	8	8	P01009-1	305	313	+	8	P01009-1	0	418	ENST00000404814.8	311	1565	++	67	P01009-1#93	0	24	ENST00000404814.8	1226	1250	+	24	0	-16	3729
P01009-1#93	0	8	8	P01009-1	305	313	+	8	P01009-1	0	355	ENST00000402629.1	34	1099	++	66	P01009-1#93	0	24	ENST00000402629.1	949	973	+	24	0	-16	3730
P01009-1#93	0	8	8	P01009-1	305	313	+	8	P01009-1	0	418	ENST00000393088.8	555	1809	++	62	P01009-1#93	0	24	ENST00000393088.8	1470	1494	+	24	0	-16	3731
P01009-1#93	0	8	8	P01009-1	305	313	+	8	P01009-1	0	418	ENST00000393087.9	47	1301	++	61	P01009-1#93	0	24	ENST00000393087.9	962	986	+	24	0	-16	3732
P01009-1#93	0	8	8	P01009-1	305	313	+	8	P01009-1	0	418	ENST00000355814.8	277	1531	++	37	P01009-1#93	0	24	ENST00000355814.8	1192	1216	+	24	0	-16	3733
P01009-1#94	0	8	8	P01009-1	314	322	+	8	P01009-1	0	418	ENST00000636712.1	152	1406	++	227	P01009-1#94	0	24	ENST00000636712.1	1094	1118	+	24	0	-16	3734
P01009-1#94	0	8	8	P01009-1	314	322	+	8	P01009-1	0	418	ENST00000449399.7	302	1556	++	100	P01009-1#94	0	24	ENST00000449399.7	1244	1268	+	24	0	-16	3735
P01009-1#94	0	8	8	P01009-1	314	322	+	8	P01009-1	0	418	ENST00000448921.5	573	1827	++	98	P01009-1#94	0	24	ENST00000448921.5	1515	1539	+	24	0	-16	3736
P01009-1#94	0	8	8	P01009-1	314	322	+	8	P01009-1	0	418	ENST00000440909.5	185	1439	++	91	P01009-1#94	0	24	ENST00000440909.5	1127	1151	+	24	0	-16	3737
P01009-1#94	0	8	8	P01009-1	314	322	+	8	P01009-1	0	418	ENST00000437397.5	381	1635	++	89	P01009-1#94	0	24	ENST00000437397.5	1323	1347	+	24	0	-16	3738
P01009-1#94	0	8	8	P01009-1	314	322	+	8	P01009-1	0	418	ENST00000404814.8	311	1565	++	67	P01009-1#94	0	24	ENST00000404814.8	1253	1277	+	24	0	-16	3739
P01009-1#94	0	8	8	P01009-1	314	322	+	8	P01009-1	0	355	ENST00000402629.1	34	1099	++	66	P01009-1#94	0	24	ENST00000402629.1	976	1000	+	24	0	-16	3740
P01009-1#94	0	8	8	P01009-1	314	322	+	8	P01009-1	0	418	ENST00000393088.8	555	1809	++	62	P01009-1#94	0	24	ENST00000393088.8	1497	1521	+	24	0	-16	3741
P01009-1#94	0	8	8	P01009-1	314	322	+	8	P01009-1	0	418	ENST00000393087.9	47	1301	++	61	P01009-1#94	0	24	ENST00000393087.9	989	1013	+	24	0	-16	3742
P01009-1#94	0	8	8	P01009-1	314	322	+	8	P01009-1	0	418	ENST00000355814.8	277	1531	++	37	P01009-1#94	0	24	ENST00000355814.8	1219	1243	+	24	0	-16	3743
P01009-1#95	0	6	6	P01009-1	323	329	+	6	P01009-1	0	418	ENST00000636712.1	152	1406	++	227	P01009-1#95	0	18	ENST00000636712.1	1121	1139	+	18	0	-12	3744
P01009-1#95	0	6	6	P01009-1	323	329	+	6	P01009-1	0	418	ENST00000449399.7	302	1556	++	100	P01009-1#95	0	18	ENST00000449399.7	1271	1289	+	18	0	-12	3745
P01009-1#95	0	6	6	P01009-1	323	329	+	6	P01009-1	0	418	ENST00000448921.5	573	1827	++	98	P01009-1#95	0	18	ENST00000448921.5	1542	1560	+	18	0	-12	3746
P01009-1#95	0	6	6	P01009-1	323	329	+	6	P01009-1	0	418	ENST00000440909.5	185	1439	++	91	P01009-1#95	0	18	ENST00000440909.5	1154	1172	+	18	0	-12	3747
P01009-1#95	0	6	6	P01009-1	323	329	+	6	P01009-1	0	418	ENST00000437397.5	381	1635	++	89	P01009-1#95	0	18	ENST00000437397.5	1350	1368	+	18	0	-12	3748
P01009-1#95	0	6	6	P01009-1	323	329	+	6	P01009-1	0	418	ENST00000404814.8	311	1565	++	67	P01009-1#95	0	18	ENST00000404814.8	1280	1298	+	18	0	-12	3749
P01009-1#95	0	6	6	P01009-1	323	329	+	6	P01009-1	0	355	ENST00000402629.1	34	1099	++	66	P01009-1#95	0	18	ENST00000402629.1	1003	1021	+	18	0	-12	3750
P01009-1#95	0	6	6	P01009-1	323	329	+	6	P01009-1	0	418	ENST00000393088.8	555	1809	++	62	P01009-1#95	0	18	ENST00000393088.8	1524	1542	+	18	0	-12	3751
P01009-1#95	0	6	6	P01009-1	323	329	+	6	P01009-1	0	418	ENST00000393087.9	47	1301	++	61	P01009-1#95	0	18	ENST00000393087.9	1016	1034	+	18	0	-12	3752
P01009-1#95	0	6	6	P01009-1	323	329	+	6	P01009-1	0	418	ENST00000355814.8	277	1531	++	37	P01009-1#95	0	18	ENST00000355814.8	1246	1264	+	18	0	-12	3753
P01009-1#96	0	3	3	P01009-1	333	336	+	3	P01009-1	0	418	ENST00000636712.1	152	1406	++	227	P01009-1#96	0	9	ENST00000636712.1	1151	1160	+	9	0	-6	3754
P01009-1#96	0	3	3	P01009-1	333	336	+	3	P01009-1	0	418	ENST00000449399.7	302	1556	++	100	P01009-1#96	0	9	ENST00000449399.7	1301	1310	+	9	0	-6	3755
P01009-1#96	0	3	3	P01009-1	333	336	+	3	P01009-1	0	418	ENST00000448921.5	573	1827	++	98	P01009-1#96	0	9	ENST00000448921.5	1572	1581	+	9	0	-6	3756
P01009-1#96	0	3	3	P01009-1	333	336	+	3	P01009-1	0	418	ENST00000440909.5	185	1439	++	91	P01009-1#96	0	9	ENST00000440909.5	1184	1193	+	9	0	-6	3757
P01009-1#96	0	3	3	P01009-1	333	336	+	3	P01009-1	0	418	ENST00000437397.5	381	1635	++	89	P01009-1#96	0	9	ENST00000437397.5	1380	1389	+	9	0	-6	3758
P01009-1#96	0	3	3	P01009-1	333	336	+	3	P01009-1	0	418	ENST00000404814.8	311	1565	++	67	P01009-1#96	0	9	ENST00000404814.8	1310	1319	+	9	0	-6	3759
P01009-1#96	0	3	3	P01009-1	333	336	+	3	P01009-1	0	355	ENST00000402629.1	34	1099	++	66	P01009-1#96	0	9	ENST00000402629.1	1033	1042	+	9	0	-6	3760
P01009-1#96	0	3	3	P01009-1	333	336	+	3	P01009-1	0	418	ENST00000393088.8	555	1809	++	62	P01009-1#96	0	9	ENST00000393088.8	1554	1563	+	9	0	-6	3761
P01009-1#96	0	3	3	P01009-1	333	336	+	3	P01009-1	0	418	ENST00000393087.9	47	1301	++	61	P01009-1#96	0	9	ENST00000393087.9	1046	1055	+	9	0	-6	3762
P01009-1#96	0	3	3	P01009-1	333	336	+	3	P01009-1	0	418	ENST00000355814.8	277	1531	++	37	P01009-1#96	0	9	ENST00000355814.8	1276	1285	+	9	0	-6	3763
P01009-1#97	0	3	3	P01009-1	336	339	+	3	P01009-1	0	418	ENST00000636712.1	152	1406	++	227	P01009-1#97	0	9	ENST00000636712.1	1160	1169	+	9	0	-6	3764
P01009-1#97	0	3	3	P01009-1	336	339	+	3	P01009-1	0	418	ENST00000449399.7	302	1556	++	100	P01009-1#97	0	9	ENST00000449399.7	1310	1319	+	9	0	-6	3765
P01009-1#97	0	3	3	P01009-1	336	339	+	3	P01009-1	0	418	ENST00000448921.5	573	1827	++	98	P01009-1#97	0	9	ENST00000448921.5	1581	1590	+	9	0	-6	3766
P01009-1#97	0	3	3	P01009-1	336	339	+	3	P01009-1	0	418	ENST00000440909.5	185	1439	++	91	P01009-1#97	0	9	ENST00000440909.5	1193	1202	+	9	0	-6	3767
P01009-1#97	0	3	3	P01009-1	336	339	+	3	P01009-1	0	418	ENST00000437397.5	381	1635	++	89	P01009-1#97	0	9	ENST00000437397.5	1389	1398	+	9	0	-6	3768
P01009-1#97	0	3	3	P01009-1	336	339	+	3	P01009-1	0	418	ENST00000404814.8	311	1565	++	67	P01009-1#97	0	9	ENST00000404814.8	1319	1328	+	9	0	-6	3769
P01009-1#97	0	3	3	P01009-1	336	339	+	3	P01009-1	0	355	ENST00000402629.1	34	1099	++	66	P01009-1#97	0	9	ENST00000402629.1	1042	1051	+	9	0	-6	3770
P01009-1#97	0	3	3	P01009-1	336	339	+	3	P01009-1	0	418	ENST00000393088.8	555	1809	++	62	P01009-1#97	0	9	ENST00000393088.8	1563	1572	+	9	0	-6	3771
P01009-1#97	0	3	3	P01009-1	336	339	+	3	P01009-1	0	418	ENST00000393087.9	47	1301	++	61	P01009-1#97	0	9	ENST00000393087.9	1055	1064	+	9	0	-6	3772
P01009-1#97	0	3	3	P01009-1	336	339	+	3	P01009-1	0	418	ENST00000355814.8	277	1531	++	37	P01009-1#97	0	9	ENST00000355814.8	1285	1294	+	9	0	-6	3773
P01009-1#98	0	3	3	P01009-1	342	345	+	3	P01009-1	0	418	ENST00000636712.1	152	1406	++	227	P01009-1#98	0	9	ENST00000636712.1	1178	1187	+	9	0	-6	3774
P01009-1#98	0	3	3	P01009-1	342	345	+	3	P01009-1	0	418	ENST00000449399.7	302	1556	++	100	P01009-1#98	0	9	ENST00000449399.7	1328	1337	+	9	0	-6	3775
P01009-1#98	0	3	3	P01009-1	342	345	+	3	P01009-1	0	418	ENST00000448921.5	573	1827	++	98	P01009-1#98	0	9	ENST00000448921.5	1599	1608	+	9	0	-6	3776
P01009-1#98	0	3	3	P01009-1	342	345	+	3	P01009-1	0	418	ENST00000440909.5	185	1439	++	91	P01009-1#98	0	9	ENST00000440909.5	1211	1220	+	9	0	-6	3777
P01009-1#98	0	3	3	P01009-1	342	345	+	3	P01009-1	0	418	ENST00000437397.5	381	1635	++	89	P01009-1#98	0	9	ENST00000437397.5	1407	1416	+	9	0	-6	3778
P01009-1#98	0	3	3	P01009-1	342	345	+	3	P01009-1	0	418	ENST00000404814.8	311	1565	++	67	P01009-1#98	0	9	ENST00000404814.8	1337	1346	+	9	0	-6	3779
P01009-1#98	0	3	3	P01009-1	342	345	+	3	P01009-1	0	355	ENST00000402629.1	34	1099	++	66	P01009-1#98	0	9	ENST00000402629.1	1060	1069	+	9	0	-6	3780
P01009-1#98	0	3	3	P01009-1	342	345	+	3	P01009-1	0	418	ENST00000393088.8	555	1809	++	62	P01009-1#98	0	9	ENST00000393088.8	1581	1590	+	9	0	-6	3781
P01009-1#98	0	3	3	P01009-1	342	345	+	3	P01009-1	0	418	ENST00000393087.9	47	1301	++	61	P01009-1#98	0	9	ENST00000393087.9	1073	1082	+	9	0	-6	3782
P01009-1#98	0	3	3	P01009-1	342	345	+	3	P01009-1	0	418	ENST00000355814.8	277	1531	++	37	P01009-1#98	0	9	ENST00000355814.8	1303	1312	+	9	0	-6	3783
P01009-1#99	0	3	3	P01009-1	346	349	+	3	P01009-1	0	418	ENST00000636712.1	152	1406	++	227	P01009-1#99	0	9	ENST00000636712.1	1190	1199	+	9	0	-6	3784
P01009-1#99	0	3	3	P01009-1	346	349	+	3	P01009-1	0	418	ENST00000449399.7	302	1556	++	100	P01009-1#99	0	9	ENST00000449399.7	1340	1349	+	9	0	-6	3785
P01009-1#99	0	3	3	P01009-1	346	349	+	3	P01009-1	0	418	ENST00000448921.5	573	1827	++	98	P01009-1#99	0	9	ENST00000448921.5	1611	1620	+	9	0	-6	3786
P01009-1#99	0	3	3	P01009-1	346	349	+	3	P01009-1	0	418	ENST00000440909.5	185	1439	++	91	P01009-1#99	0	9	ENST00000440909.5	1223	1232	+	9	0	-6	3787
P01009-1#99	0	3	3	P01009-1	346	349	+	3	P01009-1	0	418	ENST00000437397.5	381	1635	++	89	P01009-1#99	0	9	ENST00000437397.5	1419	1428	+	9	0	-6	3788
P01009-1#99	0	3	3	P01009-1	346	349	+	3	P01009-1	0	418	ENST00000404814.8	311	1565	++	67	P01009-1#99	0	9	ENST00000404814.8	1349	1358	+	9	0	-6	3789
P01009-1#99	0	3	3	P01009-1	346	349	+	3	P01009-1	0	355	ENST00000402629.1	34	1099	++	66	P01009-1#99	0	9	ENST00000402629.1	1072	1081	+	9	0	-6	3790
P01009-1#99	0	3	3	P01009-1	346	349	+	3	P01009-1	0	418	ENST00000393088.8	555	1809	++	62	P01009-1#99	0	9	ENST00000393088.8	1593	1602	+	9	0	-6	3791
P01009-1#99	0	3	3	P01009-1	346	349	+	3	P01009-1	0	418	ENST00000393087.9	47	1301	++	61	P01009-1#99	0	9	ENST00000393087.9	1085	1094	+	9	0	-6	3792
P01009-1#99	0	3	3	P01009-1	346	349	+	3	P01009-1	0	418	ENST00000355814.8	277	1531	++	37	P01009-1#99	0	9	ENST00000355814.8	1315	1324	+	9	0	-6	3793
P01009-1#100	0	14	14	P01009-1	350	364	+	14	P01009-1	0	418	ENST00000636712.1	152	1406	++	227	P01009-1#100	0	42	ENST00000636712.1	1202	1244	+	42	0	-28	3794
P01009-1#100	0	14	14	P01009-1	350	364	+	14	P01009-1	0	418	ENST00000449399.7	302	1556	++	100	P01009-1#100	0	42	ENST00000449399.7	1352	1394	+	42	0	-28	3795
P01009-1#100	0	14	14	P01009-1	350	364	+	14	P01009-1	0	418	ENST00000448921.5	573	1827	++	98	P01009-1#100	0	42	ENST00000448921.5	1623	1665	+	42	0	-28	3796
P01009-1#100	0	14	14	P01009-1	350	364	+	14	P01009-1	0	418	ENST00000440909.5	185	1439	++	91	P01009-1#100	0	42	ENST00000440909.5	1235	1277	+	42	0	-28	3797
P01009-1#100	0	14	14	P01009-1	350	364	+	14	P01009-1	0	418	ENST00000437397.5	381	1635	++	89	P01009-1#100	0	42	ENST00000437397.5	1431	1473	+	42	0	-28	3798
P01009-1#100	0	14	14	P01009-1	350	364	+	14	P01009-1	0	418	ENST00000404814.8	311	1565	++	67	P01009-1#100	0	42	ENST00000404814.8	1361	1403	+	42	0	-28	3799
P01009-1#100	0	14	14	P01009-1	350	364	+	14	P01009-1	0	355	ENST00000402629.1	34	1099	++	66	P01009-1#100	0	15	ENST00000402629.1	1084	1099	+	15	0	-1	3800
P01009-1#100	0	14	14	P01009-1	350	364	+	14	P01009-1	0	418	ENST00000393088.8	555	1809	++	62	P01009-1#100	0	42	ENST00000393088.8	1605	1647	+	42	0	-28	3801
P01009-1#100	0	14	14	P01009-1	350	364	+	14	P01009-1	0	418	ENST00000393087.9	47	1301	++	61	P01009-1#100	0	42	ENST00000393087.9	1097	1139	+	42	0	-28	3802
P01009-1#100	0	14	14	P01009-1	350	364	+	14	P01009-1	0	418	ENST00000355814.8	277	1531	++	37	P01009-1#100	0	42	ENST00000355814.8	1327	1369	+	42	0	-28	3803
P01009-1#101	0	16	16	P01009-1	365	381	+	16	P01009-1	0	418	ENST00000636712.1	152	1406	++	227	P01009-1#101	0	48	ENST00000636712.1	1247	1295	+	48	0	-32	3804
P01009-1#101	0	16	16	P01009-1	365	381	+	16	P01009-1	0	418	ENST00000449399.7	302	1556	++	100	P01009-1#101	0	48	ENST00000449399.7	1397	1445	+	48	0	-32	3805
P01009-1#101	0	16	16	P01009-1	365	381	+	16	P01009-1	0	418	ENST00000448921.5	573	1827	++	98	P01009-1#101	0	48	ENST00000448921.5	1668	1716	+	48	0	-32	3806
P01009-1#101	0	16	16	P01009-1	365	381	+	16	P01009-1	0	418	ENST00000440909.5	185	1439	++	91	P01009-1#101	0	48	ENST00000440909.5	1280	1328	+	48	0	-32	3807
P01009-1#101	0	16	16	P01009-1	365	381	+	16	P01009-1	0	418	ENST00000437397.5	381	1635	++	89	P01009-1#101	0	48	ENST00000437397.5	1476	1524	+	48	0	-32	3808
P01009-1#101	0	16	16	P01009-1	365	381	+	16	P01009-1	0	418	ENST00000404814.8	311	1565	++	67	P01009-1#101	0	48	ENST00000404814.8	1406	1454	+	48	0	-32	3809
P01009-1#101	0	16	16	P01009-1	365	381	+	16	P01009-1	0	418	ENST00000393088.8	555	1809	++	62	P01009-1#101	0	48	ENST00000393088.8	1650	1698	+	48	0	-32	3810
P01009-1#101	0	16	16	P01009-1	365	381	+	16	P01009-1	0	418	ENST00000393087.9	47	1301	++	61	P01009-1#101	0	48	ENST00000393087.9	1142	1190	+	48	0	-32	3811
P01009-1#101	0	16	16	P01009-1	365	381	+	16	P01009-1	0	418	ENST00000355814.8	277	1531	++	37	P01009-1#101	0	48	ENST00000355814.8	1372	1420	+	48	0	-32	3812
P01009-1#102	0	3	3	P01009-1	386	389	+	3	P01009-1	0	418	ENST00000636712.1	152	1406	++	227	P01009-1#102	0	9	ENST00000636712.1	1310	1319	+	9	0	-6	3813
P01009-1#102	0	3	3	P01009-1	386	389	+	3	P01009-1	0	418	ENST00000449399.7	302	1556	++	100	P01009-1#102	0	9	ENST00000449399.7	1460	1469	+	9	0	-6	3814
P01009-1#102	0	3	3	P01009-1	386	389	+	3	P01009-1	0	418	ENST00000448921.5	573	1827	++	98	P01009-1#102	0	9	ENST00000448921.5	1731	1740	+	9	0	-6	3815
P01009-1#102	0	3	3	P01009-1	386	389	+	3	P01009-1	0	418	ENST00000440909.5	185	1439	++	91	P01009-1#102	0	9	ENST00000440909.5	1343	1352	+	9	0	-6	3816
P01009-1#102	0	3	3	P01009-1	386	389	+	3	P01009-1	0	418	ENST00000437397.5	381	1635	++	89	P01009-1#102	0	9	ENST00000437397.5	1539	1548	+	9	0	-6	3817
P01009-1#102	0	3	3	P01009-1	386	389	+	3	P01009-1	0	418	ENST00000404814.8	311	1565	++	67	P01009-1#102	0	9	ENST00000404814.8	1469	1478	+	9	0	-6	3818
P01009-1#102	0	3	3	P01009-1	386	389	+	3	P01009-1	0	418	ENST00000393088.8	555	1809	++	62	P01009-1#102	0	9	ENST00000393088.8	1713	1722	+	9	0	-6	3819
P01009-1#102	0	3	3	P01009-1	386	389	+	3	P01009-1	0	418	ENST00000393087.9	47	1301	++	61	P01009-1#102	0	9	ENST00000393087.9	1205	1214	+	9	0	-6	3820
P01009-1#102	0	3	3	P01009-1	386	389	+	3	P01009-1	0	418	ENST00000355814.8	277	1531	++	37	P01009-1#102	0	9	ENST00000355814.8	1435	1444	+	9	0	-6	3821
P01009-1#103	0	7	7	P01009-1	393	400	+	7	P01009-1	0	418	ENST00000636712.1	152	1406	++	227	P01009-1#103	0	21	ENST00000636712.1	1331	1352	+	21	0	-14	3822
P01009-1#103	0	7	7	P01009-1	393	400	+	7	P01009-1	0	418	ENST00000449399.7	302	1556	++	100	P01009-1#103	0	21	ENST00000449399.7	1481	1502	+	21	0	-14	3823
P01009-1#103	0	7	7	P01009-1	393	400	+	7	P01009-1	0	418	ENST00000448921.5	573	1827	++	98	P01009-1#103	0	21	ENST00000448921.5	1752	1773	+	21	0	-14	3824
P01009-1#103	0	7	7	P01009-1	393	400	+	7	P01009-1	0	418	ENST00000440909.5	185	1439	++	91	P01009-1#103	0	21	ENST00000440909.5	1364	1385	+	21	0	-14	3825
P01009-1#103	0	7	7	P01009-1	393	400	+	7	P01009-1	0	418	ENST00000437397.5	381	1635	++	89	P01009-1#103	0	21	ENST00000437397.5	1560	1581	+	21	0	-14	3826
P01009-1#103	0	7	7	P01009-1	393	400	+	7	P01009-1	0	418	ENST00000404814.8	311	1565	++	67	P01009-1#103	0	21	ENST00000404814.8	1490	1511	+	21	0	-14	3827
P01009-1#103	0	7	7	P01009-1	393	400	+	7	P01009-1	0	418	ENST00000393088.8	555	1809	++	62	P01009-1#103	0	21	ENST00000393088.8	1734	1755	+	21	0	-14	3828
P01009-1#103	0	7	7	P01009-1	393	400	+	7	P01009-1	0	418	ENST00000393087.9	47	1301	++	61	P01009-1#103	0	21	ENST00000393087.9	1226	1247	+	21	0	-14	3829
P01009-1#103	0	7	7	P01009-1	393	400	+	7	P01009-1	0	418	ENST00000355814.8	277	1531	++	37	P01009-1#103	0	21	ENST00000355814.8	1456	1477	+	21	0	-14	3830
P01009-1#104	0	3	3	P01009-1	400	403	+	3	P01009-1	0	418	ENST00000636712.1	152	1406	++	227	P01009-1#104	0	9	ENST00000636712.1	1352	1361	+	9	0	-6	3831
P01009-1#104	0	3	3	P01009-1	400	403	+	3	P01009-1	0	418	ENST00000449399.7	302	1556	++	100	P01009-1#104	0	9	ENST00000449399.7	1502	1511	+	9	0	-6	3832
P01009-1#104	0	3	3	P01009-1	400	403	+	3	P01009-1	0	418	ENST00000448921.5	573	1827	++	98	P01009-1#104	0	9	ENST00000448921.5	1773	1782	+	9	0	-6	3833
P01009-1#104	0	3	3	P01009-1	400	403	+	3	P01009-1	0	418	ENST00000440909.5	185	1439	++	91	P01009-1#104	0	9	ENST00000440909.5	1385	1394	+	9	0	-6	3834
P01009-1#104	0	3	3	P01009-1	400	403	+	3	P01009-1	0	418	ENST00000437397.5	381	1635	++	89	P01009-1#104	0	9	ENST00000437397.5	1581	1590	+	9	0	-6	3835
P01009-1#104	0	3	3	P01009-1	400	403	+	3	P01009-1	0	418	ENST00000404814.8	311	1565	++	67	P01009-1#104	0	9	ENST00000404814.8	1511	1520	+	9	0	-6	3836
P01009-1#104	0	3	3	P01009-1	400	403	+	3	P01009-1	0	418	ENST00000393088.8	555	1809	++	62	P01009-1#104	0	9	ENST00000393088.8	1755	1764	+	9	0	-6	3837
P01009-1#104	0	3	3	P01009-1	400	403	+	3	P01009-1	0	418	ENST00000393087.9	47	1301	++	61	P01009-1#104	0	9	ENST00000393087.9	1247	1256	+	9	0	-6	3838
P01009-1#104	0	3	3	P01009-1	400	403	+	3	P01009-1	0	418	ENST00000355814.8	277	1531	++	37	P01009-1#104	0	9	ENST00000355814.8	1477	1486	+	9	0	-6	3839
P01009-1#105	0	9	9	P01009-1	405	414	+	9	P01009-1	0	418	ENST00000636712.1	152	1406	++	227	P01009-1#105	0	27	ENST00000636712.1	1367	1394	+	27	0	-18	3840
P01009-1#105	0	9	9	P01009-1	405	414	+	9	P01009-1	0	418	ENST00000449399.7	302	1556	++	100	P01009-1#105	0	27	ENST00000449399.7	1517	1544	+	27	0	-18	3841
P01009-1#105	0	9	9	P01009-1	405	414	+	9	P01009-1	0	418	ENST00000448921.5	573	1827	++	98	P01009-1#105	0	27	ENST00000448921.5	1788	1815	+	27	0	-18	3842
P01009-1#105	0	9	9	P01009-1	405	414	+	9	P01009-1	0	418	ENST00000440909.5	185	1439	++	91	P01009-1#105	0	27	ENST00000440909.5	1400	1427	+	27	0	-18	3843
P01009-1#105	0	9	9	P01009-1	405	414	+	9	P01009-1	0	418	ENST00000437397.5	381	1635	++	89	P01009-1#105	0	27	ENST00000437397.5	1596	1623	+	27	0	-18	3844
P01009-1#105	0	9	9	P01009-1	405	414	+	9	P01009-1	0	418	ENST00000404814.8	311	1565	++	67	P01009-1#105	0	27	ENST00000404814.8	1526	1553	+	27	0	-18	3845
P01009-1#105	0	9	9	P01009-1	405	414	+	9	P01009-1	0	418	ENST00000393088.8	555	1809	++	62	P01009-1#105	0	27	ENST00000393088.8	1770	1797	+	27	0	-18	3846
P01009-1#105	0	9	9	P01009-1	405	414	+	9	P01009-1	0	418	ENST00000393087.9	47	1301	++	61	P01009-1#105	0	27	ENST00000393087.9	1262	1289	+	27	0	-18	3847
P01009-1#105	0	9	9	P01009-1	405	414	+	9	P01009-1	0	418	ENST00000355814.8	277	1531	++	37	P01009-1#105	0	27	ENST00000355814.8	1492	1519	+	27	0	-18	3848
Q99732-1#0	0	161	161	Q99732-1	0	161	+	161	Q99732-1	0	161	ENST00000622633.5	39	522	++	225	Q99732-1#0	0	483	ENST00000622633.5	39	522	+	483	0	-322	3849
Q99732-1#0	0	161	161	Q99732-1	0	161	+	161	Q99732-1	0	161	ENST00000576036.5	93	576	++	185	Q99732-1#0	0	483	ENST00000576036.5	93	576	+	483	0	-322	3850
Q99732-1#0	0	161	161	Q99732-1	0	161	+	161	Q99732-1	0	58	ENST00000574848.5	380	554	++	184	Q99732-1#0	0	174	ENST00000574848.5	380	554	+	174	0	-13	3851
Q99732-1#0	0	161	161	Q99732-1	0	161	+	161	Q99732-1	0	161	ENST00000574763.5	220	703	++	183	Q99732-1#0	0	483	ENST00000574763.5	220	703	+	483	0	-322	3852
Q99732-1#0	0	161	161	Q99732-1	0	161	+	161	Q99732-1	0	75	ENST00000574703.5	39	264	++	182	Q99732-1#0	0	225	ENST00000574703.5	39	264	+	225	0	-64	3853
Q99732-1#0	0	161	161	Q99732-1	0	161	+	161	Q99732-1	0	126	ENST00000574701.5	144	522	++	181	Q99732-1#0	0	378	ENST00000574701.5	144	522	+	378	0	-217	3854
Q99732-1#0	0	161	161	Q99732-1	0	161	+	161	Q99732-1	0	74	ENST00000573332.5	39	261	++	180	Q99732-1#0	0	222	ENST00000573332.5	39	261	+	222	0	-61	3855
Q99732-1#0	0	161	161	Q99732-1	0	161	+	161	Q99732-1	93	161	ENST00000572255.5	274	478	++	179	Q99732-1#0	279	483	ENST00000572255.5	274	478	+	204	279	-322	3856
Q99732-1#0	0	161	161	Q99732-1	0	161	+	161	Q99732-1	0	126	ENST00000571976.1	61	439	++	178	Q99732-1#0	0	378	ENST00000571976.1	61	439	+	378	0	-217	3857
Q99732-1#0	0	161	161	Q99732-1	0	161	+	161	Q99732-1	0	161	ENST00000571688.5	231	714	++	177	Q99732-1#0	0	483	ENST00000571688.5	231	714	+	483	0	-322	3858
Q99732-1#0	0	161	161	Q99732-1	0	161	+	161	Q99732-1	0	153	ENST00000571627.5	118	577	++	176	Q99732-1#0	0	459	ENST00000571627.5	118	577	+	459	0	-298	3859
Q99732-1#0	0	161	161	Q99732-1	0	161	+	161	Q99732-1	0	73	ENST00000571459.5	23	242	++	175	Q99732-1#0	0	219	ENST00000571459.5	23	242	+	219	0	-58	3860
Q99732-1#0	0	161	161	Q99732-1	0	161	+	161	Q99732-1	0	39	ENST00000571277.1	468	585	++	174	Q99732-1#0	0	117	ENST00000571277.1	468	585	+	117	0	44	3861
Q99732-1#0	0	161	161	Q99732-1	0	161	+	161	Q99732-1	0	161	ENST00000570904.5	102	585	++	173	Q99732-1#0	0	483	ENST00000570904.5	102	585	+	483	0	-322	3862
Q99732-1#0	0	161	161	Q99732-1	0	161	+	161	Q99732-1	0	137	ENST00000570798.5	181	592	++	172	Q99732-1#0	0	411	ENST00000570798.5	181	592	+	411	0	-250	3863
Q99732-1#0	0	161	161	Q99732-1	0	161	+	161	Q99732-1	0	126	ENST00000413364.6	70	448	++	74	Q99732-1#0	0	378	ENST00000413364.6	70	448	+	378	0	-217	3864
Q99732-1#0	0	161	161	Q99732-1	0	161	+	161	Q99732-1	0	161	ENST00000339430.9	233	716	++	32	Q99732-1#0	0	483	ENST00000339430.9	233	716	+	483	0	-322	3865
Q99732-1#1	0	85	85	Q99732-1	75	160	+	85	Q99732-1	0	161	ENST00000622633.5	39	522	++	225	Q99732-1#1	0	255	ENST00000622633.5	264	519	+	255	0	-170	3866
Q99732-1#1	0	85	85	Q99732-1	75	160	+	85	Q99732-1	0	161	ENST00000576036.5	93	576	++	185	Q99732-1#1	0	255	ENST00000576036.5	318	573	+	255	0	-170	3867
Q99732-1#1	0	85	85	Q99732-1	75	160	+	85	Q99732-1	0	161	ENST00000574763.5	220	703	++	183	Q99732-1#1	0	255	ENST00000574763.5	445	700	+	255	0	-170	3868
Q99732-1#1	0	85	85	Q99732-1	75	160	+	85	Q99732-1	0	126	ENST00000574701.5	144	522	++	181	Q99732-1#1	0	153	ENST00000574701.5	369	522	+	153	0	-68	3869
Q99732-1#1	0	85	85	Q99732-1	75	160	+	85	Q99732-1	93	161	ENST00000572255.5	274	478	++	179	Q99732-1#1	54	255	ENST00000572255.5	274	475	+	201	54	-170	3870
Q99732-1#1	0	85	85	Q99732-1	75	160	+	85	Q99732-1	0	126	ENST00000571976.1	61	439	++	178	Q99732-1#1	0	153	ENST00000571976.1	286	439	+	153	0	-68	3871
Q99732-1#1	0	85	85	Q99732-1	75	160	+	85	Q99732-1	0	161	ENST00000571688.5	231	714	++	177	Q99732-1#1	0	255	ENST00000571688.5	456	711	+	255	0	-170	3872
Q99732-1#1	0	85	85	Q99732-1	75	160	+	85	Q99732-1	0	153	ENST00000571627.5	118	577	++	176	Q99732-1#1	0	234	ENST00000571627.5	343	577	+	234	0	-149	3873
Q99732-1#1	0	85	85	Q99732-1	75	160	+	85	Q99732-1	0	161	ENST00000570904.5	102	585	++	173	Q99732-1#1	0	255	ENST00000570904.5	327	582	+	255	0	-170	3874
Q99732-1#1	0	85	85	Q99732-1	75	160	+	85	Q99732-1	0	137	ENST00000570798.5	181	592	++	172	Q99732-1#1	0	186	ENST00000570798.5	406	592	+	186	0	-101	3875
Q99732-1#1	0	85	85	Q99732-1	75	160	+	85	Q99732-1	0	126	ENST00000413364.6	70	448	++	74	Q99732-1#1	0	153	ENST00000413364.6	295	448	+	153	0	-68	3876
Q99732-1#1	0	85	85	Q99732-1	75	160	+	85	Q99732-1	0	161	ENST00000339430.9	233	716	++	32	Q99732-1#1	0	255	ENST00000339430.9	458	713	+	255	0	-170	3877
Q99732-1#2	0	22	22	Q99732-1	0	22	+	22	Q99732-1	0	161	ENST00000622633.5	39	522	++	225	Q99732-1#2	0	66	ENST00000622633.5	39	105	+	66	0	-44	3878
Q99732-1#2	0	22	22	Q99732-1	0	22	+	22	Q99732-1	0	161	ENST00000576036.5	93	576	++	185	Q99732-1#2	0	66	ENST00000576036.5	93	159	+	66	0	-44	3879
Q99732-1#2	0	22	22	Q99732-1	0	22	+	22	Q99732-1	0	58	ENST00000574848.5	380	554	++	184	Q99732-1#2	0	66	ENST00000574848.5	380	446	+	66	0	-44	3880
Q99732-1#2	0	22	22	Q99732-1	0	22	+	22	Q99732-1	0	161	ENST00000574763.5	220	703	++	183	Q99732-1#2	0	66	ENST00000574763.5	220	286	+	66	0	-44	3881
Q99732-1#2	0	22	22	Q99732-1	0	22	+	22	Q99732-1	0	75	ENST00000574703.5	39	264	++	182	Q99732-1#2	0	66	ENST00000574703.5	39	105	+	66	0	-44	3882
Q99732-1#2	0	22	22	Q99732-1	0	22	+	22	Q99732-1	0	126	ENST00000574701.5	144	522	++	181	Q99732-1#2	0	66	ENST00000574701.5	144	210	+	66	0	-44	3883
Q99732-1#2	0	22	22	Q99732-1	0	22	+	22	Q99732-1	0	74	ENST00000573332.5	39	261	++	180	Q99732-1#2	0	66	ENST00000573332.5	39	105	+	66	0	-44	3884
Q99732-1#2	0	22	22	Q99732-1	0	22	+	22	Q99732-1	0	126	ENST00000571976.1	61	439	++	178	Q99732-1#2	0	66	ENST00000571976.1	61	127	+	66	0	-44	3885
Q99732-1#2	0	22	22	Q99732-1	0	22	+	22	Q99732-1	0	161	ENST00000571688.5	231	714	++	177	Q99732-1#2	0	66	ENST00000571688.5	231	297	+	66	0	-44	3886
Q99732-1#2	0	22	22	Q99732-1	0	22	+	22	Q99732-1	0	153	ENST00000571627.5	118	577	++	176	Q99732-1#2	0	66	ENST00000571627.5	118	184	+	66	0	-44	3887
Q99732-1#2	0	22	22	Q99732-1	0	22	+	22	Q99732-1	0	73	ENST00000571459.5	23	242	++	175	Q99732-1#2	0	66	ENST00000571459.5	23	89	+	66	0	-44	3888
Q99732-1#2	0	22	22	Q99732-1	0	22	+	22	Q99732-1	0	39	ENST00000571277.1	468	585	++	174	Q99732-1#2	0	66	ENST00000571277.1	468	534	+	66	0	-44	3889
Q99732-1#2	0	22	22	Q99732-1	0	22	+	22	Q99732-1	0	161	ENST00000570904.5	102	585	++	173	Q99732-1#2	0	66	ENST00000570904.5	102	168	+	66	0	-44	3890
Q99732-1#2	0	22	22	Q99732-1	0	22	+	22	Q99732-1	0	137	ENST00000570798.5	181	592	++	172	Q99732-1#2	0	66	ENST00000570798.5	181	247	+	66	0	-44	3891
Q99732-1#2	0	22	22	Q99732-1	0	22	+	22	Q99732-1	0	126	ENST00000413364.6	70	448	++	74	Q99732-1#2	0	66	ENST00000413364.6	70	136	+	66	0	-44	3892
Q99732-1#2	0	22	22	Q99732-1	0	22	+	22	Q99732-1	0	161	ENST00000339430.9	233	716	++	32	Q99732-1#2	0	66	ENST00000339430.9	233	299	+	66	0	-44	3893
Q99732-1#3	0	24	24	Q99732-1	110	134	+	24	Q99732-1	0	161	ENST00000622633.5	39	522	++	225	Q99732-1#3	0	72	ENST00000622633.5	369	441	+	72	0	-48	3894
Q99732-1#3	0	24	24	Q99732-1	110	134	+	24	Q99732-1	0	161	ENST00000576036.5	93	576	++	185	Q99732-1#3	0	72	ENST00000576036.5	423	495	+	72	0	-48	3895
Q99732-1#3	0	24	24	Q99732-1	110	134	+	24	Q99732-1	0	161	ENST00000574763.5	220	703	++	183	Q99732-1#3	0	72	ENST00000574763.5	550	622	+	72	0	-48	3896
Q99732-1#3	0	24	24	Q99732-1	110	134	+	24	Q99732-1	0	126	ENST00000574701.5	144	522	++	181	Q99732-1#3	0	48	ENST00000574701.5	474	522	+	48	0	-24	3897
Q99732-1#3	0	24	24	Q99732-1	110	134	+	24	Q99732-1	93	161	ENST00000572255.5	274	478	++	179	Q99732-1#3	0	72	ENST00000572255.5	325	397	+	72	0	-48	3898
Q99732-1#3	0	24	24	Q99732-1	110	134	+	24	Q99732-1	0	126	ENST00000571976.1	61	439	++	178	Q99732-1#3	0	48	ENST00000571976.1	391	439	+	48	0	-24	3899
Q99732-1#3	0	24	24	Q99732-1	110	134	+	24	Q99732-1	0	161	ENST00000571688.5	231	714	++	177	Q99732-1#3	0	72	ENST00000571688.5	561	633	+	72	0	-48	3900
Q99732-1#3	0	24	24	Q99732-1	110	134	+	24	Q99732-1	0	153	ENST00000571627.5	118	577	++	176	Q99732-1#3	0	72	ENST00000571627.5	448	520	+	72	0	-48	3901
Q99732-1#3	0	24	24	Q99732-1	110	134	+	24	Q99732-1	0	161	ENST00000570904.5	102	585	++	173	Q99732-1#3	0	72	ENST00000570904.5	432	504	+	72	0	-48	3902
Q99732-1#3	0	24	24	Q99732-1	110	134	+	24	Q99732-1	0	137	ENST00000570798.5	181	592	++	172	Q99732-1#3	0	72	ENST00000570798.5	511	583	+	72	0	-48	3903
Q99732-1#3	0	24	24	Q99732-1	110	134	+	24	Q99732-1	0	126	ENST00000413364.6	70	448	++	74	Q99732-1#3	0	48	ENST00000413364.6	400	448	+	48	0	-24	3904
Q99732-1#3	0	24	24	Q99732-1	110	134	+	24	Q99732-1	0	161	ENST00000339430.9	233	716	++	32	Q99732-1#3	0	72	ENST00000339430.9	563	635	+	72	0	-48	3905
Q99732-1#4	0	4	4	Q99732-1	16	20	+	4	Q99732-1	0	161	ENST00000622633.5	39	522	++	225	Q99732-1#4	0	12	ENST00000622633.5	87	99	+	12	0	-8	3906
Q99732-1#4	0	4	4	Q99732-1	16	20	+	4	Q99732-1	0	161	ENST00000576036.5	93	576	++	185	Q99732-1#4	0	12	ENST00000576036.5	141	153	+	12	0	-8	3907
Q99732-1#4	0	4	4	Q99732-1	16	20	+	4	Q99732-1	0	58	ENST00000574848.5	380	554	++	184	Q99732-1#4	0	12	ENST00000574848.5	428	440	+	12	0	-8	3908
Q99732-1#4	0	4	4	Q99732-1	16	20	+	4	Q99732-1	0	161	ENST00000574763.5	220	703	++	183	Q99732-1#4	0	12	ENST00000574763.5	268	280	+	12	0	-8	3909
Q99732-1#4	0	4	4	Q99732-1	16	20	+	4	Q99732-1	0	75	ENST00000574703.5	39	264	++	182	Q99732-1#4	0	12	ENST00000574703.5	87	99	+	12	0	-8	3910
Q99732-1#4	0	4	4	Q99732-1	16	20	+	4	Q99732-1	0	126	ENST00000574701.5	144	522	++	181	Q99732-1#4	0	12	ENST00000574701.5	192	204	+	12	0	-8	3911
Q99732-1#4	0	4	4	Q99732-1	16	20	+	4	Q99732-1	0	74	ENST00000573332.5	39	261	++	180	Q99732-1#4	0	12	ENST00000573332.5	87	99	+	12	0	-8	3912
Q99732-1#4	0	4	4	Q99732-1	16	20	+	4	Q99732-1	0	126	ENST00000571976.1	61	439	++	178	Q99732-1#4	0	12	ENST00000571976.1	109	121	+	12	0	-8	3913
Q99732-1#4	0	4	4	Q99732-1	16	20	+	4	Q99732-1	0	161	ENST00000571688.5	231	714	++	177	Q99732-1#4	0	12	ENST00000571688.5	279	291	+	12	0	-8	3914
Q99732-1#4	0	4	4	Q99732-1	16	20	+	4	Q99732-1	0	153	ENST00000571627.5	118	577	++	176	Q99732-1#4	0	12	ENST00000571627.5	166	178	+	12	0	-8	3915
Q99732-1#4	0	4	4	Q99732-1	16	20	+	4	Q99732-1	0	73	ENST00000571459.5	23	242	++	175	Q99732-1#4	0	12	ENST00000571459.5	71	83	+	12	0	-8	3916
Q99732-1#4	0	4	4	Q99732-1	16	20	+	4	Q99732-1	0	39	ENST00000571277.1	468	585	++	174	Q99732-1#4	0	12	ENST00000571277.1	516	528	+	12	0	-8	3917
Q99732-1#4	0	4	4	Q99732-1	16	20	+	4	Q99732-1	0	161	ENST00000570904.5	102	585	++	173	Q99732-1#4	0	12	ENST00000570904.5	150	162	+	12	0	-8	3918
Q99732-1#4	0	4	4	Q99732-1	16	20	+	4	Q99732-1	0	137	ENST00000570798.5	181	592	++	172	Q99732-1#4	0	12	ENST00000570798.5	229	241	+	12	0	-8	3919
Q99732-1#4	0	4	4	Q99732-1	16	20	+	4	Q99732-1	0	126	ENST00000413364.6	70	448	++	74	Q99732-1#4	0	12	ENST00000413364.6	118	130	+	12	0	-8	3920
Q99732-1#4	0	4	4	Q99732-1	16	20	+	4	Q99732-1	0	161	ENST00000339430.9	233	716	++	32	Q99732-1#4	0	12	ENST00000339430.9	281	293	+	12	0	-8	3921
Q99732-1#5	0	4	4	Q99732-1	19	23	+	4	Q99732-1	0	161	ENST00000622633.5	39	522	++	225	Q99732-1#5	0	12	ENST00000622633.5	96	108	+	12	0	-8	3922
Q99732-1#5	0	4	4	Q99732-1	19	23	+	4	Q99732-1	0	161	ENST00000576036.5	93	576	++	185	Q99732-1#5	0	12	ENST00000576036.5	150	162	+	12	0	-8	3923
Q99732-1#5	0	4	4	Q99732-1	19	23	+	4	Q99732-1	0	58	ENST00000574848.5	380	554	++	184	Q99732-1#5	0	12	ENST00000574848.5	437	449	+	12	0	-8	3924
Q99732-1#5	0	4	4	Q99732-1	19	23	+	4	Q99732-1	0	161	ENST00000574763.5	220	703	++	183	Q99732-1#5	0	12	ENST00000574763.5	277	289	+	12	0	-8	3925
Q99732-1#5	0	4	4	Q99732-1	19	23	+	4	Q99732-1	0	75	ENST00000574703.5	39	264	++	182	Q99732-1#5	0	12	ENST00000574703.5	96	108	+	12	0	-8	3926
Q99732-1#5	0	4	4	Q99732-1	19	23	+	4	Q99732-1	0	126	ENST00000574701.5	144	522	++	181	Q99732-1#5	0	12	ENST00000574701.5	201	213	+	12	0	-8	3927
Q99732-1#5	0	4	4	Q99732-1	19	23	+	4	Q99732-1	0	74	ENST00000573332.5	39	261	++	180	Q99732-1#5	0	12	ENST00000573332.5	96	108	+	12	0	-8	3928
Q99732-1#5	0	4	4	Q99732-1	19	23	+	4	Q99732-1	0	126	ENST00000571976.1	61	439	++	178	Q99732-1#5	0	12	ENST00000571976.1	118	130	+	12	0	-8	3929
Q99732-1#5	0	4	4	Q99732-1	19	23	+	4	Q99732-1	0	161	ENST00000571688.5	231	714	++	177	Q99732-1#5	0	12	ENST00000571688.5	288	300	+	12	0	-8	3930
Q99732-1#5	0	4	4	Q99732-1	19	23	+	4	Q99732-1	0	153	ENST00000571627.5	118	577	++	176	Q99732-1#5	0	12	ENST00000571627.5	175	187	+	12	0	-8	3931
Q99732-1#5	0	4	4	Q99732-1	19	23	+	4	Q99732-1	0	73	ENST00000571459.5	23	242	++	175	Q99732-1#5	0	12	ENST00000571459.5	80	92	+	12	0	-8	3932
Q99732-1#5	0	4	4	Q99732-1	19	23	+	4	Q99732-1	0	39	ENST00000571277.1	468	585	++	174	Q99732-1#5	0	12	ENST00000571277.1	525	537	+	12	0	-8	3933
Q99732-1#5	0	4	4	Q99732-1	19	23	+	4	Q99732-1	0	161	ENST00000570904.5	102	585	++	173	Q99732-1#5	0	12	ENST00000570904.5	159	171	+	12	0	-8	3934
Q99732-1#5	0	4	4	Q99732-1	19	23	+	4	Q99732-1	0	137	ENST00000570798.5	181	592	++	172	Q99732-1#5	0	12	ENST00000570798.5	238	250	+	12	0	-8	3935
Q99732-1#5	0	4	4	Q99732-1	19	23	+	4	Q99732-1	0	126	ENST00000413364.6	70	448	++	74	Q99732-1#5	0	12	ENST00000413364.6	127	139	+	12	0	-8	3936
Q99732-1#5	0	4	4	Q99732-1	19	23	+	4	Q99732-1	0	161	ENST00000339430.9	233	716	++	32	Q99732-1#5	0	12	ENST00000339430.9	290	302	+	12	0	-8	3937
Q99732-1#6	0	16	16	Q99732-1	6	22	+	16	Q99732-1	0	161	ENST00000622633.5	39	522	++	225	Q99732-1#6	0	48	ENST00000622633.5	57	105	+	48	0	-32	3938
Q99732-1#6	0	16	16	Q99732-1	6	22	+	16	Q99732-1	0	161	ENST00000576036.5	93	576	++	185	Q99732-1#6	0	48	ENST00000576036.5	111	159	+	48	0	-32	3939
Q99732-1#6	0	16	16	Q99732-1	6	22	+	16	Q99732-1	0	58	ENST00000574848.5	380	554	++	184	Q99732-1#6	0	48	ENST00000574848.5	398	446	+	48	0	-32	3940
Q99732-1#6	0	16	16	Q99732-1	6	22	+	16	Q99732-1	0	161	ENST00000574763.5	220	703	++	183	Q99732-1#6	0	48	ENST00000574763.5	238	286	+	48	0	-32	3941
Q99732-1#6	0	16	16	Q99732-1	6	22	+	16	Q99732-1	0	75	ENST00000574703.5	39	264	++	182	Q99732-1#6	0	48	ENST00000574703.5	57	105	+	48	0	-32	3942
Q99732-1#6	0	16	16	Q99732-1	6	22	+	16	Q99732-1	0	126	ENST00000574701.5	144	522	++	181	Q99732-1#6	0	48	ENST00000574701.5	162	210	+	48	0	-32	3943
Q99732-1#6	0	16	16	Q99732-1	6	22	+	16	Q99732-1	0	74	ENST00000573332.5	39	261	++	180	Q99732-1#6	0	48	ENST00000573332.5	57	105	+	48	0	-32	3944
Q99732-1#6	0	16	16	Q99732-1	6	22	+	16	Q99732-1	0	126	ENST00000571976.1	61	439	++	178	Q99732-1#6	0	48	ENST00000571976.1	79	127	+	48	0	-32	3945
Q99732-1#6	0	16	16	Q99732-1	6	22	+	16	Q99732-1	0	161	ENST00000571688.5	231	714	++	177	Q99732-1#6	0	48	ENST00000571688.5	249	297	+	48	0	-32	3946
Q99732-1#6	0	16	16	Q99732-1	6	22	+	16	Q99732-1	0	153	ENST00000571627.5	118	577	++	176	Q99732-1#6	0	48	ENST00000571627.5	136	184	+	48	0	-32	3947
Q99732-1#6	0	16	16	Q99732-1	6	22	+	16	Q99732-1	0	73	ENST00000571459.5	23	242	++	175	Q99732-1#6	0	48	ENST00000571459.5	41	89	+	48	0	-32	3948
Q99732-1#6	0	16	16	Q99732-1	6	22	+	16	Q99732-1	0	39	ENST00000571277.1	468	585	++	174	Q99732-1#6	0	48	ENST00000571277.1	486	534	+	48	0	-32	3949
Q99732-1#6	0	16	16	Q99732-1	6	22	+	16	Q99732-1	0	161	ENST00000570904.5	102	585	++	173	Q99732-1#6	0	48	ENST00000570904.5	120	168	+	48	0	-32	3950
Q99732-1#6	0	16	16	Q99732-1	6	22	+	16	Q99732-1	0	137	ENST00000570798.5	181	592	++	172	Q99732-1#6	0	48	ENST00000570798.5	199	247	+	48	0	-32	3951
Q99732-1#6	0	16	16	Q99732-1	6	22	+	16	Q99732-1	0	126	ENST00000413364.6	70	448	++	74	Q99732-1#6	0	48	ENST00000413364.6	88	136	+	48	0	-32	3952
Q99732-1#6	0	16	16	Q99732-1	6	22	+	16	Q99732-1	0	161	ENST00000339430.9	233	716	++	32	Q99732-1#6	0	48	ENST00000339430.9	251	299	+	48	0	-32	3953
Q99732-1#7	0	1	1	Q99732-1	95	96	+	1	Q99732-1	0	161	ENST00000622633.5	39	522	++	225	Q99732-1#7	0	3	ENST00000622633.5	324	327	+	3	0	-2	3954
Q99732-1#7	0	1	1	Q99732-1	95	96	+	1	Q99732-1	0	161	ENST00000576036.5	93	576	++	185	Q99732-1#7	0	3	ENST00000576036.5	378	381	+	3	0	-2	3955
Q99732-1#7	0	1	1	Q99732-1	95	96	+	1	Q99732-1	0	161	ENST00000574763.5	220	703	++	183	Q99732-1#7	0	3	ENST00000574763.5	505	508	+	3	0	-2	3956
Q99732-1#7	0	1	1	Q99732-1	95	96	+	1	Q99732-1	0	126	ENST00000574701.5	144	522	++	181	Q99732-1#7	0	3	ENST00000574701.5	429	432	+	3	0	-2	3957
Q99732-1#7	0	1	1	Q99732-1	95	96	+	1	Q99732-1	93	161	ENST00000572255.5	274	478	++	179	Q99732-1#7	0	3	ENST00000572255.5	280	283	+	3	0	-2	3958
Q99732-1#7	0	1	1	Q99732-1	95	96	+	1	Q99732-1	0	126	ENST00000571976.1	61	439	++	178	Q99732-1#7	0	3	ENST00000571976.1	346	349	+	3	0	-2	3959
Q99732-1#7	0	1	1	Q99732-1	95	96	+	1	Q99732-1	0	161	ENST00000571688.5	231	714	++	177	Q99732-1#7	0	3	ENST00000571688.5	516	519	+	3	0	-2	3960
Q99732-1#7	0	1	1	Q99732-1	95	96	+	1	Q99732-1	0	153	ENST00000571627.5	118	577	++	176	Q99732-1#7	0	3	ENST00000571627.5	403	406	+	3	0	-2	3961
Q99732-1#7	0	1	1	Q99732-1	95	96	+	1	Q99732-1	0	161	ENST00000570904.5	102	585	++	173	Q99732-1#7	0	3	ENST00000570904.5	387	390	+	3	0	-2	3962
Q99732-1#7	0	1	1	Q99732-1	95	96	+	1	Q99732-1	0	137	ENST00000570798.5	181	592	++	172	Q99732-1#7	0	3	ENST00000570798.5	466	469	+	3	0	-2	3963
Q99732-1#7	0	1	1	Q99732-1	95	96	+	1	Q99732-1	0	126	ENST00000413364.6	70	448	++	74	Q99732-1#7	0	3	ENST00000413364.6	355	358	+	3	0	-2	3964
Q99732-1#7	0	1	1	Q99732-1	95	96	+	1	Q99732-1	0	161	ENST00000339430.9	233	716	++	32	Q99732-1#7	0	3	ENST00000339430.9	518	521	+	3	0	-2	3965
Q99732-1#8	0	1	1	Q99732-1	98	99	+	1	Q99732-1	0	161	ENST00000622633.5	39	522	++	225	Q99732-1#8	0	3	ENST00000622633.5	333	336	+	3	0	-2	3966
Q99732-1#8	0	1	1	Q99732-1	98	99	+	1	Q99732-1	0	161	ENST00000576036.5	93	576	++	185	Q99732-1#8	0	3	ENST00000576036.5	387	390	+	3	0	-2	3967
Q99732-1#8	0	1	1	Q99732-1	98	99	+	1	Q99732-1	0	161	ENST00000574763.5	220	703	++	183	Q99732-1#8	0	3	ENST00000574763.5	514	517	+	3	0	-2	3968
Q99732-1#8	0	1	1	Q99732-1	98	99	+	1	Q99732-1	0	126	ENST00000574701.5	144	522	++	181	Q99732-1#8	0	3	ENST00000574701.5	438	441	+	3	0	-2	3969
Q99732-1#8	0	1	1	Q99732-1	98	99	+	1	Q99732-1	93	161	ENST00000572255.5	274	478	++	179	Q99732-1#8	0	3	ENST00000572255.5	289	292	+	3	0	-2	3970
Q99732-1#8	0	1	1	Q99732-1	98	99	+	1	Q99732-1	0	126	ENST00000571976.1	61	439	++	178	Q99732-1#8	0	3	ENST00000571976.1	355	358	+	3	0	-2	3971
Q99732-1#8	0	1	1	Q99732-1	98	99	+	1	Q99732-1	0	161	ENST00000571688.5	231	714	++	177	Q99732-1#8	0	3	ENST00000571688.5	525	528	+	3	0	-2	3972
Q99732-1#8	0	1	1	Q99732-1	98	99	+	1	Q99732-1	0	153	ENST00000571627.5	118	577	++	176	Q99732-1#8	0	3	ENST00000571627.5	412	415	+	3	0	-2	3973
Q99732-1#8	0	1	1	Q99732-1	98	99	+	1	Q99732-1	0	161	ENST00000570904.5	102	585	++	173	Q99732-1#8	0	3	ENST00000570904.5	396	399	+	3	0	-2	3974
Q99732-1#8	0	1	1	Q99732-1	98	99	+	1	Q99732-1	0	137	ENST00000570798.5	181	592	++	172	Q99732-1#8	0	3	ENST00000570798.5	475	478	+	3	0	-2	3975
Q99732-1#8	0	1	1	Q99732-1	98	99	+	1	Q99732-1	0	126	ENST00000413364.6	70	448	++	74	Q99732-1#8	0	3	ENST00000413364.6	364	367	+	3	0	-2	3976
Q99732-1#8	0	1	1	Q99732-1	98	99	+	1	Q99732-1	0	161	ENST00000339430.9	233	716	++	32	Q99732-1#8	0	3	ENST00000339430.9	527	530	+	3	0	-2	3977
Q99732-1#9	0	1	1	Q99732-1	147	148	+	1	Q99732-1	0	161	ENST00000622633.5	39	522	++	225	Q99732-1#9	0	3	ENST00000622633.5	480	483	+	3	0	-2	3978
Q99732-1#9	0	1	1	Q99732-1	147	148	+	1	Q99732-1	0	161	ENST00000576036.5	93	576	++	185	Q99732-1#9	0	3	ENST00000576036.5	534	537	+	3	0	-2	3979
Q99732-1#9	0	1	1	Q99732-1	147	148	+	1	Q99732-1	0	161	ENST00000574763.5	220	703	++	183	Q99732-1#9	0	3	ENST00000574763.5	661	664	+	3	0	-2	3980
Q99732-1#9	0	1	1	Q99732-1	147	148	+	1	Q99732-1	93	161	ENST00000572255.5	274	478	++	179	Q99732-1#9	0	3	ENST00000572255.5	436	439	+	3	0	-2	3981
Q99732-1#9	0	1	1	Q99732-1	147	148	+	1	Q99732-1	0	161	ENST00000571688.5	231	714	++	177	Q99732-1#9	0	3	ENST00000571688.5	672	675	+	3	0	-2	3982
Q99732-1#9	0	1	1	Q99732-1	147	148	+	1	Q99732-1	0	153	ENST00000571627.5	118	577	++	176	Q99732-1#9	0	3	ENST00000571627.5	559	562	+	3	0	-2	3983
Q99732-1#9	0	1	1	Q99732-1	147	148	+	1	Q99732-1	0	161	ENST00000570904.5	102	585	++	173	Q99732-1#9	0	3	ENST00000570904.5	543	546	+	3	0	-2	3984
Q99732-1#9	0	1	1	Q99732-1	147	148	+	1	Q99732-1	0	161	ENST00000339430.9	233	716	++	32	Q99732-1#9	0	3	ENST00000339430.9	674	677	+	3	0	-2	3985
Q99732-1#10	0	1	1	Q99732-1	150	151	+	1	Q99732-1	0	161	ENST00000622633.5	39	522	++	225	Q99732-1#10	0	3	ENST00000622633.5	489	492	+	3	0	-2	3986
Q99732-1#10	0	1	1	Q99732-1	150	151	+	1	Q99732-1	0	161	ENST00000576036.5	93	576	++	185	Q99732-1#10	0	3	ENST00000576036.5	543	546	+	3	0	-2	3987
Q99732-1#10	0	1	1	Q99732-1	150	151	+	1	Q99732-1	0	161	ENST00000574763.5	220	703	++	183	Q99732-1#10	0	3	ENST00000574763.5	670	673	+	3	0	-2	3988
Q99732-1#10	0	1	1	Q99732-1	150	151	+	1	Q99732-1	93	161	ENST00000572255.5	274	478	++	179	Q99732-1#10	0	3	ENST00000572255.5	445	448	+	3	0	-2	3989
Q99732-1#10	0	1	1	Q99732-1	150	151	+	1	Q99732-1	0	161	ENST00000571688.5	231	714	++	177	Q99732-1#10	0	3	ENST00000571688.5	681	684	+	3	0	-2	3990
Q99732-1#10	0	1	1	Q99732-1	150	151	+	1	Q99732-1	0	153	ENST00000571627.5	118	577	++	176	Q99732-1#10	0	3	ENST00000571627.5	568	571	+	3	0	-2	3991
Q99732-1#10	0	1	1	Q99732-1	150	151	+	1	Q99732-1	0	161	ENST00000570904.5	102	585	++	173	Q99732-1#10	0	3	ENST00000570904.5	552	555	+	3	0	-2	3992
Q99732-1#10	0	1	1	Q99732-1	150	151	+	1	Q99732-1	0	161	ENST00000339430.9	233	716	++	32	Q99732-1#10	0	3	ENST00000339430.9	683	686	+	3	0	-2	3993
Q99732-1#11	0	35	35	Q99732-1	126	161	+	35	Q99732-1	0	161	ENST00000622633.5	39	522	++	225	Q99732-1#11	0	105	ENST00000622633.5	417	522	+	105	0	-70	3994
Q99732-1#11	0	35	35	Q99732-1	126	161	+	35	Q99732-1	0	161	ENST00000576036.5	93	576	++	185	Q99732-1#11	0	105	ENST00000576036.5	471	576	+	105	0	-70	3995
Q99732-1#11	0	35	35	Q99732-1	126	161	+	35	Q99732-1	0	161	ENST00000574763.5	220	703	++	183	Q99732-1#11	0	105	ENST00000574763.5	598	703	+	105	0	-70	3996
Q99732-1#11	0	35	35	Q99732-1	126	161	+	35	Q99732-1	93	161	ENST00000572255.5	274	478	++	179	Q99732-1#11	0	105	ENST00000572255.5	373	478	+	105	0	-70	3997
Q99732-1#11	0	35	35	Q99732-1	126	161	+	35	Q99732-1	0	161	ENST00000571688.5	231	714	++	177	Q99732-1#11	0	105	ENST00000571688.5	609	714	+	105	0	-70	3998
Q99732-1#11	0	35	35	Q99732-1	126	161	+	35	Q99732-1	0	153	ENST00000571627.5	118	577	++	176	Q99732-1#11	0	81	ENST00000571627.5	496	577	+	81	0	-46	3999
Q99732-1#11	0	35	35	Q99732-1	126	161	+	35	Q99732-1	0	161	ENST00000570904.5	102	585	++	173	Q99732-1#11	0	105	ENST00000570904.5	480	585	+	105	0	-70	4000
Q99732-1#11	0	35	35	Q99732-1	126	161	+	35	Q99732-1	0	137	ENST00000570798.5	181	592	++	172	Q99732-1#11	0	33	ENST00000570798.5	559	592	+	33	0	2	4001
Q99732-1#11	0	35	35	Q99732-1	126	161	+	35	Q99732-1	0	161	ENST00000339430.9	233	716	++	32	Q99732-1#11	0	105	ENST00000339430.9	611	716	+	105	0	-70	4002
Q99732-1#12	0	35	35	Q99732-1	126	161	+	35	Q99732-1	0	161	ENST00000622633.5	39	522	++	225	Q99732-1#12	0	105	ENST00000622633.5	417	522	+	105	0	-70	4003
Q99732-1#12	0	35	35	Q99732-1	126	161	+	35	Q99732-1	0	161	ENST00000576036.5	93	576	++	185	Q99732-1#12	0	105	ENST00000576036.5	471	576	+	105	0	-70	4004
Q99732-1#12	0	35	35	Q99732-1	126	161	+	35	Q99732-1	0	161	ENST00000574763.5	220	703	++	183	Q99732-1#12	0	105	ENST00000574763.5	598	703	+	105	0	-70	4005
Q99732-1#12	0	35	35	Q99732-1	126	161	+	35	Q99732-1	93	161	ENST00000572255.5	274	478	++	179	Q99732-1#12	0	105	ENST00000572255.5	373	478	+	105	0	-70	4006
Q99732-1#12	0	35	35	Q99732-1	126	161	+	35	Q99732-1	0	161	ENST00000571688.5	231	714	++	177	Q99732-1#12	0	105	ENST00000571688.5	609	714	+	105	0	-70	4007
Q99732-1#12	0	35	35	Q99732-1	126	161	+	35	Q99732-1	0	153	ENST00000571627.5	118	577	++	176	Q99732-1#12	0	81	ENST00000571627.5	496	577	+	81	0	-46	4008
Q99732-1#12	0	35	35	Q99732-1	126	161	+	35	Q99732-1	0	161	ENST00000570904.5	102	585	++	173	Q99732-1#12	0	105	ENST00000570904.5	480	585	+	105	0	-70	4009
Q99732-1#12	0	35	35	Q99732-1	126	161	+	35	Q99732-1	0	137	ENST00000570798.5	181	592	++	172	Q99732-1#12	0	33	ENST00000570798.5	559	592	+	33	0	2	4010
Q99732-1#12	0	35	35	Q99732-1	126	161	+	35	Q99732-1	0	161	ENST00000339430.9	233	716	++	32	Q99732-1#12	0	105	ENST00000339430.9	611	716	+	105	0	-70	4011
Q99732-1#13	0	1	1	Q99732-1	22	23	+	1	Q99732-1	0	161	ENST00000622633.5	39	522	++	225	Q99732-1#13	0	3	ENST00000622633.5	105	108	+	3	0	-2	4012
Q99732-1#13	0	1	1	Q99732-1	22	23	+	1	Q99732-1	0	161	ENST00000576036.5	93	576	++	185	Q99732-1#13	0	3	ENST00000576036.5	159	162	+	3	0	-2	4013
Q99732-1#13	0	1	1	Q99732-1	22	23	+	1	Q99732-1	0	58	ENST00000574848.5	380	554	++	184	Q99732-1#13	0	3	ENST00000574848.5	446	449	+	3	0	-2	4014
Q99732-1#13	0	1	1	Q99732-1	22	23	+	1	Q99732-1	0	161	ENST00000574763.5	220	703	++	183	Q99732-1#13	0	3	ENST00000574763.5	286	289	+	3	0	-2	4015
Q99732-1#13	0	1	1	Q99732-1	22	23	+	1	Q99732-1	0	75	ENST00000574703.5	39	264	++	182	Q99732-1#13	0	3	ENST00000574703.5	105	108	+	3	0	-2	4016
Q99732-1#13	0	1	1	Q99732-1	22	23	+	1	Q99732-1	0	126	ENST00000574701.5	144	522	++	181	Q99732-1#13	0	3	ENST00000574701.5	210	213	+	3	0	-2	4017
Q99732-1#13	0	1	1	Q99732-1	22	23	+	1	Q99732-1	0	74	ENST00000573332.5	39	261	++	180	Q99732-1#13	0	3	ENST00000573332.5	105	108	+	3	0	-2	4018
Q99732-1#13	0	1	1	Q99732-1	22	23	+	1	Q99732-1	0	126	ENST00000571976.1	61	439	++	178	Q99732-1#13	0	3	ENST00000571976.1	127	130	+	3	0	-2	4019
Q99732-1#13	0	1	1	Q99732-1	22	23	+	1	Q99732-1	0	161	ENST00000571688.5	231	714	++	177	Q99732-1#13	0	3	ENST00000571688.5	297	300	+	3	0	-2	4020
Q99732-1#13	0	1	1	Q99732-1	22	23	+	1	Q99732-1	0	153	ENST00000571627.5	118	577	++	176	Q99732-1#13	0	3	ENST00000571627.5	184	187	+	3	0	-2	4021
Q99732-1#13	0	1	1	Q99732-1	22	23	+	1	Q99732-1	0	73	ENST00000571459.5	23	242	++	175	Q99732-1#13	0	3	ENST00000571459.5	89	92	+	3	0	-2	4022
Q99732-1#13	0	1	1	Q99732-1	22	23	+	1	Q99732-1	0	39	ENST00000571277.1	468	585	++	174	Q99732-1#13	0	3	ENST00000571277.1	534	537	+	3	0	-2	4023
Q99732-1#13	0	1	1	Q99732-1	22	23	+	1	Q99732-1	0	161	ENST00000570904.5	102	585	++	173	Q99732-1#13	0	3	ENST00000570904.5	168	171	+	3	0	-2	4024
Q99732-1#13	0	1	1	Q99732-1	22	23	+	1	Q99732-1	0	137	ENST00000570798.5	181	592	++	172	Q99732-1#13	0	3	ENST00000570798.5	247	250	+	3	0	-2	4025
Q99732-1#13	0	1	1	Q99732-1	22	23	+	1	Q99732-1	0	126	ENST00000413364.6	70	448	++	74	Q99732-1#13	0	3	ENST00000413364.6	136	139	+	3	0	-2	4026
Q99732-1#13	0	1	1	Q99732-1	22	23	+	1	Q99732-1	0	161	ENST00000339430.9	233	716	++	32	Q99732-1#13	0	3	ENST00000339430.9	299	302	+	3	0	-2	4027
Q99732-1#14	0	1	1	Q99732-1	48	49	+	1	Q99732-1	0	161	ENST00000622633.5	39	522	++	225	Q99732-1#14	0	3	ENST00000622633.5	183	186	+	3	0	-2	4028
Q99732-1#14	0	1	1	Q99732-1	48	49	+	1	Q99732-1	0	161	ENST00000576036.5	93	576	++	185	Q99732-1#14	0	3	ENST00000576036.5	237	240	+	3	0	-2	4029
Q99732-1#14	0	1	1	Q99732-1	48	49	+	1	Q99732-1	0	58	ENST00000574848.5	380	554	++	184	Q99732-1#14	0	3	ENST00000574848.5	524	527	+	3	0	-2	4030
Q99732-1#14	0	1	1	Q99732-1	48	49	+	1	Q99732-1	0	161	ENST00000574763.5	220	703	++	183	Q99732-1#14	0	3	ENST00000574763.5	364	367	+	3	0	-2	4031
Q99732-1#14	0	1	1	Q99732-1	48	49	+	1	Q99732-1	0	75	ENST00000574703.5	39	264	++	182	Q99732-1#14	0	3	ENST00000574703.5	183	186	+	3	0	-2	4032
Q99732-1#14	0	1	1	Q99732-1	48	49	+	1	Q99732-1	0	126	ENST00000574701.5	144	522	++	181	Q99732-1#14	0	3	ENST00000574701.5	288	291	+	3	0	-2	4033
Q99732-1#14	0	1	1	Q99732-1	48	49	+	1	Q99732-1	0	74	ENST00000573332.5	39	261	++	180	Q99732-1#14	0	3	ENST00000573332.5	183	186	+	3	0	-2	4034
Q99732-1#14	0	1	1	Q99732-1	48	49	+	1	Q99732-1	0	126	ENST00000571976.1	61	439	++	178	Q99732-1#14	0	3	ENST00000571976.1	205	208	+	3	0	-2	4035
Q99732-1#14	0	1	1	Q99732-1	48	49	+	1	Q99732-1	0	161	ENST00000571688.5	231	714	++	177	Q99732-1#14	0	3	ENST00000571688.5	375	378	+	3	0	-2	4036
Q99732-1#14	0	1	1	Q99732-1	48	49	+	1	Q99732-1	0	153	ENST00000571627.5	118	577	++	176	Q99732-1#14	0	3	ENST00000571627.5	262	265	+	3	0	-2	4037
Q99732-1#14	0	1	1	Q99732-1	48	49	+	1	Q99732-1	0	73	ENST00000571459.5	23	242	++	175	Q99732-1#14	0	3	ENST00000571459.5	167	170	+	3	0	-2	4038
Q99732-1#14	0	1	1	Q99732-1	48	49	+	1	Q99732-1	0	161	ENST00000570904.5	102	585	++	173	Q99732-1#14	0	3	ENST00000570904.5	246	249	+	3	0	-2	4039
Q99732-1#14	0	1	1	Q99732-1	48	49	+	1	Q99732-1	0	137	ENST00000570798.5	181	592	++	172	Q99732-1#14	0	3	ENST00000570798.5	325	328	+	3	0	-2	4040
Q99732-1#14	0	1	1	Q99732-1	48	49	+	1	Q99732-1	0	126	ENST00000413364.6	70	448	++	74	Q99732-1#14	0	3	ENST00000413364.6	214	217	+	3	0	-2	4041
Q99732-1#14	0	1	1	Q99732-1	48	49	+	1	Q99732-1	0	161	ENST00000339430.9	233	716	++	32	Q99732-1#14	0	3	ENST00000339430.9	377	380	+	3	0	-2	4042
Q99732-1#15	0	1	1	Q99732-1	91	92	+	1	Q99732-1	0	161	ENST00000622633.5	39	522	++	225	Q99732-1#15	0	3	ENST00000622633.5	312	315	+	3	0	-2	4043
Q99732-1#15	0	1	1	Q99732-1	91	92	+	1	Q99732-1	0	161	ENST00000576036.5	93	576	++	185	Q99732-1#15	0	3	ENST00000576036.5	366	369	+	3	0	-2	4044
Q99732-1#15	0	1	1	Q99732-1	91	92	+	1	Q99732-1	0	161	ENST00000574763.5	220	703	++	183	Q99732-1#15	0	3	ENST00000574763.5	493	496	+	3	0	-2	4045
Q99732-1#15	0	1	1	Q99732-1	91	92	+	1	Q99732-1	0	126	ENST00000574701.5	144	522	++	181	Q99732-1#15	0	3	ENST00000574701.5	417	420	+	3	0	-2	4046
Q99732-1#15	0	1	1	Q99732-1	91	92	+	1	Q99732-1	0	126	ENST00000571976.1	61	439	++	178	Q99732-1#15	0	3	ENST00000571976.1	334	337	+	3	0	-2	4047
Q99732-1#15	0	1	1	Q99732-1	91	92	+	1	Q99732-1	0	161	ENST00000571688.5	231	714	++	177	Q99732-1#15	0	3	ENST00000571688.5	504	507	+	3	0	-2	4048
Q99732-1#15	0	1	1	Q99732-1	91	92	+	1	Q99732-1	0	153	ENST00000571627.5	118	577	++	176	Q99732-1#15	0	3	ENST00000571627.5	391	394	+	3	0	-2	4049
Q99732-1#15	0	1	1	Q99732-1	91	92	+	1	Q99732-1	0	161	ENST00000570904.5	102	585	++	173	Q99732-1#15	0	3	ENST00000570904.5	375	378	+	3	0	-2	4050
Q99732-1#15	0	1	1	Q99732-1	91	92	+	1	Q99732-1	0	137	ENST00000570798.5	181	592	++	172	Q99732-1#15	0	3	ENST00000570798.5	454	457	+	3	0	-2	4051
Q99732-1#15	0	1	1	Q99732-1	91	92	+	1	Q99732-1	0	126	ENST00000413364.6	70	448	++	74	Q99732-1#15	0	3	ENST00000413364.6	343	346	+	3	0	-2	4052
Q99732-1#15	0	1	1	Q99732-1	91	92	+	1	Q99732-1	0	161	ENST00000339430.9	233	716	++	32	Q99732-1#15	0	3	ENST00000339430.9	506	509	+	3	0	-2	4053
Q99732-1#16	0	1	1	Q99732-1	111	112	+	1	Q99732-1	0	161	ENST00000622633.5	39	522	++	225	Q99732-1#16	0	3	ENST00000622633.5	372	375	+	3	0	-2	4054
Q99732-1#16	0	1	1	Q99732-1	111	112	+	1	Q99732-1	0	161	ENST00000576036.5	93	576	++	185	Q99732-1#16	0	3	ENST00000576036.5	426	429	+	3	0	-2	4055
Q99732-1#16	0	1	1	Q99732-1	111	112	+	1	Q99732-1	0	161	ENST00000574763.5	220	703	++	183	Q99732-1#16	0	3	ENST00000574763.5	553	556	+	3	0	-2	4056
Q99732-1#16	0	1	1	Q99732-1	111	112	+	1	Q99732-1	0	126	ENST00000574701.5	144	522	++	181	Q99732-1#16	0	3	ENST00000574701.5	477	480	+	3	0	-2	4057
Q99732-1#16	0	1	1	Q99732-1	111	112	+	1	Q99732-1	93	161	ENST00000572255.5	274	478	++	179	Q99732-1#16	0	3	ENST00000572255.5	328	331	+	3	0	-2	4058
Q99732-1#16	0	1	1	Q99732-1	111	112	+	1	Q99732-1	0	126	ENST00000571976.1	61	439	++	178	Q99732-1#16	0	3	ENST00000571976.1	394	397	+	3	0	-2	4059
Q99732-1#16	0	1	1	Q99732-1	111	112	+	1	Q99732-1	0	161	ENST00000571688.5	231	714	++	177	Q99732-1#16	0	3	ENST00000571688.5	564	567	+	3	0	-2	4060
Q99732-1#16	0	1	1	Q99732-1	111	112	+	1	Q99732-1	0	153	ENST00000571627.5	118	577	++	176	Q99732-1#16	0	3	ENST00000571627.5	451	454	+	3	0	-2	4061
Q99732-1#16	0	1	1	Q99732-1	111	112	+	1	Q99732-1	0	161	ENST00000570904.5	102	585	++	173	Q99732-1#16	0	3	ENST00000570904.5	435	438	+	3	0	-2	4062
Q99732-1#16	0	1	1	Q99732-1	111	112	+	1	Q99732-1	0	137	ENST00000570798.5	181	592	++	172	Q99732-1#16	0	3	ENST00000570798.5	514	517	+	3	0	-2	4063
Q99732-1#16	0	1	1	Q99732-1	111	112	+	1	Q99732-1	0	126	ENST00000413364.6	70	448	++	74	Q99732-1#16	0	3	ENST00000413364.6	403	406	+	3	0	-2	4064
Q99732-1#16	0	1	1	Q99732-1	111	112	+	1	Q99732-1	0	161	ENST00000339430.9	233	716	++	32	Q99732-1#16	0	3	ENST00000339430.9	566	569	+	3	0	-2	4065
Q99732-1#17	0	1	1	Q99732-1	114	115	+	1	Q99732-1	0	161	ENST00000622633.5	39	522	++	225	Q99732-1#17	0	3	ENST00000622633.5	381	384	+	3	0	-2	4066
Q99732-1#17	0	1	1	Q99732-1	114	115	+	1	Q99732-1	0	161	ENST00000576036.5	93	576	++	185	Q99732-1#17	0	3	ENST00000576036.5	435	438	+	3	0	-2	4067
Q99732-1#17	0	1	1	Q99732-1	114	115	+	1	Q99732-1	0	161	ENST00000574763.5	220	703	++	183	Q99732-1#17	0	3	ENST00000574763.5	562	565	+	3	0	-2	4068
Q99732-1#17	0	1	1	Q99732-1	114	115	+	1	Q99732-1	0	126	ENST00000574701.5	144	522	++	181	Q99732-1#17	0	3	ENST00000574701.5	486	489	+	3	0	-2	4069
Q99732-1#17	0	1	1	Q99732-1	114	115	+	1	Q99732-1	93	161	ENST00000572255.5	274	478	++	179	Q99732-1#17	0	3	ENST00000572255.5	337	340	+	3	0	-2	4070
Q99732-1#17	0	1	1	Q99732-1	114	115	+	1	Q99732-1	0	126	ENST00000571976.1	61	439	++	178	Q99732-1#17	0	3	ENST00000571976.1	403	406	+	3	0	-2	4071
Q99732-1#17	0	1	1	Q99732-1	114	115	+	1	Q99732-1	0	161	ENST00000571688.5	231	714	++	177	Q99732-1#17	0	3	ENST00000571688.5	573	576	+	3	0	-2	4072
Q99732-1#17	0	1	1	Q99732-1	114	115	+	1	Q99732-1	0	153	ENST00000571627.5	118	577	++	176	Q99732-1#17	0	3	ENST00000571627.5	460	463	+	3	0	-2	4073
Q99732-1#17	0	1	1	Q99732-1	114	115	+	1	Q99732-1	0	161	ENST00000570904.5	102	585	++	173	Q99732-1#17	0	3	ENST00000570904.5	444	447	+	3	0	-2	4074
Q99732-1#17	0	1	1	Q99732-1	114	115	+	1	Q99732-1	0	137	ENST00000570798.5	181	592	++	172	Q99732-1#17	0	3	ENST00000570798.5	523	526	+	3	0	-2	4075
Q99732-1#17	0	1	1	Q99732-1	114	115	+	1	Q99732-1	0	126	ENST00000413364.6	70	448	++	74	Q99732-1#17	0	3	ENST00000413364.6	412	415	+	3	0	-2	4076
Q99732-1#17	0	1	1	Q99732-1	114	115	+	1	Q99732-1	0	161	ENST00000339430.9	233	716	++	32	Q99732-1#17	0	3	ENST00000339430.9	575	578	+	3	0	-2	4077
Q99732-1#18	0	1	1	Q99732-1	115	116	+	1	Q99732-1	0	161	ENST00000622633.5	39	522	++	225	Q99732-1#18	0	3	ENST00000622633.5	384	387	+	3	0	-2	4078
Q99732-1#18	0	1	1	Q99732-1	115	116	+	1	Q99732-1	0	161	ENST00000576036.5	93	576	++	185	Q99732-1#18	0	3	ENST00000576036.5	438	441	+	3	0	-2	4079
Q99732-1#18	0	1	1	Q99732-1	115	116	+	1	Q99732-1	0	161	ENST00000574763.5	220	703	++	183	Q99732-1#18	0	3	ENST00000574763.5	565	568	+	3	0	-2	4080
Q99732-1#18	0	1	1	Q99732-1	115	116	+	1	Q99732-1	0	126	ENST00000574701.5	144	522	++	181	Q99732-1#18	0	3	ENST00000574701.5	489	492	+	3	0	-2	4081
Q99732-1#18	0	1	1	Q99732-1	115	116	+	1	Q99732-1	93	161	ENST00000572255.5	274	478	++	179	Q99732-1#18	0	3	ENST00000572255.5	340	343	+	3	0	-2	4082
Q99732-1#18	0	1	1	Q99732-1	115	116	+	1	Q99732-1	0	126	ENST00000571976.1	61	439	++	178	Q99732-1#18	0	3	ENST00000571976.1	406	409	+	3	0	-2	4083
Q99732-1#18	0	1	1	Q99732-1	115	116	+	1	Q99732-1	0	161	ENST00000571688.5	231	714	++	177	Q99732-1#18	0	3	ENST00000571688.5	576	579	+	3	0	-2	4084
Q99732-1#18	0	1	1	Q99732-1	115	116	+	1	Q99732-1	0	153	ENST00000571627.5	118	577	++	176	Q99732-1#18	0	3	ENST00000571627.5	463	466	+	3	0	-2	4085
Q99732-1#18	0	1	1	Q99732-1	115	116	+	1	Q99732-1	0	161	ENST00000570904.5	102	585	++	173	Q99732-1#18	0	3	ENST00000570904.5	447	450	+	3	0	-2	4086
Q99732-1#18	0	1	1	Q99732-1	115	116	+	1	Q99732-1	0	137	ENST00000570798.5	181	592	++	172	Q99732-1#18	0	3	ENST00000570798.5	526	529	+	3	0	-2	4087
Q99732-1#18	0	1	1	Q99732-1	115	116	+	1	Q99732-1	0	126	ENST00000413364.6	70	448	++	74	Q99732-1#18	0	3	ENST00000413364.6	415	418	+	3	0	-2	4088
Q99732-1#18	0	1	1	Q99732-1	115	116	+	1	Q99732-1	0	161	ENST00000339430.9	233	716	++	32	Q99732-1#18	0	3	ENST00000339430.9	578	581	+	3	0	-2	4089
Q99732-1#19	0	1	1	Q99732-1	121	122	+	1	Q99732-1	0	161	ENST00000622633.5	39	522	++	225	Q99732-1#19	0	3	ENST00000622633.5	402	405	+	3	0	-2	4090
Q99732-1#19	0	1	1	Q99732-1	121	122	+	1	Q99732-1	0	161	ENST00000576036.5	93	576	++	185	Q99732-1#19	0	3	ENST00000576036.5	456	459	+	3	0	-2	4091
Q99732-1#19	0	1	1	Q99732-1	121	122	+	1	Q99732-1	0	161	ENST00000574763.5	220	703	++	183	Q99732-1#19	0	3	ENST00000574763.5	583	586	+	3	0	-2	4092
Q99732-1#19	0	1	1	Q99732-1	121	122	+	1	Q99732-1	0	126	ENST00000574701.5	144	522	++	181	Q99732-1#19	0	3	ENST00000574701.5	507	510	+	3	0	-2	4093
Q99732-1#19	0	1	1	Q99732-1	121	122	+	1	Q99732-1	93	161	ENST00000572255.5	274	478	++	179	Q99732-1#19	0	3	ENST00000572255.5	358	361	+	3	0	-2	4094
Q99732-1#19	0	1	1	Q99732-1	121	122	+	1	Q99732-1	0	126	ENST00000571976.1	61	439	++	178	Q99732-1#19	0	3	ENST00000571976.1	424	427	+	3	0	-2	4095
Q99732-1#19	0	1	1	Q99732-1	121	122	+	1	Q99732-1	0	161	ENST00000571688.5	231	714	++	177	Q99732-1#19	0	3	ENST00000571688.5	594	597	+	3	0	-2	4096
Q99732-1#19	0	1	1	Q99732-1	121	122	+	1	Q99732-1	0	153	ENST00000571627.5	118	577	++	176	Q99732-1#19	0	3	ENST00000571627.5	481	484	+	3	0	-2	4097
Q99732-1#19	0	1	1	Q99732-1	121	122	+	1	Q99732-1	0	161	ENST00000570904.5	102	585	++	173	Q99732-1#19	0	3	ENST00000570904.5	465	468	+	3	0	-2	4098
Q99732-1#19	0	1	1	Q99732-1	121	122	+	1	Q99732-1	0	137	ENST00000570798.5	181	592	++	172	Q99732-1#19	0	3	ENST00000570798.5	544	547	+	3	0	-2	4099
Q99732-1#19	0	1	1	Q99732-1	121	122	+	1	Q99732-1	0	126	ENST00000413364.6	70	448	++	74	Q99732-1#19	0	3	ENST00000413364.6	433	436	+	3	0	-2	4100
Q99732-1#19	0	1	1	Q99732-1	121	122	+	1	Q99732-1	0	161	ENST00000339430.9	233	716	++	32	Q99732-1#19	0	3	ENST00000339430.9	596	599	+	3	0	-2	4101
Q99732-1#20	0	4	4	Q99732-1	16	20	+	4	Q99732-1	0	161	ENST00000622633.5	39	522	++	225	Q99732-1#20	0	12	ENST00000622633.5	87	99	+	12	0	-8	4102
Q99732-1#20	0	4	4	Q99732-1	16	20	+	4	Q99732-1	0	161	ENST00000576036.5	93	576	++	185	Q99732-1#20	0	12	ENST00000576036.5	141	153	+	12	0	-8	4103
Q99732-1#20	0	4	4	Q99732-1	16	20	+	4	Q99732-1	0	58	ENST00000574848.5	380	554	++	184	Q99732-1#20	0	12	ENST00000574848.5	428	440	+	12	0	-8	4104
Q99732-1#20	0	4	4	Q99732-1	16	20	+	4	Q99732-1	0	161	ENST00000574763.5	220	703	++	183	Q99732-1#20	0	12	ENST00000574763.5	268	280	+	12	0	-8	4105
Q99732-1#20	0	4	4	Q99732-1	16	20	+	4	Q99732-1	0	75	ENST00000574703.5	39	264	++	182	Q99732-1#20	0	12	ENST00000574703.5	87	99	+	12	0	-8	4106
Q99732-1#20	0	4	4	Q99732-1	16	20	+	4	Q99732-1	0	126	ENST00000574701.5	144	522	++	181	Q99732-1#20	0	12	ENST00000574701.5	192	204	+	12	0	-8	4107
Q99732-1#20	0	4	4	Q99732-1	16	20	+	4	Q99732-1	0	74	ENST00000573332.5	39	261	++	180	Q99732-1#20	0	12	ENST00000573332.5	87	99	+	12	0	-8	4108
Q99732-1#20	0	4	4	Q99732-1	16	20	+	4	Q99732-1	0	126	ENST00000571976.1	61	439	++	178	Q99732-1#20	0	12	ENST00000571976.1	109	121	+	12	0	-8	4109
Q99732-1#20	0	4	4	Q99732-1	16	20	+	4	Q99732-1	0	161	ENST00000571688.5	231	714	++	177	Q99732-1#20	0	12	ENST00000571688.5	279	291	+	12	0	-8	4110
Q99732-1#20	0	4	4	Q99732-1	16	20	+	4	Q99732-1	0	153	ENST00000571627.5	118	577	++	176	Q99732-1#20	0	12	ENST00000571627.5	166	178	+	12	0	-8	4111
Q99732-1#20	0	4	4	Q99732-1	16	20	+	4	Q99732-1	0	73	ENST00000571459.5	23	242	++	175	Q99732-1#20	0	12	ENST00000571459.5	71	83	+	12	0	-8	4112
Q99732-1#20	0	4	4	Q99732-1	16	20	+	4	Q99732-1	0	39	ENST00000571277.1	468	585	++	174	Q99732-1#20	0	12	ENST00000571277.1	516	528	+	12	0	-8	4113
Q99732-1#20	0	4	4	Q99732-1	16	20	+	4	Q99732-1	0	161	ENST00000570904.5	102	585	++	173	Q99732-1#20	0	12	ENST00000570904.5	150	162	+	12	0	-8	4114
Q99732-1#20	0	4	4	Q99732-1	16	20	+	4	Q99732-1	0	137	ENST00000570798.5	181	592	++	172	Q99732-1#20	0	12	ENST00000570798.5	229	241	+	12	0	-8	4115
Q99732-1#20	0	4	4	Q99732-1	16	20	+	4	Q99732-1	0	126	ENST00000413364.6	70	448	++	74	Q99732-1#20	0	12	ENST00000413364.6	118	130	+	12	0	-8	4116
Q99732-1#20	0	4	4	Q99732-1	16	20	+	4	Q99732-1	0	161	ENST00000339430.9	233	716	++	32	Q99732-1#20	0	12	ENST00000339430.9	281	293	+	12	0	-8	4117
Q99732-1#21	0	3	3	Q99732-1	16	19	+	3	Q99732-1	0	161	ENST00000622633.5	39	522	++	225	Q99732-1#21	0	9	ENST00000622633.5	87	96	+	9	0	-6	4118
Q99732-1#21	0	3	3	Q99732-1	16	19	+	3	Q99732-1	0	161	ENST00000576036.5	93	576	++	185	Q99732-1#21	0	9	ENST00000576036.5	141	150	+	9	0	-6	4119
Q99732-1#21	0	3	3	Q99732-1	16	19	+	3	Q99732-1	0	58	ENST00000574848.5	380	554	++	184	Q99732-1#21	0	9	ENST00000574848.5	428	437	+	9	0	-6	4120
Q99732-1#21	0	3	3	Q99732-1	16	19	+	3	Q99732-1	0	161	ENST00000574763.5	220	703	++	183	Q99732-1#21	0	9	ENST00000574763.5	268	277	+	9	0	-6	4121
Q99732-1#21	0	3	3	Q99732-1	16	19	+	3	Q99732-1	0	75	ENST00000574703.5	39	264	++	182	Q99732-1#21	0	9	ENST00000574703.5	87	96	+	9	0	-6	4122
Q99732-1#21	0	3	3	Q99732-1	16	19	+	3	Q99732-1	0	126	ENST00000574701.5	144	522	++	181	Q99732-1#21	0	9	ENST00000574701.5	192	201	+	9	0	-6	4123
Q99732-1#21	0	3	3	Q99732-1	16	19	+	3	Q99732-1	0	74	ENST00000573332.5	39	261	++	180	Q99732-1#21	0	9	ENST00000573332.5	87	96	+	9	0	-6	4124
Q99732-1#21	0	3	3	Q99732-1	16	19	+	3	Q99732-1	0	126	ENST00000571976.1	61	439	++	178	Q99732-1#21	0	9	ENST00000571976.1	109	118	+	9	0	-6	4125
Q99732-1#21	0	3	3	Q99732-1	16	19	+	3	Q99732-1	0	161	ENST00000571688.5	231	714	++	177	Q99732-1#21	0	9	ENST00000571688.5	279	288	+	9	0	-6	4126
Q99732-1#21	0	3	3	Q99732-1	16	19	+	3	Q99732-1	0	153	ENST00000571627.5	118	577	++	176	Q99732-1#21	0	9	ENST00000571627.5	166	175	+	9	0	-6	4127
Q99732-1#21	0	3	3	Q99732-1	16	19	+	3	Q99732-1	0	73	ENST00000571459.5	23	242	++	175	Q99732-1#21	0	9	ENST00000571459.5	71	80	+	9	0	-6	4128
Q99732-1#21	0	3	3	Q99732-1	16	19	+	3	Q99732-1	0	39	ENST00000571277.1	468	585	++	174	Q99732-1#21	0	9	ENST00000571277.1	516	525	+	9	0	-6	4129
Q99732-1#21	0	3	3	Q99732-1	16	19	+	3	Q99732-1	0	161	ENST00000570904.5	102	585	++	173	Q99732-1#21	0	9	ENST00000570904.5	150	159	+	9	0	-6	4130
Q99732-1#21	0	3	3	Q99732-1	16	19	+	3	Q99732-1	0	137	ENST00000570798.5	181	592	++	172	Q99732-1#21	0	9	ENST00000570798.5	229	238	+	9	0	-6	4131
Q99732-1#21	0	3	3	Q99732-1	16	19	+	3	Q99732-1	0	126	ENST00000413364.6	70	448	++	74	Q99732-1#21	0	9	ENST00000413364.6	118	127	+	9	0	-6	4132
Q99732-1#21	0	3	3	Q99732-1	16	19	+	3	Q99732-1	0	161	ENST00000339430.9	233	716	++	32	Q99732-1#21	0	9	ENST00000339430.9	281	290	+	9	0	-6	4133
Q99732-1#22	0	1	1	Q99732-1	22	23	+	1	Q99732-1	0	161	ENST00000622633.5	39	522	++	225	Q99732-1#22	0	3	ENST00000622633.5	105	108	+	3	0	-2	4134
Q99732-1#22	0	1	1	Q99732-1	22	23	+	1	Q99732-1	0	161	ENST00000576036.5	93	576	++	185	Q99732-1#22	0	3	ENST00000576036.5	159	162	+	3	0	-2	4135
Q99732-1#22	0	1	1	Q99732-1	22	23	+	1	Q99732-1	0	58	ENST00000574848.5	380	554	++	184	Q99732-1#22	0	3	ENST00000574848.5	446	449	+	3	0	-2	4136
Q99732-1#22	0	1	1	Q99732-1	22	23	+	1	Q99732-1	0	161	ENST00000574763.5	220	703	++	183	Q99732-1#22	0	3	ENST00000574763.5	286	289	+	3	0	-2	4137
Q99732-1#22	0	1	1	Q99732-1	22	23	+	1	Q99732-1	0	75	ENST00000574703.5	39	264	++	182	Q99732-1#22	0	3	ENST00000574703.5	105	108	+	3	0	-2	4138
Q99732-1#22	0	1	1	Q99732-1	22	23	+	1	Q99732-1	0	126	ENST00000574701.5	144	522	++	181	Q99732-1#22	0	3	ENST00000574701.5	210	213	+	3	0	-2	4139
Q99732-1#22	0	1	1	Q99732-1	22	23	+	1	Q99732-1	0	74	ENST00000573332.5	39	261	++	180	Q99732-1#22	0	3	ENST00000573332.5	105	108	+	3	0	-2	4140
Q99732-1#22	0	1	1	Q99732-1	22	23	+	1	Q99732-1	0	126	ENST00000571976.1	61	439	++	178	Q99732-1#22	0	3	ENST00000571976.1	127	130	+	3	0	-2	4141
Q99732-1#22	0	1	1	Q99732-1	22	23	+	1	Q99732-1	0	161	ENST00000571688.5	231	714	++	177	Q99732-1#22	0	3	ENST00000571688.5	297	300	+	3	0	-2	4142
Q99732-1#22	0	1	1	Q99732-1	22	23	+	1	Q99732-1	0	153	ENST00000571627.5	118	577	++	176	Q99732-1#22	0	3	ENST00000571627.5	184	187	+	3	0	-2	4143
Q99732-1#22	0	1	1	Q99732-1	22	23	+	1	Q99732-1	0	73	ENST00000571459.5	23	242	++	175	Q99732-1#22	0	3	ENST00000571459.5	89	92	+	3	0	-2	4144
Q99732-1#22	0	1	1	Q99732-1	22	23	+	1	Q99732-1	0	39	ENST00000571277.1	468	585	++	174	Q99732-1#22	0	3	ENST00000571277.1	534	537	+	3	0	-2	4145
Q99732-1#22	0	1	1	Q99732-1	22	23	+	1	Q99732-1	0	161	ENST00000570904.5	102	585	++	173	Q99732-1#22	0	3	ENST00000570904.5	168	171	+	3	0	-2	4146
Q99732-1#22	0	1	1	Q99732-1	22	23	+	1	Q99732-1	0	137	ENST00000570798.5	181	592	++	172	Q99732-1#22	0	3	ENST00000570798.5	247	250	+	3	0	-2	4147
Q99732-1#22	0	1	1	Q99732-1	22	23	+	1	Q99732-1	0	126	ENST00000413364.6	70	448	++	74	Q99732-1#22	0	3	ENST00000413364.6	136	139	+	3	0	-2	4148
Q99732-1#22	0	1	1	Q99732-1	22	23	+	1	Q99732-1	0	161	ENST00000339430.9	233	716	++	32	Q99732-1#22	0	3	ENST00000339430.9	299	302	+	3	0	-2	4149
Q99732-1#23	0	1	1	Q99732-1	22	23	+	1	Q99732-1	0	161	ENST00000622633.5	39	522	++	225	Q99732-1#23	0	3	ENST00000622633.5	105	108	+	3	0	-2	4150
Q99732-1#23	0	1	1	Q99732-1	22	23	+	1	Q99732-1	0	161	ENST00000576036.5	93	576	++	185	Q99732-1#23	0	3	ENST00000576036.5	159	162	+	3	0	-2	4151
Q99732-1#23	0	1	1	Q99732-1	22	23	+	1	Q99732-1	0	58	ENST00000574848.5	380	554	++	184	Q99732-1#23	0	3	ENST00000574848.5	446	449	+	3	0	-2	4152
Q99732-1#23	0	1	1	Q99732-1	22	23	+	1	Q99732-1	0	161	ENST00000574763.5	220	703	++	183	Q99732-1#23	0	3	ENST00000574763.5	286	289	+	3	0	-2	4153
Q99732-1#23	0	1	1	Q99732-1	22	23	+	1	Q99732-1	0	75	ENST00000574703.5	39	264	++	182	Q99732-1#23	0	3	ENST00000574703.5	105	108	+	3	0	-2	4154
Q99732-1#23	0	1	1	Q99732-1	22	23	+	1	Q99732-1	0	126	ENST00000574701.5	144	522	++	181	Q99732-1#23	0	3	ENST00000574701.5	210	213	+	3	0	-2	4155
Q99732-1#23	0	1	1	Q99732-1	22	23	+	1	Q99732-1	0	74	ENST00000573332.5	39	261	++	180	Q99732-1#23	0	3	ENST00000573332.5	105	108	+	3	0	-2	4156
Q99732-1#23	0	1	1	Q99732-1	22	23	+	1	Q99732-1	0	126	ENST00000571976.1	61	439	++	178	Q99732-1#23	0	3	ENST00000571976.1	127	130	+	3	0	-2	4157
Q99732-1#23	0	1	1	Q99732-1	22	23	+	1	Q99732-1	0	161	ENST00000571688.5	231	714	++	177	Q99732-1#23	0	3	ENST00000571688.5	297	300	+	3	0	-2	4158
Q99732-1#23	0	1	1	Q99732-1	22	23	+	1	Q99732-1	0	153	ENST00000571627.5	118	577	++	176	Q99732-1#23	0	3	ENST00000571627.5	184	187	+	3	0	-2	4159
Q99732-1#23	0	1	1	Q99732-1	22	23	+	1	Q99732-1	0	73	ENST00000571459.5	23	242	++	175	Q99732-1#23	0	3	ENST00000571459.5	89	92	+	3	0	-2	4160
Q99732-1#23	0	1	1	Q99732-1	22	23	+	1	Q99732-1	0	39	ENST00000571277.1	468	585	++	174	Q99732-1#23	0	3	ENST00000571277.1	534	537	+	3	0	-2	4161
Q99732-1#23	0	1	1	Q99732-1	22	23	+	1	Q99732-1	0	161	ENST00000570904.5	102	585	++	173	Q99732-1#23	0	3	ENST00000570904.5	168	171	+	3	0	-2	4162
Q99732-1#23	0	1	1	Q99732-1	22	23	+	1	Q99732-1	0	137	ENST00000570798.5	181	592	++	172	Q99732-1#23	0	3	ENST00000570798.5	247	250	+	3	0	-2	4163
Q99732-1#23	0	1	1	Q99732-1	22	23	+	1	Q99732-1	0	126	ENST00000413364.6	70	448	++	74	Q99732-1#23	0	3	ENST00000413364.6	136	139	+	3	0	-2	4164
Q99732-1#23	0	1	1	Q99732-1	22	23	+	1	Q99732-1	0	161	ENST00000339430.9	233	716	++	32	Q99732-1#23	0	3	ENST00000339430.9	299	302	+	3	0	-2	4165
Q99732-1#24	0	1	1	Q99732-1	60	61	+	1	Q99732-1	0	161	ENST00000622633.5	39	522	++	225	Q99732-1#24	0	3	ENST00000622633.5	219	222	+	3	0	-2	4166
Q99732-1#24	0	1	1	Q99732-1	60	61	+	1	Q99732-1	0	161	ENST00000576036.5	93	576	++	185	Q99732-1#24	0	3	ENST00000576036.5	273	276	+	3	0	-2	4167
Q99732-1#24	0	1	1	Q99732-1	60	61	+	1	Q99732-1	0	161	ENST00000574763.5	220	703	++	183	Q99732-1#24	0	3	ENST00000574763.5	400	403	+	3	0	-2	4168
Q99732-1#24	0	1	1	Q99732-1	60	61	+	1	Q99732-1	0	75	ENST00000574703.5	39	264	++	182	Q99732-1#24	0	3	ENST00000574703.5	219	222	+	3	0	-2	4169
Q99732-1#24	0	1	1	Q99732-1	60	61	+	1	Q99732-1	0	126	ENST00000574701.5	144	522	++	181	Q99732-1#24	0	3	ENST00000574701.5	324	327	+	3	0	-2	4170
Q99732-1#24	0	1	1	Q99732-1	60	61	+	1	Q99732-1	0	74	ENST00000573332.5	39	261	++	180	Q99732-1#24	0	3	ENST00000573332.5	219	222	+	3	0	-2	4171
Q99732-1#24	0	1	1	Q99732-1	60	61	+	1	Q99732-1	0	126	ENST00000571976.1	61	439	++	178	Q99732-1#24	0	3	ENST00000571976.1	241	244	+	3	0	-2	4172
Q99732-1#24	0	1	1	Q99732-1	60	61	+	1	Q99732-1	0	161	ENST00000571688.5	231	714	++	177	Q99732-1#24	0	3	ENST00000571688.5	411	414	+	3	0	-2	4173
Q99732-1#24	0	1	1	Q99732-1	60	61	+	1	Q99732-1	0	153	ENST00000571627.5	118	577	++	176	Q99732-1#24	0	3	ENST00000571627.5	298	301	+	3	0	-2	4174
Q99732-1#24	0	1	1	Q99732-1	60	61	+	1	Q99732-1	0	73	ENST00000571459.5	23	242	++	175	Q99732-1#24	0	3	ENST00000571459.5	203	206	+	3	0	-2	4175
Q99732-1#24	0	1	1	Q99732-1	60	61	+	1	Q99732-1	0	161	ENST00000570904.5	102	585	++	173	Q99732-1#24	0	3	ENST00000570904.5	282	285	+	3	0	-2	4176
Q99732-1#24	0	1	1	Q99732-1	60	61	+	1	Q99732-1	0	137	ENST00000570798.5	181	592	++	172	Q99732-1#24	0	3	ENST00000570798.5	361	364	+	3	0	-2	4177
Q99732-1#24	0	1	1	Q99732-1	60	61	+	1	Q99732-1	0	126	ENST00000413364.6	70	448	++	74	Q99732-1#24	0	3	ENST00000413364.6	250	253	+	3	0	-2	4178
Q99732-1#24	0	1	1	Q99732-1	60	61	+	1	Q99732-1	0	161	ENST00000339430.9	233	716	++	32	Q99732-1#24	0	3	ENST00000339430.9	413	416	+	3	0	-2	4179
Q99732-1#25	0	1	1	Q99732-1	95	96	+	1	Q99732-1	0	161	ENST00000622633.5	39	522	++	225	Q99732-1#25	0	3	ENST00000622633.5	324	327	+	3	0	-2	4180
Q99732-1#25	0	1	1	Q99732-1	95	96	+	1	Q99732-1	0	161	ENST00000576036.5	93	576	++	185	Q99732-1#25	0	3	ENST00000576036.5	378	381	+	3	0	-2	4181
Q99732-1#25	0	1	1	Q99732-1	95	96	+	1	Q99732-1	0	161	ENST00000574763.5	220	703	++	183	Q99732-1#25	0	3	ENST00000574763.5	505	508	+	3	0	-2	4182
Q99732-1#25	0	1	1	Q99732-1	95	96	+	1	Q99732-1	0	126	ENST00000574701.5	144	522	++	181	Q99732-1#25	0	3	ENST00000574701.5	429	432	+	3	0	-2	4183
Q99732-1#25	0	1	1	Q99732-1	95	96	+	1	Q99732-1	93	161	ENST00000572255.5	274	478	++	179	Q99732-1#25	0	3	ENST00000572255.5	280	283	+	3	0	-2	4184
Q99732-1#25	0	1	1	Q99732-1	95	96	+	1	Q99732-1	0	126	ENST00000571976.1	61	439	++	178	Q99732-1#25	0	3	ENST00000571976.1	346	349	+	3	0	-2	4185
Q99732-1#25	0	1	1	Q99732-1	95	96	+	1	Q99732-1	0	161	ENST00000571688.5	231	714	++	177	Q99732-1#25	0	3	ENST00000571688.5	516	519	+	3	0	-2	4186
Q99732-1#25	0	1	1	Q99732-1	95	96	+	1	Q99732-1	0	153	ENST00000571627.5	118	577	++	176	Q99732-1#25	0	3	ENST00000571627.5	403	406	+	3	0	-2	4187
Q99732-1#25	0	1	1	Q99732-1	95	96	+	1	Q99732-1	0	161	ENST00000570904.5	102	585	++	173	Q99732-1#25	0	3	ENST00000570904.5	387	390	+	3	0	-2	4188
Q99732-1#25	0	1	1	Q99732-1	95	96	+	1	Q99732-1	0	137	ENST00000570798.5	181	592	++	172	Q99732-1#25	0	3	ENST00000570798.5	466	469	+	3	0	-2	4189
Q99732-1#25	0	1	1	Q99732-1	95	96	+	1	Q99732-1	0	126	ENST00000413364.6	70	448	++	74	Q99732-1#25	0	3	ENST00000413364.6	355	358	+	3	0	-2	4190
Q99732-1#25	0	1	1	Q99732-1	95	96	+	1	Q99732-1	0	161	ENST00000339430.9	233	716	++	32	Q99732-1#25	0	3	ENST00000339430.9	518	521	+	3	0	-2	4191
Q99732-1#26	0	1	1	Q99732-1	134	135	+	1	Q99732-1	0	161	ENST00000622633.5	39	522	++	225	Q99732-1#26	0	3	ENST00000622633.5	441	444	+	3	0	-2	4192
Q99732-1#26	0	1	1	Q99732-1	134	135	+	1	Q99732-1	0	161	ENST00000576036.5	93	576	++	185	Q99732-1#26	0	3	ENST00000576036.5	495	498	+	3	0	-2	4193
Q99732-1#26	0	1	1	Q99732-1	134	135	+	1	Q99732-1	0	161	ENST00000574763.5	220	703	++	183	Q99732-1#26	0	3	ENST00000574763.5	622	625	+	3	0	-2	4194
Q99732-1#26	0	1	1	Q99732-1	134	135	+	1	Q99732-1	93	161	ENST00000572255.5	274	478	++	179	Q99732-1#26	0	3	ENST00000572255.5	397	400	+	3	0	-2	4195
Q99732-1#26	0	1	1	Q99732-1	134	135	+	1	Q99732-1	0	161	ENST00000571688.5	231	714	++	177	Q99732-1#26	0	3	ENST00000571688.5	633	636	+	3	0	-2	4196
Q99732-1#26	0	1	1	Q99732-1	134	135	+	1	Q99732-1	0	153	ENST00000571627.5	118	577	++	176	Q99732-1#26	0	3	ENST00000571627.5	520	523	+	3	0	-2	4197
Q99732-1#26	0	1	1	Q99732-1	134	135	+	1	Q99732-1	0	161	ENST00000570904.5	102	585	++	173	Q99732-1#26	0	3	ENST00000570904.5	504	507	+	3	0	-2	4198
Q99732-1#26	0	1	1	Q99732-1	134	135	+	1	Q99732-1	0	137	ENST00000570798.5	181	592	++	172	Q99732-1#26	0	3	ENST00000570798.5	583	586	+	3	0	-2	4199
Q99732-1#26	0	1	1	Q99732-1	134	135	+	1	Q99732-1	0	161	ENST00000339430.9	233	716	++	32	Q99732-1#26	0	3	ENST00000339430.9	635	638	+	3	0	-2	4200
Q99732-1#27	0	1	1	Q99732-1	143	144	+	1	Q99732-1	0	161	ENST00000622633.5	39	522	++	225	Q99732-1#27	0	3	ENST00000622633.5	468	471	+	3	0	-2	4201
Q99732-1#27	0	1	1	Q99732-1	143	144	+	1	Q99732-1	0	161	ENST00000576036.5	93	576	++	185	Q99732-1#27	0	3	ENST00000576036.5	522	525	+	3	0	-2	4202
Q99732-1#27	0	1	1	Q99732-1	143	144	+	1	Q99732-1	0	161	ENST00000574763.5	220	703	++	183	Q99732-1#27	0	3	ENST00000574763.5	649	652	+	3	0	-2	4203
Q99732-1#27	0	1	1	Q99732-1	143	144	+	1	Q99732-1	93	161	ENST00000572255.5	274	478	++	179	Q99732-1#27	0	3	ENST00000572255.5	424	427	+	3	0	-2	4204
Q99732-1#27	0	1	1	Q99732-1	143	144	+	1	Q99732-1	0	161	ENST00000571688.5	231	714	++	177	Q99732-1#27	0	3	ENST00000571688.5	660	663	+	3	0	-2	4205
Q99732-1#27	0	1	1	Q99732-1	143	144	+	1	Q99732-1	0	153	ENST00000571627.5	118	577	++	176	Q99732-1#27	0	3	ENST00000571627.5	547	550	+	3	0	-2	4206
Q99732-1#27	0	1	1	Q99732-1	143	144	+	1	Q99732-1	0	161	ENST00000570904.5	102	585	++	173	Q99732-1#27	0	3	ENST00000570904.5	531	534	+	3	0	-2	4207
Q99732-1#27	0	1	1	Q99732-1	143	144	+	1	Q99732-1	0	161	ENST00000339430.9	233	716	++	32	Q99732-1#27	0	3	ENST00000339430.9	662	665	+	3	0	-2	4208
Q99732-1#28	0	1	1	Q99732-1	147	148	+	1	Q99732-1	0	161	ENST00000622633.5	39	522	++	225	Q99732-1#28	0	3	ENST00000622633.5	480	483	+	3	0	-2	4209
Q99732-1#28	0	1	1	Q99732-1	147	148	+	1	Q99732-1	0	161	ENST00000576036.5	93	576	++	185	Q99732-1#28	0	3	ENST00000576036.5	534	537	+	3	0	-2	4210
Q99732-1#28	0	1	1	Q99732-1	147	148	+	1	Q99732-1	0	161	ENST00000574763.5	220	703	++	183	Q99732-1#28	0	3	ENST00000574763.5	661	664	+	3	0	-2	4211
Q99732-1#28	0	1	1	Q99732-1	147	148	+	1	Q99732-1	93	161	ENST00000572255.5	274	478	++	179	Q99732-1#28	0	3	ENST00000572255.5	436	439	+	3	0	-2	4212
Q99732-1#28	0	1	1	Q99732-1	147	148	+	1	Q99732-1	0	161	ENST00000571688.5	231	714	++	177	Q99732-1#28	0	3	ENST00000571688.5	672	675	+	3	0	-2	4213
Q99732-1#28	0	1	1	Q99732-1	147	148	+	1	Q99732-1	0	153	ENST00000571627.5	118	577	++	176	Q99732-1#28	0	3	ENST00000571627.5	559	562	+	3	0	-2	4214
Q99732-1#28	0	1	1	Q99732-1	147	148	+	1	Q99732-1	0	161	ENST00000570904.5	102	585	++	173	Q99732-1#28	0	3	ENST00000570904.5	543	546	+	3	0	-2	4215
Q99732-1#28	0	1	1	Q99732-1	147	148	+	1	Q99732-1	0	161	ENST00000339430.9	233	716	++	32	Q99732-1#28	0	3	ENST00000339430.9	674	677	+	3	0	-2	4216
Q9UI95#0	0	211	211	Q9UI95	0	211	+	211	Q9UI95	0	176	ENST00000697274.1	72	600	++	270	Q9UI95#0	0	528	ENST00000697274.1	72	600	+	528	0	-317	4217
Q9UI95#0	0	211	211	Q9UI95	0	211	+	211	Q9UI95	0	47	ENST00000697273.1	96	237	++	269	Q9UI95#0	0	141	ENST00000697273.1	96	237	+	141	0	70	4218
Q9UI95#0	0	211	211	Q9UI95	0	211	+	211	Q9UI95	146	211	ENST00000697272.1	2	197	++	268	Q9UI95#0	438	633	ENST00000697272.1	2	197	+	195	438	-422	4219
Q9UI95#0	0	211	211	Q9UI95	0	211	+	211	Q9UI95	0	211	ENST00000456915.2	530	1163	++	105	Q9UI95#0	0	633	ENST00000456915.2	530	1163	+	633	0	-422	4220
Q9UI95#0	0	211	211	Q9UI95	0	211	+	211	Q9UI95	0	167	ENST00000445656.5	85	676	++	95	Q9UI95#0	0	501	ENST00000445656.5	85	676	+	501	0	-290	4221
Q9UI95#0	0	211	211	Q9UI95	0	211	+	211	Q9UI95	0	211	ENST00000376692.9	122	755	++	51	Q9UI95#0	0	633	ENST00000376692.9	122	755	+	633	0	-422	4222
Q9UI95#0	0	211	211	Q9UI95	0	211	+	211	Q9UI95	0	211	ENST00000376672.5	77	749	++	50	Q9UI95#0	0	633	ENST00000376672.5	77	749	+	633	0	-422	4223
Q9UI95#0	0	211	211	Q9UI95	0	211	+	211	Q9UI95	0	211	ENST00000376669.9	92	764	++	49	Q9UI95#0	0	633	ENST00000376669.9	92	764	+	633	0	-422	4224
Q9UI95#0	0	211	211	Q9UI95	0	211	+	211	Q9UI95	0	211	ENST00000376667.7	209	842	++	48	Q9UI95#0	0	633	ENST00000376667.7	209	842	+	633	0	-422	4225
Q9UI95#0	0	211	211	Q9UI95	0	211	+	211	Q9UI95	0	211	ENST00000235310.7	929	1562	++	0	Q9UI95#0	0	633	ENST00000235310.7	929	1562	+	633	0	-422	4226
Q9UI95#1	0	191	191	Q9UI95	12	203	+	191	Q9UI95	0	176	ENST00000697274.1	72	600	++	270	Q9UI95#1	0	492	ENST00000697274.1	108	600	+	492	0	-301	4227
Q9UI95#1	0	191	191	Q9UI95	12	203	+	191	Q9UI95	0	47	ENST00000697273.1	96	237	++	269	Q9UI95#1	0	105	ENST00000697273.1	132	237	+	105	0	86	4228
Q9UI95#1	0	191	191	Q9UI95	12	203	+	191	Q9UI95	146	211	ENST00000697272.1	2	197	++	268	Q9UI95#1	402	573	ENST00000697272.1	2	173	+	171	402	-382	4229
Q9UI95#1	0	191	191	Q9UI95	12	203	+	191	Q9UI95	0	211	ENST00000456915.2	530	1163	++	105	Q9UI95#1	0	573	ENST00000456915.2	566	1139	+	573	0	-382	4230
Q9UI95#1	0	191	191	Q9UI95	12	203	+	191	Q9UI95	0	167	ENST00000445656.5	85	676	++	95	Q9UI95#1	0	465	ENST00000445656.5	121	676	+	465	0	-274	4231
Q9UI95#1	0	191	191	Q9UI95	12	203	+	191	Q9UI95	0	211	ENST00000376692.9	122	755	++	51	Q9UI95#1	0	573	ENST00000376692.9	158	731	+	573	0	-382	4232
Q9UI95#1	0	191	191	Q9UI95	12	203	+	191	Q9UI95	0	211	ENST00000376672.5	77	749	++	50	Q9UI95#1	0	573	ENST00000376672.5	113	725	+	573	0	-382	4233
Q9UI95#1	0	191	191	Q9UI95	12	203	+	191	Q9UI95	0	211	ENST00000376669.9	92	764	++	49	Q9UI95#1	0	573	ENST00000376669.9	128	740	+	573	0	-382	4234
Q9UI95#1	0	191	191	Q9UI95	12	203	+	191	Q9UI95	0	211	ENST00000376667.7	209	842	++	48	Q9UI95#1	0	573	ENST00000376667.7	245	818	+	573	0	-382	4235
Q9UI95#1	0	191	191	Q9UI95	12	203	+	191	Q9UI95	0	211	ENST00000235310.7	929	1562	++	0	Q9UI95#1	0	573	ENST00000235310.7	965	1538	+	573	0	-382	4236
Q9UI95#2	0	135	135	Q9UI95	20	155	+	135	Q9UI95	0	176	ENST00000697274.1	72	600	++	270	Q9UI95#2	0	405	ENST00000697274.1	132	537	+	405	0	-270	4237
Q9UI95#2	0	135	135	Q9UI95	20	155	+	135	Q9UI95	0	47	ENST00000697273.1	96	237	++	269	Q9UI95#2	0	81	ENST00000697273.1	156	237	+	81	0	54	4238
Q9UI95#2	0	135	135	Q9UI95	20	155	+	135	Q9UI95	146	211	ENST00000697272.1	2	197	++	268	Q9UI95#2	378	405	ENST00000697272.1	2	29	+	27	378	-270	4239
Q9UI95#2	0	135	135	Q9UI95	20	155	+	135	Q9UI95	0	211	ENST00000456915.2	530	1163	++	105	Q9UI95#2	0	405	ENST00000456915.2	590	995	+	405	0	-270	4240
Q9UI95#2	0	135	135	Q9UI95	20	155	+	135	Q9UI95	0	167	ENST00000445656.5	85	676	++	95	Q9UI95#2	0	405	ENST00000445656.5	235	640	+	405	0	-270	4241
Q9UI95#2	0	135	135	Q9UI95	20	155	+	135	Q9UI95	0	211	ENST00000376692.9	122	755	++	51	Q9UI95#2	0	405	ENST00000376692.9	182	587	+	405	0	-270	4242
Q9UI95#2	0	135	135	Q9UI95	20	155	+	135	Q9UI95	0	211	ENST00000376672.5	77	749	++	50	Q9UI95#2	0	405	ENST00000376672.5	137	581	+	405	0	-270	4243
Q9UI95#2	0	135	135	Q9UI95	20	155	+	135	Q9UI95	0	211	ENST00000376669.9	92	764	++	49	Q9UI95#2	0	405	ENST00000376669.9	152	596	+	405	0	-270	4244
Q9UI95#2	0	135	135	Q9UI95	20	155	+	135	Q9UI95	0	211	ENST00000376667.7	209	842	++	48	Q9UI95#2	0	405	ENST00000376667.7	269	674	+	405	0	-270	4245
Q9UI95#2	0	135	135	Q9UI95	20	155	+	135	Q9UI95	0	211	ENST00000235310.7	929	1562	++	0	Q9UI95#2	0	405	ENST00000235310.7	989	1394	+	405	0	-270	4246
Q9UI95#3	0	62	62	Q9UI95	149	211	+	62	Q9UI95	0	176	ENST00000697274.1	72	600	++	270	Q9UI95#3	0	81	ENST00000697274.1	519	600	+	81	0	-19	4247
Q9UI95#3	0	62	62	Q9UI95	149	211	+	62	Q9UI95	146	211	ENST00000697272.1	2	197	++	268	Q9UI95#3	0	186	ENST00000697272.1	11	197	+	186	0	-124	4248
Q9UI95#3	0	62	62	Q9UI95	149	211	+	62	Q9UI95	0	211	ENST00000456915.2	530	1163	++	105	Q9UI95#3	0	186	ENST00000456915.2	977	1163	+	186	0	-124	4249
Q9UI95#3	0	62	62	Q9UI95	149	211	+	62	Q9UI95	0	167	ENST00000445656.5	85	676	++	95	Q9UI95#3	0	54	ENST00000445656.5	622	676	+	54	0	8	4250
Q9UI95#3	0	62	62	Q9UI95	149	211	+	62	Q9UI95	0	211	ENST00000376692.9	122	755	++	51	Q9UI95#3	0	186	ENST00000376692.9	569	755	+	186	0	-124	4251
Q9UI95#3	0	62	62	Q9UI95	149	211	+	62	Q9UI95	0	211	ENST00000376672.5	77	749	++	50	Q9UI95#3	0	186	ENST00000376672.5	563	749	+	186	0	-124	4252
Q9UI95#3	0	62	62	Q9UI95	149	211	+	62	Q9UI95	0	211	ENST00000376669.9	92	764	++	49	Q9UI95#3	0	186	ENST00000376669.9	578	764	+	186	0	-124	4253
Q9UI95#3	0	62	62	Q9UI95	149	211	+	62	Q9UI95	0	211	ENST00000376667.7	209	842	++	48	Q9UI95#3	0	186	ENST00000376667.7	656	842	+	186	0	-124	4254
Q9UI95#3	0	62	62	Q9UI95	149	211	+	62	Q9UI95	0	211	ENST00000235310.7	929	1562	++	0	Q9UI95#3	0	186	ENST00000235310.7	1376	1562	+	186	0	-124	4255
Q9UI95#4	0	1	1	Q9UI95	84	85	+	1	Q9UI95	0	176	ENST00000697274.1	72	600	++	270	Q9UI95#4	0	3	ENST00000697274.1	324	327	+	3	0	-2	4256
Q9UI95#4	0	1	1	Q9UI95	84	85	+	1	Q9UI95	0	211	ENST00000456915.2	530	1163	++	105	Q9UI95#4	0	3	ENST00000456915.2	782	785	+	3	0	-2	4257
Q9UI95#4	0	1	1	Q9UI95	84	85	+	1	Q9UI95	0	167	ENST00000445656.5	85	676	++	95	Q9UI95#4	0	3	ENST00000445656.5	427	430	+	3	0	-2	4258
Q9UI95#4	0	1	1	Q9UI95	84	85	+	1	Q9UI95	0	211	ENST00000376692.9	122	755	++	51	Q9UI95#4	0	3	ENST00000376692.9	374	377	+	3	0	-2	4259
Q9UI95#4	0	1	1	Q9UI95	84	85	+	1	Q9UI95	0	211	ENST00000376672.5	77	749	++	50	Q9UI95#4	0	3	ENST00000376672.5	329	332	+	3	0	-2	4260
Q9UI95#4	0	1	1	Q9UI95	84	85	+	1	Q9UI95	0	211	ENST00000376669.9	92	764	++	49	Q9UI95#4	0	3	ENST00000376669.9	344	347	+	3	0	-2	4261
Q9UI95#4	0	1	1	Q9UI95	84	85	+	1	Q9UI95	0	211	ENST00000376667.7	209	842	++	48	Q9UI95#4	0	3	ENST00000376667.7	461	464	+	3	0	-2	4262
Q9UI95#4	0	1	1	Q9UI95	84	85	+	1	Q9UI95	0	211	ENST00000235310.7	929	1562	++	0	Q9UI95#4	0	3	ENST00000235310.7	1181	1184	+	3	0	-2	4263
Q9UI95#5	0	1	1	Q9UI95	62	63	+	1	Q9UI95	0	176	ENST00000697274.1	72	600	++	270	Q9UI95#5	0	3	ENST00000697274.1	258	261	+	3	0	-2	4264
Q9UI95#5	0	1	1	Q9UI95	62	63	+	1	Q9UI95	0	211	ENST00000456915.2	530	1163	++	105	Q9UI95#5	0	3	ENST00000456915.2	716	719	+	3	0	-2	4265
Q9UI95#5	0	1	1	Q9UI95	62	63	+	1	Q9UI95	0	167	ENST00000445656.5	85	676	++	95	Q9UI95#5	0	3	ENST00000445656.5	361	364	+	3	0	-2	4266
Q9UI95#5	0	1	1	Q9UI95	62	63	+	1	Q9UI95	0	211	ENST00000376692.9	122	755	++	51	Q9UI95#5	0	3	ENST00000376692.9	308	311	+	3	0	-2	4267
Q9UI95#5	0	1	1	Q9UI95	62	63	+	1	Q9UI95	0	211	ENST00000376672.5	77	749	++	50	Q9UI95#5	0	3	ENST00000376672.5	263	266	+	3	0	-2	4268
Q9UI95#5	0	1	1	Q9UI95	62	63	+	1	Q9UI95	0	211	ENST00000376669.9	92	764	++	49	Q9UI95#5	0	3	ENST00000376669.9	278	281	+	3	0	-2	4269
Q9UI95#5	0	1	1	Q9UI95	62	63	+	1	Q9UI95	0	211	ENST00000376667.7	209	842	++	48	Q9UI95#5	0	3	ENST00000376667.7	395	398	+	3	0	-2	4270
Q9UI95#5	0	1	1	Q9UI95	62	63	+	1	Q9UI95	0	211	ENST00000235310.7	929	1562	++	0	Q9UI95#5	0	3	ENST00000235310.7	1115	1118	+	3	0	-2	4271
Q9UI95#6	0	1	1	Q9UI95	123	124	+	1	Q9UI95	0	176	ENST00000697274.1	72	600	++	270	Q9UI95#6	0	3	ENST00000697274.1	441	444	+	3	0	-2	4272
Q9UI95#6	0	1	1	Q9UI95	123	124	+	1	Q9UI95	0	211	ENST00000456915.2	530	1163	++	105	Q9UI95#6	0	3	ENST00000456915.2	899	902	+	3	0	-2	4273
Q9UI95#6	0	1	1	Q9UI95	123	124	+	1	Q9UI95	0	167	ENST00000445656.5	85	676	++	95	Q9UI95#6	0	3	ENST00000445656.5	544	547	+	3	0	-2	4274
Q9UI95#6	0	1	1	Q9UI95	123	124	+	1	Q9UI95	0	211	ENST00000376692.9	122	755	++	51	Q9UI95#6	0	3	ENST00000376692.9	491	494	+	3	0	-2	4275
Q9UI95#6	0	1	1	Q9UI95	123	124	+	1	Q9UI95	0	211	ENST00000376672.5	77	749	++	50	Q9UI95#6	0	3	ENST00000376672.5	485	488	+	3	0	-2	4276
Q9UI95#6	0	1	1	Q9UI95	123	124	+	1	Q9UI95	0	211	ENST00000376669.9	92	764	++	49	Q9UI95#6	0	3	ENST00000376669.9	500	503	+	3	0	-2	4277
Q9UI95#6	0	1	1	Q9UI95	123	124	+	1	Q9UI95	0	211	ENST00000376667.7	209	842	++	48	Q9UI95#6	0	3	ENST00000376667.7	578	581	+	3	0	-2	4278
Q9UI95#6	0	1	1	Q9UI95	123	124	+	1	Q9UI95	0	211	ENST00000235310.7	929	1562	++	0	Q9UI95#6	0	3	ENST00000235310.7	1298	1301	+	3	0	-2	4279
Q9UI95#7	0	1	1	Q9UI95	170	171	+	1	Q9UI95	0	176	ENST00000697274.1	72	600	++	270	Q9UI95#7	0	3	ENST00000697274.1	582	585	+	3	0	-2	4280
Q9UI95#7	0	1	1	Q9UI95	170	171	+	1	Q9UI95	146	211	ENST00000697272.1	2	197	++	268	Q9UI95#7	0	3	ENST00000697272.1	74	77	+	3	0	-2	4281
Q9UI95#7	0	1	1	Q9UI95	170	171	+	1	Q9UI95	0	211	ENST00000456915.2	530	1163	++	105	Q9UI95#7	0	3	ENST00000456915.2	1040	1043	+	3	0	-2	4282
Q9UI95#7	0	1	1	Q9UI95	170	171	+	1	Q9UI95	0	211	ENST00000376692.9	122	755	++	51	Q9UI95#7	0	3	ENST00000376692.9	632	635	+	3	0	-2	4283
Q9UI95#7	0	1	1	Q9UI95	170	171	+	1	Q9UI95	0	211	ENST00000376672.5	77	749	++	50	Q9UI95#7	0	3	ENST00000376672.5	626	629	+	3	0	-2	4284
Q9UI95#7	0	1	1	Q9UI95	170	171	+	1	Q9UI95	0	211	ENST00000376669.9	92	764	++	49	Q9UI95#7	0	3	ENST00000376669.9	641	644	+	3	0	-2	4285
Q9UI95#7	0	1	1	Q9UI95	170	171	+	1	Q9UI95	0	211	ENST00000376667.7	209	842	++	48	Q9UI95#7	0	3	ENST00000376667.7	719	722	+	3	0	-2	4286
Q9UI95#7	0	1	1	Q9UI95	170	171	+	1	Q9UI95	0	211	ENST00000235310.7	929	1562	++	0	Q9UI95#7	0	3	ENST00000235310.7	1439	1442	+	3	0	-2	4287
Q9UI95#8	0	1	1	Q9UI95	185	186	+	1	Q9UI95	146	211	ENST00000697272.1	2	197	++	268	Q9UI95#8	0	3	ENST00000697272.1	119	122	+	3	0	-2	4288
Q9UI95#8	0	1	1	Q9UI95	185	186	+	1	Q9UI95	0	211	ENST00000456915.2	530	1163	++	105	Q9UI95#8	0	3	ENST00000456915.2	1085	1088	+	3	0	-2	4289
Q9UI95#8	0	1	1	Q9UI95	185	186	+	1	Q9UI95	0	211	ENST00000376692.9	122	755	++	51	Q9UI95#8	0	3	ENST00000376692.9	677	680	+	3	0	-2	4290
Q9UI95#8	0	1	1	Q9UI95	185	186	+	1	Q9UI95	0	211	ENST00000376672.5	77	749	++	50	Q9UI95#8	0	3	ENST00000376672.5	671	674	+	3	0	-2	4291
Q9UI95#8	0	1	1	Q9UI95	185	186	+	1	Q9UI95	0	211	ENST00000376669.9	92	764	++	49	Q9UI95#8	0	3	ENST00000376669.9	686	689	+	3	0	-2	4292
Q9UI95#8	0	1	1	Q9UI95	185	186	+	1	Q9UI95	0	211	ENST00000376667.7	209	842	++	48	Q9UI95#8	0	3	ENST00000376667.7	764	767	+	3	0	-2	4293
Q9UI95#8	0	1	1	Q9UI95	185	186	+	1	Q9UI95	0	211	ENST00000235310.7	929	1562	++	0	Q9UI95#8	0	3	ENST00000235310.7	1484	1487	+	3	0	-2	4294
Q9UI95#9	0	1	1	Q9UI95	199	200	+	1	Q9UI95	146	211	ENST00000697272.1	2	197	++	268	Q9UI95#9	0	3	ENST00000697272.1	161	164	+	3	0	-2	4295
Q9UI95#9	0	1	1	Q9UI95	199	200	+	1	Q9UI95	0	211	ENST00000456915.2	530	1163	++	105	Q9UI95#9	0	3	ENST00000456915.2	1127	1130	+	3	0	-2	4296
Q9UI95#9	0	1	1	Q9UI95	199	200	+	1	Q9UI95	0	211	ENST00000376692.9	122	755	++	51	Q9UI95#9	0	3	ENST00000376692.9	719	722	+	3	0	-2	4297
Q9UI95#9	0	1	1	Q9UI95	199	200	+	1	Q9UI95	0	211	ENST00000376672.5	77	749	++	50	Q9UI95#9	0	3	ENST00000376672.5	713	716	+	3	0	-2	4298
Q9UI95#9	0	1	1	Q9UI95	199	200	+	1	Q9UI95	0	211	ENST00000376669.9	92	764	++	49	Q9UI95#9	0	3	ENST00000376669.9	728	731	+	3	0	-2	4299
Q9UI95#9	0	1	1	Q9UI95	199	200	+	1	Q9UI95	0	211	ENST00000376667.7	209	842	++	48	Q9UI95#9	0	3	ENST00000376667.7	806	809	+	3	0	-2	4300
Q9UI95#9	0	1	1	Q9UI95	199	200	+	1	Q9UI95	0	211	ENST00000235310.7	929	1562	++	0	Q9UI95#9	0	3	ENST00000235310.7	1526	1529	+	3	0	-2	4301
Q9UI95#10	0	1	1	Q9UI95	201	202	+	1	Q9UI95	146	211	ENST00000697272.1	2	197	++	268	Q9UI95#10	0	3	ENST00000697272.1	167	170	+	3	0	-2	4302
Q9UI95#10	0	1	1	Q9UI95	201	202	+	1	Q9UI95	0	211	ENST00000456915.2	530	1163	++	105	Q9UI95#10	0	3	ENST00000456915.2	1133	1136	+	3	0	-2	4303
Q9UI95#10	0	1	1	Q9UI95	201	202	+	1	Q9UI95	0	211	ENST00000376692.9	122	755	++	51	Q9UI95#10	0	3	ENST00000376692.9	725	728	+	3	0	-2	4304
Q9UI95#10	0	1	1	Q9UI95	201	202	+	1	Q9UI95	0	211	ENST00000376672.5	77	749	++	50	Q9UI95#10	0	3	ENST00000376672.5	719	722	+	3	0	-2	4305
Q9UI95#10	0	1	1	Q9UI95	201	202	+	1	Q9UI95	0	211	ENST00000376669.9	92	764	++	49	Q9UI95#10	0	3	ENST00000376669.9	734	737	+	3	0	-2	4306
Q9UI95#10	0	1	1	Q9UI95	201	202	+	1	Q9UI95	0	211	ENST00000376667.7	209	842	++	48	Q9UI95#10	0	3	ENST00000376667.7	812	815	+	3	0	-2	4307
Q9UI95#10	0	1	1	Q9UI95	201	202	+	1	Q9UI95	0	211	ENST00000235310.7	929	1562	++	0	Q9UI95#10	0	3	ENST00000235310.7	1532	1535	+	3	0	-2	4308
Q9UI95#11	0	1	1	Q9UI95	16	17	+	1	Q9UI95	0	176	ENST00000697274.1	72	600	++	270	Q9UI95#11	0	3	ENST00000697274.1	120	123	+	3	0	-2	4309
Q9UI95#11	0	1	1	Q9UI95	16	17	+	1	Q9UI95	0	47	ENST00000697273.1	96	237	++	269	Q9UI95#11	0	3	ENST00000697273.1	144	147	+	3	0	-2	4310
Q9UI95#11	0	1	1	Q9UI95	16	17	+	1	Q9UI95	0	211	ENST00000456915.2	530	1163	++	105	Q9UI95#11	0	3	ENST00000456915.2	578	581	+	3	0	-2	4311
Q9UI95#11	0	1	1	Q9UI95	16	17	+	1	Q9UI95	0	167	ENST00000445656.5	85	676	++	95	Q9UI95#11	0	3	ENST00000445656.5	223	226	+	3	0	-2	4312
Q9UI95#11	0	1	1	Q9UI95	16	17	+	1	Q9UI95	0	211	ENST00000376692.9	122	755	++	51	Q9UI95#11	0	3	ENST00000376692.9	170	173	+	3	0	-2	4313
Q9UI95#11	0	1	1	Q9UI95	16	17	+	1	Q9UI95	0	211	ENST00000376672.5	77	749	++	50	Q9UI95#11	0	3	ENST00000376672.5	125	128	+	3	0	-2	4314
Q9UI95#11	0	1	1	Q9UI95	16	17	+	1	Q9UI95	0	211	ENST00000376669.9	92	764	++	49	Q9UI95#11	0	3	ENST00000376669.9	140	143	+	3	0	-2	4315
Q9UI95#11	0	1	1	Q9UI95	16	17	+	1	Q9UI95	0	211	ENST00000376667.7	209	842	++	48	Q9UI95#11	0	3	ENST00000376667.7	257	260	+	3	0	-2	4316
Q9UI95#11	0	1	1	Q9UI95	16	17	+	1	Q9UI95	0	211	ENST00000235310.7	929	1562	++	0	Q9UI95#11	0	3	ENST00000235310.7	977	980	+	3	0	-2	4317
Q9UI95#12	0	1	1	Q9UI95	95	96	+	1	Q9UI95	0	176	ENST00000697274.1	72	600	++	270	Q9UI95#12	0	3	ENST00000697274.1	357	360	+	3	0	-2	4318
Q9UI95#12	0	1	1	Q9UI95	95	96	+	1	Q9UI95	0	211	ENST00000456915.2	530	1163	++	105	Q9UI95#12	0	3	ENST00000456915.2	815	818	+	3	0	-2	4319
Q9UI95#12	0	1	1	Q9UI95	95	96	+	1	Q9UI95	0	167	ENST00000445656.5	85	676	++	95	Q9UI95#12	0	3	ENST00000445656.5	460	463	+	3	0	-2	4320
Q9UI95#12	0	1	1	Q9UI95	95	96	+	1	Q9UI95	0	211	ENST00000376692.9	122	755	++	51	Q9UI95#12	0	3	ENST00000376692.9	407	410	+	3	0	-2	4321
Q9UI95#12	0	1	1	Q9UI95	95	96	+	1	Q9UI95	0	211	ENST00000376672.5	77	749	++	50	Q9UI95#12	0	3	ENST00000376672.5	362	365	+	3	0	-2	4322
Q9UI95#12	0	1	1	Q9UI95	95	96	+	1	Q9UI95	0	211	ENST00000376669.9	92	764	++	49	Q9UI95#12	0	3	ENST00000376669.9	377	380	+	3	0	-2	4323
Q9UI95#12	0	1	1	Q9UI95	95	96	+	1	Q9UI95	0	211	ENST00000376667.7	209	842	++	48	Q9UI95#12	0	3	ENST00000376667.7	494	497	+	3	0	-2	4324
Q9UI95#12	0	1	1	Q9UI95	95	96	+	1	Q9UI95	0	211	ENST00000235310.7	929	1562	++	0	Q9UI95#12	0	3	ENST00000235310.7	1214	1217	+	3	0	-2	4325
Q9UI95#13	0	1	1	Q9UI95	198	199	+	1	Q9UI95	146	211	ENST00000697272.1	2	197	++	268	Q9UI95#13	0	3	ENST00000697272.1	158	161	+	3	0	-2	4326
Q9UI95#13	0	1	1	Q9UI95	198	199	+	1	Q9UI95	0	211	ENST00000456915.2	530	1163	++	105	Q9UI95#13	0	3	ENST00000456915.2	1124	1127	+	3	0	-2	4327
Q9UI95#13	0	1	1	Q9UI95	198	199	+	1	Q9UI95	0	211	ENST00000376692.9	122	755	++	51	Q9UI95#13	0	3	ENST00000376692.9	716	719	+	3	0	-2	4328
Q9UI95#13	0	1	1	Q9UI95	198	199	+	1	Q9UI95	0	211	ENST00000376672.5	77	749	++	50	Q9UI95#13	0	3	ENST00000376672.5	710	713	+	3	0	-2	4329
Q9UI95#13	0	1	1	Q9UI95	198	199	+	1	Q9UI95	0	211	ENST00000376669.9	92	764	++	49	Q9UI95#13	0	3	ENST00000376669.9	725	728	+	3	0	-2	4330
Q9UI95#13	0	1	1	Q9UI95	198	199	+	1	Q9UI95	0	211	ENST00000376667.7	209	842	++	48	Q9UI95#13	0	3	ENST00000376667.7	803	806	+	3	0	-2	4331
Q9UI95#13	0	1	1	Q9UI95	198	199	+	1	Q9UI95	0	211	ENST00000235310.7	929	1562	++	0	Q9UI95#13	0	3	ENST00000235310.7	1523	1526	+	3	0	-2	4332
Q9UI95#14	0	3	3	Q9UI95	5	8	+	3	Q9UI95	0	176	ENST00000697274.1	72	600	++	270	Q9UI95#14	0	9	ENST00000697274.1	87	96	+	9	0	-6	4333
Q9UI95#14	0	3	3	Q9UI95	5	8	+	3	Q9UI95	0	47	ENST00000697273.1	96	237	++	269	Q9UI95#14	0	9	ENST00000697273.1	111	120	+	9	0	-6	4334
Q9UI95#14	0	3	3	Q9UI95	5	8	+	3	Q9UI95	0	211	ENST00000456915.2	530	1163	++	105	Q9UI95#14	0	9	ENST00000456915.2	545	554	+	9	0	-6	4335
Q9UI95#14	0	3	3	Q9UI95	5	8	+	3	Q9UI95	0	167	ENST00000445656.5	85	676	++	95	Q9UI95#14	0	9	ENST00000445656.5	100	109	+	9	0	-6	4336
Q9UI95#14	0	3	3	Q9UI95	5	8	+	3	Q9UI95	0	211	ENST00000376692.9	122	755	++	51	Q9UI95#14	0	9	ENST00000376692.9	137	146	+	9	0	-6	4337
Q9UI95#14	0	3	3	Q9UI95	5	8	+	3	Q9UI95	0	211	ENST00000376672.5	77	749	++	50	Q9UI95#14	0	9	ENST00000376672.5	92	101	+	9	0	-6	4338
Q9UI95#14	0	3	3	Q9UI95	5	8	+	3	Q9UI95	0	211	ENST00000376669.9	92	764	++	49	Q9UI95#14	0	9	ENST00000376669.9	107	116	+	9	0	-6	4339
Q9UI95#14	0	3	3	Q9UI95	5	8	+	3	Q9UI95	0	211	ENST00000376667.7	209	842	++	48	Q9UI95#14	0	9	ENST00000376667.7	224	233	+	9	0	-6	4340
Q9UI95#14	0	3	3	Q9UI95	5	8	+	3	Q9UI95	0	211	ENST00000235310.7	929	1562	++	0	Q9UI95#14	0	9	ENST00000235310.7	944	953	+	9	0	-6	4341
Q9UI95#15	0	3	3	Q9UI95	9	12	+	3	Q9UI95	0	176	ENST00000697274.1	72	600	++	270	Q9UI95#15	0	9	ENST00000697274.1	99	108	+	9	0	-6	4342
Q9UI95#15	0	3	3	Q9UI95	9	12	+	3	Q9UI95	0	47	ENST00000697273.1	96	237	++	269	Q9UI95#15	0	9	ENST00000697273.1	123	132	+	9	0	-6	4343
Q9UI95#15	0	3	3	Q9UI95	9	12	+	3	Q9UI95	0	211	ENST00000456915.2	530	1163	++	105	Q9UI95#15	0	9	ENST00000456915.2	557	566	+	9	0	-6	4344
Q9UI95#15	0	3	3	Q9UI95	9	12	+	3	Q9UI95	0	167	ENST00000445656.5	85	676	++	95	Q9UI95#15	0	9	ENST00000445656.5	112	121	+	9	0	-6	4345
Q9UI95#15	0	3	3	Q9UI95	9	12	+	3	Q9UI95	0	211	ENST00000376692.9	122	755	++	51	Q9UI95#15	0	9	ENST00000376692.9	149	158	+	9	0	-6	4346
Q9UI95#15	0	3	3	Q9UI95	9	12	+	3	Q9UI95	0	211	ENST00000376672.5	77	749	++	50	Q9UI95#15	0	9	ENST00000376672.5	104	113	+	9	0	-6	4347
Q9UI95#15	0	3	3	Q9UI95	9	12	+	3	Q9UI95	0	211	ENST00000376669.9	92	764	++	49	Q9UI95#15	0	9	ENST00000376669.9	119	128	+	9	0	-6	4348
Q9UI95#15	0	3	3	Q9UI95	9	12	+	3	Q9UI95	0	211	ENST00000376667.7	209	842	++	48	Q9UI95#15	0	9	ENST00000376667.7	236	245	+	9	0	-6	4349
Q9UI95#15	0	3	3	Q9UI95	9	12	+	3	Q9UI95	0	211	ENST00000235310.7	929	1562	++	0	Q9UI95#15	0	9	ENST00000235310.7	956	965	+	9	0	-6	4350
Q9UI95#16	0	21	21	Q9UI95	12	33	+	21	Q9UI95	0	176	ENST00000697274.1	72	600	++	270	Q9UI95#16	0	63	ENST00000697274.1	108	171	+	63	0	-42	4351
Q9UI95#16	0	21	21	Q9UI95	12	33	+	21	Q9UI95	0	47	ENST00000697273.1	96	237	++	269	Q9UI95#16	0	63	ENST00000697273.1	132	195	+	63	0	-42	4352
Q9UI95#16	0	21	21	Q9UI95	12	33	+	21	Q9UI95	0	211	ENST00000456915.2	530	1163	++	105	Q9UI95#16	0	63	ENST00000456915.2	566	629	+	63	0	-42	4353
Q9UI95#16	0	21	21	Q9UI95	12	33	+	21	Q9UI95	0	167	ENST00000445656.5	85	676	++	95	Q9UI95#16	0	63	ENST00000445656.5	121	274	+	63	0	-42	4354
Q9UI95#16	0	21	21	Q9UI95	12	33	+	21	Q9UI95	0	211	ENST00000376692.9	122	755	++	51	Q9UI95#16	0	63	ENST00000376692.9	158	221	+	63	0	-42	4355
Q9UI95#16	0	21	21	Q9UI95	12	33	+	21	Q9UI95	0	211	ENST00000376672.5	77	749	++	50	Q9UI95#16	0	63	ENST00000376672.5	113	176	+	63	0	-42	4356
Q9UI95#16	0	21	21	Q9UI95	12	33	+	21	Q9UI95	0	211	ENST00000376669.9	92	764	++	49	Q9UI95#16	0	63	ENST00000376669.9	128	191	+	63	0	-42	4357
Q9UI95#16	0	21	21	Q9UI95	12	33	+	21	Q9UI95	0	211	ENST00000376667.7	209	842	++	48	Q9UI95#16	0	63	ENST00000376667.7	245	308	+	63	0	-42	4358
Q9UI95#16	0	21	21	Q9UI95	12	33	+	21	Q9UI95	0	211	ENST00000235310.7	929	1562	++	0	Q9UI95#16	0	63	ENST00000235310.7	965	1028	+	63	0	-42	4359
Q9UI95#17	0	3	3	Q9UI95	38	41	+	3	Q9UI95	0	176	ENST00000697274.1	72	600	++	270	Q9UI95#17	0	9	ENST00000697274.1	186	195	+	9	0	-6	4360
Q9UI95#17	0	3	3	Q9UI95	38	41	+	3	Q9UI95	0	47	ENST00000697273.1	96	237	++	269	Q9UI95#17	0	9	ENST00000697273.1	210	219	+	9	0	-6	4361
Q9UI95#17	0	3	3	Q9UI95	38	41	+	3	Q9UI95	0	211	ENST00000456915.2	530	1163	++	105	Q9UI95#17	0	9	ENST00000456915.2	644	653	+	9	0	-6	4362
Q9UI95#17	0	3	3	Q9UI95	38	41	+	3	Q9UI95	0	167	ENST00000445656.5	85	676	++	95	Q9UI95#17	0	9	ENST00000445656.5	289	298	+	9	0	-6	4363
Q9UI95#17	0	3	3	Q9UI95	38	41	+	3	Q9UI95	0	211	ENST00000376692.9	122	755	++	51	Q9UI95#17	0	9	ENST00000376692.9	236	245	+	9	0	-6	4364
Q9UI95#17	0	3	3	Q9UI95	38	41	+	3	Q9UI95	0	211	ENST00000376672.5	77	749	++	50	Q9UI95#17	0	9	ENST00000376672.5	191	200	+	9	0	-6	4365
Q9UI95#17	0	3	3	Q9UI95	38	41	+	3	Q9UI95	0	211	ENST00000376669.9	92	764	++	49	Q9UI95#17	0	9	ENST00000376669.9	206	215	+	9	0	-6	4366
Q9UI95#17	0	3	3	Q9UI95	38	41	+	3	Q9UI95	0	211	ENST00000376667.7	209	842	++	48	Q9UI95#17	0	9	ENST00000376667.7	323	332	+	9	0	-6	4367
Q9UI95#17	0	3	3	Q9UI95	38	41	+	3	Q9UI95	0	211	ENST00000235310.7	929	1562	++	0	Q9UI95#17	0	9	ENST00000235310.7	1043	1052	+	9	0	-6	4368
Q9UI95#18	0	6	6	Q9UI95	41	47	+	6	Q9UI95	0	176	ENST00000697274.1	72	600	++	270	Q9UI95#18	0	18	ENST00000697274.1	195	213	+	18	0	-12	4369
Q9UI95#18	0	6	6	Q9UI95	41	47	+	6	Q9UI95	0	47	ENST00000697273.1	96	237	++	269	Q9UI95#18	0	18	ENST00000697273.1	219	237	+	18	0	-12	4370
Q9UI95#18	0	6	6	Q9UI95	41	47	+	6	Q9UI95	0	211	ENST00000456915.2	530	1163	++	105	Q9UI95#18	0	18	ENST00000456915.2	653	671	+	18	0	-12	4371
Q9UI95#18	0	6	6	Q9UI95	41	47	+	6	Q9UI95	0	167	ENST00000445656.5	85	676	++	95	Q9UI95#18	0	18	ENST00000445656.5	298	316	+	18	0	-12	4372
Q9UI95#18	0	6	6	Q9UI95	41	47	+	6	Q9UI95	0	211	ENST00000376692.9	122	755	++	51	Q9UI95#18	0	18	ENST00000376692.9	245	263	+	18	0	-12	4373
Q9UI95#18	0	6	6	Q9UI95	41	47	+	6	Q9UI95	0	211	ENST00000376672.5	77	749	++	50	Q9UI95#18	0	18	ENST00000376672.5	200	218	+	18	0	-12	4374
Q9UI95#18	0	6	6	Q9UI95	41	47	+	6	Q9UI95	0	211	ENST00000376669.9	92	764	++	49	Q9UI95#18	0	18	ENST00000376669.9	215	233	+	18	0	-12	4375
Q9UI95#18	0	6	6	Q9UI95	41	47	+	6	Q9UI95	0	211	ENST00000376667.7	209	842	++	48	Q9UI95#18	0	18	ENST00000376667.7	332	350	+	18	0	-12	4376
Q9UI95#18	0	6	6	Q9UI95	41	47	+	6	Q9UI95	0	211	ENST00000235310.7	929	1562	++	0	Q9UI95#18	0	18	ENST00000235310.7	1052	1070	+	18	0	-12	4377
Q9UI95#19	0	6	6	Q9UI95	49	55	+	6	Q9UI95	0	176	ENST00000697274.1	72	600	++	270	Q9UI95#19	0	18	ENST00000697274.1	219	237	+	18	0	-12	4378
Q9UI95#19	0	6	6	Q9UI95	49	55	+	6	Q9UI95	0	211	ENST00000456915.2	530	1163	++	105	Q9UI95#19	0	18	ENST00000456915.2	677	695	+	18	0	-12	4379
Q9UI95#19	0	6	6	Q9UI95	49	55	+	6	Q9UI95	0	167	ENST00000445656.5	85	676	++	95	Q9UI95#19	0	18	ENST00000445656.5	322	340	+	18	0	-12	4380
Q9UI95#19	0	6	6	Q9UI95	49	55	+	6	Q9UI95	0	211	ENST00000376692.9	122	755	++	51	Q9UI95#19	0	18	ENST00000376692.9	269	287	+	18	0	-12	4381
Q9UI95#19	0	6	6	Q9UI95	49	55	+	6	Q9UI95	0	211	ENST00000376672.5	77	749	++	50	Q9UI95#19	0	18	ENST00000376672.5	224	242	+	18	0	-12	4382
Q9UI95#19	0	6	6	Q9UI95	49	55	+	6	Q9UI95	0	211	ENST00000376669.9	92	764	++	49	Q9UI95#19	0	18	ENST00000376669.9	239	257	+	18	0	-12	4383
Q9UI95#19	0	6	6	Q9UI95	49	55	+	6	Q9UI95	0	211	ENST00000376667.7	209	842	++	48	Q9UI95#19	0	18	ENST00000376667.7	356	374	+	18	0	-12	4384
Q9UI95#19	0	6	6	Q9UI95	49	55	+	6	Q9UI95	0	211	ENST00000235310.7	929	1562	++	0	Q9UI95#19	0	18	ENST00000235310.7	1076	1094	+	18	0	-12	4385
Q9UI95#20	0	19	19	Q9UI95	57	76	+	19	Q9UI95	0	176	ENST00000697274.1	72	600	++	270	Q9UI95#20	0	57	ENST00000697274.1	243	300	+	57	0	-38	4386
Q9UI95#20	0	19	19	Q9UI95	57	76	+	19	Q9UI95	0	211	ENST00000456915.2	530	1163	++	105	Q9UI95#20	0	57	ENST00000456915.2	701	758	+	57	0	-38	4387
Q9UI95#20	0	19	19	Q9UI95	57	76	+	19	Q9UI95	0	167	ENST00000445656.5	85	676	++	95	Q9UI95#20	0	57	ENST00000445656.5	346	403	+	57	0	-38	4388
Q9UI95#20	0	19	19	Q9UI95	57	76	+	19	Q9UI95	0	211	ENST00000376692.9	122	755	++	51	Q9UI95#20	0	57	ENST00000376692.9	293	350	+	57	0	-38	4389
Q9UI95#20	0	19	19	Q9UI95	57	76	+	19	Q9UI95	0	211	ENST00000376672.5	77	749	++	50	Q9UI95#20	0	57	ENST00000376672.5	248	305	+	57	0	-38	4390
Q9UI95#20	0	19	19	Q9UI95	57	76	+	19	Q9UI95	0	211	ENST00000376669.9	92	764	++	49	Q9UI95#20	0	57	ENST00000376669.9	263	320	+	57	0	-38	4391
Q9UI95#20	0	19	19	Q9UI95	57	76	+	19	Q9UI95	0	211	ENST00000376667.7	209	842	++	48	Q9UI95#20	0	57	ENST00000376667.7	380	437	+	57	0	-38	4392
Q9UI95#20	0	19	19	Q9UI95	57	76	+	19	Q9UI95	0	211	ENST00000235310.7	929	1562	++	0	Q9UI95#20	0	57	ENST00000235310.7	1100	1157	+	57	0	-38	4393
Q9UI95#21	0	9	9	Q9UI95	79	88	+	9	Q9UI95	0	176	ENST00000697274.1	72	600	++	270	Q9UI95#21	0	27	ENST00000697274.1	309	336	+	27	0	-18	4394
Q9UI95#21	0	9	9	Q9UI95	79	88	+	9	Q9UI95	0	211	ENST00000456915.2	530	1163	++	105	Q9UI95#21	0	27	ENST00000456915.2	767	794	+	27	0	-18	4395
Q9UI95#21	0	9	9	Q9UI95	79	88	+	9	Q9UI95	0	167	ENST00000445656.5	85	676	++	95	Q9UI95#21	0	27	ENST00000445656.5	412	439	+	27	0	-18	4396
Q9UI95#21	0	9	9	Q9UI95	79	88	+	9	Q9UI95	0	211	ENST00000376692.9	122	755	++	51	Q9UI95#21	0	27	ENST00000376692.9	359	386	+	27	0	-18	4397
Q9UI95#21	0	9	9	Q9UI95	79	88	+	9	Q9UI95	0	211	ENST00000376672.5	77	749	++	50	Q9UI95#21	0	27	ENST00000376672.5	314	341	+	27	0	-18	4398
Q9UI95#21	0	9	9	Q9UI95	79	88	+	9	Q9UI95	0	211	ENST00000376669.9	92	764	++	49	Q9UI95#21	0	27	ENST00000376669.9	329	356	+	27	0	-18	4399
Q9UI95#21	0	9	9	Q9UI95	79	88	+	9	Q9UI95	0	211	ENST00000376667.7	209	842	++	48	Q9UI95#21	0	27	ENST00000376667.7	446	473	+	27	0	-18	4400
Q9UI95#21	0	9	9	Q9UI95	79	88	+	9	Q9UI95	0	211	ENST00000235310.7	929	1562	++	0	Q9UI95#21	0	27	ENST00000235310.7	1166	1193	+	27	0	-18	4401
Q9UI95#22	0	3	3	Q9UI95	89	92	+	3	Q9UI95	0	176	ENST00000697274.1	72	600	++	270	Q9UI95#22	0	9	ENST00000697274.1	339	348	+	9	0	-6	4402
Q9UI95#22	0	3	3	Q9UI95	89	92	+	3	Q9UI95	0	211	ENST00000456915.2	530	1163	++	105	Q9UI95#22	0	9	ENST00000456915.2	797	806	+	9	0	-6	4403
Q9UI95#22	0	3	3	Q9UI95	89	92	+	3	Q9UI95	0	167	ENST00000445656.5	85	676	++	95	Q9UI95#22	0	9	ENST00000445656.5	442	451	+	9	0	-6	4404
Q9UI95#22	0	3	3	Q9UI95	89	92	+	3	Q9UI95	0	211	ENST00000376692.9	122	755	++	51	Q9UI95#22	0	9	ENST00000376692.9	389	398	+	9	0	-6	4405
Q9UI95#22	0	3	3	Q9UI95	89	92	+	3	Q9UI95	0	211	ENST00000376672.5	77	749	++	50	Q9UI95#22	0	9	ENST00000376672.5	344	353	+	9	0	-6	4406
Q9UI95#22	0	3	3	Q9UI95	89	92	+	3	Q9UI95	0	211	ENST00000376669.9	92	764	++	49	Q9UI95#22	0	9	ENST00000376669.9	359	368	+	9	0	-6	4407
Q9UI95#22	0	3	3	Q9UI95	89	92	+	3	Q9UI95	0	211	ENST00000376667.7	209	842	++	48	Q9UI95#22	0	9	ENST00000376667.7	476	485	+	9	0	-6	4408
Q9UI95#22	0	3	3	Q9UI95	89	92	+	3	Q9UI95	0	211	ENST00000235310.7	929	1562	++	0	Q9UI95#22	0	9	ENST00000235310.7	1196	1205	+	9	0	-6	4409
Q9UI95#23	0	10	10	Q9UI95	93	103	+	10	Q9UI95	0	176	ENST00000697274.1	72	600	++	270	Q9UI95#23	0	30	ENST00000697274.1	351	381	+	30	0	-20	4410
Q9UI95#23	0	10	10	Q9UI95	93	103	+	10	Q9UI95	0	211	ENST00000456915.2	530	1163	++	105	Q9UI95#23	0	30	ENST00000456915.2	809	839	+	30	0	-20	4411
Q9UI95#23	0	10	10	Q9UI95	93	103	+	10	Q9UI95	0	167	ENST00000445656.5	85	676	++	95	Q9UI95#23	0	30	ENST00000445656.5	454	484	+	30	0	-20	4412
Q9UI95#23	0	10	10	Q9UI95	93	103	+	10	Q9UI95	0	211	ENST00000376692.9	122	755	++	51	Q9UI95#23	0	30	ENST00000376692.9	401	431	+	30	0	-20	4413
Q9UI95#23	0	10	10	Q9UI95	93	103	+	10	Q9UI95	0	211	ENST00000376672.5	77	749	++	50	Q9UI95#23	0	30	ENST00000376672.5	356	386	+	30	0	-20	4414
Q9UI95#23	0	10	10	Q9UI95	93	103	+	10	Q9UI95	0	211	ENST00000376669.9	92	764	++	49	Q9UI95#23	0	30	ENST00000376669.9	371	401	+	30	0	-20	4415
Q9UI95#23	0	10	10	Q9UI95	93	103	+	10	Q9UI95	0	211	ENST00000376667.7	209	842	++	48	Q9UI95#23	0	30	ENST00000376667.7	488	518	+	30	0	-20	4416
Q9UI95#23	0	10	10	Q9UI95	93	103	+	10	Q9UI95	0	211	ENST00000235310.7	929	1562	++	0	Q9UI95#23	0	30	ENST00000235310.7	1208	1238	+	30	0	-20	4417
Q9UI95#24	0	6	6	Q9UI95	105	111	+	6	Q9UI95	0	176	ENST00000697274.1	72	600	++	270	Q9UI95#24	0	18	ENST00000697274.1	387	405	+	18	0	-12	4418
Q9UI95#24	0	6	6	Q9UI95	105	111	+	6	Q9UI95	0	211	ENST00000456915.2	530	1163	++	105	Q9UI95#24	0	18	ENST00000456915.2	845	863	+	18	0	-12	4419
Q9UI95#24	0	6	6	Q9UI95	105	111	+	6	Q9UI95	0	167	ENST00000445656.5	85	676	++	95	Q9UI95#24	0	18	ENST00000445656.5	490	508	+	18	0	-12	4420
Q9UI95#24	0	6	6	Q9UI95	105	111	+	6	Q9UI95	0	211	ENST00000376692.9	122	755	++	51	Q9UI95#24	0	18	ENST00000376692.9	437	455	+	18	0	-12	4421
Q9UI95#24	0	6	6	Q9UI95	105	111	+	6	Q9UI95	0	211	ENST00000376672.5	77	749	++	50	Q9UI95#24	0	18	ENST00000376672.5	392	449	+	18	0	-12	4422
Q9UI95#24	0	6	6	Q9UI95	105	111	+	6	Q9UI95	0	211	ENST00000376669.9	92	764	++	49	Q9UI95#24	0	18	ENST00000376669.9	407	464	+	18	0	-12	4423
Q9UI95#24	0	6	6	Q9UI95	105	111	+	6	Q9UI95	0	211	ENST00000376667.7	209	842	++	48	Q9UI95#24	0	18	ENST00000376667.7	524	542	+	18	0	-12	4424
Q9UI95#24	0	6	6	Q9UI95	105	111	+	6	Q9UI95	0	211	ENST00000235310.7	929	1562	++	0	Q9UI95#24	0	18	ENST00000235310.7	1244	1262	+	18	0	-12	4425
Q9UI95#25	0	3	3	Q9UI95	111	114	+	3	Q9UI95	0	176	ENST00000697274.1	72	600	++	270	Q9UI95#25	0	9	ENST00000697274.1	405	414	+	9	0	-6	4426
Q9UI95#25	0	3	3	Q9UI95	111	114	+	3	Q9UI95	0	211	ENST00000456915.2	530	1163	++	105	Q9UI95#25	0	9	ENST00000456915.2	863	872	+	9	0	-6	4427
Q9UI95#25	0	3	3	Q9UI95	111	114	+	3	Q9UI95	0	167	ENST00000445656.5	85	676	++	95	Q9UI95#25	0	9	ENST00000445656.5	508	517	+	9	0	-6	4428
Q9UI95#25	0	3	3	Q9UI95	111	114	+	3	Q9UI95	0	211	ENST00000376692.9	122	755	++	51	Q9UI95#25	0	9	ENST00000376692.9	455	464	+	9	0	-6	4429
Q9UI95#25	0	3	3	Q9UI95	111	114	+	3	Q9UI95	0	211	ENST00000376672.5	77	749	++	50	Q9UI95#25	0	9	ENST00000376672.5	449	458	+	9	0	-6	4430
Q9UI95#25	0	3	3	Q9UI95	111	114	+	3	Q9UI95	0	211	ENST00000376669.9	92	764	++	49	Q9UI95#25	0	9	ENST00000376669.9	464	473	+	9	0	-6	4431
Q9UI95#25	0	3	3	Q9UI95	111	114	+	3	Q9UI95	0	211	ENST00000376667.7	209	842	++	48	Q9UI95#25	0	9	ENST00000376667.7	542	551	+	9	0	-6	4432
Q9UI95#25	0	3	3	Q9UI95	111	114	+	3	Q9UI95	0	211	ENST00000235310.7	929	1562	++	0	Q9UI95#25	0	9	ENST00000235310.7	1262	1271	+	9	0	-6	4433
Q9UI95#26	0	4	4	Q9UI95	114	118	+	4	Q9UI95	0	176	ENST00000697274.1	72	600	++	270	Q9UI95#26	0	12	ENST00000697274.1	414	426	+	12	0	-8	4434
Q9UI95#26	0	4	4	Q9UI95	114	118	+	4	Q9UI95	0	211	ENST00000456915.2	530	1163	++	105	Q9UI95#26	0	12	ENST00000456915.2	872	884	+	12	0	-8	4435
Q9UI95#26	0	4	4	Q9UI95	114	118	+	4	Q9UI95	0	167	ENST00000445656.5	85	676	++	95	Q9UI95#26	0	12	ENST00000445656.5	517	529	+	12	0	-8	4436
Q9UI95#26	0	4	4	Q9UI95	114	118	+	4	Q9UI95	0	211	ENST00000376692.9	122	755	++	51	Q9UI95#26	0	12	ENST00000376692.9	464	476	+	12	0	-8	4437
Q9UI95#26	0	4	4	Q9UI95	114	118	+	4	Q9UI95	0	211	ENST00000376672.5	77	749	++	50	Q9UI95#26	0	12	ENST00000376672.5	458	470	+	12	0	-8	4438
Q9UI95#26	0	4	4	Q9UI95	114	118	+	4	Q9UI95	0	211	ENST00000376669.9	92	764	++	49	Q9UI95#26	0	12	ENST00000376669.9	473	485	+	12	0	-8	4439
Q9UI95#26	0	4	4	Q9UI95	114	118	+	4	Q9UI95	0	211	ENST00000376667.7	209	842	++	48	Q9UI95#26	0	12	ENST00000376667.7	551	563	+	12	0	-8	4440
Q9UI95#26	0	4	4	Q9UI95	114	118	+	4	Q9UI95	0	211	ENST00000235310.7	929	1562	++	0	Q9UI95#26	0	12	ENST00000235310.7	1271	1283	+	12	0	-8	4441
Q9UI95#27	0	13	13	Q9UI95	118	131	+	13	Q9UI95	0	176	ENST00000697274.1	72	600	++	270	Q9UI95#27	0	39	ENST00000697274.1	426	465	+	39	0	-26	4442
Q9UI95#27	0	13	13	Q9UI95	118	131	+	13	Q9UI95	0	211	ENST00000456915.2	530	1163	++	105	Q9UI95#27	0	39	ENST00000456915.2	884	923	+	39	0	-26	4443
Q9UI95#27	0	13	13	Q9UI95	118	131	+	13	Q9UI95	0	167	ENST00000445656.5	85	676	++	95	Q9UI95#27	0	39	ENST00000445656.5	529	568	+	39	0	-26	4444
Q9UI95#27	0	13	13	Q9UI95	118	131	+	13	Q9UI95	0	211	ENST00000376692.9	122	755	++	51	Q9UI95#27	0	39	ENST00000376692.9	476	515	+	39	0	-26	4445
Q9UI95#27	0	13	13	Q9UI95	118	131	+	13	Q9UI95	0	211	ENST00000376672.5	77	749	++	50	Q9UI95#27	0	39	ENST00000376672.5	470	509	+	39	0	-26	4446
Q9UI95#27	0	13	13	Q9UI95	118	131	+	13	Q9UI95	0	211	ENST00000376669.9	92	764	++	49	Q9UI95#27	0	39	ENST00000376669.9	485	524	+	39	0	-26	4447
Q9UI95#27	0	13	13	Q9UI95	118	131	+	13	Q9UI95	0	211	ENST00000376667.7	209	842	++	48	Q9UI95#27	0	39	ENST00000376667.7	563	602	+	39	0	-26	4448
Q9UI95#27	0	13	13	Q9UI95	118	131	+	13	Q9UI95	0	211	ENST00000235310.7	929	1562	++	0	Q9UI95#27	0	39	ENST00000235310.7	1283	1322	+	39	0	-26	4449
Q9UI95#28	0	3	3	Q9UI95	132	135	+	3	Q9UI95	0	176	ENST00000697274.1	72	600	++	270	Q9UI95#28	0	9	ENST00000697274.1	468	477	+	9	0	-6	4450
Q9UI95#28	0	3	3	Q9UI95	132	135	+	3	Q9UI95	0	211	ENST00000456915.2	530	1163	++	105	Q9UI95#28	0	9	ENST00000456915.2	926	935	+	9	0	-6	4451
Q9UI95#28	0	3	3	Q9UI95	132	135	+	3	Q9UI95	0	167	ENST00000445656.5	85	676	++	95	Q9UI95#28	0	9	ENST00000445656.5	571	580	+	9	0	-6	4452
Q9UI95#28	0	3	3	Q9UI95	132	135	+	3	Q9UI95	0	211	ENST00000376692.9	122	755	++	51	Q9UI95#28	0	9	ENST00000376692.9	518	527	+	9	0	-6	4453
Q9UI95#28	0	3	3	Q9UI95	132	135	+	3	Q9UI95	0	211	ENST00000376672.5	77	749	++	50	Q9UI95#28	0	9	ENST00000376672.5	512	521	+	9	0	-6	4454
Q9UI95#28	0	3	3	Q9UI95	132	135	+	3	Q9UI95	0	211	ENST00000376669.9	92	764	++	49	Q9UI95#28	0	9	ENST00000376669.9	527	536	+	9	0	-6	4455
Q9UI95#28	0	3	3	Q9UI95	132	135	+	3	Q9UI95	0	211	ENST00000376667.7	209	842	++	48	Q9UI95#28	0	9	ENST00000376667.7	605	614	+	9	0	-6	4456
Q9UI95#28	0	3	3	Q9UI95	132	135	+	3	Q9UI95	0	211	ENST00000235310.7	929	1562	++	0	Q9UI95#28	0	9	ENST00000235310.7	1325	1334	+	9	0	-6	4457
Q9UI95#29	0	11	11	Q9UI95	144	155	+	11	Q9UI95	0	176	ENST00000697274.1	72	600	++	270	Q9UI95#29	0	33	ENST00000697274.1	504	537	+	33	0	-22	4458
Q9UI95#29	0	11	11	Q9UI95	144	155	+	11	Q9UI95	146	211	ENST00000697272.1	2	197	++	268	Q9UI95#29	6	33	ENST00000697272.1	2	29	+	27	6	-22	4459
Q9UI95#29	0	11	11	Q9UI95	144	155	+	11	Q9UI95	0	211	ENST00000456915.2	530	1163	++	105	Q9UI95#29	0	33	ENST00000456915.2	962	995	+	33	0	-22	4460
Q9UI95#29	0	11	11	Q9UI95	144	155	+	11	Q9UI95	0	167	ENST00000445656.5	85	676	++	95	Q9UI95#29	0	33	ENST00000445656.5	607	640	+	33	0	-22	4461
Q9UI95#29	0	11	11	Q9UI95	144	155	+	11	Q9UI95	0	211	ENST00000376692.9	122	755	++	51	Q9UI95#29	0	33	ENST00000376692.9	554	587	+	33	0	-22	4462
Q9UI95#29	0	11	11	Q9UI95	144	155	+	11	Q9UI95	0	211	ENST00000376672.5	77	749	++	50	Q9UI95#29	0	33	ENST00000376672.5	548	581	+	33	0	-22	4463
Q9UI95#29	0	11	11	Q9UI95	144	155	+	11	Q9UI95	0	211	ENST00000376669.9	92	764	++	49	Q9UI95#29	0	33	ENST00000376669.9	563	596	+	33	0	-22	4464
Q9UI95#29	0	11	11	Q9UI95	144	155	+	11	Q9UI95	0	211	ENST00000376667.7	209	842	++	48	Q9UI95#29	0	33	ENST00000376667.7	641	674	+	33	0	-22	4465
Q9UI95#29	0	11	11	Q9UI95	144	155	+	11	Q9UI95	0	211	ENST00000235310.7	929	1562	++	0	Q9UI95#29	0	33	ENST00000235310.7	1361	1394	+	33	0	-22	4466
Q9UI95#30	0	4	4	Q9UI95	155	159	+	4	Q9UI95	0	176	ENST00000697274.1	72	600	++	270	Q9UI95#30	0	12	ENST00000697274.1	537	549	+	12	0	-8	4467
Q9UI95#30	0	4	4	Q9UI95	155	159	+	4	Q9UI95	146	211	ENST00000697272.1	2	197	++	268	Q9UI95#30	0	12	ENST00000697272.1	29	41	+	12	0	-8	4468
Q9UI95#30	0	4	4	Q9UI95	155	159	+	4	Q9UI95	0	211	ENST00000456915.2	530	1163	++	105	Q9UI95#30	0	12	ENST00000456915.2	995	1007	+	12	0	-8	4469
Q9UI95#30	0	4	4	Q9UI95	155	159	+	4	Q9UI95	0	167	ENST00000445656.5	85	676	++	95	Q9UI95#30	0	12	ENST00000445656.5	640	652	+	12	0	-8	4470
Q9UI95#30	0	4	4	Q9UI95	155	159	+	4	Q9UI95	0	211	ENST00000376692.9	122	755	++	51	Q9UI95#30	0	12	ENST00000376692.9	587	599	+	12	0	-8	4471
Q9UI95#30	0	4	4	Q9UI95	155	159	+	4	Q9UI95	0	211	ENST00000376672.5	77	749	++	50	Q9UI95#30	0	12	ENST00000376672.5	581	593	+	12	0	-8	4472
Q9UI95#30	0	4	4	Q9UI95	155	159	+	4	Q9UI95	0	211	ENST00000376669.9	92	764	++	49	Q9UI95#30	0	12	ENST00000376669.9	596	608	+	12	0	-8	4473
Q9UI95#30	0	4	4	Q9UI95	155	159	+	4	Q9UI95	0	211	ENST00000376667.7	209	842	++	48	Q9UI95#30	0	12	ENST00000376667.7	674	686	+	12	0	-8	4474
Q9UI95#30	0	4	4	Q9UI95	155	159	+	4	Q9UI95	0	211	ENST00000235310.7	929	1562	++	0	Q9UI95#30	0	12	ENST00000235310.7	1394	1406	+	12	0	-8	4475
Q9UI95#31	0	5	5	Q9UI95	161	166	+	5	Q9UI95	0	176	ENST00000697274.1	72	600	++	270	Q9UI95#31	0	15	ENST00000697274.1	555	570	+	15	0	-10	4476
Q9UI95#31	0	5	5	Q9UI95	161	166	+	5	Q9UI95	146	211	ENST00000697272.1	2	197	++	268	Q9UI95#31	0	15	ENST00000697272.1	47	62	+	15	0	-10	4477
Q9UI95#31	0	5	5	Q9UI95	161	166	+	5	Q9UI95	0	211	ENST00000456915.2	530	1163	++	105	Q9UI95#31	0	15	ENST00000456915.2	1013	1028	+	15	0	-10	4478
Q9UI95#31	0	5	5	Q9UI95	161	166	+	5	Q9UI95	0	167	ENST00000445656.5	85	676	++	95	Q9UI95#31	0	15	ENST00000445656.5	658	673	+	15	0	-10	4479
Q9UI95#31	0	5	5	Q9UI95	161	166	+	5	Q9UI95	0	211	ENST00000376692.9	122	755	++	51	Q9UI95#31	0	15	ENST00000376692.9	605	620	+	15	0	-10	4480
Q9UI95#31	0	5	5	Q9UI95	161	166	+	5	Q9UI95	0	211	ENST00000376672.5	77	749	++	50	Q9UI95#31	0	15	ENST00000376672.5	599	614	+	15	0	-10	4481
Q9UI95#31	0	5	5	Q9UI95	161	166	+	5	Q9UI95	0	211	ENST00000376669.9	92	764	++	49	Q9UI95#31	0	15	ENST00000376669.9	614	629	+	15	0	-10	4482
Q9UI95#31	0	5	5	Q9UI95	161	166	+	5	Q9UI95	0	211	ENST00000376667.7	209	842	++	48	Q9UI95#31	0	15	ENST00000376667.7	692	707	+	15	0	-10	4483
Q9UI95#31	0	5	5	Q9UI95	161	166	+	5	Q9UI95	0	211	ENST00000235310.7	929	1562	++	0	Q9UI95#31	0	15	ENST00000235310.7	1412	1427	+	15	0	-10	4484
Q9UI95#32	0	5	5	Q9UI95	168	173	+	5	Q9UI95	0	176	ENST00000697274.1	72	600	++	270	Q9UI95#32	0	15	ENST00000697274.1	576	591	+	15	0	-10	4485
Q9UI95#32	0	5	5	Q9UI95	168	173	+	5	Q9UI95	146	211	ENST00000697272.1	2	197	++	268	Q9UI95#32	0	15	ENST00000697272.1	68	83	+	15	0	-10	4486
Q9UI95#32	0	5	5	Q9UI95	168	173	+	5	Q9UI95	0	211	ENST00000456915.2	530	1163	++	105	Q9UI95#32	0	15	ENST00000456915.2	1034	1049	+	15	0	-10	4487
Q9UI95#32	0	5	5	Q9UI95	168	173	+	5	Q9UI95	0	211	ENST00000376692.9	122	755	++	51	Q9UI95#32	0	15	ENST00000376692.9	626	641	+	15	0	-10	4488
Q9UI95#32	0	5	5	Q9UI95	168	173	+	5	Q9UI95	0	211	ENST00000376672.5	77	749	++	50	Q9UI95#32	0	15	ENST00000376672.5	620	635	+	15	0	-10	4489
Q9UI95#32	0	5	5	Q9UI95	168	173	+	5	Q9UI95	0	211	ENST00000376669.9	92	764	++	49	Q9UI95#32	0	15	ENST00000376669.9	635	650	+	15	0	-10	4490
Q9UI95#32	0	5	5	Q9UI95	168	173	+	5	Q9UI95	0	211	ENST00000376667.7	209	842	++	48	Q9UI95#32	0	15	ENST00000376667.7	713	728	+	15	0	-10	4491
Q9UI95#32	0	5	5	Q9UI95	168	173	+	5	Q9UI95	0	211	ENST00000235310.7	929	1562	++	0	Q9UI95#32	0	15	ENST00000235310.7	1433	1448	+	15	0	-10	4492
Q9UI95#33	0	4	4	Q9UI95	175	179	+	4	Q9UI95	0	176	ENST00000697274.1	72	600	++	270	Q9UI95#33	0	3	ENST00000697274.1	597	600	+	3	0	1	4493
Q9UI95#33	0	4	4	Q9UI95	175	179	+	4	Q9UI95	146	211	ENST00000697272.1	2	197	++	268	Q9UI95#33	0	12	ENST00000697272.1	89	101	+	12	0	-8	4494
Q9UI95#33	0	4	4	Q9UI95	175	179	+	4	Q9UI95	0	211	ENST00000456915.2	530	1163	++	105	Q9UI95#33	0	12	ENST00000456915.2	1055	1067	+	12	0	-8	4495
Q9UI95#33	0	4	4	Q9UI95	175	179	+	4	Q9UI95	0	211	ENST00000376692.9	122	755	++	51	Q9UI95#33	0	12	ENST00000376692.9	647	659	+	12	0	-8	4496
Q9UI95#33	0	4	4	Q9UI95	175	179	+	4	Q9UI95	0	211	ENST00000376672.5	77	749	++	50	Q9UI95#33	0	12	ENST00000376672.5	641	653	+	12	0	-8	4497
Q9UI95#33	0	4	4	Q9UI95	175	179	+	4	Q9UI95	0	211	ENST00000376669.9	92	764	++	49	Q9UI95#33	0	12	ENST00000376669.9	656	668	+	12	0	-8	4498
Q9UI95#33	0	4	4	Q9UI95	175	179	+	4	Q9UI95	0	211	ENST00000376667.7	209	842	++	48	Q9UI95#33	0	12	ENST00000376667.7	734	746	+	12	0	-8	4499
Q9UI95#33	0	4	4	Q9UI95	175	179	+	4	Q9UI95	0	211	ENST00000235310.7	929	1562	++	0	Q9UI95#33	0	12	ENST00000235310.7	1454	1466	+	12	0	-8	4500
Q9UI95#34	0	12	12	Q9UI95	184	196	+	12	Q9UI95	146	211	ENST00000697272.1	2	197	++	268	Q9UI95#34	0	36	ENST00000697272.1	116	152	+	36	0	-24	4501
Q9UI95#34	0	12	12	Q9UI95	184	196	+	12	Q9UI95	0	211	ENST00000456915.2	530	1163	++	105	Q9UI95#34	0	36	ENST00000456915.2	1082	1118	+	36	0	-24	4502
Q9UI95#34	0	12	12	Q9UI95	184	196	+	12	Q9UI95	0	211	ENST00000376692.9	122	755	++	51	Q9UI95#34	0	36	ENST00000376692.9	674	710	+	36	0	-24	4503
Q9UI95#34	0	12	12	Q9UI95	184	196	+	12	Q9UI95	0	211	ENST00000376672.5	77	749	++	50	Q9UI95#34	0	36	ENST00000376672.5	668	704	+	36	0	-24	4504
Q9UI95#34	0	12	12	Q9UI95	184	196	+	12	Q9UI95	0	211	ENST00000376669.9	92	764	++	49	Q9UI95#34	0	36	ENST00000376669.9	683	719	+	36	0	-24	4505
Q9UI95#34	0	12	12	Q9UI95	184	196	+	12	Q9UI95	0	211	ENST00000376667.7	209	842	++	48	Q9UI95#34	0	36	ENST00000376667.7	761	797	+	36	0	-24	4506
Q9UI95#34	0	12	12	Q9UI95	184	196	+	12	Q9UI95	0	211	ENST00000235310.7	929	1562	++	0	Q9UI95#34	0	36	ENST00000235310.7	1481	1517	+	36	0	-24	4507
Q9UI95#35	0	8	8	Q9UI95	197	205	+	8	Q9UI95	146	211	ENST00000697272.1	2	197	++	268	Q9UI95#35	0	24	ENST00000697272.1	155	179	+	24	0	-16	4508
Q9UI95#35	0	8	8	Q9UI95	197	205	+	8	Q9UI95	0	211	ENST00000456915.2	530	1163	++	105	Q9UI95#35	0	24	ENST00000456915.2	1121	1145	+	24	0	-16	4509
Q9UI95#35	0	8	8	Q9UI95	197	205	+	8	Q9UI95	0	211	ENST00000376692.9	122	755	++	51	Q9UI95#35	0	24	ENST00000376692.9	713	737	+	24	0	-16	4510
Q9UI95#35	0	8	8	Q9UI95	197	205	+	8	Q9UI95	0	211	ENST00000376672.5	77	749	++	50	Q9UI95#35	0	24	ENST00000376672.5	707	731	+	24	0	-16	4511
Q9UI95#35	0	8	8	Q9UI95	197	205	+	8	Q9UI95	0	211	ENST00000376669.9	92	764	++	49	Q9UI95#35	0	24	ENST00000376669.9	722	746	+	24	0	-16	4512
Q9UI95#35	0	8	8	Q9UI95	197	205	+	8	Q9UI95	0	211	ENST00000376667.7	209	842	++	48	Q9UI95#35	0	24	ENST00000376667.7	800	824	+	24	0	-16	4513
Q9UI95#35	0	8	8	Q9UI95	197	205	+	8	Q9UI95	0	211	ENST00000235310.7	929	1562	++	0	Q9UI95#35	0	24	ENST00000235310.7	1520	1544	+	24	0	-16	4514
Q9BS31#0	0	505	505	Q9BS31	0	505	+	505	Q9BS31	0	505	ENST00000600738.5	285	1716	++	211	Q9BS31#0	0	1515	ENST00000600738.5	285	1716	+	1431	0	-1010	4515
Q9BS31#0	0	505	505	Q9BS31	0	505	+	505	Q9BS31	5	47	ENST00000599530.1	603	729	++	206	Q9BS31#0	15	141	ENST00000599530.1	603	729	+	126	15	364	4516
Q9BS31#0	0	505	505	Q9BS31	0	505	+	505	Q9BS31	5	45	ENST00000596690.1	444	564	++	204	Q9BS31#0	15	135	ENST00000596690.1	444	564	+	120	15	370	4517
Q9BS31#0	0	505	505	Q9BS31	0	505	+	505	Q9BS31	0	47	ENST00000595418.5	404	545	++	201	Q9BS31#0	0	141	ENST00000595418.5	404	545	+	141	0	364	4518
Q9BS31#0	0	505	505	Q9BS31	0	505	+	505	Q9BS31	0	505	ENST00000354957.8	291	1806	++	36	Q9BS31#0	0	1515	ENST00000354957.8	291	1806	+	1515	0	-1010	4519
Q9BS31#1	0	72	72	Q9BS31	7	79	+	72	Q9BS31	0	505	ENST00000600738.5	285	1716	++	211	Q9BS31#1	0	216	ENST00000600738.5	306	522	+	216	0	-144	4520
Q9BS31#1	0	72	72	Q9BS31	7	79	+	72	Q9BS31	5	47	ENST00000599530.1	603	729	++	206	Q9BS31#1	0	120	ENST00000599530.1	609	729	+	120	0	-48	4521
Q9BS31#1	0	72	72	Q9BS31	7	79	+	72	Q9BS31	5	45	ENST00000596690.1	444	564	++	204	Q9BS31#1	0	114	ENST00000596690.1	450	564	+	114	0	-42	4522
Q9BS31#1	0	72	72	Q9BS31	7	79	+	72	Q9BS31	0	47	ENST00000595418.5	404	545	++	201	Q9BS31#1	0	120	ENST00000595418.5	425	545	+	120	0	-48	4523
Q9BS31#1	0	72	72	Q9BS31	7	79	+	72	Q9BS31	0	505	ENST00000354957.8	291	1806	++	36	Q9BS31#1	0	216	ENST00000354957.8	312	528	+	216	0	-144	4524
Q9BS31#2	0	23	23	Q9BS31	177	200	+	23	Q9BS31	0	505	ENST00000600738.5	285	1716	++	211	Q9BS31#2	0	69	ENST00000600738.5	816	885	+	69	0	-46	4525
Q9BS31#2	0	23	23	Q9BS31	177	200	+	23	Q9BS31	0	505	ENST00000354957.8	291	1806	++	36	Q9BS31#2	0	69	ENST00000354957.8	822	891	+	69	0	-46	4526
Q9BS31#3	0	23	23	Q9BS31	205	228	+	23	Q9BS31	0	505	ENST00000600738.5	285	1716	++	211	Q9BS31#3	0	69	ENST00000600738.5	900	969	+	69	0	-46	4527
Q9BS31#3	0	23	23	Q9BS31	205	228	+	23	Q9BS31	0	505	ENST00000354957.8	291	1806	++	36	Q9BS31#3	0	69	ENST00000354957.8	906	975	+	69	0	-46	4528
Q9BS31#4	0	23	23	Q9BS31	233	256	+	23	Q9BS31	0	505	ENST00000600738.5	285	1716	++	211	Q9BS31#4	0	69	ENST00000600738.5	984	1053	+	69	0	-46	4529
Q9BS31#4	0	23	23	Q9BS31	233	256	+	23	Q9BS31	0	505	ENST00000354957.8	291	1806	++	36	Q9BS31#4	0	69	ENST00000354957.8	990	1059	+	69	0	-46	4530
Q9BS31#5	0	23	23	Q9BS31	261	284	+	23	Q9BS31	0	505	ENST00000600738.5	285	1716	++	211	Q9BS31#5	0	69	ENST00000600738.5	1068	1137	+	69	0	-46	4531
Q9BS31#5	0	23	23	Q9BS31	261	284	+	23	Q9BS31	0	505	ENST00000354957.8	291	1806	++	36	Q9BS31#5	0	69	ENST00000354957.8	1074	1143	+	69	0	-46	4532
Q9BS31#6	0	23	23	Q9BS31	289	312	+	23	Q9BS31	0	505	ENST00000600738.5	285	1716	++	211	Q9BS31#6	0	69	ENST00000600738.5	1152	1221	+	69	0	-46	4533
Q9BS31#6	0	23	23	Q9BS31	289	312	+	23	Q9BS31	0	505	ENST00000354957.8	291	1806	++	36	Q9BS31#6	0	69	ENST00000354957.8	1158	1227	+	69	0	-46	4534
Q9BS31#7	0	23	23	Q9BS31	317	340	+	23	Q9BS31	0	505	ENST00000600738.5	285	1716	++	211	Q9BS31#7	0	69	ENST00000600738.5	1236	1305	+	69	0	-46	4535
Q9BS31#7	0	23	23	Q9BS31	317	340	+	23	Q9BS31	0	505	ENST00000354957.8	291	1806	++	36	Q9BS31#7	0	69	ENST00000354957.8	1242	1311	+	69	0	-46	4536
Q9BS31#8	0	23	23	Q9BS31	345	368	+	23	Q9BS31	0	505	ENST00000600738.5	285	1716	++	211	Q9BS31#8	0	69	ENST00000600738.5	1320	1389	+	69	0	-46	4537
Q9BS31#8	0	23	23	Q9BS31	345	368	+	23	Q9BS31	0	505	ENST00000354957.8	291	1806	++	36	Q9BS31#8	0	69	ENST00000354957.8	1326	1395	+	69	0	-46	4538
Q9BS31#9	0	23	23	Q9BS31	373	396	+	23	Q9BS31	0	505	ENST00000600738.5	285	1716	++	211	Q9BS31#9	0	69	ENST00000600738.5	1404	1473	+	69	0	-46	4539
Q9BS31#9	0	23	23	Q9BS31	373	396	+	23	Q9BS31	0	505	ENST00000354957.8	291	1806	++	36	Q9BS31#9	0	69	ENST00000354957.8	1410	1479	+	69	0	-46	4540
Q9BS31#10	0	23	23	Q9BS31	401	424	+	23	Q9BS31	0	505	ENST00000600738.5	285	1716	++	211	Q9BS31#10	0	51	ENST00000600738.5	1488	1539	+	51	0	-28	4541
Q9BS31#10	0	23	23	Q9BS31	401	424	+	23	Q9BS31	0	505	ENST00000354957.8	291	1806	++	36	Q9BS31#10	0	69	ENST00000354957.8	1494	1563	+	69	0	-46	4542
Q9BS31#11	0	23	23	Q9BS31	429	452	+	23	Q9BS31	0	505	ENST00000600738.5	285	1716	++	211	Q9BS31#11	51	69	ENST00000600738.5	1539	1557	+	18	51	-46	4543
Q9BS31#11	0	23	23	Q9BS31	429	452	+	23	Q9BS31	0	505	ENST00000354957.8	291	1806	++	36	Q9BS31#11	0	69	ENST00000354957.8	1578	1647	+	69	0	-46	4544
Q9BS31#12	0	27	27	Q9BS31	454	481	+	27	Q9BS31	0	505	ENST00000600738.5	285	1716	++	211	Q9BS31#12	0	81	ENST00000600738.5	1563	1644	+	81	0	-54	4545
Q9BS31#12	0	27	27	Q9BS31	454	481	+	27	Q9BS31	0	505	ENST00000354957.8	291	1806	++	36	Q9BS31#12	0	81	ENST00000354957.8	1653	1734	+	81	0	-54	4546
Q9BS31#13	0	19	19	Q9BS31	462	481	+	19	Q9BS31	0	505	ENST00000600738.5	285	1716	++	211	Q9BS31#13	0	57	ENST00000600738.5	1587	1644	+	57	0	-38	4547
Q9BS31#13	0	19	19	Q9BS31	462	481	+	19	Q9BS31	0	505	ENST00000354957.8	291	1806	++	36	Q9BS31#13	0	57	ENST00000354957.8	1677	1734	+	57	0	-38	4548
Q9BS31#14	0	1	1	Q9BS31	111	112	+	1	Q9BS31	0	505	ENST00000600738.5	285	1716	++	211	Q9BS31#14	0	3	ENST00000600738.5	618	621	+	3	0	-2	4549
Q9BS31#14	0	1	1	Q9BS31	111	112	+	1	Q9BS31	0	505	ENST00000354957.8	291	1806	++	36	Q9BS31#14	0	3	ENST00000354957.8	624	627	+	3	0	-2	4550
Q9BS31#15	0	1	1	Q9BS31	351	352	+	1	Q9BS31	0	505	ENST00000600738.5	285	1716	++	211	Q9BS31#15	0	3	ENST00000600738.5	1338	1341	+	3	0	-2	4551
Q9BS31#15	0	1	1	Q9BS31	351	352	+	1	Q9BS31	0	505	ENST00000354957.8	291	1806	++	36	Q9BS31#15	0	3	ENST00000354957.8	1344	1347	+	3	0	-2	4552
Q9BS31#16	0	1	1	Q9BS31	468	469	+	1	Q9BS31	0	505	ENST00000600738.5	285	1716	++	211	Q9BS31#16	0	3	ENST00000600738.5	1605	1608	+	3	0	-2	4553
Q9BS31#16	0	1	1	Q9BS31	468	469	+	1	Q9BS31	0	505	ENST00000354957.8	291	1806	++	36	Q9BS31#16	0	3	ENST00000354957.8	1695	1698	+	3	0	-2	4554
Q9BS31#17	0	1	1	Q9BS31	7	8	+	1	Q9BS31	0	505	ENST00000600738.5	285	1716	++	211	Q9BS31#17	0	3	ENST00000600738.5	306	309	+	3	0	-2	4555
Q9BS31#17	0	1	1	Q9BS31	7	8	+	1	Q9BS31	5	47	ENST00000599530.1	603	729	++	206	Q9BS31#17	0	3	ENST00000599530.1	609	612	+	3	0	-2	4556
Q9BS31#17	0	1	1	Q9BS31	7	8	+	1	Q9BS31	5	45	ENST00000596690.1	444	564	++	204	Q9BS31#17	0	3	ENST00000596690.1	450	453	+	3	0	-2	4557
Q9BS31#17	0	1	1	Q9BS31	7	8	+	1	Q9BS31	0	47	ENST00000595418.5	404	545	++	201	Q9BS31#17	0	3	ENST00000595418.5	425	428	+	3	0	-2	4558
Q9BS31#17	0	1	1	Q9BS31	7	8	+	1	Q9BS31	0	505	ENST00000354957.8	291	1806	++	36	Q9BS31#17	0	3	ENST00000354957.8	312	315	+	3	0	-2	4559
Q9BS31#18	0	1	1	Q9BS31	313	314	+	1	Q9BS31	0	505	ENST00000600738.5	285	1716	++	211	Q9BS31#18	0	3	ENST00000600738.5	1224	1227	+	3	0	-2	4560
Q9BS31#18	0	1	1	Q9BS31	313	314	+	1	Q9BS31	0	505	ENST00000354957.8	291	1806	++	36	Q9BS31#18	0	3	ENST00000354957.8	1230	1233	+	3	0	-2	4561
Q8N139-1#0	0	1617	1617	Q8N139-1	0	1617	+	1617	Q8N139-1	0	153	ENST00000590645.1	189	648	++	193	Q8N139-1#0	0	459	ENST00000590645.1	189	648	+	459	0	1158	4562
Q8N139-1#0	0	1617	1617	Q8N139-1	0	1617	+	1617	Q8N139-1	0	1617	ENST00000284425.7	196	5047	++	15	Q8N139-1#0	0	4851	ENST00000284425.7	196	5047	+	4851	0	-3234	4563
Q8N139-1#1	0	21	21	Q8N139-1	30	51	+	21	Q8N139-1	0	153	ENST00000590645.1	189	648	++	193	Q8N139-1#1	0	63	ENST00000590645.1	279	342	+	63	0	-42	4564
Q8N139-1#1	0	21	21	Q8N139-1	30	51	+	21	Q8N139-1	0	1617	ENST00000284425.7	196	5047	++	15	Q8N139-1#1	0	63	ENST00000284425.7	286	349	+	63	0	-42	4565
Q8N139-1#2	0	21	21	Q8N139-1	221	242	+	21	Q8N139-1	0	1617	ENST00000284425.7	196	5047	++	15	Q8N139-1#2	0	63	ENST00000284425.7	859	922	+	63	0	-42	4566
Q8N139-1#3	0	21	21	Q8N139-1	267	288	+	21	Q8N139-1	0	1617	ENST00000284425.7	196	5047	++	15	Q8N139-1#3	0	63	ENST00000284425.7	997	1060	+	63	0	-42	4567
Q8N139-1#4	0	21	21	Q8N139-1	296	317	+	21	Q8N139-1	0	1617	ENST00000284425.7	196	5047	++	15	Q8N139-1#4	0	63	ENST00000284425.7	1084	1147	+	63	0	-42	4568
Q8N139-1#5	0	21	21	Q8N139-1	326	347	+	21	Q8N139-1	0	1617	ENST00000284425.7	196	5047	++	15	Q8N139-1#5	0	63	ENST00000284425.7	1174	1237	+	63	0	-42	4569
Q8N139-1#6	0	21	21	Q8N139-1	354	375	+	21	Q8N139-1	0	1617	ENST00000284425.7	196	5047	++	15	Q8N139-1#6	0	63	ENST00000284425.7	1258	1321	+	63	0	-42	4570
Q8N139-1#7	0	21	21	Q8N139-1	396	417	+	21	Q8N139-1	0	1617	ENST00000284425.7	196	5047	++	15	Q8N139-1#7	0	63	ENST00000284425.7	1384	1447	+	63	0	-42	4571
Q8N139-1#8	0	21	21	Q8N139-1	853	874	+	21	Q8N139-1	0	1617	ENST00000284425.7	196	5047	++	15	Q8N139-1#8	0	63	ENST00000284425.7	2755	2818	+	63	0	-42	4572
Q8N139-1#9	0	21	21	Q8N139-1	1006	1027	+	21	Q8N139-1	0	1617	ENST00000284425.7	196	5047	++	15	Q8N139-1#9	0	63	ENST00000284425.7	3214	3277	+	63	0	-42	4573
Q8N139-1#10	0	21	21	Q8N139-1	1061	1082	+	21	Q8N139-1	0	1617	ENST00000284425.7	196	5047	++	15	Q8N139-1#10	0	63	ENST00000284425.7	3379	3442	+	63	0	-42	4574
Q8N139-1#11	0	21	21	Q8N139-1	1093	1114	+	21	Q8N139-1	0	1617	ENST00000284425.7	196	5047	++	15	Q8N139-1#11	0	63	ENST00000284425.7	3475	3538	+	63	0	-42	4575
Q8N139-1#12	0	21	21	Q8N139-1	1126	1147	+	21	Q8N139-1	0	1617	ENST00000284425.7	196	5047	++	15	Q8N139-1#12	0	63	ENST00000284425.7	3574	3637	+	63	0	-42	4576
Q8N139-1#13	0	21	21	Q8N139-1	1149	1170	+	21	Q8N139-1	0	1617	ENST00000284425.7	196	5047	++	15	Q8N139-1#13	0	63	ENST00000284425.7	3643	3706	+	63	0	-42	4577
Q8N139-1#14	0	21	21	Q8N139-1	1193	1214	+	21	Q8N139-1	0	1617	ENST00000284425.7	196	5047	++	15	Q8N139-1#14	0	63	ENST00000284425.7	3775	3838	+	63	0	-42	4578
Q8N139-1#15	0	236	236	Q8N139-1	477	713	+	236	Q8N139-1	0	1617	ENST00000284425.7	196	5047	++	15	Q8N139-1#15	0	708	ENST00000284425.7	1627	2335	+	708	0	-472	4579
Q8N139-1#16	0	226	226	Q8N139-1	1287	1513	+	226	Q8N139-1	0	1617	ENST00000284425.7	196	5047	++	15	Q8N139-1#16	0	678	ENST00000284425.7	4057	4735	+	678	0	-452	4580
Q8N139-1#17	0	8	8	Q8N139-1	513	521	+	8	Q8N139-1	0	1617	ENST00000284425.7	196	5047	++	15	Q8N139-1#17	0	24	ENST00000284425.7	1735	1759	+	24	0	-16	4581
Q8N139-1#18	0	8	8	Q8N139-1	1319	1327	+	8	Q8N139-1	0	1617	ENST00000284425.7	196	5047	++	15	Q8N139-1#18	0	24	ENST00000284425.7	4153	4177	+	24	0	-16	4582
Q8N139-1#19	0	1	1	Q8N139-1	83	84	+	1	Q8N139-1	0	153	ENST00000590645.1	189	648	++	193	Q8N139-1#19	0	3	ENST00000590645.1	438	441	+	3	0	-2	4583
Q8N139-1#19	0	1	1	Q8N139-1	83	84	+	1	Q8N139-1	0	1617	ENST00000284425.7	196	5047	++	15	Q8N139-1#19	0	3	ENST00000284425.7	445	448	+	3	0	-2	4584
Q8N139-1#20	0	1	1	Q8N139-1	108	109	+	1	Q8N139-1	0	153	ENST00000590645.1	189	648	++	193	Q8N139-1#20	0	3	ENST00000590645.1	513	516	+	3	0	-2	4585
Q8N139-1#20	0	1	1	Q8N139-1	108	109	+	1	Q8N139-1	0	1617	ENST00000284425.7	196	5047	++	15	Q8N139-1#20	0	3	ENST00000284425.7	520	523	+	3	0	-2	4586
Q8N139-1#21	0	1	1	Q8N139-1	939	940	+	1	Q8N139-1	0	1617	ENST00000284425.7	196	5047	++	15	Q8N139-1#21	0	3	ENST00000284425.7	3013	3016	+	3	0	-2	4587
Q8N139-1#22	0	32	32	Q8N139-1	153	185	+	32	Q8N139-1	0	1617	ENST00000284425.7	196	5047	++	15	Q8N139-1#22	0	96	ENST00000284425.7	655	751	+	96	0	-64	4588
Q8N139-1#23	0	1432	1432	Q8N139-1	185	1617	+	1432	Q8N139-1	0	1617	ENST00000284425.7	196	5047	++	15	Q8N139-1#23	0	4296	ENST00000284425.7	751	5047	+	4296	0	-2864	4589
Q8N139-1#24	0	2	2	Q8N139-1	635	637	+	2	Q8N139-1	0	1617	ENST00000284425.7	196	5047	++	15	Q8N139-1#24	0	6	ENST00000284425.7	2101	2107	+	6	0	-4	4590
Q8N139-1#25	0	980	980	Q8N139-1	637	1617	+	980	Q8N139-1	0	1617	ENST00000284425.7	196	5047	++	15	Q8N139-1#25	0	2940	ENST00000284425.7	2107	5047	+	2940	0	-1960	4591
Q8N139-1#26	0	1	1	Q8N139-1	281	282	+	1	Q8N139-1	0	1617	ENST00000284425.7	196	5047	++	15	Q8N139-1#26	0	3	ENST00000284425.7	1039	1042	+	3	0	-2	4592
Q8N139-1#27	0	1	1	Q8N139-1	609	610	+	1	Q8N139-1	0	1617	ENST00000284425.7	196	5047	++	15	Q8N139-1#27	0	3	ENST00000284425.7	2023	2026	+	3	0	-2	4593
Q8N139-1#28	0	1	1	Q8N139-1	697	698	+	1	Q8N139-1	0	1617	ENST00000284425.7	196	5047	++	15	Q8N139-1#28	0	3	ENST00000284425.7	2287	2290	+	3	0	-2	4594
Q8N139-1#29	0	1	1	Q8N139-1	874	875	+	1	Q8N139-1	0	1617	ENST00000284425.7	196	5047	++	15	Q8N139-1#29	0	3	ENST00000284425.7	2818	2821	+	3	0	-2	4595
Q8N139-1#30	0	1	1	Q8N139-1	1321	1322	+	1	Q8N139-1	0	1617	ENST00000284425.7	196	5047	++	15	Q8N139-1#30	0	3	ENST00000284425.7	4159	4162	+	3	0	-2	4596
Q8N139-1#31	0	1	1	Q8N139-1	50	51	+	1	Q8N139-1	0	153	ENST00000590645.1	189	648	++	193	Q8N139-1#31	0	3	ENST00000590645.1	339	342	+	3	0	-2	4597
Q8N139-1#31	0	1	1	Q8N139-1	50	51	+	1	Q8N139-1	0	1617	ENST00000284425.7	196	5047	++	15	Q8N139-1#31	0	3	ENST00000284425.7	346	349	+	3	0	-2	4598
Q8N139-1#32	0	1	1	Q8N139-1	146	147	+	1	Q8N139-1	0	153	ENST00000590645.1	189	648	++	193	Q8N139-1#32	0	3	ENST00000590645.1	627	630	+	3	0	-2	4599
Q8N139-1#32	0	1	1	Q8N139-1	146	147	+	1	Q8N139-1	0	1617	ENST00000284425.7	196	5047	++	15	Q8N139-1#32	0	3	ENST00000284425.7	634	637	+	3	0	-2	4600
Q8N139-1#33	0	1	1	Q8N139-1	811	812	+	1	Q8N139-1	0	1617	ENST00000284425.7	196	5047	++	15	Q8N139-1#33	0	3	ENST00000284425.7	2629	2632	+	3	0	-2	4601
Q8N139-1#34	0	2	2	Q8N139-1	874	876	+	2	Q8N139-1	0	1617	ENST00000284425.7	196	5047	++	15	Q8N139-1#34	0	6	ENST00000284425.7	2818	2824	+	6	0	-4	4602
Q8IZY2-1#0	0	2146	2146	Q8IZY2-1	0	2146	+	2146	Q8IZY2-1	1859	2146	ENST00000612569.1	0	840	++	223	Q8IZY2-1#0	5577	6438	ENST00000612569.1	0	840	+	840	5577	-4292	4603
Q8IZY2-1#0	0	2146	2146	Q8IZY2-1	0	2146	+	2146	Q8IZY2-1	0	138	ENST00000531467.5	160	568	++	149	Q8IZY2-1#0	0	414	ENST00000531467.5	160	568	+	408	0	1732	4604
Q8IZY2-1#0	0	2146	2146	Q8IZY2-1	0	2146	+	2146	Q8IZY2-1	1181	1242	ENST00000530092.2	1	184	++	146	Q8IZY2-1#0	3543	3726	ENST00000530092.2	1	184	+	183	3543	-1580	4605
Q8IZY2-1#0	0	2146	2146	Q8IZY2-1	0	2146	+	2146	Q8IZY2-1	1536	1627	ENST00000529442.7	1	274	++	144	Q8IZY2-1#0	4608	4881	ENST00000529442.7	1	274	+	273	4608	-2735	4606
Q8IZY2-1#0	0	2146	2146	Q8IZY2-1	0	2146	+	2146	Q8IZY2-1	1538	2146	ENST00000525073.6	1	1771	++	141	Q8IZY2-1#0	4614	6438	ENST00000525073.6	1	1771	+	1770	4614	-4292	4607
Q8IZY2-1#0	0	2146	2146	Q8IZY2-1	0	2146	+	2146	Q8IZY2-1	0	164	ENST00000524850.5	84	576	++	140	Q8IZY2-1#0	0	492	ENST00000524850.5	84	576	+	492	0	1654	4608
Q8IZY2-1#0	0	2146	2146	Q8IZY2-1	0	2146	+	2146	Q8IZY2-1	843	1372	ENST00000435683.7	0	1601	++	86	Q8IZY2-1#0	2529	4116	ENST00000435683.7	0	1601	+	1587	2529	-1970	4609
Q8IZY2-1#0	0	2146	2146	Q8IZY2-1	0	2146	+	2146	Q8IZY2-1	0	2146	ENST00000263094.11	227	6665	++	10	Q8IZY2-1#0	0	6438	ENST00000263094.11	227	6665	+	6438	0	-4292	4610
Q8IZY2-1#1	0	21	21	Q8IZY2-1	21	42	+	21	Q8IZY2-1	0	138	ENST00000531467.5	160	568	++	149	Q8IZY2-1#1	0	63	ENST00000531467.5	223	280	+	57	0	-42	4611
Q8IZY2-1#1	0	21	21	Q8IZY2-1	21	42	+	21	Q8IZY2-1	0	164	ENST00000524850.5	84	576	++	140	Q8IZY2-1#1	0	63	ENST00000524850.5	147	210	+	63	0	-42	4612
Q8IZY2-1#1	0	21	21	Q8IZY2-1	21	42	+	21	Q8IZY2-1	0	2146	ENST00000263094.11	227	6665	++	10	Q8IZY2-1#1	0	63	ENST00000263094.11	290	353	+	63	0	-42	4613
Q8IZY2-1#2	0	507	507	Q8IZY2-1	42	549	+	507	Q8IZY2-1	0	138	ENST00000531467.5	160	568	++	149	Q8IZY2-1#2	0	288	ENST00000531467.5	280	568	+	288	0	219	4614
Q8IZY2-1#2	0	507	507	Q8IZY2-1	42	549	+	507	Q8IZY2-1	0	164	ENST00000524850.5	84	576	++	140	Q8IZY2-1#2	0	366	ENST00000524850.5	210	576	+	366	0	141	4615
Q8IZY2-1#2	0	507	507	Q8IZY2-1	42	549	+	507	Q8IZY2-1	0	2146	ENST00000263094.11	227	6665	++	10	Q8IZY2-1#2	0	1521	ENST00000263094.11	353	1874	+	1521	0	-1014	4616
Q8IZY2-1#3	0	21	21	Q8IZY2-1	549	570	+	21	Q8IZY2-1	0	2146	ENST00000263094.11	227	6665	++	10	Q8IZY2-1#3	0	63	ENST00000263094.11	1874	1937	+	63	0	-42	4617
Q8IZY2-1#4	0	21	21	Q8IZY2-1	592	613	+	21	Q8IZY2-1	0	2146	ENST00000263094.11	227	6665	++	10	Q8IZY2-1#4	0	63	ENST00000263094.11	2003	2066	+	63	0	-42	4618
Q8IZY2-1#5	0	21	21	Q8IZY2-1	625	646	+	21	Q8IZY2-1	0	2146	ENST00000263094.11	227	6665	++	10	Q8IZY2-1#5	0	63	ENST00000263094.11	2102	2165	+	63	0	-42	4619
Q8IZY2-1#6	0	21	21	Q8IZY2-1	654	675	+	21	Q8IZY2-1	0	2146	ENST00000263094.11	227	6665	++	10	Q8IZY2-1#6	0	63	ENST00000263094.11	2189	2252	+	63	0	-42	4620
Q8IZY2-1#7	0	21	21	Q8IZY2-1	686	707	+	21	Q8IZY2-1	0	2146	ENST00000263094.11	227	6665	++	10	Q8IZY2-1#7	0	63	ENST00000263094.11	2285	2348	+	63	0	-42	4621
Q8IZY2-1#8	0	21	21	Q8IZY2-1	726	747	+	21	Q8IZY2-1	0	2146	ENST00000263094.11	227	6665	++	10	Q8IZY2-1#8	0	63	ENST00000263094.11	2405	2468	+	63	0	-42	4622
Q8IZY2-1#9	0	21	21	Q8IZY2-1	848	869	+	21	Q8IZY2-1	843	1372	ENST00000435683.7	0	1601	++	86	Q8IZY2-1#9	0	63	ENST00000435683.7	15	78	+	63	0	-42	4623
Q8IZY2-1#9	0	21	21	Q8IZY2-1	848	869	+	21	Q8IZY2-1	0	2146	ENST00000263094.11	227	6665	++	10	Q8IZY2-1#9	0	63	ENST00000263094.11	2771	2834	+	63	0	-42	4624
Q8IZY2-1#10	0	21	21	Q8IZY2-1	1242	1263	+	21	Q8IZY2-1	843	1372	ENST00000435683.7	0	1601	++	86	Q8IZY2-1#10	0	63	ENST00000435683.7	1197	1260	+	63	0	-42	4625
Q8IZY2-1#10	0	21	21	Q8IZY2-1	1242	1263	+	21	Q8IZY2-1	0	2146	ENST00000263094.11	227	6665	++	10	Q8IZY2-1#10	0	63	ENST00000263094.11	3953	4016	+	63	0	-42	4626
Q8IZY2-1#11	0	274	274	Q8IZY2-1	1263	1537	+	274	Q8IZY2-1	1536	1627	ENST00000529442.7	1	274	++	144	Q8IZY2-1#11	819	822	ENST00000529442.7	1	4	+	3	819	-548	4627
Q8IZY2-1#11	0	274	274	Q8IZY2-1	1263	1537	+	274	Q8IZY2-1	843	1372	ENST00000435683.7	0	1601	++	86	Q8IZY2-1#11	0	327	ENST00000435683.7	1260	1601	+	327	0	-53	4628
Q8IZY2-1#11	0	274	274	Q8IZY2-1	1263	1537	+	274	Q8IZY2-1	0	2146	ENST00000263094.11	227	6665	++	10	Q8IZY2-1#11	0	822	ENST00000263094.11	4016	4838	+	822	0	-548	4629
Q8IZY2-1#12	0	21	21	Q8IZY2-1	1537	1558	+	21	Q8IZY2-1	1536	1627	ENST00000529442.7	1	274	++	144	Q8IZY2-1#12	0	63	ENST00000529442.7	4	67	+	63	0	-42	4630
Q8IZY2-1#12	0	21	21	Q8IZY2-1	1537	1558	+	21	Q8IZY2-1	1538	2146	ENST00000525073.6	1	1771	++	141	Q8IZY2-1#12	3	63	ENST00000525073.6	1	61	+	60	3	-42	4631
Q8IZY2-1#12	0	21	21	Q8IZY2-1	1537	1558	+	21	Q8IZY2-1	0	2146	ENST00000263094.11	227	6665	++	10	Q8IZY2-1#12	0	63	ENST00000263094.11	4838	4901	+	63	0	-42	4632
Q8IZY2-1#13	0	21	21	Q8IZY2-1	1583	1604	+	21	Q8IZY2-1	1536	1627	ENST00000529442.7	1	274	++	144	Q8IZY2-1#13	0	63	ENST00000529442.7	142	205	+	63	0	-42	4633
Q8IZY2-1#13	0	21	21	Q8IZY2-1	1583	1604	+	21	Q8IZY2-1	1538	2146	ENST00000525073.6	1	1771	++	141	Q8IZY2-1#13	0	63	ENST00000525073.6	136	199	+	63	0	-42	4634
Q8IZY2-1#13	0	21	21	Q8IZY2-1	1583	1604	+	21	Q8IZY2-1	0	2146	ENST00000263094.11	227	6665	++	10	Q8IZY2-1#13	0	63	ENST00000263094.11	4976	5039	+	63	0	-42	4635
Q8IZY2-1#14	0	21	21	Q8IZY2-1	1620	1641	+	21	Q8IZY2-1	1536	1627	ENST00000529442.7	1	274	++	144	Q8IZY2-1#14	0	21	ENST00000529442.7	253	274	+	21	0	0	4636
Q8IZY2-1#14	0	21	21	Q8IZY2-1	1620	1641	+	21	Q8IZY2-1	1538	2146	ENST00000525073.6	1	1771	++	141	Q8IZY2-1#14	0	21	ENST00000525073.6	247	268	+	21	0	0	4637
Q8IZY2-1#14	0	21	21	Q8IZY2-1	1620	1641	+	21	Q8IZY2-1	0	2146	ENST00000263094.11	227	6665	++	10	Q8IZY2-1#14	0	63	ENST00000263094.11	5087	5150	+	63	0	-42	4638
Q8IZY2-1#15	0	21	21	Q8IZY2-1	1648	1669	+	21	Q8IZY2-1	1538	2146	ENST00000525073.6	1	1771	++	141	Q8IZY2-1#15	0	63	ENST00000525073.6	277	340	+	63	0	-42	4639
Q8IZY2-1#15	0	21	21	Q8IZY2-1	1648	1669	+	21	Q8IZY2-1	0	2146	ENST00000263094.11	227	6665	++	10	Q8IZY2-1#15	0	63	ENST00000263094.11	5171	5234	+	63	0	-42	4640
Q8IZY2-1#16	0	21	21	Q8IZY2-1	1682	1703	+	21	Q8IZY2-1	1538	2146	ENST00000525073.6	1	1771	++	141	Q8IZY2-1#16	0	63	ENST00000525073.6	379	442	+	63	0	-42	4641
Q8IZY2-1#16	0	21	21	Q8IZY2-1	1682	1703	+	21	Q8IZY2-1	0	2146	ENST00000263094.11	227	6665	++	10	Q8IZY2-1#16	0	63	ENST00000263094.11	5273	5336	+	63	0	-42	4642
Q8IZY2-1#17	0	21	21	Q8IZY2-1	1728	1749	+	21	Q8IZY2-1	1538	2146	ENST00000525073.6	1	1771	++	141	Q8IZY2-1#17	0	63	ENST00000525073.6	517	580	+	63	0	-42	4643
Q8IZY2-1#17	0	21	21	Q8IZY2-1	1728	1749	+	21	Q8IZY2-1	0	2146	ENST00000263094.11	227	6665	++	10	Q8IZY2-1#17	0	63	ENST00000263094.11	5411	5474	+	63	0	-42	4644
Q8IZY2-1#18	0	232	232	Q8IZY2-1	806	1038	+	232	Q8IZY2-1	843	1372	ENST00000435683.7	0	1601	++	86	Q8IZY2-1#18	111	696	ENST00000435683.7	0	585	+	585	111	-464	4645
Q8IZY2-1#18	0	232	232	Q8IZY2-1	806	1038	+	232	Q8IZY2-1	0	2146	ENST00000263094.11	227	6665	++	10	Q8IZY2-1#18	0	696	ENST00000263094.11	2645	3341	+	696	0	-464	4646
Q8IZY2-1#19	0	233	233	Q8IZY2-1	1792	2025	+	233	Q8IZY2-1	1859	2146	ENST00000612569.1	0	840	++	223	Q8IZY2-1#19	201	699	ENST00000612569.1	0	498	+	498	201	-466	4647
Q8IZY2-1#19	0	233	233	Q8IZY2-1	1792	2025	+	233	Q8IZY2-1	1538	2146	ENST00000525073.6	1	1771	++	141	Q8IZY2-1#19	0	699	ENST00000525073.6	709	1408	+	699	0	-466	4648
Q8IZY2-1#19	0	233	233	Q8IZY2-1	1792	2025	+	233	Q8IZY2-1	0	2146	ENST00000263094.11	227	6665	++	10	Q8IZY2-1#19	0	699	ENST00000263094.11	5603	6302	+	699	0	-466	4649
Q8IZY2-1#20	0	25	25	Q8IZY2-1	1047	1072	+	25	Q8IZY2-1	843	1372	ENST00000435683.7	0	1601	++	86	Q8IZY2-1#20	0	75	ENST00000435683.7	612	687	+	75	0	-50	4650
Q8IZY2-1#20	0	25	25	Q8IZY2-1	1047	1072	+	25	Q8IZY2-1	0	2146	ENST00000263094.11	227	6665	++	10	Q8IZY2-1#20	0	75	ENST00000263094.11	3368	3443	+	75	0	-50	4651
Q8IZY2-1#21	0	25	25	Q8IZY2-1	1184	1209	+	25	Q8IZY2-1	1181	1242	ENST00000530092.2	1	184	++	146	Q8IZY2-1#21	0	75	ENST00000530092.2	10	85	+	75	0	-50	4652
Q8IZY2-1#21	0	25	25	Q8IZY2-1	1184	1209	+	25	Q8IZY2-1	843	1372	ENST00000435683.7	0	1601	++	86	Q8IZY2-1#21	0	75	ENST00000435683.7	1023	1098	+	75	0	-50	4653
Q8IZY2-1#21	0	25	25	Q8IZY2-1	1184	1209	+	25	Q8IZY2-1	0	2146	ENST00000263094.11	227	6665	++	10	Q8IZY2-1#21	0	75	ENST00000263094.11	3779	3854	+	75	0	-50	4654
Q8IZY2-1#22	0	43	43	Q8IZY2-1	2103	2146	+	43	Q8IZY2-1	1859	2146	ENST00000612569.1	0	840	++	223	Q8IZY2-1#22	0	129	ENST00000612569.1	711	840	+	129	0	-86	4655
Q8IZY2-1#22	0	43	43	Q8IZY2-1	2103	2146	+	43	Q8IZY2-1	1538	2146	ENST00000525073.6	1	1771	++	141	Q8IZY2-1#22	0	129	ENST00000525073.6	1642	1771	+	129	0	-86	4656
Q8IZY2-1#22	0	43	43	Q8IZY2-1	2103	2146	+	43	Q8IZY2-1	0	2146	ENST00000263094.11	227	6665	++	10	Q8IZY2-1#22	0	129	ENST00000263094.11	6536	6665	+	129	0	-86	4657
Q8IZY2-1#23	0	19	19	Q8IZY2-1	1047	1066	+	19	Q8IZY2-1	843	1372	ENST00000435683.7	0	1601	++	86	Q8IZY2-1#23	0	57	ENST00000435683.7	612	669	+	57	0	-38	4658
Q8IZY2-1#23	0	19	19	Q8IZY2-1	1047	1066	+	19	Q8IZY2-1	0	2146	ENST00000263094.11	227	6665	++	10	Q8IZY2-1#23	0	57	ENST00000263094.11	3368	3425	+	57	0	-38	4659
Q8IZY2-1#24	0	8	8	Q8IZY2-1	840	848	+	8	Q8IZY2-1	843	1372	ENST00000435683.7	0	1601	++	86	Q8IZY2-1#24	9	24	ENST00000435683.7	0	15	+	15	9	-16	4660
Q8IZY2-1#24	0	8	8	Q8IZY2-1	840	848	+	8	Q8IZY2-1	0	2146	ENST00000263094.11	227	6665	++	10	Q8IZY2-1#24	0	24	ENST00000263094.11	2747	2771	+	24	0	-16	4661
Q8IZY2-1#25	0	8	8	Q8IZY2-1	1826	1834	+	8	Q8IZY2-1	1538	2146	ENST00000525073.6	1	1771	++	141	Q8IZY2-1#25	0	24	ENST00000525073.6	811	835	+	24	0	-16	4662
Q8IZY2-1#25	0	8	8	Q8IZY2-1	1826	1834	+	8	Q8IZY2-1	0	2146	ENST00000263094.11	227	6665	++	10	Q8IZY2-1#25	0	24	ENST00000263094.11	5705	5729	+	24	0	-16	4663
Q8IZY2-1#26	0	1	1	Q8IZY2-1	311	312	+	1	Q8IZY2-1	0	2146	ENST00000263094.11	227	6665	++	10	Q8IZY2-1#26	0	3	ENST00000263094.11	1160	1163	+	3	0	-2	4664
Q8IZY2-1#27	0	151	151	Q8IZY2-1	74	225	+	151	Q8IZY2-1	0	138	ENST00000531467.5	160	568	++	149	Q8IZY2-1#27	0	192	ENST00000531467.5	376	568	+	192	0	-41	4665
Q8IZY2-1#27	0	151	151	Q8IZY2-1	74	225	+	151	Q8IZY2-1	0	164	ENST00000524850.5	84	576	++	140	Q8IZY2-1#27	0	270	ENST00000524850.5	306	576	+	270	0	-119	4666
Q8IZY2-1#27	0	151	151	Q8IZY2-1	74	225	+	151	Q8IZY2-1	0	2146	ENST00000263094.11	227	6665	++	10	Q8IZY2-1#27	0	453	ENST00000263094.11	449	902	+	453	0	-302	4667
Q8IZY2-1#28	0	15	15	Q8IZY2-1	1344	1359	+	15	Q8IZY2-1	843	1372	ENST00000435683.7	0	1601	++	86	Q8IZY2-1#28	0	45	ENST00000435683.7	1517	1562	+	45	0	-30	4668
Q8IZY2-1#28	0	15	15	Q8IZY2-1	1344	1359	+	15	Q8IZY2-1	0	2146	ENST00000263094.11	227	6665	++	10	Q8IZY2-1#28	0	45	ENST00000263094.11	4259	4304	+	45	0	-30	4669
Q8IZY2-1#29	0	138	138	Q8IZY2-1	0	138	+	138	Q8IZY2-1	0	138	ENST00000531467.5	160	568	++	149	Q8IZY2-1#29	0	414	ENST00000531467.5	160	568	+	408	0	-276	4670
Q8IZY2-1#29	0	138	138	Q8IZY2-1	0	138	+	138	Q8IZY2-1	0	164	ENST00000524850.5	84	576	++	140	Q8IZY2-1#29	0	414	ENST00000524850.5	84	498	+	414	0	-276	4671
Q8IZY2-1#29	0	138	138	Q8IZY2-1	0	138	+	138	Q8IZY2-1	0	2146	ENST00000263094.11	227	6665	++	10	Q8IZY2-1#29	0	414	ENST00000263094.11	227	641	+	414	0	-276	4672
Q8IZY2-1#30	0	28	28	Q8IZY2-1	138	166	+	28	Q8IZY2-1	0	164	ENST00000524850.5	84	576	++	140	Q8IZY2-1#30	0	78	ENST00000524850.5	498	576	+	78	0	-50	4673
Q8IZY2-1#30	0	28	28	Q8IZY2-1	138	166	+	28	Q8IZY2-1	0	2146	ENST00000263094.11	227	6665	++	10	Q8IZY2-1#30	0	84	ENST00000263094.11	641	725	+	84	0	-56	4674
Q8IZY2-1#31	0	1	1	Q8IZY2-1	187	188	+	1	Q8IZY2-1	0	2146	ENST00000263094.11	227	6665	++	10	Q8IZY2-1#31	0	3	ENST00000263094.11	788	791	+	3	0	-2	4675
Q8IZY2-1#32	0	1	1	Q8IZY2-1	318	319	+	1	Q8IZY2-1	0	2146	ENST00000263094.11	227	6665	++	10	Q8IZY2-1#32	0	3	ENST00000263094.11	1181	1184	+	3	0	-2	4676
Q8IZY2-1#33	0	1	1	Q8IZY2-1	394	395	+	1	Q8IZY2-1	0	2146	ENST00000263094.11	227	6665	++	10	Q8IZY2-1#33	0	3	ENST00000263094.11	1409	1412	+	3	0	-2	4677
Q8IZY2-1#34	0	1	1	Q8IZY2-1	462	463	+	1	Q8IZY2-1	0	2146	ENST00000263094.11	227	6665	++	10	Q8IZY2-1#34	0	3	ENST00000263094.11	1613	1616	+	3	0	-2	4678
Q8IZY2-1#35	0	1	1	Q8IZY2-1	675	676	+	1	Q8IZY2-1	0	2146	ENST00000263094.11	227	6665	++	10	Q8IZY2-1#35	0	3	ENST00000263094.11	2252	2255	+	3	0	-2	4679
Q8IZY2-1#36	0	1	1	Q8IZY2-1	717	718	+	1	Q8IZY2-1	0	2146	ENST00000263094.11	227	6665	++	10	Q8IZY2-1#36	0	3	ENST00000263094.11	2378	2381	+	3	0	-2	4680
Q8IZY2-1#37	0	1	1	Q8IZY2-1	879	880	+	1	Q8IZY2-1	843	1372	ENST00000435683.7	0	1601	++	86	Q8IZY2-1#37	0	3	ENST00000435683.7	108	111	+	3	0	-2	4681
Q8IZY2-1#37	0	1	1	Q8IZY2-1	879	880	+	1	Q8IZY2-1	0	2146	ENST00000263094.11	227	6665	++	10	Q8IZY2-1#37	0	3	ENST00000263094.11	2864	2867	+	3	0	-2	4682
Q8IZY2-1#38	0	1	1	Q8IZY2-1	1348	1349	+	1	Q8IZY2-1	843	1372	ENST00000435683.7	0	1601	++	86	Q8IZY2-1#38	0	3	ENST00000435683.7	1529	1532	+	3	0	-2	4683
Q8IZY2-1#38	0	1	1	Q8IZY2-1	1348	1349	+	1	Q8IZY2-1	0	2146	ENST00000263094.11	227	6665	++	10	Q8IZY2-1#38	0	3	ENST00000263094.11	4271	4274	+	3	0	-2	4684
Q8IZY2-1#39	0	1	1	Q8IZY2-1	1526	1527	+	1	Q8IZY2-1	0	2146	ENST00000263094.11	227	6665	++	10	Q8IZY2-1#39	0	3	ENST00000263094.11	4805	4808	+	3	0	-2	4685
Q8IZY2-1#40	0	1	1	Q8IZY2-1	1685	1686	+	1	Q8IZY2-1	1538	2146	ENST00000525073.6	1	1771	++	141	Q8IZY2-1#40	0	3	ENST00000525073.6	388	391	+	3	0	-2	4686
Q8IZY2-1#40	0	1	1	Q8IZY2-1	1685	1686	+	1	Q8IZY2-1	0	2146	ENST00000263094.11	227	6665	++	10	Q8IZY2-1#40	0	3	ENST00000263094.11	5282	5285	+	3	0	-2	4687
Q8IZY2-1#41	0	1	1	Q8IZY2-1	2044	2045	+	1	Q8IZY2-1	1859	2146	ENST00000612569.1	0	840	++	223	Q8IZY2-1#41	0	3	ENST00000612569.1	555	558	+	3	0	-2	4688
Q8IZY2-1#41	0	1	1	Q8IZY2-1	2044	2045	+	1	Q8IZY2-1	1538	2146	ENST00000525073.6	1	1771	++	141	Q8IZY2-1#41	0	3	ENST00000525073.6	1465	1468	+	3	0	-2	4689
Q8IZY2-1#41	0	1	1	Q8IZY2-1	2044	2045	+	1	Q8IZY2-1	0	2146	ENST00000263094.11	227	6665	++	10	Q8IZY2-1#41	0	3	ENST00000263094.11	6359	6362	+	3	0	-2	4690
Q8IZY2-1#42	0	1	1	Q8IZY2-1	1502	1503	+	1	Q8IZY2-1	0	2146	ENST00000263094.11	227	6665	++	10	Q8IZY2-1#42	0	3	ENST00000263094.11	4733	4736	+	3	0	-2	4691
Q8IZY2-1#43	0	1	1	Q8IZY2-1	1524	1525	+	1	Q8IZY2-1	0	2146	ENST00000263094.11	227	6665	++	10	Q8IZY2-1#43	0	3	ENST00000263094.11	4799	4802	+	3	0	-2	4692
Q8N726-1#0	0	132	132	Q8N726-1	0	132	+	132	Q8N726-1	0	132	ENST00000579755.2	61	457	++	188	Q8N726-1#0	0	396	ENST00000579755.2	61	457	+	396	0	-264	4693
Q8N726-1#0	0	132	132	Q8N726-1	0	132	+	132	Q8N726-1	0	132	ENST00000530628.2	80	476	++	147	Q8N726-1#0	0	396	ENST00000530628.2	80	476	+	396	0	-264	4694
Q8N726-1#1	0	64	64	Q8N726-1	0	64	+	64	Q8N726-1	0	132	ENST00000579755.2	61	457	++	188	Q8N726-1#1	0	192	ENST00000579755.2	61	253	+	192	0	-128	4695
Q8N726-1#1	0	64	64	Q8N726-1	0	64	+	64	Q8N726-1	0	132	ENST00000530628.2	80	476	++	147	Q8N726-1#1	0	192	ENST00000530628.2	80	272	+	192	0	-128	4696
Q8N726-1#2	0	77	77	Q8N726-1	55	132	+	77	Q8N726-1	0	132	ENST00000579755.2	61	457	++	188	Q8N726-1#2	0	231	ENST00000579755.2	226	457	+	231	0	-154	4697
Q8N726-1#2	0	77	77	Q8N726-1	55	132	+	77	Q8N726-1	0	132	ENST00000530628.2	80	476	++	147	Q8N726-1#2	0	231	ENST00000530628.2	245	476	+	231	0	-154	4698
Q8N726-1#3	0	47	47	Q8N726-1	0	47	+	47	Q8N726-1	0	132	ENST00000579755.2	61	457	++	188	Q8N726-1#3	0	141	ENST00000579755.2	61	202	+	141	0	-94	4699
Q8N726-1#3	0	47	47	Q8N726-1	0	47	+	47	Q8N726-1	0	132	ENST00000530628.2	80	476	++	147	Q8N726-1#3	0	141	ENST00000530628.2	80	221	+	141	0	-94	4700
Q8N726-1#4	0	1	1	Q8N726-1	16	17	+	1	Q8N726-1	0	132	ENST00000579755.2	61	457	++	188	Q8N726-1#4	0	3	ENST00000579755.2	109	112	+	3	0	-2	4701
Q8N726-1#4	0	1	1	Q8N726-1	16	17	+	1	Q8N726-1	0	132	ENST00000530628.2	80	476	++	147	Q8N726-1#4	0	3	ENST00000530628.2	128	131	+	3	0	-2	4702
Q8N726-1#5	0	1	1	Q8N726-1	105	106	+	1	Q8N726-1	0	132	ENST00000579755.2	61	457	++	188	Q8N726-1#5	0	3	ENST00000579755.2	376	379	+	3	0	-2	4703
Q8N726-1#5	0	1	1	Q8N726-1	105	106	+	1	Q8N726-1	0	132	ENST00000530628.2	80	476	++	147	Q8N726-1#5	0	3	ENST00000530628.2	395	398	+	3	0	-2	4704
Q8N726-1#6	0	1	1	Q8N726-1	112	113	+	1	Q8N726-1	0	132	ENST00000579755.2	61	457	++	188	Q8N726-1#6	0	3	ENST00000579755.2	397	400	+	3	0	-2	4705
Q8N726-1#6	0	1	1	Q8N726-1	112	113	+	1	Q8N726-1	0	132	ENST00000530628.2	80	476	++	147	Q8N726-1#6	0	3	ENST00000530628.2	416	419	+	3	0	-2	4706
Q8N726-1#7	0	1	1	Q8N726-1	115	116	+	1	Q8N726-1	0	132	ENST00000579755.2	61	457	++	188	Q8N726-1#7	0	3	ENST00000579755.2	406	409	+	3	0	-2	4707
Q8N726-1#7	0	1	1	Q8N726-1	115	116	+	1	Q8N726-1	0	132	ENST00000530628.2	80	476	++	147	Q8N726-1#7	0	3	ENST00000530628.2	425	428	+	3	0	-2	4708
Q8N726-1#8	0	3	3	Q8N726-1	27	30	+	3	Q8N726-1	0	132	ENST00000579755.2	61	457	++	188	Q8N726-1#8	0	9	ENST00000579755.2	142	151	+	9	0	-6	4709
Q8N726-1#8	0	3	3	Q8N726-1	27	30	+	3	Q8N726-1	0	132	ENST00000530628.2	80	476	++	147	Q8N726-1#8	0	9	ENST00000530628.2	161	170	+	9	0	-6	4710
Q8N726-1#9	0	1	1	Q8N726-1	93	94	+	1	Q8N726-1	0	132	ENST00000579755.2	61	457	++	188	Q8N726-1#9	0	3	ENST00000579755.2	340	343	+	3	0	-2	4711
Q8N726-1#9	0	1	1	Q8N726-1	93	94	+	1	Q8N726-1	0	132	ENST00000530628.2	80	476	++	147	Q8N726-1#9	0	3	ENST00000530628.2	359	362	+	3	0	-2	4712
Q9Y215-1#0	0	22	22	Q9Y215-1	0	22	+	22	Q9Y215-1	0	271	ENST00000681097.1	91	904	++	265	Q9Y215-1#0	0	66	ENST00000681097.1	91	157	+	66	0	-44	4713
Q9Y215-1#0	0	22	22	Q9Y215-1	0	22	+	22	Q9Y215-1	0	73	ENST00000679838.1	95	314	++	264	Q9Y215-1#0	0	66	ENST00000679838.1	95	161	+	66	0	-44	4714
Q9Y215-1#0	0	22	22	Q9Y215-1	0	22	+	22	Q9Y215-1	0	455	ENST00000603808.5	126	1494	++	218	Q9Y215-1#0	0	66	ENST00000603808.5	126	192	+	66	0	-44	4715
Q9Y215-1#0	0	22	22	Q9Y215-1	0	22	+	22	Q9Y215-1	0	455	ENST00000383788.10	81	1446	++	56	Q9Y215-1#0	0	66	ENST00000383788.10	81	147	+	66	0	-44	4716
Q9Y215-1#0	0	22	22	Q9Y215-1	0	22	+	22	Q9Y215-1	0	455	ENST00000383786.9	111	1374	++	55	Q9Y215-1#0	0	66	ENST00000383786.9	111	177	+	66	0	-44	4717
Q9Y215-1#1	0	433	433	Q9Y215-1	22	455	+	433	Q9Y215-1	0	271	ENST00000681097.1	91	904	++	265	Q9Y215-1#1	0	747	ENST00000681097.1	157	904	+	747	0	-314	4718
Q9Y215-1#1	0	433	433	Q9Y215-1	22	455	+	433	Q9Y215-1	0	73	ENST00000679838.1	95	314	++	264	Q9Y215-1#1	0	153	ENST00000679838.1	161	314	+	153	0	280	4719
Q9Y215-1#1	0	433	433	Q9Y215-1	22	455	+	433	Q9Y215-1	35	251	ENST00000605797.1	36	582	++	219	Q9Y215-1#1	39	687	ENST00000605797.1	36	582	+	546	39	-254	4720
Q9Y215-1#1	0	433	433	Q9Y215-1	22	455	+	433	Q9Y215-1	0	455	ENST00000603808.5	126	1494	++	218	Q9Y215-1#1	0	1299	ENST00000603808.5	192	1494	+	1299	0	-866	4721
Q9Y215-1#1	0	433	433	Q9Y215-1	22	455	+	433	Q9Y215-1	0	455	ENST00000383788.10	81	1446	++	56	Q9Y215-1#1	0	1299	ENST00000383788.10	147	1446	+	1299	0	-866	4722
Q9Y215-1#1	0	433	433	Q9Y215-1	22	455	+	433	Q9Y215-1	0	455	ENST00000383786.9	111	1374	++	55	Q9Y215-1#1	0	1299	ENST00000383786.9	177	1374	+	1197	0	-866	4723
Q9Y215-1#1	0	433	433	Q9Y215-1	22	455	+	433	Q9Y215-1	35	455	ENST00000383781.8	360	1620	++	54	Q9Y215-1#1	39	1299	ENST00000383781.8	360	1620	+	1260	39	-866	4724
Q9Y215-1#2	0	174	174	Q9Y215-1	95	269	+	174	Q9Y215-1	0	271	ENST00000681097.1	91	904	++	265	Q9Y215-1#2	0	522	ENST00000681097.1	376	898	+	522	0	-348	4725
Q9Y215-1#2	0	174	174	Q9Y215-1	95	269	+	174	Q9Y215-1	35	251	ENST00000605797.1	36	582	++	219	Q9Y215-1#2	36	468	ENST00000605797.1	150	582	+	432	36	-294	4726
Q9Y215-1#2	0	174	174	Q9Y215-1	95	269	+	174	Q9Y215-1	0	455	ENST00000603808.5	126	1494	++	218	Q9Y215-1#2	0	522	ENST00000603808.5	411	933	+	522	0	-348	4727
Q9Y215-1#2	0	174	174	Q9Y215-1	95	269	+	174	Q9Y215-1	0	455	ENST00000383788.10	81	1446	++	56	Q9Y215-1#2	0	522	ENST00000383788.10	366	888	+	522	0	-348	4728
Q9Y215-1#2	0	174	174	Q9Y215-1	95	269	+	174	Q9Y215-1	0	455	ENST00000383786.9	111	1374	++	55	Q9Y215-1#2	36	522	ENST00000383786.9	330	816	+	486	36	-348	4729
Q9Y215-1#2	0	174	174	Q9Y215-1	95	269	+	174	Q9Y215-1	35	455	ENST00000383781.8	360	1620	++	54	Q9Y215-1#2	0	522	ENST00000383781.8	540	1062	+	522	0	-348	4730
Q9Y215-1#3	0	15	15	Q9Y215-1	276	291	+	15	Q9Y215-1	0	455	ENST00000603808.5	126	1494	++	218	Q9Y215-1#3	0	45	ENST00000603808.5	954	999	+	45	0	-30	4731
Q9Y215-1#3	0	15	15	Q9Y215-1	276	291	+	15	Q9Y215-1	0	455	ENST00000383788.10	81	1446	++	56	Q9Y215-1#3	0	45	ENST00000383788.10	909	954	+	45	0	-30	4732
Q9Y215-1#3	0	15	15	Q9Y215-1	276	291	+	15	Q9Y215-1	0	455	ENST00000383786.9	111	1374	++	55	Q9Y215-1#3	0	45	ENST00000383786.9	837	882	+	45	0	-30	4733
Q9Y215-1#3	0	15	15	Q9Y215-1	276	291	+	15	Q9Y215-1	35	455	ENST00000383781.8	360	1620	++	54	Q9Y215-1#3	0	45	ENST00000383781.8	1083	1128	+	45	0	-30	4734
Q9Y215-1#4	0	17	17	Q9Y215-1	50	67	+	17	Q9Y215-1	0	271	ENST00000681097.1	91	904	++	265	Q9Y215-1#4	0	51	ENST00000681097.1	241	292	+	51	0	-34	4735
Q9Y215-1#4	0	17	17	Q9Y215-1	50	67	+	17	Q9Y215-1	0	73	ENST00000679838.1	95	314	++	264	Q9Y215-1#4	0	51	ENST00000679838.1	245	296	+	51	0	-34	4736
Q9Y215-1#4	0	17	17	Q9Y215-1	50	67	+	17	Q9Y215-1	35	251	ENST00000605797.1	36	582	++	219	Q9Y215-1#4	0	51	ENST00000605797.1	81	132	+	51	0	-34	4737
Q9Y215-1#4	0	17	17	Q9Y215-1	50	67	+	17	Q9Y215-1	0	455	ENST00000603808.5	126	1494	++	218	Q9Y215-1#4	0	51	ENST00000603808.5	276	327	+	51	0	-34	4738
Q9Y215-1#4	0	17	17	Q9Y215-1	50	67	+	17	Q9Y215-1	0	455	ENST00000383788.10	81	1446	++	56	Q9Y215-1#4	0	51	ENST00000383788.10	231	282	+	51	0	-34	4739
Q9Y215-1#4	0	17	17	Q9Y215-1	50	67	+	17	Q9Y215-1	0	455	ENST00000383786.9	111	1374	++	55	Q9Y215-1#4	0	51	ENST00000383786.9	261	312	+	51	0	-34	4740
Q9Y215-1#4	0	17	17	Q9Y215-1	50	67	+	17	Q9Y215-1	35	455	ENST00000383781.8	360	1620	++	54	Q9Y215-1#4	0	51	ENST00000383781.8	405	456	+	51	0	-34	4741
Q9Y215-1#5	0	193	193	Q9Y215-1	89	282	+	193	Q9Y215-1	0	271	ENST00000681097.1	91	904	++	265	Q9Y215-1#5	0	546	ENST00000681097.1	358	904	+	546	0	-353	4742
Q9Y215-1#5	0	193	193	Q9Y215-1	89	282	+	193	Q9Y215-1	35	251	ENST00000605797.1	36	582	++	219	Q9Y215-1#5	54	486	ENST00000605797.1	150	582	+	432	54	-293	4743
Q9Y215-1#5	0	193	193	Q9Y215-1	89	282	+	193	Q9Y215-1	0	455	ENST00000603808.5	126	1494	++	218	Q9Y215-1#5	0	579	ENST00000603808.5	393	972	+	579	0	-386	4744
Q9Y215-1#5	0	193	193	Q9Y215-1	89	282	+	193	Q9Y215-1	0	455	ENST00000383788.10	81	1446	++	56	Q9Y215-1#5	0	579	ENST00000383788.10	348	927	+	579	0	-386	4745
Q9Y215-1#5	0	193	193	Q9Y215-1	89	282	+	193	Q9Y215-1	0	455	ENST00000383786.9	111	1374	++	55	Q9Y215-1#5	54	579	ENST00000383786.9	330	855	+	525	54	-386	4746
Q9Y215-1#5	0	193	193	Q9Y215-1	89	282	+	193	Q9Y215-1	35	455	ENST00000383781.8	360	1620	++	54	Q9Y215-1#5	0	579	ENST00000383781.8	522	1101	+	579	0	-386	4747
Q9Y215-1#6	0	4	4	Q9Y215-1	129	133	+	4	Q9Y215-1	0	271	ENST00000681097.1	91	904	++	265	Q9Y215-1#6	0	12	ENST00000681097.1	478	490	+	12	0	-8	4748
Q9Y215-1#6	0	4	4	Q9Y215-1	129	133	+	4	Q9Y215-1	35	251	ENST00000605797.1	36	582	++	219	Q9Y215-1#6	0	12	ENST00000605797.1	216	228	+	12	0	-8	4749
Q9Y215-1#6	0	4	4	Q9Y215-1	129	133	+	4	Q9Y215-1	0	455	ENST00000603808.5	126	1494	++	218	Q9Y215-1#6	0	12	ENST00000603808.5	513	525	+	12	0	-8	4750
Q9Y215-1#6	0	4	4	Q9Y215-1	129	133	+	4	Q9Y215-1	0	455	ENST00000383788.10	81	1446	++	56	Q9Y215-1#6	0	12	ENST00000383788.10	468	480	+	12	0	-8	4751
Q9Y215-1#6	0	4	4	Q9Y215-1	129	133	+	4	Q9Y215-1	0	455	ENST00000383786.9	111	1374	++	55	Q9Y215-1#6	0	12	ENST00000383786.9	396	408	+	12	0	-8	4752
Q9Y215-1#6	0	4	4	Q9Y215-1	129	133	+	4	Q9Y215-1	35	455	ENST00000383781.8	360	1620	++	54	Q9Y215-1#6	0	12	ENST00000383781.8	642	654	+	12	0	-8	4753
Q9Y215-1#7	0	4	4	Q9Y215-1	234	238	+	4	Q9Y215-1	0	271	ENST00000681097.1	91	904	++	265	Q9Y215-1#7	0	12	ENST00000681097.1	793	805	+	12	0	-8	4754
Q9Y215-1#7	0	4	4	Q9Y215-1	234	238	+	4	Q9Y215-1	35	251	ENST00000605797.1	36	582	++	219	Q9Y215-1#7	0	12	ENST00000605797.1	531	543	+	12	0	-8	4755
Q9Y215-1#7	0	4	4	Q9Y215-1	234	238	+	4	Q9Y215-1	0	455	ENST00000603808.5	126	1494	++	218	Q9Y215-1#7	0	12	ENST00000603808.5	828	840	+	12	0	-8	4756
Q9Y215-1#7	0	4	4	Q9Y215-1	234	238	+	4	Q9Y215-1	0	455	ENST00000383788.10	81	1446	++	56	Q9Y215-1#7	0	12	ENST00000383788.10	783	795	+	12	0	-8	4757
Q9Y215-1#7	0	4	4	Q9Y215-1	234	238	+	4	Q9Y215-1	0	455	ENST00000383786.9	111	1374	++	55	Q9Y215-1#7	0	12	ENST00000383786.9	711	723	+	12	0	-8	4758
Q9Y215-1#7	0	4	4	Q9Y215-1	234	238	+	4	Q9Y215-1	35	455	ENST00000383781.8	360	1620	++	54	Q9Y215-1#7	0	12	ENST00000383781.8	957	969	+	12	0	-8	4759
Q9Y215-1#8	0	18	18	Q9Y215-1	132	150	+	18	Q9Y215-1	0	271	ENST00000681097.1	91	904	++	265	Q9Y215-1#8	0	54	ENST00000681097.1	487	541	+	54	0	-36	4760
Q9Y215-1#8	0	18	18	Q9Y215-1	132	150	+	18	Q9Y215-1	35	251	ENST00000605797.1	36	582	++	219	Q9Y215-1#8	0	54	ENST00000605797.1	225	279	+	54	0	-36	4761
Q9Y215-1#8	0	18	18	Q9Y215-1	132	150	+	18	Q9Y215-1	0	455	ENST00000603808.5	126	1494	++	218	Q9Y215-1#8	0	54	ENST00000603808.5	522	576	+	54	0	-36	4762
Q9Y215-1#8	0	18	18	Q9Y215-1	132	150	+	18	Q9Y215-1	0	455	ENST00000383788.10	81	1446	++	56	Q9Y215-1#8	0	54	ENST00000383788.10	477	531	+	54	0	-36	4763
Q9Y215-1#8	0	18	18	Q9Y215-1	132	150	+	18	Q9Y215-1	0	455	ENST00000383786.9	111	1374	++	55	Q9Y215-1#8	0	54	ENST00000383786.9	405	459	+	54	0	-36	4764
Q9Y215-1#8	0	18	18	Q9Y215-1	132	150	+	18	Q9Y215-1	35	455	ENST00000383781.8	360	1620	++	54	Q9Y215-1#8	0	54	ENST00000383781.8	651	705	+	54	0	-36	4765
Q9Y215-1#9	0	15	15	Q9Y215-1	182	197	+	15	Q9Y215-1	0	271	ENST00000681097.1	91	904	++	265	Q9Y215-1#9	0	45	ENST00000681097.1	637	682	+	45	0	-30	4766
Q9Y215-1#9	0	15	15	Q9Y215-1	182	197	+	15	Q9Y215-1	35	251	ENST00000605797.1	36	582	++	219	Q9Y215-1#9	0	45	ENST00000605797.1	375	420	+	45	0	-30	4767
Q9Y215-1#9	0	15	15	Q9Y215-1	182	197	+	15	Q9Y215-1	0	455	ENST00000603808.5	126	1494	++	218	Q9Y215-1#9	0	45	ENST00000603808.5	672	717	+	45	0	-30	4768
Q9Y215-1#9	0	15	15	Q9Y215-1	182	197	+	15	Q9Y215-1	0	455	ENST00000383788.10	81	1446	++	56	Q9Y215-1#9	0	45	ENST00000383788.10	627	672	+	45	0	-30	4769
Q9Y215-1#9	0	15	15	Q9Y215-1	182	197	+	15	Q9Y215-1	0	455	ENST00000383786.9	111	1374	++	55	Q9Y215-1#9	0	45	ENST00000383786.9	555	600	+	45	0	-30	4770
Q9Y215-1#9	0	15	15	Q9Y215-1	182	197	+	15	Q9Y215-1	35	455	ENST00000383781.8	360	1620	++	54	Q9Y215-1#9	0	45	ENST00000383781.8	801	846	+	45	0	-30	4771
Q9Y215-1#10	0	21	21	Q9Y215-1	252	273	+	21	Q9Y215-1	0	271	ENST00000681097.1	91	904	++	265	Q9Y215-1#10	0	57	ENST00000681097.1	847	904	+	57	0	-36	4772
Q9Y215-1#10	0	21	21	Q9Y215-1	252	273	+	21	Q9Y215-1	0	455	ENST00000603808.5	126	1494	++	218	Q9Y215-1#10	0	63	ENST00000603808.5	882	945	+	63	0	-42	4773
Q9Y215-1#10	0	21	21	Q9Y215-1	252	273	+	21	Q9Y215-1	0	455	ENST00000383788.10	81	1446	++	56	Q9Y215-1#10	0	63	ENST00000383788.10	837	900	+	63	0	-42	4774
Q9Y215-1#10	0	21	21	Q9Y215-1	252	273	+	21	Q9Y215-1	0	455	ENST00000383786.9	111	1374	++	55	Q9Y215-1#10	0	63	ENST00000383786.9	765	828	+	63	0	-42	4775
Q9Y215-1#10	0	21	21	Q9Y215-1	252	273	+	21	Q9Y215-1	35	455	ENST00000383781.8	360	1620	++	54	Q9Y215-1#10	0	63	ENST00000383781.8	1011	1074	+	63	0	-42	4776
Q9Y215-1#11	0	1	1	Q9Y215-1	50	51	+	1	Q9Y215-1	0	271	ENST00000681097.1	91	904	++	265	Q9Y215-1#11	0	3	ENST00000681097.1	241	244	+	3	0	-2	4777
Q9Y215-1#11	0	1	1	Q9Y215-1	50	51	+	1	Q9Y215-1	0	73	ENST00000679838.1	95	314	++	264	Q9Y215-1#11	0	3	ENST00000679838.1	245	248	+	3	0	-2	4778
Q9Y215-1#11	0	1	1	Q9Y215-1	50	51	+	1	Q9Y215-1	35	251	ENST00000605797.1	36	582	++	219	Q9Y215-1#11	0	3	ENST00000605797.1	81	84	+	3	0	-2	4779
Q9Y215-1#11	0	1	1	Q9Y215-1	50	51	+	1	Q9Y215-1	0	455	ENST00000603808.5	126	1494	++	218	Q9Y215-1#11	0	3	ENST00000603808.5	276	279	+	3	0	-2	4780
Q9Y215-1#11	0	1	1	Q9Y215-1	50	51	+	1	Q9Y215-1	0	455	ENST00000383788.10	81	1446	++	56	Q9Y215-1#11	0	3	ENST00000383788.10	231	234	+	3	0	-2	4781
Q9Y215-1#11	0	1	1	Q9Y215-1	50	51	+	1	Q9Y215-1	0	455	ENST00000383786.9	111	1374	++	55	Q9Y215-1#11	0	3	ENST00000383786.9	261	264	+	3	0	-2	4782
Q9Y215-1#11	0	1	1	Q9Y215-1	50	51	+	1	Q9Y215-1	35	455	ENST00000383781.8	360	1620	++	54	Q9Y215-1#11	0	3	ENST00000383781.8	405	408	+	3	0	-2	4783
Q9Y215-1#12	0	1	1	Q9Y215-1	51	52	+	1	Q9Y215-1	0	271	ENST00000681097.1	91	904	++	265	Q9Y215-1#12	0	3	ENST00000681097.1	244	247	+	3	0	-2	4784
Q9Y215-1#12	0	1	1	Q9Y215-1	51	52	+	1	Q9Y215-1	0	73	ENST00000679838.1	95	314	++	264	Q9Y215-1#12	0	3	ENST00000679838.1	248	251	+	3	0	-2	4785
Q9Y215-1#12	0	1	1	Q9Y215-1	51	52	+	1	Q9Y215-1	35	251	ENST00000605797.1	36	582	++	219	Q9Y215-1#12	0	3	ENST00000605797.1	84	87	+	3	0	-2	4786
Q9Y215-1#12	0	1	1	Q9Y215-1	51	52	+	1	Q9Y215-1	0	455	ENST00000603808.5	126	1494	++	218	Q9Y215-1#12	0	3	ENST00000603808.5	279	282	+	3	0	-2	4787
Q9Y215-1#12	0	1	1	Q9Y215-1	51	52	+	1	Q9Y215-1	0	455	ENST00000383788.10	81	1446	++	56	Q9Y215-1#12	0	3	ENST00000383788.10	234	237	+	3	0	-2	4788
Q9Y215-1#12	0	1	1	Q9Y215-1	51	52	+	1	Q9Y215-1	0	455	ENST00000383786.9	111	1374	++	55	Q9Y215-1#12	0	3	ENST00000383786.9	264	267	+	3	0	-2	4789
Q9Y215-1#12	0	1	1	Q9Y215-1	51	52	+	1	Q9Y215-1	35	455	ENST00000383781.8	360	1620	++	54	Q9Y215-1#12	0	3	ENST00000383781.8	408	411	+	3	0	-2	4790
Q9Y215-1#13	0	1	1	Q9Y215-1	92	93	+	1	Q9Y215-1	0	271	ENST00000681097.1	91	904	++	265	Q9Y215-1#13	0	3	ENST00000681097.1	367	370	+	3	0	-2	4791
Q9Y215-1#13	0	1	1	Q9Y215-1	92	93	+	1	Q9Y215-1	0	455	ENST00000603808.5	126	1494	++	218	Q9Y215-1#13	0	3	ENST00000603808.5	402	405	+	3	0	-2	4792
Q9Y215-1#13	0	1	1	Q9Y215-1	92	93	+	1	Q9Y215-1	0	455	ENST00000383788.10	81	1446	++	56	Q9Y215-1#13	0	3	ENST00000383788.10	357	360	+	3	0	-2	4793
Q9Y215-1#13	0	1	1	Q9Y215-1	92	93	+	1	Q9Y215-1	35	455	ENST00000383781.8	360	1620	++	54	Q9Y215-1#13	0	3	ENST00000383781.8	531	534	+	3	0	-2	4794
Q9Y215-1#14	0	1	1	Q9Y215-1	290	291	+	1	Q9Y215-1	0	455	ENST00000603808.5	126	1494	++	218	Q9Y215-1#14	0	3	ENST00000603808.5	996	999	+	3	0	-2	4795
Q9Y215-1#14	0	1	1	Q9Y215-1	290	291	+	1	Q9Y215-1	0	455	ENST00000383788.10	81	1446	++	56	Q9Y215-1#14	0	3	ENST00000383788.10	951	954	+	3	0	-2	4796
Q9Y215-1#14	0	1	1	Q9Y215-1	290	291	+	1	Q9Y215-1	0	455	ENST00000383786.9	111	1374	++	55	Q9Y215-1#14	0	3	ENST00000383786.9	879	882	+	3	0	-2	4797
Q9Y215-1#14	0	1	1	Q9Y215-1	290	291	+	1	Q9Y215-1	35	455	ENST00000383781.8	360	1620	++	54	Q9Y215-1#14	0	3	ENST00000383781.8	1125	1128	+	3	0	-2	4798
Q9Y215-1#15	0	1	1	Q9Y215-1	292	293	+	1	Q9Y215-1	0	455	ENST00000603808.5	126	1494	++	218	Q9Y215-1#15	0	3	ENST00000603808.5	1002	1005	+	3	0	-2	4799
Q9Y215-1#15	0	1	1	Q9Y215-1	292	293	+	1	Q9Y215-1	0	455	ENST00000383788.10	81	1446	++	56	Q9Y215-1#15	0	3	ENST00000383788.10	957	960	+	3	0	-2	4800
Q9Y215-1#15	0	1	1	Q9Y215-1	292	293	+	1	Q9Y215-1	0	455	ENST00000383786.9	111	1374	++	55	Q9Y215-1#15	0	3	ENST00000383786.9	885	888	+	3	0	-2	4801
Q9Y215-1#15	0	1	1	Q9Y215-1	292	293	+	1	Q9Y215-1	35	455	ENST00000383781.8	360	1620	++	54	Q9Y215-1#15	0	3	ENST00000383781.8	1131	1134	+	3	0	-2	4802
Q9Y215-1#16	0	35	35	Q9Y215-1	0	35	+	35	Q9Y215-1	0	271	ENST00000681097.1	91	904	++	265	Q9Y215-1#16	0	105	ENST00000681097.1	91	196	+	105	0	-70	4803
Q9Y215-1#16	0	35	35	Q9Y215-1	0	35	+	35	Q9Y215-1	0	73	ENST00000679838.1	95	314	++	264	Q9Y215-1#16	0	105	ENST00000679838.1	95	200	+	105	0	-70	4804
Q9Y215-1#16	0	35	35	Q9Y215-1	0	35	+	35	Q9Y215-1	0	455	ENST00000603808.5	126	1494	++	218	Q9Y215-1#16	0	105	ENST00000603808.5	126	231	+	105	0	-70	4805
Q9Y215-1#16	0	35	35	Q9Y215-1	0	35	+	35	Q9Y215-1	0	455	ENST00000383788.10	81	1446	++	56	Q9Y215-1#16	0	105	ENST00000383788.10	81	186	+	105	0	-70	4806
Q9Y215-1#16	0	35	35	Q9Y215-1	0	35	+	35	Q9Y215-1	0	455	ENST00000383786.9	111	1374	++	55	Q9Y215-1#16	0	105	ENST00000383786.9	111	216	+	105	0	-70	4807
Q9Y215-1#17	0	4	4	Q9Y215-1	72	76	+	4	Q9Y215-1	0	271	ENST00000681097.1	91	904	++	265	Q9Y215-1#17	0	12	ENST00000681097.1	307	319	+	12	0	-8	4808
Q9Y215-1#17	0	4	4	Q9Y215-1	72	76	+	4	Q9Y215-1	0	73	ENST00000679838.1	95	314	++	264	Q9Y215-1#17	0	3	ENST00000679838.1	311	314	+	3	0	1	4809
Q9Y215-1#17	0	4	4	Q9Y215-1	72	76	+	4	Q9Y215-1	35	251	ENST00000605797.1	36	582	++	219	Q9Y215-1#17	0	3	ENST00000605797.1	147	150	+	3	0	1	4810
Q9Y215-1#17	0	4	4	Q9Y215-1	72	76	+	4	Q9Y215-1	0	455	ENST00000603808.5	126	1494	++	218	Q9Y215-1#17	0	12	ENST00000603808.5	342	354	+	12	0	-8	4811
Q9Y215-1#17	0	4	4	Q9Y215-1	72	76	+	4	Q9Y215-1	0	455	ENST00000383788.10	81	1446	++	56	Q9Y215-1#17	0	12	ENST00000383788.10	297	309	+	12	0	-8	4812
Q9Y215-1#17	0	4	4	Q9Y215-1	72	76	+	4	Q9Y215-1	0	455	ENST00000383786.9	111	1374	++	55	Q9Y215-1#17	0	3	ENST00000383786.9	327	330	+	3	0	1	4813
Q9Y215-1#17	0	4	4	Q9Y215-1	72	76	+	4	Q9Y215-1	35	455	ENST00000383781.8	360	1620	++	54	Q9Y215-1#17	0	12	ENST00000383781.8	471	483	+	12	0	-8	4814
Q9Y215-1#18	0	34	34	Q9Y215-1	73	107	+	34	Q9Y215-1	0	271	ENST00000681097.1	91	904	++	265	Q9Y215-1#18	0	102	ENST00000681097.1	310	412	+	102	0	-68	4815
Q9Y215-1#18	0	34	34	Q9Y215-1	73	107	+	34	Q9Y215-1	0	455	ENST00000603808.5	126	1494	++	218	Q9Y215-1#18	0	102	ENST00000603808.5	345	447	+	102	0	-68	4816
Q9Y215-1#18	0	34	34	Q9Y215-1	73	107	+	34	Q9Y215-1	0	455	ENST00000383788.10	81	1446	++	56	Q9Y215-1#18	0	102	ENST00000383788.10	300	402	+	102	0	-68	4817
Q9Y215-1#18	0	34	34	Q9Y215-1	73	107	+	34	Q9Y215-1	35	455	ENST00000383781.8	360	1620	++	54	Q9Y215-1#18	0	102	ENST00000383781.8	474	576	+	102	0	-68	4818
Q9Y215-1#19	0	9	9	Q9Y215-1	123	132	+	9	Q9Y215-1	0	271	ENST00000681097.1	91	904	++	265	Q9Y215-1#19	0	27	ENST00000681097.1	460	487	+	27	0	-18	4819
Q9Y215-1#19	0	9	9	Q9Y215-1	123	132	+	9	Q9Y215-1	35	251	ENST00000605797.1	36	582	++	219	Q9Y215-1#19	0	27	ENST00000605797.1	198	225	+	27	0	-18	4820
Q9Y215-1#19	0	9	9	Q9Y215-1	123	132	+	9	Q9Y215-1	0	455	ENST00000603808.5	126	1494	++	218	Q9Y215-1#19	0	27	ENST00000603808.5	495	522	+	27	0	-18	4821
Q9Y215-1#19	0	9	9	Q9Y215-1	123	132	+	9	Q9Y215-1	0	455	ENST00000383788.10	81	1446	++	56	Q9Y215-1#19	0	27	ENST00000383788.10	450	477	+	27	0	-18	4822
Q9Y215-1#19	0	9	9	Q9Y215-1	123	132	+	9	Q9Y215-1	0	455	ENST00000383786.9	111	1374	++	55	Q9Y215-1#19	0	27	ENST00000383786.9	378	405	+	27	0	-18	4823
Q9Y215-1#19	0	9	9	Q9Y215-1	123	132	+	9	Q9Y215-1	35	455	ENST00000383781.8	360	1620	++	54	Q9Y215-1#19	0	27	ENST00000383781.8	624	651	+	27	0	-18	4824
Q9Y215-1#20	0	52	52	Q9Y215-1	239	291	+	52	Q9Y215-1	0	271	ENST00000681097.1	91	904	++	265	Q9Y215-1#20	0	96	ENST00000681097.1	808	904	+	96	0	-44	4825
Q9Y215-1#20	0	52	52	Q9Y215-1	239	291	+	52	Q9Y215-1	35	251	ENST00000605797.1	36	582	++	219	Q9Y215-1#20	0	36	ENST00000605797.1	546	582	+	36	0	16	4826
Q9Y215-1#20	0	52	52	Q9Y215-1	239	291	+	52	Q9Y215-1	0	455	ENST00000603808.5	126	1494	++	218	Q9Y215-1#20	0	156	ENST00000603808.5	843	999	+	156	0	-104	4827
Q9Y215-1#20	0	52	52	Q9Y215-1	239	291	+	52	Q9Y215-1	0	455	ENST00000383788.10	81	1446	++	56	Q9Y215-1#20	0	156	ENST00000383788.10	798	954	+	156	0	-104	4828
Q9Y215-1#20	0	52	52	Q9Y215-1	239	291	+	52	Q9Y215-1	0	455	ENST00000383786.9	111	1374	++	55	Q9Y215-1#20	0	156	ENST00000383786.9	726	882	+	156	0	-104	4829
Q9Y215-1#20	0	52	52	Q9Y215-1	239	291	+	52	Q9Y215-1	35	455	ENST00000383781.8	360	1620	++	54	Q9Y215-1#20	0	156	ENST00000383781.8	972	1128	+	156	0	-104	4830
Q9Y215-1#21	0	10	10	Q9Y215-1	271	281	+	10	Q9Y215-1	0	455	ENST00000603808.5	126	1494	++	218	Q9Y215-1#21	0	30	ENST00000603808.5	939	969	+	30	0	-20	4831
Q9Y215-1#21	0	10	10	Q9Y215-1	271	281	+	10	Q9Y215-1	0	455	ENST00000383788.10	81	1446	++	56	Q9Y215-1#21	0	30	ENST00000383788.10	894	924	+	30	0	-20	4832
Q9Y215-1#21	0	10	10	Q9Y215-1	271	281	+	10	Q9Y215-1	0	455	ENST00000383786.9	111	1374	++	55	Q9Y215-1#21	0	30	ENST00000383786.9	822	852	+	30	0	-20	4833
Q9Y215-1#21	0	10	10	Q9Y215-1	271	281	+	10	Q9Y215-1	35	455	ENST00000383781.8	360	1620	++	54	Q9Y215-1#21	0	30	ENST00000383781.8	1068	1098	+	30	0	-20	4834
Q9Y215-1#22	0	57	57	Q9Y215-1	272	329	+	57	Q9Y215-1	0	455	ENST00000603808.5	126	1494	++	218	Q9Y215-1#22	0	171	ENST00000603808.5	942	1113	+	171	0	-114	4835
Q9Y215-1#22	0	57	57	Q9Y215-1	272	329	+	57	Q9Y215-1	0	455	ENST00000383788.10	81	1446	++	56	Q9Y215-1#22	0	171	ENST00000383788.10	897	1068	+	171	0	-114	4836
Q9Y215-1#22	0	57	57	Q9Y215-1	272	329	+	57	Q9Y215-1	0	455	ENST00000383786.9	111	1374	++	55	Q9Y215-1#22	0	171	ENST00000383786.9	825	996	+	171	0	-114	4837
Q9Y215-1#22	0	57	57	Q9Y215-1	272	329	+	57	Q9Y215-1	35	455	ENST00000383781.8	360	1620	++	54	Q9Y215-1#22	0	171	ENST00000383781.8	1071	1242	+	171	0	-114	4838
Q9Y215-1#23	0	174	174	Q9Y215-1	281	455	+	174	Q9Y215-1	0	455	ENST00000603808.5	126	1494	++	218	Q9Y215-1#23	0	522	ENST00000603808.5	969	1494	+	522	0	-348	4839
Q9Y215-1#23	0	174	174	Q9Y215-1	281	455	+	174	Q9Y215-1	0	455	ENST00000383788.10	81	1446	++	56	Q9Y215-1#23	0	522	ENST00000383788.10	924	1446	+	522	0	-348	4840
Q9Y215-1#23	0	174	174	Q9Y215-1	281	455	+	174	Q9Y215-1	0	455	ENST00000383786.9	111	1374	++	55	Q9Y215-1#23	0	522	ENST00000383786.9	852	1374	+	522	0	-348	4841
Q9Y215-1#23	0	174	174	Q9Y215-1	281	455	+	174	Q9Y215-1	35	455	ENST00000383781.8	360	1620	++	54	Q9Y215-1#23	0	522	ENST00000383781.8	1098	1620	+	522	0	-348	4842
Q9Y215-1#24	0	164	164	Q9Y215-1	291	455	+	164	Q9Y215-1	0	455	ENST00000603808.5	126	1494	++	218	Q9Y215-1#24	0	492	ENST00000603808.5	999	1494	+	492	0	-328	4843
Q9Y215-1#24	0	164	164	Q9Y215-1	291	455	+	164	Q9Y215-1	0	455	ENST00000383788.10	81	1446	++	56	Q9Y215-1#24	0	492	ENST00000383788.10	954	1446	+	492	0	-328	4844
Q9Y215-1#24	0	164	164	Q9Y215-1	291	455	+	164	Q9Y215-1	0	455	ENST00000383786.9	111	1374	++	55	Q9Y215-1#24	0	492	ENST00000383786.9	882	1374	+	492	0	-328	4845
Q9Y215-1#24	0	164	164	Q9Y215-1	291	455	+	164	Q9Y215-1	35	455	ENST00000383781.8	360	1620	++	54	Q9Y215-1#24	0	492	ENST00000383781.8	1128	1620	+	492	0	-328	4846
Q9Y215-1#25	0	126	126	Q9Y215-1	329	455	+	126	Q9Y215-1	0	455	ENST00000603808.5	126	1494	++	218	Q9Y215-1#25	0	378	ENST00000603808.5	1113	1494	+	378	0	-252	4847
Q9Y215-1#25	0	126	126	Q9Y215-1	329	455	+	126	Q9Y215-1	0	455	ENST00000383788.10	81	1446	++	56	Q9Y215-1#25	0	378	ENST00000383788.10	1068	1446	+	378	0	-252	4848
Q9Y215-1#25	0	126	126	Q9Y215-1	329	455	+	126	Q9Y215-1	0	455	ENST00000383786.9	111	1374	++	55	Q9Y215-1#25	0	378	ENST00000383786.9	996	1374	+	378	0	-252	4849
Q9Y215-1#25	0	126	126	Q9Y215-1	329	455	+	126	Q9Y215-1	35	455	ENST00000383781.8	360	1620	++	54	Q9Y215-1#25	0	378	ENST00000383781.8	1242	1620	+	378	0	-252	4850
Q9Y215-1#26	0	1	1	Q9Y215-1	58	59	+	1	Q9Y215-1	0	271	ENST00000681097.1	91	904	++	265	Q9Y215-1#26	0	3	ENST00000681097.1	265	268	+	3	0	-2	4851
Q9Y215-1#26	0	1	1	Q9Y215-1	58	59	+	1	Q9Y215-1	0	73	ENST00000679838.1	95	314	++	264	Q9Y215-1#26	0	3	ENST00000679838.1	269	272	+	3	0	-2	4852
Q9Y215-1#26	0	1	1	Q9Y215-1	58	59	+	1	Q9Y215-1	35	251	ENST00000605797.1	36	582	++	219	Q9Y215-1#26	0	3	ENST00000605797.1	105	108	+	3	0	-2	4853
Q9Y215-1#26	0	1	1	Q9Y215-1	58	59	+	1	Q9Y215-1	0	455	ENST00000603808.5	126	1494	++	218	Q9Y215-1#26	0	3	ENST00000603808.5	300	303	+	3	0	-2	4854
Q9Y215-1#26	0	1	1	Q9Y215-1	58	59	+	1	Q9Y215-1	0	455	ENST00000383788.10	81	1446	++	56	Q9Y215-1#26	0	3	ENST00000383788.10	255	258	+	3	0	-2	4855
Q9Y215-1#26	0	1	1	Q9Y215-1	58	59	+	1	Q9Y215-1	0	455	ENST00000383786.9	111	1374	++	55	Q9Y215-1#26	0	3	ENST00000383786.9	285	288	+	3	0	-2	4856
Q9Y215-1#26	0	1	1	Q9Y215-1	58	59	+	1	Q9Y215-1	35	455	ENST00000383781.8	360	1620	++	54	Q9Y215-1#26	0	3	ENST00000383781.8	429	432	+	3	0	-2	4857
Q9Y215-1#27	0	1	1	Q9Y215-1	311	312	+	1	Q9Y215-1	0	455	ENST00000603808.5	126	1494	++	218	Q9Y215-1#27	0	3	ENST00000603808.5	1059	1062	+	3	0	-2	4858
Q9Y215-1#27	0	1	1	Q9Y215-1	311	312	+	1	Q9Y215-1	0	455	ENST00000383788.10	81	1446	++	56	Q9Y215-1#27	0	3	ENST00000383788.10	1014	1017	+	3	0	-2	4859
Q9Y215-1#27	0	1	1	Q9Y215-1	311	312	+	1	Q9Y215-1	0	455	ENST00000383786.9	111	1374	++	55	Q9Y215-1#27	0	3	ENST00000383786.9	942	945	+	3	0	-2	4860
Q9Y215-1#27	0	1	1	Q9Y215-1	311	312	+	1	Q9Y215-1	35	455	ENST00000383781.8	360	1620	++	54	Q9Y215-1#27	0	3	ENST00000383781.8	1188	1191	+	3	0	-2	4861
Q9Y215-1#28	0	1	1	Q9Y215-1	336	337	+	1	Q9Y215-1	0	455	ENST00000603808.5	126	1494	++	218	Q9Y215-1#28	0	3	ENST00000603808.5	1134	1137	+	3	0	-2	4862
Q9Y215-1#28	0	1	1	Q9Y215-1	336	337	+	1	Q9Y215-1	0	455	ENST00000383788.10	81	1446	++	56	Q9Y215-1#28	0	3	ENST00000383788.10	1089	1092	+	3	0	-2	4863
Q9Y215-1#28	0	1	1	Q9Y215-1	336	337	+	1	Q9Y215-1	0	455	ENST00000383786.9	111	1374	++	55	Q9Y215-1#28	0	3	ENST00000383786.9	1017	1020	+	3	0	-2	4864
Q9Y215-1#28	0	1	1	Q9Y215-1	336	337	+	1	Q9Y215-1	35	455	ENST00000383781.8	360	1620	++	54	Q9Y215-1#28	0	3	ENST00000383781.8	1263	1266	+	3	0	-2	4865
Q9Y215-1#29	0	1	1	Q9Y215-1	341	342	+	1	Q9Y215-1	0	455	ENST00000603808.5	126	1494	++	218	Q9Y215-1#29	0	3	ENST00000603808.5	1149	1152	+	3	0	-2	4866
Q9Y215-1#29	0	1	1	Q9Y215-1	341	342	+	1	Q9Y215-1	0	455	ENST00000383788.10	81	1446	++	56	Q9Y215-1#29	0	3	ENST00000383788.10	1104	1107	+	3	0	-2	4867
Q9Y215-1#29	0	1	1	Q9Y215-1	341	342	+	1	Q9Y215-1	0	455	ENST00000383786.9	111	1374	++	55	Q9Y215-1#29	0	3	ENST00000383786.9	1032	1035	+	3	0	-2	4868
Q9Y215-1#29	0	1	1	Q9Y215-1	341	342	+	1	Q9Y215-1	35	455	ENST00000383781.8	360	1620	++	54	Q9Y215-1#29	0	3	ENST00000383781.8	1278	1281	+	3	0	-2	4869
Q9Y215-1#30	0	1	1	Q9Y215-1	409	410	+	1	Q9Y215-1	0	455	ENST00000603808.5	126	1494	++	218	Q9Y215-1#30	0	3	ENST00000603808.5	1356	1359	+	3	0	-2	4870
Q9Y215-1#30	0	1	1	Q9Y215-1	409	410	+	1	Q9Y215-1	0	455	ENST00000383788.10	81	1446	++	56	Q9Y215-1#30	0	3	ENST00000383788.10	1308	1311	+	3	0	-2	4871
Q9Y215-1#30	0	1	1	Q9Y215-1	409	410	+	1	Q9Y215-1	0	455	ENST00000383786.9	111	1374	++	55	Q9Y215-1#30	0	3	ENST00000383786.9	1236	1239	+	3	0	-2	4872
Q9Y215-1#30	0	1	1	Q9Y215-1	409	410	+	1	Q9Y215-1	35	455	ENST00000383781.8	360	1620	++	54	Q9Y215-1#30	0	3	ENST00000383781.8	1482	1485	+	3	0	-2	4873
Q9Y215-1#31	0	1	1	Q9Y215-1	429	430	+	1	Q9Y215-1	0	455	ENST00000603808.5	126	1494	++	218	Q9Y215-1#31	0	3	ENST00000603808.5	1416	1419	+	3	0	-2	4874
Q9Y215-1#31	0	1	1	Q9Y215-1	429	430	+	1	Q9Y215-1	0	455	ENST00000383788.10	81	1446	++	56	Q9Y215-1#31	0	3	ENST00000383788.10	1368	1371	+	3	0	-2	4875
Q9Y215-1#31	0	1	1	Q9Y215-1	429	430	+	1	Q9Y215-1	0	455	ENST00000383786.9	111	1374	++	55	Q9Y215-1#31	0	3	ENST00000383786.9	1296	1299	+	3	0	-2	4876
Q9Y215-1#31	0	1	1	Q9Y215-1	429	430	+	1	Q9Y215-1	35	455	ENST00000383781.8	360	1620	++	54	Q9Y215-1#31	0	3	ENST00000383781.8	1542	1545	+	3	0	-2	4877
Q9Y215-1#32	0	1	1	Q9Y215-1	443	444	+	1	Q9Y215-1	0	455	ENST00000603808.5	126	1494	++	218	Q9Y215-1#32	0	3	ENST00000603808.5	1458	1461	+	3	0	-2	4878
Q9Y215-1#32	0	1	1	Q9Y215-1	443	444	+	1	Q9Y215-1	0	455	ENST00000383788.10	81	1446	++	56	Q9Y215-1#32	0	3	ENST00000383788.10	1410	1413	+	3	0	-2	4879
Q9Y215-1#32	0	1	1	Q9Y215-1	443	444	+	1	Q9Y215-1	0	455	ENST00000383786.9	111	1374	++	55	Q9Y215-1#32	0	3	ENST00000383786.9	1338	1341	+	3	0	-2	4880
Q9Y215-1#32	0	1	1	Q9Y215-1	443	444	+	1	Q9Y215-1	35	455	ENST00000383781.8	360	1620	++	54	Q9Y215-1#32	0	3	ENST00000383781.8	1584	1587	+	3	0	-2	4881
Q9Y215-1#33	0	1	1	Q9Y215-1	369	370	+	1	Q9Y215-1	0	455	ENST00000603808.5	126	1494	++	218	Q9Y215-1#33	0	3	ENST00000603808.5	1233	1236	+	3	0	-2	4882
Q9Y215-1#33	0	1	1	Q9Y215-1	369	370	+	1	Q9Y215-1	0	455	ENST00000383788.10	81	1446	++	56	Q9Y215-1#33	0	3	ENST00000383788.10	1188	1191	+	3	0	-2	4883
Q9Y215-1#33	0	1	1	Q9Y215-1	369	370	+	1	Q9Y215-1	0	455	ENST00000383786.9	111	1374	++	55	Q9Y215-1#33	0	3	ENST00000383786.9	1116	1119	+	3	0	-2	4884
Q9Y215-1#33	0	1	1	Q9Y215-1	369	370	+	1	Q9Y215-1	35	455	ENST00000383781.8	360	1620	++	54	Q9Y215-1#33	0	3	ENST00000383781.8	1362	1365	+	3	0	-2	4885
Q9Y215-1#34	0	1	1	Q9Y215-1	398	399	+	1	Q9Y215-1	0	455	ENST00000603808.5	126	1494	++	218	Q9Y215-1#34	0	3	ENST00000603808.5	1320	1323	+	3	0	-2	4886
Q9Y215-1#34	0	1	1	Q9Y215-1	398	399	+	1	Q9Y215-1	0	455	ENST00000383788.10	81	1446	++	56	Q9Y215-1#34	0	3	ENST00000383788.10	1275	1278	+	3	0	-2	4887
Q9Y215-1#34	0	1	1	Q9Y215-1	398	399	+	1	Q9Y215-1	0	455	ENST00000383786.9	111	1374	++	55	Q9Y215-1#34	0	3	ENST00000383786.9	1203	1206	+	3	0	-2	4888
Q9Y215-1#34	0	1	1	Q9Y215-1	398	399	+	1	Q9Y215-1	35	455	ENST00000383781.8	360	1620	++	54	Q9Y215-1#34	0	3	ENST00000383781.8	1449	1452	+	3	0	-2	4889
Q9Y215-1#35	0	1	1	Q9Y215-1	399	400	+	1	Q9Y215-1	0	455	ENST00000603808.5	126	1494	++	218	Q9Y215-1#35	0	3	ENST00000603808.5	1326	1329	+	3	0	-2	4890
Q9Y215-1#35	0	1	1	Q9Y215-1	399	400	+	1	Q9Y215-1	0	455	ENST00000383788.10	81	1446	++	56	Q9Y215-1#35	0	3	ENST00000383788.10	1278	1281	+	3	0	-2	4891
Q9Y215-1#35	0	1	1	Q9Y215-1	399	400	+	1	Q9Y215-1	0	455	ENST00000383786.9	111	1374	++	55	Q9Y215-1#35	0	3	ENST00000383786.9	1206	1209	+	3	0	-2	4892
Q9Y215-1#35	0	1	1	Q9Y215-1	399	400	+	1	Q9Y215-1	35	455	ENST00000383781.8	360	1620	++	54	Q9Y215-1#35	0	3	ENST00000383781.8	1452	1455	+	3	0	-2	4893
Q9Y215-1#36	0	1	1	Q9Y215-1	403	404	+	1	Q9Y215-1	0	455	ENST00000603808.5	126	1494	++	218	Q9Y215-1#36	0	3	ENST00000603808.5	1338	1341	+	3	0	-2	4894
Q9Y215-1#36	0	1	1	Q9Y215-1	403	404	+	1	Q9Y215-1	0	455	ENST00000383788.10	81	1446	++	56	Q9Y215-1#36	0	3	ENST00000383788.10	1290	1293	+	3	0	-2	4895
Q9Y215-1#36	0	1	1	Q9Y215-1	403	404	+	1	Q9Y215-1	0	455	ENST00000383786.9	111	1374	++	55	Q9Y215-1#36	0	3	ENST00000383786.9	1218	1221	+	3	0	-2	4896
Q9Y215-1#36	0	1	1	Q9Y215-1	403	404	+	1	Q9Y215-1	35	455	ENST00000383781.8	360	1620	++	54	Q9Y215-1#36	0	3	ENST00000383781.8	1464	1467	+	3	0	-2	4897
Q9Y215-1#37	0	1	1	Q9Y215-1	422	423	+	1	Q9Y215-1	0	455	ENST00000603808.5	126	1494	++	218	Q9Y215-1#37	0	3	ENST00000603808.5	1395	1398	+	3	0	-2	4898
Q9Y215-1#37	0	1	1	Q9Y215-1	422	423	+	1	Q9Y215-1	0	455	ENST00000383788.10	81	1446	++	56	Q9Y215-1#37	0	3	ENST00000383788.10	1347	1350	+	3	0	-2	4899
Q9Y215-1#37	0	1	1	Q9Y215-1	422	423	+	1	Q9Y215-1	0	455	ENST00000383786.9	111	1374	++	55	Q9Y215-1#37	0	3	ENST00000383786.9	1275	1278	+	3	0	-2	4900
Q9Y215-1#37	0	1	1	Q9Y215-1	422	423	+	1	Q9Y215-1	35	455	ENST00000383781.8	360	1620	++	54	Q9Y215-1#37	0	3	ENST00000383781.8	1521	1524	+	3	0	-2	4901
Q6PF04-1#0	0	617	617	Q6PF04-1	0	617	+	617	Q6PF04-1	334	541	ENST00000601794.1	1	622	++	216	Q6PF04-1#0	1002	1623	ENST00000601794.1	1	622	+	621	1002	-1006	4902
Q6PF04-1#0	0	617	617	Q6PF04-1	0	617	+	617	Q6PF04-1	0	94	ENST00000600853.1	260	542	++	212	Q6PF04-1#0	0	282	ENST00000600853.1	260	542	+	282	0	335	4903
Q6PF04-1#0	0	617	617	Q6PF04-1	0	617	+	617	Q6PF04-1	36	121	ENST00000599683.5	351	606	++	208	Q6PF04-1#0	108	363	ENST00000599683.5	351	606	+	255	108	254	4904
Q6PF04-1#0	0	617	617	Q6PF04-1	0	617	+	617	Q6PF04-1	36	617	ENST00000391794.8	464	2207	++	58	Q6PF04-1#0	108	1851	ENST00000391794.8	464	2207	+	1743	108	-1234	4905
Q6PF04-1#0	0	617	617	Q6PF04-1	0	617	+	617	Q6PF04-1	0	617	ENST00000293471.11	427	2278	++	19	Q6PF04-1#0	0	1851	ENST00000293471.11	427	2278	+	1851	0	-1234	4906
Q6PF04-1#1	0	71	71	Q6PF04-1	7	78	+	71	Q6PF04-1	0	94	ENST00000600853.1	260	542	++	212	Q6PF04-1#1	0	213	ENST00000600853.1	281	494	+	213	0	-142	4907
Q6PF04-1#1	0	71	71	Q6PF04-1	7	78	+	71	Q6PF04-1	36	121	ENST00000599683.5	351	606	++	208	Q6PF04-1#1	87	213	ENST00000599683.5	351	477	+	126	87	-142	4908
Q6PF04-1#1	0	71	71	Q6PF04-1	7	78	+	71	Q6PF04-1	36	617	ENST00000391794.8	464	2207	++	58	Q6PF04-1#1	87	213	ENST00000391794.8	464	590	+	126	87	-142	4909
Q6PF04-1#1	0	71	71	Q6PF04-1	7	78	+	71	Q6PF04-1	0	617	ENST00000293471.11	427	2278	++	19	Q6PF04-1#1	0	213	ENST00000293471.11	448	661	+	213	0	-142	4910
Q6PF04-1#2	0	23	23	Q6PF04-1	203	226	+	23	Q6PF04-1	36	617	ENST00000391794.8	464	2207	++	58	Q6PF04-1#2	0	69	ENST00000391794.8	965	1034	+	69	0	-46	4911
Q6PF04-1#2	0	23	23	Q6PF04-1	203	226	+	23	Q6PF04-1	0	617	ENST00000293471.11	427	2278	++	19	Q6PF04-1#2	0	69	ENST00000293471.11	1036	1105	+	69	0	-46	4912
Q6PF04-1#3	0	23	23	Q6PF04-1	231	254	+	23	Q6PF04-1	36	617	ENST00000391794.8	464	2207	++	58	Q6PF04-1#3	0	69	ENST00000391794.8	1049	1118	+	69	0	-46	4913
Q6PF04-1#3	0	23	23	Q6PF04-1	231	254	+	23	Q6PF04-1	0	617	ENST00000293471.11	427	2278	++	19	Q6PF04-1#3	0	69	ENST00000293471.11	1120	1189	+	69	0	-46	4914
Q6PF04-1#4	0	23	23	Q6PF04-1	259	282	+	23	Q6PF04-1	36	617	ENST00000391794.8	464	2207	++	58	Q6PF04-1#4	0	69	ENST00000391794.8	1133	1202	+	69	0	-46	4915
Q6PF04-1#4	0	23	23	Q6PF04-1	259	282	+	23	Q6PF04-1	0	617	ENST00000293471.11	427	2278	++	19	Q6PF04-1#4	0	69	ENST00000293471.11	1204	1273	+	69	0	-46	4916
Q6PF04-1#5	0	23	23	Q6PF04-1	287	310	+	23	Q6PF04-1	36	617	ENST00000391794.8	464	2207	++	58	Q6PF04-1#5	0	69	ENST00000391794.8	1217	1286	+	69	0	-46	4917
Q6PF04-1#5	0	23	23	Q6PF04-1	287	310	+	23	Q6PF04-1	0	617	ENST00000293471.11	427	2278	++	19	Q6PF04-1#5	0	69	ENST00000293471.11	1288	1357	+	69	0	-46	4918
Q6PF04-1#6	0	23	23	Q6PF04-1	315	338	+	23	Q6PF04-1	334	541	ENST00000601794.1	1	622	++	216	Q6PF04-1#6	57	69	ENST00000601794.1	1	13	+	12	57	-46	4919
Q6PF04-1#6	0	23	23	Q6PF04-1	315	338	+	23	Q6PF04-1	36	617	ENST00000391794.8	464	2207	++	58	Q6PF04-1#6	0	69	ENST00000391794.8	1301	1370	+	69	0	-46	4920
Q6PF04-1#6	0	23	23	Q6PF04-1	315	338	+	23	Q6PF04-1	0	617	ENST00000293471.11	427	2278	++	19	Q6PF04-1#6	0	69	ENST00000293471.11	1372	1441	+	69	0	-46	4921
Q6PF04-1#7	0	23	23	Q6PF04-1	343	366	+	23	Q6PF04-1	334	541	ENST00000601794.1	1	622	++	216	Q6PF04-1#7	0	69	ENST00000601794.1	28	97	+	69	0	-46	4922
Q6PF04-1#7	0	23	23	Q6PF04-1	343	366	+	23	Q6PF04-1	36	617	ENST00000391794.8	464	2207	++	58	Q6PF04-1#7	0	69	ENST00000391794.8	1385	1454	+	69	0	-46	4923
Q6PF04-1#7	0	23	23	Q6PF04-1	343	366	+	23	Q6PF04-1	0	617	ENST00000293471.11	427	2278	++	19	Q6PF04-1#7	0	69	ENST00000293471.11	1456	1525	+	69	0	-46	4924
Q6PF04-1#8	0	23	23	Q6PF04-1	371	394	+	23	Q6PF04-1	334	541	ENST00000601794.1	1	622	++	216	Q6PF04-1#8	0	69	ENST00000601794.1	112	181	+	69	0	-46	4925
Q6PF04-1#8	0	23	23	Q6PF04-1	371	394	+	23	Q6PF04-1	36	617	ENST00000391794.8	464	2207	++	58	Q6PF04-1#8	0	69	ENST00000391794.8	1469	1538	+	69	0	-46	4926
Q6PF04-1#8	0	23	23	Q6PF04-1	371	394	+	23	Q6PF04-1	0	617	ENST00000293471.11	427	2278	++	19	Q6PF04-1#8	0	69	ENST00000293471.11	1540	1609	+	69	0	-46	4927
Q6PF04-1#9	0	23	23	Q6PF04-1	399	422	+	23	Q6PF04-1	334	541	ENST00000601794.1	1	622	++	216	Q6PF04-1#9	0	69	ENST00000601794.1	196	265	+	69	0	-46	4928
Q6PF04-1#9	0	23	23	Q6PF04-1	399	422	+	23	Q6PF04-1	36	617	ENST00000391794.8	464	2207	++	58	Q6PF04-1#9	0	69	ENST00000391794.8	1553	1622	+	69	0	-46	4929
Q6PF04-1#9	0	23	23	Q6PF04-1	399	422	+	23	Q6PF04-1	0	617	ENST00000293471.11	427	2278	++	19	Q6PF04-1#9	0	69	ENST00000293471.11	1624	1693	+	69	0	-46	4930
Q6PF04-1#10	0	23	23	Q6PF04-1	427	450	+	23	Q6PF04-1	334	541	ENST00000601794.1	1	622	++	216	Q6PF04-1#10	0	69	ENST00000601794.1	280	349	+	69	0	-46	4931
Q6PF04-1#10	0	23	23	Q6PF04-1	427	450	+	23	Q6PF04-1	36	617	ENST00000391794.8	464	2207	++	58	Q6PF04-1#10	0	69	ENST00000391794.8	1637	1706	+	69	0	-46	4932
Q6PF04-1#10	0	23	23	Q6PF04-1	427	450	+	23	Q6PF04-1	0	617	ENST00000293471.11	427	2278	++	19	Q6PF04-1#10	0	69	ENST00000293471.11	1708	1777	+	69	0	-46	4933
Q6PF04-1#11	0	23	23	Q6PF04-1	455	478	+	23	Q6PF04-1	334	541	ENST00000601794.1	1	622	++	216	Q6PF04-1#11	0	69	ENST00000601794.1	364	433	+	69	0	-46	4934
Q6PF04-1#11	0	23	23	Q6PF04-1	455	478	+	23	Q6PF04-1	36	617	ENST00000391794.8	464	2207	++	58	Q6PF04-1#11	0	69	ENST00000391794.8	1721	1790	+	69	0	-46	4935
Q6PF04-1#11	0	23	23	Q6PF04-1	455	478	+	23	Q6PF04-1	0	617	ENST00000293471.11	427	2278	++	19	Q6PF04-1#11	0	69	ENST00000293471.11	1792	1861	+	69	0	-46	4936
Q6PF04-1#12	0	23	23	Q6PF04-1	483	506	+	23	Q6PF04-1	334	541	ENST00000601794.1	1	622	++	216	Q6PF04-1#12	0	69	ENST00000601794.1	448	517	+	69	0	-46	4937
Q6PF04-1#12	0	23	23	Q6PF04-1	483	506	+	23	Q6PF04-1	36	617	ENST00000391794.8	464	2207	++	58	Q6PF04-1#12	0	69	ENST00000391794.8	1805	1874	+	69	0	-46	4938
Q6PF04-1#12	0	23	23	Q6PF04-1	483	506	+	23	Q6PF04-1	0	617	ENST00000293471.11	427	2278	++	19	Q6PF04-1#12	0	69	ENST00000293471.11	1876	1945	+	69	0	-46	4939
Q6PF04-1#13	0	24	24	Q6PF04-1	511	535	+	24	Q6PF04-1	334	541	ENST00000601794.1	1	622	++	216	Q6PF04-1#13	0	72	ENST00000601794.1	532	604	+	72	0	-48	4940
Q6PF04-1#13	0	24	24	Q6PF04-1	511	535	+	24	Q6PF04-1	36	617	ENST00000391794.8	464	2207	++	58	Q6PF04-1#13	0	72	ENST00000391794.8	1889	1961	+	72	0	-48	4941
Q6PF04-1#13	0	24	24	Q6PF04-1	511	535	+	24	Q6PF04-1	0	617	ENST00000293471.11	427	2278	++	19	Q6PF04-1#13	0	72	ENST00000293471.11	1960	2032	+	72	0	-48	4942
Q6PF04-1#14	0	36	36	Q6PF04-1	0	36	+	36	Q6PF04-1	0	94	ENST00000600853.1	260	542	++	212	Q6PF04-1#14	0	108	ENST00000600853.1	260	368	+	108	0	-72	4943
Q6PF04-1#14	0	36	36	Q6PF04-1	0	36	+	36	Q6PF04-1	0	617	ENST00000293471.11	427	2278	++	19	Q6PF04-1#14	0	108	ENST00000293471.11	427	535	+	108	0	-72	4944
Q6PF04-1#15	0	1	1	Q6PF04-1	83	84	+	1	Q6PF04-1	0	94	ENST00000600853.1	260	542	++	212	Q6PF04-1#15	0	3	ENST00000600853.1	509	512	+	3	0	-2	4945
Q6PF04-1#15	0	1	1	Q6PF04-1	83	84	+	1	Q6PF04-1	36	121	ENST00000599683.5	351	606	++	208	Q6PF04-1#15	0	3	ENST00000599683.5	492	495	+	3	0	-2	4946
Q6PF04-1#15	0	1	1	Q6PF04-1	83	84	+	1	Q6PF04-1	36	617	ENST00000391794.8	464	2207	++	58	Q6PF04-1#15	0	3	ENST00000391794.8	605	608	+	3	0	-2	4947
Q6PF04-1#15	0	1	1	Q6PF04-1	83	84	+	1	Q6PF04-1	0	617	ENST00000293471.11	427	2278	++	19	Q6PF04-1#15	0	3	ENST00000293471.11	676	679	+	3	0	-2	4948
Q6PF04-1#16	0	1	1	Q6PF04-1	92	93	+	1	Q6PF04-1	0	94	ENST00000600853.1	260	542	++	212	Q6PF04-1#16	0	3	ENST00000600853.1	536	539	+	3	0	-2	4949
Q6PF04-1#16	0	1	1	Q6PF04-1	92	93	+	1	Q6PF04-1	36	121	ENST00000599683.5	351	606	++	208	Q6PF04-1#16	0	3	ENST00000599683.5	519	522	+	3	0	-2	4950
Q6PF04-1#16	0	1	1	Q6PF04-1	92	93	+	1	Q6PF04-1	36	617	ENST00000391794.8	464	2207	++	58	Q6PF04-1#16	0	3	ENST00000391794.8	632	635	+	3	0	-2	4951
Q6PF04-1#16	0	1	1	Q6PF04-1	92	93	+	1	Q6PF04-1	0	617	ENST00000293471.11	427	2278	++	19	Q6PF04-1#16	0	3	ENST00000293471.11	703	706	+	3	0	-2	4952
Q6PF04-1#17	0	1	1	Q6PF04-1	134	135	+	1	Q6PF04-1	36	617	ENST00000391794.8	464	2207	++	58	Q6PF04-1#17	0	3	ENST00000391794.8	758	761	+	3	0	-2	4953
Q6PF04-1#17	0	1	1	Q6PF04-1	134	135	+	1	Q6PF04-1	0	617	ENST00000293471.11	427	2278	++	19	Q6PF04-1#17	0	3	ENST00000293471.11	829	832	+	3	0	-2	4954
Q6PF04-1#18	0	1	1	Q6PF04-1	162	163	+	1	Q6PF04-1	36	617	ENST00000391794.8	464	2207	++	58	Q6PF04-1#18	0	3	ENST00000391794.8	842	845	+	3	0	-2	4955
Q6PF04-1#18	0	1	1	Q6PF04-1	162	163	+	1	Q6PF04-1	0	617	ENST00000293471.11	427	2278	++	19	Q6PF04-1#18	0	3	ENST00000293471.11	913	916	+	3	0	-2	4956
Q6PF04-1#19	0	1	1	Q6PF04-1	610	611	+	1	Q6PF04-1	36	617	ENST00000391794.8	464	2207	++	58	Q6PF04-1#19	0	3	ENST00000391794.8	2186	2189	+	3	0	-2	4957
Q6PF04-1#19	0	1	1	Q6PF04-1	610	611	+	1	Q6PF04-1	0	617	ENST00000293471.11	427	2278	++	19	Q6PF04-1#19	0	3	ENST00000293471.11	2257	2260	+	3	0	-2	4958
A7E2S9-1#0	0	258	258	A7E2S9-1	0	258	+	258	A7E2S9-1	0	258	ENST00000409867.6	247	1021	++	71	A7E2S9-1#0	0	774	ENST00000409867.6	247	1021	+	774	0	-516	4959
A7E2S9-1#0	0	258	258	A7E2S9-1	0	258	+	258	A7E2S9-1	0	205	ENST00000295181.6	250	865	++	20	A7E2S9-1#0	0	615	ENST00000295181.6	250	865	+	615	0	-357	4960
A7E2S9-1#1	0	30	30	A7E2S9-1	70	100	+	30	A7E2S9-1	0	258	ENST00000409867.6	247	1021	++	71	A7E2S9-1#1	0	90	ENST00000409867.6	457	547	+	90	0	-60	4961
A7E2S9-1#1	0	30	30	A7E2S9-1	70	100	+	30	A7E2S9-1	0	205	ENST00000295181.6	250	865	++	20	A7E2S9-1#1	0	90	ENST00000295181.6	460	550	+	90	0	-60	4962
A7E2S9-1#2	0	30	30	A7E2S9-1	103	133	+	30	A7E2S9-1	0	258	ENST00000409867.6	247	1021	++	71	A7E2S9-1#2	0	90	ENST00000409867.6	556	646	+	90	0	-60	4963
A7E2S9-1#2	0	30	30	A7E2S9-1	103	133	+	30	A7E2S9-1	0	205	ENST00000295181.6	250	865	++	20	A7E2S9-1#2	0	90	ENST00000295181.6	559	649	+	90	0	-60	4964
A7E2S9-1#3	0	30	30	A7E2S9-1	136	166	+	30	A7E2S9-1	0	258	ENST00000409867.6	247	1021	++	71	A7E2S9-1#3	0	90	ENST00000409867.6	655	745	+	90	0	-60	4965
A7E2S9-1#3	0	30	30	A7E2S9-1	136	166	+	30	A7E2S9-1	0	205	ENST00000295181.6	250	865	++	20	A7E2S9-1#3	0	90	ENST00000295181.6	658	748	+	90	0	-60	4966
A7E2S9-1#4	0	30	30	A7E2S9-1	169	199	+	30	A7E2S9-1	0	258	ENST00000409867.6	247	1021	++	71	A7E2S9-1#4	0	90	ENST00000409867.6	754	844	+	90	0	-60	4967
A7E2S9-1#4	0	30	30	A7E2S9-1	169	199	+	30	A7E2S9-1	0	205	ENST00000295181.6	250	865	++	20	A7E2S9-1#4	0	90	ENST00000295181.6	757	847	+	90	0	-60	4968
A7E2S9-1#5	0	21	21	A7E2S9-1	0	21	+	21	A7E2S9-1	0	258	ENST00000409867.6	247	1021	++	71	A7E2S9-1#5	0	63	ENST00000409867.6	247	310	+	63	0	-42	4969
A7E2S9-1#5	0	21	21	A7E2S9-1	0	21	+	21	A7E2S9-1	0	205	ENST00000295181.6	250	865	++	20	A7E2S9-1#5	0	63	ENST00000295181.6	250	313	+	63	0	-42	4970
A7E2S9-1#6	0	43	43	A7E2S9-1	215	258	+	43	A7E2S9-1	0	258	ENST00000409867.6	247	1021	++	71	A7E2S9-1#6	0	129	ENST00000409867.6	892	1021	+	129	0	-86	4971
A7E2S9-1#7	0	16	16	A7E2S9-1	215	231	+	16	A7E2S9-1	0	258	ENST00000409867.6	247	1021	++	71	A7E2S9-1#7	0	48	ENST00000409867.6	892	940	+	48	0	-32	4972
A7E2S9-1#8	0	53	53	A7E2S9-1	205	258	+	53	A7E2S9-1	0	258	ENST00000409867.6	247	1021	++	71	A7E2S9-1#8	0	159	ENST00000409867.6	862	1021	+	159	0	-106	4973
Q6PD74-1#0	0	315	315	Q6PD74-1	0	315	+	315	Q6PD74-1	109	315	ENST00000561452.5	516	1134	++	171	Q6PD74-1#0	327	945	ENST00000561452.5	516	1134	+	618	327	-630	4974
Q6PD74-1#0	0	315	315	Q6PD74-1	0	315	+	315	Q6PD74-1	109	167	ENST00000560362.1	389	563	++	170	Q6PD74-1#0	327	501	ENST00000560362.1	389	563	+	174	327	-186	4975
Q6PD74-1#0	0	315	315	Q6PD74-1	0	315	+	315	Q6PD74-1	109	315	ENST00000542650.5	313	931	++	155	Q6PD74-1#0	327	945	ENST00000542650.5	313	931	+	618	327	-630	4976
Q6PD74-1#0	0	315	315	Q6PD74-1	0	315	+	315	Q6PD74-1	0	315	ENST00000261880.10	30	975	++	7	Q6PD74-1#0	0	945	ENST00000261880.10	30	975	+	945	0	-630	4977
Q6PD74-1#1	0	38	38	Q6PD74-1	196	234	+	38	Q6PD74-1	109	315	ENST00000561452.5	516	1134	++	171	Q6PD74-1#1	0	114	ENST00000561452.5	777	891	+	114	0	-76	4978
Q6PD74-1#1	0	38	38	Q6PD74-1	196	234	+	38	Q6PD74-1	109	315	ENST00000542650.5	313	931	++	155	Q6PD74-1#1	0	114	ENST00000542650.5	574	688	+	114	0	-76	4979
Q6PD74-1#1	0	38	38	Q6PD74-1	196	234	+	38	Q6PD74-1	0	315	ENST00000261880.10	30	975	++	7	Q6PD74-1#1	0	114	ENST00000261880.10	618	732	+	114	0	-76	4980
Q6PD74-1#2	0	15	15	Q6PD74-1	219	234	+	15	Q6PD74-1	109	315	ENST00000561452.5	516	1134	++	171	Q6PD74-1#2	0	45	ENST00000561452.5	846	891	+	45	0	-30	4981
Q6PD74-1#2	0	15	15	Q6PD74-1	219	234	+	15	Q6PD74-1	109	315	ENST00000542650.5	313	931	++	155	Q6PD74-1#2	0	45	ENST00000542650.5	643	688	+	45	0	-30	4982
Q6PD74-1#2	0	15	15	Q6PD74-1	219	234	+	15	Q6PD74-1	0	315	ENST00000261880.10	30	975	++	7	Q6PD74-1#2	0	45	ENST00000261880.10	687	732	+	45	0	-30	4983
Q6PD74-1#3	0	1	1	Q6PD74-1	309	310	+	1	Q6PD74-1	109	315	ENST00000561452.5	516	1134	++	171	Q6PD74-1#3	0	3	ENST00000561452.5	1116	1119	+	3	0	-2	4984
Q6PD74-1#3	0	1	1	Q6PD74-1	309	310	+	1	Q6PD74-1	109	315	ENST00000542650.5	313	931	++	155	Q6PD74-1#3	0	3	ENST00000542650.5	913	916	+	3	0	-2	4985
Q6PD74-1#3	0	1	1	Q6PD74-1	309	310	+	1	Q6PD74-1	0	315	ENST00000261880.10	30	975	++	7	Q6PD74-1#3	0	3	ENST00000261880.10	957	960	+	3	0	-2	4986
Q6PD74-1#4	0	1	1	Q6PD74-1	310	311	+	1	Q6PD74-1	109	315	ENST00000561452.5	516	1134	++	171	Q6PD74-1#4	0	3	ENST00000561452.5	1119	1122	+	3	0	-2	4987
Q6PD74-1#4	0	1	1	Q6PD74-1	310	311	+	1	Q6PD74-1	109	315	ENST00000542650.5	313	931	++	155	Q6PD74-1#4	0	3	ENST00000542650.5	916	919	+	3	0	-2	4988
Q6PD74-1#4	0	1	1	Q6PD74-1	310	311	+	1	Q6PD74-1	0	315	ENST00000261880.10	30	975	++	7	Q6PD74-1#4	0	3	ENST00000261880.10	960	963	+	3	0	-2	4989
Q6PD74-1#5	0	109	109	Q6PD74-1	0	109	+	109	Q6PD74-1	0	315	ENST00000261880.10	30	975	++	7	Q6PD74-1#5	0	327	ENST00000261880.10	30	357	+	327	0	-218	4990
Q6PD74-1#6	0	1	1	Q6PD74-1	131	132	+	1	Q6PD74-1	109	315	ENST00000561452.5	516	1134	++	171	Q6PD74-1#6	0	3	ENST00000561452.5	582	585	+	3	0	-2	4991
Q6PD74-1#6	0	1	1	Q6PD74-1	131	132	+	1	Q6PD74-1	109	167	ENST00000560362.1	389	563	++	170	Q6PD74-1#6	0	3	ENST00000560362.1	455	458	+	3	0	-2	4992
Q6PD74-1#6	0	1	1	Q6PD74-1	131	132	+	1	Q6PD74-1	109	315	ENST00000542650.5	313	931	++	155	Q6PD74-1#6	0	3	ENST00000542650.5	379	382	+	3	0	-2	4993
Q6PD74-1#6	0	1	1	Q6PD74-1	131	132	+	1	Q6PD74-1	0	315	ENST00000261880.10	30	975	++	7	Q6PD74-1#6	0	3	ENST00000261880.10	423	426	+	3	0	-2	4994
Q6PD74-1#7	0	1	1	Q6PD74-1	25	26	+	1	Q6PD74-1	0	315	ENST00000261880.10	30	975	++	7	Q6PD74-1#7	0	3	ENST00000261880.10	105	108	+	3	0	-2	4995
Q6PD74-1#8	0	1	1	Q6PD74-1	76	77	+	1	Q6PD74-1	0	315	ENST00000261880.10	30	975	++	7	Q6PD74-1#8	0	3	ENST00000261880.10	258	261	+	3	0	-2	4996
Q6PD74-1#9	0	1	1	Q6PD74-1	87	88	+	1	Q6PD74-1	0	315	ENST00000261880.10	30	975	++	7	Q6PD74-1#9	0	3	ENST00000261880.10	291	294	+	3	0	-2	4997
Q6PD74-1#10	0	1	1	Q6PD74-1	130	131	+	1	Q6PD74-1	109	315	ENST00000561452.5	516	1134	++	171	Q6PD74-1#10	0	3	ENST00000561452.5	579	582	+	3	0	-2	4998
Q6PD74-1#10	0	1	1	Q6PD74-1	130	131	+	1	Q6PD74-1	109	167	ENST00000560362.1	389	563	++	170	Q6PD74-1#10	0	3	ENST00000560362.1	452	455	+	3	0	-2	4999
Q6PD74-1#10	0	1	1	Q6PD74-1	130	131	+	1	Q6PD74-1	109	315	ENST00000542650.5	313	931	++	155	Q6PD74-1#10	0	3	ENST00000542650.5	376	379	+	3	0	-2	5000
Q6PD74-1#10	0	1	1	Q6PD74-1	130	131	+	1	Q6PD74-1	0	315	ENST00000261880.10	30	975	++	7	Q6PD74-1#10	0	3	ENST00000261880.10	420	423	+	3	0	-2	5001
Q6PD74-1#11	0	1	1	Q6PD74-1	264	265	+	1	Q6PD74-1	109	315	ENST00000561452.5	516	1134	++	171	Q6PD74-1#11	0	3	ENST00000561452.5	981	984	+	3	0	-2	5002
Q6PD74-1#11	0	1	1	Q6PD74-1	264	265	+	1	Q6PD74-1	109	315	ENST00000542650.5	313	931	++	155	Q6PD74-1#11	0	3	ENST00000542650.5	778	781	+	3	0	-2	5003
Q6PD74-1#11	0	1	1	Q6PD74-1	264	265	+	1	Q6PD74-1	0	315	ENST00000261880.10	30	975	++	7	Q6PD74-1#11	0	3	ENST00000261880.10	822	825	+	3	0	-2	5004
Q6PD74-1#12	0	1	1	Q6PD74-1	312	313	+	1	Q6PD74-1	109	315	ENST00000561452.5	516	1134	++	171	Q6PD74-1#12	0	3	ENST00000561452.5	1125	1128	+	3	0	-2	5005
Q6PD74-1#12	0	1	1	Q6PD74-1	312	313	+	1	Q6PD74-1	109	315	ENST00000542650.5	313	931	++	155	Q6PD74-1#12	0	3	ENST00000542650.5	922	925	+	3	0	-2	5006
Q6PD74-1#12	0	1	1	Q6PD74-1	312	313	+	1	Q6PD74-1	0	315	ENST00000261880.10	30	975	++	7	Q6PD74-1#12	0	3	ENST00000261880.10	966	969	+	3	0	-2	5007
Q8N1M1-2#0	0	668	668	Q8N1M1-2	0	668	+	668	Q8N1M1-2	106	668	ENST00000553096.5	152	1838	++	163	Q8N1M1-2#0	318	2004	ENST00000553096.5	152	1838	+	1686	318	-1336	5008
Q8N1M1-2#0	0	668	668	Q8N1M1-2	0	668	+	668	Q8N1M1-2	106	318	ENST00000552295.5	236	719	++	162	Q8N1M1-2#0	318	954	ENST00000552295.5	236	719	+	483	318	-286	5009
Q8N1M1-2#0	0	668	668	Q8N1M1-2	0	668	+	668	Q8N1M1-2	106	160	ENST00000551160.5	357	519	++	161	Q8N1M1-2#0	318	480	ENST00000551160.5	357	519	+	162	318	188	5010
Q8N1M1-2#0	0	668	668	Q8N1M1-2	0	668	+	668	Q8N1M1-2	0	87	ENST00000548658.1	146	407	++	160	Q8N1M1-2#0	0	261	ENST00000548658.1	146	407	+	261	0	407	5011
Q8N1M1-2#0	0	668	668	Q8N1M1-2	0	668	+	668	Q8N1M1-2	128	317	ENST00000547208.5	209	623	++	159	Q8N1M1-2#0	384	951	ENST00000547208.5	209	623	+	414	384	-283	5012
Q8N1M1-2#0	0	668	668	Q8N1M1-2	0	668	+	668	Q8N1M1-2	162	668	ENST00000488961.5	212	1577	++	119	Q8N1M1-2#0	486	2004	ENST00000488961.5	212	1577	+	1365	486	-1336	5013
Q8N1M1-2#0	0	668	668	Q8N1M1-2	0	668	+	668	Q8N1M1-2	162	386	ENST00000476098.5	331	877	++	113	Q8N1M1-2#0	486	1158	ENST00000476098.5	331	877	+	519	486	-490	5014
Q8N1M1-2#0	0	668	668	Q8N1M1-2	0	668	+	668	Q8N1M1-2	0	378	ENST00000331471.8	172	1297	++	29	Q8N1M1-2#0	0	1134	ENST00000331471.8	172	1297	+	1125	0	-466	5015
Q8N1M1-2#0	0	668	668	Q8N1M1-2	0	668	+	668	Q8N1M1-2	0	668	ENST00000330891.10	114	2118	++	28	Q8N1M1-2#0	0	2004	ENST00000330891.10	114	2118	+	2004	0	-1336	5016
Q8N1M1-2#0	0	668	668	Q8N1M1-2	0	668	+	668	Q8N1M1-2	106	160	ENST00000266661.8	343	505	++	11	Q8N1M1-2#0	318	480	ENST00000266661.8	343	505	+	162	318	188	5017
Q8N1M1-2#1	0	25	25	Q8N1M1-2	0	25	+	25	Q8N1M1-2	0	87	ENST00000548658.1	146	407	++	160	Q8N1M1-2#1	0	75	ENST00000548658.1	146	221	+	75	0	-50	5018
Q8N1M1-2#1	0	25	25	Q8N1M1-2	0	25	+	25	Q8N1M1-2	0	378	ENST00000331471.8	172	1297	++	29	Q8N1M1-2#1	0	75	ENST00000331471.8	172	247	+	75	0	-50	5019
Q8N1M1-2#1	0	25	25	Q8N1M1-2	0	25	+	25	Q8N1M1-2	0	668	ENST00000330891.10	114	2118	++	28	Q8N1M1-2#1	0	75	ENST00000330891.10	114	189	+	75	0	-50	5020
Q8N1M1-2#2	0	21	21	Q8N1M1-2	25	46	+	21	Q8N1M1-2	0	87	ENST00000548658.1	146	407	++	160	Q8N1M1-2#2	0	63	ENST00000548658.1	221	284	+	63	0	-42	5021
Q8N1M1-2#2	0	21	21	Q8N1M1-2	25	46	+	21	Q8N1M1-2	0	378	ENST00000331471.8	172	1297	++	29	Q8N1M1-2#2	0	63	ENST00000331471.8	247	310	+	63	0	-42	5022
Q8N1M1-2#2	0	21	21	Q8N1M1-2	25	46	+	21	Q8N1M1-2	0	668	ENST00000330891.10	114	2118	++	28	Q8N1M1-2#2	0	63	ENST00000330891.10	189	252	+	63	0	-42	5023
Q8N1M1-2#3	0	24	24	Q8N1M1-2	46	70	+	24	Q8N1M1-2	0	87	ENST00000548658.1	146	407	++	160	Q8N1M1-2#3	0	72	ENST00000548658.1	284	356	+	72	0	-48	5024
Q8N1M1-2#3	0	24	24	Q8N1M1-2	46	70	+	24	Q8N1M1-2	0	378	ENST00000331471.8	172	1297	++	29	Q8N1M1-2#3	0	72	ENST00000331471.8	310	382	+	72	0	-48	5025
Q8N1M1-2#3	0	24	24	Q8N1M1-2	46	70	+	24	Q8N1M1-2	0	668	ENST00000330891.10	114	2118	++	28	Q8N1M1-2#3	0	72	ENST00000330891.10	252	324	+	72	0	-48	5026
Q8N1M1-2#4	0	21	21	Q8N1M1-2	70	91	+	21	Q8N1M1-2	0	87	ENST00000548658.1	146	407	++	160	Q8N1M1-2#4	0	51	ENST00000548658.1	356	407	+	51	0	-30	5027
Q8N1M1-2#4	0	21	21	Q8N1M1-2	70	91	+	21	Q8N1M1-2	0	378	ENST00000331471.8	172	1297	++	29	Q8N1M1-2#4	0	63	ENST00000331471.8	382	445	+	63	0	-42	5028
Q8N1M1-2#4	0	21	21	Q8N1M1-2	70	91	+	21	Q8N1M1-2	0	668	ENST00000330891.10	114	2118	++	28	Q8N1M1-2#4	0	63	ENST00000330891.10	324	387	+	63	0	-42	5029
Q8N1M1-2#5	0	87	87	Q8N1M1-2	91	178	+	87	Q8N1M1-2	106	668	ENST00000553096.5	152	1838	++	163	Q8N1M1-2#5	45	261	ENST00000553096.5	152	368	+	216	45	-174	5030
Q8N1M1-2#5	0	87	87	Q8N1M1-2	91	178	+	87	Q8N1M1-2	106	318	ENST00000552295.5	236	719	++	162	Q8N1M1-2#5	45	261	ENST00000552295.5	236	452	+	216	45	-174	5031
Q8N1M1-2#5	0	87	87	Q8N1M1-2	91	178	+	87	Q8N1M1-2	106	160	ENST00000551160.5	357	519	++	161	Q8N1M1-2#5	45	207	ENST00000551160.5	357	519	+	162	45	-120	5032
Q8N1M1-2#5	0	87	87	Q8N1M1-2	91	178	+	87	Q8N1M1-2	128	317	ENST00000547208.5	209	623	++	159	Q8N1M1-2#5	111	261	ENST00000547208.5	209	359	+	150	111	-174	5033
Q8N1M1-2#5	0	87	87	Q8N1M1-2	91	178	+	87	Q8N1M1-2	162	668	ENST00000488961.5	212	1577	++	119	Q8N1M1-2#5	213	261	ENST00000488961.5	212	260	+	48	213	-174	5034
Q8N1M1-2#5	0	87	87	Q8N1M1-2	91	178	+	87	Q8N1M1-2	162	386	ENST00000476098.5	331	877	++	113	Q8N1M1-2#5	213	261	ENST00000476098.5	331	379	+	48	213	-174	5035
Q8N1M1-2#5	0	87	87	Q8N1M1-2	91	178	+	87	Q8N1M1-2	0	378	ENST00000331471.8	172	1297	++	29	Q8N1M1-2#5	0	261	ENST00000331471.8	445	706	+	261	0	-174	5036
Q8N1M1-2#5	0	87	87	Q8N1M1-2	91	178	+	87	Q8N1M1-2	0	668	ENST00000330891.10	114	2118	++	28	Q8N1M1-2#5	0	261	ENST00000330891.10	387	648	+	261	0	-174	5037
Q8N1M1-2#5	0	87	87	Q8N1M1-2	91	178	+	87	Q8N1M1-2	106	160	ENST00000266661.8	343	505	++	11	Q8N1M1-2#5	45	207	ENST00000266661.8	343	505	+	162	45	-120	5038
Q8N1M1-2#6	0	21	21	Q8N1M1-2	178	199	+	21	Q8N1M1-2	106	668	ENST00000553096.5	152	1838	++	163	Q8N1M1-2#6	0	63	ENST00000553096.5	368	431	+	63	0	-42	5039
Q8N1M1-2#6	0	21	21	Q8N1M1-2	178	199	+	21	Q8N1M1-2	106	318	ENST00000552295.5	236	719	++	162	Q8N1M1-2#6	0	63	ENST00000552295.5	452	515	+	63	0	-42	5040
Q8N1M1-2#6	0	21	21	Q8N1M1-2	178	199	+	21	Q8N1M1-2	128	317	ENST00000547208.5	209	623	++	159	Q8N1M1-2#6	0	63	ENST00000547208.5	359	422	+	63	0	-42	5041
Q8N1M1-2#6	0	21	21	Q8N1M1-2	178	199	+	21	Q8N1M1-2	162	668	ENST00000488961.5	212	1577	++	119	Q8N1M1-2#6	0	63	ENST00000488961.5	260	323	+	63	0	-42	5042
Q8N1M1-2#6	0	21	21	Q8N1M1-2	178	199	+	21	Q8N1M1-2	162	386	ENST00000476098.5	331	877	++	113	Q8N1M1-2#6	0	63	ENST00000476098.5	379	442	+	63	0	-42	5043
Q8N1M1-2#6	0	21	21	Q8N1M1-2	178	199	+	21	Q8N1M1-2	0	378	ENST00000331471.8	172	1297	++	29	Q8N1M1-2#6	0	63	ENST00000331471.8	706	769	+	63	0	-42	5044
Q8N1M1-2#6	0	21	21	Q8N1M1-2	178	199	+	21	Q8N1M1-2	0	668	ENST00000330891.10	114	2118	++	28	Q8N1M1-2#6	0	63	ENST00000330891.10	648	711	+	63	0	-42	5045
Q8N1M1-2#7	0	29	29	Q8N1M1-2	199	228	+	29	Q8N1M1-2	106	668	ENST00000553096.5	152	1838	++	163	Q8N1M1-2#7	0	87	ENST00000553096.5	431	518	+	87	0	-58	5046
Q8N1M1-2#7	0	29	29	Q8N1M1-2	199	228	+	29	Q8N1M1-2	106	318	ENST00000552295.5	236	719	++	162	Q8N1M1-2#7	0	87	ENST00000552295.5	515	602	+	87	0	-58	5047
Q8N1M1-2#7	0	29	29	Q8N1M1-2	199	228	+	29	Q8N1M1-2	128	317	ENST00000547208.5	209	623	++	159	Q8N1M1-2#7	0	87	ENST00000547208.5	422	509	+	87	0	-58	5048
Q8N1M1-2#7	0	29	29	Q8N1M1-2	199	228	+	29	Q8N1M1-2	162	668	ENST00000488961.5	212	1577	++	119	Q8N1M1-2#7	0	87	ENST00000488961.5	323	410	+	87	0	-58	5049
Q8N1M1-2#7	0	29	29	Q8N1M1-2	199	228	+	29	Q8N1M1-2	162	386	ENST00000476098.5	331	877	++	113	Q8N1M1-2#7	0	87	ENST00000476098.5	442	529	+	87	0	-58	5050
Q8N1M1-2#7	0	29	29	Q8N1M1-2	199	228	+	29	Q8N1M1-2	0	378	ENST00000331471.8	172	1297	++	29	Q8N1M1-2#7	0	87	ENST00000331471.8	769	856	+	87	0	-58	5051
Q8N1M1-2#7	0	29	29	Q8N1M1-2	199	228	+	29	Q8N1M1-2	0	668	ENST00000330891.10	114	2118	++	28	Q8N1M1-2#7	0	87	ENST00000330891.10	711	798	+	87	0	-58	5052
Q8N1M1-2#8	0	21	21	Q8N1M1-2	228	249	+	21	Q8N1M1-2	106	668	ENST00000553096.5	152	1838	++	163	Q8N1M1-2#8	0	63	ENST00000553096.5	518	581	+	63	0	-42	5053
Q8N1M1-2#8	0	21	21	Q8N1M1-2	228	249	+	21	Q8N1M1-2	106	318	ENST00000552295.5	236	719	++	162	Q8N1M1-2#8	0	33	ENST00000552295.5	602	635	+	33	0	-12	5054
Q8N1M1-2#8	0	21	21	Q8N1M1-2	228	249	+	21	Q8N1M1-2	128	317	ENST00000547208.5	209	623	++	159	Q8N1M1-2#8	0	33	ENST00000547208.5	509	542	+	33	0	-12	5055
Q8N1M1-2#8	0	21	21	Q8N1M1-2	228	249	+	21	Q8N1M1-2	162	668	ENST00000488961.5	212	1577	++	119	Q8N1M1-2#8	0	30	ENST00000488961.5	410	440	+	30	0	-9	5056
Q8N1M1-2#8	0	21	21	Q8N1M1-2	228	249	+	21	Q8N1M1-2	162	386	ENST00000476098.5	331	877	++	113	Q8N1M1-2#8	0	33	ENST00000476098.5	529	562	+	33	0	-12	5057
Q8N1M1-2#8	0	21	21	Q8N1M1-2	228	249	+	21	Q8N1M1-2	0	378	ENST00000331471.8	172	1297	++	29	Q8N1M1-2#8	0	63	ENST00000331471.8	856	919	+	63	0	-42	5058
Q8N1M1-2#8	0	21	21	Q8N1M1-2	228	249	+	21	Q8N1M1-2	0	668	ENST00000330891.10	114	2118	++	28	Q8N1M1-2#8	0	63	ENST00000330891.10	798	861	+	63	0	-42	5059
Q8N1M1-2#9	0	21	21	Q8N1M1-2	249	270	+	21	Q8N1M1-2	106	668	ENST00000553096.5	152	1838	++	163	Q8N1M1-2#9	0	63	ENST00000553096.5	581	644	+	63	0	-42	5060
Q8N1M1-2#9	0	21	21	Q8N1M1-2	249	270	+	21	Q8N1M1-2	0	378	ENST00000331471.8	172	1297	++	29	Q8N1M1-2#9	0	63	ENST00000331471.8	919	982	+	63	0	-42	5061
Q8N1M1-2#9	0	21	21	Q8N1M1-2	249	270	+	21	Q8N1M1-2	0	668	ENST00000330891.10	114	2118	++	28	Q8N1M1-2#9	0	63	ENST00000330891.10	861	924	+	63	0	-42	5062
Q8N1M1-2#10	0	21	21	Q8N1M1-2	270	291	+	21	Q8N1M1-2	106	668	ENST00000553096.5	152	1838	++	163	Q8N1M1-2#10	0	63	ENST00000553096.5	644	707	+	63	0	-42	5063
Q8N1M1-2#10	0	21	21	Q8N1M1-2	270	291	+	21	Q8N1M1-2	106	318	ENST00000552295.5	236	719	++	162	Q8N1M1-2#10	60	63	ENST00000552295.5	635	638	+	3	60	-42	5064
Q8N1M1-2#10	0	21	21	Q8N1M1-2	270	291	+	21	Q8N1M1-2	128	317	ENST00000547208.5	209	623	++	159	Q8N1M1-2#10	60	63	ENST00000547208.5	542	545	+	3	60	-42	5065
Q8N1M1-2#10	0	21	21	Q8N1M1-2	270	291	+	21	Q8N1M1-2	162	668	ENST00000488961.5	212	1577	++	119	Q8N1M1-2#10	57	63	ENST00000488961.5	440	446	+	6	57	-42	5066
Q8N1M1-2#10	0	21	21	Q8N1M1-2	270	291	+	21	Q8N1M1-2	162	386	ENST00000476098.5	331	877	++	113	Q8N1M1-2#10	60	63	ENST00000476098.5	562	565	+	3	60	-42	5067
Q8N1M1-2#10	0	21	21	Q8N1M1-2	270	291	+	21	Q8N1M1-2	0	378	ENST00000331471.8	172	1297	++	29	Q8N1M1-2#10	0	63	ENST00000331471.8	982	1045	+	63	0	-42	5068
Q8N1M1-2#10	0	21	21	Q8N1M1-2	270	291	+	21	Q8N1M1-2	0	668	ENST00000330891.10	114	2118	++	28	Q8N1M1-2#10	0	63	ENST00000330891.10	924	987	+	63	0	-42	5069
Q8N1M1-2#11	0	377	377	Q8N1M1-2	291	668	+	377	Q8N1M1-2	106	668	ENST00000553096.5	152	1838	++	163	Q8N1M1-2#11	0	1131	ENST00000553096.5	707	1838	+	1131	0	-754	5070
Q8N1M1-2#11	0	377	377	Q8N1M1-2	291	668	+	377	Q8N1M1-2	106	318	ENST00000552295.5	236	719	++	162	Q8N1M1-2#11	0	81	ENST00000552295.5	638	719	+	81	0	296	5071
Q8N1M1-2#11	0	377	377	Q8N1M1-2	291	668	+	377	Q8N1M1-2	128	317	ENST00000547208.5	209	623	++	159	Q8N1M1-2#11	0	78	ENST00000547208.5	545	623	+	78	0	299	5072
Q8N1M1-2#11	0	377	377	Q8N1M1-2	291	668	+	377	Q8N1M1-2	162	668	ENST00000488961.5	212	1577	++	119	Q8N1M1-2#11	0	1131	ENST00000488961.5	446	1577	+	1131	0	-754	5073
Q8N1M1-2#11	0	377	377	Q8N1M1-2	291	668	+	377	Q8N1M1-2	162	386	ENST00000476098.5	331	877	++	113	Q8N1M1-2#11	0	285	ENST00000476098.5	565	877	+	285	0	92	5074
Q8N1M1-2#11	0	377	377	Q8N1M1-2	291	668	+	377	Q8N1M1-2	0	378	ENST00000331471.8	172	1297	++	29	Q8N1M1-2#11	0	261	ENST00000331471.8	1045	1297	+	252	0	116	5075
Q8N1M1-2#11	0	377	377	Q8N1M1-2	291	668	+	377	Q8N1M1-2	0	668	ENST00000330891.10	114	2118	++	28	Q8N1M1-2#11	0	1131	ENST00000330891.10	987	2118	+	1131	0	-754	5076
Q8N1M1-2#12	0	55	55	Q8N1M1-2	399	454	+	55	Q8N1M1-2	106	668	ENST00000553096.5	152	1838	++	163	Q8N1M1-2#12	0	165	ENST00000553096.5	1031	1196	+	165	0	-110	5077
Q8N1M1-2#12	0	55	55	Q8N1M1-2	399	454	+	55	Q8N1M1-2	162	668	ENST00000488961.5	212	1577	++	119	Q8N1M1-2#12	0	165	ENST00000488961.5	770	935	+	165	0	-110	5078
Q8N1M1-2#12	0	55	55	Q8N1M1-2	399	454	+	55	Q8N1M1-2	0	668	ENST00000330891.10	114	2118	++	28	Q8N1M1-2#12	0	165	ENST00000330891.10	1311	1476	+	165	0	-110	5079
Q8N1M1-2#13	0	21	21	Q8N1M1-2	472	493	+	21	Q8N1M1-2	106	668	ENST00000553096.5	152	1838	++	163	Q8N1M1-2#13	0	63	ENST00000553096.5	1250	1313	+	63	0	-42	5080
Q8N1M1-2#13	0	21	21	Q8N1M1-2	472	493	+	21	Q8N1M1-2	162	668	ENST00000488961.5	212	1577	++	119	Q8N1M1-2#13	0	63	ENST00000488961.5	989	1052	+	63	0	-42	5081
Q8N1M1-2#13	0	21	21	Q8N1M1-2	472	493	+	21	Q8N1M1-2	0	668	ENST00000330891.10	114	2118	++	28	Q8N1M1-2#13	0	63	ENST00000330891.10	1530	1593	+	63	0	-42	5082
Q8N1M1-2#14	0	39	39	Q8N1M1-2	531	570	+	39	Q8N1M1-2	106	668	ENST00000553096.5	152	1838	++	163	Q8N1M1-2#14	0	117	ENST00000553096.5	1427	1544	+	117	0	-78	5083
Q8N1M1-2#14	0	39	39	Q8N1M1-2	531	570	+	39	Q8N1M1-2	162	668	ENST00000488961.5	212	1577	++	119	Q8N1M1-2#14	0	117	ENST00000488961.5	1166	1283	+	117	0	-78	5084
Q8N1M1-2#14	0	39	39	Q8N1M1-2	531	570	+	39	Q8N1M1-2	0	668	ENST00000330891.10	114	2118	++	28	Q8N1M1-2#14	0	117	ENST00000330891.10	1707	1824	+	117	0	-78	5085
Q8N1M1-2#15	0	17	17	Q8N1M1-2	399	416	+	17	Q8N1M1-2	106	668	ENST00000553096.5	152	1838	++	163	Q8N1M1-2#15	0	51	ENST00000553096.5	1031	1082	+	51	0	-34	5086
Q8N1M1-2#15	0	17	17	Q8N1M1-2	399	416	+	17	Q8N1M1-2	162	668	ENST00000488961.5	212	1577	++	119	Q8N1M1-2#15	0	51	ENST00000488961.5	770	821	+	51	0	-34	5087
Q8N1M1-2#15	0	17	17	Q8N1M1-2	399	416	+	17	Q8N1M1-2	0	668	ENST00000330891.10	114	2118	++	28	Q8N1M1-2#15	0	51	ENST00000330891.10	1311	1362	+	51	0	-34	5088
Q8N1M1-2#16	0	19	19	Q8N1M1-2	531	550	+	19	Q8N1M1-2	106	668	ENST00000553096.5	152	1838	++	163	Q8N1M1-2#16	0	57	ENST00000553096.5	1427	1484	+	57	0	-38	5089
Q8N1M1-2#16	0	19	19	Q8N1M1-2	531	550	+	19	Q8N1M1-2	162	668	ENST00000488961.5	212	1577	++	119	Q8N1M1-2#16	0	57	ENST00000488961.5	1166	1223	+	57	0	-38	5090
Q8N1M1-2#16	0	19	19	Q8N1M1-2	531	550	+	19	Q8N1M1-2	0	668	ENST00000330891.10	114	2118	++	28	Q8N1M1-2#16	0	57	ENST00000330891.10	1707	1764	+	57	0	-38	5091
Q8N1M1-2#17	0	162	162	Q8N1M1-2	0	162	+	162	Q8N1M1-2	106	668	ENST00000553096.5	152	1838	++	163	Q8N1M1-2#17	318	486	ENST00000553096.5	152	320	+	168	318	-324	5092
Q8N1M1-2#17	0	162	162	Q8N1M1-2	0	162	+	162	Q8N1M1-2	106	318	ENST00000552295.5	236	719	++	162	Q8N1M1-2#17	318	486	ENST00000552295.5	236	404	+	168	318	-324	5093
Q8N1M1-2#17	0	162	162	Q8N1M1-2	0	162	+	162	Q8N1M1-2	106	160	ENST00000551160.5	357	519	++	161	Q8N1M1-2#17	318	480	ENST00000551160.5	357	519	+	162	318	-318	5094
Q8N1M1-2#17	0	162	162	Q8N1M1-2	0	162	+	162	Q8N1M1-2	0	87	ENST00000548658.1	146	407	++	160	Q8N1M1-2#17	0	261	ENST00000548658.1	146	407	+	261	0	-99	5095
Q8N1M1-2#17	0	162	162	Q8N1M1-2	0	162	+	162	Q8N1M1-2	128	317	ENST00000547208.5	209	623	++	159	Q8N1M1-2#17	384	486	ENST00000547208.5	209	311	+	102	384	-324	5096
Q8N1M1-2#17	0	162	162	Q8N1M1-2	0	162	+	162	Q8N1M1-2	0	378	ENST00000331471.8	172	1297	++	29	Q8N1M1-2#17	0	486	ENST00000331471.8	172	658	+	486	0	-324	5097
Q8N1M1-2#17	0	162	162	Q8N1M1-2	0	162	+	162	Q8N1M1-2	0	668	ENST00000330891.10	114	2118	++	28	Q8N1M1-2#17	0	486	ENST00000330891.10	114	600	+	486	0	-324	5098
Q8N1M1-2#17	0	162	162	Q8N1M1-2	0	162	+	162	Q8N1M1-2	106	160	ENST00000266661.8	343	505	++	11	Q8N1M1-2#17	318	480	ENST00000266661.8	343	505	+	162	318	-318	5099
Q8N1M1-2#18	0	106	106	Q8N1M1-2	0	106	+	106	Q8N1M1-2	0	87	ENST00000548658.1	146	407	++	160	Q8N1M1-2#18	0	261	ENST00000548658.1	146	407	+	261	0	-155	5100
Q8N1M1-2#18	0	106	106	Q8N1M1-2	0	106	+	106	Q8N1M1-2	0	378	ENST00000331471.8	172	1297	++	29	Q8N1M1-2#18	0	318	ENST00000331471.8	172	490	+	318	0	-212	5101
Q8N1M1-2#18	0	106	106	Q8N1M1-2	0	106	+	106	Q8N1M1-2	0	668	ENST00000330891.10	114	2118	++	28	Q8N1M1-2#18	0	318	ENST00000330891.10	114	432	+	318	0	-212	5102
Q8N1M1-2#19	0	18	18	Q8N1M1-2	160	178	+	18	Q8N1M1-2	106	668	ENST00000553096.5	152	1838	++	163	Q8N1M1-2#19	0	54	ENST00000553096.5	314	368	+	54	0	-36	5103
Q8N1M1-2#19	0	18	18	Q8N1M1-2	160	178	+	18	Q8N1M1-2	106	318	ENST00000552295.5	236	719	++	162	Q8N1M1-2#19	0	54	ENST00000552295.5	398	452	+	54	0	-36	5104
Q8N1M1-2#19	0	18	18	Q8N1M1-2	160	178	+	18	Q8N1M1-2	128	317	ENST00000547208.5	209	623	++	159	Q8N1M1-2#19	0	54	ENST00000547208.5	305	359	+	54	0	-36	5105
Q8N1M1-2#19	0	18	18	Q8N1M1-2	160	178	+	18	Q8N1M1-2	162	668	ENST00000488961.5	212	1577	++	119	Q8N1M1-2#19	6	54	ENST00000488961.5	212	260	+	48	6	-36	5106
Q8N1M1-2#19	0	18	18	Q8N1M1-2	160	178	+	18	Q8N1M1-2	162	386	ENST00000476098.5	331	877	++	113	Q8N1M1-2#19	6	54	ENST00000476098.5	331	379	+	48	6	-36	5107
Q8N1M1-2#19	0	18	18	Q8N1M1-2	160	178	+	18	Q8N1M1-2	0	378	ENST00000331471.8	172	1297	++	29	Q8N1M1-2#19	0	54	ENST00000331471.8	652	706	+	54	0	-36	5108
Q8N1M1-2#19	0	18	18	Q8N1M1-2	160	178	+	18	Q8N1M1-2	0	668	ENST00000330891.10	114	2118	++	28	Q8N1M1-2#19	0	54	ENST00000330891.10	594	648	+	54	0	-36	5109
Q8N1M1-2#20	0	490	490	Q8N1M1-2	178	668	+	490	Q8N1M1-2	106	668	ENST00000553096.5	152	1838	++	163	Q8N1M1-2#20	0	1470	ENST00000553096.5	368	1838	+	1470	0	-980	5110
Q8N1M1-2#20	0	490	490	Q8N1M1-2	178	668	+	490	Q8N1M1-2	106	318	ENST00000552295.5	236	719	++	162	Q8N1M1-2#20	0	420	ENST00000552295.5	452	719	+	267	0	70	5111
Q8N1M1-2#20	0	490	490	Q8N1M1-2	178	668	+	490	Q8N1M1-2	128	317	ENST00000547208.5	209	623	++	159	Q8N1M1-2#20	0	417	ENST00000547208.5	359	623	+	264	0	73	5112
Q8N1M1-2#20	0	490	490	Q8N1M1-2	178	668	+	490	Q8N1M1-2	162	668	ENST00000488961.5	212	1577	++	119	Q8N1M1-2#20	0	1470	ENST00000488961.5	260	1577	+	1317	0	-980	5113
Q8N1M1-2#20	0	490	490	Q8N1M1-2	178	668	+	490	Q8N1M1-2	162	386	ENST00000476098.5	331	877	++	113	Q8N1M1-2#20	0	624	ENST00000476098.5	379	877	+	471	0	-134	5114
Q8N1M1-2#20	0	490	490	Q8N1M1-2	178	668	+	490	Q8N1M1-2	0	378	ENST00000331471.8	172	1297	++	29	Q8N1M1-2#20	0	600	ENST00000331471.8	706	1297	+	591	0	-110	5115
Q8N1M1-2#20	0	490	490	Q8N1M1-2	178	668	+	490	Q8N1M1-2	0	668	ENST00000330891.10	114	2118	++	28	Q8N1M1-2#20	0	1470	ENST00000330891.10	648	2118	+	1470	0	-980	5116
Q8N1M1-2#21	0	51	51	Q8N1M1-2	238	289	+	51	Q8N1M1-2	106	668	ENST00000553096.5	152	1838	++	163	Q8N1M1-2#21	0	153	ENST00000553096.5	548	701	+	153	0	-102	5117
Q8N1M1-2#21	0	51	51	Q8N1M1-2	238	289	+	51	Q8N1M1-2	106	318	ENST00000552295.5	236	719	++	162	Q8N1M1-2#21	0	3	ENST00000552295.5	632	635	+	3	0	48	5118
Q8N1M1-2#21	0	51	51	Q8N1M1-2	238	289	+	51	Q8N1M1-2	128	317	ENST00000547208.5	209	623	++	159	Q8N1M1-2#21	0	3	ENST00000547208.5	539	542	+	3	0	48	5119
Q8N1M1-2#21	0	51	51	Q8N1M1-2	238	289	+	51	Q8N1M1-2	162	386	ENST00000476098.5	331	877	++	113	Q8N1M1-2#21	0	3	ENST00000476098.5	559	562	+	3	0	48	5120
Q8N1M1-2#21	0	51	51	Q8N1M1-2	238	289	+	51	Q8N1M1-2	0	378	ENST00000331471.8	172	1297	++	29	Q8N1M1-2#21	0	153	ENST00000331471.8	886	1039	+	153	0	-102	5121
Q8N1M1-2#21	0	51	51	Q8N1M1-2	238	289	+	51	Q8N1M1-2	0	668	ENST00000330891.10	114	2118	++	28	Q8N1M1-2#21	0	153	ENST00000330891.10	828	981	+	153	0	-102	5122
Q8N1M1-2#22	0	31	31	Q8N1M1-2	367	398	+	31	Q8N1M1-2	106	668	ENST00000553096.5	152	1838	++	163	Q8N1M1-2#22	0	93	ENST00000553096.5	935	1028	+	93	0	-62	5123
Q8N1M1-2#22	0	31	31	Q8N1M1-2	367	398	+	31	Q8N1M1-2	162	668	ENST00000488961.5	212	1577	++	119	Q8N1M1-2#22	0	93	ENST00000488961.5	674	767	+	93	0	-62	5124
Q8N1M1-2#22	0	31	31	Q8N1M1-2	367	398	+	31	Q8N1M1-2	162	386	ENST00000476098.5	331	877	++	113	Q8N1M1-2#22	0	57	ENST00000476098.5	793	877	+	57	0	-26	5125
Q8N1M1-2#22	0	31	31	Q8N1M1-2	367	398	+	31	Q8N1M1-2	0	378	ENST00000331471.8	172	1297	++	29	Q8N1M1-2#22	6	33	ENST00000331471.8	1270	1297	+	27	6	-2	5126
Q8N1M1-2#22	0	31	31	Q8N1M1-2	367	398	+	31	Q8N1M1-2	0	668	ENST00000330891.10	114	2118	++	28	Q8N1M1-2#22	0	93	ENST00000330891.10	1215	1308	+	93	0	-62	5127
Q8N1M1-2#23	0	270	270	Q8N1M1-2	398	668	+	270	Q8N1M1-2	106	668	ENST00000553096.5	152	1838	++	163	Q8N1M1-2#23	0	810	ENST00000553096.5	1028	1838	+	810	0	-540	5128
Q8N1M1-2#23	0	270	270	Q8N1M1-2	398	668	+	270	Q8N1M1-2	162	668	ENST00000488961.5	212	1577	++	119	Q8N1M1-2#23	0	810	ENST00000488961.5	767	1577	+	810	0	-540	5129
Q8N1M1-2#23	0	270	270	Q8N1M1-2	398	668	+	270	Q8N1M1-2	0	668	ENST00000330891.10	114	2118	++	28	Q8N1M1-2#23	0	810	ENST00000330891.10	1308	2118	+	810	0	-540	5130
Q8N1M1-2#24	0	1	1	Q8N1M1-2	42	43	+	1	Q8N1M1-2	0	87	ENST00000548658.1	146	407	++	160	Q8N1M1-2#24	0	3	ENST00000548658.1	272	275	+	3	0	-2	5131
Q8N1M1-2#24	0	1	1	Q8N1M1-2	42	43	+	1	Q8N1M1-2	0	378	ENST00000331471.8	172	1297	++	29	Q8N1M1-2#24	0	3	ENST00000331471.8	298	301	+	3	0	-2	5132
Q8N1M1-2#24	0	1	1	Q8N1M1-2	42	43	+	1	Q8N1M1-2	0	668	ENST00000330891.10	114	2118	++	28	Q8N1M1-2#24	0	3	ENST00000330891.10	240	243	+	3	0	-2	5133
Q8N1M1-2#25	0	1	1	Q8N1M1-2	621	622	+	1	Q8N1M1-2	106	668	ENST00000553096.5	152	1838	++	163	Q8N1M1-2#25	0	3	ENST00000553096.5	1697	1700	+	3	0	-2	5134
Q8N1M1-2#25	0	1	1	Q8N1M1-2	621	622	+	1	Q8N1M1-2	162	668	ENST00000488961.5	212	1577	++	119	Q8N1M1-2#25	0	3	ENST00000488961.5	1436	1439	+	3	0	-2	5135
Q8N1M1-2#25	0	1	1	Q8N1M1-2	621	622	+	1	Q8N1M1-2	0	668	ENST00000330891.10	114	2118	++	28	Q8N1M1-2#25	0	3	ENST00000330891.10	1977	1980	+	3	0	-2	5136
Q9BXI3#0	0	368	368	Q9BXI3	0	368	+	368	Q9BXI3	0	368	ENST00000235628.2	69	1173	++	1	Q9BXI3#0	0	1104	ENST00000235628.2	69	1173	+	1104	0	-736	5137
Q9BXI3#1	0	22	22	Q9BXI3	0	22	+	22	Q9BXI3	0	368	ENST00000235628.2	69	1173	++	1	Q9BXI3#1	0	66	ENST00000235628.2	69	135	+	66	0	-44	5138
Q9BXI3#2	0	1	1	Q9BXI3	210	211	+	1	Q9BXI3	0	368	ENST00000235628.2	69	1173	++	1	Q9BXI3#2	0	3	ENST00000235628.2	699	702	+	3	0	-2	5139
Q9BXI3#3	0	3	3	Q9BXI3	8	11	+	3	Q9BXI3	0	368	ENST00000235628.2	69	1173	++	1	Q9BXI3#3	0	9	ENST00000235628.2	93	102	+	9	0	-6	5140
Q96P26-1#0	0	610	610	Q96P26-1	0	610	+	610	Q96P26-1	357	610	ENST00000418427.1	34	793	++	79	Q96P26-1#0	1071	1830	ENST00000418427.1	34	793	+	759	1071	-1220	5141
Q96P26-1#0	0	610	610	Q96P26-1	0	610	+	610	Q96P26-1	0	188	ENST00000416783.1	68	683	++	77	Q96P26-1#0	0	564	ENST00000416783.1	68	683	+	564	0	46	5142
Q96P26-1#0	0	610	610	Q96P26-1	0	610	+	610	Q96P26-1	173	286	ENST00000406971.6	376	715	++	68	Q96P26-1#0	519	858	ENST00000406971.6	376	715	+	339	519	-248	5143
Q96P26-1#0	0	610	610	Q96P26-1	0	610	+	610	Q96P26-1	0	610	ENST00000359846.6	78	1908	++	38	Q96P26-1#0	0	1830	ENST00000359846.6	78	1908	+	1830	0	-1220	5144
Q96P26-1#0	0	610	610	Q96P26-1	0	610	+	610	Q96P26-1	99	610	ENST00000304081.9	218	1751	++	22	Q96P26-1#0	297	1830	ENST00000304081.9	218	1751	+	1533	297	-1220	5145
Q96P26-1#1	0	34	34	Q96P26-1	0	34	+	34	Q96P26-1	0	188	ENST00000416783.1	68	683	++	77	Q96P26-1#1	0	102	ENST00000416783.1	68	170	+	102	0	-68	5146
Q96P26-1#1	0	34	34	Q96P26-1	0	34	+	34	Q96P26-1	0	610	ENST00000359846.6	78	1908	++	38	Q96P26-1#1	0	102	ENST00000359846.6	78	180	+	102	0	-68	5147
Q96P26-1#2	0	177	177	Q96P26-1	100	277	+	177	Q96P26-1	0	188	ENST00000416783.1	68	683	++	77	Q96P26-1#2	0	264	ENST00000416783.1	419	683	+	264	0	-87	5148
Q96P26-1#2	0	177	177	Q96P26-1	100	277	+	177	Q96P26-1	173	286	ENST00000406971.6	376	715	++	68	Q96P26-1#2	219	531	ENST00000406971.6	376	688	+	312	219	-354	5149
Q96P26-1#2	0	177	177	Q96P26-1	100	277	+	177	Q96P26-1	0	610	ENST00000359846.6	78	1908	++	38	Q96P26-1#2	0	531	ENST00000359846.6	378	909	+	531	0	-354	5150
Q96P26-1#2	0	177	177	Q96P26-1	100	277	+	177	Q96P26-1	99	610	ENST00000304081.9	218	1751	++	22	Q96P26-1#2	0	531	ENST00000304081.9	221	752	+	531	0	-354	5151
Q96P26-1#3	0	23	23	Q96P26-1	11	34	+	23	Q96P26-1	0	188	ENST00000416783.1	68	683	++	77	Q96P26-1#3	0	69	ENST00000416783.1	101	170	+	69	0	-46	5152
Q96P26-1#3	0	23	23	Q96P26-1	11	34	+	23	Q96P26-1	0	610	ENST00000359846.6	78	1908	++	38	Q96P26-1#3	0	69	ENST00000359846.6	111	180	+	69	0	-46	5153
Q96P26-1#4	0	71	71	Q96P26-1	100	171	+	71	Q96P26-1	0	188	ENST00000416783.1	68	683	++	77	Q96P26-1#4	0	213	ENST00000416783.1	419	632	+	213	0	-142	5154
Q96P26-1#4	0	71	71	Q96P26-1	100	171	+	71	Q96P26-1	0	610	ENST00000359846.6	78	1908	++	38	Q96P26-1#4	0	213	ENST00000359846.6	378	591	+	213	0	-142	5155
Q96P26-1#4	0	71	71	Q96P26-1	100	171	+	71	Q96P26-1	99	610	ENST00000304081.9	218	1751	++	22	Q96P26-1#4	0	213	ENST00000304081.9	221	434	+	213	0	-142	5156
Q96P26-1#5	0	30	30	Q96P26-1	171	201	+	30	Q96P26-1	0	188	ENST00000416783.1	68	683	++	77	Q96P26-1#5	0	51	ENST00000416783.1	632	683	+	51	0	-21	5157
Q96P26-1#5	0	30	30	Q96P26-1	171	201	+	30	Q96P26-1	173	286	ENST00000406971.6	376	715	++	68	Q96P26-1#5	6	90	ENST00000406971.6	376	460	+	84	6	-60	5158
Q96P26-1#5	0	30	30	Q96P26-1	171	201	+	30	Q96P26-1	0	610	ENST00000359846.6	78	1908	++	38	Q96P26-1#5	0	90	ENST00000359846.6	591	681	+	90	0	-60	5159
Q96P26-1#5	0	30	30	Q96P26-1	171	201	+	30	Q96P26-1	99	610	ENST00000304081.9	218	1751	++	22	Q96P26-1#5	0	90	ENST00000304081.9	434	524	+	90	0	-60	5160
Q96P26-1#6	0	36	36	Q96P26-1	230	266	+	36	Q96P26-1	173	286	ENST00000406971.6	376	715	++	68	Q96P26-1#6	0	108	ENST00000406971.6	547	655	+	108	0	-72	5161
Q96P26-1#6	0	36	36	Q96P26-1	230	266	+	36	Q96P26-1	0	610	ENST00000359846.6	78	1908	++	38	Q96P26-1#6	0	108	ENST00000359846.6	768	876	+	108	0	-72	5162
Q96P26-1#6	0	36	36	Q96P26-1	230	266	+	36	Q96P26-1	99	610	ENST00000304081.9	218	1751	++	22	Q96P26-1#6	0	108	ENST00000304081.9	611	719	+	108	0	-72	5163
Q96P26-1#7	0	1	1	Q96P26-1	466	467	+	1	Q96P26-1	357	610	ENST00000418427.1	34	793	++	79	Q96P26-1#7	0	3	ENST00000418427.1	361	364	+	3	0	-2	5164
Q96P26-1#7	0	1	1	Q96P26-1	466	467	+	1	Q96P26-1	0	610	ENST00000359846.6	78	1908	++	38	Q96P26-1#7	0	3	ENST00000359846.6	1476	1479	+	3	0	-2	5165
Q96P26-1#7	0	1	1	Q96P26-1	466	467	+	1	Q96P26-1	99	610	ENST00000304081.9	218	1751	++	22	Q96P26-1#7	0	3	ENST00000304081.9	1319	1322	+	3	0	-2	5166
Q96P26-1#8	0	208	208	Q96P26-1	0	208	+	208	Q96P26-1	0	188	ENST00000416783.1	68	683	++	77	Q96P26-1#8	0	564	ENST00000416783.1	68	683	+	564	0	-356	5167
Q96P26-1#8	0	208	208	Q96P26-1	0	208	+	208	Q96P26-1	173	286	ENST00000406971.6	376	715	++	68	Q96P26-1#8	519	624	ENST00000406971.6	376	481	+	105	519	-416	5168
Q96P26-1#8	0	208	208	Q96P26-1	0	208	+	208	Q96P26-1	0	610	ENST00000359846.6	78	1908	++	38	Q96P26-1#8	0	624	ENST00000359846.6	78	702	+	624	0	-416	5169
Q96P26-1#8	0	208	208	Q96P26-1	0	208	+	208	Q96P26-1	99	610	ENST00000304081.9	218	1751	++	22	Q96P26-1#8	297	624	ENST00000304081.9	218	545	+	327	297	-416	5170
Q96P26-1#9	0	60	60	Q96P26-1	40	100	+	60	Q96P26-1	0	188	ENST00000416783.1	68	683	++	77	Q96P26-1#9	0	180	ENST00000416783.1	188	368	+	180	0	-120	5171
Q96P26-1#9	0	60	60	Q96P26-1	40	100	+	60	Q96P26-1	0	610	ENST00000359846.6	78	1908	++	38	Q96P26-1#9	0	180	ENST00000359846.6	198	378	+	180	0	-120	5172
Q96P26-1#9	0	60	60	Q96P26-1	40	100	+	60	Q96P26-1	99	610	ENST00000304081.9	218	1751	++	22	Q96P26-1#9	177	180	ENST00000304081.9	218	221	+	3	177	-120	5173
Q96P26-1#10	0	15	15	Q96P26-1	595	610	+	15	Q96P26-1	357	610	ENST00000418427.1	34	793	++	79	Q96P26-1#10	0	45	ENST00000418427.1	748	793	+	45	0	-30	5174
Q96P26-1#10	0	15	15	Q96P26-1	595	610	+	15	Q96P26-1	0	610	ENST00000359846.6	78	1908	++	38	Q96P26-1#10	0	45	ENST00000359846.6	1863	1908	+	45	0	-30	5175
Q96P26-1#10	0	15	15	Q96P26-1	595	610	+	15	Q96P26-1	99	610	ENST00000304081.9	218	1751	++	22	Q96P26-1#10	0	45	ENST00000304081.9	1706	1751	+	45	0	-30	5176
Q96P26-1#11	0	1	1	Q96P26-1	172	173	+	1	Q96P26-1	0	188	ENST00000416783.1	68	683	++	77	Q96P26-1#11	0	3	ENST00000416783.1	635	638	+	3	0	-2	5177
Q96P26-1#11	0	1	1	Q96P26-1	172	173	+	1	Q96P26-1	0	610	ENST00000359846.6	78	1908	++	38	Q96P26-1#11	0	3	ENST00000359846.6	594	597	+	3	0	-2	5178
Q96P26-1#11	0	1	1	Q96P26-1	172	173	+	1	Q96P26-1	99	610	ENST00000304081.9	218	1751	++	22	Q96P26-1#11	0	3	ENST00000304081.9	437	440	+	3	0	-2	5179
Q96P26-1#12	0	1	1	Q96P26-1	286	287	+	1	Q96P26-1	0	610	ENST00000359846.6	78	1908	++	38	Q96P26-1#12	0	3	ENST00000359846.6	936	939	+	3	0	-2	5180
Q96P26-1#12	0	1	1	Q96P26-1	286	287	+	1	Q96P26-1	99	610	ENST00000304081.9	218	1751	++	22	Q96P26-1#12	0	3	ENST00000304081.9	779	782	+	3	0	-2	5181
Q96P26-1#13	0	1	1	Q96P26-1	296	297	+	1	Q96P26-1	0	610	ENST00000359846.6	78	1908	++	38	Q96P26-1#13	0	3	ENST00000359846.6	966	969	+	3	0	-2	5182
Q96P26-1#13	0	1	1	Q96P26-1	296	297	+	1	Q96P26-1	99	610	ENST00000304081.9	218	1751	++	22	Q96P26-1#13	0	3	ENST00000304081.9	809	812	+	3	0	-2	5183
Q96P26-1#14	0	1	1	Q96P26-1	350	351	+	1	Q96P26-1	0	610	ENST00000359846.6	78	1908	++	38	Q96P26-1#14	0	3	ENST00000359846.6	1128	1131	+	3	0	-2	5184
Q96P26-1#14	0	1	1	Q96P26-1	350	351	+	1	Q96P26-1	99	610	ENST00000304081.9	218	1751	++	22	Q96P26-1#14	0	3	ENST00000304081.9	971	974	+	3	0	-2	5185
Q96P26-1#15	0	1	1	Q96P26-1	361	362	+	1	Q96P26-1	357	610	ENST00000418427.1	34	793	++	79	Q96P26-1#15	0	3	ENST00000418427.1	46	49	+	3	0	-2	5186
Q96P26-1#15	0	1	1	Q96P26-1	361	362	+	1	Q96P26-1	0	610	ENST00000359846.6	78	1908	++	38	Q96P26-1#15	0	3	ENST00000359846.6	1161	1164	+	3	0	-2	5187
Q96P26-1#15	0	1	1	Q96P26-1	361	362	+	1	Q96P26-1	99	610	ENST00000304081.9	218	1751	++	22	Q96P26-1#15	0	3	ENST00000304081.9	1004	1007	+	3	0	-2	5188
Q96P26-1#16	0	1	1	Q96P26-1	527	528	+	1	Q96P26-1	357	610	ENST00000418427.1	34	793	++	79	Q96P26-1#16	0	3	ENST00000418427.1	544	547	+	3	0	-2	5189
Q96P26-1#16	0	1	1	Q96P26-1	527	528	+	1	Q96P26-1	0	610	ENST00000359846.6	78	1908	++	38	Q96P26-1#16	0	3	ENST00000359846.6	1659	1662	+	3	0	-2	5190
Q96P26-1#16	0	1	1	Q96P26-1	527	528	+	1	Q96P26-1	99	610	ENST00000304081.9	218	1751	++	22	Q96P26-1#16	0	3	ENST00000304081.9	1502	1505	+	3	0	-2	5191
Q96P26-1#17	0	1	1	Q96P26-1	551	552	+	1	Q96P26-1	357	610	ENST00000418427.1	34	793	++	79	Q96P26-1#17	0	3	ENST00000418427.1	616	619	+	3	0	-2	5192
Q96P26-1#17	0	1	1	Q96P26-1	551	552	+	1	Q96P26-1	0	610	ENST00000359846.6	78	1908	++	38	Q96P26-1#17	0	3	ENST00000359846.6	1731	1734	+	3	0	-2	5193
Q96P26-1#17	0	1	1	Q96P26-1	551	552	+	1	Q96P26-1	99	610	ENST00000304081.9	218	1751	++	22	Q96P26-1#17	0	3	ENST00000304081.9	1574	1577	+	3	0	-2	5194
Q9H0P0-4#0	0	336	336	Q9H0P0-4	0	336	+	336	Q9H0P0-4	48	336	ENST00000643244.1	75	939	++	228	Q9H0P0-4#0	144	1008	ENST00000643244.1	75	939	+	864	144	-672	5195
Q9H0P0-4#0	0	336	336	Q9H0P0-4	0	336	+	336	Q9H0P0-4	5	336	ENST00000610140.7	71	1064	++	220	Q9H0P0-4#0	15	1008	ENST00000610140.7	71	1064	+	993	15	-672	5196
Q9H0P0-4#0	0	336	336	Q9H0P0-4	0	336	+	336	Q9H0P0-4	0	51	ENST00000456458.5	76	229	++	104	Q9H0P0-4#0	0	153	ENST00000456458.5	76	229	+	153	0	183	5197
Q9H0P0-4#0	0	336	336	Q9H0P0-4	0	336	+	336	Q9H0P0-4	51	93	ENST00000449201.5	179	305	++	99	Q9H0P0-4#0	153	279	ENST00000449201.5	179	305	+	126	153	57	5198
Q9H0P0-4#0	0	336	336	Q9H0P0-4	0	336	+	336	Q9H0P0-4	48	236	ENST00000409787.4	41	605	++	70	Q9H0P0-4#0	144	708	ENST00000409787.4	41	605	+	564	144	-372	5199
Q9H0P0-4#0	0	336	336	Q9H0P0-4	0	336	+	336	Q9H0P0-4	51	336	ENST00000409467.6	174	1029	++	69	Q9H0P0-4#0	153	1008	ENST00000409467.6	174	1029	+	855	153	-672	5200
Q9H0P0-4#1	0	1	1	Q9H0P0-4	87	88	+	1	Q9H0P0-4	48	336	ENST00000643244.1	75	939	++	228	Q9H0P0-4#1	0	3	ENST00000643244.1	192	195	+	3	0	-2	5201
Q9H0P0-4#1	0	1	1	Q9H0P0-4	87	88	+	1	Q9H0P0-4	5	336	ENST00000610140.7	71	1064	++	220	Q9H0P0-4#1	0	3	ENST00000610140.7	317	320	+	3	0	-2	5202
Q9H0P0-4#1	0	1	1	Q9H0P0-4	87	88	+	1	Q9H0P0-4	51	93	ENST00000449201.5	179	305	++	99	Q9H0P0-4#1	0	3	ENST00000449201.5	287	290	+	3	0	-2	5203
Q9H0P0-4#1	0	1	1	Q9H0P0-4	87	88	+	1	Q9H0P0-4	48	236	ENST00000409787.4	41	605	++	70	Q9H0P0-4#1	0	3	ENST00000409787.4	158	161	+	3	0	-2	5204
Q9H0P0-4#1	0	1	1	Q9H0P0-4	87	88	+	1	Q9H0P0-4	51	336	ENST00000409467.6	174	1029	++	69	Q9H0P0-4#1	0	3	ENST00000409467.6	282	285	+	3	0	-2	5205
Q9H0P0-4#2	0	1	1	Q9H0P0-4	89	90	+	1	Q9H0P0-4	48	336	ENST00000643244.1	75	939	++	228	Q9H0P0-4#2	0	3	ENST00000643244.1	198	201	+	3	0	-2	5206
Q9H0P0-4#2	0	1	1	Q9H0P0-4	89	90	+	1	Q9H0P0-4	5	336	ENST00000610140.7	71	1064	++	220	Q9H0P0-4#2	0	3	ENST00000610140.7	323	326	+	3	0	-2	5207
Q9H0P0-4#2	0	1	1	Q9H0P0-4	89	90	+	1	Q9H0P0-4	51	93	ENST00000449201.5	179	305	++	99	Q9H0P0-4#2	0	3	ENST00000449201.5	293	296	+	3	0	-2	5208
Q9H0P0-4#2	0	1	1	Q9H0P0-4	89	90	+	1	Q9H0P0-4	48	236	ENST00000409787.4	41	605	++	70	Q9H0P0-4#2	0	3	ENST00000409787.4	164	167	+	3	0	-2	5209
Q9H0P0-4#2	0	1	1	Q9H0P0-4	89	90	+	1	Q9H0P0-4	51	336	ENST00000409467.6	174	1029	++	69	Q9H0P0-4#2	0	3	ENST00000409467.6	288	291	+	3	0	-2	5210
Q9H0P0-4#3	0	1	1	Q9H0P0-4	87	88	+	1	Q9H0P0-4	48	336	ENST00000643244.1	75	939	++	228	Q9H0P0-4#3	0	3	ENST00000643244.1	192	195	+	3	0	-2	5211
Q9H0P0-4#3	0	1	1	Q9H0P0-4	87	88	+	1	Q9H0P0-4	5	336	ENST00000610140.7	71	1064	++	220	Q9H0P0-4#3	0	3	ENST00000610140.7	317	320	+	3	0	-2	5212
Q9H0P0-4#3	0	1	1	Q9H0P0-4	87	88	+	1	Q9H0P0-4	51	93	ENST00000449201.5	179	305	++	99	Q9H0P0-4#3	0	3	ENST00000449201.5	287	290	+	3	0	-2	5213
Q9H0P0-4#3	0	1	1	Q9H0P0-4	87	88	+	1	Q9H0P0-4	48	236	ENST00000409787.4	41	605	++	70	Q9H0P0-4#3	0	3	ENST00000409787.4	158	161	+	3	0	-2	5214
Q9H0P0-4#3	0	1	1	Q9H0P0-4	87	88	+	1	Q9H0P0-4	51	336	ENST00000409467.6	174	1029	++	69	Q9H0P0-4#3	0	3	ENST00000409467.6	282	285	+	3	0	-2	5215
Q9H0P0-4#4	0	1	1	Q9H0P0-4	89	90	+	1	Q9H0P0-4	48	336	ENST00000643244.1	75	939	++	228	Q9H0P0-4#4	0	3	ENST00000643244.1	198	201	+	3	0	-2	5216
Q9H0P0-4#4	0	1	1	Q9H0P0-4	89	90	+	1	Q9H0P0-4	5	336	ENST00000610140.7	71	1064	++	220	Q9H0P0-4#4	0	3	ENST00000610140.7	323	326	+	3	0	-2	5217
Q9H0P0-4#4	0	1	1	Q9H0P0-4	89	90	+	1	Q9H0P0-4	51	93	ENST00000449201.5	179	305	++	99	Q9H0P0-4#4	0	3	ENST00000449201.5	293	296	+	3	0	-2	5218
Q9H0P0-4#4	0	1	1	Q9H0P0-4	89	90	+	1	Q9H0P0-4	48	236	ENST00000409787.4	41	605	++	70	Q9H0P0-4#4	0	3	ENST00000409787.4	164	167	+	3	0	-2	5219
Q9H0P0-4#4	0	1	1	Q9H0P0-4	89	90	+	1	Q9H0P0-4	51	336	ENST00000409467.6	174	1029	++	69	Q9H0P0-4#4	0	3	ENST00000409467.6	288	291	+	3	0	-2	5220
Q9H0P0-4#5	0	1	1	Q9H0P0-4	134	135	+	1	Q9H0P0-4	48	336	ENST00000643244.1	75	939	++	228	Q9H0P0-4#5	0	3	ENST00000643244.1	333	336	+	3	0	-2	5221
Q9H0P0-4#5	0	1	1	Q9H0P0-4	134	135	+	1	Q9H0P0-4	5	336	ENST00000610140.7	71	1064	++	220	Q9H0P0-4#5	0	3	ENST00000610140.7	458	461	+	3	0	-2	5222
Q9H0P0-4#5	0	1	1	Q9H0P0-4	134	135	+	1	Q9H0P0-4	48	236	ENST00000409787.4	41	605	++	70	Q9H0P0-4#5	0	3	ENST00000409787.4	299	302	+	3	0	-2	5223
Q9H0P0-4#5	0	1	1	Q9H0P0-4	134	135	+	1	Q9H0P0-4	51	336	ENST00000409467.6	174	1029	++	69	Q9H0P0-4#5	0	3	ENST00000409467.6	423	426	+	3	0	-2	5224
Q9H0P0-4#6	0	1	1	Q9H0P0-4	134	135	+	1	Q9H0P0-4	48	336	ENST00000643244.1	75	939	++	228	Q9H0P0-4#6	0	3	ENST00000643244.1	333	336	+	3	0	-2	5225
Q9H0P0-4#6	0	1	1	Q9H0P0-4	134	135	+	1	Q9H0P0-4	5	336	ENST00000610140.7	71	1064	++	220	Q9H0P0-4#6	0	3	ENST00000610140.7	458	461	+	3	0	-2	5226
Q9H0P0-4#6	0	1	1	Q9H0P0-4	134	135	+	1	Q9H0P0-4	48	236	ENST00000409787.4	41	605	++	70	Q9H0P0-4#6	0	3	ENST00000409787.4	299	302	+	3	0	-2	5227
Q9H0P0-4#6	0	1	1	Q9H0P0-4	134	135	+	1	Q9H0P0-4	51	336	ENST00000409467.6	174	1029	++	69	Q9H0P0-4#6	0	3	ENST00000409467.6	423	426	+	3	0	-2	5228
Q9H0P0-4#7	0	1	1	Q9H0P0-4	155	156	+	1	Q9H0P0-4	48	336	ENST00000643244.1	75	939	++	228	Q9H0P0-4#7	0	3	ENST00000643244.1	396	399	+	3	0	-2	5229
Q9H0P0-4#7	0	1	1	Q9H0P0-4	155	156	+	1	Q9H0P0-4	5	336	ENST00000610140.7	71	1064	++	220	Q9H0P0-4#7	0	3	ENST00000610140.7	521	524	+	3	0	-2	5230
Q9H0P0-4#7	0	1	1	Q9H0P0-4	155	156	+	1	Q9H0P0-4	48	236	ENST00000409787.4	41	605	++	70	Q9H0P0-4#7	0	3	ENST00000409787.4	362	365	+	3	0	-2	5231
Q9H0P0-4#7	0	1	1	Q9H0P0-4	155	156	+	1	Q9H0P0-4	51	336	ENST00000409467.6	174	1029	++	69	Q9H0P0-4#7	0	3	ENST00000409467.6	486	489	+	3	0	-2	5232
Q9H0P0-4#8	0	2	2	Q9H0P0-4	202	204	+	2	Q9H0P0-4	48	336	ENST00000643244.1	75	939	++	228	Q9H0P0-4#8	0	6	ENST00000643244.1	537	543	+	6	0	-4	5233
Q9H0P0-4#8	0	2	2	Q9H0P0-4	202	204	+	2	Q9H0P0-4	5	336	ENST00000610140.7	71	1064	++	220	Q9H0P0-4#8	0	6	ENST00000610140.7	662	668	+	6	0	-4	5234
Q9H0P0-4#8	0	2	2	Q9H0P0-4	202	204	+	2	Q9H0P0-4	48	236	ENST00000409787.4	41	605	++	70	Q9H0P0-4#8	0	6	ENST00000409787.4	503	509	+	6	0	-4	5235
Q9H0P0-4#8	0	2	2	Q9H0P0-4	202	204	+	2	Q9H0P0-4	51	336	ENST00000409467.6	174	1029	++	69	Q9H0P0-4#8	0	6	ENST00000409467.6	627	633	+	6	0	-4	5236
Q9H0P0-4#9	0	1	1	Q9H0P0-4	251	252	+	1	Q9H0P0-4	48	336	ENST00000643244.1	75	939	++	228	Q9H0P0-4#9	0	3	ENST00000643244.1	684	687	+	3	0	-2	5237
Q9H0P0-4#9	0	1	1	Q9H0P0-4	251	252	+	1	Q9H0P0-4	5	336	ENST00000610140.7	71	1064	++	220	Q9H0P0-4#9	0	3	ENST00000610140.7	809	812	+	3	0	-2	5238
Q9H0P0-4#9	0	1	1	Q9H0P0-4	251	252	+	1	Q9H0P0-4	51	336	ENST00000409467.6	174	1029	++	69	Q9H0P0-4#9	0	3	ENST00000409467.6	774	777	+	3	0	-2	5239
Q9H0P0-4#10	0	1	1	Q9H0P0-4	276	277	+	1	Q9H0P0-4	48	336	ENST00000643244.1	75	939	++	228	Q9H0P0-4#10	0	3	ENST00000643244.1	759	762	+	3	0	-2	5240
Q9H0P0-4#10	0	1	1	Q9H0P0-4	276	277	+	1	Q9H0P0-4	5	336	ENST00000610140.7	71	1064	++	220	Q9H0P0-4#10	0	3	ENST00000610140.7	884	887	+	3	0	-2	5241
Q9H0P0-4#10	0	1	1	Q9H0P0-4	276	277	+	1	Q9H0P0-4	51	336	ENST00000409467.6	174	1029	++	69	Q9H0P0-4#10	0	3	ENST00000409467.6	849	852	+	3	0	-2	5242
Q9H0P0-4#11	0	1	1	Q9H0P0-4	277	278	+	1	Q9H0P0-4	48	336	ENST00000643244.1	75	939	++	228	Q9H0P0-4#11	0	3	ENST00000643244.1	762	765	+	3	0	-2	5243
Q9H0P0-4#11	0	1	1	Q9H0P0-4	277	278	+	1	Q9H0P0-4	5	336	ENST00000610140.7	71	1064	++	220	Q9H0P0-4#11	0	3	ENST00000610140.7	887	890	+	3	0	-2	5244
Q9H0P0-4#11	0	1	1	Q9H0P0-4	277	278	+	1	Q9H0P0-4	51	336	ENST00000409467.6	174	1029	++	69	Q9H0P0-4#11	0	3	ENST00000409467.6	852	855	+	3	0	-2	5245
Q9H0P0-4#12	0	51	51	Q9H0P0-4	0	51	+	51	Q9H0P0-4	48	336	ENST00000643244.1	75	939	++	228	Q9H0P0-4#12	144	153	ENST00000643244.1	75	84	+	9	144	-102	5246
Q9H0P0-4#12	0	51	51	Q9H0P0-4	0	51	+	51	Q9H0P0-4	5	336	ENST00000610140.7	71	1064	++	220	Q9H0P0-4#12	15	153	ENST00000610140.7	71	209	+	138	15	-102	5247
Q9H0P0-4#12	0	51	51	Q9H0P0-4	0	51	+	51	Q9H0P0-4	0	51	ENST00000456458.5	76	229	++	104	Q9H0P0-4#12	0	153	ENST00000456458.5	76	229	+	153	0	-102	5248
Q9H0P0-4#12	0	51	51	Q9H0P0-4	0	51	+	51	Q9H0P0-4	48	236	ENST00000409787.4	41	605	++	70	Q9H0P0-4#12	144	153	ENST00000409787.4	41	50	+	9	144	-102	5249
Q9H0P0-4#13	0	50	50	Q9H0P0-4	0	50	+	50	Q9H0P0-4	48	336	ENST00000643244.1	75	939	++	228	Q9H0P0-4#13	144	150	ENST00000643244.1	75	81	+	6	144	-100	5250
Q9H0P0-4#13	0	50	50	Q9H0P0-4	0	50	+	50	Q9H0P0-4	5	336	ENST00000610140.7	71	1064	++	220	Q9H0P0-4#13	15	150	ENST00000610140.7	71	206	+	135	15	-100	5251
Q9H0P0-4#13	0	50	50	Q9H0P0-4	0	50	+	50	Q9H0P0-4	0	51	ENST00000456458.5	76	229	++	104	Q9H0P0-4#13	0	150	ENST00000456458.5	76	226	+	150	0	-100	5252
Q9H0P0-4#13	0	50	50	Q9H0P0-4	0	50	+	50	Q9H0P0-4	48	236	ENST00000409787.4	41	605	++	70	Q9H0P0-4#13	144	150	ENST00000409787.4	41	47	+	6	144	-100	5253
Q9H0P0-4#14	0	50	50	Q9H0P0-4	0	50	+	50	Q9H0P0-4	48	336	ENST00000643244.1	75	939	++	228	Q9H0P0-4#14	144	150	ENST00000643244.1	75	81	+	6	144	-100	5254
Q9H0P0-4#14	0	50	50	Q9H0P0-4	0	50	+	50	Q9H0P0-4	5	336	ENST00000610140.7	71	1064	++	220	Q9H0P0-4#14	15	150	ENST00000610140.7	71	206	+	135	15	-100	5255
Q9H0P0-4#14	0	50	50	Q9H0P0-4	0	50	+	50	Q9H0P0-4	0	51	ENST00000456458.5	76	229	++	104	Q9H0P0-4#14	0	150	ENST00000456458.5	76	226	+	150	0	-100	5256
Q9H0P0-4#14	0	50	50	Q9H0P0-4	0	50	+	50	Q9H0P0-4	48	236	ENST00000409787.4	41	605	++	70	Q9H0P0-4#14	144	150	ENST00000409787.4	41	47	+	6	144	-100	5257
Q9H0P0-4#15	0	1	1	Q9H0P0-4	94	95	+	1	Q9H0P0-4	48	336	ENST00000643244.1	75	939	++	228	Q9H0P0-4#15	0	3	ENST00000643244.1	213	216	+	3	0	-2	5258
Q9H0P0-4#15	0	1	1	Q9H0P0-4	94	95	+	1	Q9H0P0-4	5	336	ENST00000610140.7	71	1064	++	220	Q9H0P0-4#15	0	3	ENST00000610140.7	338	341	+	3	0	-2	5259
Q9H0P0-4#15	0	1	1	Q9H0P0-4	94	95	+	1	Q9H0P0-4	48	236	ENST00000409787.4	41	605	++	70	Q9H0P0-4#15	0	3	ENST00000409787.4	179	182	+	3	0	-2	5260
Q9H0P0-4#15	0	1	1	Q9H0P0-4	94	95	+	1	Q9H0P0-4	51	336	ENST00000409467.6	174	1029	++	69	Q9H0P0-4#15	0	3	ENST00000409467.6	303	306	+	3	0	-2	5261
Q9H0P0-4#16	0	1	1	Q9H0P0-4	112	113	+	1	Q9H0P0-4	48	336	ENST00000643244.1	75	939	++	228	Q9H0P0-4#16	0	3	ENST00000643244.1	267	270	+	3	0	-2	5262
Q9H0P0-4#16	0	1	1	Q9H0P0-4	112	113	+	1	Q9H0P0-4	5	336	ENST00000610140.7	71	1064	++	220	Q9H0P0-4#16	0	3	ENST00000610140.7	392	395	+	3	0	-2	5263
Q9H0P0-4#16	0	1	1	Q9H0P0-4	112	113	+	1	Q9H0P0-4	48	236	ENST00000409787.4	41	605	++	70	Q9H0P0-4#16	0	3	ENST00000409787.4	233	236	+	3	0	-2	5264
Q9H0P0-4#16	0	1	1	Q9H0P0-4	112	113	+	1	Q9H0P0-4	51	336	ENST00000409467.6	174	1029	++	69	Q9H0P0-4#16	0	3	ENST00000409467.6	357	360	+	3	0	-2	5265
Q9H0P0-4#17	0	1	1	Q9H0P0-4	136	137	+	1	Q9H0P0-4	48	336	ENST00000643244.1	75	939	++	228	Q9H0P0-4#17	0	3	ENST00000643244.1	339	342	+	3	0	-2	5266
Q9H0P0-4#17	0	1	1	Q9H0P0-4	136	137	+	1	Q9H0P0-4	5	336	ENST00000610140.7	71	1064	++	220	Q9H0P0-4#17	0	3	ENST00000610140.7	464	467	+	3	0	-2	5267
Q9H0P0-4#17	0	1	1	Q9H0P0-4	136	137	+	1	Q9H0P0-4	48	236	ENST00000409787.4	41	605	++	70	Q9H0P0-4#17	0	3	ENST00000409787.4	305	308	+	3	0	-2	5268
Q9H0P0-4#17	0	1	1	Q9H0P0-4	136	137	+	1	Q9H0P0-4	51	336	ENST00000409467.6	174	1029	++	69	Q9H0P0-4#17	0	3	ENST00000409467.6	429	432	+	3	0	-2	5269
Q9H0P0-4#18	0	1	1	Q9H0P0-4	180	181	+	1	Q9H0P0-4	48	336	ENST00000643244.1	75	939	++	228	Q9H0P0-4#18	0	3	ENST00000643244.1	471	474	+	3	0	-2	5270
Q9H0P0-4#18	0	1	1	Q9H0P0-4	180	181	+	1	Q9H0P0-4	5	336	ENST00000610140.7	71	1064	++	220	Q9H0P0-4#18	0	3	ENST00000610140.7	596	599	+	3	0	-2	5271
Q9H0P0-4#18	0	1	1	Q9H0P0-4	180	181	+	1	Q9H0P0-4	48	236	ENST00000409787.4	41	605	++	70	Q9H0P0-4#18	0	3	ENST00000409787.4	437	440	+	3	0	-2	5272
Q9H0P0-4#18	0	1	1	Q9H0P0-4	180	181	+	1	Q9H0P0-4	51	336	ENST00000409467.6	174	1029	++	69	Q9H0P0-4#18	0	3	ENST00000409467.6	561	564	+	3	0	-2	5273
Q9H0P0-4#19	0	1	1	Q9H0P0-4	206	207	+	1	Q9H0P0-4	48	336	ENST00000643244.1	75	939	++	228	Q9H0P0-4#19	0	3	ENST00000643244.1	549	552	+	3	0	-2	5274
Q9H0P0-4#19	0	1	1	Q9H0P0-4	206	207	+	1	Q9H0P0-4	5	336	ENST00000610140.7	71	1064	++	220	Q9H0P0-4#19	0	3	ENST00000610140.7	674	677	+	3	0	-2	5275
Q9H0P0-4#19	0	1	1	Q9H0P0-4	206	207	+	1	Q9H0P0-4	48	236	ENST00000409787.4	41	605	++	70	Q9H0P0-4#19	0	3	ENST00000409787.4	515	518	+	3	0	-2	5276
Q9H0P0-4#19	0	1	1	Q9H0P0-4	206	207	+	1	Q9H0P0-4	51	336	ENST00000409467.6	174	1029	++	69	Q9H0P0-4#19	0	3	ENST00000409467.6	639	642	+	3	0	-2	5277
Q9H0P0-4#20	0	1	1	Q9H0P0-4	228	229	+	1	Q9H0P0-4	48	336	ENST00000643244.1	75	939	++	228	Q9H0P0-4#20	0	3	ENST00000643244.1	615	618	+	3	0	-2	5278
Q9H0P0-4#20	0	1	1	Q9H0P0-4	228	229	+	1	Q9H0P0-4	5	336	ENST00000610140.7	71	1064	++	220	Q9H0P0-4#20	0	3	ENST00000610140.7	740	743	+	3	0	-2	5279
Q9H0P0-4#20	0	1	1	Q9H0P0-4	228	229	+	1	Q9H0P0-4	48	236	ENST00000409787.4	41	605	++	70	Q9H0P0-4#20	0	3	ENST00000409787.4	581	584	+	3	0	-2	5280
Q9H0P0-4#20	0	1	1	Q9H0P0-4	228	229	+	1	Q9H0P0-4	51	336	ENST00000409467.6	174	1029	++	69	Q9H0P0-4#20	0	3	ENST00000409467.6	705	708	+	3	0	-2	5281
Q9H0P0-4#21	0	1	1	Q9H0P0-4	279	280	+	1	Q9H0P0-4	48	336	ENST00000643244.1	75	939	++	228	Q9H0P0-4#21	0	3	ENST00000643244.1	768	771	+	3	0	-2	5282
Q9H0P0-4#21	0	1	1	Q9H0P0-4	279	280	+	1	Q9H0P0-4	5	336	ENST00000610140.7	71	1064	++	220	Q9H0P0-4#21	0	3	ENST00000610140.7	893	896	+	3	0	-2	5283
Q9H0P0-4#21	0	1	1	Q9H0P0-4	279	280	+	1	Q9H0P0-4	51	336	ENST00000409467.6	174	1029	++	69	Q9H0P0-4#21	0	3	ENST00000409467.6	858	861	+	3	0	-2	5284
Q9H0P0-4#22	0	1	1	Q9H0P0-4	296	297	+	1	Q9H0P0-4	48	336	ENST00000643244.1	75	939	++	228	Q9H0P0-4#22	0	3	ENST00000643244.1	819	822	+	3	0	-2	5285
Q9H0P0-4#22	0	1	1	Q9H0P0-4	296	297	+	1	Q9H0P0-4	5	336	ENST00000610140.7	71	1064	++	220	Q9H0P0-4#22	0	3	ENST00000610140.7	944	947	+	3	0	-2	5286
Q9H0P0-4#22	0	1	1	Q9H0P0-4	296	297	+	1	Q9H0P0-4	51	336	ENST00000409467.6	174	1029	++	69	Q9H0P0-4#22	0	3	ENST00000409467.6	909	912	+	3	0	-2	5287
Q9H0P0-4#23	0	1	1	Q9H0P0-4	87	88	+	1	Q9H0P0-4	48	336	ENST00000643244.1	75	939	++	228	Q9H0P0-4#23	0	3	ENST00000643244.1	192	195	+	3	0	-2	5288
Q9H0P0-4#23	0	1	1	Q9H0P0-4	87	88	+	1	Q9H0P0-4	5	336	ENST00000610140.7	71	1064	++	220	Q9H0P0-4#23	0	3	ENST00000610140.7	317	320	+	3	0	-2	5289
Q9H0P0-4#23	0	1	1	Q9H0P0-4	87	88	+	1	Q9H0P0-4	51	93	ENST00000449201.5	179	305	++	99	Q9H0P0-4#23	0	3	ENST00000449201.5	287	290	+	3	0	-2	5290
Q9H0P0-4#23	0	1	1	Q9H0P0-4	87	88	+	1	Q9H0P0-4	48	236	ENST00000409787.4	41	605	++	70	Q9H0P0-4#23	0	3	ENST00000409787.4	158	161	+	3	0	-2	5291
Q9H0P0-4#23	0	1	1	Q9H0P0-4	87	88	+	1	Q9H0P0-4	51	336	ENST00000409467.6	174	1029	++	69	Q9H0P0-4#23	0	3	ENST00000409467.6	282	285	+	3	0	-2	5292
Q9H0P0-4#24	0	1	1	Q9H0P0-4	88	89	+	1	Q9H0P0-4	48	336	ENST00000643244.1	75	939	++	228	Q9H0P0-4#24	0	3	ENST00000643244.1	195	198	+	3	0	-2	5293
Q9H0P0-4#24	0	1	1	Q9H0P0-4	88	89	+	1	Q9H0P0-4	5	336	ENST00000610140.7	71	1064	++	220	Q9H0P0-4#24	0	3	ENST00000610140.7	320	323	+	3	0	-2	5294
Q9H0P0-4#24	0	1	1	Q9H0P0-4	88	89	+	1	Q9H0P0-4	51	93	ENST00000449201.5	179	305	++	99	Q9H0P0-4#24	0	3	ENST00000449201.5	290	293	+	3	0	-2	5295
Q9H0P0-4#24	0	1	1	Q9H0P0-4	88	89	+	1	Q9H0P0-4	48	236	ENST00000409787.4	41	605	++	70	Q9H0P0-4#24	0	3	ENST00000409787.4	161	164	+	3	0	-2	5296
Q9H0P0-4#24	0	1	1	Q9H0P0-4	88	89	+	1	Q9H0P0-4	51	336	ENST00000409467.6	174	1029	++	69	Q9H0P0-4#24	0	3	ENST00000409467.6	285	288	+	3	0	-2	5297
Q9H0P0-4#25	0	1	1	Q9H0P0-4	89	90	+	1	Q9H0P0-4	48	336	ENST00000643244.1	75	939	++	228	Q9H0P0-4#25	0	3	ENST00000643244.1	198	201	+	3	0	-2	5298
Q9H0P0-4#25	0	1	1	Q9H0P0-4	89	90	+	1	Q9H0P0-4	5	336	ENST00000610140.7	71	1064	++	220	Q9H0P0-4#25	0	3	ENST00000610140.7	323	326	+	3	0	-2	5299
Q9H0P0-4#25	0	1	1	Q9H0P0-4	89	90	+	1	Q9H0P0-4	51	93	ENST00000449201.5	179	305	++	99	Q9H0P0-4#25	0	3	ENST00000449201.5	293	296	+	3	0	-2	5300
Q9H0P0-4#25	0	1	1	Q9H0P0-4	89	90	+	1	Q9H0P0-4	48	236	ENST00000409787.4	41	605	++	70	Q9H0P0-4#25	0	3	ENST00000409787.4	164	167	+	3	0	-2	5301
Q9H0P0-4#25	0	1	1	Q9H0P0-4	89	90	+	1	Q9H0P0-4	51	336	ENST00000409467.6	174	1029	++	69	Q9H0P0-4#25	0	3	ENST00000409467.6	288	291	+	3	0	-2	5302
Q9H0P0-4#26	0	1	1	Q9H0P0-4	134	135	+	1	Q9H0P0-4	48	336	ENST00000643244.1	75	939	++	228	Q9H0P0-4#26	0	3	ENST00000643244.1	333	336	+	3	0	-2	5303
Q9H0P0-4#26	0	1	1	Q9H0P0-4	134	135	+	1	Q9H0P0-4	5	336	ENST00000610140.7	71	1064	++	220	Q9H0P0-4#26	0	3	ENST00000610140.7	458	461	+	3	0	-2	5304
Q9H0P0-4#26	0	1	1	Q9H0P0-4	134	135	+	1	Q9H0P0-4	48	236	ENST00000409787.4	41	605	++	70	Q9H0P0-4#26	0	3	ENST00000409787.4	299	302	+	3	0	-2	5305
Q9H0P0-4#26	0	1	1	Q9H0P0-4	134	135	+	1	Q9H0P0-4	51	336	ENST00000409467.6	174	1029	++	69	Q9H0P0-4#26	0	3	ENST00000409467.6	423	426	+	3	0	-2	5306
Q9H0P0-4#27	0	1	1	Q9H0P0-4	231	232	+	1	Q9H0P0-4	48	336	ENST00000643244.1	75	939	++	228	Q9H0P0-4#27	0	3	ENST00000643244.1	624	627	+	3	0	-2	5307
Q9H0P0-4#27	0	1	1	Q9H0P0-4	231	232	+	1	Q9H0P0-4	5	336	ENST00000610140.7	71	1064	++	220	Q9H0P0-4#27	0	3	ENST00000610140.7	749	752	+	3	0	-2	5308
Q9H0P0-4#27	0	1	1	Q9H0P0-4	231	232	+	1	Q9H0P0-4	48	236	ENST00000409787.4	41	605	++	70	Q9H0P0-4#27	0	3	ENST00000409787.4	590	593	+	3	0	-2	5309
Q9H0P0-4#27	0	1	1	Q9H0P0-4	231	232	+	1	Q9H0P0-4	51	336	ENST00000409467.6	174	1029	++	69	Q9H0P0-4#27	0	3	ENST00000409467.6	714	717	+	3	0	-2	5310
Q9H0P0-4#28	0	1	1	Q9H0P0-4	232	233	+	1	Q9H0P0-4	48	336	ENST00000643244.1	75	939	++	228	Q9H0P0-4#28	0	3	ENST00000643244.1	627	630	+	3	0	-2	5311
Q9H0P0-4#28	0	1	1	Q9H0P0-4	232	233	+	1	Q9H0P0-4	5	336	ENST00000610140.7	71	1064	++	220	Q9H0P0-4#28	0	3	ENST00000610140.7	752	755	+	3	0	-2	5312
Q9H0P0-4#28	0	1	1	Q9H0P0-4	232	233	+	1	Q9H0P0-4	48	236	ENST00000409787.4	41	605	++	70	Q9H0P0-4#28	0	3	ENST00000409787.4	593	596	+	3	0	-2	5313
Q9H0P0-4#28	0	1	1	Q9H0P0-4	232	233	+	1	Q9H0P0-4	51	336	ENST00000409467.6	174	1029	++	69	Q9H0P0-4#28	0	3	ENST00000409467.6	717	720	+	3	0	-2	5314
Q9H0P0-4#29	0	1	1	Q9H0P0-4	233	234	+	1	Q9H0P0-4	48	336	ENST00000643244.1	75	939	++	228	Q9H0P0-4#29	0	3	ENST00000643244.1	630	633	+	3	0	-2	5315
Q9H0P0-4#29	0	1	1	Q9H0P0-4	233	234	+	1	Q9H0P0-4	5	336	ENST00000610140.7	71	1064	++	220	Q9H0P0-4#29	0	3	ENST00000610140.7	755	758	+	3	0	-2	5316
Q9H0P0-4#29	0	1	1	Q9H0P0-4	233	234	+	1	Q9H0P0-4	48	236	ENST00000409787.4	41	605	++	70	Q9H0P0-4#29	0	3	ENST00000409787.4	596	599	+	3	0	-2	5317
Q9H0P0-4#29	0	1	1	Q9H0P0-4	233	234	+	1	Q9H0P0-4	51	336	ENST00000409467.6	174	1029	++	69	Q9H0P0-4#29	0	3	ENST00000409467.6	720	723	+	3	0	-2	5318
Q9H0P0-4#30	0	1	1	Q9H0P0-4	94	95	+	1	Q9H0P0-4	48	336	ENST00000643244.1	75	939	++	228	Q9H0P0-4#30	0	3	ENST00000643244.1	213	216	+	3	0	-2	5319
Q9H0P0-4#30	0	1	1	Q9H0P0-4	94	95	+	1	Q9H0P0-4	5	336	ENST00000610140.7	71	1064	++	220	Q9H0P0-4#30	0	3	ENST00000610140.7	338	341	+	3	0	-2	5320
Q9H0P0-4#30	0	1	1	Q9H0P0-4	94	95	+	1	Q9H0P0-4	48	236	ENST00000409787.4	41	605	++	70	Q9H0P0-4#30	0	3	ENST00000409787.4	179	182	+	3	0	-2	5321
Q9H0P0-4#30	0	1	1	Q9H0P0-4	94	95	+	1	Q9H0P0-4	51	336	ENST00000409467.6	174	1029	++	69	Q9H0P0-4#30	0	3	ENST00000409467.6	303	306	+	3	0	-2	5322
Q9H0P0-4#31	0	1	1	Q9H0P0-4	143	144	+	1	Q9H0P0-4	48	336	ENST00000643244.1	75	939	++	228	Q9H0P0-4#31	0	3	ENST00000643244.1	360	363	+	3	0	-2	5323
Q9H0P0-4#31	0	1	1	Q9H0P0-4	143	144	+	1	Q9H0P0-4	5	336	ENST00000610140.7	71	1064	++	220	Q9H0P0-4#31	0	3	ENST00000610140.7	485	488	+	3	0	-2	5324
Q9H0P0-4#31	0	1	1	Q9H0P0-4	143	144	+	1	Q9H0P0-4	48	236	ENST00000409787.4	41	605	++	70	Q9H0P0-4#31	0	3	ENST00000409787.4	326	329	+	3	0	-2	5325
Q9H0P0-4#31	0	1	1	Q9H0P0-4	143	144	+	1	Q9H0P0-4	51	336	ENST00000409467.6	174	1029	++	69	Q9H0P0-4#31	0	3	ENST00000409467.6	450	453	+	3	0	-2	5326
Q9H0P0-4#32	0	1	1	Q9H0P0-4	328	329	+	1	Q9H0P0-4	48	336	ENST00000643244.1	75	939	++	228	Q9H0P0-4#32	0	3	ENST00000643244.1	915	918	+	3	0	-2	5327
Q9H0P0-4#32	0	1	1	Q9H0P0-4	328	329	+	1	Q9H0P0-4	5	336	ENST00000610140.7	71	1064	++	220	Q9H0P0-4#32	0	3	ENST00000610140.7	1040	1043	+	3	0	-2	5328
Q9H0P0-4#32	0	1	1	Q9H0P0-4	328	329	+	1	Q9H0P0-4	51	336	ENST00000409467.6	174	1029	++	69	Q9H0P0-4#32	0	3	ENST00000409467.6	1005	1008	+	3	0	-2	5329
Q9H0P0-4#33	0	14	14	Q9H0P0-4	64	78	+	14	Q9H0P0-4	48	336	ENST00000643244.1	75	939	++	228	Q9H0P0-4#33	0	42	ENST00000643244.1	123	165	+	42	0	-28	5330
Q9H0P0-4#33	0	14	14	Q9H0P0-4	64	78	+	14	Q9H0P0-4	5	336	ENST00000610140.7	71	1064	++	220	Q9H0P0-4#33	0	42	ENST00000610140.7	248	290	+	42	0	-28	5331
Q9H0P0-4#33	0	14	14	Q9H0P0-4	64	78	+	14	Q9H0P0-4	51	93	ENST00000449201.5	179	305	++	99	Q9H0P0-4#33	0	42	ENST00000449201.5	218	260	+	42	0	-28	5332
Q9H0P0-4#33	0	14	14	Q9H0P0-4	64	78	+	14	Q9H0P0-4	48	236	ENST00000409787.4	41	605	++	70	Q9H0P0-4#33	0	42	ENST00000409787.4	89	131	+	42	0	-28	5333
Q9H0P0-4#33	0	14	14	Q9H0P0-4	64	78	+	14	Q9H0P0-4	51	336	ENST00000409467.6	174	1029	++	69	Q9H0P0-4#33	0	42	ENST00000409467.6	213	255	+	42	0	-28	5334
Q9H0P0-4#34	0	3	3	Q9H0P0-4	79	82	+	3	Q9H0P0-4	48	336	ENST00000643244.1	75	939	++	228	Q9H0P0-4#34	0	9	ENST00000643244.1	168	177	+	9	0	-6	5335
Q9H0P0-4#34	0	3	3	Q9H0P0-4	79	82	+	3	Q9H0P0-4	5	336	ENST00000610140.7	71	1064	++	220	Q9H0P0-4#34	0	9	ENST00000610140.7	293	302	+	9	0	-6	5336
Q9H0P0-4#34	0	3	3	Q9H0P0-4	79	82	+	3	Q9H0P0-4	51	93	ENST00000449201.5	179	305	++	99	Q9H0P0-4#34	0	9	ENST00000449201.5	263	272	+	9	0	-6	5337
Q9H0P0-4#34	0	3	3	Q9H0P0-4	79	82	+	3	Q9H0P0-4	48	236	ENST00000409787.4	41	605	++	70	Q9H0P0-4#34	0	9	ENST00000409787.4	134	143	+	9	0	-6	5338
Q9H0P0-4#34	0	3	3	Q9H0P0-4	79	82	+	3	Q9H0P0-4	51	336	ENST00000409467.6	174	1029	++	69	Q9H0P0-4#34	0	9	ENST00000409467.6	258	267	+	9	0	-6	5339
Q9H0P0-4#35	0	5	5	Q9H0P0-4	82	87	+	5	Q9H0P0-4	48	336	ENST00000643244.1	75	939	++	228	Q9H0P0-4#35	0	15	ENST00000643244.1	177	192	+	15	0	-10	5340
Q9H0P0-4#35	0	5	5	Q9H0P0-4	82	87	+	5	Q9H0P0-4	5	336	ENST00000610140.7	71	1064	++	220	Q9H0P0-4#35	0	15	ENST00000610140.7	302	317	+	15	0	-10	5341
Q9H0P0-4#35	0	5	5	Q9H0P0-4	82	87	+	5	Q9H0P0-4	51	93	ENST00000449201.5	179	305	++	99	Q9H0P0-4#35	0	15	ENST00000449201.5	272	287	+	15	0	-10	5342
Q9H0P0-4#35	0	5	5	Q9H0P0-4	82	87	+	5	Q9H0P0-4	48	236	ENST00000409787.4	41	605	++	70	Q9H0P0-4#35	0	15	ENST00000409787.4	143	158	+	15	0	-10	5343
Q9H0P0-4#35	0	5	5	Q9H0P0-4	82	87	+	5	Q9H0P0-4	51	336	ENST00000409467.6	174	1029	++	69	Q9H0P0-4#35	0	15	ENST00000409467.6	267	282	+	15	0	-10	5344
Q9H0P0-4#36	0	3	3	Q9H0P0-4	89	92	+	3	Q9H0P0-4	48	336	ENST00000643244.1	75	939	++	228	Q9H0P0-4#36	0	9	ENST00000643244.1	198	207	+	9	0	-6	5345
Q9H0P0-4#36	0	3	3	Q9H0P0-4	89	92	+	3	Q9H0P0-4	5	336	ENST00000610140.7	71	1064	++	220	Q9H0P0-4#36	0	9	ENST00000610140.7	323	332	+	9	0	-6	5346
Q9H0P0-4#36	0	3	3	Q9H0P0-4	89	92	+	3	Q9H0P0-4	51	93	ENST00000449201.5	179	305	++	99	Q9H0P0-4#36	0	9	ENST00000449201.5	293	302	+	9	0	-6	5347
Q9H0P0-4#36	0	3	3	Q9H0P0-4	89	92	+	3	Q9H0P0-4	48	236	ENST00000409787.4	41	605	++	70	Q9H0P0-4#36	0	9	ENST00000409787.4	164	173	+	9	0	-6	5348
Q9H0P0-4#36	0	3	3	Q9H0P0-4	89	92	+	3	Q9H0P0-4	51	336	ENST00000409467.6	174	1029	++	69	Q9H0P0-4#36	0	9	ENST00000409467.6	288	297	+	9	0	-6	5349
Q9H0P0-4#37	0	3	3	Q9H0P0-4	95	98	+	3	Q9H0P0-4	48	336	ENST00000643244.1	75	939	++	228	Q9H0P0-4#37	0	9	ENST00000643244.1	216	225	+	9	0	-6	5350
Q9H0P0-4#37	0	3	3	Q9H0P0-4	95	98	+	3	Q9H0P0-4	5	336	ENST00000610140.7	71	1064	++	220	Q9H0P0-4#37	0	9	ENST00000610140.7	341	350	+	9	0	-6	5351
Q9H0P0-4#37	0	3	3	Q9H0P0-4	95	98	+	3	Q9H0P0-4	48	236	ENST00000409787.4	41	605	++	70	Q9H0P0-4#37	0	9	ENST00000409787.4	182	191	+	9	0	-6	5352
Q9H0P0-4#37	0	3	3	Q9H0P0-4	95	98	+	3	Q9H0P0-4	51	336	ENST00000409467.6	174	1029	++	69	Q9H0P0-4#37	0	9	ENST00000409467.6	306	315	+	9	0	-6	5353
Q9H0P0-4#38	0	6	6	Q9H0P0-4	105	111	+	6	Q9H0P0-4	48	336	ENST00000643244.1	75	939	++	228	Q9H0P0-4#38	0	18	ENST00000643244.1	246	264	+	18	0	-12	5354
Q9H0P0-4#38	0	6	6	Q9H0P0-4	105	111	+	6	Q9H0P0-4	5	336	ENST00000610140.7	71	1064	++	220	Q9H0P0-4#38	0	18	ENST00000610140.7	371	389	+	18	0	-12	5355
Q9H0P0-4#38	0	6	6	Q9H0P0-4	105	111	+	6	Q9H0P0-4	48	236	ENST00000409787.4	41	605	++	70	Q9H0P0-4#38	0	18	ENST00000409787.4	212	230	+	18	0	-12	5356
Q9H0P0-4#38	0	6	6	Q9H0P0-4	105	111	+	6	Q9H0P0-4	51	336	ENST00000409467.6	174	1029	++	69	Q9H0P0-4#38	0	18	ENST00000409467.6	336	354	+	18	0	-12	5357
Q9H0P0-4#39	0	18	18	Q9H0P0-4	117	135	+	18	Q9H0P0-4	48	336	ENST00000643244.1	75	939	++	228	Q9H0P0-4#39	0	54	ENST00000643244.1	282	336	+	54	0	-36	5358
Q9H0P0-4#39	0	18	18	Q9H0P0-4	117	135	+	18	Q9H0P0-4	5	336	ENST00000610140.7	71	1064	++	220	Q9H0P0-4#39	0	54	ENST00000610140.7	407	461	+	54	0	-36	5359
Q9H0P0-4#39	0	18	18	Q9H0P0-4	117	135	+	18	Q9H0P0-4	48	236	ENST00000409787.4	41	605	++	70	Q9H0P0-4#39	0	54	ENST00000409787.4	248	302	+	54	0	-36	5360
Q9H0P0-4#39	0	18	18	Q9H0P0-4	117	135	+	18	Q9H0P0-4	51	336	ENST00000409467.6	174	1029	++	69	Q9H0P0-4#39	0	54	ENST00000409467.6	372	426	+	54	0	-36	5361
Q9H0P0-4#40	0	3	3	Q9H0P0-4	137	140	+	3	Q9H0P0-4	48	336	ENST00000643244.1	75	939	++	228	Q9H0P0-4#40	0	9	ENST00000643244.1	342	351	+	9	0	-6	5362
Q9H0P0-4#40	0	3	3	Q9H0P0-4	137	140	+	3	Q9H0P0-4	5	336	ENST00000610140.7	71	1064	++	220	Q9H0P0-4#40	0	9	ENST00000610140.7	467	476	+	9	0	-6	5363
Q9H0P0-4#40	0	3	3	Q9H0P0-4	137	140	+	3	Q9H0P0-4	48	236	ENST00000409787.4	41	605	++	70	Q9H0P0-4#40	0	9	ENST00000409787.4	308	317	+	9	0	-6	5364
Q9H0P0-4#40	0	3	3	Q9H0P0-4	137	140	+	3	Q9H0P0-4	51	336	ENST00000409467.6	174	1029	++	69	Q9H0P0-4#40	0	9	ENST00000409467.6	432	441	+	9	0	-6	5365
Q9H0P0-4#41	0	22	22	Q9H0P0-4	141	163	+	22	Q9H0P0-4	48	336	ENST00000643244.1	75	939	++	228	Q9H0P0-4#41	0	66	ENST00000643244.1	354	420	+	66	0	-44	5366
Q9H0P0-4#41	0	22	22	Q9H0P0-4	141	163	+	22	Q9H0P0-4	5	336	ENST00000610140.7	71	1064	++	220	Q9H0P0-4#41	0	66	ENST00000610140.7	479	545	+	66	0	-44	5367
Q9H0P0-4#41	0	22	22	Q9H0P0-4	141	163	+	22	Q9H0P0-4	48	236	ENST00000409787.4	41	605	++	70	Q9H0P0-4#41	0	66	ENST00000409787.4	320	386	+	66	0	-44	5368
Q9H0P0-4#41	0	22	22	Q9H0P0-4	141	163	+	22	Q9H0P0-4	51	336	ENST00000409467.6	174	1029	++	69	Q9H0P0-4#41	0	66	ENST00000409467.6	444	510	+	66	0	-44	5369
Q9H0P0-4#42	0	3	3	Q9H0P0-4	166	169	+	3	Q9H0P0-4	48	336	ENST00000643244.1	75	939	++	228	Q9H0P0-4#42	0	9	ENST00000643244.1	429	438	+	9	0	-6	5370
Q9H0P0-4#42	0	3	3	Q9H0P0-4	166	169	+	3	Q9H0P0-4	5	336	ENST00000610140.7	71	1064	++	220	Q9H0P0-4#42	0	9	ENST00000610140.7	554	563	+	9	0	-6	5371
Q9H0P0-4#42	0	3	3	Q9H0P0-4	166	169	+	3	Q9H0P0-4	48	236	ENST00000409787.4	41	605	++	70	Q9H0P0-4#42	0	9	ENST00000409787.4	395	404	+	9	0	-6	5372
Q9H0P0-4#42	0	3	3	Q9H0P0-4	166	169	+	3	Q9H0P0-4	51	336	ENST00000409467.6	174	1029	++	69	Q9H0P0-4#42	0	9	ENST00000409467.6	519	528	+	9	0	-6	5373
Q9H0P0-4#43	0	6	6	Q9H0P0-4	169	175	+	6	Q9H0P0-4	48	336	ENST00000643244.1	75	939	++	228	Q9H0P0-4#43	0	18	ENST00000643244.1	438	456	+	18	0	-12	5374
Q9H0P0-4#43	0	6	6	Q9H0P0-4	169	175	+	6	Q9H0P0-4	5	336	ENST00000610140.7	71	1064	++	220	Q9H0P0-4#43	0	18	ENST00000610140.7	563	581	+	18	0	-12	5375
Q9H0P0-4#43	0	6	6	Q9H0P0-4	169	175	+	6	Q9H0P0-4	48	236	ENST00000409787.4	41	605	++	70	Q9H0P0-4#43	0	18	ENST00000409787.4	404	422	+	18	0	-12	5376
Q9H0P0-4#43	0	6	6	Q9H0P0-4	169	175	+	6	Q9H0P0-4	51	336	ENST00000409467.6	174	1029	++	69	Q9H0P0-4#43	0	18	ENST00000409467.6	528	546	+	18	0	-12	5377
Q9H0P0-4#44	0	10	10	Q9H0P0-4	184	194	+	10	Q9H0P0-4	48	336	ENST00000643244.1	75	939	++	228	Q9H0P0-4#44	0	30	ENST00000643244.1	483	513	+	30	0	-20	5378
Q9H0P0-4#44	0	10	10	Q9H0P0-4	184	194	+	10	Q9H0P0-4	5	336	ENST00000610140.7	71	1064	++	220	Q9H0P0-4#44	0	30	ENST00000610140.7	608	638	+	30	0	-20	5379
Q9H0P0-4#44	0	10	10	Q9H0P0-4	184	194	+	10	Q9H0P0-4	48	236	ENST00000409787.4	41	605	++	70	Q9H0P0-4#44	0	30	ENST00000409787.4	449	479	+	30	0	-20	5380
Q9H0P0-4#44	0	10	10	Q9H0P0-4	184	194	+	10	Q9H0P0-4	51	336	ENST00000409467.6	174	1029	++	69	Q9H0P0-4#44	0	30	ENST00000409467.6	573	603	+	30	0	-20	5381
Q9H0P0-4#45	0	8	8	Q9H0P0-4	198	206	+	8	Q9H0P0-4	48	336	ENST00000643244.1	75	939	++	228	Q9H0P0-4#45	0	24	ENST00000643244.1	525	549	+	24	0	-16	5382
Q9H0P0-4#45	0	8	8	Q9H0P0-4	198	206	+	8	Q9H0P0-4	5	336	ENST00000610140.7	71	1064	++	220	Q9H0P0-4#45	0	24	ENST00000610140.7	650	674	+	24	0	-16	5383
Q9H0P0-4#45	0	8	8	Q9H0P0-4	198	206	+	8	Q9H0P0-4	48	236	ENST00000409787.4	41	605	++	70	Q9H0P0-4#45	0	24	ENST00000409787.4	491	515	+	24	0	-16	5384
Q9H0P0-4#45	0	8	8	Q9H0P0-4	198	206	+	8	Q9H0P0-4	51	336	ENST00000409467.6	174	1029	++	69	Q9H0P0-4#45	0	24	ENST00000409467.6	615	639	+	24	0	-16	5385
Q9H0P0-4#46	0	10	10	Q9H0P0-4	206	216	+	10	Q9H0P0-4	48	336	ENST00000643244.1	75	939	++	228	Q9H0P0-4#46	0	30	ENST00000643244.1	549	579	+	30	0	-20	5386
Q9H0P0-4#46	0	10	10	Q9H0P0-4	206	216	+	10	Q9H0P0-4	5	336	ENST00000610140.7	71	1064	++	220	Q9H0P0-4#46	0	30	ENST00000610140.7	674	704	+	30	0	-20	5387
Q9H0P0-4#46	0	10	10	Q9H0P0-4	206	216	+	10	Q9H0P0-4	48	236	ENST00000409787.4	41	605	++	70	Q9H0P0-4#46	0	30	ENST00000409787.4	515	545	+	30	0	-20	5388
Q9H0P0-4#46	0	10	10	Q9H0P0-4	206	216	+	10	Q9H0P0-4	51	336	ENST00000409467.6	174	1029	++	69	Q9H0P0-4#46	0	30	ENST00000409467.6	639	669	+	30	0	-20	5389
Q9H0P0-4#47	0	6	6	Q9H0P0-4	223	229	+	6	Q9H0P0-4	48	336	ENST00000643244.1	75	939	++	228	Q9H0P0-4#47	0	18	ENST00000643244.1	600	618	+	18	0	-12	5390
Q9H0P0-4#47	0	6	6	Q9H0P0-4	223	229	+	6	Q9H0P0-4	5	336	ENST00000610140.7	71	1064	++	220	Q9H0P0-4#47	0	18	ENST00000610140.7	725	743	+	18	0	-12	5391
Q9H0P0-4#47	0	6	6	Q9H0P0-4	223	229	+	6	Q9H0P0-4	48	236	ENST00000409787.4	41	605	++	70	Q9H0P0-4#47	0	18	ENST00000409787.4	566	584	+	18	0	-12	5392
Q9H0P0-4#47	0	6	6	Q9H0P0-4	223	229	+	6	Q9H0P0-4	51	336	ENST00000409467.6	174	1029	++	69	Q9H0P0-4#47	0	18	ENST00000409467.6	690	708	+	18	0	-12	5393
Q9H0P0-4#48	0	3	3	Q9H0P0-4	230	233	+	3	Q9H0P0-4	48	336	ENST00000643244.1	75	939	++	228	Q9H0P0-4#48	0	9	ENST00000643244.1	621	630	+	9	0	-6	5394
Q9H0P0-4#48	0	3	3	Q9H0P0-4	230	233	+	3	Q9H0P0-4	5	336	ENST00000610140.7	71	1064	++	220	Q9H0P0-4#48	0	9	ENST00000610140.7	746	755	+	9	0	-6	5395
Q9H0P0-4#48	0	3	3	Q9H0P0-4	230	233	+	3	Q9H0P0-4	48	236	ENST00000409787.4	41	605	++	70	Q9H0P0-4#48	0	9	ENST00000409787.4	587	596	+	9	0	-6	5396
Q9H0P0-4#48	0	3	3	Q9H0P0-4	230	233	+	3	Q9H0P0-4	51	336	ENST00000409467.6	174	1029	++	69	Q9H0P0-4#48	0	9	ENST00000409467.6	711	720	+	9	0	-6	5397
Q9H0P0-4#49	0	6	6	Q9H0P0-4	236	242	+	6	Q9H0P0-4	48	336	ENST00000643244.1	75	939	++	228	Q9H0P0-4#49	0	18	ENST00000643244.1	639	657	+	18	0	-12	5398
Q9H0P0-4#49	0	6	6	Q9H0P0-4	236	242	+	6	Q9H0P0-4	5	336	ENST00000610140.7	71	1064	++	220	Q9H0P0-4#49	0	18	ENST00000610140.7	764	782	+	18	0	-12	5399
Q9H0P0-4#49	0	6	6	Q9H0P0-4	236	242	+	6	Q9H0P0-4	51	336	ENST00000409467.6	174	1029	++	69	Q9H0P0-4#49	0	18	ENST00000409467.6	729	747	+	18	0	-12	5400
Q9H0P0-4#50	0	7	7	Q9H0P0-4	251	258	+	7	Q9H0P0-4	48	336	ENST00000643244.1	75	939	++	228	Q9H0P0-4#50	0	21	ENST00000643244.1	684	705	+	21	0	-14	5401
Q9H0P0-4#50	0	7	7	Q9H0P0-4	251	258	+	7	Q9H0P0-4	5	336	ENST00000610140.7	71	1064	++	220	Q9H0P0-4#50	0	21	ENST00000610140.7	809	830	+	21	0	-14	5402
Q9H0P0-4#50	0	7	7	Q9H0P0-4	251	258	+	7	Q9H0P0-4	51	336	ENST00000409467.6	174	1029	++	69	Q9H0P0-4#50	0	21	ENST00000409467.6	774	795	+	21	0	-14	5403
Q9H0P0-4#51	0	5	5	Q9H0P0-4	259	264	+	5	Q9H0P0-4	48	336	ENST00000643244.1	75	939	++	228	Q9H0P0-4#51	0	15	ENST00000643244.1	708	723	+	15	0	-10	5404
Q9H0P0-4#51	0	5	5	Q9H0P0-4	259	264	+	5	Q9H0P0-4	5	336	ENST00000610140.7	71	1064	++	220	Q9H0P0-4#51	0	15	ENST00000610140.7	833	848	+	15	0	-10	5405
Q9H0P0-4#51	0	5	5	Q9H0P0-4	259	264	+	5	Q9H0P0-4	51	336	ENST00000409467.6	174	1029	++	69	Q9H0P0-4#51	0	15	ENST00000409467.6	798	813	+	15	0	-10	5406
Q9H0P0-4#52	0	4	4	Q9H0P0-4	264	268	+	4	Q9H0P0-4	48	336	ENST00000643244.1	75	939	++	228	Q9H0P0-4#52	0	12	ENST00000643244.1	723	735	+	12	0	-8	5407
Q9H0P0-4#52	0	4	4	Q9H0P0-4	264	268	+	4	Q9H0P0-4	5	336	ENST00000610140.7	71	1064	++	220	Q9H0P0-4#52	0	12	ENST00000610140.7	848	860	+	12	0	-8	5408
Q9H0P0-4#52	0	4	4	Q9H0P0-4	264	268	+	4	Q9H0P0-4	51	336	ENST00000409467.6	174	1029	++	69	Q9H0P0-4#52	0	12	ENST00000409467.6	813	825	+	12	0	-8	5409
Q9H0P0-4#53	0	9	9	Q9H0P0-4	270	279	+	9	Q9H0P0-4	48	336	ENST00000643244.1	75	939	++	228	Q9H0P0-4#53	0	27	ENST00000643244.1	741	768	+	27	0	-18	5410
Q9H0P0-4#53	0	9	9	Q9H0P0-4	270	279	+	9	Q9H0P0-4	5	336	ENST00000610140.7	71	1064	++	220	Q9H0P0-4#53	0	27	ENST00000610140.7	866	893	+	27	0	-18	5411
Q9H0P0-4#53	0	9	9	Q9H0P0-4	270	279	+	9	Q9H0P0-4	51	336	ENST00000409467.6	174	1029	++	69	Q9H0P0-4#53	0	27	ENST00000409467.6	831	858	+	27	0	-18	5412
Q9H0P0-4#54	0	4	4	Q9H0P0-4	279	283	+	4	Q9H0P0-4	48	336	ENST00000643244.1	75	939	++	228	Q9H0P0-4#54	0	12	ENST00000643244.1	768	780	+	12	0	-8	5413
Q9H0P0-4#54	0	4	4	Q9H0P0-4	279	283	+	4	Q9H0P0-4	5	336	ENST00000610140.7	71	1064	++	220	Q9H0P0-4#54	0	12	ENST00000610140.7	893	905	+	12	0	-8	5414
Q9H0P0-4#54	0	4	4	Q9H0P0-4	279	283	+	4	Q9H0P0-4	51	336	ENST00000409467.6	174	1029	++	69	Q9H0P0-4#54	0	12	ENST00000409467.6	858	870	+	12	0	-8	5415
Q9H0P0-4#55	0	4	4	Q9H0P0-4	283	287	+	4	Q9H0P0-4	48	336	ENST00000643244.1	75	939	++	228	Q9H0P0-4#55	0	12	ENST00000643244.1	780	792	+	12	0	-8	5416
Q9H0P0-4#55	0	4	4	Q9H0P0-4	283	287	+	4	Q9H0P0-4	5	336	ENST00000610140.7	71	1064	++	220	Q9H0P0-4#55	0	12	ENST00000610140.7	905	917	+	12	0	-8	5417
Q9H0P0-4#55	0	4	4	Q9H0P0-4	283	287	+	4	Q9H0P0-4	51	336	ENST00000409467.6	174	1029	++	69	Q9H0P0-4#55	0	12	ENST00000409467.6	870	882	+	12	0	-8	5418
Q9H0P0-4#56	0	9	9	Q9H0P0-4	291	300	+	9	Q9H0P0-4	48	336	ENST00000643244.1	75	939	++	228	Q9H0P0-4#56	0	27	ENST00000643244.1	804	831	+	27	0	-18	5419
Q9H0P0-4#56	0	9	9	Q9H0P0-4	291	300	+	9	Q9H0P0-4	5	336	ENST00000610140.7	71	1064	++	220	Q9H0P0-4#56	0	27	ENST00000610140.7	929	956	+	27	0	-18	5420
Q9H0P0-4#56	0	9	9	Q9H0P0-4	291	300	+	9	Q9H0P0-4	51	336	ENST00000409467.6	174	1029	++	69	Q9H0P0-4#56	0	27	ENST00000409467.6	894	921	+	27	0	-18	5421
Q9H0P0-4#57	0	9	9	Q9H0P0-4	303	312	+	9	Q9H0P0-4	48	336	ENST00000643244.1	75	939	++	228	Q9H0P0-4#57	0	27	ENST00000643244.1	840	867	+	27	0	-18	5422
Q9H0P0-4#57	0	9	9	Q9H0P0-4	303	312	+	9	Q9H0P0-4	5	336	ENST00000610140.7	71	1064	++	220	Q9H0P0-4#57	0	27	ENST00000610140.7	965	992	+	27	0	-18	5423
Q9H0P0-4#57	0	9	9	Q9H0P0-4	303	312	+	9	Q9H0P0-4	51	336	ENST00000409467.6	174	1029	++	69	Q9H0P0-4#57	0	27	ENST00000409467.6	930	957	+	27	0	-18	5424
Q9H0P0-4#58	0	6	6	Q9H0P0-4	314	320	+	6	Q9H0P0-4	48	336	ENST00000643244.1	75	939	++	228	Q9H0P0-4#58	0	18	ENST00000643244.1	873	891	+	18	0	-12	5425
Q9H0P0-4#58	0	6	6	Q9H0P0-4	314	320	+	6	Q9H0P0-4	5	336	ENST00000610140.7	71	1064	++	220	Q9H0P0-4#58	0	18	ENST00000610140.7	998	1016	+	18	0	-12	5426
Q9H0P0-4#58	0	6	6	Q9H0P0-4	314	320	+	6	Q9H0P0-4	51	336	ENST00000409467.6	174	1029	++	69	Q9H0P0-4#58	0	18	ENST00000409467.6	963	981	+	18	0	-12	5427
Q9H0P0-4#59	0	10	10	Q9H0P0-4	325	335	+	10	Q9H0P0-4	48	336	ENST00000643244.1	75	939	++	228	Q9H0P0-4#59	0	30	ENST00000643244.1	906	936	+	30	0	-20	5428
Q9H0P0-4#59	0	10	10	Q9H0P0-4	325	335	+	10	Q9H0P0-4	5	336	ENST00000610140.7	71	1064	++	220	Q9H0P0-4#59	0	30	ENST00000610140.7	1031	1061	+	30	0	-20	5429
Q9H0P0-4#59	0	10	10	Q9H0P0-4	325	335	+	10	Q9H0P0-4	51	336	ENST00000409467.6	174	1029	++	69	Q9H0P0-4#59	0	30	ENST00000409467.6	996	1026	+	30	0	-20	5430
O95336#0	0	1	1	O95336	0	1	+	1	O95336	0	208	ENST00000600923.5	3	651	++	213	O95336#0	0	3	ENST00000600923.5	3	6	+	3	0	-2	5431
O95336#0	0	1	1	O95336	0	1	+	1	O95336	0	139	ENST00000594761.5	37	454	++	198	O95336#0	0	3	ENST00000594761.5	37	40	+	3	0	-2	5432
O95336#0	0	1	1	O95336	0	1	+	1	O95336	0	258	ENST00000252603.7	24	798	++	5	O95336#0	0	3	ENST00000252603.7	24	27	+	3	0	-2	5433
O95336#1	0	257	257	O95336	1	258	+	257	O95336	0	208	ENST00000600923.5	3	651	++	213	O95336#1	0	621	ENST00000600923.5	6	651	+	621	0	-364	5434
O95336#1	0	257	257	O95336	1	258	+	257	O95336	64	258	ENST00000595782.1	0	441	++	202	O95336#1	189	771	ENST00000595782.1	0	441	+	441	189	-514	5435
O95336#1	0	257	257	O95336	1	258	+	257	O95336	0	139	ENST00000594761.5	37	454	++	198	O95336#1	0	414	ENST00000594761.5	40	454	+	414	0	-157	5436
O95336#1	0	257	257	O95336	1	258	+	257	O95336	0	258	ENST00000252603.7	24	798	++	5	O95336#1	0	771	ENST00000252603.7	27	798	+	771	0	-514	5437
O95336#2	0	1	1	O95336	1	2	+	1	O95336	0	208	ENST00000600923.5	3	651	++	213	O95336#2	0	3	ENST00000600923.5	6	9	+	3	0	-2	5438
O95336#2	0	1	1	O95336	1	2	+	1	O95336	0	139	ENST00000594761.5	37	454	++	198	O95336#2	0	3	ENST00000594761.5	40	43	+	3	0	-2	5439
O95336#2	0	1	1	O95336	1	2	+	1	O95336	0	258	ENST00000252603.7	24	798	++	5	O95336#2	0	3	ENST00000252603.7	27	30	+	3	0	-2	5440
O95336#3	0	1	1	O95336	48	49	+	1	O95336	0	208	ENST00000600923.5	3	651	++	213	O95336#3	0	3	ENST00000600923.5	147	150	+	3	0	-2	5441
O95336#3	0	1	1	O95336	48	49	+	1	O95336	0	139	ENST00000594761.5	37	454	++	198	O95336#3	0	3	ENST00000594761.5	181	184	+	3	0	-2	5442
O95336#3	0	1	1	O95336	48	49	+	1	O95336	0	258	ENST00000252603.7	24	798	++	5	O95336#3	0	3	ENST00000252603.7	168	171	+	3	0	-2	5443
O95336#4	0	1	1	O95336	179	180	+	1	O95336	0	208	ENST00000600923.5	3	651	++	213	O95336#4	0	3	ENST00000600923.5	564	567	+	3	0	-2	5444
O95336#4	0	1	1	O95336	179	180	+	1	O95336	0	258	ENST00000252603.7	24	798	++	5	O95336#4	0	3	ENST00000252603.7	561	564	+	3	0	-2	5445
Q969T7-1#0	0	300	300	Q969T7-1	0	300	+	300	Q969T7-1	36	189	ENST00000521789.5	76	535	++	134	Q969T7-1#0	108	567	ENST00000521789.5	76	535	+	459	108	-267	5446
Q969T7-1#0	0	300	300	Q969T7-1	0	300	+	300	Q969T7-1	108	189	ENST00000486304.2	0	243	++	116	Q969T7-1#0	324	567	ENST00000486304.2	0	243	+	243	324	-267	5447
Q969T7-1#0	0	300	300	Q969T7-1	0	300	+	300	Q969T7-1	0	38	ENST00000475053.5	53	167	++	111	Q969T7-1#0	0	114	ENST00000475053.5	53	167	+	114	0	186	5448
Q969T7-1#0	0	300	300	Q969T7-1	0	300	+	300	Q969T7-1	3	40	ENST00000445655.5	163	274	++	94	Q969T7-1#0	9	120	ENST00000445655.5	163	274	+	111	9	180	5449
Q969T7-1#0	0	300	300	Q969T7-1	0	300	+	300	Q969T7-1	0	300	ENST00000435506.7	39	939	++	85	Q969T7-1#0	0	900	ENST00000435506.7	39	939	+	900	0	-600	5450
Q969T7-1#0	0	300	300	Q969T7-1	0	300	+	300	Q969T7-1	0	257	ENST00000415460.5	48	729	++	75	Q969T7-1#0	0	771	ENST00000415460.5	48	729	+	681	0	-471	5451
Q969T7-1#1	0	1	1	Q969T7-1	40	41	+	1	Q969T7-1	36	189	ENST00000521789.5	76	535	++	134	Q969T7-1#1	0	3	ENST00000521789.5	88	91	+	3	0	-2	5452
Q969T7-1#1	0	1	1	Q969T7-1	40	41	+	1	Q969T7-1	0	300	ENST00000435506.7	39	939	++	85	Q969T7-1#1	0	3	ENST00000435506.7	159	162	+	3	0	-2	5453
Q969T7-1#1	0	1	1	Q969T7-1	40	41	+	1	Q969T7-1	0	257	ENST00000415460.5	48	729	++	75	Q969T7-1#1	0	3	ENST00000415460.5	168	171	+	3	0	-2	5454
Q969T7-1#2	0	1	1	Q969T7-1	42	43	+	1	Q969T7-1	36	189	ENST00000521789.5	76	535	++	134	Q969T7-1#2	0	3	ENST00000521789.5	94	97	+	3	0	-2	5455
Q969T7-1#2	0	1	1	Q969T7-1	42	43	+	1	Q969T7-1	0	300	ENST00000435506.7	39	939	++	85	Q969T7-1#2	0	3	ENST00000435506.7	165	168	+	3	0	-2	5456
Q969T7-1#2	0	1	1	Q969T7-1	42	43	+	1	Q969T7-1	0	257	ENST00000415460.5	48	729	++	75	Q969T7-1#2	0	3	ENST00000415460.5	174	177	+	3	0	-2	5457
Q969T7-1#3	0	1	1	Q969T7-1	40	41	+	1	Q969T7-1	36	189	ENST00000521789.5	76	535	++	134	Q969T7-1#3	0	3	ENST00000521789.5	88	91	+	3	0	-2	5458
Q969T7-1#3	0	1	1	Q969T7-1	40	41	+	1	Q969T7-1	0	300	ENST00000435506.7	39	939	++	85	Q969T7-1#3	0	3	ENST00000435506.7	159	162	+	3	0	-2	5459
Q969T7-1#3	0	1	1	Q969T7-1	40	41	+	1	Q969T7-1	0	257	ENST00000415460.5	48	729	++	75	Q969T7-1#3	0	3	ENST00000415460.5	168	171	+	3	0	-2	5460
Q969T7-1#4	0	1	1	Q969T7-1	42	43	+	1	Q969T7-1	36	189	ENST00000521789.5	76	535	++	134	Q969T7-1#4	0	3	ENST00000521789.5	94	97	+	3	0	-2	5461
Q969T7-1#4	0	1	1	Q969T7-1	42	43	+	1	Q969T7-1	0	300	ENST00000435506.7	39	939	++	85	Q969T7-1#4	0	3	ENST00000435506.7	165	168	+	3	0	-2	5462
Q969T7-1#4	0	1	1	Q969T7-1	42	43	+	1	Q969T7-1	0	257	ENST00000415460.5	48	729	++	75	Q969T7-1#4	0	3	ENST00000415460.5	174	177	+	3	0	-2	5463
Q969T7-1#5	0	1	1	Q969T7-1	87	88	+	1	Q969T7-1	36	189	ENST00000521789.5	76	535	++	134	Q969T7-1#5	0	3	ENST00000521789.5	229	232	+	3	0	-2	5464
Q969T7-1#5	0	1	1	Q969T7-1	87	88	+	1	Q969T7-1	0	300	ENST00000435506.7	39	939	++	85	Q969T7-1#5	0	3	ENST00000435506.7	300	303	+	3	0	-2	5465
Q969T7-1#5	0	1	1	Q969T7-1	87	88	+	1	Q969T7-1	0	257	ENST00000415460.5	48	729	++	75	Q969T7-1#5	0	3	ENST00000415460.5	309	312	+	3	0	-2	5466
Q969T7-1#6	0	1	1	Q969T7-1	87	88	+	1	Q969T7-1	36	189	ENST00000521789.5	76	535	++	134	Q969T7-1#6	0	3	ENST00000521789.5	229	232	+	3	0	-2	5467
Q969T7-1#6	0	1	1	Q969T7-1	87	88	+	1	Q969T7-1	0	300	ENST00000435506.7	39	939	++	85	Q969T7-1#6	0	3	ENST00000435506.7	300	303	+	3	0	-2	5468
Q969T7-1#6	0	1	1	Q969T7-1	87	88	+	1	Q969T7-1	0	257	ENST00000415460.5	48	729	++	75	Q969T7-1#6	0	3	ENST00000415460.5	309	312	+	3	0	-2	5469
Q969T7-1#7	0	2	2	Q969T7-1	155	157	+	2	Q969T7-1	36	189	ENST00000521789.5	76	535	++	134	Q969T7-1#7	0	6	ENST00000521789.5	433	439	+	6	0	-4	5470
Q969T7-1#7	0	2	2	Q969T7-1	155	157	+	2	Q969T7-1	108	189	ENST00000486304.2	0	243	++	116	Q969T7-1#7	0	6	ENST00000486304.2	141	147	+	6	0	-4	5471
Q969T7-1#7	0	2	2	Q969T7-1	155	157	+	2	Q969T7-1	0	300	ENST00000435506.7	39	939	++	85	Q969T7-1#7	0	6	ENST00000435506.7	504	510	+	6	0	-4	5472
Q969T7-1#7	0	2	2	Q969T7-1	155	157	+	2	Q969T7-1	0	257	ENST00000415460.5	48	729	++	75	Q969T7-1#7	0	6	ENST00000415460.5	423	429	+	6	0	-4	5473
Q969T7-1#8	0	1	1	Q969T7-1	204	205	+	1	Q969T7-1	0	300	ENST00000435506.7	39	939	++	85	Q969T7-1#8	0	3	ENST00000435506.7	651	654	+	3	0	-2	5474
Q969T7-1#8	0	1	1	Q969T7-1	204	205	+	1	Q969T7-1	0	257	ENST00000415460.5	48	729	++	75	Q969T7-1#8	0	3	ENST00000415460.5	570	573	+	3	0	-2	5475
Q969T7-1#9	0	1	1	Q969T7-1	229	230	+	1	Q969T7-1	0	300	ENST00000435506.7	39	939	++	85	Q969T7-1#9	0	3	ENST00000435506.7	726	729	+	3	0	-2	5476
Q969T7-1#9	0	1	1	Q969T7-1	229	230	+	1	Q969T7-1	0	257	ENST00000415460.5	48	729	++	75	Q969T7-1#9	0	3	ENST00000415460.5	645	648	+	3	0	-2	5477
Q969T7-1#10	0	1	1	Q969T7-1	255	256	+	1	Q969T7-1	0	300	ENST00000435506.7	39	939	++	85	Q969T7-1#10	0	3	ENST00000435506.7	804	807	+	3	0	-2	5478
Q969T7-1#10	0	1	1	Q969T7-1	255	256	+	1	Q969T7-1	0	257	ENST00000415460.5	48	729	++	75	Q969T7-1#10	0	3	ENST00000415460.5	723	726	+	3	0	-2	5479
Q969T7-1#11	0	8	8	Q969T7-1	0	8	+	8	Q969T7-1	0	38	ENST00000475053.5	53	167	++	111	Q969T7-1#11	0	24	ENST00000475053.5	53	77	+	24	0	-16	5480
Q969T7-1#11	0	8	8	Q969T7-1	0	8	+	8	Q969T7-1	3	40	ENST00000445655.5	163	274	++	94	Q969T7-1#11	9	24	ENST00000445655.5	163	178	+	15	9	-16	5481
Q969T7-1#11	0	8	8	Q969T7-1	0	8	+	8	Q969T7-1	0	300	ENST00000435506.7	39	939	++	85	Q969T7-1#11	0	24	ENST00000435506.7	39	63	+	24	0	-16	5482
Q969T7-1#11	0	8	8	Q969T7-1	0	8	+	8	Q969T7-1	0	257	ENST00000415460.5	48	729	++	75	Q969T7-1#11	0	24	ENST00000415460.5	48	72	+	24	0	-16	5483
Q969T7-1#12	0	1	1	Q969T7-1	208	209	+	1	Q969T7-1	0	300	ENST00000435506.7	39	939	++	85	Q969T7-1#12	0	3	ENST00000435506.7	663	666	+	3	0	-2	5484
Q969T7-1#12	0	1	1	Q969T7-1	208	209	+	1	Q969T7-1	0	257	ENST00000415460.5	48	729	++	75	Q969T7-1#12	0	3	ENST00000415460.5	582	585	+	3	0	-2	5485
Q969T7-1#13	0	1	1	Q969T7-1	212	213	+	1	Q969T7-1	0	300	ENST00000435506.7	39	939	++	85	Q969T7-1#13	0	3	ENST00000435506.7	675	678	+	3	0	-2	5486
Q969T7-1#13	0	1	1	Q969T7-1	212	213	+	1	Q969T7-1	0	257	ENST00000415460.5	48	729	++	75	Q969T7-1#13	0	3	ENST00000415460.5	594	597	+	3	0	-2	5487
Q969T7-1#14	0	3	3	Q969T7-1	0	3	+	3	Q969T7-1	0	38	ENST00000475053.5	53	167	++	111	Q969T7-1#14	0	9	ENST00000475053.5	53	62	+	9	0	-6	5488
Q969T7-1#14	0	3	3	Q969T7-1	0	3	+	3	Q969T7-1	0	300	ENST00000435506.7	39	939	++	85	Q969T7-1#14	0	9	ENST00000435506.7	39	48	+	9	0	-6	5489
Q969T7-1#14	0	3	3	Q969T7-1	0	3	+	3	Q969T7-1	0	257	ENST00000415460.5	48	729	++	75	Q969T7-1#14	0	9	ENST00000415460.5	48	57	+	9	0	-6	5490
Q969T7-1#15	0	3	3	Q969T7-1	6	9	+	3	Q969T7-1	0	38	ENST00000475053.5	53	167	++	111	Q969T7-1#15	0	9	ENST00000475053.5	71	80	+	9	0	-6	5491
Q969T7-1#15	0	3	3	Q969T7-1	6	9	+	3	Q969T7-1	3	40	ENST00000445655.5	163	274	++	94	Q969T7-1#15	0	9	ENST00000445655.5	172	181	+	9	0	-6	5492
Q969T7-1#15	0	3	3	Q969T7-1	6	9	+	3	Q969T7-1	0	300	ENST00000435506.7	39	939	++	85	Q969T7-1#15	0	9	ENST00000435506.7	57	66	+	9	0	-6	5493
Q969T7-1#15	0	3	3	Q969T7-1	6	9	+	3	Q969T7-1	0	257	ENST00000415460.5	48	729	++	75	Q969T7-1#15	0	9	ENST00000415460.5	66	75	+	9	0	-6	5494
Q969T7-1#16	0	14	14	Q969T7-1	17	31	+	14	Q969T7-1	0	38	ENST00000475053.5	53	167	++	111	Q969T7-1#16	0	42	ENST00000475053.5	104	146	+	42	0	-28	5495
Q969T7-1#16	0	14	14	Q969T7-1	17	31	+	14	Q969T7-1	3	40	ENST00000445655.5	163	274	++	94	Q969T7-1#16	0	42	ENST00000445655.5	205	247	+	42	0	-28	5496
Q969T7-1#16	0	14	14	Q969T7-1	17	31	+	14	Q969T7-1	0	300	ENST00000435506.7	39	939	++	85	Q969T7-1#16	0	42	ENST00000435506.7	90	132	+	42	0	-28	5497
Q969T7-1#16	0	14	14	Q969T7-1	17	31	+	14	Q969T7-1	0	257	ENST00000415460.5	48	729	++	75	Q969T7-1#16	0	42	ENST00000415460.5	99	141	+	42	0	-28	5498
Q969T7-1#17	0	3	3	Q969T7-1	32	35	+	3	Q969T7-1	0	38	ENST00000475053.5	53	167	++	111	Q969T7-1#17	0	9	ENST00000475053.5	149	158	+	9	0	-6	5499
Q969T7-1#17	0	3	3	Q969T7-1	32	35	+	3	Q969T7-1	3	40	ENST00000445655.5	163	274	++	94	Q969T7-1#17	0	9	ENST00000445655.5	250	259	+	9	0	-6	5500
Q969T7-1#17	0	3	3	Q969T7-1	32	35	+	3	Q969T7-1	0	300	ENST00000435506.7	39	939	++	85	Q969T7-1#17	0	9	ENST00000435506.7	135	144	+	9	0	-6	5501
Q969T7-1#17	0	3	3	Q969T7-1	32	35	+	3	Q969T7-1	0	257	ENST00000415460.5	48	729	++	75	Q969T7-1#17	0	9	ENST00000415460.5	144	153	+	9	0	-6	5502
Q969T7-1#18	0	6	6	Q969T7-1	35	41	+	6	Q969T7-1	36	189	ENST00000521789.5	76	535	++	134	Q969T7-1#18	3	18	ENST00000521789.5	76	91	+	15	3	-12	5503
Q969T7-1#18	0	6	6	Q969T7-1	35	41	+	6	Q969T7-1	0	38	ENST00000475053.5	53	167	++	111	Q969T7-1#18	0	9	ENST00000475053.5	158	167	+	9	0	-3	5504
Q969T7-1#18	0	6	6	Q969T7-1	35	41	+	6	Q969T7-1	3	40	ENST00000445655.5	163	274	++	94	Q969T7-1#18	0	15	ENST00000445655.5	259	274	+	15	0	-9	5505
Q969T7-1#18	0	6	6	Q969T7-1	35	41	+	6	Q969T7-1	0	300	ENST00000435506.7	39	939	++	85	Q969T7-1#18	0	18	ENST00000435506.7	144	162	+	18	0	-12	5506
Q969T7-1#18	0	6	6	Q969T7-1	35	41	+	6	Q969T7-1	0	257	ENST00000415460.5	48	729	++	75	Q969T7-1#18	0	18	ENST00000415460.5	153	171	+	18	0	-12	5507
Q969T7-1#19	0	5	5	Q969T7-1	41	46	+	5	Q969T7-1	36	189	ENST00000521789.5	76	535	++	134	Q969T7-1#19	0	15	ENST00000521789.5	91	106	+	15	0	-10	5508
Q969T7-1#19	0	5	5	Q969T7-1	41	46	+	5	Q969T7-1	0	300	ENST00000435506.7	39	939	++	85	Q969T7-1#19	0	15	ENST00000435506.7	162	177	+	15	0	-10	5509
Q969T7-1#19	0	5	5	Q969T7-1	41	46	+	5	Q969T7-1	0	257	ENST00000415460.5	48	729	++	75	Q969T7-1#19	0	15	ENST00000415460.5	171	186	+	15	0	-10	5510
Q969T7-1#20	0	3	3	Q969T7-1	48	51	+	3	Q969T7-1	36	189	ENST00000521789.5	76	535	++	134	Q969T7-1#20	0	9	ENST00000521789.5	112	121	+	9	0	-6	5511
Q969T7-1#20	0	3	3	Q969T7-1	48	51	+	3	Q969T7-1	0	300	ENST00000435506.7	39	939	++	85	Q969T7-1#20	0	9	ENST00000435506.7	183	192	+	9	0	-6	5512
Q969T7-1#20	0	3	3	Q969T7-1	48	51	+	3	Q969T7-1	0	257	ENST00000415460.5	48	729	++	75	Q969T7-1#20	0	9	ENST00000415460.5	192	201	+	9	0	-6	5513
Q969T7-1#21	0	3	3	Q969T7-1	58	61	+	3	Q969T7-1	36	189	ENST00000521789.5	76	535	++	134	Q969T7-1#21	0	9	ENST00000521789.5	142	151	+	9	0	-6	5514
Q969T7-1#21	0	3	3	Q969T7-1	58	61	+	3	Q969T7-1	0	300	ENST00000435506.7	39	939	++	85	Q969T7-1#21	0	9	ENST00000435506.7	213	222	+	9	0	-6	5515
Q969T7-1#21	0	3	3	Q969T7-1	58	61	+	3	Q969T7-1	0	257	ENST00000415460.5	48	729	++	75	Q969T7-1#21	0	9	ENST00000415460.5	222	231	+	9	0	-6	5516
Q969T7-1#22	0	4	4	Q969T7-1	61	65	+	4	Q969T7-1	36	189	ENST00000521789.5	76	535	++	134	Q969T7-1#22	0	12	ENST00000521789.5	151	163	+	12	0	-8	5517
Q969T7-1#22	0	4	4	Q969T7-1	61	65	+	4	Q969T7-1	0	300	ENST00000435506.7	39	939	++	85	Q969T7-1#22	0	12	ENST00000435506.7	222	234	+	12	0	-8	5518
Q969T7-1#22	0	4	4	Q969T7-1	61	65	+	4	Q969T7-1	0	257	ENST00000415460.5	48	729	++	75	Q969T7-1#22	0	12	ENST00000415460.5	231	243	+	12	0	-8	5519
Q969T7-1#23	0	18	18	Q969T7-1	70	88	+	18	Q969T7-1	36	189	ENST00000521789.5	76	535	++	134	Q969T7-1#23	0	54	ENST00000521789.5	178	232	+	54	0	-36	5520
Q969T7-1#23	0	18	18	Q969T7-1	70	88	+	18	Q969T7-1	0	300	ENST00000435506.7	39	939	++	85	Q969T7-1#23	0	54	ENST00000435506.7	249	303	+	54	0	-36	5521
Q969T7-1#23	0	18	18	Q969T7-1	70	88	+	18	Q969T7-1	0	257	ENST00000415460.5	48	729	++	75	Q969T7-1#23	0	54	ENST00000415460.5	258	312	+	54	0	-36	5522
Q969T7-1#24	0	20	20	Q969T7-1	94	114	+	20	Q969T7-1	36	189	ENST00000521789.5	76	535	++	134	Q969T7-1#24	0	60	ENST00000521789.5	250	310	+	60	0	-40	5523
Q969T7-1#24	0	20	20	Q969T7-1	94	114	+	20	Q969T7-1	108	189	ENST00000486304.2	0	243	++	116	Q969T7-1#24	42	60	ENST00000486304.2	0	18	+	18	42	-40	5524
Q969T7-1#24	0	20	20	Q969T7-1	94	114	+	20	Q969T7-1	0	300	ENST00000435506.7	39	939	++	85	Q969T7-1#24	0	60	ENST00000435506.7	321	381	+	60	0	-40	5525
Q969T7-1#24	0	20	20	Q969T7-1	94	114	+	20	Q969T7-1	0	257	ENST00000415460.5	48	729	++	75	Q969T7-1#24	0	33	ENST00000415460.5	330	363	+	33	0	-13	5526
Q969T7-1#25	0	9	9	Q969T7-1	120	129	+	9	Q969T7-1	36	189	ENST00000521789.5	76	535	++	134	Q969T7-1#25	0	27	ENST00000521789.5	328	355	+	27	0	-18	5527
Q969T7-1#25	0	9	9	Q969T7-1	120	129	+	9	Q969T7-1	108	189	ENST00000486304.2	0	243	++	116	Q969T7-1#25	0	27	ENST00000486304.2	36	63	+	27	0	-18	5528
Q969T7-1#25	0	9	9	Q969T7-1	120	129	+	9	Q969T7-1	0	300	ENST00000435506.7	39	939	++	85	Q969T7-1#25	0	27	ENST00000435506.7	399	426	+	27	0	-18	5529
Q969T7-1#26	0	10	10	Q969T7-1	137	147	+	10	Q969T7-1	36	189	ENST00000521789.5	76	535	++	134	Q969T7-1#26	0	30	ENST00000521789.5	379	409	+	30	0	-20	5530
Q969T7-1#26	0	10	10	Q969T7-1	137	147	+	10	Q969T7-1	108	189	ENST00000486304.2	0	243	++	116	Q969T7-1#26	0	30	ENST00000486304.2	87	117	+	30	0	-20	5531
Q969T7-1#26	0	10	10	Q969T7-1	137	147	+	10	Q969T7-1	0	300	ENST00000435506.7	39	939	++	85	Q969T7-1#26	0	30	ENST00000435506.7	450	480	+	30	0	-20	5532
Q969T7-1#26	0	10	10	Q969T7-1	137	147	+	10	Q969T7-1	0	257	ENST00000415460.5	48	729	++	75	Q969T7-1#26	0	30	ENST00000415460.5	369	399	+	30	0	-20	5533
Q969T7-1#27	0	8	8	Q969T7-1	151	159	+	8	Q969T7-1	36	189	ENST00000521789.5	76	535	++	134	Q969T7-1#27	0	24	ENST00000521789.5	421	445	+	24	0	-16	5534
Q969T7-1#27	0	8	8	Q969T7-1	151	159	+	8	Q969T7-1	108	189	ENST00000486304.2	0	243	++	116	Q969T7-1#27	0	24	ENST00000486304.2	129	153	+	24	0	-16	5535
Q969T7-1#27	0	8	8	Q969T7-1	151	159	+	8	Q969T7-1	0	300	ENST00000435506.7	39	939	++	85	Q969T7-1#27	0	24	ENST00000435506.7	492	516	+	24	0	-16	5536
Q969T7-1#27	0	8	8	Q969T7-1	151	159	+	8	Q969T7-1	0	257	ENST00000415460.5	48	729	++	75	Q969T7-1#27	0	24	ENST00000415460.5	411	435	+	24	0	-16	5537
Q969T7-1#28	0	10	10	Q969T7-1	159	169	+	10	Q969T7-1	36	189	ENST00000521789.5	76	535	++	134	Q969T7-1#28	0	30	ENST00000521789.5	445	475	+	30	0	-20	5538
Q969T7-1#28	0	10	10	Q969T7-1	159	169	+	10	Q969T7-1	108	189	ENST00000486304.2	0	243	++	116	Q969T7-1#28	0	30	ENST00000486304.2	153	183	+	30	0	-20	5539
Q969T7-1#28	0	10	10	Q969T7-1	159	169	+	10	Q969T7-1	0	300	ENST00000435506.7	39	939	++	85	Q969T7-1#28	0	30	ENST00000435506.7	516	546	+	30	0	-20	5540
Q969T7-1#28	0	10	10	Q969T7-1	159	169	+	10	Q969T7-1	0	257	ENST00000415460.5	48	729	++	75	Q969T7-1#28	0	30	ENST00000415460.5	435	465	+	30	0	-20	5541
Q969T7-1#29	0	10	10	Q969T7-1	176	186	+	10	Q969T7-1	36	189	ENST00000521789.5	76	535	++	134	Q969T7-1#29	0	30	ENST00000521789.5	496	526	+	30	0	-20	5542
Q969T7-1#29	0	10	10	Q969T7-1	176	186	+	10	Q969T7-1	108	189	ENST00000486304.2	0	243	++	116	Q969T7-1#29	0	30	ENST00000486304.2	204	234	+	30	0	-20	5543
Q969T7-1#29	0	10	10	Q969T7-1	176	186	+	10	Q969T7-1	0	300	ENST00000435506.7	39	939	++	85	Q969T7-1#29	0	30	ENST00000435506.7	567	597	+	30	0	-20	5544
Q969T7-1#29	0	10	10	Q969T7-1	176	186	+	10	Q969T7-1	0	257	ENST00000415460.5	48	729	++	75	Q969T7-1#29	0	30	ENST00000415460.5	486	516	+	30	0	-20	5545
Q969T7-1#30	0	8	8	Q969T7-1	189	197	+	8	Q969T7-1	0	300	ENST00000435506.7	39	939	++	85	Q969T7-1#30	0	24	ENST00000435506.7	606	630	+	24	0	-16	5546
Q969T7-1#30	0	8	8	Q969T7-1	189	197	+	8	Q969T7-1	0	257	ENST00000415460.5	48	729	++	75	Q969T7-1#30	0	24	ENST00000415460.5	525	549	+	24	0	-16	5547
Q969T7-1#31	0	3	3	Q969T7-1	206	209	+	3	Q969T7-1	0	300	ENST00000435506.7	39	939	++	85	Q969T7-1#31	0	9	ENST00000435506.7	657	666	+	9	0	-6	5548
Q969T7-1#31	0	3	3	Q969T7-1	206	209	+	3	Q969T7-1	0	257	ENST00000415460.5	48	729	++	75	Q969T7-1#31	0	9	ENST00000415460.5	576	585	+	9	0	-6	5549
Q969T7-1#32	0	9	9	Q969T7-1	223	232	+	9	Q969T7-1	0	300	ENST00000435506.7	39	939	++	85	Q969T7-1#32	0	27	ENST00000435506.7	708	735	+	27	0	-18	5550
Q969T7-1#32	0	9	9	Q969T7-1	223	232	+	9	Q969T7-1	0	257	ENST00000415460.5	48	729	++	75	Q969T7-1#32	0	27	ENST00000415460.5	627	654	+	27	0	-18	5551
Q969T7-1#33	0	4	4	Q969T7-1	232	236	+	4	Q969T7-1	0	300	ENST00000435506.7	39	939	++	85	Q969T7-1#33	0	12	ENST00000435506.7	735	747	+	12	0	-8	5552
Q969T7-1#33	0	4	4	Q969T7-1	232	236	+	4	Q969T7-1	0	257	ENST00000415460.5	48	729	++	75	Q969T7-1#33	0	12	ENST00000415460.5	654	666	+	12	0	-8	5553
Q969T7-1#34	0	4	4	Q969T7-1	236	240	+	4	Q969T7-1	0	300	ENST00000435506.7	39	939	++	85	Q969T7-1#34	0	12	ENST00000435506.7	747	759	+	12	0	-8	5554
Q969T7-1#34	0	4	4	Q969T7-1	236	240	+	4	Q969T7-1	0	257	ENST00000415460.5	48	729	++	75	Q969T7-1#34	0	12	ENST00000415460.5	666	678	+	12	0	-8	5555
Q969T7-1#35	0	8	8	Q969T7-1	245	253	+	8	Q969T7-1	0	300	ENST00000435506.7	39	939	++	85	Q969T7-1#35	0	24	ENST00000435506.7	774	798	+	24	0	-16	5556
Q969T7-1#35	0	8	8	Q969T7-1	245	253	+	8	Q969T7-1	0	257	ENST00000415460.5	48	729	++	75	Q969T7-1#35	0	24	ENST00000415460.5	693	717	+	24	0	-16	5557
Q969T7-1#36	0	11	11	Q969T7-1	256	267	+	11	Q969T7-1	0	300	ENST00000435506.7	39	939	++	85	Q969T7-1#36	0	33	ENST00000435506.7	807	840	+	33	0	-22	5558
Q969T7-1#36	0	11	11	Q969T7-1	256	267	+	11	Q969T7-1	0	257	ENST00000415460.5	48	729	++	75	Q969T7-1#36	0	3	ENST00000415460.5	726	729	+	3	0	8	5559
Q969T7-1#37	0	6	6	Q969T7-1	268	274	+	6	Q969T7-1	0	300	ENST00000435506.7	39	939	++	85	Q969T7-1#37	0	18	ENST00000435506.7	843	861	+	18	0	-12	5560
Q969T7-1#38	0	11	11	Q969T7-1	278	289	+	11	Q969T7-1	0	300	ENST00000435506.7	39	939	++	85	Q969T7-1#38	0	33	ENST00000435506.7	873	906	+	33	0	-22	5561
A8K2U0-1#0	0	17	17	A8K2U0-1	0	17	+	17	A8K2U0-1	0	1454	ENST00000299698.12	31	4393	++	21	A8K2U0-1#0	0	51	ENST00000299698.12	31	82	+	51	0	-34	5562
A8K2U0-1#1	0	1437	1437	A8K2U0-1	17	1454	+	1437	A8K2U0-1	492	671	ENST00000545692.1	31	568	++	158	A8K2U0-1#1	1425	1962	ENST00000545692.1	31	568	+	537	1425	-525	5563
A8K2U0-1#1	0	1437	1437	A8K2U0-1	17	1454	+	1437	A8K2U0-1	450	1454	ENST00000541459.5	0	3012	++	154	A8K2U0-1#1	1299	4311	ENST00000541459.5	0	3012	+	3012	1299	-2874	5564
A8K2U0-1#1	0	1437	1437	A8K2U0-1	17	1454	+	1437	A8K2U0-1	492	1454	ENST00000539547.5	171	3057	++	153	A8K2U0-1#1	1425	4311	ENST00000539547.5	171	3057	+	2886	1425	-2874	5565
A8K2U0-1#1	0	1437	1437	A8K2U0-1	17	1454	+	1437	A8K2U0-1	1273	1454	ENST00000537475.1	1	544	++	152	A8K2U0-1#1	3768	4311	ENST00000537475.1	1	544	+	543	3768	-2874	5566
A8K2U0-1#1	0	1437	1437	A8K2U0-1	17	1454	+	1437	A8K2U0-1	491	528	ENST00000536789.5	350	461	++	151	A8K2U0-1#1	1422	1533	ENST00000536789.5	350	461	+	111	1422	-96	5567
A8K2U0-1#1	0	1437	1437	A8K2U0-1	17	1454	+	1437	A8K2U0-1	0	1454	ENST00000299698.12	31	4393	++	21	A8K2U0-1#1	0	4311	ENST00000299698.12	82	4393	+	4311	0	-2874	5568
A8K2U0-1#2	0	32	32	A8K2U0-1	694	726	+	32	A8K2U0-1	450	1454	ENST00000541459.5	0	3012	++	154	A8K2U0-1#2	0	96	ENST00000541459.5	732	828	+	96	0	-64	5569
A8K2U0-1#2	0	32	32	A8K2U0-1	694	726	+	32	A8K2U0-1	492	1454	ENST00000539547.5	171	3057	++	153	A8K2U0-1#2	0	96	ENST00000539547.5	777	873	+	96	0	-64	5570
A8K2U0-1#2	0	32	32	A8K2U0-1	694	726	+	32	A8K2U0-1	0	1454	ENST00000299698.12	31	4393	++	21	A8K2U0-1#2	0	96	ENST00000299698.12	2113	2209	+	96	0	-64	5571
A8K2U0-1#3	0	1	1	A8K2U0-1	119	120	+	1	A8K2U0-1	0	1454	ENST00000299698.12	31	4393	++	21	A8K2U0-1#3	0	3	ENST00000299698.12	388	391	+	3	0	-2	5572
A8K2U0-1#4	0	1	1	A8K2U0-1	280	281	+	1	A8K2U0-1	0	1454	ENST00000299698.12	31	4393	++	21	A8K2U0-1#4	0	3	ENST00000299698.12	871	874	+	3	0	-2	5573
A8K2U0-1#5	0	1	1	A8K2U0-1	408	409	+	1	A8K2U0-1	0	1454	ENST00000299698.12	31	4393	++	21	A8K2U0-1#5	0	3	ENST00000299698.12	1255	1258	+	3	0	-2	5574
A8K2U0-1#6	0	1	1	A8K2U0-1	856	857	+	1	A8K2U0-1	450	1454	ENST00000541459.5	0	3012	++	154	A8K2U0-1#6	0	3	ENST00000541459.5	1218	1221	+	3	0	-2	5575
A8K2U0-1#6	0	1	1	A8K2U0-1	856	857	+	1	A8K2U0-1	492	1454	ENST00000539547.5	171	3057	++	153	A8K2U0-1#6	0	3	ENST00000539547.5	1263	1266	+	3	0	-2	5576
A8K2U0-1#6	0	1	1	A8K2U0-1	856	857	+	1	A8K2U0-1	0	1454	ENST00000299698.12	31	4393	++	21	A8K2U0-1#6	0	3	ENST00000299698.12	2599	2602	+	3	0	-2	5577
A8K2U0-1#7	0	1	1	A8K2U0-1	1019	1020	+	1	A8K2U0-1	450	1454	ENST00000541459.5	0	3012	++	154	A8K2U0-1#7	0	3	ENST00000541459.5	1707	1710	+	3	0	-2	5578
A8K2U0-1#7	0	1	1	A8K2U0-1	1019	1020	+	1	A8K2U0-1	492	1454	ENST00000539547.5	171	3057	++	153	A8K2U0-1#7	0	3	ENST00000539547.5	1752	1755	+	3	0	-2	5579
A8K2U0-1#7	0	1	1	A8K2U0-1	1019	1020	+	1	A8K2U0-1	0	1454	ENST00000299698.12	31	4393	++	21	A8K2U0-1#7	0	3	ENST00000299698.12	3088	3091	+	3	0	-2	5580
A8K2U0-1#8	0	39	39	A8K2U0-1	39	78	+	39	A8K2U0-1	0	1454	ENST00000299698.12	31	4393	++	21	A8K2U0-1#8	0	117	ENST00000299698.12	148	265	+	117	0	-78	5581
A8K2U0-1#9	0	51	51	A8K2U0-1	240	291	+	51	A8K2U0-1	0	1454	ENST00000299698.12	31	4393	++	21	A8K2U0-1#9	0	153	ENST00000299698.12	751	904	+	153	0	-102	5582
A8K2U0-1#10	0	21	21	A8K2U0-1	258	279	+	21	A8K2U0-1	0	1454	ENST00000299698.12	31	4393	++	21	A8K2U0-1#10	0	63	ENST00000299698.12	805	868	+	63	0	-42	5583
A8K2U0-1#11	0	94	94	A8K2U0-1	463	557	+	94	A8K2U0-1	492	671	ENST00000545692.1	31	568	++	158	A8K2U0-1#11	87	282	ENST00000545692.1	31	226	+	195	87	-188	5584
A8K2U0-1#11	0	94	94	A8K2U0-1	463	557	+	94	A8K2U0-1	450	1454	ENST00000541459.5	0	3012	++	154	A8K2U0-1#11	0	282	ENST00000541459.5	39	321	+	282	0	-188	5585
A8K2U0-1#11	0	94	94	A8K2U0-1	463	557	+	94	A8K2U0-1	492	1454	ENST00000539547.5	171	3057	++	153	A8K2U0-1#11	87	282	ENST00000539547.5	171	366	+	195	87	-188	5586
A8K2U0-1#11	0	94	94	A8K2U0-1	463	557	+	94	A8K2U0-1	491	528	ENST00000536789.5	350	461	++	151	A8K2U0-1#11	84	195	ENST00000536789.5	350	461	+	111	84	-101	5587
A8K2U0-1#11	0	94	94	A8K2U0-1	463	557	+	94	A8K2U0-1	0	1454	ENST00000299698.12	31	4393	++	21	A8K2U0-1#11	0	282	ENST00000299698.12	1420	1702	+	282	0	-188	5588
A8K2U0-1#12	0	181	181	A8K2U0-1	588	769	+	181	A8K2U0-1	492	671	ENST00000545692.1	31	568	++	158	A8K2U0-1#12	0	249	ENST00000545692.1	319	568	+	249	0	-68	5589
A8K2U0-1#12	0	181	181	A8K2U0-1	588	769	+	181	A8K2U0-1	450	1454	ENST00000541459.5	0	3012	++	154	A8K2U0-1#12	0	543	ENST00000541459.5	414	957	+	543	0	-362	5590
A8K2U0-1#12	0	181	181	A8K2U0-1	588	769	+	181	A8K2U0-1	492	1454	ENST00000539547.5	171	3057	++	153	A8K2U0-1#12	0	543	ENST00000539547.5	459	1002	+	543	0	-362	5591
A8K2U0-1#12	0	181	181	A8K2U0-1	588	769	+	181	A8K2U0-1	0	1454	ENST00000299698.12	31	4393	++	21	A8K2U0-1#12	0	543	ENST00000299698.12	1795	2338	+	543	0	-362	5592
A8K2U0-1#13	0	29	29	A8K2U0-1	818	847	+	29	A8K2U0-1	450	1454	ENST00000541459.5	0	3012	++	154	A8K2U0-1#13	0	87	ENST00000541459.5	1104	1191	+	87	0	-58	5593
A8K2U0-1#13	0	29	29	A8K2U0-1	818	847	+	29	A8K2U0-1	492	1454	ENST00000539547.5	171	3057	++	153	A8K2U0-1#13	0	87	ENST00000539547.5	1149	1236	+	87	0	-58	5594
A8K2U0-1#13	0	29	29	A8K2U0-1	818	847	+	29	A8K2U0-1	0	1454	ENST00000299698.12	31	4393	++	21	A8K2U0-1#13	0	87	ENST00000299698.12	2485	2572	+	87	0	-58	5595
A8K2U0-1#14	0	37	37	A8K2U0-1	844	881	+	37	A8K2U0-1	450	1454	ENST00000541459.5	0	3012	++	154	A8K2U0-1#14	0	111	ENST00000541459.5	1182	1293	+	111	0	-74	5596
A8K2U0-1#14	0	37	37	A8K2U0-1	844	881	+	37	A8K2U0-1	492	1454	ENST00000539547.5	171	3057	++	153	A8K2U0-1#14	0	111	ENST00000539547.5	1227	1338	+	111	0	-74	5597
A8K2U0-1#14	0	37	37	A8K2U0-1	844	881	+	37	A8K2U0-1	0	1454	ENST00000299698.12	31	4393	++	21	A8K2U0-1#14	0	111	ENST00000299698.12	2563	2674	+	111	0	-74	5598
A8K2U0-1#15	0	389	389	A8K2U0-1	918	1307	+	389	A8K2U0-1	450	1454	ENST00000541459.5	0	3012	++	154	A8K2U0-1#15	0	1167	ENST00000541459.5	1404	2571	+	1167	0	-778	5599
A8K2U0-1#15	0	389	389	A8K2U0-1	918	1307	+	389	A8K2U0-1	492	1454	ENST00000539547.5	171	3057	++	153	A8K2U0-1#15	0	1167	ENST00000539547.5	1449	2616	+	1167	0	-778	5600
A8K2U0-1#15	0	389	389	A8K2U0-1	918	1307	+	389	A8K2U0-1	1273	1454	ENST00000537475.1	1	544	++	152	A8K2U0-1#15	1065	1167	ENST00000537475.1	1	103	+	102	1065	-778	5601
A8K2U0-1#15	0	389	389	A8K2U0-1	918	1307	+	389	A8K2U0-1	0	1454	ENST00000299698.12	31	4393	++	21	A8K2U0-1#15	0	1167	ENST00000299698.12	2785	3952	+	1167	0	-778	5602
A8K2U0-1#16	0	49	49	A8K2U0-1	1074	1123	+	49	A8K2U0-1	450	1454	ENST00000541459.5	0	3012	++	154	A8K2U0-1#16	0	147	ENST00000541459.5	1872	2019	+	147	0	-98	5603
A8K2U0-1#16	0	49	49	A8K2U0-1	1074	1123	+	49	A8K2U0-1	492	1454	ENST00000539547.5	171	3057	++	153	A8K2U0-1#16	0	147	ENST00000539547.5	1917	2064	+	147	0	-98	5604
A8K2U0-1#16	0	49	49	A8K2U0-1	1074	1123	+	49	A8K2U0-1	0	1454	ENST00000299698.12	31	4393	++	21	A8K2U0-1#16	0	147	ENST00000299698.12	3253	3400	+	147	0	-98	5605
A8K2U0-1#17	0	116	116	A8K2U0-1	1337	1453	+	116	A8K2U0-1	450	1454	ENST00000541459.5	0	3012	++	154	A8K2U0-1#17	0	348	ENST00000541459.5	2661	3009	+	348	0	-232	5606
A8K2U0-1#17	0	116	116	A8K2U0-1	1337	1453	+	116	A8K2U0-1	492	1454	ENST00000539547.5	171	3057	++	153	A8K2U0-1#17	0	348	ENST00000539547.5	2706	3054	+	348	0	-232	5607
A8K2U0-1#17	0	116	116	A8K2U0-1	1337	1453	+	116	A8K2U0-1	1273	1454	ENST00000537475.1	1	544	++	152	A8K2U0-1#17	0	348	ENST00000537475.1	193	541	+	348	0	-232	5608
A8K2U0-1#17	0	116	116	A8K2U0-1	1337	1453	+	116	A8K2U0-1	0	1454	ENST00000299698.12	31	4393	++	21	A8K2U0-1#17	0	348	ENST00000299698.12	4042	4390	+	348	0	-232	5609
A8K2U0-1#18	0	4	4	A8K2U0-1	969	973	+	4	A8K2U0-1	450	1454	ENST00000541459.5	0	3012	++	154	A8K2U0-1#18	0	12	ENST00000541459.5	1557	1569	+	12	0	-8	5610
A8K2U0-1#18	0	4	4	A8K2U0-1	969	973	+	4	A8K2U0-1	492	1454	ENST00000539547.5	171	3057	++	153	A8K2U0-1#18	0	12	ENST00000539547.5	1602	1614	+	12	0	-8	5611
A8K2U0-1#18	0	4	4	A8K2U0-1	969	973	+	4	A8K2U0-1	0	1454	ENST00000299698.12	31	4393	++	21	A8K2U0-1#18	0	12	ENST00000299698.12	2938	2950	+	12	0	-8	5612
A8K2U0-1#19	0	491	491	A8K2U0-1	1	492	+	491	A8K2U0-1	450	1454	ENST00000541459.5	0	3012	++	154	A8K2U0-1#19	1347	1473	ENST00000541459.5	0	126	+	126	1347	-982	5613
A8K2U0-1#19	0	491	491	A8K2U0-1	1	492	+	491	A8K2U0-1	491	528	ENST00000536789.5	350	461	++	151	A8K2U0-1#19	1470	1473	ENST00000536789.5	350	353	+	3	1470	-982	5614
A8K2U0-1#19	0	491	491	A8K2U0-1	1	492	+	491	A8K2U0-1	0	1454	ENST00000299698.12	31	4393	++	21	A8K2U0-1#19	0	1473	ENST00000299698.12	34	1507	+	1473	0	-982	5615
A8K2U0-1#20	0	1	1	A8K2U0-1	206	207	+	1	A8K2U0-1	0	1454	ENST00000299698.12	31	4393	++	21	A8K2U0-1#20	0	3	ENST00000299698.12	649	652	+	3	0	-2	5616
A8K2U0-1#21	0	1200	1200	A8K2U0-1	254	1454	+	1200	A8K2U0-1	492	671	ENST00000545692.1	31	568	++	158	A8K2U0-1#21	714	1251	ENST00000545692.1	31	568	+	537	714	-51	5617
A8K2U0-1#21	0	1200	1200	A8K2U0-1	254	1454	+	1200	A8K2U0-1	450	1454	ENST00000541459.5	0	3012	++	154	A8K2U0-1#21	588	3600	ENST00000541459.5	0	3012	+	3012	588	-2400	5618
A8K2U0-1#21	0	1200	1200	A8K2U0-1	254	1454	+	1200	A8K2U0-1	492	1454	ENST00000539547.5	171	3057	++	153	A8K2U0-1#21	714	3600	ENST00000539547.5	171	3057	+	2886	714	-2400	5619
A8K2U0-1#21	0	1200	1200	A8K2U0-1	254	1454	+	1200	A8K2U0-1	1273	1454	ENST00000537475.1	1	544	++	152	A8K2U0-1#21	3057	3600	ENST00000537475.1	1	544	+	543	3057	-2400	5620
A8K2U0-1#21	0	1200	1200	A8K2U0-1	254	1454	+	1200	A8K2U0-1	491	528	ENST00000536789.5	350	461	++	151	A8K2U0-1#21	711	822	ENST00000536789.5	350	461	+	111	711	378	5621
A8K2U0-1#21	0	1200	1200	A8K2U0-1	254	1454	+	1200	A8K2U0-1	0	1454	ENST00000299698.12	31	4393	++	21	A8K2U0-1#21	0	3600	ENST00000299698.12	793	4393	+	3600	0	-2400	5622
A8K2U0-1#22	0	1	1	A8K2U0-1	295	296	+	1	A8K2U0-1	0	1454	ENST00000299698.12	31	4393	++	21	A8K2U0-1#22	0	3	ENST00000299698.12	916	919	+	3	0	-2	5623
A8K2U0-1#23	0	1	1	A8K2U0-1	355	356	+	1	A8K2U0-1	0	1454	ENST00000299698.12	31	4393	++	21	A8K2U0-1#23	0	3	ENST00000299698.12	1096	1099	+	3	0	-2	5624
A8K2U0-1#24	0	1	1	A8K2U0-1	849	850	+	1	A8K2U0-1	450	1454	ENST00000541459.5	0	3012	++	154	A8K2U0-1#24	0	3	ENST00000541459.5	1197	1200	+	3	0	-2	5625
A8K2U0-1#24	0	1	1	A8K2U0-1	849	850	+	1	A8K2U0-1	492	1454	ENST00000539547.5	171	3057	++	153	A8K2U0-1#24	0	3	ENST00000539547.5	1242	1245	+	3	0	-2	5626
A8K2U0-1#24	0	1	1	A8K2U0-1	849	850	+	1	A8K2U0-1	0	1454	ENST00000299698.12	31	4393	++	21	A8K2U0-1#24	0	3	ENST00000299698.12	2578	2581	+	3	0	-2	5627
A8K2U0-1#25	0	562	562	A8K2U0-1	892	1454	+	562	A8K2U0-1	450	1454	ENST00000541459.5	0	3012	++	154	A8K2U0-1#25	0	1686	ENST00000541459.5	1326	3012	+	1686	0	-1124	5628
A8K2U0-1#25	0	562	562	A8K2U0-1	892	1454	+	562	A8K2U0-1	492	1454	ENST00000539547.5	171	3057	++	153	A8K2U0-1#25	0	1686	ENST00000539547.5	1371	3057	+	1686	0	-1124	5629
A8K2U0-1#25	0	562	562	A8K2U0-1	892	1454	+	562	A8K2U0-1	1273	1454	ENST00000537475.1	1	544	++	152	A8K2U0-1#25	1143	1686	ENST00000537475.1	1	544	+	543	1143	-1124	5630
A8K2U0-1#25	0	562	562	A8K2U0-1	892	1454	+	562	A8K2U0-1	0	1454	ENST00000299698.12	31	4393	++	21	A8K2U0-1#25	0	1686	ENST00000299698.12	2707	4393	+	1686	0	-1124	5631
A8K2U0-1#26	0	1	1	A8K2U0-1	969	970	+	1	A8K2U0-1	450	1454	ENST00000541459.5	0	3012	++	154	A8K2U0-1#26	0	3	ENST00000541459.5	1557	1560	+	3	0	-2	5632
A8K2U0-1#26	0	1	1	A8K2U0-1	969	970	+	1	A8K2U0-1	492	1454	ENST00000539547.5	171	3057	++	153	A8K2U0-1#26	0	3	ENST00000539547.5	1602	1605	+	3	0	-2	5633
A8K2U0-1#26	0	1	1	A8K2U0-1	969	970	+	1	A8K2U0-1	0	1454	ENST00000299698.12	31	4393	++	21	A8K2U0-1#26	0	3	ENST00000299698.12	2938	2941	+	3	0	-2	5634
A8K2U0-1#27	0	483	483	A8K2U0-1	971	1454	+	483	A8K2U0-1	450	1454	ENST00000541459.5	0	3012	++	154	A8K2U0-1#27	0	1449	ENST00000541459.5	1563	3012	+	1449	0	-966	5635
A8K2U0-1#27	0	483	483	A8K2U0-1	971	1454	+	483	A8K2U0-1	492	1454	ENST00000539547.5	171	3057	++	153	A8K2U0-1#27	0	1449	ENST00000539547.5	1608	3057	+	1449	0	-966	5636
A8K2U0-1#27	0	483	483	A8K2U0-1	971	1454	+	483	A8K2U0-1	1273	1454	ENST00000537475.1	1	544	++	152	A8K2U0-1#27	906	1449	ENST00000537475.1	1	544	+	543	906	-966	5637
A8K2U0-1#27	0	483	483	A8K2U0-1	971	1454	+	483	A8K2U0-1	0	1454	ENST00000299698.12	31	4393	++	21	A8K2U0-1#27	0	1449	ENST00000299698.12	2944	4393	+	1449	0	-966	5638
A8K2U0-1#28	0	1	1	A8K2U0-1	1000	1001	+	1	A8K2U0-1	450	1454	ENST00000541459.5	0	3012	++	154	A8K2U0-1#28	0	3	ENST00000541459.5	1650	1653	+	3	0	-2	5639
A8K2U0-1#28	0	1	1	A8K2U0-1	1000	1001	+	1	A8K2U0-1	492	1454	ENST00000539547.5	171	3057	++	153	A8K2U0-1#28	0	3	ENST00000539547.5	1695	1698	+	3	0	-2	5640
A8K2U0-1#28	0	1	1	A8K2U0-1	1000	1001	+	1	A8K2U0-1	0	1454	ENST00000299698.12	31	4393	++	21	A8K2U0-1#28	0	3	ENST00000299698.12	3031	3034	+	3	0	-2	5641
A8K2U0-1#29	0	1	1	A8K2U0-1	1121	1122	+	1	A8K2U0-1	450	1454	ENST00000541459.5	0	3012	++	154	A8K2U0-1#29	0	3	ENST00000541459.5	2013	2016	+	3	0	-2	5642
A8K2U0-1#29	0	1	1	A8K2U0-1	1121	1122	+	1	A8K2U0-1	492	1454	ENST00000539547.5	171	3057	++	153	A8K2U0-1#29	0	3	ENST00000539547.5	2058	2061	+	3	0	-2	5643
A8K2U0-1#29	0	1	1	A8K2U0-1	1121	1122	+	1	A8K2U0-1	0	1454	ENST00000299698.12	31	4393	++	21	A8K2U0-1#29	0	3	ENST00000299698.12	3394	3397	+	3	0	-2	5644
A8K2U0-1#30	0	1	1	A8K2U0-1	1130	1131	+	1	A8K2U0-1	450	1454	ENST00000541459.5	0	3012	++	154	A8K2U0-1#30	0	3	ENST00000541459.5	2040	2043	+	3	0	-2	5645
A8K2U0-1#30	0	1	1	A8K2U0-1	1130	1131	+	1	A8K2U0-1	492	1454	ENST00000539547.5	171	3057	++	153	A8K2U0-1#30	0	3	ENST00000539547.5	2085	2088	+	3	0	-2	5646
A8K2U0-1#30	0	1	1	A8K2U0-1	1130	1131	+	1	A8K2U0-1	0	1454	ENST00000299698.12	31	4393	++	21	A8K2U0-1#30	0	3	ENST00000299698.12	3421	3424	+	3	0	-2	5647
A8K2U0-1#31	0	1	1	A8K2U0-1	1228	1229	+	1	A8K2U0-1	450	1454	ENST00000541459.5	0	3012	++	154	A8K2U0-1#31	0	3	ENST00000541459.5	2334	2337	+	3	0	-2	5648
A8K2U0-1#31	0	1	1	A8K2U0-1	1228	1229	+	1	A8K2U0-1	492	1454	ENST00000539547.5	171	3057	++	153	A8K2U0-1#31	0	3	ENST00000539547.5	2379	2382	+	3	0	-2	5649
A8K2U0-1#31	0	1	1	A8K2U0-1	1228	1229	+	1	A8K2U0-1	0	1454	ENST00000299698.12	31	4393	++	21	A8K2U0-1#31	0	3	ENST00000299698.12	3715	3718	+	3	0	-2	5650
A8K2U0-1#32	0	1	1	A8K2U0-1	1256	1257	+	1	A8K2U0-1	450	1454	ENST00000541459.5	0	3012	++	154	A8K2U0-1#32	0	3	ENST00000541459.5	2418	2421	+	3	0	-2	5651
A8K2U0-1#32	0	1	1	A8K2U0-1	1256	1257	+	1	A8K2U0-1	492	1454	ENST00000539547.5	171	3057	++	153	A8K2U0-1#32	0	3	ENST00000539547.5	2463	2466	+	3	0	-2	5652
A8K2U0-1#32	0	1	1	A8K2U0-1	1256	1257	+	1	A8K2U0-1	0	1454	ENST00000299698.12	31	4393	++	21	A8K2U0-1#32	0	3	ENST00000299698.12	3799	3802	+	3	0	-2	5653
A8K2U0-1#33	0	1	1	A8K2U0-1	1311	1312	+	1	A8K2U0-1	450	1454	ENST00000541459.5	0	3012	++	154	A8K2U0-1#33	0	3	ENST00000541459.5	2583	2586	+	3	0	-2	5654
A8K2U0-1#33	0	1	1	A8K2U0-1	1311	1312	+	1	A8K2U0-1	492	1454	ENST00000539547.5	171	3057	++	153	A8K2U0-1#33	0	3	ENST00000539547.5	2628	2631	+	3	0	-2	5655
A8K2U0-1#33	0	1	1	A8K2U0-1	1311	1312	+	1	A8K2U0-1	1273	1454	ENST00000537475.1	1	544	++	152	A8K2U0-1#33	0	3	ENST00000537475.1	115	118	+	3	0	-2	5656
A8K2U0-1#33	0	1	1	A8K2U0-1	1311	1312	+	1	A8K2U0-1	0	1454	ENST00000299698.12	31	4393	++	21	A8K2U0-1#33	0	3	ENST00000299698.12	3964	3967	+	3	0	-2	5657
A8K2U0-1#34	0	1	1	A8K2U0-1	1411	1412	+	1	A8K2U0-1	450	1454	ENST00000541459.5	0	3012	++	154	A8K2U0-1#34	0	3	ENST00000541459.5	2883	2886	+	3	0	-2	5658
A8K2U0-1#34	0	1	1	A8K2U0-1	1411	1412	+	1	A8K2U0-1	492	1454	ENST00000539547.5	171	3057	++	153	A8K2U0-1#34	0	3	ENST00000539547.5	2928	2931	+	3	0	-2	5659
A8K2U0-1#34	0	1	1	A8K2U0-1	1411	1412	+	1	A8K2U0-1	1273	1454	ENST00000537475.1	1	544	++	152	A8K2U0-1#34	0	3	ENST00000537475.1	415	418	+	3	0	-2	5660
A8K2U0-1#34	0	1	1	A8K2U0-1	1411	1412	+	1	A8K2U0-1	0	1454	ENST00000299698.12	31	4393	++	21	A8K2U0-1#34	0	3	ENST00000299698.12	4264	4267	+	3	0	-2	5661
A8K2U0-1#35	0	1	1	A8K2U0-1	1430	1431	+	1	A8K2U0-1	450	1454	ENST00000541459.5	0	3012	++	154	A8K2U0-1#35	0	3	ENST00000541459.5	2940	2943	+	3	0	-2	5662
A8K2U0-1#35	0	1	1	A8K2U0-1	1430	1431	+	1	A8K2U0-1	492	1454	ENST00000539547.5	171	3057	++	153	A8K2U0-1#35	0	3	ENST00000539547.5	2985	2988	+	3	0	-2	5663
A8K2U0-1#35	0	1	1	A8K2U0-1	1430	1431	+	1	A8K2U0-1	1273	1454	ENST00000537475.1	1	544	++	152	A8K2U0-1#35	0	3	ENST00000537475.1	472	475	+	3	0	-2	5664
A8K2U0-1#35	0	1	1	A8K2U0-1	1430	1431	+	1	A8K2U0-1	0	1454	ENST00000299698.12	31	4393	++	21	A8K2U0-1#35	0	3	ENST00000299698.12	4321	4324	+	3	0	-2	5665
A8K2U0-1#36	0	1	1	A8K2U0-1	732	733	+	1	A8K2U0-1	450	1454	ENST00000541459.5	0	3012	++	154	A8K2U0-1#36	0	3	ENST00000541459.5	846	849	+	3	0	-2	5666
A8K2U0-1#36	0	1	1	A8K2U0-1	732	733	+	1	A8K2U0-1	492	1454	ENST00000539547.5	171	3057	++	153	A8K2U0-1#36	0	3	ENST00000539547.5	891	894	+	3	0	-2	5667
A8K2U0-1#36	0	1	1	A8K2U0-1	732	733	+	1	A8K2U0-1	0	1454	ENST00000299698.12	31	4393	++	21	A8K2U0-1#36	0	3	ENST00000299698.12	2227	2230	+	3	0	-2	5668
A8K2U0-1#37	0	1	1	A8K2U0-1	747	748	+	1	A8K2U0-1	450	1454	ENST00000541459.5	0	3012	++	154	A8K2U0-1#37	0	3	ENST00000541459.5	891	894	+	3	0	-2	5669
A8K2U0-1#37	0	1	1	A8K2U0-1	747	748	+	1	A8K2U0-1	492	1454	ENST00000539547.5	171	3057	++	153	A8K2U0-1#37	0	3	ENST00000539547.5	936	939	+	3	0	-2	5670
A8K2U0-1#37	0	1	1	A8K2U0-1	747	748	+	1	A8K2U0-1	0	1454	ENST00000299698.12	31	4393	++	21	A8K2U0-1#37	0	3	ENST00000299698.12	2272	2275	+	3	0	-2	5671
A8K2U0-1#38	0	1	1	A8K2U0-1	1149	1150	+	1	A8K2U0-1	450	1454	ENST00000541459.5	0	3012	++	154	A8K2U0-1#38	0	3	ENST00000541459.5	2097	2100	+	3	0	-2	5672
A8K2U0-1#38	0	1	1	A8K2U0-1	1149	1150	+	1	A8K2U0-1	492	1454	ENST00000539547.5	171	3057	++	153	A8K2U0-1#38	0	3	ENST00000539547.5	2142	2145	+	3	0	-2	5673
A8K2U0-1#38	0	1	1	A8K2U0-1	1149	1150	+	1	A8K2U0-1	0	1454	ENST00000299698.12	31	4393	++	21	A8K2U0-1#38	0	3	ENST00000299698.12	3478	3481	+	3	0	-2	5674
A8K2U0-1#39	0	1	1	A8K2U0-1	1247	1248	+	1	A8K2U0-1	450	1454	ENST00000541459.5	0	3012	++	154	A8K2U0-1#39	0	3	ENST00000541459.5	2391	2394	+	3	0	-2	5675
A8K2U0-1#39	0	1	1	A8K2U0-1	1247	1248	+	1	A8K2U0-1	492	1454	ENST00000539547.5	171	3057	++	153	A8K2U0-1#39	0	3	ENST00000539547.5	2436	2439	+	3	0	-2	5676
A8K2U0-1#39	0	1	1	A8K2U0-1	1247	1248	+	1	A8K2U0-1	0	1454	ENST00000299698.12	31	4393	++	21	A8K2U0-1#39	0	3	ENST00000299698.12	3772	3775	+	3	0	-2	5677
A8K2U0-1#40	0	1	1	A8K2U0-1	1451	1452	+	1	A8K2U0-1	450	1454	ENST00000541459.5	0	3012	++	154	A8K2U0-1#40	0	3	ENST00000541459.5	3003	3006	+	3	0	-2	5678
A8K2U0-1#40	0	1	1	A8K2U0-1	1451	1452	+	1	A8K2U0-1	492	1454	ENST00000539547.5	171	3057	++	153	A8K2U0-1#40	0	3	ENST00000539547.5	3048	3051	+	3	0	-2	5679
A8K2U0-1#40	0	1	1	A8K2U0-1	1451	1452	+	1	A8K2U0-1	1273	1454	ENST00000537475.1	1	544	++	152	A8K2U0-1#40	0	3	ENST00000537475.1	535	538	+	3	0	-2	5680
A8K2U0-1#40	0	1	1	A8K2U0-1	1451	1452	+	1	A8K2U0-1	0	1454	ENST00000299698.12	31	4393	++	21	A8K2U0-1#40	0	3	ENST00000299698.12	4384	4387	+	3	0	-2	5681
A8K2U0-1#41	0	9	9	A8K2U0-1	23	32	+	9	A8K2U0-1	0	1454	ENST00000299698.12	31	4393	++	21	A8K2U0-1#41	0	27	ENST00000299698.12	100	127	+	27	0	-18	5682
A8K2U0-1#42	0	8	8	A8K2U0-1	34	42	+	8	A8K2U0-1	0	1454	ENST00000299698.12	31	4393	++	21	A8K2U0-1#42	0	24	ENST00000299698.12	133	157	+	24	0	-16	5683
A8K2U0-1#43	0	7	7	A8K2U0-1	50	57	+	7	A8K2U0-1	0	1454	ENST00000299698.12	31	4393	++	21	A8K2U0-1#43	0	21	ENST00000299698.12	181	202	+	21	0	-14	5684
A8K2U0-1#44	0	8	8	A8K2U0-1	61	69	+	8	A8K2U0-1	0	1454	ENST00000299698.12	31	4393	++	21	A8K2U0-1#44	0	24	ENST00000299698.12	214	238	+	24	0	-16	5685
A8K2U0-1#45	0	7	7	A8K2U0-1	75	82	+	7	A8K2U0-1	0	1454	ENST00000299698.12	31	4393	++	21	A8K2U0-1#45	0	21	ENST00000299698.12	256	277	+	21	0	-14	5686
A8K2U0-1#46	0	16	16	A8K2U0-1	86	102	+	16	A8K2U0-1	0	1454	ENST00000299698.12	31	4393	++	21	A8K2U0-1#46	0	48	ENST00000299698.12	289	337	+	48	0	-32	5687
A8K2U0-1#47	0	12	12	A8K2U0-1	104	116	+	12	A8K2U0-1	0	1454	ENST00000299698.12	31	4393	++	21	A8K2U0-1#47	0	36	ENST00000299698.12	343	379	+	36	0	-24	5688
A8K2U0-1#48	0	7	7	A8K2U0-1	120	127	+	7	A8K2U0-1	0	1454	ENST00000299698.12	31	4393	++	21	A8K2U0-1#48	0	21	ENST00000299698.12	391	412	+	21	0	-14	5689
A8K2U0-1#49	0	3	3	A8K2U0-1	128	131	+	3	A8K2U0-1	0	1454	ENST00000299698.12	31	4393	++	21	A8K2U0-1#49	0	9	ENST00000299698.12	415	424	+	9	0	-6	5690
A8K2U0-1#50	0	9	9	A8K2U0-1	135	144	+	9	A8K2U0-1	0	1454	ENST00000299698.12	31	4393	++	21	A8K2U0-1#50	0	27	ENST00000299698.12	436	463	+	27	0	-18	5691
A8K2U0-1#51	0	7	7	A8K2U0-1	154	161	+	7	A8K2U0-1	0	1454	ENST00000299698.12	31	4393	++	21	A8K2U0-1#51	0	21	ENST00000299698.12	493	514	+	21	0	-14	5692
A8K2U0-1#52	0	8	8	A8K2U0-1	166	174	+	8	A8K2U0-1	0	1454	ENST00000299698.12	31	4393	++	21	A8K2U0-1#52	0	24	ENST00000299698.12	529	553	+	24	0	-16	5693
A8K2U0-1#53	0	7	7	A8K2U0-1	179	186	+	7	A8K2U0-1	0	1454	ENST00000299698.12	31	4393	++	21	A8K2U0-1#53	0	21	ENST00000299698.12	568	589	+	21	0	-14	5694
A8K2U0-1#54	0	7	7	A8K2U0-1	193	200	+	7	A8K2U0-1	0	1454	ENST00000299698.12	31	4393	++	21	A8K2U0-1#54	0	21	ENST00000299698.12	610	631	+	21	0	-14	5695
A8K2U0-1#55	0	4	4	A8K2U0-1	200	204	+	4	A8K2U0-1	0	1454	ENST00000299698.12	31	4393	++	21	A8K2U0-1#55	0	12	ENST00000299698.12	631	643	+	12	0	-8	5696
A8K2U0-1#56	0	7	7	A8K2U0-1	204	211	+	7	A8K2U0-1	0	1454	ENST00000299698.12	31	4393	++	21	A8K2U0-1#56	0	21	ENST00000299698.12	643	664	+	21	0	-14	5697
A8K2U0-1#57	0	5	5	A8K2U0-1	218	223	+	5	A8K2U0-1	0	1454	ENST00000299698.12	31	4393	++	21	A8K2U0-1#57	0	15	ENST00000299698.12	685	700	+	15	0	-10	5698
A8K2U0-1#58	0	6	6	A8K2U0-1	226	232	+	6	A8K2U0-1	0	1454	ENST00000299698.12	31	4393	++	21	A8K2U0-1#58	0	18	ENST00000299698.12	709	727	+	18	0	-12	5699
A8K2U0-1#59	0	11	11	A8K2U0-1	233	244	+	11	A8K2U0-1	0	1454	ENST00000299698.12	31	4393	++	21	A8K2U0-1#59	0	33	ENST00000299698.12	730	763	+	33	0	-22	5700
A8K2U0-1#60	0	11	11	A8K2U0-1	251	262	+	11	A8K2U0-1	0	1454	ENST00000299698.12	31	4393	++	21	A8K2U0-1#60	0	33	ENST00000299698.12	784	817	+	33	0	-22	5701
A8K2U0-1#61	0	3	3	A8K2U0-1	268	271	+	3	A8K2U0-1	0	1454	ENST00000299698.12	31	4393	++	21	A8K2U0-1#61	0	9	ENST00000299698.12	835	844	+	9	0	-6	5702
A8K2U0-1#62	0	8	8	A8K2U0-1	277	285	+	8	A8K2U0-1	0	1454	ENST00000299698.12	31	4393	++	21	A8K2U0-1#62	0	24	ENST00000299698.12	862	886	+	24	0	-16	5703
A8K2U0-1#63	0	7	7	A8K2U0-1	290	297	+	7	A8K2U0-1	0	1454	ENST00000299698.12	31	4393	++	21	A8K2U0-1#63	0	21	ENST00000299698.12	901	922	+	21	0	-14	5704
A8K2U0-1#64	0	3	3	A8K2U0-1	297	300	+	3	A8K2U0-1	0	1454	ENST00000299698.12	31	4393	++	21	A8K2U0-1#64	0	9	ENST00000299698.12	922	931	+	9	0	-6	5705
A8K2U0-1#65	0	15	15	A8K2U0-1	305	320	+	15	A8K2U0-1	0	1454	ENST00000299698.12	31	4393	++	21	A8K2U0-1#65	0	45	ENST00000299698.12	946	991	+	45	0	-30	5706
A8K2U0-1#66	0	3	3	A8K2U0-1	320	323	+	3	A8K2U0-1	0	1454	ENST00000299698.12	31	4393	++	21	A8K2U0-1#66	0	9	ENST00000299698.12	991	1000	+	9	0	-6	5707
A8K2U0-1#67	0	11	11	A8K2U0-1	325	336	+	11	A8K2U0-1	0	1454	ENST00000299698.12	31	4393	++	21	A8K2U0-1#67	0	33	ENST00000299698.12	1006	1039	+	33	0	-22	5708
A8K2U0-1#68	0	10	10	A8K2U0-1	337	347	+	10	A8K2U0-1	0	1454	ENST00000299698.12	31	4393	++	21	A8K2U0-1#68	0	30	ENST00000299698.12	1042	1072	+	30	0	-20	5709
A8K2U0-1#69	0	3	3	A8K2U0-1	348	351	+	3	A8K2U0-1	0	1454	ENST00000299698.12	31	4393	++	21	A8K2U0-1#69	0	9	ENST00000299698.12	1075	1084	+	9	0	-6	5710
A8K2U0-1#70	0	8	8	A8K2U0-1	356	364	+	8	A8K2U0-1	0	1454	ENST00000299698.12	31	4393	++	21	A8K2U0-1#70	0	24	ENST00000299698.12	1099	1123	+	24	0	-16	5711
A8K2U0-1#71	0	3	3	A8K2U0-1	365	368	+	3	A8K2U0-1	0	1454	ENST00000299698.12	31	4393	++	21	A8K2U0-1#71	0	9	ENST00000299698.12	1126	1135	+	9	0	-6	5712
A8K2U0-1#72	0	8	8	A8K2U0-1	374	382	+	8	A8K2U0-1	0	1454	ENST00000299698.12	31	4393	++	21	A8K2U0-1#72	0	24	ENST00000299698.12	1153	1177	+	24	0	-16	5713
A8K2U0-1#73	0	5	5	A8K2U0-1	387	392	+	5	A8K2U0-1	0	1454	ENST00000299698.12	31	4393	++	21	A8K2U0-1#73	0	15	ENST00000299698.12	1192	1207	+	15	0	-10	5714
A8K2U0-1#74	0	6	6	A8K2U0-1	397	403	+	6	A8K2U0-1	0	1454	ENST00000299698.12	31	4393	++	21	A8K2U0-1#74	0	18	ENST00000299698.12	1222	1240	+	18	0	-12	5715
A8K2U0-1#75	0	3	3	A8K2U0-1	405	408	+	3	A8K2U0-1	0	1454	ENST00000299698.12	31	4393	++	21	A8K2U0-1#75	0	9	ENST00000299698.12	1246	1255	+	9	0	-6	5716
A8K2U0-1#76	0	7	7	A8K2U0-1	412	419	+	7	A8K2U0-1	0	1454	ENST00000299698.12	31	4393	++	21	A8K2U0-1#76	0	21	ENST00000299698.12	1267	1288	+	21	0	-14	5717
A8K2U0-1#77	0	3	3	A8K2U0-1	427	430	+	3	A8K2U0-1	0	1454	ENST00000299698.12	31	4393	++	21	A8K2U0-1#77	0	9	ENST00000299698.12	1312	1321	+	9	0	-6	5718
A8K2U0-1#78	0	3	3	A8K2U0-1	433	436	+	3	A8K2U0-1	0	1454	ENST00000299698.12	31	4393	++	21	A8K2U0-1#78	0	9	ENST00000299698.12	1330	1339	+	9	0	-6	5719
A8K2U0-1#79	0	7	7	A8K2U0-1	437	444	+	7	A8K2U0-1	0	1454	ENST00000299698.12	31	4393	++	21	A8K2U0-1#79	0	21	ENST00000299698.12	1342	1363	+	21	0	-14	5720
A8K2U0-1#80	0	3	3	A8K2U0-1	447	450	+	3	A8K2U0-1	0	1454	ENST00000299698.12	31	4393	++	21	A8K2U0-1#80	0	9	ENST00000299698.12	1372	1381	+	9	0	-6	5721
A8K2U0-1#81	0	4	4	A8K2U0-1	451	455	+	4	A8K2U0-1	450	1454	ENST00000541459.5	0	3012	++	154	A8K2U0-1#81	0	12	ENST00000541459.5	3	15	+	12	0	-8	5722
A8K2U0-1#81	0	4	4	A8K2U0-1	451	455	+	4	A8K2U0-1	0	1454	ENST00000299698.12	31	4393	++	21	A8K2U0-1#81	0	12	ENST00000299698.12	1384	1396	+	12	0	-8	5723
A8K2U0-1#82	0	10	10	A8K2U0-1	465	475	+	10	A8K2U0-1	450	1454	ENST00000541459.5	0	3012	++	154	A8K2U0-1#82	0	30	ENST00000541459.5	45	75	+	30	0	-20	5724
A8K2U0-1#82	0	10	10	A8K2U0-1	465	475	+	10	A8K2U0-1	0	1454	ENST00000299698.12	31	4393	++	21	A8K2U0-1#82	0	30	ENST00000299698.12	1426	1456	+	30	0	-20	5725
A8K2U0-1#83	0	3	3	A8K2U0-1	478	481	+	3	A8K2U0-1	450	1454	ENST00000541459.5	0	3012	++	154	A8K2U0-1#83	0	9	ENST00000541459.5	84	93	+	9	0	-6	5726
A8K2U0-1#83	0	3	3	A8K2U0-1	478	481	+	3	A8K2U0-1	0	1454	ENST00000299698.12	31	4393	++	21	A8K2U0-1#83	0	9	ENST00000299698.12	1465	1474	+	9	0	-6	5727
A8K2U0-1#84	0	3	3	A8K2U0-1	482	485	+	3	A8K2U0-1	450	1454	ENST00000541459.5	0	3012	++	154	A8K2U0-1#84	0	9	ENST00000541459.5	96	105	+	9	0	-6	5728
A8K2U0-1#84	0	3	3	A8K2U0-1	482	485	+	3	A8K2U0-1	0	1454	ENST00000299698.12	31	4393	++	21	A8K2U0-1#84	0	9	ENST00000299698.12	1477	1486	+	9	0	-6	5729
A8K2U0-1#85	0	9	9	A8K2U0-1	486	495	+	9	A8K2U0-1	492	671	ENST00000545692.1	31	568	++	158	A8K2U0-1#85	18	27	ENST00000545692.1	31	40	+	9	18	-18	5730
A8K2U0-1#85	0	9	9	A8K2U0-1	486	495	+	9	A8K2U0-1	450	1454	ENST00000541459.5	0	3012	++	154	A8K2U0-1#85	0	27	ENST00000541459.5	108	135	+	27	0	-18	5731
A8K2U0-1#85	0	9	9	A8K2U0-1	486	495	+	9	A8K2U0-1	492	1454	ENST00000539547.5	171	3057	++	153	A8K2U0-1#85	18	27	ENST00000539547.5	171	180	+	9	18	-18	5732
A8K2U0-1#85	0	9	9	A8K2U0-1	486	495	+	9	A8K2U0-1	491	528	ENST00000536789.5	350	461	++	151	A8K2U0-1#85	15	27	ENST00000536789.5	350	362	+	12	15	-18	5733
A8K2U0-1#85	0	9	9	A8K2U0-1	486	495	+	9	A8K2U0-1	0	1454	ENST00000299698.12	31	4393	++	21	A8K2U0-1#85	0	27	ENST00000299698.12	1489	1516	+	27	0	-18	5734
A8K2U0-1#86	0	10	10	A8K2U0-1	497	507	+	10	A8K2U0-1	492	671	ENST00000545692.1	31	568	++	158	A8K2U0-1#86	0	30	ENST00000545692.1	46	76	+	30	0	-20	5735
A8K2U0-1#86	0	10	10	A8K2U0-1	497	507	+	10	A8K2U0-1	450	1454	ENST00000541459.5	0	3012	++	154	A8K2U0-1#86	0	30	ENST00000541459.5	141	171	+	30	0	-20	5736
A8K2U0-1#86	0	10	10	A8K2U0-1	497	507	+	10	A8K2U0-1	492	1454	ENST00000539547.5	171	3057	++	153	A8K2U0-1#86	0	30	ENST00000539547.5	186	216	+	30	0	-20	5737
A8K2U0-1#86	0	10	10	A8K2U0-1	497	507	+	10	A8K2U0-1	491	528	ENST00000536789.5	350	461	++	151	A8K2U0-1#86	0	30	ENST00000536789.5	368	398	+	30	0	-20	5738
A8K2U0-1#86	0	10	10	A8K2U0-1	497	507	+	10	A8K2U0-1	0	1454	ENST00000299698.12	31	4393	++	21	A8K2U0-1#86	0	30	ENST00000299698.12	1522	1552	+	30	0	-20	5739
A8K2U0-1#87	0	3	3	A8K2U0-1	508	511	+	3	A8K2U0-1	492	671	ENST00000545692.1	31	568	++	158	A8K2U0-1#87	0	9	ENST00000545692.1	79	88	+	9	0	-6	5740
A8K2U0-1#87	0	3	3	A8K2U0-1	508	511	+	3	A8K2U0-1	450	1454	ENST00000541459.5	0	3012	++	154	A8K2U0-1#87	0	9	ENST00000541459.5	174	183	+	9	0	-6	5741
A8K2U0-1#87	0	3	3	A8K2U0-1	508	511	+	3	A8K2U0-1	492	1454	ENST00000539547.5	171	3057	++	153	A8K2U0-1#87	0	9	ENST00000539547.5	219	228	+	9	0	-6	5742
A8K2U0-1#87	0	3	3	A8K2U0-1	508	511	+	3	A8K2U0-1	491	528	ENST00000536789.5	350	461	++	151	A8K2U0-1#87	0	9	ENST00000536789.5	401	410	+	9	0	-6	5743
A8K2U0-1#87	0	3	3	A8K2U0-1	508	511	+	3	A8K2U0-1	0	1454	ENST00000299698.12	31	4393	++	21	A8K2U0-1#87	0	9	ENST00000299698.12	1555	1564	+	9	0	-6	5744
A8K2U0-1#88	0	8	8	A8K2U0-1	515	523	+	8	A8K2U0-1	492	671	ENST00000545692.1	31	568	++	158	A8K2U0-1#88	0	24	ENST00000545692.1	100	124	+	24	0	-16	5745
A8K2U0-1#88	0	8	8	A8K2U0-1	515	523	+	8	A8K2U0-1	450	1454	ENST00000541459.5	0	3012	++	154	A8K2U0-1#88	0	24	ENST00000541459.5	195	219	+	24	0	-16	5746
A8K2U0-1#88	0	8	8	A8K2U0-1	515	523	+	8	A8K2U0-1	492	1454	ENST00000539547.5	171	3057	++	153	A8K2U0-1#88	0	24	ENST00000539547.5	240	264	+	24	0	-16	5747
A8K2U0-1#88	0	8	8	A8K2U0-1	515	523	+	8	A8K2U0-1	491	528	ENST00000536789.5	350	461	++	151	A8K2U0-1#88	0	24	ENST00000536789.5	422	446	+	24	0	-16	5748
A8K2U0-1#88	0	8	8	A8K2U0-1	515	523	+	8	A8K2U0-1	0	1454	ENST00000299698.12	31	4393	++	21	A8K2U0-1#88	0	24	ENST00000299698.12	1576	1600	+	24	0	-16	5749
A8K2U0-1#89	0	3	3	A8K2U0-1	525	528	+	3	A8K2U0-1	492	671	ENST00000545692.1	31	568	++	158	A8K2U0-1#89	0	9	ENST00000545692.1	130	139	+	9	0	-6	5750
A8K2U0-1#89	0	3	3	A8K2U0-1	525	528	+	3	A8K2U0-1	450	1454	ENST00000541459.5	0	3012	++	154	A8K2U0-1#89	0	9	ENST00000541459.5	225	234	+	9	0	-6	5751
A8K2U0-1#89	0	3	3	A8K2U0-1	525	528	+	3	A8K2U0-1	492	1454	ENST00000539547.5	171	3057	++	153	A8K2U0-1#89	0	9	ENST00000539547.5	270	279	+	9	0	-6	5752
A8K2U0-1#89	0	3	3	A8K2U0-1	525	528	+	3	A8K2U0-1	491	528	ENST00000536789.5	350	461	++	151	A8K2U0-1#89	0	9	ENST00000536789.5	452	461	+	9	0	-6	5753
A8K2U0-1#89	0	3	3	A8K2U0-1	525	528	+	3	A8K2U0-1	0	1454	ENST00000299698.12	31	4393	++	21	A8K2U0-1#89	0	9	ENST00000299698.12	1606	1615	+	9	0	-6	5754
A8K2U0-1#90	0	7	7	A8K2U0-1	532	539	+	7	A8K2U0-1	492	671	ENST00000545692.1	31	568	++	158	A8K2U0-1#90	0	21	ENST00000545692.1	151	172	+	21	0	-14	5755
A8K2U0-1#90	0	7	7	A8K2U0-1	532	539	+	7	A8K2U0-1	450	1454	ENST00000541459.5	0	3012	++	154	A8K2U0-1#90	0	21	ENST00000541459.5	246	267	+	21	0	-14	5756
A8K2U0-1#90	0	7	7	A8K2U0-1	532	539	+	7	A8K2U0-1	492	1454	ENST00000539547.5	171	3057	++	153	A8K2U0-1#90	0	21	ENST00000539547.5	291	312	+	21	0	-14	5757
A8K2U0-1#90	0	7	7	A8K2U0-1	532	539	+	7	A8K2U0-1	0	1454	ENST00000299698.12	31	4393	++	21	A8K2U0-1#90	0	21	ENST00000299698.12	1627	1648	+	21	0	-14	5758
A8K2U0-1#91	0	3	3	A8K2U0-1	540	543	+	3	A8K2U0-1	492	671	ENST00000545692.1	31	568	++	158	A8K2U0-1#91	0	9	ENST00000545692.1	175	184	+	9	0	-6	5759
A8K2U0-1#91	0	3	3	A8K2U0-1	540	543	+	3	A8K2U0-1	450	1454	ENST00000541459.5	0	3012	++	154	A8K2U0-1#91	0	9	ENST00000541459.5	270	279	+	9	0	-6	5760
A8K2U0-1#91	0	3	3	A8K2U0-1	540	543	+	3	A8K2U0-1	492	1454	ENST00000539547.5	171	3057	++	153	A8K2U0-1#91	0	9	ENST00000539547.5	315	324	+	9	0	-6	5761
A8K2U0-1#91	0	3	3	A8K2U0-1	540	543	+	3	A8K2U0-1	0	1454	ENST00000299698.12	31	4393	++	21	A8K2U0-1#91	0	9	ENST00000299698.12	1651	1660	+	9	0	-6	5762
A8K2U0-1#92	0	7	7	A8K2U0-1	544	551	+	7	A8K2U0-1	492	671	ENST00000545692.1	31	568	++	158	A8K2U0-1#92	0	21	ENST00000545692.1	187	208	+	21	0	-14	5763
A8K2U0-1#92	0	7	7	A8K2U0-1	544	551	+	7	A8K2U0-1	450	1454	ENST00000541459.5	0	3012	++	154	A8K2U0-1#92	0	21	ENST00000541459.5	282	303	+	21	0	-14	5764
A8K2U0-1#92	0	7	7	A8K2U0-1	544	551	+	7	A8K2U0-1	492	1454	ENST00000539547.5	171	3057	++	153	A8K2U0-1#92	0	21	ENST00000539547.5	327	348	+	21	0	-14	5765
A8K2U0-1#92	0	7	7	A8K2U0-1	544	551	+	7	A8K2U0-1	0	1454	ENST00000299698.12	31	4393	++	21	A8K2U0-1#92	0	21	ENST00000299698.12	1663	1684	+	21	0	-14	5766
A8K2U0-1#93	0	9	9	A8K2U0-1	562	571	+	9	A8K2U0-1	492	671	ENST00000545692.1	31	568	++	158	A8K2U0-1#93	0	27	ENST00000545692.1	241	268	+	27	0	-18	5767
A8K2U0-1#93	0	9	9	A8K2U0-1	562	571	+	9	A8K2U0-1	450	1454	ENST00000541459.5	0	3012	++	154	A8K2U0-1#93	0	27	ENST00000541459.5	336	363	+	27	0	-18	5768
A8K2U0-1#93	0	9	9	A8K2U0-1	562	571	+	9	A8K2U0-1	492	1454	ENST00000539547.5	171	3057	++	153	A8K2U0-1#93	0	27	ENST00000539547.5	381	408	+	27	0	-18	5769
A8K2U0-1#93	0	9	9	A8K2U0-1	562	571	+	9	A8K2U0-1	0	1454	ENST00000299698.12	31	4393	++	21	A8K2U0-1#93	0	27	ENST00000299698.12	1717	1744	+	27	0	-18	5770
A8K2U0-1#94	0	8	8	A8K2U0-1	574	582	+	8	A8K2U0-1	492	671	ENST00000545692.1	31	568	++	158	A8K2U0-1#94	0	24	ENST00000545692.1	277	301	+	24	0	-16	5771
A8K2U0-1#94	0	8	8	A8K2U0-1	574	582	+	8	A8K2U0-1	450	1454	ENST00000541459.5	0	3012	++	154	A8K2U0-1#94	0	24	ENST00000541459.5	372	396	+	24	0	-16	5772
A8K2U0-1#94	0	8	8	A8K2U0-1	574	582	+	8	A8K2U0-1	492	1454	ENST00000539547.5	171	3057	++	153	A8K2U0-1#94	0	24	ENST00000539547.5	417	441	+	24	0	-16	5773
A8K2U0-1#94	0	8	8	A8K2U0-1	574	582	+	8	A8K2U0-1	0	1454	ENST00000299698.12	31	4393	++	21	A8K2U0-1#94	0	24	ENST00000299698.12	1753	1777	+	24	0	-16	5774
A8K2U0-1#95	0	8	8	A8K2U0-1	587	595	+	8	A8K2U0-1	492	671	ENST00000545692.1	31	568	++	158	A8K2U0-1#95	0	24	ENST00000545692.1	316	340	+	24	0	-16	5775
A8K2U0-1#95	0	8	8	A8K2U0-1	587	595	+	8	A8K2U0-1	450	1454	ENST00000541459.5	0	3012	++	154	A8K2U0-1#95	0	24	ENST00000541459.5	411	435	+	24	0	-16	5776
A8K2U0-1#95	0	8	8	A8K2U0-1	587	595	+	8	A8K2U0-1	492	1454	ENST00000539547.5	171	3057	++	153	A8K2U0-1#95	0	24	ENST00000539547.5	456	480	+	24	0	-16	5777
A8K2U0-1#95	0	8	8	A8K2U0-1	587	595	+	8	A8K2U0-1	0	1454	ENST00000299698.12	31	4393	++	21	A8K2U0-1#95	0	24	ENST00000299698.12	1792	1816	+	24	0	-16	5778
A8K2U0-1#96	0	6	6	A8K2U0-1	595	601	+	6	A8K2U0-1	492	671	ENST00000545692.1	31	568	++	158	A8K2U0-1#96	0	18	ENST00000545692.1	340	358	+	18	0	-12	5779
A8K2U0-1#96	0	6	6	A8K2U0-1	595	601	+	6	A8K2U0-1	450	1454	ENST00000541459.5	0	3012	++	154	A8K2U0-1#96	0	18	ENST00000541459.5	435	453	+	18	0	-12	5780
A8K2U0-1#96	0	6	6	A8K2U0-1	595	601	+	6	A8K2U0-1	492	1454	ENST00000539547.5	171	3057	++	153	A8K2U0-1#96	0	18	ENST00000539547.5	480	498	+	18	0	-12	5781
A8K2U0-1#96	0	6	6	A8K2U0-1	595	601	+	6	A8K2U0-1	0	1454	ENST00000299698.12	31	4393	++	21	A8K2U0-1#96	0	18	ENST00000299698.12	1816	1834	+	18	0	-12	5782
A8K2U0-1#97	0	4	4	A8K2U0-1	602	606	+	4	A8K2U0-1	492	671	ENST00000545692.1	31	568	++	158	A8K2U0-1#97	0	12	ENST00000545692.1	361	373	+	12	0	-8	5783
A8K2U0-1#97	0	4	4	A8K2U0-1	602	606	+	4	A8K2U0-1	450	1454	ENST00000541459.5	0	3012	++	154	A8K2U0-1#97	0	12	ENST00000541459.5	456	468	+	12	0	-8	5784
A8K2U0-1#97	0	4	4	A8K2U0-1	602	606	+	4	A8K2U0-1	492	1454	ENST00000539547.5	171	3057	++	153	A8K2U0-1#97	0	12	ENST00000539547.5	501	513	+	12	0	-8	5785
A8K2U0-1#97	0	4	4	A8K2U0-1	602	606	+	4	A8K2U0-1	0	1454	ENST00000299698.12	31	4393	++	21	A8K2U0-1#97	0	12	ENST00000299698.12	1837	1849	+	12	0	-8	5786
A8K2U0-1#98	0	6	6	A8K2U0-1	608	614	+	6	A8K2U0-1	492	671	ENST00000545692.1	31	568	++	158	A8K2U0-1#98	0	18	ENST00000545692.1	379	397	+	18	0	-12	5787
A8K2U0-1#98	0	6	6	A8K2U0-1	608	614	+	6	A8K2U0-1	450	1454	ENST00000541459.5	0	3012	++	154	A8K2U0-1#98	0	18	ENST00000541459.5	474	492	+	18	0	-12	5788
A8K2U0-1#98	0	6	6	A8K2U0-1	608	614	+	6	A8K2U0-1	492	1454	ENST00000539547.5	171	3057	++	153	A8K2U0-1#98	0	18	ENST00000539547.5	519	537	+	18	0	-12	5789
A8K2U0-1#98	0	6	6	A8K2U0-1	608	614	+	6	A8K2U0-1	0	1454	ENST00000299698.12	31	4393	++	21	A8K2U0-1#98	0	18	ENST00000299698.12	1855	1873	+	18	0	-12	5790
A8K2U0-1#99	0	3	3	A8K2U0-1	624	627	+	3	A8K2U0-1	492	671	ENST00000545692.1	31	568	++	158	A8K2U0-1#99	0	9	ENST00000545692.1	427	436	+	9	0	-6	5791
A8K2U0-1#99	0	3	3	A8K2U0-1	624	627	+	3	A8K2U0-1	450	1454	ENST00000541459.5	0	3012	++	154	A8K2U0-1#99	0	9	ENST00000541459.5	522	531	+	9	0	-6	5792
A8K2U0-1#99	0	3	3	A8K2U0-1	624	627	+	3	A8K2U0-1	492	1454	ENST00000539547.5	171	3057	++	153	A8K2U0-1#99	0	9	ENST00000539547.5	567	576	+	9	0	-6	5793
A8K2U0-1#99	0	3	3	A8K2U0-1	624	627	+	3	A8K2U0-1	0	1454	ENST00000299698.12	31	4393	++	21	A8K2U0-1#99	0	9	ENST00000299698.12	1903	1912	+	9	0	-6	5794
A8K2U0-1#100	0	6	6	A8K2U0-1	670	676	+	6	A8K2U0-1	492	671	ENST00000545692.1	31	568	++	158	A8K2U0-1#100	0	3	ENST00000545692.1	565	568	+	3	0	3	5795
A8K2U0-1#100	0	6	6	A8K2U0-1	670	676	+	6	A8K2U0-1	450	1454	ENST00000541459.5	0	3012	++	154	A8K2U0-1#100	0	18	ENST00000541459.5	660	678	+	18	0	-12	5796
A8K2U0-1#100	0	6	6	A8K2U0-1	670	676	+	6	A8K2U0-1	492	1454	ENST00000539547.5	171	3057	++	153	A8K2U0-1#100	0	18	ENST00000539547.5	705	723	+	18	0	-12	5797
A8K2U0-1#100	0	6	6	A8K2U0-1	670	676	+	6	A8K2U0-1	0	1454	ENST00000299698.12	31	4393	++	21	A8K2U0-1#100	0	18	ENST00000299698.12	2041	2059	+	18	0	-12	5798
A8K2U0-1#101	0	3	3	A8K2U0-1	676	679	+	3	A8K2U0-1	450	1454	ENST00000541459.5	0	3012	++	154	A8K2U0-1#101	0	9	ENST00000541459.5	678	687	+	9	0	-6	5799
A8K2U0-1#101	0	3	3	A8K2U0-1	676	679	+	3	A8K2U0-1	492	1454	ENST00000539547.5	171	3057	++	153	A8K2U0-1#101	0	9	ENST00000539547.5	723	732	+	9	0	-6	5800
A8K2U0-1#101	0	3	3	A8K2U0-1	676	679	+	3	A8K2U0-1	0	1454	ENST00000299698.12	31	4393	++	21	A8K2U0-1#101	0	9	ENST00000299698.12	2059	2068	+	9	0	-6	5801
A8K2U0-1#102	0	8	8	A8K2U0-1	679	687	+	8	A8K2U0-1	450	1454	ENST00000541459.5	0	3012	++	154	A8K2U0-1#102	0	24	ENST00000541459.5	687	711	+	24	0	-16	5802
A8K2U0-1#102	0	8	8	A8K2U0-1	679	687	+	8	A8K2U0-1	492	1454	ENST00000539547.5	171	3057	++	153	A8K2U0-1#102	0	24	ENST00000539547.5	732	756	+	24	0	-16	5803
A8K2U0-1#102	0	8	8	A8K2U0-1	679	687	+	8	A8K2U0-1	0	1454	ENST00000299698.12	31	4393	++	21	A8K2U0-1#102	0	24	ENST00000299698.12	2068	2092	+	24	0	-16	5804
A8K2U0-1#103	0	9	9	A8K2U0-1	734	743	+	9	A8K2U0-1	450	1454	ENST00000541459.5	0	3012	++	154	A8K2U0-1#103	0	27	ENST00000541459.5	852	879	+	27	0	-18	5805
A8K2U0-1#103	0	9	9	A8K2U0-1	734	743	+	9	A8K2U0-1	492	1454	ENST00000539547.5	171	3057	++	153	A8K2U0-1#103	0	27	ENST00000539547.5	897	924	+	27	0	-18	5806
A8K2U0-1#103	0	9	9	A8K2U0-1	734	743	+	9	A8K2U0-1	0	1454	ENST00000299698.12	31	4393	++	21	A8K2U0-1#103	0	27	ENST00000299698.12	2233	2260	+	27	0	-18	5807
A8K2U0-1#104	0	8	8	A8K2U0-1	747	755	+	8	A8K2U0-1	450	1454	ENST00000541459.5	0	3012	++	154	A8K2U0-1#104	0	24	ENST00000541459.5	891	915	+	24	0	-16	5808
A8K2U0-1#104	0	8	8	A8K2U0-1	747	755	+	8	A8K2U0-1	492	1454	ENST00000539547.5	171	3057	++	153	A8K2U0-1#104	0	24	ENST00000539547.5	936	960	+	24	0	-16	5809
A8K2U0-1#104	0	8	8	A8K2U0-1	747	755	+	8	A8K2U0-1	0	1454	ENST00000299698.12	31	4393	++	21	A8K2U0-1#104	0	24	ENST00000299698.12	2272	2296	+	24	0	-16	5810
A8K2U0-1#105	0	12	12	A8K2U0-1	759	771	+	12	A8K2U0-1	450	1454	ENST00000541459.5	0	3012	++	154	A8K2U0-1#105	0	36	ENST00000541459.5	927	963	+	36	0	-24	5811
A8K2U0-1#105	0	12	12	A8K2U0-1	759	771	+	12	A8K2U0-1	492	1454	ENST00000539547.5	171	3057	++	153	A8K2U0-1#105	0	36	ENST00000539547.5	972	1008	+	36	0	-24	5812
A8K2U0-1#105	0	12	12	A8K2U0-1	759	771	+	12	A8K2U0-1	0	1454	ENST00000299698.12	31	4393	++	21	A8K2U0-1#105	0	36	ENST00000299698.12	2308	2344	+	36	0	-24	5813
A8K2U0-1#106	0	3	3	A8K2U0-1	771	774	+	3	A8K2U0-1	450	1454	ENST00000541459.5	0	3012	++	154	A8K2U0-1#106	0	9	ENST00000541459.5	963	972	+	9	0	-6	5814
A8K2U0-1#106	0	3	3	A8K2U0-1	771	774	+	3	A8K2U0-1	492	1454	ENST00000539547.5	171	3057	++	153	A8K2U0-1#106	0	9	ENST00000539547.5	1008	1017	+	9	0	-6	5815
A8K2U0-1#106	0	3	3	A8K2U0-1	771	774	+	3	A8K2U0-1	0	1454	ENST00000299698.12	31	4393	++	21	A8K2U0-1#106	0	9	ENST00000299698.12	2344	2353	+	9	0	-6	5816
A8K2U0-1#107	0	4	4	A8K2U0-1	774	778	+	4	A8K2U0-1	450	1454	ENST00000541459.5	0	3012	++	154	A8K2U0-1#107	0	12	ENST00000541459.5	972	984	+	12	0	-8	5817
A8K2U0-1#107	0	4	4	A8K2U0-1	774	778	+	4	A8K2U0-1	492	1454	ENST00000539547.5	171	3057	++	153	A8K2U0-1#107	0	12	ENST00000539547.5	1017	1029	+	12	0	-8	5818
A8K2U0-1#107	0	4	4	A8K2U0-1	774	778	+	4	A8K2U0-1	0	1454	ENST00000299698.12	31	4393	++	21	A8K2U0-1#107	0	12	ENST00000299698.12	2353	2365	+	12	0	-8	5819
A8K2U0-1#108	0	5	5	A8K2U0-1	781	786	+	5	A8K2U0-1	450	1454	ENST00000541459.5	0	3012	++	154	A8K2U0-1#108	0	15	ENST00000541459.5	993	1008	+	15	0	-10	5820
A8K2U0-1#108	0	5	5	A8K2U0-1	781	786	+	5	A8K2U0-1	492	1454	ENST00000539547.5	171	3057	++	153	A8K2U0-1#108	0	15	ENST00000539547.5	1038	1053	+	15	0	-10	5821
A8K2U0-1#108	0	5	5	A8K2U0-1	781	786	+	5	A8K2U0-1	0	1454	ENST00000299698.12	31	4393	++	21	A8K2U0-1#108	0	15	ENST00000299698.12	2374	2389	+	15	0	-10	5822
A8K2U0-1#109	0	7	7	A8K2U0-1	788	795	+	7	A8K2U0-1	450	1454	ENST00000541459.5	0	3012	++	154	A8K2U0-1#109	0	21	ENST00000541459.5	1014	1035	+	21	0	-14	5823
A8K2U0-1#109	0	7	7	A8K2U0-1	788	795	+	7	A8K2U0-1	492	1454	ENST00000539547.5	171	3057	++	153	A8K2U0-1#109	0	21	ENST00000539547.5	1059	1080	+	21	0	-14	5824
A8K2U0-1#109	0	7	7	A8K2U0-1	788	795	+	7	A8K2U0-1	0	1454	ENST00000299698.12	31	4393	++	21	A8K2U0-1#109	0	21	ENST00000299698.12	2395	2416	+	21	0	-14	5825
A8K2U0-1#110	0	4	4	A8K2U0-1	797	801	+	4	A8K2U0-1	450	1454	ENST00000541459.5	0	3012	++	154	A8K2U0-1#110	0	12	ENST00000541459.5	1041	1053	+	12	0	-8	5826
A8K2U0-1#110	0	4	4	A8K2U0-1	797	801	+	4	A8K2U0-1	492	1454	ENST00000539547.5	171	3057	++	153	A8K2U0-1#110	0	12	ENST00000539547.5	1086	1098	+	12	0	-8	5827
A8K2U0-1#110	0	4	4	A8K2U0-1	797	801	+	4	A8K2U0-1	0	1454	ENST00000299698.12	31	4393	++	21	A8K2U0-1#110	0	12	ENST00000299698.12	2422	2434	+	12	0	-8	5828
A8K2U0-1#111	0	11	11	A8K2U0-1	803	814	+	11	A8K2U0-1	450	1454	ENST00000541459.5	0	3012	++	154	A8K2U0-1#111	0	33	ENST00000541459.5	1059	1092	+	33	0	-22	5829
A8K2U0-1#111	0	11	11	A8K2U0-1	803	814	+	11	A8K2U0-1	492	1454	ENST00000539547.5	171	3057	++	153	A8K2U0-1#111	0	33	ENST00000539547.5	1104	1137	+	33	0	-22	5830
A8K2U0-1#111	0	11	11	A8K2U0-1	803	814	+	11	A8K2U0-1	0	1454	ENST00000299698.12	31	4393	++	21	A8K2U0-1#111	0	33	ENST00000299698.12	2440	2473	+	33	0	-22	5831
A8K2U0-1#112	0	3	3	A8K2U0-1	815	818	+	3	A8K2U0-1	450	1454	ENST00000541459.5	0	3012	++	154	A8K2U0-1#112	0	9	ENST00000541459.5	1095	1104	+	9	0	-6	5832
A8K2U0-1#112	0	3	3	A8K2U0-1	815	818	+	3	A8K2U0-1	492	1454	ENST00000539547.5	171	3057	++	153	A8K2U0-1#112	0	9	ENST00000539547.5	1140	1149	+	9	0	-6	5833
A8K2U0-1#112	0	3	3	A8K2U0-1	815	818	+	3	A8K2U0-1	0	1454	ENST00000299698.12	31	4393	++	21	A8K2U0-1#112	0	9	ENST00000299698.12	2476	2485	+	9	0	-6	5834
A8K2U0-1#113	0	7	7	A8K2U0-1	819	826	+	7	A8K2U0-1	450	1454	ENST00000541459.5	0	3012	++	154	A8K2U0-1#113	0	21	ENST00000541459.5	1107	1128	+	21	0	-14	5835
A8K2U0-1#113	0	7	7	A8K2U0-1	819	826	+	7	A8K2U0-1	492	1454	ENST00000539547.5	171	3057	++	153	A8K2U0-1#113	0	21	ENST00000539547.5	1152	1173	+	21	0	-14	5836
A8K2U0-1#113	0	7	7	A8K2U0-1	819	826	+	7	A8K2U0-1	0	1454	ENST00000299698.12	31	4393	++	21	A8K2U0-1#113	0	21	ENST00000299698.12	2488	2509	+	21	0	-14	5837
A8K2U0-1#114	0	3	3	A8K2U0-1	831	834	+	3	A8K2U0-1	450	1454	ENST00000541459.5	0	3012	++	154	A8K2U0-1#114	0	9	ENST00000541459.5	1143	1152	+	9	0	-6	5838
A8K2U0-1#114	0	3	3	A8K2U0-1	831	834	+	3	A8K2U0-1	492	1454	ENST00000539547.5	171	3057	++	153	A8K2U0-1#114	0	9	ENST00000539547.5	1188	1197	+	9	0	-6	5839
A8K2U0-1#114	0	3	3	A8K2U0-1	831	834	+	3	A8K2U0-1	0	1454	ENST00000299698.12	31	4393	++	21	A8K2U0-1#114	0	9	ENST00000299698.12	2524	2533	+	9	0	-6	5840
A8K2U0-1#115	0	3	3	A8K2U0-1	837	840	+	3	A8K2U0-1	450	1454	ENST00000541459.5	0	3012	++	154	A8K2U0-1#115	0	9	ENST00000541459.5	1161	1170	+	9	0	-6	5841
A8K2U0-1#115	0	3	3	A8K2U0-1	837	840	+	3	A8K2U0-1	492	1454	ENST00000539547.5	171	3057	++	153	A8K2U0-1#115	0	9	ENST00000539547.5	1206	1215	+	9	0	-6	5842
A8K2U0-1#115	0	3	3	A8K2U0-1	837	840	+	3	A8K2U0-1	0	1454	ENST00000299698.12	31	4393	++	21	A8K2U0-1#115	0	9	ENST00000299698.12	2542	2551	+	9	0	-6	5843
A8K2U0-1#116	0	6	6	A8K2U0-1	840	846	+	6	A8K2U0-1	450	1454	ENST00000541459.5	0	3012	++	154	A8K2U0-1#116	0	18	ENST00000541459.5	1170	1188	+	18	0	-12	5844
A8K2U0-1#116	0	6	6	A8K2U0-1	840	846	+	6	A8K2U0-1	492	1454	ENST00000539547.5	171	3057	++	153	A8K2U0-1#116	0	18	ENST00000539547.5	1215	1233	+	18	0	-12	5845
A8K2U0-1#116	0	6	6	A8K2U0-1	840	846	+	6	A8K2U0-1	0	1454	ENST00000299698.12	31	4393	++	21	A8K2U0-1#116	0	18	ENST00000299698.12	2551	2569	+	18	0	-12	5846
A8K2U0-1#117	0	11	11	A8K2U0-1	849	860	+	11	A8K2U0-1	450	1454	ENST00000541459.5	0	3012	++	154	A8K2U0-1#117	0	33	ENST00000541459.5	1197	1230	+	33	0	-22	5847
A8K2U0-1#117	0	11	11	A8K2U0-1	849	860	+	11	A8K2U0-1	492	1454	ENST00000539547.5	171	3057	++	153	A8K2U0-1#117	0	33	ENST00000539547.5	1242	1275	+	33	0	-22	5848
A8K2U0-1#117	0	11	11	A8K2U0-1	849	860	+	11	A8K2U0-1	0	1454	ENST00000299698.12	31	4393	++	21	A8K2U0-1#117	0	33	ENST00000299698.12	2578	2611	+	33	0	-22	5849
A8K2U0-1#118	0	11	11	A8K2U0-1	863	874	+	11	A8K2U0-1	450	1454	ENST00000541459.5	0	3012	++	154	A8K2U0-1#118	0	33	ENST00000541459.5	1239	1272	+	33	0	-22	5850
A8K2U0-1#118	0	11	11	A8K2U0-1	863	874	+	11	A8K2U0-1	492	1454	ENST00000539547.5	171	3057	++	153	A8K2U0-1#118	0	33	ENST00000539547.5	1284	1317	+	33	0	-22	5851
A8K2U0-1#118	0	11	11	A8K2U0-1	863	874	+	11	A8K2U0-1	0	1454	ENST00000299698.12	31	4393	++	21	A8K2U0-1#118	0	33	ENST00000299698.12	2620	2653	+	33	0	-22	5852
A8K2U0-1#119	0	3	3	A8K2U0-1	880	883	+	3	A8K2U0-1	450	1454	ENST00000541459.5	0	3012	++	154	A8K2U0-1#119	0	9	ENST00000541459.5	1290	1299	+	9	0	-6	5853
A8K2U0-1#119	0	3	3	A8K2U0-1	880	883	+	3	A8K2U0-1	492	1454	ENST00000539547.5	171	3057	++	153	A8K2U0-1#119	0	9	ENST00000539547.5	1335	1344	+	9	0	-6	5854
A8K2U0-1#119	0	3	3	A8K2U0-1	880	883	+	3	A8K2U0-1	0	1454	ENST00000299698.12	31	4393	++	21	A8K2U0-1#119	0	9	ENST00000299698.12	2671	2680	+	9	0	-6	5855
A8K2U0-1#120	0	3	3	A8K2U0-1	889	892	+	3	A8K2U0-1	450	1454	ENST00000541459.5	0	3012	++	154	A8K2U0-1#120	0	9	ENST00000541459.5	1317	1326	+	9	0	-6	5856
A8K2U0-1#120	0	3	3	A8K2U0-1	889	892	+	3	A8K2U0-1	492	1454	ENST00000539547.5	171	3057	++	153	A8K2U0-1#120	0	9	ENST00000539547.5	1362	1371	+	9	0	-6	5857
A8K2U0-1#120	0	3	3	A8K2U0-1	889	892	+	3	A8K2U0-1	0	1454	ENST00000299698.12	31	4393	++	21	A8K2U0-1#120	0	9	ENST00000299698.12	2698	2707	+	9	0	-6	5858
A8K2U0-1#121	0	11	11	A8K2U0-1	893	904	+	11	A8K2U0-1	450	1454	ENST00000541459.5	0	3012	++	154	A8K2U0-1#121	0	33	ENST00000541459.5	1329	1362	+	33	0	-22	5859
A8K2U0-1#121	0	11	11	A8K2U0-1	893	904	+	11	A8K2U0-1	492	1454	ENST00000539547.5	171	3057	++	153	A8K2U0-1#121	0	33	ENST00000539547.5	1374	1407	+	33	0	-22	5860
A8K2U0-1#121	0	11	11	A8K2U0-1	893	904	+	11	A8K2U0-1	0	1454	ENST00000299698.12	31	4393	++	21	A8K2U0-1#121	0	33	ENST00000299698.12	2710	2743	+	33	0	-22	5861
A8K2U0-1#122	0	13	13	A8K2U0-1	905	918	+	13	A8K2U0-1	450	1454	ENST00000541459.5	0	3012	++	154	A8K2U0-1#122	0	39	ENST00000541459.5	1365	1404	+	39	0	-26	5862
A8K2U0-1#122	0	13	13	A8K2U0-1	905	918	+	13	A8K2U0-1	492	1454	ENST00000539547.5	171	3057	++	153	A8K2U0-1#122	0	39	ENST00000539547.5	1410	1449	+	39	0	-26	5863
A8K2U0-1#122	0	13	13	A8K2U0-1	905	918	+	13	A8K2U0-1	0	1454	ENST00000299698.12	31	4393	++	21	A8K2U0-1#122	0	39	ENST00000299698.12	2746	2785	+	39	0	-26	5864
A8K2U0-1#123	0	10	10	A8K2U0-1	920	930	+	10	A8K2U0-1	450	1454	ENST00000541459.5	0	3012	++	154	A8K2U0-1#123	0	30	ENST00000541459.5	1410	1440	+	30	0	-20	5865
A8K2U0-1#123	0	10	10	A8K2U0-1	920	930	+	10	A8K2U0-1	492	1454	ENST00000539547.5	171	3057	++	153	A8K2U0-1#123	0	30	ENST00000539547.5	1455	1485	+	30	0	-20	5866
A8K2U0-1#123	0	10	10	A8K2U0-1	920	930	+	10	A8K2U0-1	0	1454	ENST00000299698.12	31	4393	++	21	A8K2U0-1#123	0	30	ENST00000299698.12	2791	2821	+	30	0	-20	5867
A8K2U0-1#124	0	11	11	A8K2U0-1	942	953	+	11	A8K2U0-1	450	1454	ENST00000541459.5	0	3012	++	154	A8K2U0-1#124	0	33	ENST00000541459.5	1476	1509	+	33	0	-22	5868
A8K2U0-1#124	0	11	11	A8K2U0-1	942	953	+	11	A8K2U0-1	492	1454	ENST00000539547.5	171	3057	++	153	A8K2U0-1#124	0	33	ENST00000539547.5	1521	1554	+	33	0	-22	5869
A8K2U0-1#124	0	11	11	A8K2U0-1	942	953	+	11	A8K2U0-1	0	1454	ENST00000299698.12	31	4393	++	21	A8K2U0-1#124	0	33	ENST00000299698.12	2857	2890	+	33	0	-22	5870
A8K2U0-1#125	0	8	8	A8K2U0-1	955	963	+	8	A8K2U0-1	450	1454	ENST00000541459.5	0	3012	++	154	A8K2U0-1#125	0	24	ENST00000541459.5	1515	1539	+	24	0	-16	5871
A8K2U0-1#125	0	8	8	A8K2U0-1	955	963	+	8	A8K2U0-1	492	1454	ENST00000539547.5	171	3057	++	153	A8K2U0-1#125	0	24	ENST00000539547.5	1560	1584	+	24	0	-16	5872
A8K2U0-1#125	0	8	8	A8K2U0-1	955	963	+	8	A8K2U0-1	0	1454	ENST00000299698.12	31	4393	++	21	A8K2U0-1#125	0	24	ENST00000299698.12	2896	2920	+	24	0	-16	5873
A8K2U0-1#126	0	3	3	A8K2U0-1	970	973	+	3	A8K2U0-1	450	1454	ENST00000541459.5	0	3012	++	154	A8K2U0-1#126	0	9	ENST00000541459.5	1560	1569	+	9	0	-6	5874
A8K2U0-1#126	0	3	3	A8K2U0-1	970	973	+	3	A8K2U0-1	492	1454	ENST00000539547.5	171	3057	++	153	A8K2U0-1#126	0	9	ENST00000539547.5	1605	1614	+	9	0	-6	5875
A8K2U0-1#126	0	3	3	A8K2U0-1	970	973	+	3	A8K2U0-1	0	1454	ENST00000299698.12	31	4393	++	21	A8K2U0-1#126	0	9	ENST00000299698.12	2941	2950	+	9	0	-6	5876
A8K2U0-1#127	0	15	15	A8K2U0-1	974	989	+	15	A8K2U0-1	450	1454	ENST00000541459.5	0	3012	++	154	A8K2U0-1#127	0	45	ENST00000541459.5	1572	1617	+	45	0	-30	5877
A8K2U0-1#127	0	15	15	A8K2U0-1	974	989	+	15	A8K2U0-1	492	1454	ENST00000539547.5	171	3057	++	153	A8K2U0-1#127	0	45	ENST00000539547.5	1617	1662	+	45	0	-30	5878
A8K2U0-1#127	0	15	15	A8K2U0-1	974	989	+	15	A8K2U0-1	0	1454	ENST00000299698.12	31	4393	++	21	A8K2U0-1#127	0	45	ENST00000299698.12	2953	2998	+	45	0	-30	5879
A8K2U0-1#128	0	3	3	A8K2U0-1	989	992	+	3	A8K2U0-1	450	1454	ENST00000541459.5	0	3012	++	154	A8K2U0-1#128	0	9	ENST00000541459.5	1617	1626	+	9	0	-6	5880
A8K2U0-1#128	0	3	3	A8K2U0-1	989	992	+	3	A8K2U0-1	492	1454	ENST00000539547.5	171	3057	++	153	A8K2U0-1#128	0	9	ENST00000539547.5	1662	1671	+	9	0	-6	5881
A8K2U0-1#128	0	3	3	A8K2U0-1	989	992	+	3	A8K2U0-1	0	1454	ENST00000299698.12	31	4393	++	21	A8K2U0-1#128	0	9	ENST00000299698.12	2998	3007	+	9	0	-6	5882
A8K2U0-1#129	0	15	15	A8K2U0-1	995	1010	+	15	A8K2U0-1	450	1454	ENST00000541459.5	0	3012	++	154	A8K2U0-1#129	0	45	ENST00000541459.5	1635	1680	+	45	0	-30	5883
A8K2U0-1#129	0	15	15	A8K2U0-1	995	1010	+	15	A8K2U0-1	492	1454	ENST00000539547.5	171	3057	++	153	A8K2U0-1#129	0	45	ENST00000539547.5	1680	1725	+	45	0	-30	5884
A8K2U0-1#129	0	15	15	A8K2U0-1	995	1010	+	15	A8K2U0-1	0	1454	ENST00000299698.12	31	4393	++	21	A8K2U0-1#129	0	45	ENST00000299698.12	3016	3061	+	45	0	-30	5885
A8K2U0-1#130	0	3	3	A8K2U0-1	1010	1013	+	3	A8K2U0-1	450	1454	ENST00000541459.5	0	3012	++	154	A8K2U0-1#130	0	9	ENST00000541459.5	1680	1689	+	9	0	-6	5886
A8K2U0-1#130	0	3	3	A8K2U0-1	1010	1013	+	3	A8K2U0-1	492	1454	ENST00000539547.5	171	3057	++	153	A8K2U0-1#130	0	9	ENST00000539547.5	1725	1734	+	9	0	-6	5887
A8K2U0-1#130	0	3	3	A8K2U0-1	1010	1013	+	3	A8K2U0-1	0	1454	ENST00000299698.12	31	4393	++	21	A8K2U0-1#130	0	9	ENST00000299698.12	3061	3070	+	9	0	-6	5888
A8K2U0-1#131	0	3	3	A8K2U0-1	1013	1016	+	3	A8K2U0-1	450	1454	ENST00000541459.5	0	3012	++	154	A8K2U0-1#131	0	9	ENST00000541459.5	1689	1698	+	9	0	-6	5889
A8K2U0-1#131	0	3	3	A8K2U0-1	1013	1016	+	3	A8K2U0-1	492	1454	ENST00000539547.5	171	3057	++	153	A8K2U0-1#131	0	9	ENST00000539547.5	1734	1743	+	9	0	-6	5890
A8K2U0-1#131	0	3	3	A8K2U0-1	1013	1016	+	3	A8K2U0-1	0	1454	ENST00000299698.12	31	4393	++	21	A8K2U0-1#131	0	9	ENST00000299698.12	3070	3079	+	9	0	-6	5891
A8K2U0-1#132	0	3	3	A8K2U0-1	1020	1023	+	3	A8K2U0-1	450	1454	ENST00000541459.5	0	3012	++	154	A8K2U0-1#132	0	9	ENST00000541459.5	1710	1719	+	9	0	-6	5892
A8K2U0-1#132	0	3	3	A8K2U0-1	1020	1023	+	3	A8K2U0-1	492	1454	ENST00000539547.5	171	3057	++	153	A8K2U0-1#132	0	9	ENST00000539547.5	1755	1764	+	9	0	-6	5893
A8K2U0-1#132	0	3	3	A8K2U0-1	1020	1023	+	3	A8K2U0-1	0	1454	ENST00000299698.12	31	4393	++	21	A8K2U0-1#132	0	9	ENST00000299698.12	3091	3100	+	9	0	-6	5894
A8K2U0-1#133	0	4	4	A8K2U0-1	1024	1028	+	4	A8K2U0-1	450	1454	ENST00000541459.5	0	3012	++	154	A8K2U0-1#133	0	12	ENST00000541459.5	1722	1734	+	12	0	-8	5895
A8K2U0-1#133	0	4	4	A8K2U0-1	1024	1028	+	4	A8K2U0-1	492	1454	ENST00000539547.5	171	3057	++	153	A8K2U0-1#133	0	12	ENST00000539547.5	1767	1779	+	12	0	-8	5896
A8K2U0-1#133	0	4	4	A8K2U0-1	1024	1028	+	4	A8K2U0-1	0	1454	ENST00000299698.12	31	4393	++	21	A8K2U0-1#133	0	12	ENST00000299698.12	3103	3115	+	12	0	-8	5897
A8K2U0-1#134	0	3	3	A8K2U0-1	1029	1032	+	3	A8K2U0-1	450	1454	ENST00000541459.5	0	3012	++	154	A8K2U0-1#134	0	9	ENST00000541459.5	1737	1746	+	9	0	-6	5898
A8K2U0-1#134	0	3	3	A8K2U0-1	1029	1032	+	3	A8K2U0-1	492	1454	ENST00000539547.5	171	3057	++	153	A8K2U0-1#134	0	9	ENST00000539547.5	1782	1791	+	9	0	-6	5899
A8K2U0-1#134	0	3	3	A8K2U0-1	1029	1032	+	3	A8K2U0-1	0	1454	ENST00000299698.12	31	4393	++	21	A8K2U0-1#134	0	9	ENST00000299698.12	3118	3127	+	9	0	-6	5900
A8K2U0-1#135	0	11	11	A8K2U0-1	1034	1045	+	11	A8K2U0-1	450	1454	ENST00000541459.5	0	3012	++	154	A8K2U0-1#135	0	33	ENST00000541459.5	1752	1785	+	33	0	-22	5901
A8K2U0-1#135	0	11	11	A8K2U0-1	1034	1045	+	11	A8K2U0-1	492	1454	ENST00000539547.5	171	3057	++	153	A8K2U0-1#135	0	33	ENST00000539547.5	1797	1830	+	33	0	-22	5902
A8K2U0-1#135	0	11	11	A8K2U0-1	1034	1045	+	11	A8K2U0-1	0	1454	ENST00000299698.12	31	4393	++	21	A8K2U0-1#135	0	33	ENST00000299698.12	3133	3166	+	33	0	-22	5903
A8K2U0-1#136	0	3	3	A8K2U0-1	1047	1050	+	3	A8K2U0-1	450	1454	ENST00000541459.5	0	3012	++	154	A8K2U0-1#136	0	9	ENST00000541459.5	1791	1800	+	9	0	-6	5904
A8K2U0-1#136	0	3	3	A8K2U0-1	1047	1050	+	3	A8K2U0-1	492	1454	ENST00000539547.5	171	3057	++	153	A8K2U0-1#136	0	9	ENST00000539547.5	1836	1845	+	9	0	-6	5905
A8K2U0-1#136	0	3	3	A8K2U0-1	1047	1050	+	3	A8K2U0-1	0	1454	ENST00000299698.12	31	4393	++	21	A8K2U0-1#136	0	9	ENST00000299698.12	3172	3181	+	9	0	-6	5906
A8K2U0-1#137	0	13	13	A8K2U0-1	1056	1069	+	13	A8K2U0-1	450	1454	ENST00000541459.5	0	3012	++	154	A8K2U0-1#137	0	39	ENST00000541459.5	1818	1857	+	39	0	-26	5907
A8K2U0-1#137	0	13	13	A8K2U0-1	1056	1069	+	13	A8K2U0-1	492	1454	ENST00000539547.5	171	3057	++	153	A8K2U0-1#137	0	39	ENST00000539547.5	1863	1902	+	39	0	-26	5908
A8K2U0-1#137	0	13	13	A8K2U0-1	1056	1069	+	13	A8K2U0-1	0	1454	ENST00000299698.12	31	4393	++	21	A8K2U0-1#137	0	39	ENST00000299698.12	3199	3238	+	39	0	-26	5909
A8K2U0-1#138	0	4	4	A8K2U0-1	1071	1075	+	4	A8K2U0-1	450	1454	ENST00000541459.5	0	3012	++	154	A8K2U0-1#138	0	12	ENST00000541459.5	1863	1875	+	12	0	-8	5910
A8K2U0-1#138	0	4	4	A8K2U0-1	1071	1075	+	4	A8K2U0-1	492	1454	ENST00000539547.5	171	3057	++	153	A8K2U0-1#138	0	12	ENST00000539547.5	1908	1920	+	12	0	-8	5911
A8K2U0-1#138	0	4	4	A8K2U0-1	1071	1075	+	4	A8K2U0-1	0	1454	ENST00000299698.12	31	4393	++	21	A8K2U0-1#138	0	12	ENST00000299698.12	3244	3256	+	12	0	-8	5912
A8K2U0-1#139	0	3	3	A8K2U0-1	1078	1081	+	3	A8K2U0-1	450	1454	ENST00000541459.5	0	3012	++	154	A8K2U0-1#139	0	9	ENST00000541459.5	1884	1893	+	9	0	-6	5913
A8K2U0-1#139	0	3	3	A8K2U0-1	1078	1081	+	3	A8K2U0-1	492	1454	ENST00000539547.5	171	3057	++	153	A8K2U0-1#139	0	9	ENST00000539547.5	1929	1938	+	9	0	-6	5914
A8K2U0-1#139	0	3	3	A8K2U0-1	1078	1081	+	3	A8K2U0-1	0	1454	ENST00000299698.12	31	4393	++	21	A8K2U0-1#139	0	9	ENST00000299698.12	3265	3274	+	9	0	-6	5915
A8K2U0-1#140	0	4	4	A8K2U0-1	1082	1086	+	4	A8K2U0-1	450	1454	ENST00000541459.5	0	3012	++	154	A8K2U0-1#140	0	12	ENST00000541459.5	1896	1908	+	12	0	-8	5916
A8K2U0-1#140	0	4	4	A8K2U0-1	1082	1086	+	4	A8K2U0-1	492	1454	ENST00000539547.5	171	3057	++	153	A8K2U0-1#140	0	12	ENST00000539547.5	1941	1953	+	12	0	-8	5917
A8K2U0-1#140	0	4	4	A8K2U0-1	1082	1086	+	4	A8K2U0-1	0	1454	ENST00000299698.12	31	4393	++	21	A8K2U0-1#140	0	12	ENST00000299698.12	3277	3289	+	12	0	-8	5918
A8K2U0-1#141	0	3	3	A8K2U0-1	1086	1089	+	3	A8K2U0-1	450	1454	ENST00000541459.5	0	3012	++	154	A8K2U0-1#141	0	9	ENST00000541459.5	1908	1917	+	9	0	-6	5919
A8K2U0-1#141	0	3	3	A8K2U0-1	1086	1089	+	3	A8K2U0-1	492	1454	ENST00000539547.5	171	3057	++	153	A8K2U0-1#141	0	9	ENST00000539547.5	1953	1962	+	9	0	-6	5920
A8K2U0-1#141	0	3	3	A8K2U0-1	1086	1089	+	3	A8K2U0-1	0	1454	ENST00000299698.12	31	4393	++	21	A8K2U0-1#141	0	9	ENST00000299698.12	3289	3298	+	9	0	-6	5921
A8K2U0-1#142	0	12	12	A8K2U0-1	1093	1105	+	12	A8K2U0-1	450	1454	ENST00000541459.5	0	3012	++	154	A8K2U0-1#142	0	36	ENST00000541459.5	1929	1965	+	36	0	-24	5922
A8K2U0-1#142	0	12	12	A8K2U0-1	1093	1105	+	12	A8K2U0-1	492	1454	ENST00000539547.5	171	3057	++	153	A8K2U0-1#142	0	36	ENST00000539547.5	1974	2010	+	36	0	-24	5923
A8K2U0-1#142	0	12	12	A8K2U0-1	1093	1105	+	12	A8K2U0-1	0	1454	ENST00000299698.12	31	4393	++	21	A8K2U0-1#142	0	36	ENST00000299698.12	3310	3346	+	36	0	-24	5924
A8K2U0-1#143	0	4	4	A8K2U0-1	1105	1109	+	4	A8K2U0-1	450	1454	ENST00000541459.5	0	3012	++	154	A8K2U0-1#143	0	12	ENST00000541459.5	1965	1977	+	12	0	-8	5925
A8K2U0-1#143	0	4	4	A8K2U0-1	1105	1109	+	4	A8K2U0-1	492	1454	ENST00000539547.5	171	3057	++	153	A8K2U0-1#143	0	12	ENST00000539547.5	2010	2022	+	12	0	-8	5926
A8K2U0-1#143	0	4	4	A8K2U0-1	1105	1109	+	4	A8K2U0-1	0	1454	ENST00000299698.12	31	4393	++	21	A8K2U0-1#143	0	12	ENST00000299698.12	3346	3358	+	12	0	-8	5927
A8K2U0-1#144	0	10	10	A8K2U0-1	1114	1124	+	10	A8K2U0-1	450	1454	ENST00000541459.5	0	3012	++	154	A8K2U0-1#144	0	30	ENST00000541459.5	1992	2022	+	30	0	-20	5928
A8K2U0-1#144	0	10	10	A8K2U0-1	1114	1124	+	10	A8K2U0-1	492	1454	ENST00000539547.5	171	3057	++	153	A8K2U0-1#144	0	30	ENST00000539547.5	2037	2067	+	30	0	-20	5929
A8K2U0-1#144	0	10	10	A8K2U0-1	1114	1124	+	10	A8K2U0-1	0	1454	ENST00000299698.12	31	4393	++	21	A8K2U0-1#144	0	30	ENST00000299698.12	3373	3403	+	30	0	-20	5930
A8K2U0-1#145	0	4	4	A8K2U0-1	1126	1130	+	4	A8K2U0-1	450	1454	ENST00000541459.5	0	3012	++	154	A8K2U0-1#145	0	12	ENST00000541459.5	2028	2040	+	12	0	-8	5931
A8K2U0-1#145	0	4	4	A8K2U0-1	1126	1130	+	4	A8K2U0-1	492	1454	ENST00000539547.5	171	3057	++	153	A8K2U0-1#145	0	12	ENST00000539547.5	2073	2085	+	12	0	-8	5932
A8K2U0-1#145	0	4	4	A8K2U0-1	1126	1130	+	4	A8K2U0-1	0	1454	ENST00000299698.12	31	4393	++	21	A8K2U0-1#145	0	12	ENST00000299698.12	3409	3421	+	12	0	-8	5933
A8K2U0-1#146	0	9	9	A8K2U0-1	1134	1143	+	9	A8K2U0-1	450	1454	ENST00000541459.5	0	3012	++	154	A8K2U0-1#146	0	27	ENST00000541459.5	2052	2079	+	27	0	-18	5934
A8K2U0-1#146	0	9	9	A8K2U0-1	1134	1143	+	9	A8K2U0-1	492	1454	ENST00000539547.5	171	3057	++	153	A8K2U0-1#146	0	27	ENST00000539547.5	2097	2124	+	27	0	-18	5935
A8K2U0-1#146	0	9	9	A8K2U0-1	1134	1143	+	9	A8K2U0-1	0	1454	ENST00000299698.12	31	4393	++	21	A8K2U0-1#146	0	27	ENST00000299698.12	3433	3460	+	27	0	-18	5936
A8K2U0-1#147	0	5	5	A8K2U0-1	1143	1148	+	5	A8K2U0-1	450	1454	ENST00000541459.5	0	3012	++	154	A8K2U0-1#147	0	15	ENST00000541459.5	2079	2094	+	15	0	-10	5937
A8K2U0-1#147	0	5	5	A8K2U0-1	1143	1148	+	5	A8K2U0-1	492	1454	ENST00000539547.5	171	3057	++	153	A8K2U0-1#147	0	15	ENST00000539547.5	2124	2139	+	15	0	-10	5938
A8K2U0-1#147	0	5	5	A8K2U0-1	1143	1148	+	5	A8K2U0-1	0	1454	ENST00000299698.12	31	4393	++	21	A8K2U0-1#147	0	15	ENST00000299698.12	3460	3475	+	15	0	-10	5939
A8K2U0-1#148	0	5	5	A8K2U0-1	1149	1154	+	5	A8K2U0-1	450	1454	ENST00000541459.5	0	3012	++	154	A8K2U0-1#148	0	15	ENST00000541459.5	2097	2112	+	15	0	-10	5940
A8K2U0-1#148	0	5	5	A8K2U0-1	1149	1154	+	5	A8K2U0-1	492	1454	ENST00000539547.5	171	3057	++	153	A8K2U0-1#148	0	15	ENST00000539547.5	2142	2157	+	15	0	-10	5941
A8K2U0-1#148	0	5	5	A8K2U0-1	1149	1154	+	5	A8K2U0-1	0	1454	ENST00000299698.12	31	4393	++	21	A8K2U0-1#148	0	15	ENST00000299698.12	3478	3493	+	15	0	-10	5942
A8K2U0-1#149	0	6	6	A8K2U0-1	1154	1160	+	6	A8K2U0-1	450	1454	ENST00000541459.5	0	3012	++	154	A8K2U0-1#149	0	18	ENST00000541459.5	2112	2130	+	18	0	-12	5943
A8K2U0-1#149	0	6	6	A8K2U0-1	1154	1160	+	6	A8K2U0-1	492	1454	ENST00000539547.5	171	3057	++	153	A8K2U0-1#149	0	18	ENST00000539547.5	2157	2175	+	18	0	-12	5944
A8K2U0-1#149	0	6	6	A8K2U0-1	1154	1160	+	6	A8K2U0-1	0	1454	ENST00000299698.12	31	4393	++	21	A8K2U0-1#149	0	18	ENST00000299698.12	3493	3511	+	18	0	-12	5945
A8K2U0-1#150	0	5	5	A8K2U0-1	1162	1167	+	5	A8K2U0-1	450	1454	ENST00000541459.5	0	3012	++	154	A8K2U0-1#150	0	15	ENST00000541459.5	2136	2151	+	15	0	-10	5946
A8K2U0-1#150	0	5	5	A8K2U0-1	1162	1167	+	5	A8K2U0-1	492	1454	ENST00000539547.5	171	3057	++	153	A8K2U0-1#150	0	15	ENST00000539547.5	2181	2196	+	15	0	-10	5947
A8K2U0-1#150	0	5	5	A8K2U0-1	1162	1167	+	5	A8K2U0-1	0	1454	ENST00000299698.12	31	4393	++	21	A8K2U0-1#150	0	15	ENST00000299698.12	3517	3532	+	15	0	-10	5948
A8K2U0-1#151	0	4	4	A8K2U0-1	1169	1173	+	4	A8K2U0-1	450	1454	ENST00000541459.5	0	3012	++	154	A8K2U0-1#151	0	12	ENST00000541459.5	2157	2169	+	12	0	-8	5949
A8K2U0-1#151	0	4	4	A8K2U0-1	1169	1173	+	4	A8K2U0-1	492	1454	ENST00000539547.5	171	3057	++	153	A8K2U0-1#151	0	12	ENST00000539547.5	2202	2214	+	12	0	-8	5950
A8K2U0-1#151	0	4	4	A8K2U0-1	1169	1173	+	4	A8K2U0-1	0	1454	ENST00000299698.12	31	4393	++	21	A8K2U0-1#151	0	12	ENST00000299698.12	3538	3550	+	12	0	-8	5951
A8K2U0-1#152	0	13	13	A8K2U0-1	1191	1204	+	13	A8K2U0-1	450	1454	ENST00000541459.5	0	3012	++	154	A8K2U0-1#152	0	39	ENST00000541459.5	2223	2262	+	39	0	-26	5952
A8K2U0-1#152	0	13	13	A8K2U0-1	1191	1204	+	13	A8K2U0-1	492	1454	ENST00000539547.5	171	3057	++	153	A8K2U0-1#152	0	39	ENST00000539547.5	2268	2307	+	39	0	-26	5953
A8K2U0-1#152	0	13	13	A8K2U0-1	1191	1204	+	13	A8K2U0-1	0	1454	ENST00000299698.12	31	4393	++	21	A8K2U0-1#152	0	39	ENST00000299698.12	3604	3643	+	39	0	-26	5954
A8K2U0-1#153	0	4	4	A8K2U0-1	1204	1208	+	4	A8K2U0-1	450	1454	ENST00000541459.5	0	3012	++	154	A8K2U0-1#153	0	12	ENST00000541459.5	2262	2274	+	12	0	-8	5955
A8K2U0-1#153	0	4	4	A8K2U0-1	1204	1208	+	4	A8K2U0-1	492	1454	ENST00000539547.5	171	3057	++	153	A8K2U0-1#153	0	12	ENST00000539547.5	2307	2319	+	12	0	-8	5956
A8K2U0-1#153	0	4	4	A8K2U0-1	1204	1208	+	4	A8K2U0-1	0	1454	ENST00000299698.12	31	4393	++	21	A8K2U0-1#153	0	12	ENST00000299698.12	3643	3655	+	12	0	-8	5957
A8K2U0-1#154	0	14	14	A8K2U0-1	1211	1225	+	14	A8K2U0-1	450	1454	ENST00000541459.5	0	3012	++	154	A8K2U0-1#154	0	42	ENST00000541459.5	2283	2325	+	42	0	-28	5958
A8K2U0-1#154	0	14	14	A8K2U0-1	1211	1225	+	14	A8K2U0-1	492	1454	ENST00000539547.5	171	3057	++	153	A8K2U0-1#154	0	42	ENST00000539547.5	2328	2370	+	42	0	-28	5959
A8K2U0-1#154	0	14	14	A8K2U0-1	1211	1225	+	14	A8K2U0-1	0	1454	ENST00000299698.12	31	4393	++	21	A8K2U0-1#154	0	42	ENST00000299698.12	3664	3706	+	42	0	-28	5960
A8K2U0-1#155	0	5	5	A8K2U0-1	1229	1234	+	5	A8K2U0-1	450	1454	ENST00000541459.5	0	3012	++	154	A8K2U0-1#155	0	15	ENST00000541459.5	2337	2352	+	15	0	-10	5961
A8K2U0-1#155	0	5	5	A8K2U0-1	1229	1234	+	5	A8K2U0-1	492	1454	ENST00000539547.5	171	3057	++	153	A8K2U0-1#155	0	15	ENST00000539547.5	2382	2397	+	15	0	-10	5962
A8K2U0-1#155	0	5	5	A8K2U0-1	1229	1234	+	5	A8K2U0-1	0	1454	ENST00000299698.12	31	4393	++	21	A8K2U0-1#155	0	15	ENST00000299698.12	3718	3733	+	15	0	-10	5963
A8K2U0-1#156	0	4	4	A8K2U0-1	1235	1239	+	4	A8K2U0-1	450	1454	ENST00000541459.5	0	3012	++	154	A8K2U0-1#156	0	12	ENST00000541459.5	2355	2367	+	12	0	-8	5964
A8K2U0-1#156	0	4	4	A8K2U0-1	1235	1239	+	4	A8K2U0-1	492	1454	ENST00000539547.5	171	3057	++	153	A8K2U0-1#156	0	12	ENST00000539547.5	2400	2412	+	12	0	-8	5965
A8K2U0-1#156	0	4	4	A8K2U0-1	1235	1239	+	4	A8K2U0-1	0	1454	ENST00000299698.12	31	4393	++	21	A8K2U0-1#156	0	12	ENST00000299698.12	3736	3748	+	12	0	-8	5966
A8K2U0-1#157	0	15	15	A8K2U0-1	1239	1254	+	15	A8K2U0-1	450	1454	ENST00000541459.5	0	3012	++	154	A8K2U0-1#157	0	45	ENST00000541459.5	2367	2412	+	45	0	-30	5967
A8K2U0-1#157	0	15	15	A8K2U0-1	1239	1254	+	15	A8K2U0-1	492	1454	ENST00000539547.5	171	3057	++	153	A8K2U0-1#157	0	45	ENST00000539547.5	2412	2457	+	45	0	-30	5968
A8K2U0-1#157	0	15	15	A8K2U0-1	1239	1254	+	15	A8K2U0-1	0	1454	ENST00000299698.12	31	4393	++	21	A8K2U0-1#157	0	45	ENST00000299698.12	3748	3793	+	45	0	-30	5969
A8K2U0-1#158	0	9	9	A8K2U0-1	1259	1268	+	9	A8K2U0-1	450	1454	ENST00000541459.5	0	3012	++	154	A8K2U0-1#158	0	27	ENST00000541459.5	2427	2454	+	27	0	-18	5970
A8K2U0-1#158	0	9	9	A8K2U0-1	1259	1268	+	9	A8K2U0-1	492	1454	ENST00000539547.5	171	3057	++	153	A8K2U0-1#158	0	27	ENST00000539547.5	2472	2499	+	27	0	-18	5971
A8K2U0-1#158	0	9	9	A8K2U0-1	1259	1268	+	9	A8K2U0-1	0	1454	ENST00000299698.12	31	4393	++	21	A8K2U0-1#158	0	27	ENST00000299698.12	3808	3835	+	27	0	-18	5972
A8K2U0-1#159	0	3	3	A8K2U0-1	1268	1271	+	3	A8K2U0-1	450	1454	ENST00000541459.5	0	3012	++	154	A8K2U0-1#159	0	9	ENST00000541459.5	2454	2463	+	9	0	-6	5973
A8K2U0-1#159	0	3	3	A8K2U0-1	1268	1271	+	3	A8K2U0-1	492	1454	ENST00000539547.5	171	3057	++	153	A8K2U0-1#159	0	9	ENST00000539547.5	2499	2508	+	9	0	-6	5974
A8K2U0-1#159	0	3	3	A8K2U0-1	1268	1271	+	3	A8K2U0-1	0	1454	ENST00000299698.12	31	4393	++	21	A8K2U0-1#159	0	9	ENST00000299698.12	3835	3844	+	9	0	-6	5975
A8K2U0-1#160	0	5	5	A8K2U0-1	1273	1278	+	5	A8K2U0-1	450	1454	ENST00000541459.5	0	3012	++	154	A8K2U0-1#160	0	15	ENST00000541459.5	2469	2484	+	15	0	-10	5976
A8K2U0-1#160	0	5	5	A8K2U0-1	1273	1278	+	5	A8K2U0-1	492	1454	ENST00000539547.5	171	3057	++	153	A8K2U0-1#160	0	15	ENST00000539547.5	2514	2529	+	15	0	-10	5977
A8K2U0-1#160	0	5	5	A8K2U0-1	1273	1278	+	5	A8K2U0-1	1273	1454	ENST00000537475.1	1	544	++	152	A8K2U0-1#160	0	15	ENST00000537475.1	1	16	+	15	0	-10	5978
A8K2U0-1#160	0	5	5	A8K2U0-1	1273	1278	+	5	A8K2U0-1	0	1454	ENST00000299698.12	31	4393	++	21	A8K2U0-1#160	0	15	ENST00000299698.12	3850	3865	+	15	0	-10	5979
A8K2U0-1#161	0	3	3	A8K2U0-1	1279	1282	+	3	A8K2U0-1	450	1454	ENST00000541459.5	0	3012	++	154	A8K2U0-1#161	0	9	ENST00000541459.5	2487	2496	+	9	0	-6	5980
A8K2U0-1#161	0	3	3	A8K2U0-1	1279	1282	+	3	A8K2U0-1	492	1454	ENST00000539547.5	171	3057	++	153	A8K2U0-1#161	0	9	ENST00000539547.5	2532	2541	+	9	0	-6	5981
A8K2U0-1#161	0	3	3	A8K2U0-1	1279	1282	+	3	A8K2U0-1	1273	1454	ENST00000537475.1	1	544	++	152	A8K2U0-1#161	0	9	ENST00000537475.1	19	28	+	9	0	-6	5982
A8K2U0-1#161	0	3	3	A8K2U0-1	1279	1282	+	3	A8K2U0-1	0	1454	ENST00000299698.12	31	4393	++	21	A8K2U0-1#161	0	9	ENST00000299698.12	3868	3877	+	9	0	-6	5983
A8K2U0-1#162	0	4	4	A8K2U0-1	1286	1290	+	4	A8K2U0-1	450	1454	ENST00000541459.5	0	3012	++	154	A8K2U0-1#162	0	12	ENST00000541459.5	2508	2520	+	12	0	-8	5984
A8K2U0-1#162	0	4	4	A8K2U0-1	1286	1290	+	4	A8K2U0-1	492	1454	ENST00000539547.5	171	3057	++	153	A8K2U0-1#162	0	12	ENST00000539547.5	2553	2565	+	12	0	-8	5985
A8K2U0-1#162	0	4	4	A8K2U0-1	1286	1290	+	4	A8K2U0-1	1273	1454	ENST00000537475.1	1	544	++	152	A8K2U0-1#162	0	12	ENST00000537475.1	40	52	+	12	0	-8	5986
A8K2U0-1#162	0	4	4	A8K2U0-1	1286	1290	+	4	A8K2U0-1	0	1454	ENST00000299698.12	31	4393	++	21	A8K2U0-1#162	0	12	ENST00000299698.12	3889	3901	+	12	0	-8	5987
A8K2U0-1#163	0	12	12	A8K2U0-1	1294	1306	+	12	A8K2U0-1	450	1454	ENST00000541459.5	0	3012	++	154	A8K2U0-1#163	0	36	ENST00000541459.5	2532	2568	+	36	0	-24	5988
A8K2U0-1#163	0	12	12	A8K2U0-1	1294	1306	+	12	A8K2U0-1	492	1454	ENST00000539547.5	171	3057	++	153	A8K2U0-1#163	0	36	ENST00000539547.5	2577	2613	+	36	0	-24	5989
A8K2U0-1#163	0	12	12	A8K2U0-1	1294	1306	+	12	A8K2U0-1	1273	1454	ENST00000537475.1	1	544	++	152	A8K2U0-1#163	0	36	ENST00000537475.1	64	100	+	36	0	-24	5990
A8K2U0-1#163	0	12	12	A8K2U0-1	1294	1306	+	12	A8K2U0-1	0	1454	ENST00000299698.12	31	4393	++	21	A8K2U0-1#163	0	36	ENST00000299698.12	3913	3949	+	36	0	-24	5991
A8K2U0-1#164	0	11	11	A8K2U0-1	1307	1318	+	11	A8K2U0-1	450	1454	ENST00000541459.5	0	3012	++	154	A8K2U0-1#164	0	33	ENST00000541459.5	2571	2604	+	33	0	-22	5992
A8K2U0-1#164	0	11	11	A8K2U0-1	1307	1318	+	11	A8K2U0-1	492	1454	ENST00000539547.5	171	3057	++	153	A8K2U0-1#164	0	33	ENST00000539547.5	2616	2649	+	33	0	-22	5993
A8K2U0-1#164	0	11	11	A8K2U0-1	1307	1318	+	11	A8K2U0-1	1273	1454	ENST00000537475.1	1	544	++	152	A8K2U0-1#164	0	33	ENST00000537475.1	103	136	+	33	0	-22	5994
A8K2U0-1#164	0	11	11	A8K2U0-1	1307	1318	+	11	A8K2U0-1	0	1454	ENST00000299698.12	31	4393	++	21	A8K2U0-1#164	0	33	ENST00000299698.12	3952	3985	+	33	0	-22	5995
A8K2U0-1#165	0	8	8	A8K2U0-1	1324	1332	+	8	A8K2U0-1	450	1454	ENST00000541459.5	0	3012	++	154	A8K2U0-1#165	0	24	ENST00000541459.5	2622	2646	+	24	0	-16	5996
A8K2U0-1#165	0	8	8	A8K2U0-1	1324	1332	+	8	A8K2U0-1	492	1454	ENST00000539547.5	171	3057	++	153	A8K2U0-1#165	0	24	ENST00000539547.5	2667	2691	+	24	0	-16	5997
A8K2U0-1#165	0	8	8	A8K2U0-1	1324	1332	+	8	A8K2U0-1	1273	1454	ENST00000537475.1	1	544	++	152	A8K2U0-1#165	0	24	ENST00000537475.1	154	178	+	24	0	-16	5998
A8K2U0-1#165	0	8	8	A8K2U0-1	1324	1332	+	8	A8K2U0-1	0	1454	ENST00000299698.12	31	4393	++	21	A8K2U0-1#165	0	24	ENST00000299698.12	4003	4027	+	24	0	-16	5999
A8K2U0-1#166	0	3	3	A8K2U0-1	1337	1340	+	3	A8K2U0-1	450	1454	ENST00000541459.5	0	3012	++	154	A8K2U0-1#166	0	9	ENST00000541459.5	2661	2670	+	9	0	-6	6000
A8K2U0-1#166	0	3	3	A8K2U0-1	1337	1340	+	3	A8K2U0-1	492	1454	ENST00000539547.5	171	3057	++	153	A8K2U0-1#166	0	9	ENST00000539547.5	2706	2715	+	9	0	-6	6001
A8K2U0-1#166	0	3	3	A8K2U0-1	1337	1340	+	3	A8K2U0-1	1273	1454	ENST00000537475.1	1	544	++	152	A8K2U0-1#166	0	9	ENST00000537475.1	193	202	+	9	0	-6	6002
A8K2U0-1#166	0	3	3	A8K2U0-1	1337	1340	+	3	A8K2U0-1	0	1454	ENST00000299698.12	31	4393	++	21	A8K2U0-1#166	0	9	ENST00000299698.12	4042	4051	+	9	0	-6	6003
A8K2U0-1#167	0	9	9	A8K2U0-1	1346	1355	+	9	A8K2U0-1	450	1454	ENST00000541459.5	0	3012	++	154	A8K2U0-1#167	0	27	ENST00000541459.5	2688	2715	+	27	0	-18	6004
A8K2U0-1#167	0	9	9	A8K2U0-1	1346	1355	+	9	A8K2U0-1	492	1454	ENST00000539547.5	171	3057	++	153	A8K2U0-1#167	0	27	ENST00000539547.5	2733	2760	+	27	0	-18	6005
A8K2U0-1#167	0	9	9	A8K2U0-1	1346	1355	+	9	A8K2U0-1	1273	1454	ENST00000537475.1	1	544	++	152	A8K2U0-1#167	0	27	ENST00000537475.1	220	247	+	27	0	-18	6006
A8K2U0-1#167	0	9	9	A8K2U0-1	1346	1355	+	9	A8K2U0-1	0	1454	ENST00000299698.12	31	4393	++	21	A8K2U0-1#167	0	27	ENST00000299698.12	4069	4096	+	27	0	-18	6007
A8K2U0-1#168	0	5	5	A8K2U0-1	1356	1361	+	5	A8K2U0-1	450	1454	ENST00000541459.5	0	3012	++	154	A8K2U0-1#168	0	15	ENST00000541459.5	2718	2733	+	15	0	-10	6008
A8K2U0-1#168	0	5	5	A8K2U0-1	1356	1361	+	5	A8K2U0-1	492	1454	ENST00000539547.5	171	3057	++	153	A8K2U0-1#168	0	15	ENST00000539547.5	2763	2778	+	15	0	-10	6009
A8K2U0-1#168	0	5	5	A8K2U0-1	1356	1361	+	5	A8K2U0-1	1273	1454	ENST00000537475.1	1	544	++	152	A8K2U0-1#168	0	15	ENST00000537475.1	250	265	+	15	0	-10	6010
A8K2U0-1#168	0	5	5	A8K2U0-1	1356	1361	+	5	A8K2U0-1	0	1454	ENST00000299698.12	31	4393	++	21	A8K2U0-1#168	0	15	ENST00000299698.12	4099	4114	+	15	0	-10	6011
A8K2U0-1#169	0	6	6	A8K2U0-1	1364	1370	+	6	A8K2U0-1	450	1454	ENST00000541459.5	0	3012	++	154	A8K2U0-1#169	0	18	ENST00000541459.5	2742	2760	+	18	0	-12	6012
A8K2U0-1#169	0	6	6	A8K2U0-1	1364	1370	+	6	A8K2U0-1	492	1454	ENST00000539547.5	171	3057	++	153	A8K2U0-1#169	0	18	ENST00000539547.5	2787	2805	+	18	0	-12	6013
A8K2U0-1#169	0	6	6	A8K2U0-1	1364	1370	+	6	A8K2U0-1	1273	1454	ENST00000537475.1	1	544	++	152	A8K2U0-1#169	0	18	ENST00000537475.1	274	292	+	18	0	-12	6014
A8K2U0-1#169	0	6	6	A8K2U0-1	1364	1370	+	6	A8K2U0-1	0	1454	ENST00000299698.12	31	4393	++	21	A8K2U0-1#169	0	18	ENST00000299698.12	4123	4141	+	18	0	-12	6015
A8K2U0-1#170	0	3	3	A8K2U0-1	1377	1380	+	3	A8K2U0-1	450	1454	ENST00000541459.5	0	3012	++	154	A8K2U0-1#170	0	9	ENST00000541459.5	2781	2790	+	9	0	-6	6016
A8K2U0-1#170	0	3	3	A8K2U0-1	1377	1380	+	3	A8K2U0-1	492	1454	ENST00000539547.5	171	3057	++	153	A8K2U0-1#170	0	9	ENST00000539547.5	2826	2835	+	9	0	-6	6017
A8K2U0-1#170	0	3	3	A8K2U0-1	1377	1380	+	3	A8K2U0-1	1273	1454	ENST00000537475.1	1	544	++	152	A8K2U0-1#170	0	9	ENST00000537475.1	313	322	+	9	0	-6	6018
A8K2U0-1#170	0	3	3	A8K2U0-1	1377	1380	+	3	A8K2U0-1	0	1454	ENST00000299698.12	31	4393	++	21	A8K2U0-1#170	0	9	ENST00000299698.12	4162	4171	+	9	0	-6	6019
A8K2U0-1#171	0	6	6	A8K2U0-1	1380	1386	+	6	A8K2U0-1	450	1454	ENST00000541459.5	0	3012	++	154	A8K2U0-1#171	0	18	ENST00000541459.5	2790	2808	+	18	0	-12	6020
A8K2U0-1#171	0	6	6	A8K2U0-1	1380	1386	+	6	A8K2U0-1	492	1454	ENST00000539547.5	171	3057	++	153	A8K2U0-1#171	0	18	ENST00000539547.5	2835	2853	+	18	0	-12	6021
A8K2U0-1#171	0	6	6	A8K2U0-1	1380	1386	+	6	A8K2U0-1	1273	1454	ENST00000537475.1	1	544	++	152	A8K2U0-1#171	0	18	ENST00000537475.1	322	340	+	18	0	-12	6022
A8K2U0-1#171	0	6	6	A8K2U0-1	1380	1386	+	6	A8K2U0-1	0	1454	ENST00000299698.12	31	4393	++	21	A8K2U0-1#171	0	18	ENST00000299698.12	4171	4189	+	18	0	-12	6023
A8K2U0-1#172	0	4	4	A8K2U0-1	1392	1396	+	4	A8K2U0-1	450	1454	ENST00000541459.5	0	3012	++	154	A8K2U0-1#172	0	12	ENST00000541459.5	2826	2838	+	12	0	-8	6024
A8K2U0-1#172	0	4	4	A8K2U0-1	1392	1396	+	4	A8K2U0-1	492	1454	ENST00000539547.5	171	3057	++	153	A8K2U0-1#172	0	12	ENST00000539547.5	2871	2883	+	12	0	-8	6025
A8K2U0-1#172	0	4	4	A8K2U0-1	1392	1396	+	4	A8K2U0-1	1273	1454	ENST00000537475.1	1	544	++	152	A8K2U0-1#172	0	12	ENST00000537475.1	358	370	+	12	0	-8	6026
A8K2U0-1#172	0	4	4	A8K2U0-1	1392	1396	+	4	A8K2U0-1	0	1454	ENST00000299698.12	31	4393	++	21	A8K2U0-1#172	0	12	ENST00000299698.12	4207	4219	+	12	0	-8	6027
A8K2U0-1#173	0	9	9	A8K2U0-1	1397	1406	+	9	A8K2U0-1	450	1454	ENST00000541459.5	0	3012	++	154	A8K2U0-1#173	0	27	ENST00000541459.5	2841	2868	+	27	0	-18	6028
A8K2U0-1#173	0	9	9	A8K2U0-1	1397	1406	+	9	A8K2U0-1	492	1454	ENST00000539547.5	171	3057	++	153	A8K2U0-1#173	0	27	ENST00000539547.5	2886	2913	+	27	0	-18	6029
A8K2U0-1#173	0	9	9	A8K2U0-1	1397	1406	+	9	A8K2U0-1	1273	1454	ENST00000537475.1	1	544	++	152	A8K2U0-1#173	0	27	ENST00000537475.1	373	400	+	27	0	-18	6030
A8K2U0-1#173	0	9	9	A8K2U0-1	1397	1406	+	9	A8K2U0-1	0	1454	ENST00000299698.12	31	4393	++	21	A8K2U0-1#173	0	27	ENST00000299698.12	4222	4249	+	27	0	-18	6031
A8K2U0-1#174	0	11	11	A8K2U0-1	1412	1423	+	11	A8K2U0-1	450	1454	ENST00000541459.5	0	3012	++	154	A8K2U0-1#174	0	33	ENST00000541459.5	2886	2919	+	33	0	-22	6032
A8K2U0-1#174	0	11	11	A8K2U0-1	1412	1423	+	11	A8K2U0-1	492	1454	ENST00000539547.5	171	3057	++	153	A8K2U0-1#174	0	33	ENST00000539547.5	2931	2964	+	33	0	-22	6033
A8K2U0-1#174	0	11	11	A8K2U0-1	1412	1423	+	11	A8K2U0-1	1273	1454	ENST00000537475.1	1	544	++	152	A8K2U0-1#174	0	33	ENST00000537475.1	418	451	+	33	0	-22	6034
A8K2U0-1#174	0	11	11	A8K2U0-1	1412	1423	+	11	A8K2U0-1	0	1454	ENST00000299698.12	31	4393	++	21	A8K2U0-1#174	0	33	ENST00000299698.12	4267	4300	+	33	0	-22	6035
A8K2U0-1#175	0	3	3	A8K2U0-1	1424	1427	+	3	A8K2U0-1	450	1454	ENST00000541459.5	0	3012	++	154	A8K2U0-1#175	0	9	ENST00000541459.5	2922	2931	+	9	0	-6	6036
A8K2U0-1#175	0	3	3	A8K2U0-1	1424	1427	+	3	A8K2U0-1	492	1454	ENST00000539547.5	171	3057	++	153	A8K2U0-1#175	0	9	ENST00000539547.5	2967	2976	+	9	0	-6	6037
A8K2U0-1#175	0	3	3	A8K2U0-1	1424	1427	+	3	A8K2U0-1	1273	1454	ENST00000537475.1	1	544	++	152	A8K2U0-1#175	0	9	ENST00000537475.1	454	463	+	9	0	-6	6038
A8K2U0-1#175	0	3	3	A8K2U0-1	1424	1427	+	3	A8K2U0-1	0	1454	ENST00000299698.12	31	4393	++	21	A8K2U0-1#175	0	9	ENST00000299698.12	4303	4312	+	9	0	-6	6039
A8K2U0-1#176	0	9	9	A8K2U0-1	1430	1439	+	9	A8K2U0-1	450	1454	ENST00000541459.5	0	3012	++	154	A8K2U0-1#176	0	27	ENST00000541459.5	2940	2967	+	27	0	-18	6040
A8K2U0-1#176	0	9	9	A8K2U0-1	1430	1439	+	9	A8K2U0-1	492	1454	ENST00000539547.5	171	3057	++	153	A8K2U0-1#176	0	27	ENST00000539547.5	2985	3012	+	27	0	-18	6041
A8K2U0-1#176	0	9	9	A8K2U0-1	1430	1439	+	9	A8K2U0-1	1273	1454	ENST00000537475.1	1	544	++	152	A8K2U0-1#176	0	27	ENST00000537475.1	472	499	+	27	0	-18	6042
A8K2U0-1#176	0	9	9	A8K2U0-1	1430	1439	+	9	A8K2U0-1	0	1454	ENST00000299698.12	31	4393	++	21	A8K2U0-1#176	0	27	ENST00000299698.12	4321	4348	+	27	0	-18	6043
A8K2U0-1#177	0	7	7	A8K2U0-1	1442	1449	+	7	A8K2U0-1	450	1454	ENST00000541459.5	0	3012	++	154	A8K2U0-1#177	0	21	ENST00000541459.5	2976	2997	+	21	0	-14	6044
A8K2U0-1#177	0	7	7	A8K2U0-1	1442	1449	+	7	A8K2U0-1	492	1454	ENST00000539547.5	171	3057	++	153	A8K2U0-1#177	0	21	ENST00000539547.5	3021	3042	+	21	0	-14	6045
A8K2U0-1#177	0	7	7	A8K2U0-1	1442	1449	+	7	A8K2U0-1	1273	1454	ENST00000537475.1	1	544	++	152	A8K2U0-1#177	0	21	ENST00000537475.1	508	529	+	21	0	-14	6046
A8K2U0-1#177	0	7	7	A8K2U0-1	1442	1449	+	7	A8K2U0-1	0	1454	ENST00000299698.12	31	4393	++	21	A8K2U0-1#177	0	21	ENST00000299698.12	4357	4378	+	21	0	-14	6047
P11137-1#0	0	1827	1827	P11137-1	0	1827	+	1827	P11137-1	0	1827	ENST00000704357.1	451	6025	++	271	P11137-1#0	0	5481	ENST00000704357.1	451	6025	+	5481	0	-3654	6048
P11137-1#0	0	1827	1827	P11137-1	0	1827	+	1827	P11137-1	0	1827	ENST00000682079.1	451	5932	++	266	P11137-1#0	0	5481	ENST00000682079.1	451	5932	+	5481	0	-3654	6049
P11137-1#0	0	1827	1827	P11137-1	0	1827	+	1827	P11137-1	106	1827	ENST00000673860.1	1122	6288	++	229	P11137-1#0	318	5481	ENST00000673860.1	1122	6288	+	5160	318	-3654	6050
P11137-1#0	0	1827	1827	P11137-1	0	1827	+	1827	P11137-1	0	1827	ENST00000447185.5	0	5469	++	97	P11137-1#0	0	5481	ENST00000447185.5	0	5469	+	5469	0	-3654	6051
P11137-1#0	0	1827	1827	P11137-1	0	1827	+	1827	P11137-1	106	485	ENST00000445941.5	879	2019	++	96	P11137-1#0	318	1455	ENST00000445941.5	879	2019	+	1134	318	372	6052
P11137-1#0	0	1827	1827	P11137-1	0	1827	+	1827	P11137-1	1507	1827	ENST00000392194.5	619	1579	++	60	P11137-1#0	4521	5481	ENST00000392194.5	619	1579	+	960	4521	-3654	6053
P11137-1#0	0	1827	1827	P11137-1	0	1827	+	1827	P11137-1	0	106	ENST00000392193.5	295	613	++	59	P11137-1#0	0	318	ENST00000392193.5	295	613	+	318	0	1509	6054
P11137-1#0	0	1827	1827	P11137-1	0	1827	+	1827	P11137-1	1507	1827	ENST00000361559.8	949	1909	++	41	P11137-1#0	4521	5481	ENST00000361559.8	949	1909	+	960	4521	-3654	6055
P11137-1#0	0	1827	1827	P11137-1	0	1827	+	1827	P11137-1	0	1827	ENST00000360351.8	506	5987	++	39	P11137-1#0	0	5481	ENST00000360351.8	506	5987	+	5481	0	-3654	6056
P11137-1#1	0	31	31	P11137-1	1660	1691	+	31	P11137-1	0	1827	ENST00000704357.1	451	6025	++	271	P11137-1#1	0	93	ENST00000704357.1	5431	5524	+	93	0	-62	6057
P11137-1#1	0	31	31	P11137-1	1660	1691	+	31	P11137-1	0	1827	ENST00000682079.1	451	5932	++	266	P11137-1#1	0	93	ENST00000682079.1	5431	5524	+	93	0	-62	6058
P11137-1#1	0	31	31	P11137-1	1660	1691	+	31	P11137-1	106	1827	ENST00000673860.1	1122	6288	++	229	P11137-1#1	0	93	ENST00000673860.1	5787	5880	+	93	0	-62	6059
P11137-1#1	0	31	31	P11137-1	1660	1691	+	31	P11137-1	0	1827	ENST00000447185.5	0	5469	++	97	P11137-1#1	0	93	ENST00000447185.5	4968	5061	+	93	0	-62	6060
P11137-1#1	0	31	31	P11137-1	1660	1691	+	31	P11137-1	1507	1827	ENST00000392194.5	619	1579	++	60	P11137-1#1	0	93	ENST00000392194.5	1078	1171	+	93	0	-62	6061
P11137-1#1	0	31	31	P11137-1	1660	1691	+	31	P11137-1	1507	1827	ENST00000361559.8	949	1909	++	41	P11137-1#1	0	93	ENST00000361559.8	1408	1501	+	93	0	-62	6062
P11137-1#1	0	31	31	P11137-1	1660	1691	+	31	P11137-1	0	1827	ENST00000360351.8	506	5987	++	39	P11137-1#1	0	93	ENST00000360351.8	5486	5579	+	93	0	-62	6063
P11137-1#2	0	31	31	P11137-1	1691	1722	+	31	P11137-1	0	1827	ENST00000704357.1	451	6025	++	271	P11137-1#2	0	93	ENST00000704357.1	5524	5710	+	93	0	-62	6064
P11137-1#2	0	31	31	P11137-1	1691	1722	+	31	P11137-1	0	1827	ENST00000682079.1	451	5932	++	266	P11137-1#2	0	93	ENST00000682079.1	5524	5617	+	93	0	-62	6065
P11137-1#2	0	31	31	P11137-1	1691	1722	+	31	P11137-1	106	1827	ENST00000673860.1	1122	6288	++	229	P11137-1#2	0	93	ENST00000673860.1	5880	5973	+	93	0	-62	6066
P11137-1#2	0	31	31	P11137-1	1691	1722	+	31	P11137-1	0	1827	ENST00000447185.5	0	5469	++	97	P11137-1#2	0	93	ENST00000447185.5	5061	5154	+	93	0	-62	6067
P11137-1#2	0	31	31	P11137-1	1691	1722	+	31	P11137-1	1507	1827	ENST00000392194.5	619	1579	++	60	P11137-1#2	0	93	ENST00000392194.5	1171	1264	+	93	0	-62	6068
P11137-1#2	0	31	31	P11137-1	1691	1722	+	31	P11137-1	1507	1827	ENST00000361559.8	949	1909	++	41	P11137-1#2	0	93	ENST00000361559.8	1501	1594	+	93	0	-62	6069
P11137-1#2	0	31	31	P11137-1	1691	1722	+	31	P11137-1	0	1827	ENST00000360351.8	506	5987	++	39	P11137-1#2	0	93	ENST00000360351.8	5579	5672	+	93	0	-62	6070
P11137-1#3	0	32	32	P11137-1	1722	1754	+	32	P11137-1	0	1827	ENST00000704357.1	451	6025	++	271	P11137-1#3	0	96	ENST00000704357.1	5710	5806	+	96	0	-64	6071
P11137-1#3	0	32	32	P11137-1	1722	1754	+	32	P11137-1	0	1827	ENST00000682079.1	451	5932	++	266	P11137-1#3	0	96	ENST00000682079.1	5617	5713	+	96	0	-64	6072
P11137-1#3	0	32	32	P11137-1	1722	1754	+	32	P11137-1	106	1827	ENST00000673860.1	1122	6288	++	229	P11137-1#3	0	96	ENST00000673860.1	5973	6069	+	96	0	-64	6073
P11137-1#3	0	32	32	P11137-1	1722	1754	+	32	P11137-1	0	1827	ENST00000447185.5	0	5469	++	97	P11137-1#3	0	96	ENST00000447185.5	5154	5250	+	96	0	-64	6074
P11137-1#3	0	32	32	P11137-1	1722	1754	+	32	P11137-1	1507	1827	ENST00000392194.5	619	1579	++	60	P11137-1#3	0	96	ENST00000392194.5	1264	1360	+	96	0	-64	6075
P11137-1#3	0	32	32	P11137-1	1722	1754	+	32	P11137-1	1507	1827	ENST00000361559.8	949	1909	++	41	P11137-1#3	0	96	ENST00000361559.8	1594	1690	+	96	0	-64	6076
P11137-1#3	0	32	32	P11137-1	1722	1754	+	32	P11137-1	0	1827	ENST00000360351.8	506	5987	++	39	P11137-1#3	0	96	ENST00000360351.8	5672	5768	+	96	0	-64	6077
P11137-1#4	0	88	88	P11137-1	0	88	+	88	P11137-1	0	1827	ENST00000704357.1	451	6025	++	271	P11137-1#4	0	264	ENST00000704357.1	451	715	+	264	0	-176	6078
P11137-1#4	0	88	88	P11137-1	0	88	+	88	P11137-1	0	1827	ENST00000682079.1	451	5932	++	266	P11137-1#4	0	264	ENST00000682079.1	451	715	+	264	0	-176	6079
P11137-1#4	0	88	88	P11137-1	0	88	+	88	P11137-1	0	1827	ENST00000447185.5	0	5469	++	97	P11137-1#4	0	264	ENST00000447185.5	0	264	+	264	0	-176	6080
P11137-1#4	0	88	88	P11137-1	0	88	+	88	P11137-1	0	106	ENST00000392193.5	295	613	++	59	P11137-1#4	0	264	ENST00000392193.5	295	559	+	264	0	-176	6081
P11137-1#4	0	88	88	P11137-1	0	88	+	88	P11137-1	0	1827	ENST00000360351.8	506	5987	++	39	P11137-1#4	0	264	ENST00000360351.8	506	770	+	264	0	-176	6082
P11137-1#5	0	113	113	P11137-1	108	221	+	113	P11137-1	0	1827	ENST00000704357.1	451	6025	++	271	P11137-1#5	0	339	ENST00000704357.1	775	1114	+	339	0	-226	6083
P11137-1#5	0	113	113	P11137-1	108	221	+	113	P11137-1	0	1827	ENST00000682079.1	451	5932	++	266	P11137-1#5	0	339	ENST00000682079.1	775	1114	+	339	0	-226	6084
P11137-1#5	0	113	113	P11137-1	108	221	+	113	P11137-1	106	1827	ENST00000673860.1	1122	6288	++	229	P11137-1#5	0	339	ENST00000673860.1	1128	1470	+	336	0	-226	6085
P11137-1#5	0	113	113	P11137-1	108	221	+	113	P11137-1	0	1827	ENST00000447185.5	0	5469	++	97	P11137-1#5	0	339	ENST00000447185.5	324	651	+	327	0	-226	6086
P11137-1#5	0	113	113	P11137-1	108	221	+	113	P11137-1	106	485	ENST00000445941.5	879	2019	++	96	P11137-1#5	0	339	ENST00000445941.5	885	1227	+	336	0	-226	6087
P11137-1#5	0	113	113	P11137-1	108	221	+	113	P11137-1	0	1827	ENST00000360351.8	506	5987	++	39	P11137-1#5	0	339	ENST00000360351.8	830	1169	+	339	0	-226	6088
P11137-1#6	0	158	158	P11137-1	339	497	+	158	P11137-1	0	1827	ENST00000704357.1	451	6025	++	271	P11137-1#6	0	474	ENST00000704357.1	1468	1942	+	474	0	-316	6089
P11137-1#6	0	158	158	P11137-1	339	497	+	158	P11137-1	0	1827	ENST00000682079.1	451	5932	++	266	P11137-1#6	0	474	ENST00000682079.1	1468	1942	+	474	0	-316	6090
P11137-1#6	0	158	158	P11137-1	339	497	+	158	P11137-1	106	1827	ENST00000673860.1	1122	6288	++	229	P11137-1#6	0	474	ENST00000673860.1	1824	2298	+	474	0	-316	6091
P11137-1#6	0	158	158	P11137-1	339	497	+	158	P11137-1	0	1827	ENST00000447185.5	0	5469	++	97	P11137-1#6	0	474	ENST00000447185.5	1005	1479	+	474	0	-316	6092
P11137-1#6	0	158	158	P11137-1	339	497	+	158	P11137-1	106	485	ENST00000445941.5	879	2019	++	96	P11137-1#6	0	438	ENST00000445941.5	1581	2019	+	438	0	-280	6093
P11137-1#6	0	158	158	P11137-1	339	497	+	158	P11137-1	0	1827	ENST00000360351.8	506	5987	++	39	P11137-1#6	0	474	ENST00000360351.8	1523	1997	+	474	0	-316	6094
P11137-1#7	0	82	82	P11137-1	578	660	+	82	P11137-1	0	1827	ENST00000704357.1	451	6025	++	271	P11137-1#7	0	246	ENST00000704357.1	2185	2431	+	246	0	-164	6095
P11137-1#7	0	82	82	P11137-1	578	660	+	82	P11137-1	0	1827	ENST00000682079.1	451	5932	++	266	P11137-1#7	0	246	ENST00000682079.1	2185	2431	+	246	0	-164	6096
P11137-1#7	0	82	82	P11137-1	578	660	+	82	P11137-1	106	1827	ENST00000673860.1	1122	6288	++	229	P11137-1#7	0	246	ENST00000673860.1	2541	2787	+	246	0	-164	6097
P11137-1#7	0	82	82	P11137-1	578	660	+	82	P11137-1	0	1827	ENST00000447185.5	0	5469	++	97	P11137-1#7	0	246	ENST00000447185.5	1722	1968	+	246	0	-164	6098
P11137-1#7	0	82	82	P11137-1	578	660	+	82	P11137-1	0	1827	ENST00000360351.8	506	5987	++	39	P11137-1#7	0	246	ENST00000360351.8	2240	2486	+	246	0	-164	6099
P11137-1#8	0	44	44	P11137-1	700	744	+	44	P11137-1	0	1827	ENST00000704357.1	451	6025	++	271	P11137-1#8	0	132	ENST00000704357.1	2551	2683	+	132	0	-88	6100
P11137-1#8	0	44	44	P11137-1	700	744	+	44	P11137-1	0	1827	ENST00000682079.1	451	5932	++	266	P11137-1#8	0	132	ENST00000682079.1	2551	2683	+	132	0	-88	6101
P11137-1#8	0	44	44	P11137-1	700	744	+	44	P11137-1	106	1827	ENST00000673860.1	1122	6288	++	229	P11137-1#8	0	132	ENST00000673860.1	2907	3039	+	132	0	-88	6102
P11137-1#8	0	44	44	P11137-1	700	744	+	44	P11137-1	0	1827	ENST00000447185.5	0	5469	++	97	P11137-1#8	0	132	ENST00000447185.5	2088	2220	+	132	0	-88	6103
P11137-1#8	0	44	44	P11137-1	700	744	+	44	P11137-1	0	1827	ENST00000360351.8	506	5987	++	39	P11137-1#8	0	132	ENST00000360351.8	2606	2738	+	132	0	-88	6104
P11137-1#9	0	58	58	P11137-1	930	988	+	58	P11137-1	0	1827	ENST00000704357.1	451	6025	++	271	P11137-1#9	0	174	ENST00000704357.1	3241	3415	+	174	0	-116	6105
P11137-1#9	0	58	58	P11137-1	930	988	+	58	P11137-1	0	1827	ENST00000682079.1	451	5932	++	266	P11137-1#9	0	174	ENST00000682079.1	3241	3415	+	174	0	-116	6106
P11137-1#9	0	58	58	P11137-1	930	988	+	58	P11137-1	106	1827	ENST00000673860.1	1122	6288	++	229	P11137-1#9	0	174	ENST00000673860.1	3597	3771	+	174	0	-116	6107
P11137-1#9	0	58	58	P11137-1	930	988	+	58	P11137-1	0	1827	ENST00000447185.5	0	5469	++	97	P11137-1#9	0	174	ENST00000447185.5	2778	2952	+	174	0	-116	6108
P11137-1#9	0	58	58	P11137-1	930	988	+	58	P11137-1	0	1827	ENST00000360351.8	506	5987	++	39	P11137-1#9	0	174	ENST00000360351.8	3296	3470	+	174	0	-116	6109
P11137-1#10	0	88	88	P11137-1	1072	1160	+	88	P11137-1	0	1827	ENST00000704357.1	451	6025	++	271	P11137-1#10	0	264	ENST00000704357.1	3667	3931	+	264	0	-176	6110
P11137-1#10	0	88	88	P11137-1	1072	1160	+	88	P11137-1	0	1827	ENST00000682079.1	451	5932	++	266	P11137-1#10	0	264	ENST00000682079.1	3667	3931	+	264	0	-176	6111
P11137-1#10	0	88	88	P11137-1	1072	1160	+	88	P11137-1	106	1827	ENST00000673860.1	1122	6288	++	229	P11137-1#10	0	264	ENST00000673860.1	4023	4287	+	264	0	-176	6112
P11137-1#10	0	88	88	P11137-1	1072	1160	+	88	P11137-1	0	1827	ENST00000447185.5	0	5469	++	97	P11137-1#10	0	264	ENST00000447185.5	3204	3468	+	264	0	-176	6113
P11137-1#10	0	88	88	P11137-1	1072	1160	+	88	P11137-1	0	1827	ENST00000360351.8	506	5987	++	39	P11137-1#10	0	264	ENST00000360351.8	3722	3986	+	264	0	-176	6114
P11137-1#11	0	20	20	P11137-1	1196	1216	+	20	P11137-1	0	1827	ENST00000704357.1	451	6025	++	271	P11137-1#11	0	60	ENST00000704357.1	4039	4099	+	60	0	-40	6115
P11137-1#11	0	20	20	P11137-1	1196	1216	+	20	P11137-1	0	1827	ENST00000682079.1	451	5932	++	266	P11137-1#11	0	60	ENST00000682079.1	4039	4099	+	60	0	-40	6116
P11137-1#11	0	20	20	P11137-1	1196	1216	+	20	P11137-1	106	1827	ENST00000673860.1	1122	6288	++	229	P11137-1#11	0	60	ENST00000673860.1	4395	4455	+	60	0	-40	6117
P11137-1#11	0	20	20	P11137-1	1196	1216	+	20	P11137-1	0	1827	ENST00000447185.5	0	5469	++	97	P11137-1#11	0	60	ENST00000447185.5	3576	3636	+	60	0	-40	6118
P11137-1#11	0	20	20	P11137-1	1196	1216	+	20	P11137-1	0	1827	ENST00000360351.8	506	5987	++	39	P11137-1#11	0	60	ENST00000360351.8	4094	4154	+	60	0	-40	6119
P11137-1#12	0	82	82	P11137-1	1296	1378	+	82	P11137-1	0	1827	ENST00000704357.1	451	6025	++	271	P11137-1#12	0	246	ENST00000704357.1	4339	4585	+	246	0	-164	6120
P11137-1#12	0	82	82	P11137-1	1296	1378	+	82	P11137-1	0	1827	ENST00000682079.1	451	5932	++	266	P11137-1#12	0	246	ENST00000682079.1	4339	4585	+	246	0	-164	6121
P11137-1#12	0	82	82	P11137-1	1296	1378	+	82	P11137-1	106	1827	ENST00000673860.1	1122	6288	++	229	P11137-1#12	0	246	ENST00000673860.1	4695	4941	+	246	0	-164	6122
P11137-1#12	0	82	82	P11137-1	1296	1378	+	82	P11137-1	0	1827	ENST00000447185.5	0	5469	++	97	P11137-1#12	0	246	ENST00000447185.5	3876	4122	+	246	0	-164	6123
P11137-1#12	0	82	82	P11137-1	1296	1378	+	82	P11137-1	0	1827	ENST00000360351.8	506	5987	++	39	P11137-1#12	0	246	ENST00000360351.8	4394	4640	+	246	0	-164	6124
P11137-1#13	0	58	58	P11137-1	1402	1460	+	58	P11137-1	0	1827	ENST00000704357.1	451	6025	++	271	P11137-1#13	0	174	ENST00000704357.1	4657	4831	+	174	0	-116	6125
P11137-1#13	0	58	58	P11137-1	1402	1460	+	58	P11137-1	0	1827	ENST00000682079.1	451	5932	++	266	P11137-1#13	0	174	ENST00000682079.1	4657	4831	+	174	0	-116	6126
P11137-1#13	0	58	58	P11137-1	1402	1460	+	58	P11137-1	106	1827	ENST00000673860.1	1122	6288	++	229	P11137-1#13	0	174	ENST00000673860.1	5013	5187	+	174	0	-116	6127
P11137-1#13	0	58	58	P11137-1	1402	1460	+	58	P11137-1	0	1827	ENST00000447185.5	0	5469	++	97	P11137-1#13	0	174	ENST00000447185.5	4194	4368	+	174	0	-116	6128
P11137-1#13	0	58	58	P11137-1	1402	1460	+	58	P11137-1	0	1827	ENST00000360351.8	506	5987	++	39	P11137-1#13	0	174	ENST00000360351.8	4712	4886	+	174	0	-116	6129
P11137-1#14	0	21	21	P11137-1	1446	1467	+	21	P11137-1	0	1827	ENST00000704357.1	451	6025	++	271	P11137-1#14	0	63	ENST00000704357.1	4789	4852	+	63	0	-42	6130
P11137-1#14	0	21	21	P11137-1	1446	1467	+	21	P11137-1	0	1827	ENST00000682079.1	451	5932	++	266	P11137-1#14	0	63	ENST00000682079.1	4789	4852	+	63	0	-42	6131
P11137-1#14	0	21	21	P11137-1	1446	1467	+	21	P11137-1	106	1827	ENST00000673860.1	1122	6288	++	229	P11137-1#14	0	63	ENST00000673860.1	5145	5208	+	63	0	-42	6132
P11137-1#14	0	21	21	P11137-1	1446	1467	+	21	P11137-1	0	1827	ENST00000447185.5	0	5469	++	97	P11137-1#14	0	63	ENST00000447185.5	4326	4389	+	63	0	-42	6133
P11137-1#14	0	21	21	P11137-1	1446	1467	+	21	P11137-1	0	1827	ENST00000360351.8	506	5987	++	39	P11137-1#14	0	63	ENST00000360351.8	4844	4907	+	63	0	-42	6134
P11137-1#15	0	20	20	P11137-1	1470	1490	+	20	P11137-1	0	1827	ENST00000704357.1	451	6025	++	271	P11137-1#15	0	60	ENST00000704357.1	4861	4921	+	60	0	-40	6135
P11137-1#15	0	20	20	P11137-1	1470	1490	+	20	P11137-1	0	1827	ENST00000682079.1	451	5932	++	266	P11137-1#15	0	60	ENST00000682079.1	4861	4921	+	60	0	-40	6136
P11137-1#15	0	20	20	P11137-1	1470	1490	+	20	P11137-1	106	1827	ENST00000673860.1	1122	6288	++	229	P11137-1#15	0	60	ENST00000673860.1	5217	5277	+	60	0	-40	6137
P11137-1#15	0	20	20	P11137-1	1470	1490	+	20	P11137-1	0	1827	ENST00000447185.5	0	5469	++	97	P11137-1#15	0	60	ENST00000447185.5	4398	4458	+	60	0	-40	6138
P11137-1#15	0	20	20	P11137-1	1470	1490	+	20	P11137-1	0	1827	ENST00000360351.8	506	5987	++	39	P11137-1#15	0	60	ENST00000360351.8	4916	4976	+	60	0	-40	6139
P11137-1#16	0	133	133	P11137-1	1505	1638	+	133	P11137-1	0	1827	ENST00000704357.1	451	6025	++	271	P11137-1#16	0	399	ENST00000704357.1	4966	5365	+	399	0	-266	6140
P11137-1#16	0	133	133	P11137-1	1505	1638	+	133	P11137-1	0	1827	ENST00000682079.1	451	5932	++	266	P11137-1#16	0	399	ENST00000682079.1	4966	5365	+	399	0	-266	6141
P11137-1#16	0	133	133	P11137-1	1505	1638	+	133	P11137-1	106	1827	ENST00000673860.1	1122	6288	++	229	P11137-1#16	0	399	ENST00000673860.1	5322	5721	+	399	0	-266	6142
P11137-1#16	0	133	133	P11137-1	1505	1638	+	133	P11137-1	0	1827	ENST00000447185.5	0	5469	++	97	P11137-1#16	0	399	ENST00000447185.5	4503	4902	+	399	0	-266	6143
P11137-1#16	0	133	133	P11137-1	1505	1638	+	133	P11137-1	1507	1827	ENST00000392194.5	619	1579	++	60	P11137-1#16	6	399	ENST00000392194.5	619	1012	+	393	6	-266	6144
P11137-1#16	0	133	133	P11137-1	1505	1638	+	133	P11137-1	1507	1827	ENST00000361559.8	949	1909	++	41	P11137-1#16	6	399	ENST00000361559.8	949	1342	+	393	6	-266	6145
P11137-1#16	0	133	133	P11137-1	1505	1638	+	133	P11137-1	0	1827	ENST00000360351.8	506	5987	++	39	P11137-1#16	0	399	ENST00000360351.8	5021	5420	+	399	0	-266	6146
P11137-1#17	0	23	23	P11137-1	1778	1801	+	23	P11137-1	0	1827	ENST00000704357.1	451	6025	++	271	P11137-1#17	0	69	ENST00000704357.1	5878	5947	+	69	0	-46	6147
P11137-1#17	0	23	23	P11137-1	1778	1801	+	23	P11137-1	0	1827	ENST00000682079.1	451	5932	++	266	P11137-1#17	0	69	ENST00000682079.1	5785	5854	+	69	0	-46	6148
P11137-1#17	0	23	23	P11137-1	1778	1801	+	23	P11137-1	106	1827	ENST00000673860.1	1122	6288	++	229	P11137-1#17	0	69	ENST00000673860.1	6141	6210	+	69	0	-46	6149
P11137-1#17	0	23	23	P11137-1	1778	1801	+	23	P11137-1	0	1827	ENST00000447185.5	0	5469	++	97	P11137-1#17	0	69	ENST00000447185.5	5322	5391	+	69	0	-46	6150
P11137-1#17	0	23	23	P11137-1	1778	1801	+	23	P11137-1	1507	1827	ENST00000392194.5	619	1579	++	60	P11137-1#17	0	69	ENST00000392194.5	1432	1501	+	69	0	-46	6151
P11137-1#17	0	23	23	P11137-1	1778	1801	+	23	P11137-1	1507	1827	ENST00000361559.8	949	1909	++	41	P11137-1#17	0	69	ENST00000361559.8	1762	1831	+	69	0	-46	6152
P11137-1#17	0	23	23	P11137-1	1778	1801	+	23	P11137-1	0	1827	ENST00000360351.8	506	5987	++	39	P11137-1#17	0	69	ENST00000360351.8	5840	5909	+	69	0	-46	6153
P11137-1#18	0	19	19	P11137-1	61	80	+	19	P11137-1	0	1827	ENST00000704357.1	451	6025	++	271	P11137-1#18	0	57	ENST00000704357.1	634	691	+	57	0	-38	6154
P11137-1#18	0	19	19	P11137-1	61	80	+	19	P11137-1	0	1827	ENST00000682079.1	451	5932	++	266	P11137-1#18	0	57	ENST00000682079.1	634	691	+	57	0	-38	6155
P11137-1#18	0	19	19	P11137-1	61	80	+	19	P11137-1	0	1827	ENST00000447185.5	0	5469	++	97	P11137-1#18	0	57	ENST00000447185.5	183	240	+	57	0	-38	6156
P11137-1#18	0	19	19	P11137-1	61	80	+	19	P11137-1	0	106	ENST00000392193.5	295	613	++	59	P11137-1#18	0	57	ENST00000392193.5	478	535	+	57	0	-38	6157
P11137-1#18	0	19	19	P11137-1	61	80	+	19	P11137-1	0	1827	ENST00000360351.8	506	5987	++	39	P11137-1#18	0	57	ENST00000360351.8	689	746	+	57	0	-38	6158
P11137-1#19	0	19	19	P11137-1	172	191	+	19	P11137-1	0	1827	ENST00000704357.1	451	6025	++	271	P11137-1#19	0	57	ENST00000704357.1	967	1024	+	57	0	-38	6159
P11137-1#19	0	19	19	P11137-1	172	191	+	19	P11137-1	0	1827	ENST00000682079.1	451	5932	++	266	P11137-1#19	0	57	ENST00000682079.1	967	1024	+	57	0	-38	6160
P11137-1#19	0	19	19	P11137-1	172	191	+	19	P11137-1	106	1827	ENST00000673860.1	1122	6288	++	229	P11137-1#19	0	57	ENST00000673860.1	1323	1380	+	57	0	-38	6161
P11137-1#19	0	19	19	P11137-1	172	191	+	19	P11137-1	0	1827	ENST00000447185.5	0	5469	++	97	P11137-1#19	0	57	ENST00000447185.5	504	561	+	57	0	-38	6162
P11137-1#19	0	19	19	P11137-1	172	191	+	19	P11137-1	106	485	ENST00000445941.5	879	2019	++	96	P11137-1#19	0	57	ENST00000445941.5	1080	1137	+	57	0	-38	6163
P11137-1#19	0	19	19	P11137-1	172	191	+	19	P11137-1	0	1827	ENST00000360351.8	506	5987	++	39	P11137-1#19	0	57	ENST00000360351.8	1022	1079	+	57	0	-38	6164
P11137-1#20	0	16	16	P11137-1	364	380	+	16	P11137-1	0	1827	ENST00000704357.1	451	6025	++	271	P11137-1#20	0	48	ENST00000704357.1	1543	1591	+	48	0	-32	6165
P11137-1#20	0	16	16	P11137-1	364	380	+	16	P11137-1	0	1827	ENST00000682079.1	451	5932	++	266	P11137-1#20	0	48	ENST00000682079.1	1543	1591	+	48	0	-32	6166
P11137-1#20	0	16	16	P11137-1	364	380	+	16	P11137-1	106	1827	ENST00000673860.1	1122	6288	++	229	P11137-1#20	0	48	ENST00000673860.1	1899	1947	+	48	0	-32	6167
P11137-1#20	0	16	16	P11137-1	364	380	+	16	P11137-1	0	1827	ENST00000447185.5	0	5469	++	97	P11137-1#20	0	48	ENST00000447185.5	1080	1128	+	48	0	-32	6168
P11137-1#20	0	16	16	P11137-1	364	380	+	16	P11137-1	106	485	ENST00000445941.5	879	2019	++	96	P11137-1#20	0	48	ENST00000445941.5	1656	1704	+	48	0	-32	6169
P11137-1#20	0	16	16	P11137-1	364	380	+	16	P11137-1	0	1827	ENST00000360351.8	506	5987	++	39	P11137-1#20	0	48	ENST00000360351.8	1598	1646	+	48	0	-32	6170
P11137-1#21	0	24	24	P11137-1	394	418	+	24	P11137-1	0	1827	ENST00000704357.1	451	6025	++	271	P11137-1#21	0	72	ENST00000704357.1	1633	1705	+	72	0	-48	6171
P11137-1#21	0	24	24	P11137-1	394	418	+	24	P11137-1	0	1827	ENST00000682079.1	451	5932	++	266	P11137-1#21	0	72	ENST00000682079.1	1633	1705	+	72	0	-48	6172
P11137-1#21	0	24	24	P11137-1	394	418	+	24	P11137-1	106	1827	ENST00000673860.1	1122	6288	++	229	P11137-1#21	0	72	ENST00000673860.1	1989	2061	+	72	0	-48	6173
P11137-1#21	0	24	24	P11137-1	394	418	+	24	P11137-1	0	1827	ENST00000447185.5	0	5469	++	97	P11137-1#21	0	72	ENST00000447185.5	1170	1242	+	72	0	-48	6174
P11137-1#21	0	24	24	P11137-1	394	418	+	24	P11137-1	106	485	ENST00000445941.5	879	2019	++	96	P11137-1#21	0	72	ENST00000445941.5	1746	1818	+	72	0	-48	6175
P11137-1#21	0	24	24	P11137-1	394	418	+	24	P11137-1	0	1827	ENST00000360351.8	506	5987	++	39	P11137-1#21	0	72	ENST00000360351.8	1688	1760	+	72	0	-48	6176
P11137-1#22	0	16	16	P11137-1	418	434	+	16	P11137-1	0	1827	ENST00000704357.1	451	6025	++	271	P11137-1#22	0	48	ENST00000704357.1	1705	1753	+	48	0	-32	6177
P11137-1#22	0	16	16	P11137-1	418	434	+	16	P11137-1	0	1827	ENST00000682079.1	451	5932	++	266	P11137-1#22	0	48	ENST00000682079.1	1705	1753	+	48	0	-32	6178
P11137-1#22	0	16	16	P11137-1	418	434	+	16	P11137-1	106	1827	ENST00000673860.1	1122	6288	++	229	P11137-1#22	0	48	ENST00000673860.1	2061	2109	+	48	0	-32	6179
P11137-1#22	0	16	16	P11137-1	418	434	+	16	P11137-1	0	1827	ENST00000447185.5	0	5469	++	97	P11137-1#22	0	48	ENST00000447185.5	1242	1290	+	48	0	-32	6180
P11137-1#22	0	16	16	P11137-1	418	434	+	16	P11137-1	106	485	ENST00000445941.5	879	2019	++	96	P11137-1#22	0	48	ENST00000445941.5	1818	1866	+	48	0	-32	6181
P11137-1#22	0	16	16	P11137-1	418	434	+	16	P11137-1	0	1827	ENST00000360351.8	506	5987	++	39	P11137-1#22	0	48	ENST00000360351.8	1760	1808	+	48	0	-32	6182
P11137-1#23	0	31	31	P11137-1	435	466	+	31	P11137-1	0	1827	ENST00000704357.1	451	6025	++	271	P11137-1#23	0	93	ENST00000704357.1	1756	1849	+	93	0	-62	6183
P11137-1#23	0	31	31	P11137-1	435	466	+	31	P11137-1	0	1827	ENST00000682079.1	451	5932	++	266	P11137-1#23	0	93	ENST00000682079.1	1756	1849	+	93	0	-62	6184
P11137-1#23	0	31	31	P11137-1	435	466	+	31	P11137-1	106	1827	ENST00000673860.1	1122	6288	++	229	P11137-1#23	0	93	ENST00000673860.1	2112	2205	+	93	0	-62	6185
P11137-1#23	0	31	31	P11137-1	435	466	+	31	P11137-1	0	1827	ENST00000447185.5	0	5469	++	97	P11137-1#23	0	93	ENST00000447185.5	1293	1386	+	93	0	-62	6186
P11137-1#23	0	31	31	P11137-1	435	466	+	31	P11137-1	106	485	ENST00000445941.5	879	2019	++	96	P11137-1#23	0	93	ENST00000445941.5	1869	1962	+	93	0	-62	6187
P11137-1#23	0	31	31	P11137-1	435	466	+	31	P11137-1	0	1827	ENST00000360351.8	506	5987	++	39	P11137-1#23	0	93	ENST00000360351.8	1811	1904	+	93	0	-62	6188
P11137-1#24	0	43	43	P11137-1	578	621	+	43	P11137-1	0	1827	ENST00000704357.1	451	6025	++	271	P11137-1#24	0	129	ENST00000704357.1	2185	2314	+	129	0	-86	6189
P11137-1#24	0	43	43	P11137-1	578	621	+	43	P11137-1	0	1827	ENST00000682079.1	451	5932	++	266	P11137-1#24	0	129	ENST00000682079.1	2185	2314	+	129	0	-86	6190
P11137-1#24	0	43	43	P11137-1	578	621	+	43	P11137-1	106	1827	ENST00000673860.1	1122	6288	++	229	P11137-1#24	0	129	ENST00000673860.1	2541	2670	+	129	0	-86	6191
P11137-1#24	0	43	43	P11137-1	578	621	+	43	P11137-1	0	1827	ENST00000447185.5	0	5469	++	97	P11137-1#24	0	129	ENST00000447185.5	1722	1851	+	129	0	-86	6192
P11137-1#24	0	43	43	P11137-1	578	621	+	43	P11137-1	0	1827	ENST00000360351.8	506	5987	++	39	P11137-1#24	0	129	ENST00000360351.8	2240	2369	+	129	0	-86	6193
P11137-1#25	0	29	29	P11137-1	621	650	+	29	P11137-1	0	1827	ENST00000704357.1	451	6025	++	271	P11137-1#25	0	87	ENST00000704357.1	2314	2401	+	87	0	-58	6194
P11137-1#25	0	29	29	P11137-1	621	650	+	29	P11137-1	0	1827	ENST00000682079.1	451	5932	++	266	P11137-1#25	0	87	ENST00000682079.1	2314	2401	+	87	0	-58	6195
P11137-1#25	0	29	29	P11137-1	621	650	+	29	P11137-1	106	1827	ENST00000673860.1	1122	6288	++	229	P11137-1#25	0	87	ENST00000673860.1	2670	2757	+	87	0	-58	6196
P11137-1#25	0	29	29	P11137-1	621	650	+	29	P11137-1	0	1827	ENST00000447185.5	0	5469	++	97	P11137-1#25	0	87	ENST00000447185.5	1851	1938	+	87	0	-58	6197
P11137-1#25	0	29	29	P11137-1	621	650	+	29	P11137-1	0	1827	ENST00000360351.8	506	5987	++	39	P11137-1#25	0	87	ENST00000360351.8	2369	2456	+	87	0	-58	6198
P11137-1#26	0	56	56	P11137-1	930	986	+	56	P11137-1	0	1827	ENST00000704357.1	451	6025	++	271	P11137-1#26	0	168	ENST00000704357.1	3241	3409	+	168	0	-112	6199
P11137-1#26	0	56	56	P11137-1	930	986	+	56	P11137-1	0	1827	ENST00000682079.1	451	5932	++	266	P11137-1#26	0	168	ENST00000682079.1	3241	3409	+	168	0	-112	6200
P11137-1#26	0	56	56	P11137-1	930	986	+	56	P11137-1	106	1827	ENST00000673860.1	1122	6288	++	229	P11137-1#26	0	168	ENST00000673860.1	3597	3765	+	168	0	-112	6201
P11137-1#26	0	56	56	P11137-1	930	986	+	56	P11137-1	0	1827	ENST00000447185.5	0	5469	++	97	P11137-1#26	0	168	ENST00000447185.5	2778	2946	+	168	0	-112	6202
P11137-1#26	0	56	56	P11137-1	930	986	+	56	P11137-1	0	1827	ENST00000360351.8	506	5987	++	39	P11137-1#26	0	168	ENST00000360351.8	3296	3464	+	168	0	-112	6203
P11137-1#27	0	59	59	P11137-1	1099	1158	+	59	P11137-1	0	1827	ENST00000704357.1	451	6025	++	271	P11137-1#27	0	177	ENST00000704357.1	3748	3925	+	177	0	-118	6204
P11137-1#27	0	59	59	P11137-1	1099	1158	+	59	P11137-1	0	1827	ENST00000682079.1	451	5932	++	266	P11137-1#27	0	177	ENST00000682079.1	3748	3925	+	177	0	-118	6205
P11137-1#27	0	59	59	P11137-1	1099	1158	+	59	P11137-1	106	1827	ENST00000673860.1	1122	6288	++	229	P11137-1#27	0	177	ENST00000673860.1	4104	4281	+	177	0	-118	6206
P11137-1#27	0	59	59	P11137-1	1099	1158	+	59	P11137-1	0	1827	ENST00000447185.5	0	5469	++	97	P11137-1#27	0	177	ENST00000447185.5	3285	3462	+	177	0	-118	6207
P11137-1#27	0	59	59	P11137-1	1099	1158	+	59	P11137-1	0	1827	ENST00000360351.8	506	5987	++	39	P11137-1#27	0	177	ENST00000360351.8	3803	3980	+	177	0	-118	6208
P11137-1#28	0	16	16	P11137-1	1313	1329	+	16	P11137-1	0	1827	ENST00000704357.1	451	6025	++	271	P11137-1#28	0	48	ENST00000704357.1	4390	4438	+	48	0	-32	6209
P11137-1#28	0	16	16	P11137-1	1313	1329	+	16	P11137-1	0	1827	ENST00000682079.1	451	5932	++	266	P11137-1#28	0	48	ENST00000682079.1	4390	4438	+	48	0	-32	6210
P11137-1#28	0	16	16	P11137-1	1313	1329	+	16	P11137-1	106	1827	ENST00000673860.1	1122	6288	++	229	P11137-1#28	0	48	ENST00000673860.1	4746	4794	+	48	0	-32	6211
P11137-1#28	0	16	16	P11137-1	1313	1329	+	16	P11137-1	0	1827	ENST00000447185.5	0	5469	++	97	P11137-1#28	0	48	ENST00000447185.5	3927	3975	+	48	0	-32	6212
P11137-1#28	0	16	16	P11137-1	1313	1329	+	16	P11137-1	0	1827	ENST00000360351.8	506	5987	++	39	P11137-1#28	0	48	ENST00000360351.8	4445	4493	+	48	0	-32	6213
P11137-1#29	0	30	30	P11137-1	1348	1378	+	30	P11137-1	0	1827	ENST00000704357.1	451	6025	++	271	P11137-1#29	0	90	ENST00000704357.1	4495	4585	+	90	0	-60	6214
P11137-1#29	0	30	30	P11137-1	1348	1378	+	30	P11137-1	0	1827	ENST00000682079.1	451	5932	++	266	P11137-1#29	0	90	ENST00000682079.1	4495	4585	+	90	0	-60	6215
P11137-1#29	0	30	30	P11137-1	1348	1378	+	30	P11137-1	106	1827	ENST00000673860.1	1122	6288	++	229	P11137-1#29	0	90	ENST00000673860.1	4851	4941	+	90	0	-60	6216
P11137-1#29	0	30	30	P11137-1	1348	1378	+	30	P11137-1	0	1827	ENST00000447185.5	0	5469	++	97	P11137-1#29	0	90	ENST00000447185.5	4032	4122	+	90	0	-60	6217
P11137-1#29	0	30	30	P11137-1	1348	1378	+	30	P11137-1	0	1827	ENST00000360351.8	506	5987	++	39	P11137-1#29	0	90	ENST00000360351.8	4550	4640	+	90	0	-60	6218
P11137-1#30	0	18	18	P11137-1	1558	1576	+	18	P11137-1	0	1827	ENST00000704357.1	451	6025	++	271	P11137-1#30	0	54	ENST00000704357.1	5125	5179	+	54	0	-36	6219
P11137-1#30	0	18	18	P11137-1	1558	1576	+	18	P11137-1	0	1827	ENST00000682079.1	451	5932	++	266	P11137-1#30	0	54	ENST00000682079.1	5125	5179	+	54	0	-36	6220
P11137-1#30	0	18	18	P11137-1	1558	1576	+	18	P11137-1	106	1827	ENST00000673860.1	1122	6288	++	229	P11137-1#30	0	54	ENST00000673860.1	5481	5535	+	54	0	-36	6221
P11137-1#30	0	18	18	P11137-1	1558	1576	+	18	P11137-1	0	1827	ENST00000447185.5	0	5469	++	97	P11137-1#30	0	54	ENST00000447185.5	4662	4716	+	54	0	-36	6222
P11137-1#30	0	18	18	P11137-1	1558	1576	+	18	P11137-1	1507	1827	ENST00000392194.5	619	1579	++	60	P11137-1#30	0	54	ENST00000392194.5	772	826	+	54	0	-36	6223
P11137-1#30	0	18	18	P11137-1	1558	1576	+	18	P11137-1	1507	1827	ENST00000361559.8	949	1909	++	41	P11137-1#30	0	54	ENST00000361559.8	1102	1156	+	54	0	-36	6224
P11137-1#30	0	18	18	P11137-1	1558	1576	+	18	P11137-1	0	1827	ENST00000360351.8	506	5987	++	39	P11137-1#30	0	54	ENST00000360351.8	5180	5234	+	54	0	-36	6225
P11137-1#31	0	36	36	P11137-1	1582	1618	+	36	P11137-1	0	1827	ENST00000704357.1	451	6025	++	271	P11137-1#31	0	108	ENST00000704357.1	5197	5305	+	108	0	-72	6226
P11137-1#31	0	36	36	P11137-1	1582	1618	+	36	P11137-1	0	1827	ENST00000682079.1	451	5932	++	266	P11137-1#31	0	108	ENST00000682079.1	5197	5305	+	108	0	-72	6227
P11137-1#31	0	36	36	P11137-1	1582	1618	+	36	P11137-1	106	1827	ENST00000673860.1	1122	6288	++	229	P11137-1#31	0	108	ENST00000673860.1	5553	5661	+	108	0	-72	6228
P11137-1#31	0	36	36	P11137-1	1582	1618	+	36	P11137-1	0	1827	ENST00000447185.5	0	5469	++	97	P11137-1#31	0	108	ENST00000447185.5	4734	4842	+	108	0	-72	6229
P11137-1#31	0	36	36	P11137-1	1582	1618	+	36	P11137-1	1507	1827	ENST00000392194.5	619	1579	++	60	P11137-1#31	0	108	ENST00000392194.5	844	952	+	108	0	-72	6230
P11137-1#31	0	36	36	P11137-1	1582	1618	+	36	P11137-1	1507	1827	ENST00000361559.8	949	1909	++	41	P11137-1#31	0	108	ENST00000361559.8	1174	1282	+	108	0	-72	6231
P11137-1#31	0	36	36	P11137-1	1582	1618	+	36	P11137-1	0	1827	ENST00000360351.8	506	5987	++	39	P11137-1#31	0	108	ENST00000360351.8	5252	5360	+	108	0	-72	6232
P11137-1#32	0	22	22	P11137-1	1779	1801	+	22	P11137-1	0	1827	ENST00000704357.1	451	6025	++	271	P11137-1#32	0	66	ENST00000704357.1	5881	5947	+	66	0	-44	6233
P11137-1#32	0	22	22	P11137-1	1779	1801	+	22	P11137-1	0	1827	ENST00000682079.1	451	5932	++	266	P11137-1#32	0	66	ENST00000682079.1	5788	5854	+	66	0	-44	6234
P11137-1#32	0	22	22	P11137-1	1779	1801	+	22	P11137-1	106	1827	ENST00000673860.1	1122	6288	++	229	P11137-1#32	0	66	ENST00000673860.1	6144	6210	+	66	0	-44	6235
P11137-1#32	0	22	22	P11137-1	1779	1801	+	22	P11137-1	0	1827	ENST00000447185.5	0	5469	++	97	P11137-1#32	0	66	ENST00000447185.5	5325	5391	+	66	0	-44	6236
P11137-1#32	0	22	22	P11137-1	1779	1801	+	22	P11137-1	1507	1827	ENST00000392194.5	619	1579	++	60	P11137-1#32	0	66	ENST00000392194.5	1435	1501	+	66	0	-44	6237
P11137-1#32	0	22	22	P11137-1	1779	1801	+	22	P11137-1	1507	1827	ENST00000361559.8	949	1909	++	41	P11137-1#32	0	66	ENST00000361559.8	1765	1831	+	66	0	-44	6238
P11137-1#32	0	22	22	P11137-1	1779	1801	+	22	P11137-1	0	1827	ENST00000360351.8	506	5987	++	39	P11137-1#32	0	66	ENST00000360351.8	5843	5909	+	66	0	-44	6239
P11137-1#33	0	1	1	P11137-1	135	136	+	1	P11137-1	0	1827	ENST00000704357.1	451	6025	++	271	P11137-1#33	0	3	ENST00000704357.1	856	859	+	3	0	-2	6240
P11137-1#33	0	1	1	P11137-1	135	136	+	1	P11137-1	0	1827	ENST00000682079.1	451	5932	++	266	P11137-1#33	0	3	ENST00000682079.1	856	859	+	3	0	-2	6241
P11137-1#33	0	1	1	P11137-1	135	136	+	1	P11137-1	106	1827	ENST00000673860.1	1122	6288	++	229	P11137-1#33	0	3	ENST00000673860.1	1212	1215	+	3	0	-2	6242
P11137-1#33	0	1	1	P11137-1	135	136	+	1	P11137-1	0	1827	ENST00000447185.5	0	5469	++	97	P11137-1#33	0	3	ENST00000447185.5	405	408	+	3	0	-2	6243
P11137-1#33	0	1	1	P11137-1	135	136	+	1	P11137-1	106	485	ENST00000445941.5	879	2019	++	96	P11137-1#33	0	3	ENST00000445941.5	969	972	+	3	0	-2	6244
P11137-1#33	0	1	1	P11137-1	135	136	+	1	P11137-1	0	1827	ENST00000360351.8	506	5987	++	39	P11137-1#33	0	3	ENST00000360351.8	911	914	+	3	0	-2	6245
P11137-1#34	0	1	1	P11137-1	139	140	+	1	P11137-1	0	1827	ENST00000704357.1	451	6025	++	271	P11137-1#34	0	3	ENST00000704357.1	868	871	+	3	0	-2	6246
P11137-1#34	0	1	1	P11137-1	139	140	+	1	P11137-1	0	1827	ENST00000682079.1	451	5932	++	266	P11137-1#34	0	3	ENST00000682079.1	868	871	+	3	0	-2	6247
P11137-1#34	0	1	1	P11137-1	139	140	+	1	P11137-1	106	1827	ENST00000673860.1	1122	6288	++	229	P11137-1#34	0	3	ENST00000673860.1	1224	1227	+	3	0	-2	6248
P11137-1#34	0	1	1	P11137-1	139	140	+	1	P11137-1	0	1827	ENST00000447185.5	0	5469	++	97	P11137-1#34	0	3	ENST00000447185.5	417	420	+	3	0	-2	6249
P11137-1#34	0	1	1	P11137-1	139	140	+	1	P11137-1	106	485	ENST00000445941.5	879	2019	++	96	P11137-1#34	0	3	ENST00000445941.5	981	984	+	3	0	-2	6250
P11137-1#34	0	1	1	P11137-1	139	140	+	1	P11137-1	0	1827	ENST00000360351.8	506	5987	++	39	P11137-1#34	0	3	ENST00000360351.8	923	926	+	3	0	-2	6251
P11137-1#35	0	1	1	P11137-1	142	143	+	1	P11137-1	0	1827	ENST00000704357.1	451	6025	++	271	P11137-1#35	0	3	ENST00000704357.1	877	880	+	3	0	-2	6252
P11137-1#35	0	1	1	P11137-1	142	143	+	1	P11137-1	0	1827	ENST00000682079.1	451	5932	++	266	P11137-1#35	0	3	ENST00000682079.1	877	880	+	3	0	-2	6253
P11137-1#35	0	1	1	P11137-1	142	143	+	1	P11137-1	106	1827	ENST00000673860.1	1122	6288	++	229	P11137-1#35	0	3	ENST00000673860.1	1233	1236	+	3	0	-2	6254
P11137-1#35	0	1	1	P11137-1	142	143	+	1	P11137-1	0	1827	ENST00000447185.5	0	5469	++	97	P11137-1#35	0	3	ENST00000447185.5	426	429	+	3	0	-2	6255
P11137-1#35	0	1	1	P11137-1	142	143	+	1	P11137-1	106	485	ENST00000445941.5	879	2019	++	96	P11137-1#35	0	3	ENST00000445941.5	990	993	+	3	0	-2	6256
P11137-1#35	0	1	1	P11137-1	142	143	+	1	P11137-1	0	1827	ENST00000360351.8	506	5987	++	39	P11137-1#35	0	3	ENST00000360351.8	932	935	+	3	0	-2	6257
P11137-1#36	0	1	1	P11137-1	284	285	+	1	P11137-1	0	1827	ENST00000704357.1	451	6025	++	271	P11137-1#36	0	3	ENST00000704357.1	1303	1306	+	3	0	-2	6258
P11137-1#36	0	1	1	P11137-1	284	285	+	1	P11137-1	0	1827	ENST00000682079.1	451	5932	++	266	P11137-1#36	0	3	ENST00000682079.1	1303	1306	+	3	0	-2	6259
P11137-1#36	0	1	1	P11137-1	284	285	+	1	P11137-1	106	1827	ENST00000673860.1	1122	6288	++	229	P11137-1#36	0	3	ENST00000673860.1	1659	1662	+	3	0	-2	6260
P11137-1#36	0	1	1	P11137-1	284	285	+	1	P11137-1	0	1827	ENST00000447185.5	0	5469	++	97	P11137-1#36	0	3	ENST00000447185.5	840	843	+	3	0	-2	6261
P11137-1#36	0	1	1	P11137-1	284	285	+	1	P11137-1	106	485	ENST00000445941.5	879	2019	++	96	P11137-1#36	0	3	ENST00000445941.5	1416	1419	+	3	0	-2	6262
P11137-1#36	0	1	1	P11137-1	284	285	+	1	P11137-1	0	1827	ENST00000360351.8	506	5987	++	39	P11137-1#36	0	3	ENST00000360351.8	1358	1361	+	3	0	-2	6263
P11137-1#37	0	1	1	P11137-1	497	498	+	1	P11137-1	0	1827	ENST00000704357.1	451	6025	++	271	P11137-1#37	0	3	ENST00000704357.1	1942	1945	+	3	0	-2	6264
P11137-1#37	0	1	1	P11137-1	497	498	+	1	P11137-1	0	1827	ENST00000682079.1	451	5932	++	266	P11137-1#37	0	3	ENST00000682079.1	1942	1945	+	3	0	-2	6265
P11137-1#37	0	1	1	P11137-1	497	498	+	1	P11137-1	106	1827	ENST00000673860.1	1122	6288	++	229	P11137-1#37	0	3	ENST00000673860.1	2298	2301	+	3	0	-2	6266
P11137-1#37	0	1	1	P11137-1	497	498	+	1	P11137-1	0	1827	ENST00000447185.5	0	5469	++	97	P11137-1#37	0	3	ENST00000447185.5	1479	1482	+	3	0	-2	6267
P11137-1#37	0	1	1	P11137-1	497	498	+	1	P11137-1	0	1827	ENST00000360351.8	506	5987	++	39	P11137-1#37	0	3	ENST00000360351.8	1997	2000	+	3	0	-2	6268
P11137-1#38	0	1	1	P11137-1	600	601	+	1	P11137-1	0	1827	ENST00000704357.1	451	6025	++	271	P11137-1#38	0	3	ENST00000704357.1	2251	2254	+	3	0	-2	6269
P11137-1#38	0	1	1	P11137-1	600	601	+	1	P11137-1	0	1827	ENST00000682079.1	451	5932	++	266	P11137-1#38	0	3	ENST00000682079.1	2251	2254	+	3	0	-2	6270
P11137-1#38	0	1	1	P11137-1	600	601	+	1	P11137-1	106	1827	ENST00000673860.1	1122	6288	++	229	P11137-1#38	0	3	ENST00000673860.1	2607	2610	+	3	0	-2	6271
P11137-1#38	0	1	1	P11137-1	600	601	+	1	P11137-1	0	1827	ENST00000447185.5	0	5469	++	97	P11137-1#38	0	3	ENST00000447185.5	1788	1791	+	3	0	-2	6272
P11137-1#38	0	1	1	P11137-1	600	601	+	1	P11137-1	0	1827	ENST00000360351.8	506	5987	++	39	P11137-1#38	0	3	ENST00000360351.8	2306	2309	+	3	0	-2	6273
P11137-1#39	0	1	1	P11137-1	604	605	+	1	P11137-1	0	1827	ENST00000704357.1	451	6025	++	271	P11137-1#39	0	3	ENST00000704357.1	2263	2266	+	3	0	-2	6274
P11137-1#39	0	1	1	P11137-1	604	605	+	1	P11137-1	0	1827	ENST00000682079.1	451	5932	++	266	P11137-1#39	0	3	ENST00000682079.1	2263	2266	+	3	0	-2	6275
P11137-1#39	0	1	1	P11137-1	604	605	+	1	P11137-1	106	1827	ENST00000673860.1	1122	6288	++	229	P11137-1#39	0	3	ENST00000673860.1	2619	2622	+	3	0	-2	6276
P11137-1#39	0	1	1	P11137-1	604	605	+	1	P11137-1	0	1827	ENST00000447185.5	0	5469	++	97	P11137-1#39	0	3	ENST00000447185.5	1800	1803	+	3	0	-2	6277
P11137-1#39	0	1	1	P11137-1	604	605	+	1	P11137-1	0	1827	ENST00000360351.8	506	5987	++	39	P11137-1#39	0	3	ENST00000360351.8	2318	2321	+	3	0	-2	6278
P11137-1#40	0	1	1	P11137-1	609	610	+	1	P11137-1	0	1827	ENST00000704357.1	451	6025	++	271	P11137-1#40	0	3	ENST00000704357.1	2278	2281	+	3	0	-2	6279
P11137-1#40	0	1	1	P11137-1	609	610	+	1	P11137-1	0	1827	ENST00000682079.1	451	5932	++	266	P11137-1#40	0	3	ENST00000682079.1	2278	2281	+	3	0	-2	6280
P11137-1#40	0	1	1	P11137-1	609	610	+	1	P11137-1	106	1827	ENST00000673860.1	1122	6288	++	229	P11137-1#40	0	3	ENST00000673860.1	2634	2637	+	3	0	-2	6281
P11137-1#40	0	1	1	P11137-1	609	610	+	1	P11137-1	0	1827	ENST00000447185.5	0	5469	++	97	P11137-1#40	0	3	ENST00000447185.5	1815	1818	+	3	0	-2	6282
P11137-1#40	0	1	1	P11137-1	609	610	+	1	P11137-1	0	1827	ENST00000360351.8	506	5987	++	39	P11137-1#40	0	3	ENST00000360351.8	2333	2336	+	3	0	-2	6283
P11137-1#41	0	1	1	P11137-1	628	629	+	1	P11137-1	0	1827	ENST00000704357.1	451	6025	++	271	P11137-1#41	0	3	ENST00000704357.1	2335	2338	+	3	0	-2	6284
P11137-1#41	0	1	1	P11137-1	628	629	+	1	P11137-1	0	1827	ENST00000682079.1	451	5932	++	266	P11137-1#41	0	3	ENST00000682079.1	2335	2338	+	3	0	-2	6285
P11137-1#41	0	1	1	P11137-1	628	629	+	1	P11137-1	106	1827	ENST00000673860.1	1122	6288	++	229	P11137-1#41	0	3	ENST00000673860.1	2691	2694	+	3	0	-2	6286
P11137-1#41	0	1	1	P11137-1	628	629	+	1	P11137-1	0	1827	ENST00000447185.5	0	5469	++	97	P11137-1#41	0	3	ENST00000447185.5	1872	1875	+	3	0	-2	6287
P11137-1#41	0	1	1	P11137-1	628	629	+	1	P11137-1	0	1827	ENST00000360351.8	506	5987	++	39	P11137-1#41	0	3	ENST00000360351.8	2390	2393	+	3	0	-2	6288
P11137-1#42	0	1	1	P11137-1	724	725	+	1	P11137-1	0	1827	ENST00000704357.1	451	6025	++	271	P11137-1#42	0	3	ENST00000704357.1	2623	2626	+	3	0	-2	6289
P11137-1#42	0	1	1	P11137-1	724	725	+	1	P11137-1	0	1827	ENST00000682079.1	451	5932	++	266	P11137-1#42	0	3	ENST00000682079.1	2623	2626	+	3	0	-2	6290
P11137-1#42	0	1	1	P11137-1	724	725	+	1	P11137-1	106	1827	ENST00000673860.1	1122	6288	++	229	P11137-1#42	0	3	ENST00000673860.1	2979	2982	+	3	0	-2	6291
P11137-1#42	0	1	1	P11137-1	724	725	+	1	P11137-1	0	1827	ENST00000447185.5	0	5469	++	97	P11137-1#42	0	3	ENST00000447185.5	2160	2163	+	3	0	-2	6292
P11137-1#42	0	1	1	P11137-1	724	725	+	1	P11137-1	0	1827	ENST00000360351.8	506	5987	++	39	P11137-1#42	0	3	ENST00000360351.8	2678	2681	+	3	0	-2	6293
P11137-1#43	0	1	1	P11137-1	728	729	+	1	P11137-1	0	1827	ENST00000704357.1	451	6025	++	271	P11137-1#43	0	3	ENST00000704357.1	2635	2638	+	3	0	-2	6294
P11137-1#43	0	1	1	P11137-1	728	729	+	1	P11137-1	0	1827	ENST00000682079.1	451	5932	++	266	P11137-1#43	0	3	ENST00000682079.1	2635	2638	+	3	0	-2	6295
P11137-1#43	0	1	1	P11137-1	728	729	+	1	P11137-1	106	1827	ENST00000673860.1	1122	6288	++	229	P11137-1#43	0	3	ENST00000673860.1	2991	2994	+	3	0	-2	6296
P11137-1#43	0	1	1	P11137-1	728	729	+	1	P11137-1	0	1827	ENST00000447185.5	0	5469	++	97	P11137-1#43	0	3	ENST00000447185.5	2172	2175	+	3	0	-2	6297
P11137-1#43	0	1	1	P11137-1	728	729	+	1	P11137-1	0	1827	ENST00000360351.8	506	5987	++	39	P11137-1#43	0	3	ENST00000360351.8	2690	2693	+	3	0	-2	6298
P11137-1#44	0	1	1	P11137-1	732	733	+	1	P11137-1	0	1827	ENST00000704357.1	451	6025	++	271	P11137-1#44	0	3	ENST00000704357.1	2647	2650	+	3	0	-2	6299
P11137-1#44	0	1	1	P11137-1	732	733	+	1	P11137-1	0	1827	ENST00000682079.1	451	5932	++	266	P11137-1#44	0	3	ENST00000682079.1	2647	2650	+	3	0	-2	6300
P11137-1#44	0	1	1	P11137-1	732	733	+	1	P11137-1	106	1827	ENST00000673860.1	1122	6288	++	229	P11137-1#44	0	3	ENST00000673860.1	3003	3006	+	3	0	-2	6301
P11137-1#44	0	1	1	P11137-1	732	733	+	1	P11137-1	0	1827	ENST00000447185.5	0	5469	++	97	P11137-1#44	0	3	ENST00000447185.5	2184	2187	+	3	0	-2	6302
P11137-1#44	0	1	1	P11137-1	732	733	+	1	P11137-1	0	1827	ENST00000360351.8	506	5987	++	39	P11137-1#44	0	3	ENST00000360351.8	2702	2705	+	3	0	-2	6303
P11137-1#45	0	1	1	P11137-1	735	736	+	1	P11137-1	0	1827	ENST00000704357.1	451	6025	++	271	P11137-1#45	0	3	ENST00000704357.1	2656	2659	+	3	0	-2	6304
P11137-1#45	0	1	1	P11137-1	735	736	+	1	P11137-1	0	1827	ENST00000682079.1	451	5932	++	266	P11137-1#45	0	3	ENST00000682079.1	2656	2659	+	3	0	-2	6305
P11137-1#45	0	1	1	P11137-1	735	736	+	1	P11137-1	106	1827	ENST00000673860.1	1122	6288	++	229	P11137-1#45	0	3	ENST00000673860.1	3012	3015	+	3	0	-2	6306
P11137-1#45	0	1	1	P11137-1	735	736	+	1	P11137-1	0	1827	ENST00000447185.5	0	5469	++	97	P11137-1#45	0	3	ENST00000447185.5	2193	2196	+	3	0	-2	6307
P11137-1#45	0	1	1	P11137-1	735	736	+	1	P11137-1	0	1827	ENST00000360351.8	506	5987	++	39	P11137-1#45	0	3	ENST00000360351.8	2711	2714	+	3	0	-2	6308
P11137-1#46	0	1	1	P11137-1	737	738	+	1	P11137-1	0	1827	ENST00000704357.1	451	6025	++	271	P11137-1#46	0	3	ENST00000704357.1	2662	2665	+	3	0	-2	6309
P11137-1#46	0	1	1	P11137-1	737	738	+	1	P11137-1	0	1827	ENST00000682079.1	451	5932	++	266	P11137-1#46	0	3	ENST00000682079.1	2662	2665	+	3	0	-2	6310
P11137-1#46	0	1	1	P11137-1	737	738	+	1	P11137-1	106	1827	ENST00000673860.1	1122	6288	++	229	P11137-1#46	0	3	ENST00000673860.1	3018	3021	+	3	0	-2	6311
P11137-1#46	0	1	1	P11137-1	737	738	+	1	P11137-1	0	1827	ENST00000447185.5	0	5469	++	97	P11137-1#46	0	3	ENST00000447185.5	2199	2202	+	3	0	-2	6312
P11137-1#46	0	1	1	P11137-1	737	738	+	1	P11137-1	0	1827	ENST00000360351.8	506	5987	++	39	P11137-1#46	0	3	ENST00000360351.8	2717	2720	+	3	0	-2	6313
P11137-1#47	0	1	1	P11137-1	744	745	+	1	P11137-1	0	1827	ENST00000704357.1	451	6025	++	271	P11137-1#47	0	3	ENST00000704357.1	2683	2686	+	3	0	-2	6314
P11137-1#47	0	1	1	P11137-1	744	745	+	1	P11137-1	0	1827	ENST00000682079.1	451	5932	++	266	P11137-1#47	0	3	ENST00000682079.1	2683	2686	+	3	0	-2	6315
P11137-1#47	0	1	1	P11137-1	744	745	+	1	P11137-1	106	1827	ENST00000673860.1	1122	6288	++	229	P11137-1#47	0	3	ENST00000673860.1	3039	3042	+	3	0	-2	6316
P11137-1#47	0	1	1	P11137-1	744	745	+	1	P11137-1	0	1827	ENST00000447185.5	0	5469	++	97	P11137-1#47	0	3	ENST00000447185.5	2220	2223	+	3	0	-2	6317
P11137-1#47	0	1	1	P11137-1	744	745	+	1	P11137-1	0	1827	ENST00000360351.8	506	5987	++	39	P11137-1#47	0	3	ENST00000360351.8	2738	2741	+	3	0	-2	6318
P11137-1#48	0	1	1	P11137-1	820	821	+	1	P11137-1	0	1827	ENST00000704357.1	451	6025	++	271	P11137-1#48	0	3	ENST00000704357.1	2911	2914	+	3	0	-2	6319
P11137-1#48	0	1	1	P11137-1	820	821	+	1	P11137-1	0	1827	ENST00000682079.1	451	5932	++	266	P11137-1#48	0	3	ENST00000682079.1	2911	2914	+	3	0	-2	6320
P11137-1#48	0	1	1	P11137-1	820	821	+	1	P11137-1	106	1827	ENST00000673860.1	1122	6288	++	229	P11137-1#48	0	3	ENST00000673860.1	3267	3270	+	3	0	-2	6321
P11137-1#48	0	1	1	P11137-1	820	821	+	1	P11137-1	0	1827	ENST00000447185.5	0	5469	++	97	P11137-1#48	0	3	ENST00000447185.5	2448	2451	+	3	0	-2	6322
P11137-1#48	0	1	1	P11137-1	820	821	+	1	P11137-1	0	1827	ENST00000360351.8	506	5987	++	39	P11137-1#48	0	3	ENST00000360351.8	2966	2969	+	3	0	-2	6323
P11137-1#49	0	1	1	P11137-1	880	881	+	1	P11137-1	0	1827	ENST00000704357.1	451	6025	++	271	P11137-1#49	0	3	ENST00000704357.1	3091	3094	+	3	0	-2	6324
P11137-1#49	0	1	1	P11137-1	880	881	+	1	P11137-1	0	1827	ENST00000682079.1	451	5932	++	266	P11137-1#49	0	3	ENST00000682079.1	3091	3094	+	3	0	-2	6325
P11137-1#49	0	1	1	P11137-1	880	881	+	1	P11137-1	106	1827	ENST00000673860.1	1122	6288	++	229	P11137-1#49	0	3	ENST00000673860.1	3447	3450	+	3	0	-2	6326
P11137-1#49	0	1	1	P11137-1	880	881	+	1	P11137-1	0	1827	ENST00000447185.5	0	5469	++	97	P11137-1#49	0	3	ENST00000447185.5	2628	2631	+	3	0	-2	6327
P11137-1#49	0	1	1	P11137-1	880	881	+	1	P11137-1	0	1827	ENST00000360351.8	506	5987	++	39	P11137-1#49	0	3	ENST00000360351.8	3146	3149	+	3	0	-2	6328
P11137-1#50	0	1	1	P11137-1	889	890	+	1	P11137-1	0	1827	ENST00000704357.1	451	6025	++	271	P11137-1#50	0	3	ENST00000704357.1	3118	3121	+	3	0	-2	6329
P11137-1#50	0	1	1	P11137-1	889	890	+	1	P11137-1	0	1827	ENST00000682079.1	451	5932	++	266	P11137-1#50	0	3	ENST00000682079.1	3118	3121	+	3	0	-2	6330
P11137-1#50	0	1	1	P11137-1	889	890	+	1	P11137-1	106	1827	ENST00000673860.1	1122	6288	++	229	P11137-1#50	0	3	ENST00000673860.1	3474	3477	+	3	0	-2	6331
P11137-1#50	0	1	1	P11137-1	889	890	+	1	P11137-1	0	1827	ENST00000447185.5	0	5469	++	97	P11137-1#50	0	3	ENST00000447185.5	2655	2658	+	3	0	-2	6332
P11137-1#50	0	1	1	P11137-1	889	890	+	1	P11137-1	0	1827	ENST00000360351.8	506	5987	++	39	P11137-1#50	0	3	ENST00000360351.8	3173	3176	+	3	0	-2	6333
P11137-1#51	0	1	1	P11137-1	935	936	+	1	P11137-1	0	1827	ENST00000704357.1	451	6025	++	271	P11137-1#51	0	3	ENST00000704357.1	3256	3259	+	3	0	-2	6334
P11137-1#51	0	1	1	P11137-1	935	936	+	1	P11137-1	0	1827	ENST00000682079.1	451	5932	++	266	P11137-1#51	0	3	ENST00000682079.1	3256	3259	+	3	0	-2	6335
P11137-1#51	0	1	1	P11137-1	935	936	+	1	P11137-1	106	1827	ENST00000673860.1	1122	6288	++	229	P11137-1#51	0	3	ENST00000673860.1	3612	3615	+	3	0	-2	6336
P11137-1#51	0	1	1	P11137-1	935	936	+	1	P11137-1	0	1827	ENST00000447185.5	0	5469	++	97	P11137-1#51	0	3	ENST00000447185.5	2793	2796	+	3	0	-2	6337
P11137-1#51	0	1	1	P11137-1	935	936	+	1	P11137-1	0	1827	ENST00000360351.8	506	5987	++	39	P11137-1#51	0	3	ENST00000360351.8	3311	3314	+	3	0	-2	6338
P11137-1#52	0	1	1	P11137-1	1132	1133	+	1	P11137-1	0	1827	ENST00000704357.1	451	6025	++	271	P11137-1#52	0	3	ENST00000704357.1	3847	3850	+	3	0	-2	6339
P11137-1#52	0	1	1	P11137-1	1132	1133	+	1	P11137-1	0	1827	ENST00000682079.1	451	5932	++	266	P11137-1#52	0	3	ENST00000682079.1	3847	3850	+	3	0	-2	6340
P11137-1#52	0	1	1	P11137-1	1132	1133	+	1	P11137-1	106	1827	ENST00000673860.1	1122	6288	++	229	P11137-1#52	0	3	ENST00000673860.1	4203	4206	+	3	0	-2	6341
P11137-1#52	0	1	1	P11137-1	1132	1133	+	1	P11137-1	0	1827	ENST00000447185.5	0	5469	++	97	P11137-1#52	0	3	ENST00000447185.5	3384	3387	+	3	0	-2	6342
P11137-1#52	0	1	1	P11137-1	1132	1133	+	1	P11137-1	0	1827	ENST00000360351.8	506	5987	++	39	P11137-1#52	0	3	ENST00000360351.8	3902	3905	+	3	0	-2	6343
P11137-1#53	0	1	1	P11137-1	1133	1134	+	1	P11137-1	0	1827	ENST00000704357.1	451	6025	++	271	P11137-1#53	0	3	ENST00000704357.1	3850	3853	+	3	0	-2	6344
P11137-1#53	0	1	1	P11137-1	1133	1134	+	1	P11137-1	0	1827	ENST00000682079.1	451	5932	++	266	P11137-1#53	0	3	ENST00000682079.1	3850	3853	+	3	0	-2	6345
P11137-1#53	0	1	1	P11137-1	1133	1134	+	1	P11137-1	106	1827	ENST00000673860.1	1122	6288	++	229	P11137-1#53	0	3	ENST00000673860.1	4206	4209	+	3	0	-2	6346
P11137-1#53	0	1	1	P11137-1	1133	1134	+	1	P11137-1	0	1827	ENST00000447185.5	0	5469	++	97	P11137-1#53	0	3	ENST00000447185.5	3387	3390	+	3	0	-2	6347
P11137-1#53	0	1	1	P11137-1	1133	1134	+	1	P11137-1	0	1827	ENST00000360351.8	506	5987	++	39	P11137-1#53	0	3	ENST00000360351.8	3905	3908	+	3	0	-2	6348
P11137-1#54	0	1	1	P11137-1	1138	1139	+	1	P11137-1	0	1827	ENST00000704357.1	451	6025	++	271	P11137-1#54	0	3	ENST00000704357.1	3865	3868	+	3	0	-2	6349
P11137-1#54	0	1	1	P11137-1	1138	1139	+	1	P11137-1	0	1827	ENST00000682079.1	451	5932	++	266	P11137-1#54	0	3	ENST00000682079.1	3865	3868	+	3	0	-2	6350
P11137-1#54	0	1	1	P11137-1	1138	1139	+	1	P11137-1	106	1827	ENST00000673860.1	1122	6288	++	229	P11137-1#54	0	3	ENST00000673860.1	4221	4224	+	3	0	-2	6351
P11137-1#54	0	1	1	P11137-1	1138	1139	+	1	P11137-1	0	1827	ENST00000447185.5	0	5469	++	97	P11137-1#54	0	3	ENST00000447185.5	3402	3405	+	3	0	-2	6352
P11137-1#54	0	1	1	P11137-1	1138	1139	+	1	P11137-1	0	1827	ENST00000360351.8	506	5987	++	39	P11137-1#54	0	3	ENST00000360351.8	3920	3923	+	3	0	-2	6353
P11137-1#55	0	1	1	P11137-1	1153	1154	+	1	P11137-1	0	1827	ENST00000704357.1	451	6025	++	271	P11137-1#55	0	3	ENST00000704357.1	3910	3913	+	3	0	-2	6354
P11137-1#55	0	1	1	P11137-1	1153	1154	+	1	P11137-1	0	1827	ENST00000682079.1	451	5932	++	266	P11137-1#55	0	3	ENST00000682079.1	3910	3913	+	3	0	-2	6355
P11137-1#55	0	1	1	P11137-1	1153	1154	+	1	P11137-1	106	1827	ENST00000673860.1	1122	6288	++	229	P11137-1#55	0	3	ENST00000673860.1	4266	4269	+	3	0	-2	6356
P11137-1#55	0	1	1	P11137-1	1153	1154	+	1	P11137-1	0	1827	ENST00000447185.5	0	5469	++	97	P11137-1#55	0	3	ENST00000447185.5	3447	3450	+	3	0	-2	6357
P11137-1#55	0	1	1	P11137-1	1153	1154	+	1	P11137-1	0	1827	ENST00000360351.8	506	5987	++	39	P11137-1#55	0	3	ENST00000360351.8	3965	3968	+	3	0	-2	6358
P11137-1#56	0	1	1	P11137-1	1154	1155	+	1	P11137-1	0	1827	ENST00000704357.1	451	6025	++	271	P11137-1#56	0	3	ENST00000704357.1	3913	3916	+	3	0	-2	6359
P11137-1#56	0	1	1	P11137-1	1154	1155	+	1	P11137-1	0	1827	ENST00000682079.1	451	5932	++	266	P11137-1#56	0	3	ENST00000682079.1	3913	3916	+	3	0	-2	6360
P11137-1#56	0	1	1	P11137-1	1154	1155	+	1	P11137-1	106	1827	ENST00000673860.1	1122	6288	++	229	P11137-1#56	0	3	ENST00000673860.1	4269	4272	+	3	0	-2	6361
P11137-1#56	0	1	1	P11137-1	1154	1155	+	1	P11137-1	0	1827	ENST00000447185.5	0	5469	++	97	P11137-1#56	0	3	ENST00000447185.5	3450	3453	+	3	0	-2	6362
P11137-1#56	0	1	1	P11137-1	1154	1155	+	1	P11137-1	0	1827	ENST00000360351.8	506	5987	++	39	P11137-1#56	0	3	ENST00000360351.8	3968	3971	+	3	0	-2	6363
P11137-1#57	0	1	1	P11137-1	1158	1159	+	1	P11137-1	0	1827	ENST00000704357.1	451	6025	++	271	P11137-1#57	0	3	ENST00000704357.1	3925	3928	+	3	0	-2	6364
P11137-1#57	0	1	1	P11137-1	1158	1159	+	1	P11137-1	0	1827	ENST00000682079.1	451	5932	++	266	P11137-1#57	0	3	ENST00000682079.1	3925	3928	+	3	0	-2	6365
P11137-1#57	0	1	1	P11137-1	1158	1159	+	1	P11137-1	106	1827	ENST00000673860.1	1122	6288	++	229	P11137-1#57	0	3	ENST00000673860.1	4281	4284	+	3	0	-2	6366
P11137-1#57	0	1	1	P11137-1	1158	1159	+	1	P11137-1	0	1827	ENST00000447185.5	0	5469	++	97	P11137-1#57	0	3	ENST00000447185.5	3462	3465	+	3	0	-2	6367
P11137-1#57	0	1	1	P11137-1	1158	1159	+	1	P11137-1	0	1827	ENST00000360351.8	506	5987	++	39	P11137-1#57	0	3	ENST00000360351.8	3980	3983	+	3	0	-2	6368
P11137-1#58	0	1	1	P11137-1	1346	1347	+	1	P11137-1	0	1827	ENST00000704357.1	451	6025	++	271	P11137-1#58	0	3	ENST00000704357.1	4489	4492	+	3	0	-2	6369
P11137-1#58	0	1	1	P11137-1	1346	1347	+	1	P11137-1	0	1827	ENST00000682079.1	451	5932	++	266	P11137-1#58	0	3	ENST00000682079.1	4489	4492	+	3	0	-2	6370
P11137-1#58	0	1	1	P11137-1	1346	1347	+	1	P11137-1	106	1827	ENST00000673860.1	1122	6288	++	229	P11137-1#58	0	3	ENST00000673860.1	4845	4848	+	3	0	-2	6371
P11137-1#58	0	1	1	P11137-1	1346	1347	+	1	P11137-1	0	1827	ENST00000447185.5	0	5469	++	97	P11137-1#58	0	3	ENST00000447185.5	4026	4029	+	3	0	-2	6372
P11137-1#58	0	1	1	P11137-1	1346	1347	+	1	P11137-1	0	1827	ENST00000360351.8	506	5987	++	39	P11137-1#58	0	3	ENST00000360351.8	4544	4547	+	3	0	-2	6373
P11137-1#59	0	1	1	P11137-1	1352	1353	+	1	P11137-1	0	1827	ENST00000704357.1	451	6025	++	271	P11137-1#59	0	3	ENST00000704357.1	4507	4510	+	3	0	-2	6374
P11137-1#59	0	1	1	P11137-1	1352	1353	+	1	P11137-1	0	1827	ENST00000682079.1	451	5932	++	266	P11137-1#59	0	3	ENST00000682079.1	4507	4510	+	3	0	-2	6375
P11137-1#59	0	1	1	P11137-1	1352	1353	+	1	P11137-1	106	1827	ENST00000673860.1	1122	6288	++	229	P11137-1#59	0	3	ENST00000673860.1	4863	4866	+	3	0	-2	6376
P11137-1#59	0	1	1	P11137-1	1352	1353	+	1	P11137-1	0	1827	ENST00000447185.5	0	5469	++	97	P11137-1#59	0	3	ENST00000447185.5	4044	4047	+	3	0	-2	6377
P11137-1#59	0	1	1	P11137-1	1352	1353	+	1	P11137-1	0	1827	ENST00000360351.8	506	5987	++	39	P11137-1#59	0	3	ENST00000360351.8	4562	4565	+	3	0	-2	6378
P11137-1#60	0	1	1	P11137-1	1533	1534	+	1	P11137-1	0	1827	ENST00000704357.1	451	6025	++	271	P11137-1#60	0	3	ENST00000704357.1	5050	5053	+	3	0	-2	6379
P11137-1#60	0	1	1	P11137-1	1533	1534	+	1	P11137-1	0	1827	ENST00000682079.1	451	5932	++	266	P11137-1#60	0	3	ENST00000682079.1	5050	5053	+	3	0	-2	6380
P11137-1#60	0	1	1	P11137-1	1533	1534	+	1	P11137-1	106	1827	ENST00000673860.1	1122	6288	++	229	P11137-1#60	0	3	ENST00000673860.1	5406	5409	+	3	0	-2	6381
P11137-1#60	0	1	1	P11137-1	1533	1534	+	1	P11137-1	0	1827	ENST00000447185.5	0	5469	++	97	P11137-1#60	0	3	ENST00000447185.5	4587	4590	+	3	0	-2	6382
P11137-1#60	0	1	1	P11137-1	1533	1534	+	1	P11137-1	1507	1827	ENST00000392194.5	619	1579	++	60	P11137-1#60	0	3	ENST00000392194.5	697	700	+	3	0	-2	6383
P11137-1#60	0	1	1	P11137-1	1533	1534	+	1	P11137-1	1507	1827	ENST00000361559.8	949	1909	++	41	P11137-1#60	0	3	ENST00000361559.8	1027	1030	+	3	0	-2	6384
P11137-1#60	0	1	1	P11137-1	1533	1534	+	1	P11137-1	0	1827	ENST00000360351.8	506	5987	++	39	P11137-1#60	0	3	ENST00000360351.8	5105	5108	+	3	0	-2	6385
P11137-1#61	0	1	1	P11137-1	1554	1555	+	1	P11137-1	0	1827	ENST00000704357.1	451	6025	++	271	P11137-1#61	0	3	ENST00000704357.1	5113	5116	+	3	0	-2	6386
P11137-1#61	0	1	1	P11137-1	1554	1555	+	1	P11137-1	0	1827	ENST00000682079.1	451	5932	++	266	P11137-1#61	0	3	ENST00000682079.1	5113	5116	+	3	0	-2	6387
P11137-1#61	0	1	1	P11137-1	1554	1555	+	1	P11137-1	106	1827	ENST00000673860.1	1122	6288	++	229	P11137-1#61	0	3	ENST00000673860.1	5469	5472	+	3	0	-2	6388
P11137-1#61	0	1	1	P11137-1	1554	1555	+	1	P11137-1	0	1827	ENST00000447185.5	0	5469	++	97	P11137-1#61	0	3	ENST00000447185.5	4650	4653	+	3	0	-2	6389
P11137-1#61	0	1	1	P11137-1	1554	1555	+	1	P11137-1	1507	1827	ENST00000392194.5	619	1579	++	60	P11137-1#61	0	3	ENST00000392194.5	760	763	+	3	0	-2	6390
P11137-1#61	0	1	1	P11137-1	1554	1555	+	1	P11137-1	1507	1827	ENST00000361559.8	949	1909	++	41	P11137-1#61	0	3	ENST00000361559.8	1090	1093	+	3	0	-2	6391
P11137-1#61	0	1	1	P11137-1	1554	1555	+	1	P11137-1	0	1827	ENST00000360351.8	506	5987	++	39	P11137-1#61	0	3	ENST00000360351.8	5168	5171	+	3	0	-2	6392
P11137-1#62	0	1	1	P11137-1	1587	1588	+	1	P11137-1	0	1827	ENST00000704357.1	451	6025	++	271	P11137-1#62	0	3	ENST00000704357.1	5212	5215	+	3	0	-2	6393
P11137-1#62	0	1	1	P11137-1	1587	1588	+	1	P11137-1	0	1827	ENST00000682079.1	451	5932	++	266	P11137-1#62	0	3	ENST00000682079.1	5212	5215	+	3	0	-2	6394
P11137-1#62	0	1	1	P11137-1	1587	1588	+	1	P11137-1	106	1827	ENST00000673860.1	1122	6288	++	229	P11137-1#62	0	3	ENST00000673860.1	5568	5571	+	3	0	-2	6395
P11137-1#62	0	1	1	P11137-1	1587	1588	+	1	P11137-1	0	1827	ENST00000447185.5	0	5469	++	97	P11137-1#62	0	3	ENST00000447185.5	4749	4752	+	3	0	-2	6396
P11137-1#62	0	1	1	P11137-1	1587	1588	+	1	P11137-1	1507	1827	ENST00000392194.5	619	1579	++	60	P11137-1#62	0	3	ENST00000392194.5	859	862	+	3	0	-2	6397
P11137-1#62	0	1	1	P11137-1	1587	1588	+	1	P11137-1	1507	1827	ENST00000361559.8	949	1909	++	41	P11137-1#62	0	3	ENST00000361559.8	1189	1192	+	3	0	-2	6398
P11137-1#62	0	1	1	P11137-1	1587	1588	+	1	P11137-1	0	1827	ENST00000360351.8	506	5987	++	39	P11137-1#62	0	3	ENST00000360351.8	5267	5270	+	3	0	-2	6399
P11137-1#63	0	1	1	P11137-1	1601	1602	+	1	P11137-1	0	1827	ENST00000704357.1	451	6025	++	271	P11137-1#63	0	3	ENST00000704357.1	5254	5257	+	3	0	-2	6400
P11137-1#63	0	1	1	P11137-1	1601	1602	+	1	P11137-1	0	1827	ENST00000682079.1	451	5932	++	266	P11137-1#63	0	3	ENST00000682079.1	5254	5257	+	3	0	-2	6401
P11137-1#63	0	1	1	P11137-1	1601	1602	+	1	P11137-1	106	1827	ENST00000673860.1	1122	6288	++	229	P11137-1#63	0	3	ENST00000673860.1	5610	5613	+	3	0	-2	6402
P11137-1#63	0	1	1	P11137-1	1601	1602	+	1	P11137-1	0	1827	ENST00000447185.5	0	5469	++	97	P11137-1#63	0	3	ENST00000447185.5	4791	4794	+	3	0	-2	6403
P11137-1#63	0	1	1	P11137-1	1601	1602	+	1	P11137-1	1507	1827	ENST00000392194.5	619	1579	++	60	P11137-1#63	0	3	ENST00000392194.5	901	904	+	3	0	-2	6404
P11137-1#63	0	1	1	P11137-1	1601	1602	+	1	P11137-1	1507	1827	ENST00000361559.8	949	1909	++	41	P11137-1#63	0	3	ENST00000361559.8	1231	1234	+	3	0	-2	6405
P11137-1#63	0	1	1	P11137-1	1601	1602	+	1	P11137-1	0	1827	ENST00000360351.8	506	5987	++	39	P11137-1#63	0	3	ENST00000360351.8	5309	5312	+	3	0	-2	6406
P11137-1#64	0	1	1	P11137-1	1604	1605	+	1	P11137-1	0	1827	ENST00000704357.1	451	6025	++	271	P11137-1#64	0	3	ENST00000704357.1	5263	5266	+	3	0	-2	6407
P11137-1#64	0	1	1	P11137-1	1604	1605	+	1	P11137-1	0	1827	ENST00000682079.1	451	5932	++	266	P11137-1#64	0	3	ENST00000682079.1	5263	5266	+	3	0	-2	6408
P11137-1#64	0	1	1	P11137-1	1604	1605	+	1	P11137-1	106	1827	ENST00000673860.1	1122	6288	++	229	P11137-1#64	0	3	ENST00000673860.1	5619	5622	+	3	0	-2	6409
P11137-1#64	0	1	1	P11137-1	1604	1605	+	1	P11137-1	0	1827	ENST00000447185.5	0	5469	++	97	P11137-1#64	0	3	ENST00000447185.5	4800	4803	+	3	0	-2	6410
P11137-1#64	0	1	1	P11137-1	1604	1605	+	1	P11137-1	1507	1827	ENST00000392194.5	619	1579	++	60	P11137-1#64	0	3	ENST00000392194.5	910	913	+	3	0	-2	6411
P11137-1#64	0	1	1	P11137-1	1604	1605	+	1	P11137-1	1507	1827	ENST00000361559.8	949	1909	++	41	P11137-1#64	0	3	ENST00000361559.8	1240	1243	+	3	0	-2	6412
P11137-1#64	0	1	1	P11137-1	1604	1605	+	1	P11137-1	0	1827	ENST00000360351.8	506	5987	++	39	P11137-1#64	0	3	ENST00000360351.8	5318	5321	+	3	0	-2	6413
P11137-1#65	0	1	1	P11137-1	1615	1616	+	1	P11137-1	0	1827	ENST00000704357.1	451	6025	++	271	P11137-1#65	0	3	ENST00000704357.1	5296	5299	+	3	0	-2	6414
P11137-1#65	0	1	1	P11137-1	1615	1616	+	1	P11137-1	0	1827	ENST00000682079.1	451	5932	++	266	P11137-1#65	0	3	ENST00000682079.1	5296	5299	+	3	0	-2	6415
P11137-1#65	0	1	1	P11137-1	1615	1616	+	1	P11137-1	106	1827	ENST00000673860.1	1122	6288	++	229	P11137-1#65	0	3	ENST00000673860.1	5652	5655	+	3	0	-2	6416
P11137-1#65	0	1	1	P11137-1	1615	1616	+	1	P11137-1	0	1827	ENST00000447185.5	0	5469	++	97	P11137-1#65	0	3	ENST00000447185.5	4833	4836	+	3	0	-2	6417
P11137-1#65	0	1	1	P11137-1	1615	1616	+	1	P11137-1	1507	1827	ENST00000392194.5	619	1579	++	60	P11137-1#65	0	3	ENST00000392194.5	943	946	+	3	0	-2	6418
P11137-1#65	0	1	1	P11137-1	1615	1616	+	1	P11137-1	1507	1827	ENST00000361559.8	949	1909	++	41	P11137-1#65	0	3	ENST00000361559.8	1273	1276	+	3	0	-2	6419
P11137-1#65	0	1	1	P11137-1	1615	1616	+	1	P11137-1	0	1827	ENST00000360351.8	506	5987	++	39	P11137-1#65	0	3	ENST00000360351.8	5351	5354	+	3	0	-2	6420
P11137-1#66	0	1	1	P11137-1	1618	1619	+	1	P11137-1	0	1827	ENST00000704357.1	451	6025	++	271	P11137-1#66	0	3	ENST00000704357.1	5305	5308	+	3	0	-2	6421
P11137-1#66	0	1	1	P11137-1	1618	1619	+	1	P11137-1	0	1827	ENST00000682079.1	451	5932	++	266	P11137-1#66	0	3	ENST00000682079.1	5305	5308	+	3	0	-2	6422
P11137-1#66	0	1	1	P11137-1	1618	1619	+	1	P11137-1	106	1827	ENST00000673860.1	1122	6288	++	229	P11137-1#66	0	3	ENST00000673860.1	5661	5664	+	3	0	-2	6423
P11137-1#66	0	1	1	P11137-1	1618	1619	+	1	P11137-1	0	1827	ENST00000447185.5	0	5469	++	97	P11137-1#66	0	3	ENST00000447185.5	4842	4845	+	3	0	-2	6424
P11137-1#66	0	1	1	P11137-1	1618	1619	+	1	P11137-1	1507	1827	ENST00000392194.5	619	1579	++	60	P11137-1#66	0	3	ENST00000392194.5	952	955	+	3	0	-2	6425
P11137-1#66	0	1	1	P11137-1	1618	1619	+	1	P11137-1	1507	1827	ENST00000361559.8	949	1909	++	41	P11137-1#66	0	3	ENST00000361559.8	1282	1285	+	3	0	-2	6426
P11137-1#66	0	1	1	P11137-1	1618	1619	+	1	P11137-1	0	1827	ENST00000360351.8	506	5987	++	39	P11137-1#66	0	3	ENST00000360351.8	5360	5363	+	3	0	-2	6427
P11137-1#67	0	1	1	P11137-1	1648	1649	+	1	P11137-1	0	1827	ENST00000704357.1	451	6025	++	271	P11137-1#67	0	3	ENST00000704357.1	5395	5398	+	3	0	-2	6428
P11137-1#67	0	1	1	P11137-1	1648	1649	+	1	P11137-1	0	1827	ENST00000682079.1	451	5932	++	266	P11137-1#67	0	3	ENST00000682079.1	5395	5398	+	3	0	-2	6429
P11137-1#67	0	1	1	P11137-1	1648	1649	+	1	P11137-1	106	1827	ENST00000673860.1	1122	6288	++	229	P11137-1#67	0	3	ENST00000673860.1	5751	5754	+	3	0	-2	6430
P11137-1#67	0	1	1	P11137-1	1648	1649	+	1	P11137-1	0	1827	ENST00000447185.5	0	5469	++	97	P11137-1#67	0	3	ENST00000447185.5	4932	4935	+	3	0	-2	6431
P11137-1#67	0	1	1	P11137-1	1648	1649	+	1	P11137-1	1507	1827	ENST00000392194.5	619	1579	++	60	P11137-1#67	0	3	ENST00000392194.5	1042	1045	+	3	0	-2	6432
P11137-1#67	0	1	1	P11137-1	1648	1649	+	1	P11137-1	1507	1827	ENST00000361559.8	949	1909	++	41	P11137-1#67	0	3	ENST00000361559.8	1372	1375	+	3	0	-2	6433
P11137-1#67	0	1	1	P11137-1	1648	1649	+	1	P11137-1	0	1827	ENST00000360351.8	506	5987	++	39	P11137-1#67	0	3	ENST00000360351.8	5450	5453	+	3	0	-2	6434
P11137-1#68	0	1	1	P11137-1	1652	1653	+	1	P11137-1	0	1827	ENST00000704357.1	451	6025	++	271	P11137-1#68	0	3	ENST00000704357.1	5407	5410	+	3	0	-2	6435
P11137-1#68	0	1	1	P11137-1	1652	1653	+	1	P11137-1	0	1827	ENST00000682079.1	451	5932	++	266	P11137-1#68	0	3	ENST00000682079.1	5407	5410	+	3	0	-2	6436
P11137-1#68	0	1	1	P11137-1	1652	1653	+	1	P11137-1	106	1827	ENST00000673860.1	1122	6288	++	229	P11137-1#68	0	3	ENST00000673860.1	5763	5766	+	3	0	-2	6437
P11137-1#68	0	1	1	P11137-1	1652	1653	+	1	P11137-1	0	1827	ENST00000447185.5	0	5469	++	97	P11137-1#68	0	3	ENST00000447185.5	4944	4947	+	3	0	-2	6438
P11137-1#68	0	1	1	P11137-1	1652	1653	+	1	P11137-1	1507	1827	ENST00000392194.5	619	1579	++	60	P11137-1#68	0	3	ENST00000392194.5	1054	1057	+	3	0	-2	6439
P11137-1#68	0	1	1	P11137-1	1652	1653	+	1	P11137-1	1507	1827	ENST00000361559.8	949	1909	++	41	P11137-1#68	0	3	ENST00000361559.8	1384	1387	+	3	0	-2	6440
P11137-1#68	0	1	1	P11137-1	1652	1653	+	1	P11137-1	0	1827	ENST00000360351.8	506	5987	++	39	P11137-1#68	0	3	ENST00000360351.8	5462	5465	+	3	0	-2	6441
P11137-1#69	0	1	1	P11137-1	1678	1679	+	1	P11137-1	0	1827	ENST00000704357.1	451	6025	++	271	P11137-1#69	0	3	ENST00000704357.1	5485	5488	+	3	0	-2	6442
P11137-1#69	0	1	1	P11137-1	1678	1679	+	1	P11137-1	0	1827	ENST00000682079.1	451	5932	++	266	P11137-1#69	0	3	ENST00000682079.1	5485	5488	+	3	0	-2	6443
P11137-1#69	0	1	1	P11137-1	1678	1679	+	1	P11137-1	106	1827	ENST00000673860.1	1122	6288	++	229	P11137-1#69	0	3	ENST00000673860.1	5841	5844	+	3	0	-2	6444
P11137-1#69	0	1	1	P11137-1	1678	1679	+	1	P11137-1	0	1827	ENST00000447185.5	0	5469	++	97	P11137-1#69	0	3	ENST00000447185.5	5022	5025	+	3	0	-2	6445
P11137-1#69	0	1	1	P11137-1	1678	1679	+	1	P11137-1	1507	1827	ENST00000392194.5	619	1579	++	60	P11137-1#69	0	3	ENST00000392194.5	1132	1135	+	3	0	-2	6446
P11137-1#69	0	1	1	P11137-1	1678	1679	+	1	P11137-1	1507	1827	ENST00000361559.8	949	1909	++	41	P11137-1#69	0	3	ENST00000361559.8	1462	1465	+	3	0	-2	6447
P11137-1#69	0	1	1	P11137-1	1678	1679	+	1	P11137-1	0	1827	ENST00000360351.8	506	5987	++	39	P11137-1#69	0	3	ENST00000360351.8	5540	5543	+	3	0	-2	6448
P11137-1#70	0	1	1	P11137-1	1781	1782	+	1	P11137-1	0	1827	ENST00000704357.1	451	6025	++	271	P11137-1#70	0	3	ENST00000704357.1	5887	5890	+	3	0	-2	6449
P11137-1#70	0	1	1	P11137-1	1781	1782	+	1	P11137-1	0	1827	ENST00000682079.1	451	5932	++	266	P11137-1#70	0	3	ENST00000682079.1	5794	5797	+	3	0	-2	6450
P11137-1#70	0	1	1	P11137-1	1781	1782	+	1	P11137-1	106	1827	ENST00000673860.1	1122	6288	++	229	P11137-1#70	0	3	ENST00000673860.1	6150	6153	+	3	0	-2	6451
P11137-1#70	0	1	1	P11137-1	1781	1782	+	1	P11137-1	0	1827	ENST00000447185.5	0	5469	++	97	P11137-1#70	0	3	ENST00000447185.5	5331	5334	+	3	0	-2	6452
P11137-1#70	0	1	1	P11137-1	1781	1782	+	1	P11137-1	1507	1827	ENST00000392194.5	619	1579	++	60	P11137-1#70	0	3	ENST00000392194.5	1441	1444	+	3	0	-2	6453
P11137-1#70	0	1	1	P11137-1	1781	1782	+	1	P11137-1	1507	1827	ENST00000361559.8	949	1909	++	41	P11137-1#70	0	3	ENST00000361559.8	1771	1774	+	3	0	-2	6454
P11137-1#70	0	1	1	P11137-1	1781	1782	+	1	P11137-1	0	1827	ENST00000360351.8	506	5987	++	39	P11137-1#70	0	3	ENST00000360351.8	5849	5852	+	3	0	-2	6455
P11137-1#71	0	1	1	P11137-1	1786	1787	+	1	P11137-1	0	1827	ENST00000704357.1	451	6025	++	271	P11137-1#71	0	3	ENST00000704357.1	5902	5905	+	3	0	-2	6456
P11137-1#71	0	1	1	P11137-1	1786	1787	+	1	P11137-1	0	1827	ENST00000682079.1	451	5932	++	266	P11137-1#71	0	3	ENST00000682079.1	5809	5812	+	3	0	-2	6457
P11137-1#71	0	1	1	P11137-1	1786	1787	+	1	P11137-1	106	1827	ENST00000673860.1	1122	6288	++	229	P11137-1#71	0	3	ENST00000673860.1	6165	6168	+	3	0	-2	6458
P11137-1#71	0	1	1	P11137-1	1786	1787	+	1	P11137-1	0	1827	ENST00000447185.5	0	5469	++	97	P11137-1#71	0	3	ENST00000447185.5	5346	5349	+	3	0	-2	6459
P11137-1#71	0	1	1	P11137-1	1786	1787	+	1	P11137-1	1507	1827	ENST00000392194.5	619	1579	++	60	P11137-1#71	0	3	ENST00000392194.5	1456	1459	+	3	0	-2	6460
P11137-1#71	0	1	1	P11137-1	1786	1787	+	1	P11137-1	1507	1827	ENST00000361559.8	949	1909	++	41	P11137-1#71	0	3	ENST00000361559.8	1786	1789	+	3	0	-2	6461
P11137-1#71	0	1	1	P11137-1	1786	1787	+	1	P11137-1	0	1827	ENST00000360351.8	506	5987	++	39	P11137-1#71	0	3	ENST00000360351.8	5864	5867	+	3	0	-2	6462
P11137-1#72	0	1	1	P11137-1	1789	1790	+	1	P11137-1	0	1827	ENST00000704357.1	451	6025	++	271	P11137-1#72	0	3	ENST00000704357.1	5911	5914	+	3	0	-2	6463
P11137-1#72	0	1	1	P11137-1	1789	1790	+	1	P11137-1	0	1827	ENST00000682079.1	451	5932	++	266	P11137-1#72	0	3	ENST00000682079.1	5818	5821	+	3	0	-2	6464
P11137-1#72	0	1	1	P11137-1	1789	1790	+	1	P11137-1	106	1827	ENST00000673860.1	1122	6288	++	229	P11137-1#72	0	3	ENST00000673860.1	6174	6177	+	3	0	-2	6465
P11137-1#72	0	1	1	P11137-1	1789	1790	+	1	P11137-1	0	1827	ENST00000447185.5	0	5469	++	97	P11137-1#72	0	3	ENST00000447185.5	5355	5358	+	3	0	-2	6466
P11137-1#72	0	1	1	P11137-1	1789	1790	+	1	P11137-1	1507	1827	ENST00000392194.5	619	1579	++	60	P11137-1#72	0	3	ENST00000392194.5	1465	1468	+	3	0	-2	6467
P11137-1#72	0	1	1	P11137-1	1789	1790	+	1	P11137-1	1507	1827	ENST00000361559.8	949	1909	++	41	P11137-1#72	0	3	ENST00000361559.8	1795	1798	+	3	0	-2	6468
P11137-1#72	0	1	1	P11137-1	1789	1790	+	1	P11137-1	0	1827	ENST00000360351.8	506	5987	++	39	P11137-1#72	0	3	ENST00000360351.8	5873	5876	+	3	0	-2	6469
P11137-1#73	0	1	1	P11137-1	1794	1795	+	1	P11137-1	0	1827	ENST00000704357.1	451	6025	++	271	P11137-1#73	0	3	ENST00000704357.1	5926	5929	+	3	0	-2	6470
P11137-1#73	0	1	1	P11137-1	1794	1795	+	1	P11137-1	0	1827	ENST00000682079.1	451	5932	++	266	P11137-1#73	0	3	ENST00000682079.1	5833	5836	+	3	0	-2	6471
P11137-1#73	0	1	1	P11137-1	1794	1795	+	1	P11137-1	106	1827	ENST00000673860.1	1122	6288	++	229	P11137-1#73	0	3	ENST00000673860.1	6189	6192	+	3	0	-2	6472
P11137-1#73	0	1	1	P11137-1	1794	1795	+	1	P11137-1	0	1827	ENST00000447185.5	0	5469	++	97	P11137-1#73	0	3	ENST00000447185.5	5370	5373	+	3	0	-2	6473
P11137-1#73	0	1	1	P11137-1	1794	1795	+	1	P11137-1	1507	1827	ENST00000392194.5	619	1579	++	60	P11137-1#73	0	3	ENST00000392194.5	1480	1483	+	3	0	-2	6474
P11137-1#73	0	1	1	P11137-1	1794	1795	+	1	P11137-1	1507	1827	ENST00000361559.8	949	1909	++	41	P11137-1#73	0	3	ENST00000361559.8	1810	1813	+	3	0	-2	6475
P11137-1#73	0	1	1	P11137-1	1794	1795	+	1	P11137-1	0	1827	ENST00000360351.8	506	5987	++	39	P11137-1#73	0	3	ENST00000360351.8	5888	5891	+	3	0	-2	6476
P11137-1#74	0	1	1	P11137-1	1807	1808	+	1	P11137-1	0	1827	ENST00000704357.1	451	6025	++	271	P11137-1#74	0	3	ENST00000704357.1	5965	5968	+	3	0	-2	6477
P11137-1#74	0	1	1	P11137-1	1807	1808	+	1	P11137-1	0	1827	ENST00000682079.1	451	5932	++	266	P11137-1#74	0	3	ENST00000682079.1	5872	5875	+	3	0	-2	6478
P11137-1#74	0	1	1	P11137-1	1807	1808	+	1	P11137-1	106	1827	ENST00000673860.1	1122	6288	++	229	P11137-1#74	0	3	ENST00000673860.1	6228	6231	+	3	0	-2	6479
P11137-1#74	0	1	1	P11137-1	1807	1808	+	1	P11137-1	0	1827	ENST00000447185.5	0	5469	++	97	P11137-1#74	0	3	ENST00000447185.5	5409	5412	+	3	0	-2	6480
P11137-1#74	0	1	1	P11137-1	1807	1808	+	1	P11137-1	1507	1827	ENST00000392194.5	619	1579	++	60	P11137-1#74	0	3	ENST00000392194.5	1519	1522	+	3	0	-2	6481
P11137-1#74	0	1	1	P11137-1	1807	1808	+	1	P11137-1	1507	1827	ENST00000361559.8	949	1909	++	41	P11137-1#74	0	3	ENST00000361559.8	1849	1852	+	3	0	-2	6482
P11137-1#74	0	1	1	P11137-1	1807	1808	+	1	P11137-1	0	1827	ENST00000360351.8	506	5987	++	39	P11137-1#74	0	3	ENST00000360351.8	5927	5930	+	3	0	-2	6483
P11137-1#75	0	1356	1356	P11137-1	151	1507	+	1356	P11137-1	0	1827	ENST00000704357.1	451	6025	++	271	P11137-1#75	0	4068	ENST00000704357.1	904	4972	+	4068	0	-2712	6484
P11137-1#75	0	1356	1356	P11137-1	151	1507	+	1356	P11137-1	0	1827	ENST00000682079.1	451	5932	++	266	P11137-1#75	0	4068	ENST00000682079.1	904	4972	+	4068	0	-2712	6485
P11137-1#75	0	1356	1356	P11137-1	151	1507	+	1356	P11137-1	106	1827	ENST00000673860.1	1122	6288	++	229	P11137-1#75	0	4068	ENST00000673860.1	1260	5328	+	4068	0	-2712	6486
P11137-1#75	0	1356	1356	P11137-1	151	1507	+	1356	P11137-1	0	1827	ENST00000447185.5	0	5469	++	97	P11137-1#75	12	4068	ENST00000447185.5	453	4509	+	4056	12	-2712	6487
P11137-1#75	0	1356	1356	P11137-1	151	1507	+	1356	P11137-1	106	485	ENST00000445941.5	879	2019	++	96	P11137-1#75	0	1002	ENST00000445941.5	1017	2019	+	1002	0	354	6488
P11137-1#75	0	1356	1356	P11137-1	151	1507	+	1356	P11137-1	0	1827	ENST00000360351.8	506	5987	++	39	P11137-1#75	0	4068	ENST00000360351.8	959	5027	+	4068	0	-2712	6489
P11137-1#76	0	78	78	P11137-1	151	229	+	78	P11137-1	0	1827	ENST00000704357.1	451	6025	++	271	P11137-1#76	0	234	ENST00000704357.1	904	1138	+	234	0	-156	6490
P11137-1#76	0	78	78	P11137-1	151	229	+	78	P11137-1	0	1827	ENST00000682079.1	451	5932	++	266	P11137-1#76	0	234	ENST00000682079.1	904	1138	+	234	0	-156	6491
P11137-1#76	0	78	78	P11137-1	151	229	+	78	P11137-1	106	1827	ENST00000673860.1	1122	6288	++	229	P11137-1#76	0	234	ENST00000673860.1	1260	1494	+	234	0	-156	6492
P11137-1#76	0	78	78	P11137-1	151	229	+	78	P11137-1	0	1827	ENST00000447185.5	0	5469	++	97	P11137-1#76	12	234	ENST00000447185.5	453	675	+	222	12	-156	6493
P11137-1#76	0	78	78	P11137-1	151	229	+	78	P11137-1	106	485	ENST00000445941.5	879	2019	++	96	P11137-1#76	0	234	ENST00000445941.5	1017	1251	+	234	0	-156	6494
P11137-1#76	0	78	78	P11137-1	151	229	+	78	P11137-1	0	1827	ENST00000360351.8	506	5987	++	39	P11137-1#76	0	234	ENST00000360351.8	959	1193	+	234	0	-156	6495
P11137-1#77	0	4	4	P11137-1	151	155	+	4	P11137-1	0	1827	ENST00000704357.1	451	6025	++	271	P11137-1#77	0	12	ENST00000704357.1	904	916	+	12	0	-8	6496
P11137-1#77	0	4	4	P11137-1	151	155	+	4	P11137-1	0	1827	ENST00000682079.1	451	5932	++	266	P11137-1#77	0	12	ENST00000682079.1	904	916	+	12	0	-8	6497
P11137-1#77	0	4	4	P11137-1	151	155	+	4	P11137-1	106	1827	ENST00000673860.1	1122	6288	++	229	P11137-1#77	0	12	ENST00000673860.1	1260	1272	+	12	0	-8	6498
P11137-1#77	0	4	4	P11137-1	151	155	+	4	P11137-1	106	485	ENST00000445941.5	879	2019	++	96	P11137-1#77	0	12	ENST00000445941.5	1017	1029	+	12	0	-8	6499
P11137-1#77	0	4	4	P11137-1	151	155	+	4	P11137-1	0	1827	ENST00000360351.8	506	5987	++	39	P11137-1#77	0	12	ENST00000360351.8	959	971	+	12	0	-8	6500
P11137-1#78	0	1299	1299	P11137-1	229	1528	+	1299	P11137-1	0	1827	ENST00000704357.1	451	6025	++	271	P11137-1#78	0	3897	ENST00000704357.1	1138	5035	+	3897	0	-2598	6501
P11137-1#78	0	1299	1299	P11137-1	229	1528	+	1299	P11137-1	0	1827	ENST00000682079.1	451	5932	++	266	P11137-1#78	0	3897	ENST00000682079.1	1138	5035	+	3897	0	-2598	6502
P11137-1#78	0	1299	1299	P11137-1	229	1528	+	1299	P11137-1	106	1827	ENST00000673860.1	1122	6288	++	229	P11137-1#78	0	3897	ENST00000673860.1	1494	5391	+	3897	0	-2598	6503
P11137-1#78	0	1299	1299	P11137-1	229	1528	+	1299	P11137-1	0	1827	ENST00000447185.5	0	5469	++	97	P11137-1#78	0	3897	ENST00000447185.5	675	4572	+	3897	0	-2598	6504
P11137-1#78	0	1299	1299	P11137-1	229	1528	+	1299	P11137-1	106	485	ENST00000445941.5	879	2019	++	96	P11137-1#78	0	768	ENST00000445941.5	1251	2019	+	768	0	531	6505
P11137-1#78	0	1299	1299	P11137-1	229	1528	+	1299	P11137-1	1507	1827	ENST00000392194.5	619	1579	++	60	P11137-1#78	3834	3897	ENST00000392194.5	619	682	+	63	3834	-2598	6506
P11137-1#78	0	1299	1299	P11137-1	229	1528	+	1299	P11137-1	1507	1827	ENST00000361559.8	949	1909	++	41	P11137-1#78	3834	3897	ENST00000361559.8	949	1012	+	63	3834	-2598	6507
P11137-1#78	0	1299	1299	P11137-1	229	1528	+	1299	P11137-1	0	1827	ENST00000360351.8	506	5987	++	39	P11137-1#78	0	3897	ENST00000360351.8	1193	5090	+	3897	0	-2598	6508
P11137-1#79	0	1	1	P11137-1	1690	1691	+	1	P11137-1	0	1827	ENST00000704357.1	451	6025	++	271	P11137-1#79	0	3	ENST00000704357.1	5521	5524	+	3	0	-2	6509
P11137-1#79	0	1	1	P11137-1	1690	1691	+	1	P11137-1	0	1827	ENST00000682079.1	451	5932	++	266	P11137-1#79	0	3	ENST00000682079.1	5521	5524	+	3	0	-2	6510
P11137-1#79	0	1	1	P11137-1	1690	1691	+	1	P11137-1	106	1827	ENST00000673860.1	1122	6288	++	229	P11137-1#79	0	3	ENST00000673860.1	5877	5880	+	3	0	-2	6511
P11137-1#79	0	1	1	P11137-1	1690	1691	+	1	P11137-1	0	1827	ENST00000447185.5	0	5469	++	97	P11137-1#79	0	3	ENST00000447185.5	5058	5061	+	3	0	-2	6512
P11137-1#79	0	1	1	P11137-1	1690	1691	+	1	P11137-1	1507	1827	ENST00000392194.5	619	1579	++	60	P11137-1#79	0	3	ENST00000392194.5	1168	1171	+	3	0	-2	6513
P11137-1#79	0	1	1	P11137-1	1690	1691	+	1	P11137-1	1507	1827	ENST00000361559.8	949	1909	++	41	P11137-1#79	0	3	ENST00000361559.8	1498	1501	+	3	0	-2	6514
P11137-1#79	0	1	1	P11137-1	1690	1691	+	1	P11137-1	0	1827	ENST00000360351.8	506	5987	++	39	P11137-1#79	0	3	ENST00000360351.8	5576	5579	+	3	0	-2	6515
P11137-1#80	0	1	1	P11137-1	81	82	+	1	P11137-1	0	1827	ENST00000704357.1	451	6025	++	271	P11137-1#80	0	3	ENST00000704357.1	694	697	+	3	0	-2	6516
P11137-1#80	0	1	1	P11137-1	81	82	+	1	P11137-1	0	1827	ENST00000682079.1	451	5932	++	266	P11137-1#80	0	3	ENST00000682079.1	694	697	+	3	0	-2	6517
P11137-1#80	0	1	1	P11137-1	81	82	+	1	P11137-1	0	1827	ENST00000447185.5	0	5469	++	97	P11137-1#80	0	3	ENST00000447185.5	243	246	+	3	0	-2	6518
P11137-1#80	0	1	1	P11137-1	81	82	+	1	P11137-1	0	106	ENST00000392193.5	295	613	++	59	P11137-1#80	0	3	ENST00000392193.5	538	541	+	3	0	-2	6519
P11137-1#80	0	1	1	P11137-1	81	82	+	1	P11137-1	0	1827	ENST00000360351.8	506	5987	++	39	P11137-1#80	0	3	ENST00000360351.8	749	752	+	3	0	-2	6520
P11137-1#81	0	1	1	P11137-1	178	179	+	1	P11137-1	0	1827	ENST00000704357.1	451	6025	++	271	P11137-1#81	0	3	ENST00000704357.1	985	988	+	3	0	-2	6521
P11137-1#81	0	1	1	P11137-1	178	179	+	1	P11137-1	0	1827	ENST00000682079.1	451	5932	++	266	P11137-1#81	0	3	ENST00000682079.1	985	988	+	3	0	-2	6522
P11137-1#81	0	1	1	P11137-1	178	179	+	1	P11137-1	106	1827	ENST00000673860.1	1122	6288	++	229	P11137-1#81	0	3	ENST00000673860.1	1341	1344	+	3	0	-2	6523
P11137-1#81	0	1	1	P11137-1	178	179	+	1	P11137-1	0	1827	ENST00000447185.5	0	5469	++	97	P11137-1#81	0	3	ENST00000447185.5	522	525	+	3	0	-2	6524
P11137-1#81	0	1	1	P11137-1	178	179	+	1	P11137-1	106	485	ENST00000445941.5	879	2019	++	96	P11137-1#81	0	3	ENST00000445941.5	1098	1101	+	3	0	-2	6525
P11137-1#81	0	1	1	P11137-1	178	179	+	1	P11137-1	0	1827	ENST00000360351.8	506	5987	++	39	P11137-1#81	0	3	ENST00000360351.8	1040	1043	+	3	0	-2	6526
P11137-1#82	0	1	1	P11137-1	276	277	+	1	P11137-1	0	1827	ENST00000704357.1	451	6025	++	271	P11137-1#82	0	3	ENST00000704357.1	1279	1282	+	3	0	-2	6527
P11137-1#82	0	1	1	P11137-1	276	277	+	1	P11137-1	0	1827	ENST00000682079.1	451	5932	++	266	P11137-1#82	0	3	ENST00000682079.1	1279	1282	+	3	0	-2	6528
P11137-1#82	0	1	1	P11137-1	276	277	+	1	P11137-1	106	1827	ENST00000673860.1	1122	6288	++	229	P11137-1#82	0	3	ENST00000673860.1	1635	1638	+	3	0	-2	6529
P11137-1#82	0	1	1	P11137-1	276	277	+	1	P11137-1	0	1827	ENST00000447185.5	0	5469	++	97	P11137-1#82	0	3	ENST00000447185.5	816	819	+	3	0	-2	6530
P11137-1#82	0	1	1	P11137-1	276	277	+	1	P11137-1	106	485	ENST00000445941.5	879	2019	++	96	P11137-1#82	0	3	ENST00000445941.5	1392	1395	+	3	0	-2	6531
P11137-1#82	0	1	1	P11137-1	276	277	+	1	P11137-1	0	1827	ENST00000360351.8	506	5987	++	39	P11137-1#82	0	3	ENST00000360351.8	1334	1337	+	3	0	-2	6532
P11137-1#83	0	1	1	P11137-1	422	423	+	1	P11137-1	0	1827	ENST00000704357.1	451	6025	++	271	P11137-1#83	0	3	ENST00000704357.1	1717	1720	+	3	0	-2	6533
P11137-1#83	0	1	1	P11137-1	422	423	+	1	P11137-1	0	1827	ENST00000682079.1	451	5932	++	266	P11137-1#83	0	3	ENST00000682079.1	1717	1720	+	3	0	-2	6534
P11137-1#83	0	1	1	P11137-1	422	423	+	1	P11137-1	106	1827	ENST00000673860.1	1122	6288	++	229	P11137-1#83	0	3	ENST00000673860.1	2073	2076	+	3	0	-2	6535
P11137-1#83	0	1	1	P11137-1	422	423	+	1	P11137-1	0	1827	ENST00000447185.5	0	5469	++	97	P11137-1#83	0	3	ENST00000447185.5	1254	1257	+	3	0	-2	6536
P11137-1#83	0	1	1	P11137-1	422	423	+	1	P11137-1	106	485	ENST00000445941.5	879	2019	++	96	P11137-1#83	0	3	ENST00000445941.5	1830	1833	+	3	0	-2	6537
P11137-1#83	0	1	1	P11137-1	422	423	+	1	P11137-1	0	1827	ENST00000360351.8	506	5987	++	39	P11137-1#83	0	3	ENST00000360351.8	1772	1775	+	3	0	-2	6538
P11137-1#84	0	1	1	P11137-1	704	705	+	1	P11137-1	0	1827	ENST00000704357.1	451	6025	++	271	P11137-1#84	0	3	ENST00000704357.1	2563	2566	+	3	0	-2	6539
P11137-1#84	0	1	1	P11137-1	704	705	+	1	P11137-1	0	1827	ENST00000682079.1	451	5932	++	266	P11137-1#84	0	3	ENST00000682079.1	2563	2566	+	3	0	-2	6540
P11137-1#84	0	1	1	P11137-1	704	705	+	1	P11137-1	106	1827	ENST00000673860.1	1122	6288	++	229	P11137-1#84	0	3	ENST00000673860.1	2919	2922	+	3	0	-2	6541
P11137-1#84	0	1	1	P11137-1	704	705	+	1	P11137-1	0	1827	ENST00000447185.5	0	5469	++	97	P11137-1#84	0	3	ENST00000447185.5	2100	2103	+	3	0	-2	6542
P11137-1#84	0	1	1	P11137-1	704	705	+	1	P11137-1	0	1827	ENST00000360351.8	506	5987	++	39	P11137-1#84	0	3	ENST00000360351.8	2618	2621	+	3	0	-2	6543
P11137-1#85	0	1	1	P11137-1	975	976	+	1	P11137-1	0	1827	ENST00000704357.1	451	6025	++	271	P11137-1#85	0	3	ENST00000704357.1	3376	3379	+	3	0	-2	6544
P11137-1#85	0	1	1	P11137-1	975	976	+	1	P11137-1	0	1827	ENST00000682079.1	451	5932	++	266	P11137-1#85	0	3	ENST00000682079.1	3376	3379	+	3	0	-2	6545
P11137-1#85	0	1	1	P11137-1	975	976	+	1	P11137-1	106	1827	ENST00000673860.1	1122	6288	++	229	P11137-1#85	0	3	ENST00000673860.1	3732	3735	+	3	0	-2	6546
P11137-1#85	0	1	1	P11137-1	975	976	+	1	P11137-1	0	1827	ENST00000447185.5	0	5469	++	97	P11137-1#85	0	3	ENST00000447185.5	2913	2916	+	3	0	-2	6547
P11137-1#85	0	1	1	P11137-1	975	976	+	1	P11137-1	0	1827	ENST00000360351.8	506	5987	++	39	P11137-1#85	0	3	ENST00000360351.8	3431	3434	+	3	0	-2	6548
P11137-1#86	0	1	1	P11137-1	990	991	+	1	P11137-1	0	1827	ENST00000704357.1	451	6025	++	271	P11137-1#86	0	3	ENST00000704357.1	3421	3424	+	3	0	-2	6549
P11137-1#86	0	1	1	P11137-1	990	991	+	1	P11137-1	0	1827	ENST00000682079.1	451	5932	++	266	P11137-1#86	0	3	ENST00000682079.1	3421	3424	+	3	0	-2	6550
P11137-1#86	0	1	1	P11137-1	990	991	+	1	P11137-1	106	1827	ENST00000673860.1	1122	6288	++	229	P11137-1#86	0	3	ENST00000673860.1	3777	3780	+	3	0	-2	6551
P11137-1#86	0	1	1	P11137-1	990	991	+	1	P11137-1	0	1827	ENST00000447185.5	0	5469	++	97	P11137-1#86	0	3	ENST00000447185.5	2958	2961	+	3	0	-2	6552
P11137-1#86	0	1	1	P11137-1	990	991	+	1	P11137-1	0	1827	ENST00000360351.8	506	5987	++	39	P11137-1#86	0	3	ENST00000360351.8	3476	3479	+	3	0	-2	6553
P11137-1#87	0	1	1	P11137-1	1098	1099	+	1	P11137-1	0	1827	ENST00000704357.1	451	6025	++	271	P11137-1#87	0	3	ENST00000704357.1	3745	3748	+	3	0	-2	6554
P11137-1#87	0	1	1	P11137-1	1098	1099	+	1	P11137-1	0	1827	ENST00000682079.1	451	5932	++	266	P11137-1#87	0	3	ENST00000682079.1	3745	3748	+	3	0	-2	6555
P11137-1#87	0	1	1	P11137-1	1098	1099	+	1	P11137-1	106	1827	ENST00000673860.1	1122	6288	++	229	P11137-1#87	0	3	ENST00000673860.1	4101	4104	+	3	0	-2	6556
P11137-1#87	0	1	1	P11137-1	1098	1099	+	1	P11137-1	0	1827	ENST00000447185.5	0	5469	++	97	P11137-1#87	0	3	ENST00000447185.5	3282	3285	+	3	0	-2	6557
P11137-1#87	0	1	1	P11137-1	1098	1099	+	1	P11137-1	0	1827	ENST00000360351.8	506	5987	++	39	P11137-1#87	0	3	ENST00000360351.8	3800	3803	+	3	0	-2	6558
P11137-1#88	0	1	1	P11137-1	8	9	+	1	P11137-1	0	1827	ENST00000704357.1	451	6025	++	271	P11137-1#88	0	3	ENST00000704357.1	475	478	+	3	0	-2	6559
P11137-1#88	0	1	1	P11137-1	8	9	+	1	P11137-1	0	1827	ENST00000682079.1	451	5932	++	266	P11137-1#88	0	3	ENST00000682079.1	475	478	+	3	0	-2	6560
P11137-1#88	0	1	1	P11137-1	8	9	+	1	P11137-1	0	1827	ENST00000447185.5	0	5469	++	97	P11137-1#88	0	3	ENST00000447185.5	24	27	+	3	0	-2	6561
P11137-1#88	0	1	1	P11137-1	8	9	+	1	P11137-1	0	106	ENST00000392193.5	295	613	++	59	P11137-1#88	0	3	ENST00000392193.5	319	322	+	3	0	-2	6562
P11137-1#88	0	1	1	P11137-1	8	9	+	1	P11137-1	0	1827	ENST00000360351.8	506	5987	++	39	P11137-1#88	0	3	ENST00000360351.8	530	533	+	3	0	-2	6563
P11137-1#89	0	1	1	P11137-1	36	37	+	1	P11137-1	0	1827	ENST00000704357.1	451	6025	++	271	P11137-1#89	0	3	ENST00000704357.1	559	562	+	3	0	-2	6564
P11137-1#89	0	1	1	P11137-1	36	37	+	1	P11137-1	0	1827	ENST00000682079.1	451	5932	++	266	P11137-1#89	0	3	ENST00000682079.1	559	562	+	3	0	-2	6565
P11137-1#89	0	1	1	P11137-1	36	37	+	1	P11137-1	0	1827	ENST00000447185.5	0	5469	++	97	P11137-1#89	0	3	ENST00000447185.5	108	111	+	3	0	-2	6566
P11137-1#89	0	1	1	P11137-1	36	37	+	1	P11137-1	0	106	ENST00000392193.5	295	613	++	59	P11137-1#89	0	3	ENST00000392193.5	403	406	+	3	0	-2	6567
P11137-1#89	0	1	1	P11137-1	36	37	+	1	P11137-1	0	1827	ENST00000360351.8	506	5987	++	39	P11137-1#89	0	3	ENST00000360351.8	614	617	+	3	0	-2	6568
P11137-1#90	0	1	1	P11137-1	107	108	+	1	P11137-1	0	1827	ENST00000704357.1	451	6025	++	271	P11137-1#90	0	3	ENST00000704357.1	772	775	+	3	0	-2	6569
P11137-1#90	0	1	1	P11137-1	107	108	+	1	P11137-1	0	1827	ENST00000682079.1	451	5932	++	266	P11137-1#90	0	3	ENST00000682079.1	772	775	+	3	0	-2	6570
P11137-1#90	0	1	1	P11137-1	107	108	+	1	P11137-1	106	1827	ENST00000673860.1	1122	6288	++	229	P11137-1#90	0	3	ENST00000673860.1	1125	1128	+	3	0	-2	6571
P11137-1#90	0	1	1	P11137-1	107	108	+	1	P11137-1	0	1827	ENST00000447185.5	0	5469	++	97	P11137-1#90	0	3	ENST00000447185.5	321	324	+	3	0	-2	6572
P11137-1#90	0	1	1	P11137-1	107	108	+	1	P11137-1	106	485	ENST00000445941.5	879	2019	++	96	P11137-1#90	0	3	ENST00000445941.5	882	885	+	3	0	-2	6573
P11137-1#90	0	1	1	P11137-1	107	108	+	1	P11137-1	0	1827	ENST00000360351.8	506	5987	++	39	P11137-1#90	0	3	ENST00000360351.8	827	830	+	3	0	-2	6574
P11137-1#91	0	1	1	P11137-1	186	187	+	1	P11137-1	0	1827	ENST00000704357.1	451	6025	++	271	P11137-1#91	0	3	ENST00000704357.1	1009	1012	+	3	0	-2	6575
P11137-1#91	0	1	1	P11137-1	186	187	+	1	P11137-1	0	1827	ENST00000682079.1	451	5932	++	266	P11137-1#91	0	3	ENST00000682079.1	1009	1012	+	3	0	-2	6576
P11137-1#91	0	1	1	P11137-1	186	187	+	1	P11137-1	106	1827	ENST00000673860.1	1122	6288	++	229	P11137-1#91	0	3	ENST00000673860.1	1365	1368	+	3	0	-2	6577
P11137-1#91	0	1	1	P11137-1	186	187	+	1	P11137-1	0	1827	ENST00000447185.5	0	5469	++	97	P11137-1#91	0	3	ENST00000447185.5	546	549	+	3	0	-2	6578
P11137-1#91	0	1	1	P11137-1	186	187	+	1	P11137-1	106	485	ENST00000445941.5	879	2019	++	96	P11137-1#91	0	3	ENST00000445941.5	1122	1125	+	3	0	-2	6579
P11137-1#91	0	1	1	P11137-1	186	187	+	1	P11137-1	0	1827	ENST00000360351.8	506	5987	++	39	P11137-1#91	0	3	ENST00000360351.8	1064	1067	+	3	0	-2	6580
P11137-1#92	0	1	1	P11137-1	1111	1112	+	1	P11137-1	0	1827	ENST00000704357.1	451	6025	++	271	P11137-1#92	0	3	ENST00000704357.1	3784	3787	+	3	0	-2	6581
P11137-1#92	0	1	1	P11137-1	1111	1112	+	1	P11137-1	0	1827	ENST00000682079.1	451	5932	++	266	P11137-1#92	0	3	ENST00000682079.1	3784	3787	+	3	0	-2	6582
P11137-1#92	0	1	1	P11137-1	1111	1112	+	1	P11137-1	106	1827	ENST00000673860.1	1122	6288	++	229	P11137-1#92	0	3	ENST00000673860.1	4140	4143	+	3	0	-2	6583
P11137-1#92	0	1	1	P11137-1	1111	1112	+	1	P11137-1	0	1827	ENST00000447185.5	0	5469	++	97	P11137-1#92	0	3	ENST00000447185.5	3321	3324	+	3	0	-2	6584
P11137-1#92	0	1	1	P11137-1	1111	1112	+	1	P11137-1	0	1827	ENST00000360351.8	506	5987	++	39	P11137-1#92	0	3	ENST00000360351.8	3839	3842	+	3	0	-2	6585
P11137-1#93	0	1	1	P11137-1	1654	1655	+	1	P11137-1	0	1827	ENST00000704357.1	451	6025	++	271	P11137-1#93	0	3	ENST00000704357.1	5413	5416	+	3	0	-2	6586
P11137-1#93	0	1	1	P11137-1	1654	1655	+	1	P11137-1	0	1827	ENST00000682079.1	451	5932	++	266	P11137-1#93	0	3	ENST00000682079.1	5413	5416	+	3	0	-2	6587
P11137-1#93	0	1	1	P11137-1	1654	1655	+	1	P11137-1	106	1827	ENST00000673860.1	1122	6288	++	229	P11137-1#93	0	3	ENST00000673860.1	5769	5772	+	3	0	-2	6588
P11137-1#93	0	1	1	P11137-1	1654	1655	+	1	P11137-1	0	1827	ENST00000447185.5	0	5469	++	97	P11137-1#93	0	3	ENST00000447185.5	4950	4953	+	3	0	-2	6589
P11137-1#93	0	1	1	P11137-1	1654	1655	+	1	P11137-1	1507	1827	ENST00000392194.5	619	1579	++	60	P11137-1#93	0	3	ENST00000392194.5	1060	1063	+	3	0	-2	6590
P11137-1#93	0	1	1	P11137-1	1654	1655	+	1	P11137-1	1507	1827	ENST00000361559.8	949	1909	++	41	P11137-1#93	0	3	ENST00000361559.8	1390	1393	+	3	0	-2	6591
P11137-1#93	0	1	1	P11137-1	1654	1655	+	1	P11137-1	0	1827	ENST00000360351.8	506	5987	++	39	P11137-1#93	0	3	ENST00000360351.8	5468	5471	+	3	0	-2	6592
P11137-1#94	0	2	2	P11137-1	1714	1716	+	2	P11137-1	0	1827	ENST00000704357.1	451	6025	++	271	P11137-1#94	0	6	ENST00000704357.1	5686	5692	+	6	0	-4	6593
P11137-1#94	0	2	2	P11137-1	1714	1716	+	2	P11137-1	0	1827	ENST00000682079.1	451	5932	++	266	P11137-1#94	0	6	ENST00000682079.1	5593	5599	+	6	0	-4	6594
P11137-1#94	0	2	2	P11137-1	1714	1716	+	2	P11137-1	106	1827	ENST00000673860.1	1122	6288	++	229	P11137-1#94	0	6	ENST00000673860.1	5949	5955	+	6	0	-4	6595
P11137-1#94	0	2	2	P11137-1	1714	1716	+	2	P11137-1	0	1827	ENST00000447185.5	0	5469	++	97	P11137-1#94	0	6	ENST00000447185.5	5130	5136	+	6	0	-4	6596
P11137-1#94	0	2	2	P11137-1	1714	1716	+	2	P11137-1	1507	1827	ENST00000392194.5	619	1579	++	60	P11137-1#94	0	6	ENST00000392194.5	1240	1246	+	6	0	-4	6597
P11137-1#94	0	2	2	P11137-1	1714	1716	+	2	P11137-1	1507	1827	ENST00000361559.8	949	1909	++	41	P11137-1#94	0	6	ENST00000361559.8	1570	1576	+	6	0	-4	6598
P11137-1#94	0	2	2	P11137-1	1714	1716	+	2	P11137-1	0	1827	ENST00000360351.8	506	5987	++	39	P11137-1#94	0	6	ENST00000360351.8	5648	5654	+	6	0	-4	6599
P11137-1#95	0	1	1	P11137-1	1735	1736	+	1	P11137-1	0	1827	ENST00000704357.1	451	6025	++	271	P11137-1#95	0	3	ENST00000704357.1	5749	5752	+	3	0	-2	6600
P11137-1#95	0	1	1	P11137-1	1735	1736	+	1	P11137-1	0	1827	ENST00000682079.1	451	5932	++	266	P11137-1#95	0	3	ENST00000682079.1	5656	5659	+	3	0	-2	6601
P11137-1#95	0	1	1	P11137-1	1735	1736	+	1	P11137-1	106	1827	ENST00000673860.1	1122	6288	++	229	P11137-1#95	0	3	ENST00000673860.1	6012	6015	+	3	0	-2	6602
P11137-1#95	0	1	1	P11137-1	1735	1736	+	1	P11137-1	0	1827	ENST00000447185.5	0	5469	++	97	P11137-1#95	0	3	ENST00000447185.5	5193	5196	+	3	0	-2	6603
P11137-1#95	0	1	1	P11137-1	1735	1736	+	1	P11137-1	1507	1827	ENST00000392194.5	619	1579	++	60	P11137-1#95	0	3	ENST00000392194.5	1303	1306	+	3	0	-2	6604
P11137-1#95	0	1	1	P11137-1	1735	1736	+	1	P11137-1	1507	1827	ENST00000361559.8	949	1909	++	41	P11137-1#95	0	3	ENST00000361559.8	1633	1636	+	3	0	-2	6605
P11137-1#95	0	1	1	P11137-1	1735	1736	+	1	P11137-1	0	1827	ENST00000360351.8	506	5987	++	39	P11137-1#95	0	3	ENST00000360351.8	5711	5714	+	3	0	-2	6606
P11137-1#96	0	1	1	P11137-1	66	67	+	1	P11137-1	0	1827	ENST00000704357.1	451	6025	++	271	P11137-1#96	0	3	ENST00000704357.1	649	652	+	3	0	-2	6607
P11137-1#96	0	1	1	P11137-1	66	67	+	1	P11137-1	0	1827	ENST00000682079.1	451	5932	++	266	P11137-1#96	0	3	ENST00000682079.1	649	652	+	3	0	-2	6608
P11137-1#96	0	1	1	P11137-1	66	67	+	1	P11137-1	0	1827	ENST00000447185.5	0	5469	++	97	P11137-1#96	0	3	ENST00000447185.5	198	201	+	3	0	-2	6609
P11137-1#96	0	1	1	P11137-1	66	67	+	1	P11137-1	0	106	ENST00000392193.5	295	613	++	59	P11137-1#96	0	3	ENST00000392193.5	493	496	+	3	0	-2	6610
P11137-1#96	0	1	1	P11137-1	66	67	+	1	P11137-1	0	1827	ENST00000360351.8	506	5987	++	39	P11137-1#96	0	3	ENST00000360351.8	704	707	+	3	0	-2	6611
P11137-1#97	0	1	1	P11137-1	322	323	+	1	P11137-1	0	1827	ENST00000704357.1	451	6025	++	271	P11137-1#97	0	3	ENST00000704357.1	1417	1420	+	3	0	-2	6612
P11137-1#97	0	1	1	P11137-1	322	323	+	1	P11137-1	0	1827	ENST00000682079.1	451	5932	++	266	P11137-1#97	0	3	ENST00000682079.1	1417	1420	+	3	0	-2	6613
P11137-1#97	0	1	1	P11137-1	322	323	+	1	P11137-1	106	1827	ENST00000673860.1	1122	6288	++	229	P11137-1#97	0	3	ENST00000673860.1	1773	1776	+	3	0	-2	6614
P11137-1#97	0	1	1	P11137-1	322	323	+	1	P11137-1	0	1827	ENST00000447185.5	0	5469	++	97	P11137-1#97	0	3	ENST00000447185.5	954	957	+	3	0	-2	6615
P11137-1#97	0	1	1	P11137-1	322	323	+	1	P11137-1	106	485	ENST00000445941.5	879	2019	++	96	P11137-1#97	0	3	ENST00000445941.5	1530	1533	+	3	0	-2	6616
P11137-1#97	0	1	1	P11137-1	322	323	+	1	P11137-1	0	1827	ENST00000360351.8	506	5987	++	39	P11137-1#97	0	3	ENST00000360351.8	1472	1475	+	3	0	-2	6617
P11137-1#98	0	1	1	P11137-1	353	354	+	1	P11137-1	0	1827	ENST00000704357.1	451	6025	++	271	P11137-1#98	0	3	ENST00000704357.1	1510	1513	+	3	0	-2	6618
P11137-1#98	0	1	1	P11137-1	353	354	+	1	P11137-1	0	1827	ENST00000682079.1	451	5932	++	266	P11137-1#98	0	3	ENST00000682079.1	1510	1513	+	3	0	-2	6619
P11137-1#98	0	1	1	P11137-1	353	354	+	1	P11137-1	106	1827	ENST00000673860.1	1122	6288	++	229	P11137-1#98	0	3	ENST00000673860.1	1866	1869	+	3	0	-2	6620
P11137-1#98	0	1	1	P11137-1	353	354	+	1	P11137-1	0	1827	ENST00000447185.5	0	5469	++	97	P11137-1#98	0	3	ENST00000447185.5	1047	1050	+	3	0	-2	6621
P11137-1#98	0	1	1	P11137-1	353	354	+	1	P11137-1	106	485	ENST00000445941.5	879	2019	++	96	P11137-1#98	0	3	ENST00000445941.5	1623	1626	+	3	0	-2	6622
P11137-1#98	0	1	1	P11137-1	353	354	+	1	P11137-1	0	1827	ENST00000360351.8	506	5987	++	39	P11137-1#98	0	3	ENST00000360351.8	1565	1568	+	3	0	-2	6623
P11137-1#99	0	1	1	P11137-1	385	386	+	1	P11137-1	0	1827	ENST00000704357.1	451	6025	++	271	P11137-1#99	0	3	ENST00000704357.1	1606	1609	+	3	0	-2	6624
P11137-1#99	0	1	1	P11137-1	385	386	+	1	P11137-1	0	1827	ENST00000682079.1	451	5932	++	266	P11137-1#99	0	3	ENST00000682079.1	1606	1609	+	3	0	-2	6625
P11137-1#99	0	1	1	P11137-1	385	386	+	1	P11137-1	106	1827	ENST00000673860.1	1122	6288	++	229	P11137-1#99	0	3	ENST00000673860.1	1962	1965	+	3	0	-2	6626
P11137-1#99	0	1	1	P11137-1	385	386	+	1	P11137-1	0	1827	ENST00000447185.5	0	5469	++	97	P11137-1#99	0	3	ENST00000447185.5	1143	1146	+	3	0	-2	6627
P11137-1#99	0	1	1	P11137-1	385	386	+	1	P11137-1	106	485	ENST00000445941.5	879	2019	++	96	P11137-1#99	0	3	ENST00000445941.5	1719	1722	+	3	0	-2	6628
P11137-1#99	0	1	1	P11137-1	385	386	+	1	P11137-1	0	1827	ENST00000360351.8	506	5987	++	39	P11137-1#99	0	3	ENST00000360351.8	1661	1664	+	3	0	-2	6629
P51809-1#0	0	1	1	P51809-1	0	1	+	1	P51809-1	0	51	ENST00000488344.6_PAR_Y	98	251	++	118	P51809-1#0	0	3	ENST00000488344.6_PAR_Y	98	101	+	3	0	-2	6630
P51809-1#0	0	1	1	P51809-1	0	1	+	1	P51809-1	0	51	ENST00000488344.6	98	251	++	117	P51809-1#0	0	3	ENST00000488344.6	98	101	+	3	0	-2	6631
P51809-1#0	0	1	1	P51809-1	0	1	+	1	P51809-1	0	220	ENST00000460621.6_PAR_Y	80	617	++	108	P51809-1#0	0	3	ENST00000460621.6_PAR_Y	80	83	+	3	0	-2	6632
P51809-1#0	0	1	1	P51809-1	0	1	+	1	P51809-1	0	220	ENST00000460621.6	80	617	++	107	P51809-1#0	0	3	ENST00000460621.6	80	83	+	3	0	-2	6633
P51809-1#0	0	1	1	P51809-1	0	1	+	1	P51809-1	0	220	ENST00000286448.12_PAR_Y	113	773	++	17	P51809-1#0	0	3	ENST00000286448.12_PAR_Y	113	116	+	3	0	-2	6634
P51809-1#0	0	1	1	P51809-1	0	1	+	1	P51809-1	0	220	ENST00000286448.12	113	773	++	16	P51809-1#0	0	3	ENST00000286448.12	113	116	+	3	0	-2	6635
P51809-1#0	0	1	1	P51809-1	0	1	+	1	P51809-1	0	220	ENST00000262640.11_PAR_Y	83	675	++	9	P51809-1#0	0	3	ENST00000262640.11_PAR_Y	83	86	+	3	0	-2	6636
P51809-1#0	0	1	1	P51809-1	0	1	+	1	P51809-1	0	220	ENST00000262640.11	83	675	++	8	P51809-1#0	0	3	ENST00000262640.11	83	86	+	3	0	-2	6637
P51809-1#1	0	219	219	P51809-1	1	220	+	219	P51809-1	0	51	ENST00000488344.6_PAR_Y	98	251	++	118	P51809-1#1	0	150	ENST00000488344.6_PAR_Y	101	251	+	150	0	69	6638
P51809-1#1	0	219	219	P51809-1	1	220	+	219	P51809-1	0	51	ENST00000488344.6	98	251	++	117	P51809-1#1	0	150	ENST00000488344.6	101	251	+	150	0	69	6639
P51809-1#1	0	219	219	P51809-1	1	220	+	219	P51809-1	0	220	ENST00000460621.6_PAR_Y	80	617	++	108	P51809-1#1	0	657	ENST00000460621.6_PAR_Y	83	617	+	534	0	-438	6640
P51809-1#1	0	219	219	P51809-1	1	220	+	219	P51809-1	0	220	ENST00000460621.6	80	617	++	107	P51809-1#1	0	657	ENST00000460621.6	83	617	+	534	0	-438	6641
P51809-1#1	0	219	219	P51809-1	1	220	+	219	P51809-1	0	220	ENST00000286448.12_PAR_Y	113	773	++	17	P51809-1#1	0	657	ENST00000286448.12_PAR_Y	116	773	+	657	0	-438	6642
P51809-1#1	0	219	219	P51809-1	1	220	+	219	P51809-1	0	220	ENST00000286448.12	113	773	++	16	P51809-1#1	0	657	ENST00000286448.12	116	773	+	657	0	-438	6643
P51809-1#1	0	219	219	P51809-1	1	220	+	219	P51809-1	0	220	ENST00000262640.11_PAR_Y	83	675	++	9	P51809-1#1	0	657	ENST00000262640.11_PAR_Y	86	675	+	588	0	-438	6644
P51809-1#1	0	219	219	P51809-1	1	220	+	219	P51809-1	0	220	ENST00000262640.11	83	675	++	8	P51809-1#1	0	657	ENST00000262640.11	86	675	+	588	0	-438	6645
P51809-1#2	0	187	187	P51809-1	1	188	+	187	P51809-1	0	51	ENST00000488344.6_PAR_Y	98	251	++	118	P51809-1#2	0	150	ENST00000488344.6_PAR_Y	101	251	+	150	0	37	6646
P51809-1#2	0	187	187	P51809-1	1	188	+	187	P51809-1	0	51	ENST00000488344.6	98	251	++	117	P51809-1#2	0	150	ENST00000488344.6	101	251	+	150	0	37	6647
P51809-1#2	0	187	187	P51809-1	1	188	+	187	P51809-1	0	220	ENST00000460621.6_PAR_Y	80	617	++	108	P51809-1#2	0	561	ENST00000460621.6_PAR_Y	83	521	+	438	0	-374	6648
P51809-1#2	0	187	187	P51809-1	1	188	+	187	P51809-1	0	220	ENST00000460621.6	80	617	++	107	P51809-1#2	0	561	ENST00000460621.6	83	521	+	438	0	-374	6649
P51809-1#2	0	187	187	P51809-1	1	188	+	187	P51809-1	0	220	ENST00000286448.12_PAR_Y	113	773	++	17	P51809-1#2	0	561	ENST00000286448.12_PAR_Y	116	677	+	561	0	-374	6650
P51809-1#2	0	187	187	P51809-1	1	188	+	187	P51809-1	0	220	ENST00000286448.12	113	773	++	16	P51809-1#2	0	561	ENST00000286448.12	116	677	+	561	0	-374	6651
P51809-1#2	0	187	187	P51809-1	1	188	+	187	P51809-1	0	220	ENST00000262640.11_PAR_Y	83	675	++	9	P51809-1#2	0	561	ENST00000262640.11_PAR_Y	86	579	+	492	0	-374	6652
P51809-1#2	0	187	187	P51809-1	1	188	+	187	P51809-1	0	220	ENST00000262640.11	83	675	++	8	P51809-1#2	0	561	ENST00000262640.11	86	579	+	492	0	-374	6653
P51809-1#3	0	21	21	P51809-1	188	209	+	21	P51809-1	0	220	ENST00000460621.6_PAR_Y	80	617	++	108	P51809-1#3	0	63	ENST00000460621.6_PAR_Y	521	584	+	63	0	-42	6654
P51809-1#3	0	21	21	P51809-1	188	209	+	21	P51809-1	0	220	ENST00000460621.6	80	617	++	107	P51809-1#3	0	63	ENST00000460621.6	521	584	+	63	0	-42	6655
P51809-1#3	0	21	21	P51809-1	188	209	+	21	P51809-1	0	220	ENST00000286448.12_PAR_Y	113	773	++	17	P51809-1#3	0	63	ENST00000286448.12_PAR_Y	677	740	+	63	0	-42	6656
P51809-1#3	0	21	21	P51809-1	188	209	+	21	P51809-1	0	220	ENST00000286448.12	113	773	++	16	P51809-1#3	0	63	ENST00000286448.12	677	740	+	63	0	-42	6657
P51809-1#3	0	21	21	P51809-1	188	209	+	21	P51809-1	0	220	ENST00000262640.11_PAR_Y	83	675	++	9	P51809-1#3	0	63	ENST00000262640.11_PAR_Y	579	642	+	63	0	-42	6658
P51809-1#3	0	21	21	P51809-1	188	209	+	21	P51809-1	0	220	ENST00000262640.11	83	675	++	8	P51809-1#3	0	63	ENST00000262640.11	579	642	+	63	0	-42	6659
P51809-1#4	0	11	11	P51809-1	209	220	+	11	P51809-1	0	220	ENST00000460621.6_PAR_Y	80	617	++	108	P51809-1#4	0	33	ENST00000460621.6_PAR_Y	584	617	+	33	0	-22	6660
P51809-1#4	0	11	11	P51809-1	209	220	+	11	P51809-1	0	220	ENST00000460621.6	80	617	++	107	P51809-1#4	0	33	ENST00000460621.6	584	617	+	33	0	-22	6661
P51809-1#4	0	11	11	P51809-1	209	220	+	11	P51809-1	0	220	ENST00000286448.12_PAR_Y	113	773	++	17	P51809-1#4	0	33	ENST00000286448.12_PAR_Y	740	773	+	33	0	-22	6662
P51809-1#4	0	11	11	P51809-1	209	220	+	11	P51809-1	0	220	ENST00000286448.12	113	773	++	16	P51809-1#4	0	33	ENST00000286448.12	740	773	+	33	0	-22	6663
P51809-1#4	0	11	11	P51809-1	209	220	+	11	P51809-1	0	220	ENST00000262640.11_PAR_Y	83	675	++	9	P51809-1#4	0	33	ENST00000262640.11_PAR_Y	642	675	+	33	0	-22	6664
P51809-1#4	0	11	11	P51809-1	209	220	+	11	P51809-1	0	220	ENST00000262640.11	83	675	++	8	P51809-1#4	0	33	ENST00000262640.11	642	675	+	33	0	-22	6665
P51809-1#5	0	104	104	P51809-1	6	110	+	104	P51809-1	0	51	ENST00000488344.6_PAR_Y	98	251	++	118	P51809-1#5	0	135	ENST00000488344.6_PAR_Y	116	251	+	135	0	-31	6666
P51809-1#5	0	104	104	P51809-1	6	110	+	104	P51809-1	0	51	ENST00000488344.6	98	251	++	117	P51809-1#5	0	135	ENST00000488344.6	116	251	+	135	0	-31	6667
P51809-1#5	0	104	104	P51809-1	6	110	+	104	P51809-1	0	220	ENST00000460621.6_PAR_Y	80	617	++	108	P51809-1#5	0	312	ENST00000460621.6_PAR_Y	98	287	+	189	0	-208	6668
P51809-1#5	0	104	104	P51809-1	6	110	+	104	P51809-1	0	220	ENST00000460621.6	80	617	++	107	P51809-1#5	0	312	ENST00000460621.6	98	287	+	189	0	-208	6669
P51809-1#5	0	104	104	P51809-1	6	110	+	104	P51809-1	0	220	ENST00000286448.12_PAR_Y	113	773	++	17	P51809-1#5	0	312	ENST00000286448.12_PAR_Y	131	443	+	312	0	-208	6670
P51809-1#5	0	104	104	P51809-1	6	110	+	104	P51809-1	0	220	ENST00000286448.12	113	773	++	16	P51809-1#5	0	312	ENST00000286448.12	131	443	+	312	0	-208	6671
P51809-1#5	0	104	104	P51809-1	6	110	+	104	P51809-1	0	220	ENST00000262640.11_PAR_Y	83	675	++	9	P51809-1#5	0	312	ENST00000262640.11_PAR_Y	101	413	+	312	0	-208	6672
P51809-1#5	0	104	104	P51809-1	6	110	+	104	P51809-1	0	220	ENST00000262640.11	83	675	++	8	P51809-1#5	0	312	ENST00000262640.11	101	413	+	312	0	-208	6673
P51809-1#6	0	61	61	P51809-1	124	185	+	61	P51809-1	0	220	ENST00000460621.6_PAR_Y	80	617	++	108	P51809-1#6	0	183	ENST00000460621.6_PAR_Y	329	512	+	183	0	-122	6674
P51809-1#6	0	61	61	P51809-1	124	185	+	61	P51809-1	0	220	ENST00000460621.6	80	617	++	107	P51809-1#6	0	183	ENST00000460621.6	329	512	+	183	0	-122	6675
P51809-1#6	0	61	61	P51809-1	124	185	+	61	P51809-1	0	220	ENST00000286448.12_PAR_Y	113	773	++	17	P51809-1#6	0	183	ENST00000286448.12_PAR_Y	485	668	+	183	0	-122	6676
P51809-1#6	0	61	61	P51809-1	124	185	+	61	P51809-1	0	220	ENST00000286448.12	113	773	++	16	P51809-1#6	0	183	ENST00000286448.12	485	668	+	183	0	-122	6677
P51809-1#6	0	61	61	P51809-1	124	185	+	61	P51809-1	0	220	ENST00000262640.11_PAR_Y	83	675	++	9	P51809-1#6	0	183	ENST00000262640.11_PAR_Y	455	570	+	114	0	-122	6678
P51809-1#6	0	61	61	P51809-1	124	185	+	61	P51809-1	0	220	ENST00000262640.11	83	675	++	8	P51809-1#6	0	183	ENST00000262640.11	455	570	+	114	0	-122	6679
P51809-1#7	0	1	1	P51809-1	1	2	+	1	P51809-1	0	51	ENST00000488344.6_PAR_Y	98	251	++	118	P51809-1#7	0	3	ENST00000488344.6_PAR_Y	101	104	+	3	0	-2	6680
P51809-1#7	0	1	1	P51809-1	1	2	+	1	P51809-1	0	51	ENST00000488344.6	98	251	++	117	P51809-1#7	0	3	ENST00000488344.6	101	104	+	3	0	-2	6681
P51809-1#7	0	1	1	P51809-1	1	2	+	1	P51809-1	0	220	ENST00000460621.6_PAR_Y	80	617	++	108	P51809-1#7	0	3	ENST00000460621.6_PAR_Y	83	86	+	3	0	-2	6682
P51809-1#7	0	1	1	P51809-1	1	2	+	1	P51809-1	0	220	ENST00000460621.6	80	617	++	107	P51809-1#7	0	3	ENST00000460621.6	83	86	+	3	0	-2	6683
P51809-1#7	0	1	1	P51809-1	1	2	+	1	P51809-1	0	220	ENST00000286448.12_PAR_Y	113	773	++	17	P51809-1#7	0	3	ENST00000286448.12_PAR_Y	116	119	+	3	0	-2	6684
P51809-1#7	0	1	1	P51809-1	1	2	+	1	P51809-1	0	220	ENST00000286448.12	113	773	++	16	P51809-1#7	0	3	ENST00000286448.12	116	119	+	3	0	-2	6685
P51809-1#7	0	1	1	P51809-1	1	2	+	1	P51809-1	0	220	ENST00000262640.11_PAR_Y	83	675	++	9	P51809-1#7	0	3	ENST00000262640.11_PAR_Y	86	89	+	3	0	-2	6686
P51809-1#7	0	1	1	P51809-1	1	2	+	1	P51809-1	0	220	ENST00000262640.11	83	675	++	8	P51809-1#7	0	3	ENST00000262640.11	86	89	+	3	0	-2	6687
P51809-1#8	0	1	1	P51809-1	166	167	+	1	P51809-1	0	220	ENST00000460621.6_PAR_Y	80	617	++	108	P51809-1#8	0	3	ENST00000460621.6_PAR_Y	455	458	+	3	0	-2	6688
P51809-1#8	0	1	1	P51809-1	166	167	+	1	P51809-1	0	220	ENST00000460621.6	80	617	++	107	P51809-1#8	0	3	ENST00000460621.6	455	458	+	3	0	-2	6689
P51809-1#8	0	1	1	P51809-1	166	167	+	1	P51809-1	0	220	ENST00000286448.12_PAR_Y	113	773	++	17	P51809-1#8	0	3	ENST00000286448.12_PAR_Y	611	614	+	3	0	-2	6690
P51809-1#8	0	1	1	P51809-1	166	167	+	1	P51809-1	0	220	ENST00000286448.12	113	773	++	16	P51809-1#8	0	3	ENST00000286448.12	611	614	+	3	0	-2	6691
P51809-1#9	0	1	1	P51809-1	167	168	+	1	P51809-1	0	220	ENST00000460621.6_PAR_Y	80	617	++	108	P51809-1#9	0	3	ENST00000460621.6_PAR_Y	458	461	+	3	0	-2	6692
P51809-1#9	0	1	1	P51809-1	167	168	+	1	P51809-1	0	220	ENST00000460621.6	80	617	++	107	P51809-1#9	0	3	ENST00000460621.6	458	461	+	3	0	-2	6693
P51809-1#9	0	1	1	P51809-1	167	168	+	1	P51809-1	0	220	ENST00000286448.12_PAR_Y	113	773	++	17	P51809-1#9	0	3	ENST00000286448.12_PAR_Y	614	617	+	3	0	-2	6694
P51809-1#9	0	1	1	P51809-1	167	168	+	1	P51809-1	0	220	ENST00000286448.12	113	773	++	16	P51809-1#9	0	3	ENST00000286448.12	614	617	+	3	0	-2	6695
P51809-1#9	0	1	1	P51809-1	167	168	+	1	P51809-1	0	220	ENST00000262640.11_PAR_Y	83	675	++	9	P51809-1#9	0	3	ENST00000262640.11_PAR_Y	516	519	+	3	0	-2	6696
P51809-1#9	0	1	1	P51809-1	167	168	+	1	P51809-1	0	220	ENST00000262640.11	83	675	++	8	P51809-1#9	0	3	ENST00000262640.11	516	519	+	3	0	-2	6697
P51809-1#10	0	41	41	P51809-1	27	68	+	41	P51809-1	0	51	ENST00000488344.6_PAR_Y	98	251	++	118	P51809-1#10	0	72	ENST00000488344.6_PAR_Y	179	251	+	72	0	-31	6698
P51809-1#10	0	41	41	P51809-1	27	68	+	41	P51809-1	0	51	ENST00000488344.6	98	251	++	117	P51809-1#10	0	72	ENST00000488344.6	179	251	+	72	0	-31	6699
P51809-1#10	0	41	41	P51809-1	27	68	+	41	P51809-1	0	220	ENST00000286448.12_PAR_Y	113	773	++	17	P51809-1#10	0	123	ENST00000286448.12_PAR_Y	194	317	+	123	0	-82	6700
P51809-1#10	0	41	41	P51809-1	27	68	+	41	P51809-1	0	220	ENST00000286448.12	113	773	++	16	P51809-1#10	0	123	ENST00000286448.12	194	317	+	123	0	-82	6701
P51809-1#10	0	41	41	P51809-1	27	68	+	41	P51809-1	0	220	ENST00000262640.11_PAR_Y	83	675	++	9	P51809-1#10	0	123	ENST00000262640.11_PAR_Y	164	287	+	123	0	-82	6702
P51809-1#10	0	41	41	P51809-1	27	68	+	41	P51809-1	0	220	ENST00000262640.11	83	675	++	8	P51809-1#10	0	123	ENST00000262640.11	164	287	+	123	0	-82	6703
P51809-1#11	0	76	76	P51809-1	144	220	+	76	P51809-1	0	220	ENST00000460621.6_PAR_Y	80	617	++	108	P51809-1#11	0	228	ENST00000460621.6_PAR_Y	389	617	+	228	0	-152	6704
P51809-1#11	0	76	76	P51809-1	144	220	+	76	P51809-1	0	220	ENST00000460621.6	80	617	++	107	P51809-1#11	0	228	ENST00000460621.6	389	617	+	228	0	-152	6705
P51809-1#11	0	76	76	P51809-1	144	220	+	76	P51809-1	0	220	ENST00000286448.12_PAR_Y	113	773	++	17	P51809-1#11	0	228	ENST00000286448.12_PAR_Y	545	773	+	228	0	-152	6706
P51809-1#11	0	76	76	P51809-1	144	220	+	76	P51809-1	0	220	ENST00000286448.12	113	773	++	16	P51809-1#11	0	228	ENST00000286448.12	545	773	+	228	0	-152	6707
P51809-1#11	0	76	76	P51809-1	144	220	+	76	P51809-1	0	220	ENST00000262640.11_PAR_Y	83	675	++	9	P51809-1#11	69	228	ENST00000262640.11_PAR_Y	516	675	+	159	69	-152	6708
P51809-1#11	0	76	76	P51809-1	144	220	+	76	P51809-1	0	220	ENST00000262640.11	83	675	++	8	P51809-1#11	69	228	ENST00000262640.11	516	675	+	159	69	-152	6709
P51809-1#12	0	1	1	P51809-1	97	98	+	1	P51809-1	0	220	ENST00000460621.6_PAR_Y	80	617	++	108	P51809-1#12	0	3	ENST00000460621.6_PAR_Y	248	251	+	3	0	-2	6710
P51809-1#12	0	1	1	P51809-1	97	98	+	1	P51809-1	0	220	ENST00000460621.6	80	617	++	107	P51809-1#12	0	3	ENST00000460621.6	248	251	+	3	0	-2	6711
P51809-1#12	0	1	1	P51809-1	97	98	+	1	P51809-1	0	220	ENST00000286448.12_PAR_Y	113	773	++	17	P51809-1#12	0	3	ENST00000286448.12_PAR_Y	404	407	+	3	0	-2	6712
P51809-1#12	0	1	1	P51809-1	97	98	+	1	P51809-1	0	220	ENST00000286448.12	113	773	++	16	P51809-1#12	0	3	ENST00000286448.12	404	407	+	3	0	-2	6713
P51809-1#12	0	1	1	P51809-1	97	98	+	1	P51809-1	0	220	ENST00000262640.11_PAR_Y	83	675	++	9	P51809-1#12	0	3	ENST00000262640.11_PAR_Y	374	377	+	3	0	-2	6714
P51809-1#12	0	1	1	P51809-1	97	98	+	1	P51809-1	0	220	ENST00000262640.11	83	675	++	8	P51809-1#12	0	3	ENST00000262640.11	374	377	+	3	0	-2	6715
P51809-1#13	0	6	6	P51809-1	4	10	+	6	P51809-1	0	51	ENST00000488344.6_PAR_Y	98	251	++	118	P51809-1#13	0	18	ENST00000488344.6_PAR_Y	110	128	+	18	0	-12	6716
P51809-1#13	0	6	6	P51809-1	4	10	+	6	P51809-1	0	51	ENST00000488344.6	98	251	++	117	P51809-1#13	0	18	ENST00000488344.6	110	128	+	18	0	-12	6717
P51809-1#13	0	6	6	P51809-1	4	10	+	6	P51809-1	0	220	ENST00000460621.6_PAR_Y	80	617	++	108	P51809-1#13	0	18	ENST00000460621.6_PAR_Y	92	110	+	18	0	-12	6718
P51809-1#13	0	6	6	P51809-1	4	10	+	6	P51809-1	0	220	ENST00000460621.6	80	617	++	107	P51809-1#13	0	18	ENST00000460621.6	92	110	+	18	0	-12	6719
P51809-1#13	0	6	6	P51809-1	4	10	+	6	P51809-1	0	220	ENST00000286448.12_PAR_Y	113	773	++	17	P51809-1#13	0	18	ENST00000286448.12_PAR_Y	125	143	+	18	0	-12	6720
P51809-1#13	0	6	6	P51809-1	4	10	+	6	P51809-1	0	220	ENST00000286448.12	113	773	++	16	P51809-1#13	0	18	ENST00000286448.12	125	143	+	18	0	-12	6721
P51809-1#13	0	6	6	P51809-1	4	10	+	6	P51809-1	0	220	ENST00000262640.11_PAR_Y	83	675	++	9	P51809-1#13	0	18	ENST00000262640.11_PAR_Y	95	113	+	18	0	-12	6722
P51809-1#13	0	6	6	P51809-1	4	10	+	6	P51809-1	0	220	ENST00000262640.11	83	675	++	8	P51809-1#13	0	18	ENST00000262640.11	95	113	+	18	0	-12	6723
P51809-1#14	0	7	7	P51809-1	12	19	+	7	P51809-1	0	51	ENST00000488344.6_PAR_Y	98	251	++	118	P51809-1#14	0	21	ENST00000488344.6_PAR_Y	134	155	+	21	0	-14	6724
P51809-1#14	0	7	7	P51809-1	12	19	+	7	P51809-1	0	51	ENST00000488344.6	98	251	++	117	P51809-1#14	0	21	ENST00000488344.6	134	155	+	21	0	-14	6725
P51809-1#14	0	7	7	P51809-1	12	19	+	7	P51809-1	0	220	ENST00000460621.6_PAR_Y	80	617	++	108	P51809-1#14	0	21	ENST00000460621.6_PAR_Y	116	137	+	21	0	-14	6726
P51809-1#14	0	7	7	P51809-1	12	19	+	7	P51809-1	0	220	ENST00000460621.6	80	617	++	107	P51809-1#14	0	21	ENST00000460621.6	116	137	+	21	0	-14	6727
P51809-1#14	0	7	7	P51809-1	12	19	+	7	P51809-1	0	220	ENST00000286448.12_PAR_Y	113	773	++	17	P51809-1#14	0	21	ENST00000286448.12_PAR_Y	149	170	+	21	0	-14	6728
P51809-1#14	0	7	7	P51809-1	12	19	+	7	P51809-1	0	220	ENST00000286448.12	113	773	++	16	P51809-1#14	0	21	ENST00000286448.12	149	170	+	21	0	-14	6729
P51809-1#14	0	7	7	P51809-1	12	19	+	7	P51809-1	0	220	ENST00000262640.11_PAR_Y	83	675	++	9	P51809-1#14	0	21	ENST00000262640.11_PAR_Y	119	140	+	21	0	-14	6730
P51809-1#14	0	7	7	P51809-1	12	19	+	7	P51809-1	0	220	ENST00000262640.11	83	675	++	8	P51809-1#14	0	21	ENST00000262640.11	119	140	+	21	0	-14	6731
P51809-1#15	0	3	3	P51809-1	20	23	+	3	P51809-1	0	51	ENST00000488344.6_PAR_Y	98	251	++	118	P51809-1#15	0	9	ENST00000488344.6_PAR_Y	158	167	+	9	0	-6	6732
P51809-1#15	0	3	3	P51809-1	20	23	+	3	P51809-1	0	51	ENST00000488344.6	98	251	++	117	P51809-1#15	0	9	ENST00000488344.6	158	167	+	9	0	-6	6733
P51809-1#15	0	3	3	P51809-1	20	23	+	3	P51809-1	0	220	ENST00000460621.6_PAR_Y	80	617	++	108	P51809-1#15	0	9	ENST00000460621.6_PAR_Y	140	149	+	9	0	-6	6734
P51809-1#15	0	3	3	P51809-1	20	23	+	3	P51809-1	0	220	ENST00000460621.6	80	617	++	107	P51809-1#15	0	9	ENST00000460621.6	140	149	+	9	0	-6	6735
P51809-1#15	0	3	3	P51809-1	20	23	+	3	P51809-1	0	220	ENST00000286448.12_PAR_Y	113	773	++	17	P51809-1#15	0	9	ENST00000286448.12_PAR_Y	173	182	+	9	0	-6	6736
P51809-1#15	0	3	3	P51809-1	20	23	+	3	P51809-1	0	220	ENST00000286448.12	113	773	++	16	P51809-1#15	0	9	ENST00000286448.12	173	182	+	9	0	-6	6737
P51809-1#15	0	3	3	P51809-1	20	23	+	3	P51809-1	0	220	ENST00000262640.11_PAR_Y	83	675	++	9	P51809-1#15	0	9	ENST00000262640.11_PAR_Y	143	152	+	9	0	-6	6738
P51809-1#15	0	3	3	P51809-1	20	23	+	3	P51809-1	0	220	ENST00000262640.11	83	675	++	8	P51809-1#15	0	9	ENST00000262640.11	143	152	+	9	0	-6	6739
P51809-1#16	0	8	8	P51809-1	25	33	+	8	P51809-1	0	51	ENST00000488344.6_PAR_Y	98	251	++	118	P51809-1#16	0	24	ENST00000488344.6_PAR_Y	173	197	+	24	0	-16	6740
P51809-1#16	0	8	8	P51809-1	25	33	+	8	P51809-1	0	51	ENST00000488344.6	98	251	++	117	P51809-1#16	0	24	ENST00000488344.6	173	197	+	24	0	-16	6741
P51809-1#16	0	8	8	P51809-1	25	33	+	8	P51809-1	0	220	ENST00000460621.6_PAR_Y	80	617	++	108	P51809-1#16	0	6	ENST00000460621.6_PAR_Y	155	161	+	6	0	2	6742
P51809-1#16	0	8	8	P51809-1	25	33	+	8	P51809-1	0	220	ENST00000460621.6	80	617	++	107	P51809-1#16	0	6	ENST00000460621.6	155	161	+	6	0	2	6743
P51809-1#16	0	8	8	P51809-1	25	33	+	8	P51809-1	0	220	ENST00000286448.12_PAR_Y	113	773	++	17	P51809-1#16	0	24	ENST00000286448.12_PAR_Y	188	212	+	24	0	-16	6744
P51809-1#16	0	8	8	P51809-1	25	33	+	8	P51809-1	0	220	ENST00000286448.12	113	773	++	16	P51809-1#16	0	24	ENST00000286448.12	188	212	+	24	0	-16	6745
P51809-1#16	0	8	8	P51809-1	25	33	+	8	P51809-1	0	220	ENST00000262640.11_PAR_Y	83	675	++	9	P51809-1#16	0	24	ENST00000262640.11_PAR_Y	158	182	+	24	0	-16	6746
P51809-1#16	0	8	8	P51809-1	25	33	+	8	P51809-1	0	220	ENST00000262640.11	83	675	++	8	P51809-1#16	0	24	ENST00000262640.11	158	182	+	24	0	-16	6747
P51809-1#17	0	3	3	P51809-1	37	40	+	3	P51809-1	0	51	ENST00000488344.6_PAR_Y	98	251	++	118	P51809-1#17	0	9	ENST00000488344.6_PAR_Y	209	218	+	9	0	-6	6748
P51809-1#17	0	3	3	P51809-1	37	40	+	3	P51809-1	0	51	ENST00000488344.6	98	251	++	117	P51809-1#17	0	9	ENST00000488344.6	209	218	+	9	0	-6	6749
P51809-1#17	0	3	3	P51809-1	37	40	+	3	P51809-1	0	220	ENST00000286448.12_PAR_Y	113	773	++	17	P51809-1#17	0	9	ENST00000286448.12_PAR_Y	224	233	+	9	0	-6	6750
P51809-1#17	0	3	3	P51809-1	37	40	+	3	P51809-1	0	220	ENST00000286448.12	113	773	++	16	P51809-1#17	0	9	ENST00000286448.12	224	233	+	9	0	-6	6751
P51809-1#17	0	3	3	P51809-1	37	40	+	3	P51809-1	0	220	ENST00000262640.11_PAR_Y	83	675	++	9	P51809-1#17	0	9	ENST00000262640.11_PAR_Y	194	203	+	9	0	-6	6752
P51809-1#17	0	3	3	P51809-1	37	40	+	3	P51809-1	0	220	ENST00000262640.11	83	675	++	8	P51809-1#17	0	9	ENST00000262640.11	194	203	+	9	0	-6	6753
P51809-1#18	0	6	6	P51809-1	41	47	+	6	P51809-1	0	51	ENST00000488344.6_PAR_Y	98	251	++	118	P51809-1#18	0	18	ENST00000488344.6_PAR_Y	221	239	+	18	0	-12	6754
P51809-1#18	0	6	6	P51809-1	41	47	+	6	P51809-1	0	51	ENST00000488344.6	98	251	++	117	P51809-1#18	0	18	ENST00000488344.6	221	239	+	18	0	-12	6755
P51809-1#18	0	6	6	P51809-1	41	47	+	6	P51809-1	0	220	ENST00000286448.12_PAR_Y	113	773	++	17	P51809-1#18	0	18	ENST00000286448.12_PAR_Y	236	254	+	18	0	-12	6756
P51809-1#18	0	6	6	P51809-1	41	47	+	6	P51809-1	0	220	ENST00000286448.12	113	773	++	16	P51809-1#18	0	18	ENST00000286448.12	236	254	+	18	0	-12	6757
P51809-1#18	0	6	6	P51809-1	41	47	+	6	P51809-1	0	220	ENST00000262640.11_PAR_Y	83	675	++	9	P51809-1#18	0	18	ENST00000262640.11_PAR_Y	206	224	+	18	0	-12	6758
P51809-1#18	0	6	6	P51809-1	41	47	+	6	P51809-1	0	220	ENST00000262640.11	83	675	++	8	P51809-1#18	0	18	ENST00000262640.11	206	224	+	18	0	-12	6759
P51809-1#19	0	8	8	P51809-1	49	57	+	8	P51809-1	0	51	ENST00000488344.6_PAR_Y	98	251	++	118	P51809-1#19	0	6	ENST00000488344.6_PAR_Y	245	251	+	6	0	2	6760
P51809-1#19	0	8	8	P51809-1	49	57	+	8	P51809-1	0	51	ENST00000488344.6	98	251	++	117	P51809-1#19	0	6	ENST00000488344.6	245	251	+	6	0	2	6761
P51809-1#19	0	8	8	P51809-1	49	57	+	8	P51809-1	0	220	ENST00000286448.12_PAR_Y	113	773	++	17	P51809-1#19	0	24	ENST00000286448.12_PAR_Y	260	284	+	24	0	-16	6762
P51809-1#19	0	8	8	P51809-1	49	57	+	8	P51809-1	0	220	ENST00000286448.12	113	773	++	16	P51809-1#19	0	24	ENST00000286448.12	260	284	+	24	0	-16	6763
P51809-1#19	0	8	8	P51809-1	49	57	+	8	P51809-1	0	220	ENST00000262640.11_PAR_Y	83	675	++	9	P51809-1#19	0	24	ENST00000262640.11_PAR_Y	230	254	+	24	0	-16	6764
P51809-1#19	0	8	8	P51809-1	49	57	+	8	P51809-1	0	220	ENST00000262640.11	83	675	++	8	P51809-1#19	0	24	ENST00000262640.11	230	254	+	24	0	-16	6765
P51809-1#20	0	11	11	P51809-1	59	70	+	11	P51809-1	0	220	ENST00000460621.6_PAR_Y	80	617	++	108	P51809-1#20	27	33	ENST00000460621.6_PAR_Y	161	167	+	6	27	-22	6766
P51809-1#20	0	11	11	P51809-1	59	70	+	11	P51809-1	0	220	ENST00000460621.6	80	617	++	107	P51809-1#20	27	33	ENST00000460621.6	161	167	+	6	27	-22	6767
P51809-1#20	0	11	11	P51809-1	59	70	+	11	P51809-1	0	220	ENST00000286448.12_PAR_Y	113	773	++	17	P51809-1#20	0	33	ENST00000286448.12_PAR_Y	290	323	+	33	0	-22	6768
P51809-1#20	0	11	11	P51809-1	59	70	+	11	P51809-1	0	220	ENST00000286448.12	113	773	++	16	P51809-1#20	0	33	ENST00000286448.12	290	323	+	33	0	-22	6769
P51809-1#20	0	11	11	P51809-1	59	70	+	11	P51809-1	0	220	ENST00000262640.11_PAR_Y	83	675	++	9	P51809-1#20	0	33	ENST00000262640.11_PAR_Y	260	293	+	33	0	-22	6770
P51809-1#20	0	11	11	P51809-1	59	70	+	11	P51809-1	0	220	ENST00000262640.11	83	675	++	8	P51809-1#20	0	33	ENST00000262640.11	260	293	+	33	0	-22	6771
P51809-1#21	0	18	18	P51809-1	71	89	+	18	P51809-1	0	220	ENST00000460621.6_PAR_Y	80	617	++	108	P51809-1#21	0	54	ENST00000460621.6_PAR_Y	170	224	+	54	0	-36	6772
P51809-1#21	0	18	18	P51809-1	71	89	+	18	P51809-1	0	220	ENST00000460621.6	80	617	++	107	P51809-1#21	0	54	ENST00000460621.6	170	224	+	54	0	-36	6773
P51809-1#21	0	18	18	P51809-1	71	89	+	18	P51809-1	0	220	ENST00000286448.12_PAR_Y	113	773	++	17	P51809-1#21	0	54	ENST00000286448.12_PAR_Y	326	380	+	54	0	-36	6774
P51809-1#21	0	18	18	P51809-1	71	89	+	18	P51809-1	0	220	ENST00000286448.12	113	773	++	16	P51809-1#21	0	54	ENST00000286448.12	326	380	+	54	0	-36	6775
P51809-1#21	0	18	18	P51809-1	71	89	+	18	P51809-1	0	220	ENST00000262640.11_PAR_Y	83	675	++	9	P51809-1#21	0	54	ENST00000262640.11_PAR_Y	296	350	+	54	0	-36	6776
P51809-1#21	0	18	18	P51809-1	71	89	+	18	P51809-1	0	220	ENST00000262640.11	83	675	++	8	P51809-1#21	0	54	ENST00000262640.11	296	350	+	54	0	-36	6777
P51809-1#22	0	5	5	P51809-1	90	95	+	5	P51809-1	0	220	ENST00000460621.6_PAR_Y	80	617	++	108	P51809-1#22	0	15	ENST00000460621.6_PAR_Y	227	242	+	15	0	-10	6778
P51809-1#22	0	5	5	P51809-1	90	95	+	5	P51809-1	0	220	ENST00000460621.6	80	617	++	107	P51809-1#22	0	15	ENST00000460621.6	227	242	+	15	0	-10	6779
P51809-1#22	0	5	5	P51809-1	90	95	+	5	P51809-1	0	220	ENST00000286448.12_PAR_Y	113	773	++	17	P51809-1#22	0	15	ENST00000286448.12_PAR_Y	383	398	+	15	0	-10	6780
P51809-1#22	0	5	5	P51809-1	90	95	+	5	P51809-1	0	220	ENST00000286448.12	113	773	++	16	P51809-1#22	0	15	ENST00000286448.12	383	398	+	15	0	-10	6781
P51809-1#22	0	5	5	P51809-1	90	95	+	5	P51809-1	0	220	ENST00000262640.11_PAR_Y	83	675	++	9	P51809-1#22	0	15	ENST00000262640.11_PAR_Y	353	368	+	15	0	-10	6782
P51809-1#22	0	5	5	P51809-1	90	95	+	5	P51809-1	0	220	ENST00000262640.11	83	675	++	8	P51809-1#22	0	15	ENST00000262640.11	353	368	+	15	0	-10	6783
P51809-1#23	0	15	15	P51809-1	102	117	+	15	P51809-1	0	220	ENST00000460621.6_PAR_Y	80	617	++	108	P51809-1#23	0	45	ENST00000460621.6_PAR_Y	263	308	+	45	0	-30	6784
P51809-1#23	0	15	15	P51809-1	102	117	+	15	P51809-1	0	220	ENST00000460621.6	80	617	++	107	P51809-1#23	0	45	ENST00000460621.6	263	308	+	45	0	-30	6785
P51809-1#23	0	15	15	P51809-1	102	117	+	15	P51809-1	0	220	ENST00000286448.12_PAR_Y	113	773	++	17	P51809-1#23	0	45	ENST00000286448.12_PAR_Y	419	464	+	45	0	-30	6786
P51809-1#23	0	15	15	P51809-1	102	117	+	15	P51809-1	0	220	ENST00000286448.12	113	773	++	16	P51809-1#23	0	45	ENST00000286448.12	419	464	+	45	0	-30	6787
P51809-1#23	0	15	15	P51809-1	102	117	+	15	P51809-1	0	220	ENST00000262640.11_PAR_Y	83	675	++	9	P51809-1#23	0	45	ENST00000262640.11_PAR_Y	389	434	+	45	0	-30	6788
P51809-1#23	0	15	15	P51809-1	102	117	+	15	P51809-1	0	220	ENST00000262640.11	83	675	++	8	P51809-1#23	0	45	ENST00000262640.11	389	434	+	45	0	-30	6789
P29274#0	0	412	412	P29274	0	412	+	412	P29274	0	412	ENST00000618076.3	524	1760	++	224	P29274#0	0	1236	ENST00000618076.3	524	1760	+	1236	0	-824	6790
P29274#0	0	412	412	P29274	0	412	+	412	P29274	0	412	ENST00000611543.4	306	1542	++	222	P29274#0	0	1236	ENST00000611543.4	306	1542	+	1236	0	-824	6791
P29274#0	0	412	412	P29274	0	412	+	412	P29274	0	412	ENST00000610595.4	630	1866	++	221	P29274#0	0	1236	ENST00000610595.4	630	1866	+	1236	0	-824	6792
P29274#0	0	412	412	P29274	0	412	+	412	P29274	0	83	ENST00000496258.1	439	688	++	123	P29274#0	0	249	ENST00000496258.1	439	688	+	249	0	163	6793
P29274#0	0	412	412	P29274	0	412	+	412	P29274	0	108	ENST00000486108.1	601	925	++	115	P29274#0	0	324	ENST00000486108.1	601	925	+	324	0	88	6794
P29274#0	0	412	412	P29274	0	412	+	412	P29274	0	29	ENST00000472248.5	630	717	++	110	P29274#0	0	87	ENST00000472248.5	630	717	+	87	0	325	6795
P29274#0	0	412	412	P29274	0	412	+	412	P29274	0	365	ENST00000444262.6	422	1517	++	92	P29274#0	0	1095	ENST00000444262.6	422	1517	+	1095	0	-683	6796
P29274#0	0	412	412	P29274	0	412	+	412	P29274	0	76	ENST00000439591.1	330	558	++	90	P29274#0	0	228	ENST00000439591.1	330	558	+	228	0	184	6797
P29274#0	0	412	412	P29274	0	412	+	412	P29274	0	64	ENST00000436735.1	476	668	++	88	P29274#0	0	192	ENST00000436735.1	476	668	+	192	0	220	6798
P29274#0	0	412	412	P29274	0	412	+	412	P29274	0	87	ENST00000424232.5	306	567	++	80	P29274#0	0	261	ENST00000424232.5	306	567	+	261	0	151	6799
P29274#0	0	412	412	P29274	0	412	+	412	P29274	0	412	ENST00000337539.12	422	1658	++	31	P29274#0	0	1236	ENST00000337539.12	422	1658	+	1236	0	-824	6800
P29274#1	0	7	7	P29274	0	7	+	7	P29274	0	412	ENST00000618076.3	524	1760	++	224	P29274#1	0	21	ENST00000618076.3	524	545	+	21	0	-14	6801
P29274#1	0	7	7	P29274	0	7	+	7	P29274	0	412	ENST00000611543.4	306	1542	++	222	P29274#1	0	21	ENST00000611543.4	306	327	+	21	0	-14	6802
P29274#1	0	7	7	P29274	0	7	+	7	P29274	0	412	ENST00000610595.4	630	1866	++	221	P29274#1	0	21	ENST00000610595.4	630	651	+	21	0	-14	6803
P29274#1	0	7	7	P29274	0	7	+	7	P29274	0	83	ENST00000496258.1	439	688	++	123	P29274#1	0	21	ENST00000496258.1	439	460	+	21	0	-14	6804
P29274#1	0	7	7	P29274	0	7	+	7	P29274	0	108	ENST00000486108.1	601	925	++	115	P29274#1	0	21	ENST00000486108.1	601	622	+	21	0	-14	6805
P29274#1	0	7	7	P29274	0	7	+	7	P29274	0	29	ENST00000472248.5	630	717	++	110	P29274#1	0	21	ENST00000472248.5	630	651	+	21	0	-14	6806
P29274#1	0	7	7	P29274	0	7	+	7	P29274	0	365	ENST00000444262.6	422	1517	++	92	P29274#1	0	21	ENST00000444262.6	422	443	+	21	0	-14	6807
P29274#1	0	7	7	P29274	0	7	+	7	P29274	0	76	ENST00000439591.1	330	558	++	90	P29274#1	0	21	ENST00000439591.1	330	351	+	21	0	-14	6808
P29274#1	0	7	7	P29274	0	7	+	7	P29274	0	64	ENST00000436735.1	476	668	++	88	P29274#1	0	21	ENST00000436735.1	476	497	+	21	0	-14	6809
P29274#1	0	7	7	P29274	0	7	+	7	P29274	0	87	ENST00000424232.5	306	567	++	80	P29274#1	0	21	ENST00000424232.5	306	327	+	21	0	-14	6810
P29274#1	0	7	7	P29274	0	7	+	7	P29274	0	412	ENST00000337539.12	422	1658	++	31	P29274#1	0	21	ENST00000337539.12	422	443	+	21	0	-14	6811
P29274#2	0	25	25	P29274	7	32	+	25	P29274	0	412	ENST00000618076.3	524	1760	++	224	P29274#2	0	75	ENST00000618076.3	545	620	+	75	0	-50	6812
P29274#2	0	25	25	P29274	7	32	+	25	P29274	0	412	ENST00000611543.4	306	1542	++	222	P29274#2	0	75	ENST00000611543.4	327	402	+	75	0	-50	6813
P29274#2	0	25	25	P29274	7	32	+	25	P29274	0	412	ENST00000610595.4	630	1866	++	221	P29274#2	0	75	ENST00000610595.4	651	726	+	75	0	-50	6814
P29274#2	0	25	25	P29274	7	32	+	25	P29274	0	83	ENST00000496258.1	439	688	++	123	P29274#2	0	75	ENST00000496258.1	460	535	+	75	0	-50	6815
P29274#2	0	25	25	P29274	7	32	+	25	P29274	0	108	ENST00000486108.1	601	925	++	115	P29274#2	0	75	ENST00000486108.1	622	697	+	75	0	-50	6816
P29274#2	0	25	25	P29274	7	32	+	25	P29274	0	29	ENST00000472248.5	630	717	++	110	P29274#2	0	66	ENST00000472248.5	651	717	+	66	0	-41	6817
P29274#2	0	25	25	P29274	7	32	+	25	P29274	0	365	ENST00000444262.6	422	1517	++	92	P29274#2	0	75	ENST00000444262.6	443	518	+	75	0	-50	6818
P29274#2	0	25	25	P29274	7	32	+	25	P29274	0	76	ENST00000439591.1	330	558	++	90	P29274#2	0	75	ENST00000439591.1	351	426	+	75	0	-50	6819
P29274#2	0	25	25	P29274	7	32	+	25	P29274	0	64	ENST00000436735.1	476	668	++	88	P29274#2	0	75	ENST00000436735.1	497	572	+	75	0	-50	6820
P29274#2	0	25	25	P29274	7	32	+	25	P29274	0	87	ENST00000424232.5	306	567	++	80	P29274#2	0	75	ENST00000424232.5	327	402	+	75	0	-50	6821
P29274#2	0	25	25	P29274	7	32	+	25	P29274	0	412	ENST00000337539.12	422	1658	++	31	P29274#2	0	75	ENST00000337539.12	443	518	+	75	0	-50	6822
P29274#3	0	10	10	P29274	32	42	+	10	P29274	0	412	ENST00000618076.3	524	1760	++	224	P29274#3	0	30	ENST00000618076.3	620	650	+	30	0	-20	6823
P29274#3	0	10	10	P29274	32	42	+	10	P29274	0	412	ENST00000611543.4	306	1542	++	222	P29274#3	0	30	ENST00000611543.4	402	432	+	30	0	-20	6824
P29274#3	0	10	10	P29274	32	42	+	10	P29274	0	412	ENST00000610595.4	630	1866	++	221	P29274#3	0	30	ENST00000610595.4	726	756	+	30	0	-20	6825
P29274#3	0	10	10	P29274	32	42	+	10	P29274	0	83	ENST00000496258.1	439	688	++	123	P29274#3	0	30	ENST00000496258.1	535	565	+	30	0	-20	6826
P29274#3	0	10	10	P29274	32	42	+	10	P29274	0	108	ENST00000486108.1	601	925	++	115	P29274#3	0	30	ENST00000486108.1	697	727	+	30	0	-20	6827
P29274#3	0	10	10	P29274	32	42	+	10	P29274	0	365	ENST00000444262.6	422	1517	++	92	P29274#3	0	30	ENST00000444262.6	518	548	+	30	0	-20	6828
P29274#3	0	10	10	P29274	32	42	+	10	P29274	0	76	ENST00000439591.1	330	558	++	90	P29274#3	0	30	ENST00000439591.1	426	456	+	30	0	-20	6829
P29274#3	0	10	10	P29274	32	42	+	10	P29274	0	64	ENST00000436735.1	476	668	++	88	P29274#3	0	30	ENST00000436735.1	572	602	+	30	0	-20	6830
P29274#3	0	10	10	P29274	32	42	+	10	P29274	0	87	ENST00000424232.5	306	567	++	80	P29274#3	0	30	ENST00000424232.5	402	432	+	30	0	-20	6831
P29274#3	0	10	10	P29274	32	42	+	10	P29274	0	412	ENST00000337539.12	422	1658	++	31	P29274#3	0	30	ENST00000337539.12	518	548	+	30	0	-20	6832
P29274#4	0	24	24	P29274	42	66	+	24	P29274	0	412	ENST00000618076.3	524	1760	++	224	P29274#4	0	72	ENST00000618076.3	650	722	+	72	0	-48	6833
P29274#4	0	24	24	P29274	42	66	+	24	P29274	0	412	ENST00000611543.4	306	1542	++	222	P29274#4	0	72	ENST00000611543.4	432	504	+	72	0	-48	6834
P29274#4	0	24	24	P29274	42	66	+	24	P29274	0	412	ENST00000610595.4	630	1866	++	221	P29274#4	0	72	ENST00000610595.4	756	828	+	72	0	-48	6835
P29274#4	0	24	24	P29274	42	66	+	24	P29274	0	83	ENST00000496258.1	439	688	++	123	P29274#4	0	72	ENST00000496258.1	565	637	+	72	0	-48	6836
P29274#4	0	24	24	P29274	42	66	+	24	P29274	0	108	ENST00000486108.1	601	925	++	115	P29274#4	0	72	ENST00000486108.1	727	799	+	72	0	-48	6837
P29274#4	0	24	24	P29274	42	66	+	24	P29274	0	365	ENST00000444262.6	422	1517	++	92	P29274#4	0	72	ENST00000444262.6	548	620	+	72	0	-48	6838
P29274#4	0	24	24	P29274	42	66	+	24	P29274	0	76	ENST00000439591.1	330	558	++	90	P29274#4	0	72	ENST00000439591.1	456	528	+	72	0	-48	6839
P29274#4	0	24	24	P29274	42	66	+	24	P29274	0	64	ENST00000436735.1	476	668	++	88	P29274#4	0	66	ENST00000436735.1	602	668	+	66	0	-42	6840
P29274#4	0	24	24	P29274	42	66	+	24	P29274	0	87	ENST00000424232.5	306	567	++	80	P29274#4	0	72	ENST00000424232.5	432	504	+	72	0	-48	6841
P29274#4	0	24	24	P29274	42	66	+	24	P29274	0	412	ENST00000337539.12	422	1658	++	31	P29274#4	0	72	ENST00000337539.12	548	620	+	72	0	-48	6842
P29274#5	0	11	11	P29274	66	77	+	11	P29274	0	412	ENST00000618076.3	524	1760	++	224	P29274#5	0	33	ENST00000618076.3	722	755	+	33	0	-22	6843
P29274#5	0	11	11	P29274	66	77	+	11	P29274	0	412	ENST00000611543.4	306	1542	++	222	P29274#5	0	33	ENST00000611543.4	504	537	+	33	0	-22	6844
P29274#5	0	11	11	P29274	66	77	+	11	P29274	0	412	ENST00000610595.4	630	1866	++	221	P29274#5	0	33	ENST00000610595.4	828	861	+	33	0	-22	6845
P29274#5	0	11	11	P29274	66	77	+	11	P29274	0	83	ENST00000496258.1	439	688	++	123	P29274#5	0	33	ENST00000496258.1	637	670	+	33	0	-22	6846
P29274#5	0	11	11	P29274	66	77	+	11	P29274	0	108	ENST00000486108.1	601	925	++	115	P29274#5	0	33	ENST00000486108.1	799	832	+	33	0	-22	6847
P29274#5	0	11	11	P29274	66	77	+	11	P29274	0	365	ENST00000444262.6	422	1517	++	92	P29274#5	0	33	ENST00000444262.6	620	653	+	33	0	-22	6848
P29274#5	0	11	11	P29274	66	77	+	11	P29274	0	76	ENST00000439591.1	330	558	++	90	P29274#5	0	30	ENST00000439591.1	528	558	+	30	0	-19	6849
P29274#5	0	11	11	P29274	66	77	+	11	P29274	0	87	ENST00000424232.5	306	567	++	80	P29274#5	0	33	ENST00000424232.5	504	537	+	33	0	-22	6850
P29274#5	0	11	11	P29274	66	77	+	11	P29274	0	412	ENST00000337539.12	422	1658	++	31	P29274#5	0	33	ENST00000337539.12	620	653	+	33	0	-22	6851
P29274#6	0	23	23	P29274	77	100	+	23	P29274	0	412	ENST00000618076.3	524	1760	++	224	P29274#6	0	69	ENST00000618076.3	755	824	+	69	0	-46	6852
P29274#6	0	23	23	P29274	77	100	+	23	P29274	0	412	ENST00000611543.4	306	1542	++	222	P29274#6	0	69	ENST00000611543.4	537	606	+	69	0	-46	6853
P29274#6	0	23	23	P29274	77	100	+	23	P29274	0	412	ENST00000610595.4	630	1866	++	221	P29274#6	0	69	ENST00000610595.4	861	930	+	69	0	-46	6854
P29274#6	0	23	23	P29274	77	100	+	23	P29274	0	83	ENST00000496258.1	439	688	++	123	P29274#6	0	18	ENST00000496258.1	670	688	+	18	0	5	6855
P29274#6	0	23	23	P29274	77	100	+	23	P29274	0	108	ENST00000486108.1	601	925	++	115	P29274#6	0	69	ENST00000486108.1	832	901	+	69	0	-46	6856
P29274#6	0	23	23	P29274	77	100	+	23	P29274	0	365	ENST00000444262.6	422	1517	++	92	P29274#6	0	69	ENST00000444262.6	653	722	+	69	0	-46	6857
P29274#6	0	23	23	P29274	77	100	+	23	P29274	0	87	ENST00000424232.5	306	567	++	80	P29274#6	0	30	ENST00000424232.5	537	567	+	30	0	-7	6858
P29274#6	0	23	23	P29274	77	100	+	23	P29274	0	412	ENST00000337539.12	422	1658	++	31	P29274#6	0	69	ENST00000337539.12	653	722	+	69	0	-46	6859
P29274#7	0	20	20	P29274	100	120	+	20	P29274	0	412	ENST00000618076.3	524	1760	++	224	P29274#7	0	60	ENST00000618076.3	824	884	+	60	0	-40	6860
P29274#7	0	20	20	P29274	100	120	+	20	P29274	0	412	ENST00000611543.4	306	1542	++	222	P29274#7	0	60	ENST00000611543.4	606	666	+	60	0	-40	6861
P29274#7	0	20	20	P29274	100	120	+	20	P29274	0	412	ENST00000610595.4	630	1866	++	221	P29274#7	0	60	ENST00000610595.4	930	990	+	60	0	-40	6862
P29274#7	0	20	20	P29274	100	120	+	20	P29274	0	108	ENST00000486108.1	601	925	++	115	P29274#7	0	24	ENST00000486108.1	901	925	+	24	0	-4	6863
P29274#7	0	20	20	P29274	100	120	+	20	P29274	0	365	ENST00000444262.6	422	1517	++	92	P29274#7	0	60	ENST00000444262.6	722	782	+	60	0	-40	6864
P29274#7	0	20	20	P29274	100	120	+	20	P29274	0	412	ENST00000337539.12	422	1658	++	31	P29274#7	0	60	ENST00000337539.12	722	782	+	60	0	-40	6865
P29274#8	0	23	23	P29274	120	143	+	23	P29274	0	412	ENST00000618076.3	524	1760	++	224	P29274#8	0	69	ENST00000618076.3	884	953	+	69	0	-46	6866
P29274#8	0	23	23	P29274	120	143	+	23	P29274	0	412	ENST00000611543.4	306	1542	++	222	P29274#8	0	69	ENST00000611543.4	666	735	+	69	0	-46	6867
P29274#8	0	23	23	P29274	120	143	+	23	P29274	0	412	ENST00000610595.4	630	1866	++	221	P29274#8	0	69	ENST00000610595.4	990	1059	+	69	0	-46	6868
P29274#8	0	23	23	P29274	120	143	+	23	P29274	0	365	ENST00000444262.6	422	1517	++	92	P29274#8	0	69	ENST00000444262.6	782	851	+	69	0	-46	6869
P29274#8	0	23	23	P29274	120	143	+	23	P29274	0	412	ENST00000337539.12	422	1658	++	31	P29274#8	0	69	ENST00000337539.12	782	851	+	69	0	-46	6870
P29274#9	0	30	30	P29274	143	173	+	30	P29274	0	412	ENST00000618076.3	524	1760	++	224	P29274#9	0	90	ENST00000618076.3	953	1043	+	90	0	-60	6871
P29274#9	0	30	30	P29274	143	173	+	30	P29274	0	412	ENST00000611543.4	306	1542	++	222	P29274#9	0	90	ENST00000611543.4	735	825	+	90	0	-60	6872
P29274#9	0	30	30	P29274	143	173	+	30	P29274	0	412	ENST00000610595.4	630	1866	++	221	P29274#9	0	90	ENST00000610595.4	1059	1149	+	90	0	-60	6873
P29274#9	0	30	30	P29274	143	173	+	30	P29274	0	365	ENST00000444262.6	422	1517	++	92	P29274#9	0	90	ENST00000444262.6	851	941	+	90	0	-60	6874
P29274#9	0	30	30	P29274	143	173	+	30	P29274	0	412	ENST00000337539.12	422	1658	++	31	P29274#9	0	90	ENST00000337539.12	851	941	+	90	0	-60	6875
P29274#10	0	25	25	P29274	173	198	+	25	P29274	0	412	ENST00000618076.3	524	1760	++	224	P29274#10	0	75	ENST00000618076.3	1043	1118	+	75	0	-50	6876
P29274#10	0	25	25	P29274	173	198	+	25	P29274	0	412	ENST00000611543.4	306	1542	++	222	P29274#10	0	75	ENST00000611543.4	825	900	+	75	0	-50	6877
P29274#10	0	25	25	P29274	173	198	+	25	P29274	0	412	ENST00000610595.4	630	1866	++	221	P29274#10	0	75	ENST00000610595.4	1149	1224	+	75	0	-50	6878
P29274#10	0	25	25	P29274	173	198	+	25	P29274	0	365	ENST00000444262.6	422	1517	++	92	P29274#10	0	75	ENST00000444262.6	941	1016	+	75	0	-50	6879
P29274#10	0	25	25	P29274	173	198	+	25	P29274	0	412	ENST00000337539.12	422	1658	++	31	P29274#10	0	75	ENST00000337539.12	941	1016	+	75	0	-50	6880
P29274#11	0	36	36	P29274	198	234	+	36	P29274	0	412	ENST00000618076.3	524	1760	++	224	P29274#11	0	108	ENST00000618076.3	1118	1226	+	108	0	-72	6881
P29274#11	0	36	36	P29274	198	234	+	36	P29274	0	412	ENST00000611543.4	306	1542	++	222	P29274#11	0	108	ENST00000611543.4	900	1008	+	108	0	-72	6882
P29274#11	0	36	36	P29274	198	234	+	36	P29274	0	412	ENST00000610595.4	630	1866	++	221	P29274#11	0	108	ENST00000610595.4	1224	1332	+	108	0	-72	6883
P29274#11	0	36	36	P29274	198	234	+	36	P29274	0	365	ENST00000444262.6	422	1517	++	92	P29274#11	0	108	ENST00000444262.6	1016	1124	+	108	0	-72	6884
P29274#11	0	36	36	P29274	198	234	+	36	P29274	0	412	ENST00000337539.12	422	1658	++	31	P29274#11	0	108	ENST00000337539.12	1016	1124	+	108	0	-72	6885
P29274#12	0	24	24	P29274	234	258	+	24	P29274	0	412	ENST00000618076.3	524	1760	++	224	P29274#12	0	72	ENST00000618076.3	1226	1298	+	72	0	-48	6886
P29274#12	0	24	24	P29274	234	258	+	24	P29274	0	412	ENST00000611543.4	306	1542	++	222	P29274#12	0	72	ENST00000611543.4	1008	1080	+	72	0	-48	6887
P29274#12	0	24	24	P29274	234	258	+	24	P29274	0	412	ENST00000610595.4	630	1866	++	221	P29274#12	0	72	ENST00000610595.4	1332	1404	+	72	0	-48	6888
P29274#12	0	24	24	P29274	234	258	+	24	P29274	0	365	ENST00000444262.6	422	1517	++	92	P29274#12	0	72	ENST00000444262.6	1124	1196	+	72	0	-48	6889
P29274#12	0	24	24	P29274	234	258	+	24	P29274	0	412	ENST00000337539.12	422	1658	++	31	P29274#12	0	72	ENST00000337539.12	1124	1196	+	72	0	-48	6890
P29274#13	0	8	8	P29274	258	266	+	8	P29274	0	412	ENST00000618076.3	524	1760	++	224	P29274#13	0	24	ENST00000618076.3	1298	1322	+	24	0	-16	6891
P29274#13	0	8	8	P29274	258	266	+	8	P29274	0	412	ENST00000611543.4	306	1542	++	222	P29274#13	0	24	ENST00000611543.4	1080	1104	+	24	0	-16	6892
P29274#13	0	8	8	P29274	258	266	+	8	P29274	0	412	ENST00000610595.4	630	1866	++	221	P29274#13	0	24	ENST00000610595.4	1404	1428	+	24	0	-16	6893
P29274#13	0	8	8	P29274	258	266	+	8	P29274	0	365	ENST00000444262.6	422	1517	++	92	P29274#13	0	24	ENST00000444262.6	1196	1220	+	24	0	-16	6894
P29274#13	0	8	8	P29274	258	266	+	8	P29274	0	412	ENST00000337539.12	422	1658	++	31	P29274#13	0	24	ENST00000337539.12	1196	1220	+	24	0	-16	6895
P29274#14	0	24	24	P29274	266	290	+	24	P29274	0	412	ENST00000618076.3	524	1760	++	224	P29274#14	0	72	ENST00000618076.3	1322	1394	+	72	0	-48	6896
P29274#14	0	24	24	P29274	266	290	+	24	P29274	0	412	ENST00000611543.4	306	1542	++	222	P29274#14	0	72	ENST00000611543.4	1104	1176	+	72	0	-48	6897
P29274#14	0	24	24	P29274	266	290	+	24	P29274	0	412	ENST00000610595.4	630	1866	++	221	P29274#14	0	72	ENST00000610595.4	1428	1500	+	72	0	-48	6898
P29274#14	0	24	24	P29274	266	290	+	24	P29274	0	365	ENST00000444262.6	422	1517	++	92	P29274#14	0	72	ENST00000444262.6	1220	1292	+	72	0	-48	6899
P29274#14	0	24	24	P29274	266	290	+	24	P29274	0	412	ENST00000337539.12	422	1658	++	31	P29274#14	0	72	ENST00000337539.12	1220	1292	+	72	0	-48	6900
P29274#15	0	122	122	P29274	290	412	+	122	P29274	0	412	ENST00000618076.3	524	1760	++	224	P29274#15	0	366	ENST00000618076.3	1394	1760	+	366	0	-244	6901
P29274#15	0	122	122	P29274	290	412	+	122	P29274	0	412	ENST00000611543.4	306	1542	++	222	P29274#15	0	366	ENST00000611543.4	1176	1542	+	366	0	-244	6902
P29274#15	0	122	122	P29274	290	412	+	122	P29274	0	412	ENST00000610595.4	630	1866	++	221	P29274#15	0	366	ENST00000610595.4	1500	1866	+	366	0	-244	6903
P29274#15	0	122	122	P29274	290	412	+	122	P29274	0	365	ENST00000444262.6	422	1517	++	92	P29274#15	0	225	ENST00000444262.6	1292	1517	+	225	0	-103	6904
P29274#15	0	122	122	P29274	290	412	+	122	P29274	0	412	ENST00000337539.12	422	1658	++	31	P29274#15	0	366	ENST00000337539.12	1292	1658	+	366	0	-244	6905
P29274#16	0	22	22	P29274	390	412	+	22	P29274	0	412	ENST00000618076.3	524	1760	++	224	P29274#16	0	66	ENST00000618076.3	1694	1760	+	66	0	-44	6906
P29274#16	0	22	22	P29274	390	412	+	22	P29274	0	412	ENST00000611543.4	306	1542	++	222	P29274#16	0	66	ENST00000611543.4	1476	1542	+	66	0	-44	6907
P29274#16	0	22	22	P29274	390	412	+	22	P29274	0	412	ENST00000610595.4	630	1866	++	221	P29274#16	0	66	ENST00000610595.4	1800	1866	+	66	0	-44	6908
P29274#16	0	22	22	P29274	390	412	+	22	P29274	0	412	ENST00000337539.12	422	1658	++	31	P29274#16	0	66	ENST00000337539.12	1592	1658	+	66	0	-44	6909
P29274#17	0	1	1	P29274	168	169	+	1	P29274	0	412	ENST00000618076.3	524	1760	++	224	P29274#17	0	3	ENST00000618076.3	1028	1031	+	3	0	-2	6910
P29274#17	0	1	1	P29274	168	169	+	1	P29274	0	412	ENST00000611543.4	306	1542	++	222	P29274#17	0	3	ENST00000611543.4	810	813	+	3	0	-2	6911
P29274#17	0	1	1	P29274	168	169	+	1	P29274	0	412	ENST00000610595.4	630	1866	++	221	P29274#17	0	3	ENST00000610595.4	1134	1137	+	3	0	-2	6912
P29274#17	0	1	1	P29274	168	169	+	1	P29274	0	365	ENST00000444262.6	422	1517	++	92	P29274#17	0	3	ENST00000444262.6	926	929	+	3	0	-2	6913
P29274#17	0	1	1	P29274	168	169	+	1	P29274	0	412	ENST00000337539.12	422	1658	++	31	P29274#17	0	3	ENST00000337539.12	926	929	+	3	0	-2	6914
P29274#18	0	1	1	P29274	252	253	+	1	P29274	0	412	ENST00000618076.3	524	1760	++	224	P29274#18	0	3	ENST00000618076.3	1280	1283	+	3	0	-2	6915
P29274#18	0	1	1	P29274	252	253	+	1	P29274	0	412	ENST00000611543.4	306	1542	++	222	P29274#18	0	3	ENST00000611543.4	1062	1065	+	3	0	-2	6916
P29274#18	0	1	1	P29274	252	253	+	1	P29274	0	412	ENST00000610595.4	630	1866	++	221	P29274#18	0	3	ENST00000610595.4	1386	1389	+	3	0	-2	6917
P29274#18	0	1	1	P29274	252	253	+	1	P29274	0	365	ENST00000444262.6	422	1517	++	92	P29274#18	0	3	ENST00000444262.6	1178	1181	+	3	0	-2	6918
P29274#18	0	1	1	P29274	252	253	+	1	P29274	0	412	ENST00000337539.12	422	1658	++	31	P29274#18	0	3	ENST00000337539.12	1178	1181	+	3	0	-2	6919
P29274#19	0	1	1	P29274	276	277	+	1	P29274	0	412	ENST00000618076.3	524	1760	++	224	P29274#19	0	3	ENST00000618076.3	1352	1355	+	3	0	-2	6920
P29274#19	0	1	1	P29274	276	277	+	1	P29274	0	412	ENST00000611543.4	306	1542	++	222	P29274#19	0	3	ENST00000611543.4	1134	1137	+	3	0	-2	6921
P29274#19	0	1	1	P29274	276	277	+	1	P29274	0	412	ENST00000610595.4	630	1866	++	221	P29274#19	0	3	ENST00000610595.4	1458	1461	+	3	0	-2	6922
P29274#19	0	1	1	P29274	276	277	+	1	P29274	0	365	ENST00000444262.6	422	1517	++	92	P29274#19	0	3	ENST00000444262.6	1250	1253	+	3	0	-2	6923
P29274#19	0	1	1	P29274	276	277	+	1	P29274	0	412	ENST00000337539.12	422	1658	++	31	P29274#19	0	3	ENST00000337539.12	1250	1253	+	3	0	-2	6924
P29274#20	0	1	1	P29274	277	278	+	1	P29274	0	412	ENST00000618076.3	524	1760	++	224	P29274#20	0	3	ENST00000618076.3	1355	1358	+	3	0	-2	6925
P29274#20	0	1	1	P29274	277	278	+	1	P29274	0	412	ENST00000611543.4	306	1542	++	222	P29274#20	0	3	ENST00000611543.4	1137	1140	+	3	0	-2	6926
P29274#20	0	1	1	P29274	277	278	+	1	P29274	0	412	ENST00000610595.4	630	1866	++	221	P29274#20	0	3	ENST00000610595.4	1461	1464	+	3	0	-2	6927
P29274#20	0	1	1	P29274	277	278	+	1	P29274	0	365	ENST00000444262.6	422	1517	++	92	P29274#20	0	3	ENST00000444262.6	1253	1256	+	3	0	-2	6928
P29274#20	0	1	1	P29274	277	278	+	1	P29274	0	412	ENST00000337539.12	422	1658	++	31	P29274#20	0	3	ENST00000337539.12	1253	1256	+	3	0	-2	6929
P29274#21	0	1	1	P29274	153	154	+	1	P29274	0	412	ENST00000618076.3	524	1760	++	224	P29274#21	0	3	ENST00000618076.3	983	986	+	3	0	-2	6930
P29274#21	0	1	1	P29274	153	154	+	1	P29274	0	412	ENST00000611543.4	306	1542	++	222	P29274#21	0	3	ENST00000611543.4	765	768	+	3	0	-2	6931
P29274#21	0	1	1	P29274	153	154	+	1	P29274	0	412	ENST00000610595.4	630	1866	++	221	P29274#21	0	3	ENST00000610595.4	1089	1092	+	3	0	-2	6932
P29274#21	0	1	1	P29274	153	154	+	1	P29274	0	365	ENST00000444262.6	422	1517	++	92	P29274#21	0	3	ENST00000444262.6	881	884	+	3	0	-2	6933
P29274#21	0	1	1	P29274	153	154	+	1	P29274	0	412	ENST00000337539.12	422	1658	++	31	P29274#21	0	3	ENST00000337539.12	881	884	+	3	0	-2	6934
P29274#22	0	89	89	P29274	70	159	+	89	P29274	0	412	ENST00000618076.3	524	1760	++	224	P29274#22	0	267	ENST00000618076.3	734	1001	+	267	0	-178	6935
P29274#22	0	89	89	P29274	70	159	+	89	P29274	0	412	ENST00000611543.4	306	1542	++	222	P29274#22	0	267	ENST00000611543.4	516	783	+	267	0	-178	6936
P29274#22	0	89	89	P29274	70	159	+	89	P29274	0	412	ENST00000610595.4	630	1866	++	221	P29274#22	0	267	ENST00000610595.4	840	1107	+	267	0	-178	6937
P29274#22	0	89	89	P29274	70	159	+	89	P29274	0	83	ENST00000496258.1	439	688	++	123	P29274#22	0	39	ENST00000496258.1	649	688	+	39	0	50	6938
P29274#22	0	89	89	P29274	70	159	+	89	P29274	0	108	ENST00000486108.1	601	925	++	115	P29274#22	0	114	ENST00000486108.1	811	925	+	114	0	-25	6939
P29274#22	0	89	89	P29274	70	159	+	89	P29274	0	365	ENST00000444262.6	422	1517	++	92	P29274#22	0	267	ENST00000444262.6	632	899	+	267	0	-178	6940
P29274#22	0	89	89	P29274	70	159	+	89	P29274	0	76	ENST00000439591.1	330	558	++	90	P29274#22	0	18	ENST00000439591.1	540	558	+	18	0	71	6941
P29274#22	0	89	89	P29274	70	159	+	89	P29274	0	87	ENST00000424232.5	306	567	++	80	P29274#22	0	51	ENST00000424232.5	516	567	+	51	0	38	6942
P29274#22	0	89	89	P29274	70	159	+	89	P29274	0	412	ENST00000337539.12	422	1658	++	31	P29274#22	0	267	ENST00000337539.12	632	899	+	267	0	-178	6943
P29274#23	0	73	73	P29274	73	146	+	73	P29274	0	412	ENST00000618076.3	524	1760	++	224	P29274#23	0	219	ENST00000618076.3	743	962	+	219	0	-146	6944
P29274#23	0	73	73	P29274	73	146	+	73	P29274	0	412	ENST00000611543.4	306	1542	++	222	P29274#23	0	219	ENST00000611543.4	525	744	+	219	0	-146	6945
P29274#23	0	73	73	P29274	73	146	+	73	P29274	0	412	ENST00000610595.4	630	1866	++	221	P29274#23	0	219	ENST00000610595.4	849	1068	+	219	0	-146	6946
P29274#23	0	73	73	P29274	73	146	+	73	P29274	0	83	ENST00000496258.1	439	688	++	123	P29274#23	0	30	ENST00000496258.1	658	688	+	30	0	43	6947
P29274#23	0	73	73	P29274	73	146	+	73	P29274	0	108	ENST00000486108.1	601	925	++	115	P29274#23	0	105	ENST00000486108.1	820	925	+	105	0	-32	6948
P29274#23	0	73	73	P29274	73	146	+	73	P29274	0	365	ENST00000444262.6	422	1517	++	92	P29274#23	0	219	ENST00000444262.6	641	860	+	219	0	-146	6949
P29274#23	0	73	73	P29274	73	146	+	73	P29274	0	76	ENST00000439591.1	330	558	++	90	P29274#23	0	9	ENST00000439591.1	549	558	+	9	0	64	6950
P29274#23	0	73	73	P29274	73	146	+	73	P29274	0	87	ENST00000424232.5	306	567	++	80	P29274#23	0	42	ENST00000424232.5	525	567	+	42	0	31	6951
P29274#23	0	73	73	P29274	73	146	+	73	P29274	0	412	ENST00000337539.12	422	1658	++	31	P29274#23	0	219	ENST00000337539.12	641	860	+	219	0	-146	6952
P29274#24	0	90	90	P29274	76	166	+	90	P29274	0	412	ENST00000618076.3	524	1760	++	224	P29274#24	0	270	ENST00000618076.3	752	1022	+	270	0	-180	6953
P29274#24	0	90	90	P29274	76	166	+	90	P29274	0	412	ENST00000611543.4	306	1542	++	222	P29274#24	0	270	ENST00000611543.4	534	804	+	270	0	-180	6954
P29274#24	0	90	90	P29274	76	166	+	90	P29274	0	412	ENST00000610595.4	630	1866	++	221	P29274#24	0	270	ENST00000610595.4	858	1128	+	270	0	-180	6955
P29274#24	0	90	90	P29274	76	166	+	90	P29274	0	83	ENST00000496258.1	439	688	++	123	P29274#24	0	21	ENST00000496258.1	667	688	+	21	0	69	6956
P29274#24	0	90	90	P29274	76	166	+	90	P29274	0	108	ENST00000486108.1	601	925	++	115	P29274#24	0	96	ENST00000486108.1	829	925	+	96	0	-6	6957
P29274#24	0	90	90	P29274	76	166	+	90	P29274	0	365	ENST00000444262.6	422	1517	++	92	P29274#24	0	270	ENST00000444262.6	650	920	+	270	0	-180	6958
P29274#24	0	90	90	P29274	76	166	+	90	P29274	0	87	ENST00000424232.5	306	567	++	80	P29274#24	0	33	ENST00000424232.5	534	567	+	33	0	57	6959
P29274#24	0	90	90	P29274	76	166	+	90	P29274	0	412	ENST00000337539.12	422	1658	++	31	P29274#24	0	270	ENST00000337539.12	650	920	+	270	0	-180	6960
P29274#25	0	4	4	P29274	258	262	+	4	P29274	0	412	ENST00000618076.3	524	1760	++	224	P29274#25	0	12	ENST00000618076.3	1298	1310	+	12	0	-8	6961
P29274#25	0	4	4	P29274	258	262	+	4	P29274	0	412	ENST00000611543.4	306	1542	++	222	P29274#25	0	12	ENST00000611543.4	1080	1092	+	12	0	-8	6962
P29274#25	0	4	4	P29274	258	262	+	4	P29274	0	412	ENST00000610595.4	630	1866	++	221	P29274#25	0	12	ENST00000610595.4	1404	1416	+	12	0	-8	6963
P29274#25	0	4	4	P29274	258	262	+	4	P29274	0	365	ENST00000444262.6	422	1517	++	92	P29274#25	0	12	ENST00000444262.6	1196	1208	+	12	0	-8	6964
P29274#25	0	4	4	P29274	258	262	+	4	P29274	0	412	ENST00000337539.12	422	1658	++	31	P29274#25	0	12	ENST00000337539.12	1196	1208	+	12	0	-8	6965
P29274#26	0	1	1	P29274	49	50	+	1	P29274	0	412	ENST00000618076.3	524	1760	++	224	P29274#26	0	3	ENST00000618076.3	671	674	+	3	0	-2	6966
P29274#26	0	1	1	P29274	49	50	+	1	P29274	0	412	ENST00000611543.4	306	1542	++	222	P29274#26	0	3	ENST00000611543.4	453	456	+	3	0	-2	6967
P29274#26	0	1	1	P29274	49	50	+	1	P29274	0	412	ENST00000610595.4	630	1866	++	221	P29274#26	0	3	ENST00000610595.4	777	780	+	3	0	-2	6968
P29274#26	0	1	1	P29274	49	50	+	1	P29274	0	83	ENST00000496258.1	439	688	++	123	P29274#26	0	3	ENST00000496258.1	586	589	+	3	0	-2	6969
P29274#26	0	1	1	P29274	49	50	+	1	P29274	0	108	ENST00000486108.1	601	925	++	115	P29274#26	0	3	ENST00000486108.1	748	751	+	3	0	-2	6970
P29274#26	0	1	1	P29274	49	50	+	1	P29274	0	365	ENST00000444262.6	422	1517	++	92	P29274#26	0	3	ENST00000444262.6	569	572	+	3	0	-2	6971
P29274#26	0	1	1	P29274	49	50	+	1	P29274	0	76	ENST00000439591.1	330	558	++	90	P29274#26	0	3	ENST00000439591.1	477	480	+	3	0	-2	6972
P29274#26	0	1	1	P29274	49	50	+	1	P29274	0	64	ENST00000436735.1	476	668	++	88	P29274#26	0	3	ENST00000436735.1	623	626	+	3	0	-2	6973
P29274#26	0	1	1	P29274	49	50	+	1	P29274	0	87	ENST00000424232.5	306	567	++	80	P29274#26	0	3	ENST00000424232.5	453	456	+	3	0	-2	6974
P29274#26	0	1	1	P29274	49	50	+	1	P29274	0	412	ENST00000337539.12	422	1658	++	31	P29274#26	0	3	ENST00000337539.12	569	572	+	3	0	-2	6975
P29274#27	0	1	1	P29274	299	300	+	1	P29274	0	412	ENST00000618076.3	524	1760	++	224	P29274#27	0	3	ENST00000618076.3	1421	1424	+	3	0	-2	6976
P29274#27	0	1	1	P29274	299	300	+	1	P29274	0	412	ENST00000611543.4	306	1542	++	222	P29274#27	0	3	ENST00000611543.4	1203	1206	+	3	0	-2	6977
P29274#27	0	1	1	P29274	299	300	+	1	P29274	0	412	ENST00000610595.4	630	1866	++	221	P29274#27	0	3	ENST00000610595.4	1527	1530	+	3	0	-2	6978
P29274#27	0	1	1	P29274	299	300	+	1	P29274	0	365	ENST00000444262.6	422	1517	++	92	P29274#27	0	3	ENST00000444262.6	1319	1322	+	3	0	-2	6979
P29274#27	0	1	1	P29274	299	300	+	1	P29274	0	412	ENST00000337539.12	422	1658	++	31	P29274#27	0	3	ENST00000337539.12	1319	1322	+	3	0	-2	6980
P29274#28	0	1	1	P29274	391	392	+	1	P29274	0	412	ENST00000618076.3	524	1760	++	224	P29274#28	0	3	ENST00000618076.3	1697	1700	+	3	0	-2	6981
P29274#28	0	1	1	P29274	391	392	+	1	P29274	0	412	ENST00000611543.4	306	1542	++	222	P29274#28	0	3	ENST00000611543.4	1479	1482	+	3	0	-2	6982
P29274#28	0	1	1	P29274	391	392	+	1	P29274	0	412	ENST00000610595.4	630	1866	++	221	P29274#28	0	3	ENST00000610595.4	1803	1806	+	3	0	-2	6983
P29274#28	0	1	1	P29274	391	392	+	1	P29274	0	412	ENST00000337539.12	422	1658	++	31	P29274#28	0	3	ENST00000337539.12	1595	1598	+	3	0	-2	6984
P29274#29	0	32	32	P29274	1	33	+	32	P29274	0	412	ENST00000618076.3	524	1760	++	224	P29274#29	0	96	ENST00000618076.3	527	623	+	96	0	-64	6985
P29274#29	0	32	32	P29274	1	33	+	32	P29274	0	412	ENST00000611543.4	306	1542	++	222	P29274#29	0	96	ENST00000611543.4	309	405	+	96	0	-64	6986
P29274#29	0	32	32	P29274	1	33	+	32	P29274	0	412	ENST00000610595.4	630	1866	++	221	P29274#29	0	96	ENST00000610595.4	633	729	+	96	0	-64	6987
P29274#29	0	32	32	P29274	1	33	+	32	P29274	0	83	ENST00000496258.1	439	688	++	123	P29274#29	0	96	ENST00000496258.1	442	538	+	96	0	-64	6988
P29274#29	0	32	32	P29274	1	33	+	32	P29274	0	108	ENST00000486108.1	601	925	++	115	P29274#29	0	96	ENST00000486108.1	604	700	+	96	0	-64	6989
P29274#29	0	32	32	P29274	1	33	+	32	P29274	0	29	ENST00000472248.5	630	717	++	110	P29274#29	0	84	ENST00000472248.5	633	717	+	84	0	-52	6990
P29274#29	0	32	32	P29274	1	33	+	32	P29274	0	365	ENST00000444262.6	422	1517	++	92	P29274#29	0	96	ENST00000444262.6	425	521	+	96	0	-64	6991
P29274#29	0	32	32	P29274	1	33	+	32	P29274	0	76	ENST00000439591.1	330	558	++	90	P29274#29	0	96	ENST00000439591.1	333	429	+	96	0	-64	6992
P29274#29	0	32	32	P29274	1	33	+	32	P29274	0	64	ENST00000436735.1	476	668	++	88	P29274#29	0	96	ENST00000436735.1	479	575	+	96	0	-64	6993
P29274#29	0	32	32	P29274	1	33	+	32	P29274	0	87	ENST00000424232.5	306	567	++	80	P29274#29	0	96	ENST00000424232.5	309	405	+	96	0	-64	6994
P29274#29	0	32	32	P29274	1	33	+	32	P29274	0	412	ENST00000337539.12	422	1658	++	31	P29274#29	0	96	ENST00000337539.12	425	521	+	96	0	-64	6995
P29274#30	0	3	3	P29274	34	37	+	3	P29274	0	412	ENST00000618076.3	524	1760	++	224	P29274#30	0	9	ENST00000618076.3	626	635	+	9	0	-6	6996
P29274#30	0	3	3	P29274	34	37	+	3	P29274	0	412	ENST00000611543.4	306	1542	++	222	P29274#30	0	9	ENST00000611543.4	408	417	+	9	0	-6	6997
P29274#30	0	3	3	P29274	34	37	+	3	P29274	0	412	ENST00000610595.4	630	1866	++	221	P29274#30	0	9	ENST00000610595.4	732	741	+	9	0	-6	6998
P29274#30	0	3	3	P29274	34	37	+	3	P29274	0	83	ENST00000496258.1	439	688	++	123	P29274#30	0	9	ENST00000496258.1	541	550	+	9	0	-6	6999
P29274#30	0	3	3	P29274	34	37	+	3	P29274	0	108	ENST00000486108.1	601	925	++	115	P29274#30	0	9	ENST00000486108.1	703	712	+	9	0	-6	7000
P29274#30	0	3	3	P29274	34	37	+	3	P29274	0	365	ENST00000444262.6	422	1517	++	92	P29274#30	0	9	ENST00000444262.6	524	533	+	9	0	-6	7001
P29274#30	0	3	3	P29274	34	37	+	3	P29274	0	76	ENST00000439591.1	330	558	++	90	P29274#30	0	9	ENST00000439591.1	432	441	+	9	0	-6	7002
P29274#30	0	3	3	P29274	34	37	+	3	P29274	0	64	ENST00000436735.1	476	668	++	88	P29274#30	0	9	ENST00000436735.1	578	587	+	9	0	-6	7003
P29274#30	0	3	3	P29274	34	37	+	3	P29274	0	87	ENST00000424232.5	306	567	++	80	P29274#30	0	9	ENST00000424232.5	408	417	+	9	0	-6	7004
P29274#30	0	3	3	P29274	34	37	+	3	P29274	0	412	ENST00000337539.12	422	1658	++	31	P29274#30	0	9	ENST00000337539.12	524	533	+	9	0	-6	7005
P29274#31	0	18	18	P29274	39	57	+	18	P29274	0	412	ENST00000618076.3	524	1760	++	224	P29274#31	0	54	ENST00000618076.3	641	695	+	54	0	-36	7006
P29274#31	0	18	18	P29274	39	57	+	18	P29274	0	412	ENST00000611543.4	306	1542	++	222	P29274#31	0	54	ENST00000611543.4	423	477	+	54	0	-36	7007
P29274#31	0	18	18	P29274	39	57	+	18	P29274	0	412	ENST00000610595.4	630	1866	++	221	P29274#31	0	54	ENST00000610595.4	747	801	+	54	0	-36	7008
P29274#31	0	18	18	P29274	39	57	+	18	P29274	0	83	ENST00000496258.1	439	688	++	123	P29274#31	0	54	ENST00000496258.1	556	610	+	54	0	-36	7009
P29274#31	0	18	18	P29274	39	57	+	18	P29274	0	108	ENST00000486108.1	601	925	++	115	P29274#31	0	54	ENST00000486108.1	718	772	+	54	0	-36	7010
P29274#31	0	18	18	P29274	39	57	+	18	P29274	0	365	ENST00000444262.6	422	1517	++	92	P29274#31	0	54	ENST00000444262.6	539	593	+	54	0	-36	7011
P29274#31	0	18	18	P29274	39	57	+	18	P29274	0	76	ENST00000439591.1	330	558	++	90	P29274#31	0	54	ENST00000439591.1	447	501	+	54	0	-36	7012
P29274#31	0	18	18	P29274	39	57	+	18	P29274	0	64	ENST00000436735.1	476	668	++	88	P29274#31	0	54	ENST00000436735.1	593	647	+	54	0	-36	7013
P29274#31	0	18	18	P29274	39	57	+	18	P29274	0	87	ENST00000424232.5	306	567	++	80	P29274#31	0	54	ENST00000424232.5	423	477	+	54	0	-36	7014
P29274#31	0	18	18	P29274	39	57	+	18	P29274	0	412	ENST00000337539.12	422	1658	++	31	P29274#31	0	54	ENST00000337539.12	539	593	+	54	0	-36	7015
P29274#32	0	9	9	P29274	58	67	+	9	P29274	0	412	ENST00000618076.3	524	1760	++	224	P29274#32	0	27	ENST00000618076.3	698	725	+	27	0	-18	7016
P29274#32	0	9	9	P29274	58	67	+	9	P29274	0	412	ENST00000611543.4	306	1542	++	222	P29274#32	0	27	ENST00000611543.4	480	507	+	27	0	-18	7017
P29274#32	0	9	9	P29274	58	67	+	9	P29274	0	412	ENST00000610595.4	630	1866	++	221	P29274#32	0	27	ENST00000610595.4	804	831	+	27	0	-18	7018
P29274#32	0	9	9	P29274	58	67	+	9	P29274	0	83	ENST00000496258.1	439	688	++	123	P29274#32	0	27	ENST00000496258.1	613	640	+	27	0	-18	7019
P29274#32	0	9	9	P29274	58	67	+	9	P29274	0	108	ENST00000486108.1	601	925	++	115	P29274#32	0	27	ENST00000486108.1	775	802	+	27	0	-18	7020
P29274#32	0	9	9	P29274	58	67	+	9	P29274	0	365	ENST00000444262.6	422	1517	++	92	P29274#32	0	27	ENST00000444262.6	596	623	+	27	0	-18	7021
P29274#32	0	9	9	P29274	58	67	+	9	P29274	0	76	ENST00000439591.1	330	558	++	90	P29274#32	0	27	ENST00000439591.1	504	531	+	27	0	-18	7022
P29274#32	0	9	9	P29274	58	67	+	9	P29274	0	64	ENST00000436735.1	476	668	++	88	P29274#32	0	18	ENST00000436735.1	650	668	+	18	0	-9	7023
P29274#32	0	9	9	P29274	58	67	+	9	P29274	0	87	ENST00000424232.5	306	567	++	80	P29274#32	0	27	ENST00000424232.5	480	507	+	27	0	-18	7024
P29274#32	0	9	9	P29274	58	67	+	9	P29274	0	412	ENST00000337539.12	422	1658	++	31	P29274#32	0	27	ENST00000337539.12	596	623	+	27	0	-18	7025
P29274#33	0	3	3	P29274	70	73	+	3	P29274	0	412	ENST00000618076.3	524	1760	++	224	P29274#33	0	9	ENST00000618076.3	734	743	+	9	0	-6	7026
P29274#33	0	3	3	P29274	70	73	+	3	P29274	0	412	ENST00000611543.4	306	1542	++	222	P29274#33	0	9	ENST00000611543.4	516	525	+	9	0	-6	7027
P29274#33	0	3	3	P29274	70	73	+	3	P29274	0	412	ENST00000610595.4	630	1866	++	221	P29274#33	0	9	ENST00000610595.4	840	849	+	9	0	-6	7028
P29274#33	0	3	3	P29274	70	73	+	3	P29274	0	83	ENST00000496258.1	439	688	++	123	P29274#33	0	9	ENST00000496258.1	649	658	+	9	0	-6	7029
P29274#33	0	3	3	P29274	70	73	+	3	P29274	0	108	ENST00000486108.1	601	925	++	115	P29274#33	0	9	ENST00000486108.1	811	820	+	9	0	-6	7030
P29274#33	0	3	3	P29274	70	73	+	3	P29274	0	365	ENST00000444262.6	422	1517	++	92	P29274#33	0	9	ENST00000444262.6	632	641	+	9	0	-6	7031
P29274#33	0	3	3	P29274	70	73	+	3	P29274	0	76	ENST00000439591.1	330	558	++	90	P29274#33	0	9	ENST00000439591.1	540	549	+	9	0	-6	7032
P29274#33	0	3	3	P29274	70	73	+	3	P29274	0	87	ENST00000424232.5	306	567	++	80	P29274#33	0	9	ENST00000424232.5	516	525	+	9	0	-6	7033
P29274#33	0	3	3	P29274	70	73	+	3	P29274	0	412	ENST00000337539.12	422	1658	++	31	P29274#33	0	9	ENST00000337539.12	632	641	+	9	0	-6	7034
P29274#34	0	34	34	P29274	73	107	+	34	P29274	0	412	ENST00000618076.3	524	1760	++	224	P29274#34	0	102	ENST00000618076.3	743	845	+	102	0	-68	7035
P29274#34	0	34	34	P29274	73	107	+	34	P29274	0	412	ENST00000611543.4	306	1542	++	222	P29274#34	0	102	ENST00000611543.4	525	627	+	102	0	-68	7036
P29274#34	0	34	34	P29274	73	107	+	34	P29274	0	412	ENST00000610595.4	630	1866	++	221	P29274#34	0	102	ENST00000610595.4	849	951	+	102	0	-68	7037
P29274#34	0	34	34	P29274	73	107	+	34	P29274	0	83	ENST00000496258.1	439	688	++	123	P29274#34	0	30	ENST00000496258.1	658	688	+	30	0	4	7038
P29274#34	0	34	34	P29274	73	107	+	34	P29274	0	108	ENST00000486108.1	601	925	++	115	P29274#34	0	102	ENST00000486108.1	820	922	+	102	0	-68	7039
P29274#34	0	34	34	P29274	73	107	+	34	P29274	0	365	ENST00000444262.6	422	1517	++	92	P29274#34	0	102	ENST00000444262.6	641	743	+	102	0	-68	7040
P29274#34	0	34	34	P29274	73	107	+	34	P29274	0	76	ENST00000439591.1	330	558	++	90	P29274#34	0	9	ENST00000439591.1	549	558	+	9	0	25	7041
P29274#34	0	34	34	P29274	73	107	+	34	P29274	0	87	ENST00000424232.5	306	567	++	80	P29274#34	0	42	ENST00000424232.5	525	567	+	42	0	-8	7042
P29274#34	0	34	34	P29274	73	107	+	34	P29274	0	412	ENST00000337539.12	422	1658	++	31	P29274#34	0	102	ENST00000337539.12	641	743	+	102	0	-68	7043
P29274#35	0	7	7	P29274	108	115	+	7	P29274	0	412	ENST00000618076.3	524	1760	++	224	P29274#35	0	21	ENST00000618076.3	848	869	+	21	0	-14	7044
P29274#35	0	7	7	P29274	108	115	+	7	P29274	0	412	ENST00000611543.4	306	1542	++	222	P29274#35	0	21	ENST00000611543.4	630	651	+	21	0	-14	7045
P29274#35	0	7	7	P29274	108	115	+	7	P29274	0	412	ENST00000610595.4	630	1866	++	221	P29274#35	0	21	ENST00000610595.4	954	975	+	21	0	-14	7046
P29274#35	0	7	7	P29274	108	115	+	7	P29274	0	365	ENST00000444262.6	422	1517	++	92	P29274#35	0	21	ENST00000444262.6	746	767	+	21	0	-14	7047
P29274#35	0	7	7	P29274	108	115	+	7	P29274	0	412	ENST00000337539.12	422	1658	++	31	P29274#35	0	21	ENST00000337539.12	746	767	+	21	0	-14	7048
P29274#36	0	19	19	P29274	117	136	+	19	P29274	0	412	ENST00000618076.3	524	1760	++	224	P29274#36	0	57	ENST00000618076.3	875	932	+	57	0	-38	7049
P29274#36	0	19	19	P29274	117	136	+	19	P29274	0	412	ENST00000611543.4	306	1542	++	222	P29274#36	0	57	ENST00000611543.4	657	714	+	57	0	-38	7050
P29274#36	0	19	19	P29274	117	136	+	19	P29274	0	412	ENST00000610595.4	630	1866	++	221	P29274#36	0	57	ENST00000610595.4	981	1038	+	57	0	-38	7051
P29274#36	0	19	19	P29274	117	136	+	19	P29274	0	365	ENST00000444262.6	422	1517	++	92	P29274#36	0	57	ENST00000444262.6	773	830	+	57	0	-38	7052
P29274#36	0	19	19	P29274	117	136	+	19	P29274	0	412	ENST00000337539.12	422	1658	++	31	P29274#36	0	57	ENST00000337539.12	773	830	+	57	0	-38	7053
P29274#37	0	4	4	P29274	137	141	+	4	P29274	0	412	ENST00000618076.3	524	1760	++	224	P29274#37	0	12	ENST00000618076.3	935	947	+	12	0	-8	7054
P29274#37	0	4	4	P29274	137	141	+	4	P29274	0	412	ENST00000611543.4	306	1542	++	222	P29274#37	0	12	ENST00000611543.4	717	729	+	12	0	-8	7055
P29274#37	0	4	4	P29274	137	141	+	4	P29274	0	412	ENST00000610595.4	630	1866	++	221	P29274#37	0	12	ENST00000610595.4	1041	1053	+	12	0	-8	7056
P29274#37	0	4	4	P29274	137	141	+	4	P29274	0	365	ENST00000444262.6	422	1517	++	92	P29274#37	0	12	ENST00000444262.6	833	845	+	12	0	-8	7057
P29274#37	0	4	4	P29274	137	141	+	4	P29274	0	412	ENST00000337539.12	422	1658	++	31	P29274#37	0	12	ENST00000337539.12	833	845	+	12	0	-8	7058
P29274#38	0	5	5	P29274	143	148	+	5	P29274	0	412	ENST00000618076.3	524	1760	++	224	P29274#38	0	15	ENST00000618076.3	953	968	+	15	0	-10	7059
P29274#38	0	5	5	P29274	143	148	+	5	P29274	0	412	ENST00000611543.4	306	1542	++	222	P29274#38	0	15	ENST00000611543.4	735	750	+	15	0	-10	7060
P29274#38	0	5	5	P29274	143	148	+	5	P29274	0	412	ENST00000610595.4	630	1866	++	221	P29274#38	0	15	ENST00000610595.4	1059	1074	+	15	0	-10	7061
P29274#38	0	5	5	P29274	143	148	+	5	P29274	0	365	ENST00000444262.6	422	1517	++	92	P29274#38	0	15	ENST00000444262.6	851	866	+	15	0	-10	7062
P29274#38	0	5	5	P29274	143	148	+	5	P29274	0	412	ENST00000337539.12	422	1658	++	31	P29274#38	0	15	ENST00000337539.12	851	866	+	15	0	-10	7063
P29274#39	0	7	7	P29274	150	157	+	7	P29274	0	412	ENST00000618076.3	524	1760	++	224	P29274#39	0	21	ENST00000618076.3	974	995	+	21	0	-14	7064
P29274#39	0	7	7	P29274	150	157	+	7	P29274	0	412	ENST00000611543.4	306	1542	++	222	P29274#39	0	21	ENST00000611543.4	756	777	+	21	0	-14	7065
P29274#39	0	7	7	P29274	150	157	+	7	P29274	0	412	ENST00000610595.4	630	1866	++	221	P29274#39	0	21	ENST00000610595.4	1080	1101	+	21	0	-14	7066
P29274#39	0	7	7	P29274	150	157	+	7	P29274	0	365	ENST00000444262.6	422	1517	++	92	P29274#39	0	21	ENST00000444262.6	872	893	+	21	0	-14	7067
P29274#39	0	7	7	P29274	150	157	+	7	P29274	0	412	ENST00000337539.12	422	1658	++	31	P29274#39	0	21	ENST00000337539.12	872	893	+	21	0	-14	7068
P29274#40	0	3	3	P29274	162	165	+	3	P29274	0	412	ENST00000618076.3	524	1760	++	224	P29274#40	0	9	ENST00000618076.3	1010	1019	+	9	0	-6	7069
P29274#40	0	3	3	P29274	162	165	+	3	P29274	0	412	ENST00000611543.4	306	1542	++	222	P29274#40	0	9	ENST00000611543.4	792	801	+	9	0	-6	7070
P29274#40	0	3	3	P29274	162	165	+	3	P29274	0	412	ENST00000610595.4	630	1866	++	221	P29274#40	0	9	ENST00000610595.4	1116	1125	+	9	0	-6	7071
P29274#40	0	3	3	P29274	162	165	+	3	P29274	0	365	ENST00000444262.6	422	1517	++	92	P29274#40	0	9	ENST00000444262.6	908	917	+	9	0	-6	7072
P29274#40	0	3	3	P29274	162	165	+	3	P29274	0	412	ENST00000337539.12	422	1658	++	31	P29274#40	0	9	ENST00000337539.12	908	917	+	9	0	-6	7073
P29274#41	0	4	4	P29274	167	171	+	4	P29274	0	412	ENST00000618076.3	524	1760	++	224	P29274#41	0	12	ENST00000618076.3	1025	1037	+	12	0	-8	7074
P29274#41	0	4	4	P29274	167	171	+	4	P29274	0	412	ENST00000611543.4	306	1542	++	222	P29274#41	0	12	ENST00000611543.4	807	819	+	12	0	-8	7075
P29274#41	0	4	4	P29274	167	171	+	4	P29274	0	412	ENST00000610595.4	630	1866	++	221	P29274#41	0	12	ENST00000610595.4	1131	1143	+	12	0	-8	7076
P29274#41	0	4	4	P29274	167	171	+	4	P29274	0	365	ENST00000444262.6	422	1517	++	92	P29274#41	0	12	ENST00000444262.6	923	935	+	12	0	-8	7077
P29274#41	0	4	4	P29274	167	171	+	4	P29274	0	412	ENST00000337539.12	422	1658	++	31	P29274#41	0	12	ENST00000337539.12	923	935	+	12	0	-8	7078
P29274#42	0	6	6	P29274	173	179	+	6	P29274	0	412	ENST00000618076.3	524	1760	++	224	P29274#42	0	18	ENST00000618076.3	1043	1061	+	18	0	-12	7079
P29274#42	0	6	6	P29274	173	179	+	6	P29274	0	412	ENST00000611543.4	306	1542	++	222	P29274#42	0	18	ENST00000611543.4	825	843	+	18	0	-12	7080
P29274#42	0	6	6	P29274	173	179	+	6	P29274	0	412	ENST00000610595.4	630	1866	++	221	P29274#42	0	18	ENST00000610595.4	1149	1167	+	18	0	-12	7081
P29274#42	0	6	6	P29274	173	179	+	6	P29274	0	365	ENST00000444262.6	422	1517	++	92	P29274#42	0	18	ENST00000444262.6	941	959	+	18	0	-12	7082
P29274#42	0	6	6	P29274	173	179	+	6	P29274	0	412	ENST00000337539.12	422	1658	++	31	P29274#42	0	18	ENST00000337539.12	941	959	+	18	0	-12	7083
P29274#43	0	4	4	P29274	181	185	+	4	P29274	0	412	ENST00000618076.3	524	1760	++	224	P29274#43	0	12	ENST00000618076.3	1067	1079	+	12	0	-8	7084
P29274#43	0	4	4	P29274	181	185	+	4	P29274	0	412	ENST00000611543.4	306	1542	++	222	P29274#43	0	12	ENST00000611543.4	849	861	+	12	0	-8	7085
P29274#43	0	4	4	P29274	181	185	+	4	P29274	0	412	ENST00000610595.4	630	1866	++	221	P29274#43	0	12	ENST00000610595.4	1173	1185	+	12	0	-8	7086
P29274#43	0	4	4	P29274	181	185	+	4	P29274	0	365	ENST00000444262.6	422	1517	++	92	P29274#43	0	12	ENST00000444262.6	965	977	+	12	0	-8	7087
P29274#43	0	4	4	P29274	181	185	+	4	P29274	0	412	ENST00000337539.12	422	1658	++	31	P29274#43	0	12	ENST00000337539.12	965	977	+	12	0	-8	7088
P29274#44	0	22	22	P29274	186	208	+	22	P29274	0	412	ENST00000618076.3	524	1760	++	224	P29274#44	0	66	ENST00000618076.3	1082	1148	+	66	0	-44	7089
P29274#44	0	22	22	P29274	186	208	+	22	P29274	0	412	ENST00000611543.4	306	1542	++	222	P29274#44	0	66	ENST00000611543.4	864	930	+	66	0	-44	7090
P29274#44	0	22	22	P29274	186	208	+	22	P29274	0	412	ENST00000610595.4	630	1866	++	221	P29274#44	0	66	ENST00000610595.4	1188	1254	+	66	0	-44	7091
P29274#44	0	22	22	P29274	186	208	+	22	P29274	0	365	ENST00000444262.6	422	1517	++	92	P29274#44	0	66	ENST00000444262.6	980	1046	+	66	0	-44	7092
P29274#44	0	22	22	P29274	186	208	+	22	P29274	0	412	ENST00000337539.12	422	1658	++	31	P29274#44	0	66	ENST00000337539.12	980	1046	+	66	0	-44	7093
P29274#45	0	4	4	P29274	212	216	+	4	P29274	0	412	ENST00000618076.3	524	1760	++	224	P29274#45	0	12	ENST00000618076.3	1160	1172	+	12	0	-8	7094
P29274#45	0	4	4	P29274	212	216	+	4	P29274	0	412	ENST00000611543.4	306	1542	++	222	P29274#45	0	12	ENST00000611543.4	942	954	+	12	0	-8	7095
P29274#45	0	4	4	P29274	212	216	+	4	P29274	0	412	ENST00000610595.4	630	1866	++	221	P29274#45	0	12	ENST00000610595.4	1266	1278	+	12	0	-8	7096
P29274#45	0	4	4	P29274	212	216	+	4	P29274	0	365	ENST00000444262.6	422	1517	++	92	P29274#45	0	12	ENST00000444262.6	1058	1070	+	12	0	-8	7097
P29274#45	0	4	4	P29274	212	216	+	4	P29274	0	412	ENST00000337539.12	422	1658	++	31	P29274#45	0	12	ENST00000337539.12	1058	1070	+	12	0	-8	7098
P29274#46	0	40	40	P29274	218	258	+	40	P29274	0	412	ENST00000618076.3	524	1760	++	224	P29274#46	0	120	ENST00000618076.3	1178	1298	+	120	0	-80	7099
P29274#46	0	40	40	P29274	218	258	+	40	P29274	0	412	ENST00000611543.4	306	1542	++	222	P29274#46	0	120	ENST00000611543.4	960	1080	+	120	0	-80	7100
P29274#46	0	40	40	P29274	218	258	+	40	P29274	0	412	ENST00000610595.4	630	1866	++	221	P29274#46	0	120	ENST00000610595.4	1284	1404	+	120	0	-80	7101
P29274#46	0	40	40	P29274	218	258	+	40	P29274	0	365	ENST00000444262.6	422	1517	++	92	P29274#46	0	120	ENST00000444262.6	1076	1196	+	120	0	-80	7102
P29274#46	0	40	40	P29274	218	258	+	40	P29274	0	412	ENST00000337539.12	422	1658	++	31	P29274#46	0	120	ENST00000337539.12	1076	1196	+	120	0	-80	7103
P29274#47	0	3	3	P29274	259	262	+	3	P29274	0	412	ENST00000618076.3	524	1760	++	224	P29274#47	0	9	ENST00000618076.3	1301	1310	+	9	0	-6	7104
P29274#47	0	3	3	P29274	259	262	+	3	P29274	0	412	ENST00000611543.4	306	1542	++	222	P29274#47	0	9	ENST00000611543.4	1083	1092	+	9	0	-6	7105
P29274#47	0	3	3	P29274	259	262	+	3	P29274	0	412	ENST00000610595.4	630	1866	++	221	P29274#47	0	9	ENST00000610595.4	1407	1416	+	9	0	-6	7106
P29274#47	0	3	3	P29274	259	262	+	3	P29274	0	365	ENST00000444262.6	422	1517	++	92	P29274#47	0	9	ENST00000444262.6	1199	1208	+	9	0	-6	7107
P29274#47	0	3	3	P29274	259	262	+	3	P29274	0	412	ENST00000337539.12	422	1658	++	31	P29274#47	0	9	ENST00000337539.12	1199	1208	+	9	0	-6	7108
P29274#48	0	25	25	P29274	266	291	+	25	P29274	0	412	ENST00000618076.3	524	1760	++	224	P29274#48	0	75	ENST00000618076.3	1322	1397	+	75	0	-50	7109
P29274#48	0	25	25	P29274	266	291	+	25	P29274	0	412	ENST00000611543.4	306	1542	++	222	P29274#48	0	75	ENST00000611543.4	1104	1179	+	75	0	-50	7110
P29274#48	0	25	25	P29274	266	291	+	25	P29274	0	412	ENST00000610595.4	630	1866	++	221	P29274#48	0	75	ENST00000610595.4	1428	1503	+	75	0	-50	7111
P29274#48	0	25	25	P29274	266	291	+	25	P29274	0	365	ENST00000444262.6	422	1517	++	92	P29274#48	0	75	ENST00000444262.6	1220	1295	+	75	0	-50	7112
P29274#48	0	25	25	P29274	266	291	+	25	P29274	0	412	ENST00000337539.12	422	1658	++	31	P29274#48	0	75	ENST00000337539.12	1220	1295	+	75	0	-50	7113
P29274#49	0	11	11	P29274	292	303	+	11	P29274	0	412	ENST00000618076.3	524	1760	++	224	P29274#49	0	33	ENST00000618076.3	1400	1433	+	33	0	-22	7114
P29274#49	0	11	11	P29274	292	303	+	11	P29274	0	412	ENST00000611543.4	306	1542	++	222	P29274#49	0	33	ENST00000611543.4	1182	1215	+	33	0	-22	7115
P29274#49	0	11	11	P29274	292	303	+	11	P29274	0	412	ENST00000610595.4	630	1866	++	221	P29274#49	0	33	ENST00000610595.4	1506	1539	+	33	0	-22	7116
P29274#49	0	11	11	P29274	292	303	+	11	P29274	0	365	ENST00000444262.6	422	1517	++	92	P29274#49	0	33	ENST00000444262.6	1298	1331	+	33	0	-22	7117
P29274#49	0	11	11	P29274	292	303	+	11	P29274	0	412	ENST00000337539.12	422	1658	++	31	P29274#49	0	33	ENST00000337539.12	1298	1331	+	33	0	-22	7118
P29274#50	0	4	4	P29274	303	307	+	4	P29274	0	412	ENST00000618076.3	524	1760	++	224	P29274#50	0	12	ENST00000618076.3	1433	1445	+	12	0	-8	7119
P29274#50	0	4	4	P29274	303	307	+	4	P29274	0	412	ENST00000611543.4	306	1542	++	222	P29274#50	0	12	ENST00000611543.4	1215	1227	+	12	0	-8	7120
P29274#50	0	4	4	P29274	303	307	+	4	P29274	0	412	ENST00000610595.4	630	1866	++	221	P29274#50	0	12	ENST00000610595.4	1539	1551	+	12	0	-8	7121
P29274#50	0	4	4	P29274	303	307	+	4	P29274	0	365	ENST00000444262.6	422	1517	++	92	P29274#50	0	12	ENST00000444262.6	1331	1343	+	12	0	-8	7122
P29274#50	0	4	4	P29274	303	307	+	4	P29274	0	412	ENST00000337539.12	422	1658	++	31	P29274#50	0	12	ENST00000337539.12	1331	1343	+	12	0	-8	7123
P29274#51	0	3	3	P29274	307	310	+	3	P29274	0	412	ENST00000618076.3	524	1760	++	224	P29274#51	0	9	ENST00000618076.3	1445	1454	+	9	0	-6	7124
P29274#51	0	3	3	P29274	307	310	+	3	P29274	0	412	ENST00000611543.4	306	1542	++	222	P29274#51	0	9	ENST00000611543.4	1227	1236	+	9	0	-6	7125
P29274#51	0	3	3	P29274	307	310	+	3	P29274	0	412	ENST00000610595.4	630	1866	++	221	P29274#51	0	9	ENST00000610595.4	1551	1560	+	9	0	-6	7126
P29274#51	0	3	3	P29274	307	310	+	3	P29274	0	365	ENST00000444262.6	422	1517	++	92	P29274#51	0	9	ENST00000444262.6	1343	1352	+	9	0	-6	7127
P29274#51	0	3	3	P29274	307	310	+	3	P29274	0	412	ENST00000337539.12	422	1658	++	31	P29274#51	0	9	ENST00000337539.12	1343	1352	+	9	0	-6	7128
P29274#52	0	6	6	P29274	311	317	+	6	P29274	0	412	ENST00000618076.3	524	1760	++	224	P29274#52	0	18	ENST00000618076.3	1457	1475	+	18	0	-12	7129
P29274#52	0	6	6	P29274	311	317	+	6	P29274	0	412	ENST00000611543.4	306	1542	++	222	P29274#52	0	18	ENST00000611543.4	1239	1257	+	18	0	-12	7130
P29274#52	0	6	6	P29274	311	317	+	6	P29274	0	412	ENST00000610595.4	630	1866	++	221	P29274#52	0	18	ENST00000610595.4	1563	1581	+	18	0	-12	7131
P29274#52	0	6	6	P29274	311	317	+	6	P29274	0	365	ENST00000444262.6	422	1517	++	92	P29274#52	0	18	ENST00000444262.6	1355	1373	+	18	0	-12	7132
P29274#52	0	6	6	P29274	311	317	+	6	P29274	0	412	ENST00000337539.12	422	1658	++	31	P29274#52	0	18	ENST00000337539.12	1355	1373	+	18	0	-12	7133
P29275#0	0	332	332	P29275	0	332	+	332	P29275	0	332	ENST00000304222.3	119	1115	++	23	P29275#0	0	996	ENST00000304222.3	119	1115	+	996	0	-664	7134
P29275#1	0	8	8	P29275	0	8	+	8	P29275	0	332	ENST00000304222.3	119	1115	++	23	P29275#1	0	24	ENST00000304222.3	119	143	+	24	0	-16	7135
P29275#2	0	25	25	P29275	8	33	+	25	P29275	0	332	ENST00000304222.3	119	1115	++	23	P29275#2	0	75	ENST00000304222.3	143	218	+	75	0	-50	7136
P29275#3	0	10	10	P29275	33	43	+	10	P29275	0	332	ENST00000304222.3	119	1115	++	23	P29275#3	0	30	ENST00000304222.3	218	248	+	30	0	-20	7137
P29275#4	0	24	24	P29275	43	67	+	24	P29275	0	332	ENST00000304222.3	119	1115	++	23	P29275#4	0	72	ENST00000304222.3	248	320	+	72	0	-48	7138
P29275#5	0	11	11	P29275	67	78	+	11	P29275	0	332	ENST00000304222.3	119	1115	++	23	P29275#5	0	33	ENST00000304222.3	320	353	+	33	0	-22	7139
P29275#6	0	23	23	P29275	78	101	+	23	P29275	0	332	ENST00000304222.3	119	1115	++	23	P29275#6	0	69	ENST00000304222.3	353	422	+	69	0	-46	7140
P29275#7	0	20	20	P29275	101	121	+	20	P29275	0	332	ENST00000304222.3	119	1115	++	23	P29275#7	0	60	ENST00000304222.3	422	482	+	60	0	-40	7141
P29275#8	0	23	23	P29275	121	144	+	23	P29275	0	332	ENST00000304222.3	119	1115	++	23	P29275#8	0	69	ENST00000304222.3	482	551	+	69	0	-46	7142
P29275#9	0	34	34	P29275	144	178	+	34	P29275	0	332	ENST00000304222.3	119	1115	++	23	P29275#9	0	102	ENST00000304222.3	551	653	+	102	0	-68	7143
P29275#10	0	25	25	P29275	178	203	+	25	P29275	0	332	ENST00000304222.3	119	1115	++	23	P29275#10	0	75	ENST00000304222.3	653	728	+	75	0	-50	7144
P29275#11	0	32	32	P29275	203	235	+	32	P29275	0	332	ENST00000304222.3	119	1115	++	23	P29275#11	0	96	ENST00000304222.3	728	824	+	96	0	-64	7145
P29275#12	0	24	24	P29275	235	259	+	24	P29275	0	332	ENST00000304222.3	119	1115	++	23	P29275#12	0	72	ENST00000304222.3	824	896	+	72	0	-48	7146
P29275#13	0	8	8	P29275	259	267	+	8	P29275	0	332	ENST00000304222.3	119	1115	++	23	P29275#13	0	24	ENST00000304222.3	896	920	+	24	0	-16	7147
P29275#14	0	24	24	P29275	267	291	+	24	P29275	0	332	ENST00000304222.3	119	1115	++	23	P29275#14	0	72	ENST00000304222.3	920	992	+	72	0	-48	7148
P29275#15	0	41	41	P29275	291	332	+	41	P29275	0	332	ENST00000304222.3	119	1115	++	23	P29275#15	0	123	ENST00000304222.3	992	1115	+	123	0	-82	7149
P29275#16	0	1	1	P29275	173	174	+	1	P29275	0	332	ENST00000304222.3	119	1115	++	23	P29275#16	0	3	ENST00000304222.3	638	641	+	3	0	-2	7150
P29275#17	0	1	1	P29275	253	254	+	1	P29275	0	332	ENST00000304222.3	119	1115	++	23	P29275#17	0	3	ENST00000304222.3	878	881	+	3	0	-2	7151
P29275#18	0	1	1	P29275	278	279	+	1	P29275	0	332	ENST00000304222.3	119	1115	++	23	P29275#18	0	3	ENST00000304222.3	953	956	+	3	0	-2	7152
P29275#19	0	1	1	P29275	279	280	+	1	P29275	0	332	ENST00000304222.3	119	1115	++	23	P29275#19	0	3	ENST00000304222.3	956	959	+	3	0	-2	7153
P29275#20	0	1	1	P29275	310	311	+	1	P29275	0	332	ENST00000304222.3	119	1115	++	23	P29275#20	0	3	ENST00000304222.3	1049	1052	+	3	0	-2	7154
P29275#21	0	1	1	P29275	152	153	+	1	P29275	0	332	ENST00000304222.3	119	1115	++	23	P29275#21	0	3	ENST00000304222.3	575	578	+	3	0	-2	7155
P29275#22	0	1	1	P29275	162	163	+	1	P29275	0	332	ENST00000304222.3	119	1115	++	23	P29275#22	0	3	ENST00000304222.3	605	608	+	3	0	-2	7156
P29275#23	0	94	94	P29275	77	171	+	94	P29275	0	332	ENST00000304222.3	119	1115	++	23	P29275#23	0	282	ENST00000304222.3	350	632	+	282	0	-188	7157
P29275#24	0	29	29	P29275	4	33	+	29	P29275	0	332	ENST00000304222.3	119	1115	++	23	P29275#24	0	87	ENST00000304222.3	131	218	+	87	0	-58	7158
P29275#25	0	29	29	P29275	40	69	+	29	P29275	0	332	ENST00000304222.3	119	1115	++	23	P29275#25	0	87	ENST00000304222.3	239	326	+	87	0	-58	7159
P29275#26	0	34	34	P29275	74	108	+	34	P29275	0	332	ENST00000304222.3	119	1115	++	23	P29275#26	0	102	ENST00000304222.3	341	443	+	102	0	-68	7160
P29275#27	0	4	4	P29275	112	116	+	4	P29275	0	332	ENST00000304222.3	119	1115	++	23	P29275#27	0	12	ENST00000304222.3	455	467	+	12	0	-8	7161
P29275#28	0	19	19	P29275	118	137	+	19	P29275	0	332	ENST00000304222.3	119	1115	++	23	P29275#28	0	57	ENST00000304222.3	473	530	+	57	0	-38	7162
P29275#29	0	3	3	P29275	139	142	+	3	P29275	0	332	ENST00000304222.3	119	1115	++	23	P29275#29	0	9	ENST00000304222.3	536	545	+	9	0	-6	7163
P29275#30	0	3	3	P29275	146	149	+	3	P29275	0	332	ENST00000304222.3	119	1115	++	23	P29275#30	0	9	ENST00000304222.3	557	566	+	9	0	-6	7164
P29275#31	0	3	3	P29275	172	175	+	3	P29275	0	332	ENST00000304222.3	119	1115	++	23	P29275#31	0	9	ENST00000304222.3	635	644	+	9	0	-6	7165
P29275#32	0	6	6	P29275	178	184	+	6	P29275	0	332	ENST00000304222.3	119	1115	++	23	P29275#32	0	18	ENST00000304222.3	653	671	+	18	0	-12	7166
P29275#33	0	5	5	P29275	185	190	+	5	P29275	0	332	ENST00000304222.3	119	1115	++	23	P29275#33	0	15	ENST00000304222.3	674	689	+	15	0	-10	7167
P29275#34	0	26	26	P29275	191	217	+	26	P29275	0	332	ENST00000304222.3	119	1115	++	23	P29275#34	0	78	ENST00000304222.3	692	770	+	78	0	-52	7168
P29275#35	0	36	36	P29275	223	259	+	36	P29275	0	332	ENST00000304222.3	119	1115	++	23	P29275#35	0	108	ENST00000304222.3	788	896	+	108	0	-72	7169
P29275#36	0	4	4	P29275	261	265	+	4	P29275	0	332	ENST00000304222.3	119	1115	++	23	P29275#36	0	12	ENST00000304222.3	902	914	+	12	0	-8	7170
P29275#37	0	21	21	P29275	269	290	+	21	P29275	0	332	ENST00000304222.3	119	1115	++	23	P29275#37	0	63	ENST00000304222.3	926	989	+	63	0	-42	7171
P29275#38	0	3	3	P29275	290	293	+	3	P29275	0	332	ENST00000304222.3	119	1115	++	23	P29275#38	0	9	ENST00000304222.3	989	998	+	9	0	-6	7172
P29275#39	0	13	13	P29275	294	307	+	13	P29275	0	332	ENST00000304222.3	119	1115	++	23	P29275#39	0	39	ENST00000304222.3	1001	1040	+	39	0	-26	7173
O94911-3#0	0	1621	1621	O94911-3	0	1621	+	1621	O94911-3	353	1012	ENST00000589533.5	1	1978	++	192	O94911-3#0	1059	3036	ENST00000589533.5	1	1978	+	1977	1059	-1415	7174
O94911-3#0	0	1621	1621	O94911-3	0	1621	+	1621	O94911-3	0	1621	ENST00000586539.6	340	5203	++	191	O94911-3#0	0	4863	ENST00000586539.6	340	5203	+	4863	0	-3242	7175
O94911-3#0	0	1621	1621	O94911-3	0	1621	+	1621	O94911-3	0	115	ENST00000585531.1	163	508	++	189	O94911-3#0	0	345	ENST00000585531.1	163	508	+	345	0	1276	7176
O94911-3#0	0	1621	1621	O94911-3	0	1621	+	1621	O94911-3	0	1621	ENST00000430352.6	179	5027	++	81	O94911-3#0	0	4863	ENST00000430352.6	179	5027	+	4848	0	-3242	7177
O94911-3#0	0	1621	1621	O94911-3	0	1621	+	1621	O94911-3	0	1621	ENST00000269080.6	138	4881	++	12	O94911-3#0	0	4863	ENST00000269080.6	138	4881	+	4743	0	-3242	7178
O94911-3#1	0	21	21	O94911-3	29	50	+	21	O94911-3	0	1621	ENST00000586539.6	340	5203	++	191	O94911-3#1	0	63	ENST00000586539.6	427	490	+	63	0	-42	7179
O94911-3#1	0	21	21	O94911-3	29	50	+	21	O94911-3	0	115	ENST00000585531.1	163	508	++	189	O94911-3#1	0	63	ENST00000585531.1	250	313	+	63	0	-42	7180
O94911-3#1	0	21	21	O94911-3	29	50	+	21	O94911-3	0	1621	ENST00000430352.6	179	5027	++	81	O94911-3#1	0	63	ENST00000430352.6	266	329	+	63	0	-42	7181
O94911-3#1	0	21	21	O94911-3	29	50	+	21	O94911-3	0	1621	ENST00000269080.6	138	4881	++	12	O94911-3#1	0	63	ENST00000269080.6	225	288	+	63	0	-42	7182
O94911-3#2	0	21	21	O94911-3	219	240	+	21	O94911-3	0	1621	ENST00000586539.6	340	5203	++	191	O94911-3#2	0	63	ENST00000586539.6	997	1060	+	63	0	-42	7183
O94911-3#2	0	21	21	O94911-3	219	240	+	21	O94911-3	0	1621	ENST00000430352.6	179	5027	++	81	O94911-3#2	0	63	ENST00000430352.6	836	899	+	63	0	-42	7184
O94911-3#2	0	21	21	O94911-3	219	240	+	21	O94911-3	0	1621	ENST00000269080.6	138	4881	++	12	O94911-3#2	0	63	ENST00000269080.6	795	858	+	63	0	-42	7185
O94911-3#3	0	21	21	O94911-3	267	288	+	21	O94911-3	0	1621	ENST00000586539.6	340	5203	++	191	O94911-3#3	0	63	ENST00000586539.6	1141	1204	+	63	0	-42	7186
O94911-3#3	0	21	21	O94911-3	267	288	+	21	O94911-3	0	1621	ENST00000430352.6	179	5027	++	81	O94911-3#3	0	63	ENST00000430352.6	980	1043	+	63	0	-42	7187
O94911-3#3	0	21	21	O94911-3	267	288	+	21	O94911-3	0	1621	ENST00000269080.6	138	4881	++	12	O94911-3#3	0	63	ENST00000269080.6	939	1002	+	63	0	-42	7188
O94911-3#4	0	21	21	O94911-3	298	319	+	21	O94911-3	0	1621	ENST00000586539.6	340	5203	++	191	O94911-3#4	0	63	ENST00000586539.6	1234	1297	+	63	0	-42	7189
O94911-3#4	0	21	21	O94911-3	298	319	+	21	O94911-3	0	1621	ENST00000430352.6	179	5027	++	81	O94911-3#4	0	63	ENST00000430352.6	1073	1136	+	63	0	-42	7190
O94911-3#4	0	21	21	O94911-3	298	319	+	21	O94911-3	0	1621	ENST00000269080.6	138	4881	++	12	O94911-3#4	0	63	ENST00000269080.6	1032	1095	+	63	0	-42	7191
O94911-3#5	0	21	21	O94911-3	326	347	+	21	O94911-3	0	1621	ENST00000586539.6	340	5203	++	191	O94911-3#5	0	63	ENST00000586539.6	1318	1381	+	63	0	-42	7192
O94911-3#5	0	21	21	O94911-3	326	347	+	21	O94911-3	0	1621	ENST00000430352.6	179	5027	++	81	O94911-3#5	0	63	ENST00000430352.6	1157	1220	+	63	0	-42	7193
O94911-3#5	0	21	21	O94911-3	326	347	+	21	O94911-3	0	1621	ENST00000269080.6	138	4881	++	12	O94911-3#5	0	63	ENST00000269080.6	1116	1179	+	63	0	-42	7194
O94911-3#6	0	21	21	O94911-3	358	379	+	21	O94911-3	353	1012	ENST00000589533.5	1	1978	++	192	O94911-3#6	0	63	ENST00000589533.5	16	79	+	63	0	-42	7195
O94911-3#6	0	21	21	O94911-3	358	379	+	21	O94911-3	0	1621	ENST00000586539.6	340	5203	++	191	O94911-3#6	0	63	ENST00000586539.6	1414	1477	+	63	0	-42	7196
O94911-3#6	0	21	21	O94911-3	358	379	+	21	O94911-3	0	1621	ENST00000430352.6	179	5027	++	81	O94911-3#6	0	63	ENST00000430352.6	1253	1316	+	63	0	-42	7197
O94911-3#6	0	21	21	O94911-3	358	379	+	21	O94911-3	0	1621	ENST00000269080.6	138	4881	++	12	O94911-3#6	0	63	ENST00000269080.6	1212	1275	+	63	0	-42	7198
O94911-3#7	0	21	21	O94911-3	396	417	+	21	O94911-3	353	1012	ENST00000589533.5	1	1978	++	192	O94911-3#7	0	63	ENST00000589533.5	130	193	+	63	0	-42	7199
O94911-3#7	0	21	21	O94911-3	396	417	+	21	O94911-3	0	1621	ENST00000586539.6	340	5203	++	191	O94911-3#7	0	63	ENST00000586539.6	1528	1591	+	63	0	-42	7200
O94911-3#7	0	21	21	O94911-3	396	417	+	21	O94911-3	0	1621	ENST00000430352.6	179	5027	++	81	O94911-3#7	0	63	ENST00000430352.6	1367	1430	+	63	0	-42	7201
O94911-3#7	0	21	21	O94911-3	396	417	+	21	O94911-3	0	1621	ENST00000269080.6	138	4881	++	12	O94911-3#7	0	63	ENST00000269080.6	1326	1389	+	63	0	-42	7202
O94911-3#8	0	21	21	O94911-3	863	884	+	21	O94911-3	353	1012	ENST00000589533.5	1	1978	++	192	O94911-3#8	0	63	ENST00000589533.5	1531	1594	+	63	0	-42	7203
O94911-3#8	0	21	21	O94911-3	863	884	+	21	O94911-3	0	1621	ENST00000586539.6	340	5203	++	191	O94911-3#8	0	63	ENST00000586539.6	2929	2992	+	63	0	-42	7204
O94911-3#8	0	21	21	O94911-3	863	884	+	21	O94911-3	0	1621	ENST00000430352.6	179	5027	++	81	O94911-3#8	0	63	ENST00000430352.6	2768	2831	+	63	0	-42	7205
O94911-3#8	0	21	21	O94911-3	863	884	+	21	O94911-3	0	1621	ENST00000269080.6	138	4881	++	12	O94911-3#8	0	63	ENST00000269080.6	2607	2670	+	63	0	-42	7206
O94911-3#9	0	21	21	O94911-3	1018	1039	+	21	O94911-3	0	1621	ENST00000586539.6	340	5203	++	191	O94911-3#9	0	63	ENST00000586539.6	3394	3457	+	63	0	-42	7207
O94911-3#9	0	21	21	O94911-3	1018	1039	+	21	O94911-3	0	1621	ENST00000430352.6	179	5027	++	81	O94911-3#9	0	63	ENST00000430352.6	3233	3296	+	63	0	-42	7208
O94911-3#9	0	21	21	O94911-3	1018	1039	+	21	O94911-3	0	1621	ENST00000269080.6	138	4881	++	12	O94911-3#9	0	63	ENST00000269080.6	3072	3135	+	63	0	-42	7209
O94911-3#10	0	21	21	O94911-3	1069	1090	+	21	O94911-3	0	1621	ENST00000586539.6	340	5203	++	191	O94911-3#10	0	63	ENST00000586539.6	3547	3610	+	63	0	-42	7210
O94911-3#10	0	21	21	O94911-3	1069	1090	+	21	O94911-3	0	1621	ENST00000430352.6	179	5027	++	81	O94911-3#10	0	63	ENST00000430352.6	3386	3449	+	63	0	-42	7211
O94911-3#10	0	21	21	O94911-3	1069	1090	+	21	O94911-3	0	1621	ENST00000269080.6	138	4881	++	12	O94911-3#10	0	63	ENST00000269080.6	3225	3288	+	63	0	-42	7212
O94911-3#11	0	21	21	O94911-3	1105	1126	+	21	O94911-3	0	1621	ENST00000586539.6	340	5203	++	191	O94911-3#11	0	63	ENST00000586539.6	3655	3718	+	63	0	-42	7213
O94911-3#11	0	21	21	O94911-3	1105	1126	+	21	O94911-3	0	1621	ENST00000430352.6	179	5027	++	81	O94911-3#11	0	63	ENST00000430352.6	3494	3557	+	63	0	-42	7214
O94911-3#11	0	21	21	O94911-3	1105	1126	+	21	O94911-3	0	1621	ENST00000269080.6	138	4881	++	12	O94911-3#11	0	63	ENST00000269080.6	3333	3396	+	63	0	-42	7215
O94911-3#12	0	21	21	O94911-3	1135	1156	+	21	O94911-3	0	1621	ENST00000586539.6	340	5203	++	191	O94911-3#12	0	63	ENST00000586539.6	3745	3808	+	63	0	-42	7216
O94911-3#12	0	21	21	O94911-3	1135	1156	+	21	O94911-3	0	1621	ENST00000430352.6	179	5027	++	81	O94911-3#12	0	63	ENST00000430352.6	3584	3647	+	63	0	-42	7217
O94911-3#12	0	21	21	O94911-3	1135	1156	+	21	O94911-3	0	1621	ENST00000269080.6	138	4881	++	12	O94911-3#12	0	63	ENST00000269080.6	3423	3486	+	63	0	-42	7218
O94911-3#13	0	21	21	O94911-3	1160	1181	+	21	O94911-3	0	1621	ENST00000586539.6	340	5203	++	191	O94911-3#13	0	63	ENST00000586539.6	3820	3883	+	63	0	-42	7219
O94911-3#13	0	21	21	O94911-3	1160	1181	+	21	O94911-3	0	1621	ENST00000430352.6	179	5027	++	81	O94911-3#13	0	63	ENST00000430352.6	3659	3722	+	63	0	-42	7220
O94911-3#13	0	21	21	O94911-3	1160	1181	+	21	O94911-3	0	1621	ENST00000269080.6	138	4881	++	12	O94911-3#13	0	63	ENST00000269080.6	3498	3561	+	63	0	-42	7221
O94911-3#14	0	21	21	O94911-3	1196	1217	+	21	O94911-3	0	1621	ENST00000586539.6	340	5203	++	191	O94911-3#14	0	63	ENST00000586539.6	3928	3991	+	63	0	-42	7222
O94911-3#14	0	21	21	O94911-3	1196	1217	+	21	O94911-3	0	1621	ENST00000430352.6	179	5027	++	81	O94911-3#14	0	63	ENST00000430352.6	3767	3830	+	63	0	-42	7223
O94911-3#14	0	21	21	O94911-3	1196	1217	+	21	O94911-3	0	1621	ENST00000269080.6	138	4881	++	12	O94911-3#14	0	63	ENST00000269080.6	3606	3669	+	63	0	-42	7224
O94911-3#15	0	236	236	O94911-3	479	715	+	236	O94911-3	353	1012	ENST00000589533.5	1	1978	++	192	O94911-3#15	0	708	ENST00000589533.5	379	1087	+	708	0	-472	7225
O94911-3#15	0	236	236	O94911-3	479	715	+	236	O94911-3	0	1621	ENST00000586539.6	340	5203	++	191	O94911-3#15	0	708	ENST00000586539.6	1777	2485	+	708	0	-472	7226
O94911-3#15	0	236	236	O94911-3	479	715	+	236	O94911-3	0	1621	ENST00000430352.6	179	5027	++	81	O94911-3#15	0	708	ENST00000430352.6	1616	2324	+	708	0	-472	7227
O94911-3#15	0	236	236	O94911-3	479	715	+	236	O94911-3	0	1621	ENST00000269080.6	138	4881	++	12	O94911-3#15	0	708	ENST00000269080.6	1575	2163	+	588	0	-472	7228
O94911-3#16	0	234	234	O94911-3	1284	1518	+	234	O94911-3	0	1621	ENST00000586539.6	340	5203	++	191	O94911-3#16	0	702	ENST00000586539.6	4192	4894	+	702	0	-468	7229
O94911-3#16	0	234	234	O94911-3	1284	1518	+	234	O94911-3	0	1621	ENST00000430352.6	179	5027	++	81	O94911-3#16	0	702	ENST00000430352.6	4016	4718	+	702	0	-468	7230
O94911-3#16	0	234	234	O94911-3	1284	1518	+	234	O94911-3	0	1621	ENST00000269080.6	138	4881	++	12	O94911-3#16	0	702	ENST00000269080.6	3870	4572	+	702	0	-468	7231
O94911-3#17	0	8	8	O94911-3	515	523	+	8	O94911-3	353	1012	ENST00000589533.5	1	1978	++	192	O94911-3#17	0	24	ENST00000589533.5	487	511	+	24	0	-16	7232
O94911-3#17	0	8	8	O94911-3	515	523	+	8	O94911-3	0	1621	ENST00000586539.6	340	5203	++	191	O94911-3#17	0	24	ENST00000586539.6	1885	1909	+	24	0	-16	7233
O94911-3#17	0	8	8	O94911-3	515	523	+	8	O94911-3	0	1621	ENST00000430352.6	179	5027	++	81	O94911-3#17	0	24	ENST00000430352.6	1724	1748	+	24	0	-16	7234
O94911-3#17	0	8	8	O94911-3	515	523	+	8	O94911-3	0	1621	ENST00000269080.6	138	4881	++	12	O94911-3#17	0	24	ENST00000269080.6	1683	1707	+	24	0	-16	7235
O94911-3#18	0	8	8	O94911-3	1322	1330	+	8	O94911-3	0	1621	ENST00000586539.6	340	5203	++	191	O94911-3#18	0	24	ENST00000586539.6	4306	4330	+	24	0	-16	7236
O94911-3#18	0	8	8	O94911-3	1322	1330	+	8	O94911-3	0	1621	ENST00000430352.6	179	5027	++	81	O94911-3#18	0	24	ENST00000430352.6	4130	4154	+	24	0	-16	7237
O94911-3#18	0	8	8	O94911-3	1322	1330	+	8	O94911-3	0	1621	ENST00000269080.6	138	4881	++	12	O94911-3#18	0	24	ENST00000269080.6	3984	4008	+	24	0	-16	7238
O94911-3#19	0	1	1	O94911-3	70	71	+	1	O94911-3	0	1621	ENST00000586539.6	340	5203	++	191	O94911-3#19	0	3	ENST00000586539.6	550	553	+	3	0	-2	7239
O94911-3#19	0	1	1	O94911-3	70	71	+	1	O94911-3	0	115	ENST00000585531.1	163	508	++	189	O94911-3#19	0	3	ENST00000585531.1	373	376	+	3	0	-2	7240
O94911-3#19	0	1	1	O94911-3	70	71	+	1	O94911-3	0	1621	ENST00000430352.6	179	5027	++	81	O94911-3#19	0	3	ENST00000430352.6	389	392	+	3	0	-2	7241
O94911-3#19	0	1	1	O94911-3	70	71	+	1	O94911-3	0	1621	ENST00000269080.6	138	4881	++	12	O94911-3#19	0	3	ENST00000269080.6	348	351	+	3	0	-2	7242
O94911-3#20	0	1	1	O94911-3	83	84	+	1	O94911-3	0	1621	ENST00000586539.6	340	5203	++	191	O94911-3#20	0	3	ENST00000586539.6	589	592	+	3	0	-2	7243
O94911-3#20	0	1	1	O94911-3	83	84	+	1	O94911-3	0	115	ENST00000585531.1	163	508	++	189	O94911-3#20	0	3	ENST00000585531.1	412	415	+	3	0	-2	7244
O94911-3#20	0	1	1	O94911-3	83	84	+	1	O94911-3	0	1621	ENST00000430352.6	179	5027	++	81	O94911-3#20	0	3	ENST00000430352.6	428	431	+	3	0	-2	7245
O94911-3#20	0	1	1	O94911-3	83	84	+	1	O94911-3	0	1621	ENST00000269080.6	138	4881	++	12	O94911-3#20	0	3	ENST00000269080.6	387	390	+	3	0	-2	7246
O94911-3#21	0	1	1	O94911-3	193	194	+	1	O94911-3	0	1621	ENST00000586539.6	340	5203	++	191	O94911-3#21	0	3	ENST00000586539.6	919	922	+	3	0	-2	7247
O94911-3#21	0	1	1	O94911-3	193	194	+	1	O94911-3	0	1621	ENST00000430352.6	179	5027	++	81	O94911-3#21	0	3	ENST00000430352.6	758	761	+	3	0	-2	7248
O94911-3#21	0	1	1	O94911-3	193	194	+	1	O94911-3	0	1621	ENST00000269080.6	138	4881	++	12	O94911-3#21	0	3	ENST00000269080.6	717	720	+	3	0	-2	7249
O94911-3#22	0	1	1	O94911-3	242	243	+	1	O94911-3	0	1621	ENST00000586539.6	340	5203	++	191	O94911-3#22	0	3	ENST00000586539.6	1066	1069	+	3	0	-2	7250
O94911-3#22	0	1	1	O94911-3	242	243	+	1	O94911-3	0	1621	ENST00000430352.6	179	5027	++	81	O94911-3#22	0	3	ENST00000430352.6	905	908	+	3	0	-2	7251
O94911-3#22	0	1	1	O94911-3	242	243	+	1	O94911-3	0	1621	ENST00000269080.6	138	4881	++	12	O94911-3#22	0	3	ENST00000269080.6	864	867	+	3	0	-2	7252
O94911-3#23	0	1	1	O94911-3	483	484	+	1	O94911-3	353	1012	ENST00000589533.5	1	1978	++	192	O94911-3#23	0	3	ENST00000589533.5	391	394	+	3	0	-2	7253
O94911-3#23	0	1	1	O94911-3	483	484	+	1	O94911-3	0	1621	ENST00000586539.6	340	5203	++	191	O94911-3#23	0	3	ENST00000586539.6	1789	1792	+	3	0	-2	7254
O94911-3#23	0	1	1	O94911-3	483	484	+	1	O94911-3	0	1621	ENST00000430352.6	179	5027	++	81	O94911-3#23	0	3	ENST00000430352.6	1628	1631	+	3	0	-2	7255
O94911-3#23	0	1	1	O94911-3	483	484	+	1	O94911-3	0	1621	ENST00000269080.6	138	4881	++	12	O94911-3#23	0	3	ENST00000269080.6	1587	1590	+	3	0	-2	7256
O94911-3#24	0	1	1	O94911-3	554	555	+	1	O94911-3	353	1012	ENST00000589533.5	1	1978	++	192	O94911-3#24	0	3	ENST00000589533.5	604	607	+	3	0	-2	7257
O94911-3#24	0	1	1	O94911-3	554	555	+	1	O94911-3	0	1621	ENST00000586539.6	340	5203	++	191	O94911-3#24	0	3	ENST00000586539.6	2002	2005	+	3	0	-2	7258
O94911-3#24	0	1	1	O94911-3	554	555	+	1	O94911-3	0	1621	ENST00000430352.6	179	5027	++	81	O94911-3#24	0	3	ENST00000430352.6	1841	1844	+	3	0	-2	7259
O94911-3#24	0	1	1	O94911-3	554	555	+	1	O94911-3	0	1621	ENST00000269080.6	138	4881	++	12	O94911-3#24	0	3	ENST00000269080.6	1800	1803	+	3	0	-2	7260
O94911-3#25	0	1	1	O94911-3	615	616	+	1	O94911-3	353	1012	ENST00000589533.5	1	1978	++	192	O94911-3#25	0	3	ENST00000589533.5	787	790	+	3	0	-2	7261
O94911-3#25	0	1	1	O94911-3	615	616	+	1	O94911-3	0	1621	ENST00000586539.6	340	5203	++	191	O94911-3#25	0	3	ENST00000586539.6	2185	2188	+	3	0	-2	7262
O94911-3#25	0	1	1	O94911-3	615	616	+	1	O94911-3	0	1621	ENST00000430352.6	179	5027	++	81	O94911-3#25	0	3	ENST00000430352.6	2024	2027	+	3	0	-2	7263
O94911-3#26	0	1	1	O94911-3	723	724	+	1	O94911-3	353	1012	ENST00000589533.5	1	1978	++	192	O94911-3#26	0	3	ENST00000589533.5	1111	1114	+	3	0	-2	7264
O94911-3#26	0	1	1	O94911-3	723	724	+	1	O94911-3	0	1621	ENST00000586539.6	340	5203	++	191	O94911-3#26	0	3	ENST00000586539.6	2509	2512	+	3	0	-2	7265
O94911-3#26	0	1	1	O94911-3	723	724	+	1	O94911-3	0	1621	ENST00000430352.6	179	5027	++	81	O94911-3#26	0	3	ENST00000430352.6	2348	2351	+	3	0	-2	7266
O94911-3#26	0	1	1	O94911-3	723	724	+	1	O94911-3	0	1621	ENST00000269080.6	138	4881	++	12	O94911-3#26	0	3	ENST00000269080.6	2187	2190	+	3	0	-2	7267
O94911-3#27	0	1	1	O94911-3	796	797	+	1	O94911-3	353	1012	ENST00000589533.5	1	1978	++	192	O94911-3#27	0	3	ENST00000589533.5	1330	1333	+	3	0	-2	7268
O94911-3#27	0	1	1	O94911-3	796	797	+	1	O94911-3	0	1621	ENST00000586539.6	340	5203	++	191	O94911-3#27	0	3	ENST00000586539.6	2728	2731	+	3	0	-2	7269
O94911-3#27	0	1	1	O94911-3	796	797	+	1	O94911-3	0	1621	ENST00000430352.6	179	5027	++	81	O94911-3#27	0	3	ENST00000430352.6	2567	2570	+	3	0	-2	7270
O94911-3#27	0	1	1	O94911-3	796	797	+	1	O94911-3	0	1621	ENST00000269080.6	138	4881	++	12	O94911-3#27	0	3	ENST00000269080.6	2406	2409	+	3	0	-2	7271
O94911-3#28	0	1	1	O94911-3	918	919	+	1	O94911-3	353	1012	ENST00000589533.5	1	1978	++	192	O94911-3#28	0	3	ENST00000589533.5	1696	1699	+	3	0	-2	7272
O94911-3#28	0	1	1	O94911-3	918	919	+	1	O94911-3	0	1621	ENST00000586539.6	340	5203	++	191	O94911-3#28	0	3	ENST00000586539.6	3094	3097	+	3	0	-2	7273
O94911-3#28	0	1	1	O94911-3	918	919	+	1	O94911-3	0	1621	ENST00000430352.6	179	5027	++	81	O94911-3#28	0	3	ENST00000430352.6	2933	2936	+	3	0	-2	7274
O94911-3#28	0	1	1	O94911-3	918	919	+	1	O94911-3	0	1621	ENST00000269080.6	138	4881	++	12	O94911-3#28	0	3	ENST00000269080.6	2772	2775	+	3	0	-2	7275
O94911-3#29	0	1	1	O94911-3	947	948	+	1	O94911-3	353	1012	ENST00000589533.5	1	1978	++	192	O94911-3#29	0	3	ENST00000589533.5	1783	1786	+	3	0	-2	7276
O94911-3#29	0	1	1	O94911-3	947	948	+	1	O94911-3	0	1621	ENST00000586539.6	340	5203	++	191	O94911-3#29	0	3	ENST00000586539.6	3181	3184	+	3	0	-2	7277
O94911-3#29	0	1	1	O94911-3	947	948	+	1	O94911-3	0	1621	ENST00000430352.6	179	5027	++	81	O94911-3#29	0	3	ENST00000430352.6	3020	3023	+	3	0	-2	7278
O94911-3#29	0	1	1	O94911-3	947	948	+	1	O94911-3	0	1621	ENST00000269080.6	138	4881	++	12	O94911-3#29	0	3	ENST00000269080.6	2859	2862	+	3	0	-2	7279
O94911-3#30	0	1	1	O94911-3	966	967	+	1	O94911-3	353	1012	ENST00000589533.5	1	1978	++	192	O94911-3#30	0	3	ENST00000589533.5	1840	1843	+	3	0	-2	7280
O94911-3#30	0	1	1	O94911-3	966	967	+	1	O94911-3	0	1621	ENST00000586539.6	340	5203	++	191	O94911-3#30	0	3	ENST00000586539.6	3238	3241	+	3	0	-2	7281
O94911-3#30	0	1	1	O94911-3	966	967	+	1	O94911-3	0	1621	ENST00000430352.6	179	5027	++	81	O94911-3#30	0	3	ENST00000430352.6	3077	3080	+	3	0	-2	7282
O94911-3#30	0	1	1	O94911-3	966	967	+	1	O94911-3	0	1621	ENST00000269080.6	138	4881	++	12	O94911-3#30	0	3	ENST00000269080.6	2916	2919	+	3	0	-2	7283
O94911-3#31	0	1	1	O94911-3	1269	1270	+	1	O94911-3	0	1621	ENST00000586539.6	340	5203	++	191	O94911-3#31	0	3	ENST00000586539.6	4147	4150	+	3	0	-2	7284
O94911-3#31	0	1	1	O94911-3	1269	1270	+	1	O94911-3	0	1621	ENST00000430352.6	179	5027	++	81	O94911-3#31	0	3	ENST00000430352.6	3971	3974	+	3	0	-2	7285
O94911-3#31	0	1	1	O94911-3	1269	1270	+	1	O94911-3	0	1621	ENST00000269080.6	138	4881	++	12	O94911-3#31	0	3	ENST00000269080.6	3825	3828	+	3	0	-2	7286
O94911-3#32	0	1	1	O94911-3	1307	1308	+	1	O94911-3	0	1621	ENST00000586539.6	340	5203	++	191	O94911-3#32	0	3	ENST00000586539.6	4261	4264	+	3	0	-2	7287
O94911-3#32	0	1	1	O94911-3	1307	1308	+	1	O94911-3	0	1621	ENST00000430352.6	179	5027	++	81	O94911-3#32	0	3	ENST00000430352.6	4085	4088	+	3	0	-2	7288
O94911-3#32	0	1	1	O94911-3	1307	1308	+	1	O94911-3	0	1621	ENST00000269080.6	138	4881	++	12	O94911-3#32	0	3	ENST00000269080.6	3939	3942	+	3	0	-2	7289
O94911-3#33	0	1	1	O94911-3	1372	1373	+	1	O94911-3	0	1621	ENST00000586539.6	340	5203	++	191	O94911-3#33	0	3	ENST00000586539.6	4456	4459	+	3	0	-2	7290
O94911-3#33	0	1	1	O94911-3	1372	1373	+	1	O94911-3	0	1621	ENST00000430352.6	179	5027	++	81	O94911-3#33	0	3	ENST00000430352.6	4280	4283	+	3	0	-2	7291
O94911-3#33	0	1	1	O94911-3	1372	1373	+	1	O94911-3	0	1621	ENST00000269080.6	138	4881	++	12	O94911-3#33	0	3	ENST00000269080.6	4134	4137	+	3	0	-2	7292
O94911-3#34	0	1	1	O94911-3	1434	1435	+	1	O94911-3	0	1621	ENST00000586539.6	340	5203	++	191	O94911-3#34	0	3	ENST00000586539.6	4642	4645	+	3	0	-2	7293
O94911-3#34	0	1	1	O94911-3	1434	1435	+	1	O94911-3	0	1621	ENST00000430352.6	179	5027	++	81	O94911-3#34	0	3	ENST00000430352.6	4466	4469	+	3	0	-2	7294
O94911-3#34	0	1	1	O94911-3	1434	1435	+	1	O94911-3	0	1621	ENST00000269080.6	138	4881	++	12	O94911-3#34	0	3	ENST00000269080.6	4320	4323	+	3	0	-2	7295
O94911-3#35	0	1355	1355	O94911-3	266	1621	+	1355	O94911-3	353	1012	ENST00000589533.5	1	1978	++	192	O94911-3#35	261	2238	ENST00000589533.5	1	1978	+	1977	261	-883	7296
O94911-3#35	0	1355	1355	O94911-3	266	1621	+	1355	O94911-3	0	1621	ENST00000586539.6	340	5203	++	191	O94911-3#35	0	4065	ENST00000586539.6	1138	5203	+	4065	0	-2710	7297
O94911-3#35	0	1355	1355	O94911-3	266	1621	+	1355	O94911-3	0	1621	ENST00000430352.6	179	5027	++	81	O94911-3#35	0	4065	ENST00000430352.6	977	5027	+	4050	0	-2710	7298
O94911-3#35	0	1355	1355	O94911-3	266	1621	+	1355	O94911-3	0	1621	ENST00000269080.6	138	4881	++	12	O94911-3#35	0	4065	ENST00000269080.6	936	4881	+	3945	0	-2710	7299
O94911-3#36	0	40	40	O94911-3	597	637	+	40	O94911-3	353	1012	ENST00000589533.5	1	1978	++	192	O94911-3#36	0	120	ENST00000589533.5	733	853	+	120	0	-80	7300
O94911-3#36	0	40	40	O94911-3	597	637	+	40	O94911-3	0	1621	ENST00000586539.6	340	5203	++	191	O94911-3#36	0	120	ENST00000586539.6	2131	2251	+	120	0	-80	7301
O94911-3#36	0	40	40	O94911-3	597	637	+	40	O94911-3	0	1621	ENST00000430352.6	179	5027	++	81	O94911-3#36	0	120	ENST00000430352.6	1970	2090	+	120	0	-80	7302
O94911-3#37	0	1	1	O94911-3	255	256	+	1	O94911-3	0	1621	ENST00000586539.6	340	5203	++	191	O94911-3#37	0	3	ENST00000586539.6	1105	1108	+	3	0	-2	7303
O94911-3#37	0	1	1	O94911-3	255	256	+	1	O94911-3	0	1621	ENST00000430352.6	179	5027	++	81	O94911-3#37	0	3	ENST00000430352.6	944	947	+	3	0	-2	7304
O94911-3#37	0	1	1	O94911-3	255	256	+	1	O94911-3	0	1621	ENST00000269080.6	138	4881	++	12	O94911-3#37	0	3	ENST00000269080.6	903	906	+	3	0	-2	7305
O94911-3#38	0	1	1	O94911-3	330	331	+	1	O94911-3	0	1621	ENST00000586539.6	340	5203	++	191	O94911-3#38	0	3	ENST00000586539.6	1330	1333	+	3	0	-2	7306
O94911-3#38	0	1	1	O94911-3	330	331	+	1	O94911-3	0	1621	ENST00000430352.6	179	5027	++	81	O94911-3#38	0	3	ENST00000430352.6	1169	1172	+	3	0	-2	7307
O94911-3#38	0	1	1	O94911-3	330	331	+	1	O94911-3	0	1621	ENST00000269080.6	138	4881	++	12	O94911-3#38	0	3	ENST00000269080.6	1128	1131	+	3	0	-2	7308
O94911-3#39	0	1	1	O94911-3	415	416	+	1	O94911-3	353	1012	ENST00000589533.5	1	1978	++	192	O94911-3#39	0	3	ENST00000589533.5	187	190	+	3	0	-2	7309
O94911-3#39	0	1	1	O94911-3	415	416	+	1	O94911-3	0	1621	ENST00000586539.6	340	5203	++	191	O94911-3#39	0	3	ENST00000586539.6	1585	1588	+	3	0	-2	7310
O94911-3#39	0	1	1	O94911-3	415	416	+	1	O94911-3	0	1621	ENST00000430352.6	179	5027	++	81	O94911-3#39	0	3	ENST00000430352.6	1424	1427	+	3	0	-2	7311
O94911-3#39	0	1	1	O94911-3	415	416	+	1	O94911-3	0	1621	ENST00000269080.6	138	4881	++	12	O94911-3#39	0	3	ENST00000269080.6	1383	1386	+	3	0	-2	7312
O94911-3#40	0	1	1	O94911-3	488	489	+	1	O94911-3	353	1012	ENST00000589533.5	1	1978	++	192	O94911-3#40	0	3	ENST00000589533.5	406	409	+	3	0	-2	7313
O94911-3#40	0	1	1	O94911-3	488	489	+	1	O94911-3	0	1621	ENST00000586539.6	340	5203	++	191	O94911-3#40	0	3	ENST00000586539.6	1804	1807	+	3	0	-2	7314
O94911-3#40	0	1	1	O94911-3	488	489	+	1	O94911-3	0	1621	ENST00000430352.6	179	5027	++	81	O94911-3#40	0	3	ENST00000430352.6	1643	1646	+	3	0	-2	7315
O94911-3#40	0	1	1	O94911-3	488	489	+	1	O94911-3	0	1621	ENST00000269080.6	138	4881	++	12	O94911-3#40	0	3	ENST00000269080.6	1602	1605	+	3	0	-2	7316
O94911-3#41	0	1	1	O94911-3	648	649	+	1	O94911-3	353	1012	ENST00000589533.5	1	1978	++	192	O94911-3#41	0	3	ENST00000589533.5	886	889	+	3	0	-2	7317
O94911-3#41	0	1	1	O94911-3	648	649	+	1	O94911-3	0	1621	ENST00000586539.6	340	5203	++	191	O94911-3#41	0	3	ENST00000586539.6	2284	2287	+	3	0	-2	7318
O94911-3#41	0	1	1	O94911-3	648	649	+	1	O94911-3	0	1621	ENST00000430352.6	179	5027	++	81	O94911-3#41	0	3	ENST00000430352.6	2123	2126	+	3	0	-2	7319
O94911-3#41	0	1	1	O94911-3	648	649	+	1	O94911-3	0	1621	ENST00000269080.6	138	4881	++	12	O94911-3#41	0	3	ENST00000269080.6	1962	1965	+	3	0	-2	7320
O94911-3#42	0	1	1	O94911-3	658	659	+	1	O94911-3	353	1012	ENST00000589533.5	1	1978	++	192	O94911-3#42	0	3	ENST00000589533.5	916	919	+	3	0	-2	7321
O94911-3#42	0	1	1	O94911-3	658	659	+	1	O94911-3	0	1621	ENST00000586539.6	340	5203	++	191	O94911-3#42	0	3	ENST00000586539.6	2314	2317	+	3	0	-2	7322
O94911-3#42	0	1	1	O94911-3	658	659	+	1	O94911-3	0	1621	ENST00000430352.6	179	5027	++	81	O94911-3#42	0	3	ENST00000430352.6	2153	2156	+	3	0	-2	7323
O94911-3#42	0	1	1	O94911-3	658	659	+	1	O94911-3	0	1621	ENST00000269080.6	138	4881	++	12	O94911-3#42	0	3	ENST00000269080.6	1992	1995	+	3	0	-2	7324
O94911-3#43	0	1	1	O94911-3	719	720	+	1	O94911-3	353	1012	ENST00000589533.5	1	1978	++	192	O94911-3#43	0	3	ENST00000589533.5	1099	1102	+	3	0	-2	7325
O94911-3#43	0	1	1	O94911-3	719	720	+	1	O94911-3	0	1621	ENST00000586539.6	340	5203	++	191	O94911-3#43	0	3	ENST00000586539.6	2497	2500	+	3	0	-2	7326
O94911-3#43	0	1	1	O94911-3	719	720	+	1	O94911-3	0	1621	ENST00000430352.6	179	5027	++	81	O94911-3#43	0	3	ENST00000430352.6	2336	2339	+	3	0	-2	7327
O94911-3#43	0	1	1	O94911-3	719	720	+	1	O94911-3	0	1621	ENST00000269080.6	138	4881	++	12	O94911-3#43	0	3	ENST00000269080.6	2175	2178	+	3	0	-2	7328
O94911-3#44	0	841	841	O94911-3	780	1621	+	841	O94911-3	353	1012	ENST00000589533.5	1	1978	++	192	O94911-3#44	0	696	ENST00000589533.5	1282	1978	+	696	0	145	7329
O94911-3#44	0	841	841	O94911-3	780	1621	+	841	O94911-3	0	1621	ENST00000586539.6	340	5203	++	191	O94911-3#44	0	2523	ENST00000586539.6	2680	5203	+	2523	0	-1682	7330
O94911-3#44	0	841	841	O94911-3	780	1621	+	841	O94911-3	0	1621	ENST00000430352.6	179	5027	++	81	O94911-3#44	0	2523	ENST00000430352.6	2519	5027	+	2508	0	-1682	7331
O94911-3#44	0	841	841	O94911-3	780	1621	+	841	O94911-3	0	1621	ENST00000269080.6	138	4881	++	12	O94911-3#44	0	2523	ENST00000269080.6	2358	4881	+	2523	0	-1682	7332
O94911-3#45	0	1	1	O94911-3	1469	1470	+	1	O94911-3	0	1621	ENST00000586539.6	340	5203	++	191	O94911-3#45	0	3	ENST00000586539.6	4747	4750	+	3	0	-2	7333
O94911-3#45	0	1	1	O94911-3	1469	1470	+	1	O94911-3	0	1621	ENST00000430352.6	179	5027	++	81	O94911-3#45	0	3	ENST00000430352.6	4571	4574	+	3	0	-2	7334
O94911-3#45	0	1	1	O94911-3	1469	1470	+	1	O94911-3	0	1621	ENST00000269080.6	138	4881	++	12	O94911-3#45	0	3	ENST00000269080.6	4425	4428	+	3	0	-2	7335
Q8IUA7-1#0	0	1624	1624	Q8IUA7-1	0	1624	+	1624	Q8IUA7-1	0	89	ENST00000585714.1	313	580	++	190	Q8IUA7-1#0	0	267	ENST00000585714.1	313	580	+	267	0	1357	7336
Q8IUA7-1#0	0	1624	1624	Q8IUA7-1	0	1624	+	1624	Q8IUA7-1	0	267	ENST00000495634.5	54	855	++	122	Q8IUA7-1#0	0	801	ENST00000495634.5	54	855	+	801	0	823	7337
Q8IUA7-1#0	0	1624	1624	Q8IUA7-1	0	1624	+	1624	Q8IUA7-1	0	1624	ENST00000453985.6	72	4830	++	102	Q8IUA7-1#0	0	4872	ENST00000453985.6	72	4830	+	4758	0	-3248	7338
Q8IUA7-1#0	0	1624	1624	Q8IUA7-1	0	1624	+	1624	Q8IUA7-1	0	1624	ENST00000340001.9	75	4947	++	33	Q8IUA7-1#0	0	4872	ENST00000340001.9	75	4947	+	4872	0	-3248	7339
Q8IUA7-1#1	0	21	21	Q8IUA7-1	30	51	+	21	Q8IUA7-1	0	89	ENST00000585714.1	313	580	++	190	Q8IUA7-1#1	0	63	ENST00000585714.1	403	466	+	63	0	-42	7340
Q8IUA7-1#1	0	21	21	Q8IUA7-1	30	51	+	21	Q8IUA7-1	0	267	ENST00000495634.5	54	855	++	122	Q8IUA7-1#1	0	63	ENST00000495634.5	144	207	+	63	0	-42	7341
Q8IUA7-1#1	0	21	21	Q8IUA7-1	30	51	+	21	Q8IUA7-1	0	1624	ENST00000453985.6	72	4830	++	102	Q8IUA7-1#1	0	63	ENST00000453985.6	162	225	+	63	0	-42	7342
Q8IUA7-1#1	0	21	21	Q8IUA7-1	30	51	+	21	Q8IUA7-1	0	1624	ENST00000340001.9	75	4947	++	33	Q8IUA7-1#1	0	63	ENST00000340001.9	165	228	+	63	0	-42	7343
Q8IUA7-1#2	0	23	23	Q8IUA7-1	220	243	+	23	Q8IUA7-1	0	267	ENST00000495634.5	54	855	++	122	Q8IUA7-1#2	0	69	ENST00000495634.5	714	783	+	69	0	-46	7344
Q8IUA7-1#2	0	23	23	Q8IUA7-1	220	243	+	23	Q8IUA7-1	0	1624	ENST00000453985.6	72	4830	++	102	Q8IUA7-1#2	0	69	ENST00000453985.6	732	801	+	69	0	-46	7345
Q8IUA7-1#2	0	23	23	Q8IUA7-1	220	243	+	23	Q8IUA7-1	0	1624	ENST00000340001.9	75	4947	++	33	Q8IUA7-1#2	0	69	ENST00000340001.9	735	804	+	69	0	-46	7346
Q8IUA7-1#3	0	21	21	Q8IUA7-1	268	289	+	21	Q8IUA7-1	0	1624	ENST00000453985.6	72	4830	++	102	Q8IUA7-1#3	0	63	ENST00000453985.6	876	939	+	63	0	-42	7347
Q8IUA7-1#3	0	21	21	Q8IUA7-1	268	289	+	21	Q8IUA7-1	0	1624	ENST00000340001.9	75	4947	++	33	Q8IUA7-1#3	0	63	ENST00000340001.9	879	942	+	63	0	-42	7348
Q8IUA7-1#4	0	21	21	Q8IUA7-1	299	320	+	21	Q8IUA7-1	0	1624	ENST00000453985.6	72	4830	++	102	Q8IUA7-1#4	0	63	ENST00000453985.6	969	1032	+	63	0	-42	7349
Q8IUA7-1#4	0	21	21	Q8IUA7-1	299	320	+	21	Q8IUA7-1	0	1624	ENST00000340001.9	75	4947	++	33	Q8IUA7-1#4	0	63	ENST00000340001.9	972	1035	+	63	0	-42	7350
Q8IUA7-1#5	0	21	21	Q8IUA7-1	328	349	+	21	Q8IUA7-1	0	1624	ENST00000453985.6	72	4830	++	102	Q8IUA7-1#5	0	63	ENST00000453985.6	1056	1119	+	63	0	-42	7351
Q8IUA7-1#5	0	21	21	Q8IUA7-1	328	349	+	21	Q8IUA7-1	0	1624	ENST00000340001.9	75	4947	++	33	Q8IUA7-1#5	0	63	ENST00000340001.9	1059	1122	+	63	0	-42	7352
Q8IUA7-1#6	0	21	21	Q8IUA7-1	353	374	+	21	Q8IUA7-1	0	1624	ENST00000453985.6	72	4830	++	102	Q8IUA7-1#6	0	63	ENST00000453985.6	1131	1194	+	63	0	-42	7353
Q8IUA7-1#6	0	21	21	Q8IUA7-1	353	374	+	21	Q8IUA7-1	0	1624	ENST00000340001.9	75	4947	++	33	Q8IUA7-1#6	0	63	ENST00000340001.9	1134	1197	+	63	0	-42	7354
Q8IUA7-1#7	0	21	21	Q8IUA7-1	397	418	+	21	Q8IUA7-1	0	1624	ENST00000453985.6	72	4830	++	102	Q8IUA7-1#7	0	63	ENST00000453985.6	1263	1326	+	63	0	-42	7355
Q8IUA7-1#7	0	21	21	Q8IUA7-1	397	418	+	21	Q8IUA7-1	0	1624	ENST00000340001.9	75	4947	++	33	Q8IUA7-1#7	0	63	ENST00000340001.9	1266	1329	+	63	0	-42	7356
Q8IUA7-1#8	0	21	21	Q8IUA7-1	863	884	+	21	Q8IUA7-1	0	1624	ENST00000453985.6	72	4830	++	102	Q8IUA7-1#8	0	63	ENST00000453985.6	2661	2724	+	63	0	-42	7357
Q8IUA7-1#8	0	21	21	Q8IUA7-1	863	884	+	21	Q8IUA7-1	0	1624	ENST00000340001.9	75	4947	++	33	Q8IUA7-1#8	0	63	ENST00000340001.9	2664	2727	+	63	0	-42	7358
Q8IUA7-1#9	0	21	21	Q8IUA7-1	1025	1046	+	21	Q8IUA7-1	0	1624	ENST00000453985.6	72	4830	++	102	Q8IUA7-1#9	0	63	ENST00000453985.6	3147	3210	+	63	0	-42	7359
Q8IUA7-1#9	0	21	21	Q8IUA7-1	1025	1046	+	21	Q8IUA7-1	0	1624	ENST00000340001.9	75	4947	++	33	Q8IUA7-1#9	0	63	ENST00000340001.9	3150	3213	+	63	0	-42	7360
Q8IUA7-1#10	0	21	21	Q8IUA7-1	1064	1085	+	21	Q8IUA7-1	0	1624	ENST00000453985.6	72	4830	++	102	Q8IUA7-1#10	0	63	ENST00000453985.6	3264	3327	+	63	0	-42	7361
Q8IUA7-1#10	0	21	21	Q8IUA7-1	1064	1085	+	21	Q8IUA7-1	0	1624	ENST00000340001.9	75	4947	++	33	Q8IUA7-1#10	0	63	ENST00000340001.9	3267	3330	+	63	0	-42	7362
Q8IUA7-1#11	0	21	21	Q8IUA7-1	1107	1128	+	21	Q8IUA7-1	0	1624	ENST00000340001.9	75	4947	++	33	Q8IUA7-1#11	0	63	ENST00000340001.9	3396	3459	+	63	0	-42	7363
Q8IUA7-1#12	0	21	21	Q8IUA7-1	1135	1156	+	21	Q8IUA7-1	0	1624	ENST00000453985.6	72	4830	++	102	Q8IUA7-1#12	30	63	ENST00000453985.6	3393	3426	+	33	30	-42	7364
Q8IUA7-1#12	0	21	21	Q8IUA7-1	1135	1156	+	21	Q8IUA7-1	0	1624	ENST00000340001.9	75	4947	++	33	Q8IUA7-1#12	0	63	ENST00000340001.9	3480	3543	+	63	0	-42	7365
Q8IUA7-1#13	0	21	21	Q8IUA7-1	1162	1183	+	21	Q8IUA7-1	0	1624	ENST00000453985.6	72	4830	++	102	Q8IUA7-1#13	0	63	ENST00000453985.6	3444	3507	+	63	0	-42	7366
Q8IUA7-1#13	0	21	21	Q8IUA7-1	1162	1183	+	21	Q8IUA7-1	0	1624	ENST00000340001.9	75	4947	++	33	Q8IUA7-1#13	0	63	ENST00000340001.9	3561	3624	+	63	0	-42	7367
Q8IUA7-1#14	0	21	21	Q8IUA7-1	1199	1220	+	21	Q8IUA7-1	0	1624	ENST00000453985.6	72	4830	++	102	Q8IUA7-1#14	0	63	ENST00000453985.6	3555	3618	+	63	0	-42	7368
Q8IUA7-1#14	0	21	21	Q8IUA7-1	1199	1220	+	21	Q8IUA7-1	0	1624	ENST00000340001.9	75	4947	++	33	Q8IUA7-1#14	0	63	ENST00000340001.9	3672	3735	+	63	0	-42	7369
Q8IUA7-1#15	0	236	236	Q8IUA7-1	480	716	+	236	Q8IUA7-1	0	1624	ENST00000453985.6	72	4830	++	102	Q8IUA7-1#15	0	708	ENST00000453985.6	1512	2220	+	708	0	-472	7370
Q8IUA7-1#15	0	236	236	Q8IUA7-1	480	716	+	236	Q8IUA7-1	0	1624	ENST00000340001.9	75	4947	++	33	Q8IUA7-1#15	0	708	ENST00000340001.9	1515	2223	+	708	0	-472	7371
Q8IUA7-1#16	0	234	234	Q8IUA7-1	1287	1521	+	234	Q8IUA7-1	0	1624	ENST00000453985.6	72	4830	++	102	Q8IUA7-1#16	0	702	ENST00000453985.6	3819	4521	+	702	0	-468	7372
Q8IUA7-1#16	0	234	234	Q8IUA7-1	1287	1521	+	234	Q8IUA7-1	0	1624	ENST00000340001.9	75	4947	++	33	Q8IUA7-1#16	0	702	ENST00000340001.9	3936	4638	+	702	0	-468	7373
Q8IUA7-1#17	0	8	8	Q8IUA7-1	516	524	+	8	Q8IUA7-1	0	1624	ENST00000453985.6	72	4830	++	102	Q8IUA7-1#17	0	24	ENST00000453985.6	1620	1644	+	24	0	-16	7374
Q8IUA7-1#17	0	8	8	Q8IUA7-1	516	524	+	8	Q8IUA7-1	0	1624	ENST00000340001.9	75	4947	++	33	Q8IUA7-1#17	0	24	ENST00000340001.9	1623	1647	+	24	0	-16	7375
Q8IUA7-1#18	0	8	8	Q8IUA7-1	1325	1333	+	8	Q8IUA7-1	0	1624	ENST00000453985.6	72	4830	++	102	Q8IUA7-1#18	0	24	ENST00000453985.6	3933	3957	+	24	0	-16	7376
Q8IUA7-1#18	0	8	8	Q8IUA7-1	1325	1333	+	8	Q8IUA7-1	0	1624	ENST00000340001.9	75	4947	++	33	Q8IUA7-1#18	0	24	ENST00000340001.9	4050	4074	+	24	0	-16	7377
Q8IUA7-1#19	0	1	1	Q8IUA7-1	119	120	+	1	Q8IUA7-1	0	267	ENST00000495634.5	54	855	++	122	Q8IUA7-1#19	0	3	ENST00000495634.5	411	414	+	3	0	-2	7378
Q8IUA7-1#19	0	1	1	Q8IUA7-1	119	120	+	1	Q8IUA7-1	0	1624	ENST00000453985.6	72	4830	++	102	Q8IUA7-1#19	0	3	ENST00000453985.6	429	432	+	3	0	-2	7379
Q8IUA7-1#19	0	1	1	Q8IUA7-1	119	120	+	1	Q8IUA7-1	0	1624	ENST00000340001.9	75	4947	++	33	Q8IUA7-1#19	0	3	ENST00000340001.9	432	435	+	3	0	-2	7380
Q8IUA7-1#20	0	1	1	Q8IUA7-1	194	195	+	1	Q8IUA7-1	0	267	ENST00000495634.5	54	855	++	122	Q8IUA7-1#20	0	3	ENST00000495634.5	636	639	+	3	0	-2	7381
Q8IUA7-1#20	0	1	1	Q8IUA7-1	194	195	+	1	Q8IUA7-1	0	1624	ENST00000453985.6	72	4830	++	102	Q8IUA7-1#20	0	3	ENST00000453985.6	654	657	+	3	0	-2	7382
Q8IUA7-1#20	0	1	1	Q8IUA7-1	194	195	+	1	Q8IUA7-1	0	1624	ENST00000340001.9	75	4947	++	33	Q8IUA7-1#20	0	3	ENST00000340001.9	657	660	+	3	0	-2	7383
Q8IUA7-1#21	0	1	1	Q8IUA7-1	948	949	+	1	Q8IUA7-1	0	1624	ENST00000453985.6	72	4830	++	102	Q8IUA7-1#21	0	3	ENST00000453985.6	2916	2919	+	3	0	-2	7384
Q8IUA7-1#21	0	1	1	Q8IUA7-1	948	949	+	1	Q8IUA7-1	0	1624	ENST00000340001.9	75	4947	++	33	Q8IUA7-1#21	0	3	ENST00000340001.9	2919	2922	+	3	0	-2	7385
Q8IUA7-1#22	0	1358	1358	Q8IUA7-1	266	1624	+	1358	Q8IUA7-1	0	267	ENST00000495634.5	54	855	++	122	Q8IUA7-1#22	0	3	ENST00000495634.5	852	855	+	3	0	1355	7386
Q8IUA7-1#22	0	1358	1358	Q8IUA7-1	266	1624	+	1358	Q8IUA7-1	0	1624	ENST00000453985.6	72	4830	++	102	Q8IUA7-1#22	0	4074	ENST00000453985.6	870	4830	+	3960	0	-2716	7387
Q8IUA7-1#22	0	1358	1358	Q8IUA7-1	266	1624	+	1358	Q8IUA7-1	0	1624	ENST00000340001.9	75	4947	++	33	Q8IUA7-1#22	0	4074	ENST00000340001.9	873	4947	+	4074	0	-2716	7388
Q8IUA7-1#23	0	1357	1357	Q8IUA7-1	267	1624	+	1357	Q8IUA7-1	0	1624	ENST00000453985.6	72	4830	++	102	Q8IUA7-1#23	0	4071	ENST00000453985.6	873	4830	+	3957	0	-2714	7389
Q8IUA7-1#23	0	1357	1357	Q8IUA7-1	267	1624	+	1357	Q8IUA7-1	0	1624	ENST00000340001.9	75	4947	++	33	Q8IUA7-1#23	0	4071	ENST00000340001.9	876	4947	+	4071	0	-2714	7390
Q8IUA7-1#24	0	1	1	Q8IUA7-1	1428	1429	+	1	Q8IUA7-1	0	1624	ENST00000453985.6	72	4830	++	102	Q8IUA7-1#24	0	3	ENST00000453985.6	4242	4245	+	3	0	-2	7391
Q8IUA7-1#24	0	1	1	Q8IUA7-1	1428	1429	+	1	Q8IUA7-1	0	1624	ENST00000340001.9	75	4947	++	33	Q8IUA7-1#24	0	3	ENST00000340001.9	4359	4362	+	3	0	-2	7392
Q8IUA7-1#25	0	1	1	Q8IUA7-1	1428	1429	+	1	Q8IUA7-1	0	1624	ENST00000453985.6	72	4830	++	102	Q8IUA7-1#25	0	3	ENST00000453985.6	4242	4245	+	3	0	-2	7393
Q8IUA7-1#25	0	1	1	Q8IUA7-1	1428	1429	+	1	Q8IUA7-1	0	1624	ENST00000340001.9	75	4947	++	33	Q8IUA7-1#25	0	3	ENST00000340001.9	4359	4362	+	3	0	-2	7394
Q8IUA7-1#26	0	195	195	Q8IUA7-1	1429	1624	+	195	Q8IUA7-1	0	1624	ENST00000453985.6	72	4830	++	102	Q8IUA7-1#26	0	585	ENST00000453985.6	4245	4830	+	585	0	-390	7395
Q8IUA7-1#26	0	195	195	Q8IUA7-1	1429	1624	+	195	Q8IUA7-1	0	1624	ENST00000340001.9	75	4947	++	33	Q8IUA7-1#26	0	585	ENST00000340001.9	4362	4947	+	585	0	-390	7396
Q8IUA7-1#27	0	1	1	Q8IUA7-1	352	353	+	1	Q8IUA7-1	0	1624	ENST00000453985.6	72	4830	++	102	Q8IUA7-1#27	0	3	ENST00000453985.6	1128	1131	+	3	0	-2	7397
Q8IUA7-1#27	0	1	1	Q8IUA7-1	352	353	+	1	Q8IUA7-1	0	1624	ENST00000340001.9	75	4947	++	33	Q8IUA7-1#27	0	3	ENST00000340001.9	1131	1134	+	3	0	-2	7398
Q8IUA7-1#28	0	1	1	Q8IUA7-1	784	785	+	1	Q8IUA7-1	0	1624	ENST00000453985.6	72	4830	++	102	Q8IUA7-1#28	0	3	ENST00000453985.6	2424	2427	+	3	0	-2	7399
Q8IUA7-1#28	0	1	1	Q8IUA7-1	784	785	+	1	Q8IUA7-1	0	1624	ENST00000340001.9	75	4947	++	33	Q8IUA7-1#28	0	3	ENST00000340001.9	2427	2430	+	3	0	-2	7400
Q8IUA7-1#29	0	1	1	Q8IUA7-1	1305	1306	+	1	Q8IUA7-1	0	1624	ENST00000453985.6	72	4830	++	102	Q8IUA7-1#29	0	3	ENST00000453985.6	3873	3876	+	3	0	-2	7401
Q8IUA7-1#29	0	1	1	Q8IUA7-1	1305	1306	+	1	Q8IUA7-1	0	1624	ENST00000340001.9	75	4947	++	33	Q8IUA7-1#29	0	3	ENST00000340001.9	3990	3993	+	3	0	-2	7402
Q8IUA7-1#30	0	1	1	Q8IUA7-1	1355	1356	+	1	Q8IUA7-1	0	1624	ENST00000453985.6	72	4830	++	102	Q8IUA7-1#30	0	3	ENST00000453985.6	4023	4026	+	3	0	-2	7403
Q8IUA7-1#30	0	1	1	Q8IUA7-1	1355	1356	+	1	Q8IUA7-1	0	1624	ENST00000340001.9	75	4947	++	33	Q8IUA7-1#30	0	3	ENST00000340001.9	4140	4143	+	3	0	-2	7404
Q8IUA7-1#31	0	1	1	Q8IUA7-1	1429	1430	+	1	Q8IUA7-1	0	1624	ENST00000453985.6	72	4830	++	102	Q8IUA7-1#31	0	3	ENST00000453985.6	4245	4248	+	3	0	-2	7405
Q8IUA7-1#31	0	1	1	Q8IUA7-1	1429	1430	+	1	Q8IUA7-1	0	1624	ENST00000340001.9	75	4947	++	33	Q8IUA7-1#31	0	3	ENST00000340001.9	4362	4365	+	3	0	-2	7406
Q8WWZ4-1#0	0	1543	1543	Q8WWZ4-1	0	1543	+	1543	Q8WWZ4-1	0	1543	ENST00000690296.1	556	5185	++	267	Q8WWZ4-1#0	0	4629	ENST00000690296.1	556	5185	+	4629	0	-3086	7407
Q8WWZ4-1#0	0	1543	1543	Q8WWZ4-1	0	1543	+	1543	Q8WWZ4-1	40	176	ENST00000524273.1	2	410	++	139	Q8WWZ4-1#0	120	528	ENST00000524273.1	2	410	+	408	120	1015	7408
Q8WWZ4-1#0	0	1543	1543	Q8WWZ4-1	0	1543	+	1543	Q8WWZ4-1	0	68	ENST00000523512.5	409	613	++	138	Q8WWZ4-1#0	0	204	ENST00000523512.5	409	613	+	204	0	1339	7409
Q8WWZ4-1#0	0	1543	1543	Q8WWZ4-1	0	1543	+	1543	Q8WWZ4-1	0	1322	ENST00000523419.5	84	4050	++	137	Q8WWZ4-1#0	0	3966	ENST00000523419.5	84	4050	+	3966	0	-2423	7410
Q8WWZ4-1#0	0	1543	1543	Q8WWZ4-1	0	1543	+	1543	Q8WWZ4-1	1466	1511	ENST00000522787.5	0	135	++	136	Q8WWZ4-1#0	4398	4533	ENST00000522787.5	0	135	+	135	4398	-2990	7411
Q8WWZ4-1#0	0	1543	1543	Q8WWZ4-1	0	1543	+	1543	Q8WWZ4-1	0	412	ENST00000522406.5	387	1623	++	135	Q8WWZ4-1#0	0	1236	ENST00000522406.5	387	1623	+	1236	0	307	7412
Q8WWZ4-1#0	0	1543	1543	Q8WWZ4-1	0	1543	+	1543	Q8WWZ4-1	1466	1523	ENST00000521538.5	1	172	++	133	Q8WWZ4-1#0	4398	4569	ENST00000521538.5	1	172	+	171	4398	-3026	7413
Q8WWZ4-1#0	0	1543	1543	Q8WWZ4-1	0	1543	+	1543	Q8WWZ4-1	0	338	ENST00000518929.5	84	1098	++	132	Q8WWZ4-1#0	0	1014	ENST00000518929.5	84	1098	+	1014	0	529	7414
Q8WWZ4-1#0	0	1543	1543	Q8WWZ4-1	0	1543	+	1543	Q8WWZ4-1	0	1543	ENST00000269081.8	910	5539	++	13	Q8WWZ4-1#0	0	4629	ENST00000269081.8	910	5539	+	4629	0	-3086	7415
Q8WWZ4-1#1	0	21	21	Q8WWZ4-1	82	103	+	21	Q8WWZ4-1	0	1543	ENST00000690296.1	556	5185	++	267	Q8WWZ4-1#1	0	63	ENST00000690296.1	802	865	+	63	0	-42	7416
Q8WWZ4-1#1	0	21	21	Q8WWZ4-1	82	103	+	21	Q8WWZ4-1	40	176	ENST00000524273.1	2	410	++	139	Q8WWZ4-1#1	0	63	ENST00000524273.1	128	191	+	63	0	-42	7417
Q8WWZ4-1#1	0	21	21	Q8WWZ4-1	82	103	+	21	Q8WWZ4-1	0	1322	ENST00000523419.5	84	4050	++	137	Q8WWZ4-1#1	0	63	ENST00000523419.5	330	393	+	63	0	-42	7418
Q8WWZ4-1#1	0	21	21	Q8WWZ4-1	82	103	+	21	Q8WWZ4-1	0	412	ENST00000522406.5	387	1623	++	135	Q8WWZ4-1#1	0	63	ENST00000522406.5	633	696	+	63	0	-42	7419
Q8WWZ4-1#1	0	21	21	Q8WWZ4-1	82	103	+	21	Q8WWZ4-1	0	338	ENST00000518929.5	84	1098	++	132	Q8WWZ4-1#1	0	63	ENST00000518929.5	330	393	+	63	0	-42	7420
Q8WWZ4-1#1	0	21	21	Q8WWZ4-1	82	103	+	21	Q8WWZ4-1	0	1543	ENST00000269081.8	910	5539	++	13	Q8WWZ4-1#1	0	63	ENST00000269081.8	1156	1219	+	63	0	-42	7421
Q8WWZ4-1#2	0	21	21	Q8WWZ4-1	134	155	+	21	Q8WWZ4-1	0	1543	ENST00000690296.1	556	5185	++	267	Q8WWZ4-1#2	0	63	ENST00000690296.1	958	1021	+	63	0	-42	7422
Q8WWZ4-1#2	0	21	21	Q8WWZ4-1	134	155	+	21	Q8WWZ4-1	40	176	ENST00000524273.1	2	410	++	139	Q8WWZ4-1#2	0	63	ENST00000524273.1	284	347	+	63	0	-42	7423
Q8WWZ4-1#2	0	21	21	Q8WWZ4-1	134	155	+	21	Q8WWZ4-1	0	1322	ENST00000523419.5	84	4050	++	137	Q8WWZ4-1#2	0	63	ENST00000523419.5	486	549	+	63	0	-42	7424
Q8WWZ4-1#2	0	21	21	Q8WWZ4-1	134	155	+	21	Q8WWZ4-1	0	412	ENST00000522406.5	387	1623	++	135	Q8WWZ4-1#2	0	63	ENST00000522406.5	789	852	+	63	0	-42	7425
Q8WWZ4-1#2	0	21	21	Q8WWZ4-1	134	155	+	21	Q8WWZ4-1	0	338	ENST00000518929.5	84	1098	++	132	Q8WWZ4-1#2	0	63	ENST00000518929.5	486	549	+	63	0	-42	7426
Q8WWZ4-1#2	0	21	21	Q8WWZ4-1	134	155	+	21	Q8WWZ4-1	0	1543	ENST00000269081.8	910	5539	++	13	Q8WWZ4-1#2	0	63	ENST00000269081.8	1312	1375	+	63	0	-42	7427
Q8WWZ4-1#3	0	21	21	Q8WWZ4-1	184	205	+	21	Q8WWZ4-1	0	1543	ENST00000690296.1	556	5185	++	267	Q8WWZ4-1#3	0	63	ENST00000690296.1	1108	1171	+	63	0	-42	7428
Q8WWZ4-1#3	0	21	21	Q8WWZ4-1	184	205	+	21	Q8WWZ4-1	0	1322	ENST00000523419.5	84	4050	++	137	Q8WWZ4-1#3	0	63	ENST00000523419.5	636	699	+	63	0	-42	7429
Q8WWZ4-1#3	0	21	21	Q8WWZ4-1	184	205	+	21	Q8WWZ4-1	0	412	ENST00000522406.5	387	1623	++	135	Q8WWZ4-1#3	0	63	ENST00000522406.5	939	1002	+	63	0	-42	7430
Q8WWZ4-1#3	0	21	21	Q8WWZ4-1	184	205	+	21	Q8WWZ4-1	0	338	ENST00000518929.5	84	1098	++	132	Q8WWZ4-1#3	0	63	ENST00000518929.5	636	699	+	63	0	-42	7431
Q8WWZ4-1#3	0	21	21	Q8WWZ4-1	184	205	+	21	Q8WWZ4-1	0	1543	ENST00000269081.8	910	5539	++	13	Q8WWZ4-1#3	0	63	ENST00000269081.8	1462	1525	+	63	0	-42	7432
Q8WWZ4-1#4	0	21	21	Q8WWZ4-1	209	230	+	21	Q8WWZ4-1	0	1543	ENST00000690296.1	556	5185	++	267	Q8WWZ4-1#4	0	63	ENST00000690296.1	1183	1246	+	63	0	-42	7433
Q8WWZ4-1#4	0	21	21	Q8WWZ4-1	209	230	+	21	Q8WWZ4-1	0	1322	ENST00000523419.5	84	4050	++	137	Q8WWZ4-1#4	0	63	ENST00000523419.5	711	774	+	63	0	-42	7434
Q8WWZ4-1#4	0	21	21	Q8WWZ4-1	209	230	+	21	Q8WWZ4-1	0	412	ENST00000522406.5	387	1623	++	135	Q8WWZ4-1#4	0	63	ENST00000522406.5	1014	1077	+	63	0	-42	7435
Q8WWZ4-1#4	0	21	21	Q8WWZ4-1	209	230	+	21	Q8WWZ4-1	0	338	ENST00000518929.5	84	1098	++	132	Q8WWZ4-1#4	0	63	ENST00000518929.5	711	774	+	63	0	-42	7436
Q8WWZ4-1#4	0	21	21	Q8WWZ4-1	209	230	+	21	Q8WWZ4-1	0	1543	ENST00000269081.8	910	5539	++	13	Q8WWZ4-1#4	0	63	ENST00000269081.8	1537	1600	+	63	0	-42	7437
Q8WWZ4-1#5	0	21	21	Q8WWZ4-1	239	260	+	21	Q8WWZ4-1	0	1543	ENST00000690296.1	556	5185	++	267	Q8WWZ4-1#5	0	63	ENST00000690296.1	1273	1336	+	63	0	-42	7438
Q8WWZ4-1#5	0	21	21	Q8WWZ4-1	239	260	+	21	Q8WWZ4-1	0	1322	ENST00000523419.5	84	4050	++	137	Q8WWZ4-1#5	0	63	ENST00000523419.5	801	864	+	63	0	-42	7439
Q8WWZ4-1#5	0	21	21	Q8WWZ4-1	239	260	+	21	Q8WWZ4-1	0	412	ENST00000522406.5	387	1623	++	135	Q8WWZ4-1#5	0	63	ENST00000522406.5	1104	1167	+	63	0	-42	7440
Q8WWZ4-1#5	0	21	21	Q8WWZ4-1	239	260	+	21	Q8WWZ4-1	0	338	ENST00000518929.5	84	1098	++	132	Q8WWZ4-1#5	0	63	ENST00000518929.5	801	864	+	63	0	-42	7441
Q8WWZ4-1#5	0	21	21	Q8WWZ4-1	239	260	+	21	Q8WWZ4-1	0	1543	ENST00000269081.8	910	5539	++	13	Q8WWZ4-1#5	0	63	ENST00000269081.8	1627	1690	+	63	0	-42	7442
Q8WWZ4-1#6	0	21	21	Q8WWZ4-1	263	284	+	21	Q8WWZ4-1	0	1543	ENST00000690296.1	556	5185	++	267	Q8WWZ4-1#6	0	63	ENST00000690296.1	1345	1408	+	63	0	-42	7443
Q8WWZ4-1#6	0	21	21	Q8WWZ4-1	263	284	+	21	Q8WWZ4-1	0	1322	ENST00000523419.5	84	4050	++	137	Q8WWZ4-1#6	0	63	ENST00000523419.5	873	936	+	63	0	-42	7444
Q8WWZ4-1#6	0	21	21	Q8WWZ4-1	263	284	+	21	Q8WWZ4-1	0	412	ENST00000522406.5	387	1623	++	135	Q8WWZ4-1#6	0	63	ENST00000522406.5	1176	1239	+	63	0	-42	7445
Q8WWZ4-1#6	0	21	21	Q8WWZ4-1	263	284	+	21	Q8WWZ4-1	0	338	ENST00000518929.5	84	1098	++	132	Q8WWZ4-1#6	0	63	ENST00000518929.5	873	936	+	63	0	-42	7446
Q8WWZ4-1#6	0	21	21	Q8WWZ4-1	263	284	+	21	Q8WWZ4-1	0	1543	ENST00000269081.8	910	5539	++	13	Q8WWZ4-1#6	0	63	ENST00000269081.8	1699	1762	+	63	0	-42	7447
Q8WWZ4-1#7	0	21	21	Q8WWZ4-1	309	330	+	21	Q8WWZ4-1	0	1543	ENST00000690296.1	556	5185	++	267	Q8WWZ4-1#7	0	63	ENST00000690296.1	1483	1546	+	63	0	-42	7448
Q8WWZ4-1#7	0	21	21	Q8WWZ4-1	309	330	+	21	Q8WWZ4-1	0	1322	ENST00000523419.5	84	4050	++	137	Q8WWZ4-1#7	0	63	ENST00000523419.5	1011	1074	+	63	0	-42	7449
Q8WWZ4-1#7	0	21	21	Q8WWZ4-1	309	330	+	21	Q8WWZ4-1	0	412	ENST00000522406.5	387	1623	++	135	Q8WWZ4-1#7	0	63	ENST00000522406.5	1314	1377	+	63	0	-42	7450
Q8WWZ4-1#7	0	21	21	Q8WWZ4-1	309	330	+	21	Q8WWZ4-1	0	338	ENST00000518929.5	84	1098	++	132	Q8WWZ4-1#7	0	63	ENST00000518929.5	1011	1074	+	63	0	-42	7451
Q8WWZ4-1#7	0	21	21	Q8WWZ4-1	309	330	+	21	Q8WWZ4-1	0	1543	ENST00000269081.8	910	5539	++	13	Q8WWZ4-1#7	0	63	ENST00000269081.8	1837	1900	+	63	0	-42	7452
Q8WWZ4-1#8	0	21	21	Q8WWZ4-1	773	794	+	21	Q8WWZ4-1	0	1543	ENST00000690296.1	556	5185	++	267	Q8WWZ4-1#8	0	63	ENST00000690296.1	2875	2938	+	63	0	-42	7453
Q8WWZ4-1#8	0	21	21	Q8WWZ4-1	773	794	+	21	Q8WWZ4-1	0	1322	ENST00000523419.5	84	4050	++	137	Q8WWZ4-1#8	0	63	ENST00000523419.5	2403	2466	+	63	0	-42	7454
Q8WWZ4-1#8	0	21	21	Q8WWZ4-1	773	794	+	21	Q8WWZ4-1	0	1543	ENST00000269081.8	910	5539	++	13	Q8WWZ4-1#8	0	63	ENST00000269081.8	3229	3292	+	63	0	-42	7455
Q8WWZ4-1#9	0	21	21	Q8WWZ4-1	889	910	+	21	Q8WWZ4-1	0	1543	ENST00000690296.1	556	5185	++	267	Q8WWZ4-1#9	0	63	ENST00000690296.1	3223	3286	+	63	0	-42	7456
Q8WWZ4-1#9	0	21	21	Q8WWZ4-1	889	910	+	21	Q8WWZ4-1	0	1322	ENST00000523419.5	84	4050	++	137	Q8WWZ4-1#9	0	63	ENST00000523419.5	2751	2814	+	63	0	-42	7457
Q8WWZ4-1#9	0	21	21	Q8WWZ4-1	889	910	+	21	Q8WWZ4-1	0	1543	ENST00000269081.8	910	5539	++	13	Q8WWZ4-1#9	0	63	ENST00000269081.8	3577	3640	+	63	0	-42	7458
Q8WWZ4-1#10	0	21	21	Q8WWZ4-1	925	946	+	21	Q8WWZ4-1	0	1543	ENST00000690296.1	556	5185	++	267	Q8WWZ4-1#10	0	63	ENST00000690296.1	3331	3394	+	63	0	-42	7459
Q8WWZ4-1#10	0	21	21	Q8WWZ4-1	925	946	+	21	Q8WWZ4-1	0	1322	ENST00000523419.5	84	4050	++	137	Q8WWZ4-1#10	0	63	ENST00000523419.5	2859	2922	+	63	0	-42	7460
Q8WWZ4-1#10	0	21	21	Q8WWZ4-1	925	946	+	21	Q8WWZ4-1	0	1543	ENST00000269081.8	910	5539	++	13	Q8WWZ4-1#10	0	63	ENST00000269081.8	3685	3748	+	63	0	-42	7461
Q8WWZ4-1#11	0	21	21	Q8WWZ4-1	984	1005	+	21	Q8WWZ4-1	0	1543	ENST00000690296.1	556	5185	++	267	Q8WWZ4-1#11	0	63	ENST00000690296.1	3508	3571	+	63	0	-42	7462
Q8WWZ4-1#11	0	21	21	Q8WWZ4-1	984	1005	+	21	Q8WWZ4-1	0	1322	ENST00000523419.5	84	4050	++	137	Q8WWZ4-1#11	0	63	ENST00000523419.5	3036	3099	+	63	0	-42	7463
Q8WWZ4-1#11	0	21	21	Q8WWZ4-1	984	1005	+	21	Q8WWZ4-1	0	1543	ENST00000269081.8	910	5539	++	13	Q8WWZ4-1#11	0	63	ENST00000269081.8	3862	3925	+	63	0	-42	7464
Q8WWZ4-1#12	0	21	21	Q8WWZ4-1	1013	1034	+	21	Q8WWZ4-1	0	1543	ENST00000690296.1	556	5185	++	267	Q8WWZ4-1#12	0	63	ENST00000690296.1	3595	3658	+	63	0	-42	7465
Q8WWZ4-1#12	0	21	21	Q8WWZ4-1	1013	1034	+	21	Q8WWZ4-1	0	1322	ENST00000523419.5	84	4050	++	137	Q8WWZ4-1#12	0	63	ENST00000523419.5	3123	3186	+	63	0	-42	7466
Q8WWZ4-1#12	0	21	21	Q8WWZ4-1	1013	1034	+	21	Q8WWZ4-1	0	1543	ENST00000269081.8	910	5539	++	13	Q8WWZ4-1#12	0	63	ENST00000269081.8	3949	4012	+	63	0	-42	7467
Q8WWZ4-1#13	0	21	21	Q8WWZ4-1	1045	1066	+	21	Q8WWZ4-1	0	1543	ENST00000690296.1	556	5185	++	267	Q8WWZ4-1#13	0	63	ENST00000690296.1	3691	3754	+	63	0	-42	7468
Q8WWZ4-1#13	0	21	21	Q8WWZ4-1	1045	1066	+	21	Q8WWZ4-1	0	1322	ENST00000523419.5	84	4050	++	137	Q8WWZ4-1#13	0	63	ENST00000523419.5	3219	3282	+	63	0	-42	7469
Q8WWZ4-1#13	0	21	21	Q8WWZ4-1	1045	1066	+	21	Q8WWZ4-1	0	1543	ENST00000269081.8	910	5539	++	13	Q8WWZ4-1#13	0	63	ENST00000269081.8	4045	4108	+	63	0	-42	7470
Q8WWZ4-1#14	0	21	21	Q8WWZ4-1	1072	1093	+	21	Q8WWZ4-1	0	1543	ENST00000690296.1	556	5185	++	267	Q8WWZ4-1#14	0	63	ENST00000690296.1	3772	3835	+	63	0	-42	7471
Q8WWZ4-1#14	0	21	21	Q8WWZ4-1	1072	1093	+	21	Q8WWZ4-1	0	1322	ENST00000523419.5	84	4050	++	137	Q8WWZ4-1#14	0	63	ENST00000523419.5	3300	3363	+	63	0	-42	7472
Q8WWZ4-1#14	0	21	21	Q8WWZ4-1	1072	1093	+	21	Q8WWZ4-1	0	1543	ENST00000269081.8	910	5539	++	13	Q8WWZ4-1#14	0	63	ENST00000269081.8	4126	4189	+	63	0	-42	7473
Q8WWZ4-1#15	0	21	21	Q8WWZ4-1	1112	1133	+	21	Q8WWZ4-1	0	1543	ENST00000690296.1	556	5185	++	267	Q8WWZ4-1#15	0	63	ENST00000690296.1	3892	3955	+	63	0	-42	7474
Q8WWZ4-1#15	0	21	21	Q8WWZ4-1	1112	1133	+	21	Q8WWZ4-1	0	1322	ENST00000523419.5	84	4050	++	137	Q8WWZ4-1#15	0	63	ENST00000523419.5	3420	3483	+	63	0	-42	7475
Q8WWZ4-1#15	0	21	21	Q8WWZ4-1	1112	1133	+	21	Q8WWZ4-1	0	1543	ENST00000269081.8	910	5539	++	13	Q8WWZ4-1#15	0	63	ENST00000269081.8	4246	4309	+	63	0	-42	7476
Q8WWZ4-1#16	0	236	236	Q8WWZ4-1	390	626	+	236	Q8WWZ4-1	0	1543	ENST00000690296.1	556	5185	++	267	Q8WWZ4-1#16	0	708	ENST00000690296.1	1726	2434	+	708	0	-472	7477
Q8WWZ4-1#16	0	236	236	Q8WWZ4-1	390	626	+	236	Q8WWZ4-1	0	1322	ENST00000523419.5	84	4050	++	137	Q8WWZ4-1#16	0	708	ENST00000523419.5	1254	1962	+	708	0	-472	7478
Q8WWZ4-1#16	0	236	236	Q8WWZ4-1	390	626	+	236	Q8WWZ4-1	0	412	ENST00000522406.5	387	1623	++	135	Q8WWZ4-1#16	0	66	ENST00000522406.5	1557	1623	+	66	0	170	7479
Q8WWZ4-1#16	0	236	236	Q8WWZ4-1	390	626	+	236	Q8WWZ4-1	0	1543	ENST00000269081.8	910	5539	++	13	Q8WWZ4-1#16	0	708	ENST00000269081.8	2080	2788	+	708	0	-472	7480
Q8WWZ4-1#17	0	235	235	Q8WWZ4-1	1205	1440	+	235	Q8WWZ4-1	0	1543	ENST00000690296.1	556	5185	++	267	Q8WWZ4-1#17	0	705	ENST00000690296.1	4171	4876	+	705	0	-470	7481
Q8WWZ4-1#17	0	235	235	Q8WWZ4-1	1205	1440	+	235	Q8WWZ4-1	0	1322	ENST00000523419.5	84	4050	++	137	Q8WWZ4-1#17	0	351	ENST00000523419.5	3699	4050	+	351	0	-116	7482
Q8WWZ4-1#17	0	235	235	Q8WWZ4-1	1205	1440	+	235	Q8WWZ4-1	0	1543	ENST00000269081.8	910	5539	++	13	Q8WWZ4-1#17	0	705	ENST00000269081.8	4525	5230	+	705	0	-470	7483
Q8WWZ4-1#18	0	25	25	Q8WWZ4-1	1152	1177	+	25	Q8WWZ4-1	0	1543	ENST00000690296.1	556	5185	++	267	Q8WWZ4-1#18	0	75	ENST00000690296.1	4012	4087	+	75	0	-50	7484
Q8WWZ4-1#18	0	25	25	Q8WWZ4-1	1152	1177	+	25	Q8WWZ4-1	0	1322	ENST00000523419.5	84	4050	++	137	Q8WWZ4-1#18	0	75	ENST00000523419.5	3540	3615	+	75	0	-50	7485
Q8WWZ4-1#18	0	25	25	Q8WWZ4-1	1152	1177	+	25	Q8WWZ4-1	0	1543	ENST00000269081.8	910	5539	++	13	Q8WWZ4-1#18	0	75	ENST00000269081.8	4366	4441	+	75	0	-50	7486
Q8WWZ4-1#19	0	8	8	Q8WWZ4-1	426	434	+	8	Q8WWZ4-1	0	1543	ENST00000690296.1	556	5185	++	267	Q8WWZ4-1#19	0	24	ENST00000690296.1	1834	1858	+	24	0	-16	7487
Q8WWZ4-1#19	0	8	8	Q8WWZ4-1	426	434	+	8	Q8WWZ4-1	0	1322	ENST00000523419.5	84	4050	++	137	Q8WWZ4-1#19	0	24	ENST00000523419.5	1362	1386	+	24	0	-16	7488
Q8WWZ4-1#19	0	8	8	Q8WWZ4-1	426	434	+	8	Q8WWZ4-1	0	1543	ENST00000269081.8	910	5539	++	13	Q8WWZ4-1#19	0	24	ENST00000269081.8	2188	2212	+	24	0	-16	7489
Q8WWZ4-1#20	0	8	8	Q8WWZ4-1	1238	1246	+	8	Q8WWZ4-1	0	1543	ENST00000690296.1	556	5185	++	267	Q8WWZ4-1#20	0	24	ENST00000690296.1	4270	4294	+	24	0	-16	7490
Q8WWZ4-1#20	0	8	8	Q8WWZ4-1	1238	1246	+	8	Q8WWZ4-1	0	1322	ENST00000523419.5	84	4050	++	137	Q8WWZ4-1#20	0	24	ENST00000523419.5	3798	3822	+	24	0	-16	7491
Q8WWZ4-1#20	0	8	8	Q8WWZ4-1	1238	1246	+	8	Q8WWZ4-1	0	1543	ENST00000269081.8	910	5539	++	13	Q8WWZ4-1#20	0	24	ENST00000269081.8	4624	4648	+	24	0	-16	7492
Q8WWZ4-1#21	0	23	23	Q8WWZ4-1	0	23	+	23	Q8WWZ4-1	0	1543	ENST00000690296.1	556	5185	++	267	Q8WWZ4-1#21	0	69	ENST00000690296.1	556	625	+	69	0	-46	7493
Q8WWZ4-1#21	0	23	23	Q8WWZ4-1	0	23	+	23	Q8WWZ4-1	0	68	ENST00000523512.5	409	613	++	138	Q8WWZ4-1#21	0	69	ENST00000523512.5	409	478	+	69	0	-46	7494
Q8WWZ4-1#21	0	23	23	Q8WWZ4-1	0	23	+	23	Q8WWZ4-1	0	1322	ENST00000523419.5	84	4050	++	137	Q8WWZ4-1#21	0	69	ENST00000523419.5	84	153	+	69	0	-46	7495
Q8WWZ4-1#21	0	23	23	Q8WWZ4-1	0	23	+	23	Q8WWZ4-1	0	412	ENST00000522406.5	387	1623	++	135	Q8WWZ4-1#21	0	69	ENST00000522406.5	387	456	+	69	0	-46	7496
Q8WWZ4-1#21	0	23	23	Q8WWZ4-1	0	23	+	23	Q8WWZ4-1	0	338	ENST00000518929.5	84	1098	++	132	Q8WWZ4-1#21	0	69	ENST00000518929.5	84	153	+	69	0	-46	7497
Q8WWZ4-1#21	0	23	23	Q8WWZ4-1	0	23	+	23	Q8WWZ4-1	0	1543	ENST00000269081.8	910	5539	++	13	Q8WWZ4-1#21	0	69	ENST00000269081.8	910	979	+	69	0	-46	7498
Q8WWZ4-1#22	0	1	1	Q8WWZ4-1	66	67	+	1	Q8WWZ4-1	0	1543	ENST00000690296.1	556	5185	++	267	Q8WWZ4-1#22	0	3	ENST00000690296.1	754	757	+	3	0	-2	7499
Q8WWZ4-1#22	0	1	1	Q8WWZ4-1	66	67	+	1	Q8WWZ4-1	40	176	ENST00000524273.1	2	410	++	139	Q8WWZ4-1#22	0	3	ENST00000524273.1	80	83	+	3	0	-2	7500
Q8WWZ4-1#22	0	1	1	Q8WWZ4-1	66	67	+	1	Q8WWZ4-1	0	68	ENST00000523512.5	409	613	++	138	Q8WWZ4-1#22	0	3	ENST00000523512.5	607	610	+	3	0	-2	7501
Q8WWZ4-1#22	0	1	1	Q8WWZ4-1	66	67	+	1	Q8WWZ4-1	0	1322	ENST00000523419.5	84	4050	++	137	Q8WWZ4-1#22	0	3	ENST00000523419.5	282	285	+	3	0	-2	7502
Q8WWZ4-1#22	0	1	1	Q8WWZ4-1	66	67	+	1	Q8WWZ4-1	0	412	ENST00000522406.5	387	1623	++	135	Q8WWZ4-1#22	0	3	ENST00000522406.5	585	588	+	3	0	-2	7503
Q8WWZ4-1#22	0	1	1	Q8WWZ4-1	66	67	+	1	Q8WWZ4-1	0	338	ENST00000518929.5	84	1098	++	132	Q8WWZ4-1#22	0	3	ENST00000518929.5	282	285	+	3	0	-2	7504
Q8WWZ4-1#22	0	1	1	Q8WWZ4-1	66	67	+	1	Q8WWZ4-1	0	1543	ENST00000269081.8	910	5539	++	13	Q8WWZ4-1#22	0	3	ENST00000269081.8	1108	1111	+	3	0	-2	7505
Q8WWZ4-1#23	0	1476	1476	Q8WWZ4-1	67	1543	+	1476	Q8WWZ4-1	0	1543	ENST00000690296.1	556	5185	++	267	Q8WWZ4-1#23	0	4428	ENST00000690296.1	757	5185	+	4428	0	-2952	7506
Q8WWZ4-1#23	0	1476	1476	Q8WWZ4-1	67	1543	+	1476	Q8WWZ4-1	40	176	ENST00000524273.1	2	410	++	139	Q8WWZ4-1#23	0	327	ENST00000524273.1	83	410	+	327	0	1149	7507
Q8WWZ4-1#23	0	1476	1476	Q8WWZ4-1	67	1543	+	1476	Q8WWZ4-1	0	68	ENST00000523512.5	409	613	++	138	Q8WWZ4-1#23	0	3	ENST00000523512.5	610	613	+	3	0	1473	7508
Q8WWZ4-1#23	0	1476	1476	Q8WWZ4-1	67	1543	+	1476	Q8WWZ4-1	0	1322	ENST00000523419.5	84	4050	++	137	Q8WWZ4-1#23	0	3765	ENST00000523419.5	285	4050	+	3765	0	-2289	7509
Q8WWZ4-1#23	0	1476	1476	Q8WWZ4-1	67	1543	+	1476	Q8WWZ4-1	1466	1511	ENST00000522787.5	0	135	++	136	Q8WWZ4-1#23	4197	4332	ENST00000522787.5	0	135	+	135	4197	-2856	7510
Q8WWZ4-1#23	0	1476	1476	Q8WWZ4-1	67	1543	+	1476	Q8WWZ4-1	0	412	ENST00000522406.5	387	1623	++	135	Q8WWZ4-1#23	0	1035	ENST00000522406.5	588	1623	+	1035	0	441	7511
Q8WWZ4-1#23	0	1476	1476	Q8WWZ4-1	67	1543	+	1476	Q8WWZ4-1	1466	1523	ENST00000521538.5	1	172	++	133	Q8WWZ4-1#23	4197	4368	ENST00000521538.5	1	172	+	171	4197	-2892	7512
Q8WWZ4-1#23	0	1476	1476	Q8WWZ4-1	67	1543	+	1476	Q8WWZ4-1	0	338	ENST00000518929.5	84	1098	++	132	Q8WWZ4-1#23	0	813	ENST00000518929.5	285	1098	+	813	0	663	7513
Q8WWZ4-1#23	0	1476	1476	Q8WWZ4-1	67	1543	+	1476	Q8WWZ4-1	0	1543	ENST00000269081.8	910	5539	++	13	Q8WWZ4-1#23	0	4428	ENST00000269081.8	1111	5539	+	4428	0	-2952	7514
Q8WWZ4-1#24	0	40	40	Q8WWZ4-1	412	452	+	40	Q8WWZ4-1	0	1543	ENST00000690296.1	556	5185	++	267	Q8WWZ4-1#24	0	120	ENST00000690296.1	1792	1912	+	120	0	-80	7515
Q8WWZ4-1#24	0	40	40	Q8WWZ4-1	412	452	+	40	Q8WWZ4-1	0	1322	ENST00000523419.5	84	4050	++	137	Q8WWZ4-1#24	0	120	ENST00000523419.5	1320	1440	+	120	0	-80	7516
Q8WWZ4-1#24	0	40	40	Q8WWZ4-1	412	452	+	40	Q8WWZ4-1	0	1543	ENST00000269081.8	910	5539	++	13	Q8WWZ4-1#24	0	120	ENST00000269081.8	2146	2266	+	120	0	-80	7517
Q8WWZ4-1#25	0	1	1	Q8WWZ4-1	449	450	+	1	Q8WWZ4-1	0	1543	ENST00000690296.1	556	5185	++	267	Q8WWZ4-1#25	0	3	ENST00000690296.1	1903	1906	+	3	0	-2	7518
Q8WWZ4-1#25	0	1	1	Q8WWZ4-1	449	450	+	1	Q8WWZ4-1	0	1322	ENST00000523419.5	84	4050	++	137	Q8WWZ4-1#25	0	3	ENST00000523419.5	1431	1434	+	3	0	-2	7519
Q8WWZ4-1#25	0	1	1	Q8WWZ4-1	449	450	+	1	Q8WWZ4-1	0	1543	ENST00000269081.8	910	5539	++	13	Q8WWZ4-1#25	0	3	ENST00000269081.8	2257	2260	+	3	0	-2	7520
Q8WWZ4-1#26	0	1093	1093	Q8WWZ4-1	450	1543	+	1093	Q8WWZ4-1	0	1543	ENST00000690296.1	556	5185	++	267	Q8WWZ4-1#26	0	3279	ENST00000690296.1	1906	5185	+	3279	0	-2186	7521
Q8WWZ4-1#26	0	1093	1093	Q8WWZ4-1	450	1543	+	1093	Q8WWZ4-1	0	1322	ENST00000523419.5	84	4050	++	137	Q8WWZ4-1#26	0	2616	ENST00000523419.5	1434	4050	+	2616	0	-1523	7522
Q8WWZ4-1#26	0	1093	1093	Q8WWZ4-1	450	1543	+	1093	Q8WWZ4-1	1466	1511	ENST00000522787.5	0	135	++	136	Q8WWZ4-1#26	3048	3183	ENST00000522787.5	0	135	+	135	3048	-2090	7523
Q8WWZ4-1#26	0	1093	1093	Q8WWZ4-1	450	1543	+	1093	Q8WWZ4-1	1466	1523	ENST00000521538.5	1	172	++	133	Q8WWZ4-1#26	3048	3219	ENST00000521538.5	1	172	+	171	3048	-2126	7524
Q8WWZ4-1#26	0	1093	1093	Q8WWZ4-1	450	1543	+	1093	Q8WWZ4-1	0	1543	ENST00000269081.8	910	5539	++	13	Q8WWZ4-1#26	0	3279	ENST00000269081.8	2260	5539	+	3279	0	-2186	7525
Q8WWZ4-1#27	0	1091	1091	Q8WWZ4-1	452	1543	+	1091	Q8WWZ4-1	0	1543	ENST00000690296.1	556	5185	++	267	Q8WWZ4-1#27	0	3273	ENST00000690296.1	1912	5185	+	3273	0	-2182	7526
Q8WWZ4-1#27	0	1091	1091	Q8WWZ4-1	452	1543	+	1091	Q8WWZ4-1	0	1322	ENST00000523419.5	84	4050	++	137	Q8WWZ4-1#27	0	2610	ENST00000523419.5	1440	4050	+	2610	0	-1519	7527
Q8WWZ4-1#27	0	1091	1091	Q8WWZ4-1	452	1543	+	1091	Q8WWZ4-1	1466	1511	ENST00000522787.5	0	135	++	136	Q8WWZ4-1#27	3042	3177	ENST00000522787.5	0	135	+	135	3042	-2086	7528
Q8WWZ4-1#27	0	1091	1091	Q8WWZ4-1	452	1543	+	1091	Q8WWZ4-1	1466	1523	ENST00000521538.5	1	172	++	133	Q8WWZ4-1#27	3042	3213	ENST00000521538.5	1	172	+	171	3042	-2122	7529
Q8WWZ4-1#27	0	1091	1091	Q8WWZ4-1	452	1543	+	1091	Q8WWZ4-1	0	1543	ENST00000269081.8	910	5539	++	13	Q8WWZ4-1#27	0	3273	ENST00000269081.8	2266	5539	+	3273	0	-2182	7530
Q8WWZ4-1#28	0	1	1	Q8WWZ4-1	202	203	+	1	Q8WWZ4-1	0	1543	ENST00000690296.1	556	5185	++	267	Q8WWZ4-1#28	0	3	ENST00000690296.1	1162	1165	+	3	0	-2	7531
Q8WWZ4-1#28	0	1	1	Q8WWZ4-1	202	203	+	1	Q8WWZ4-1	0	1322	ENST00000523419.5	84	4050	++	137	Q8WWZ4-1#28	0	3	ENST00000523419.5	690	693	+	3	0	-2	7532
Q8WWZ4-1#28	0	1	1	Q8WWZ4-1	202	203	+	1	Q8WWZ4-1	0	412	ENST00000522406.5	387	1623	++	135	Q8WWZ4-1#28	0	3	ENST00000522406.5	993	996	+	3	0	-2	7533
Q8WWZ4-1#28	0	1	1	Q8WWZ4-1	202	203	+	1	Q8WWZ4-1	0	338	ENST00000518929.5	84	1098	++	132	Q8WWZ4-1#28	0	3	ENST00000518929.5	690	693	+	3	0	-2	7534
Q8WWZ4-1#28	0	1	1	Q8WWZ4-1	202	203	+	1	Q8WWZ4-1	0	1543	ENST00000269081.8	910	5539	++	13	Q8WWZ4-1#28	0	3	ENST00000269081.8	1516	1519	+	3	0	-2	7535
Q8WWZ4-1#29	0	1	1	Q8WWZ4-1	286	287	+	1	Q8WWZ4-1	0	1543	ENST00000690296.1	556	5185	++	267	Q8WWZ4-1#29	0	3	ENST00000690296.1	1414	1417	+	3	0	-2	7536
Q8WWZ4-1#29	0	1	1	Q8WWZ4-1	286	287	+	1	Q8WWZ4-1	0	1322	ENST00000523419.5	84	4050	++	137	Q8WWZ4-1#29	0	3	ENST00000523419.5	942	945	+	3	0	-2	7537
Q8WWZ4-1#29	0	1	1	Q8WWZ4-1	286	287	+	1	Q8WWZ4-1	0	412	ENST00000522406.5	387	1623	++	135	Q8WWZ4-1#29	0	3	ENST00000522406.5	1245	1248	+	3	0	-2	7538
Q8WWZ4-1#29	0	1	1	Q8WWZ4-1	286	287	+	1	Q8WWZ4-1	0	338	ENST00000518929.5	84	1098	++	132	Q8WWZ4-1#29	0	3	ENST00000518929.5	942	945	+	3	0	-2	7539
Q8WWZ4-1#29	0	1	1	Q8WWZ4-1	286	287	+	1	Q8WWZ4-1	0	1543	ENST00000269081.8	910	5539	++	13	Q8WWZ4-1#29	0	3	ENST00000269081.8	1768	1771	+	3	0	-2	7540
Q8WWZ4-1#30	0	1	1	Q8WWZ4-1	915	916	+	1	Q8WWZ4-1	0	1543	ENST00000690296.1	556	5185	++	267	Q8WWZ4-1#30	0	3	ENST00000690296.1	3301	3304	+	3	0	-2	7541
Q8WWZ4-1#30	0	1	1	Q8WWZ4-1	915	916	+	1	Q8WWZ4-1	0	1322	ENST00000523419.5	84	4050	++	137	Q8WWZ4-1#30	0	3	ENST00000523419.5	2829	2832	+	3	0	-2	7542
Q8WWZ4-1#30	0	1	1	Q8WWZ4-1	915	916	+	1	Q8WWZ4-1	0	1543	ENST00000269081.8	910	5539	++	13	Q8WWZ4-1#30	0	3	ENST00000269081.8	3655	3658	+	3	0	-2	7543
Q8WWZ4-1#31	0	1	1	Q8WWZ4-1	1321	1322	+	1	Q8WWZ4-1	0	1543	ENST00000690296.1	556	5185	++	267	Q8WWZ4-1#31	0	3	ENST00000690296.1	4519	4522	+	3	0	-2	7544
Q8WWZ4-1#31	0	1	1	Q8WWZ4-1	1321	1322	+	1	Q8WWZ4-1	0	1322	ENST00000523419.5	84	4050	++	137	Q8WWZ4-1#31	0	3	ENST00000523419.5	4047	4050	+	3	0	-2	7545
Q8WWZ4-1#31	0	1	1	Q8WWZ4-1	1321	1322	+	1	Q8WWZ4-1	0	1543	ENST00000269081.8	910	5539	++	13	Q8WWZ4-1#31	0	3	ENST00000269081.8	4873	4876	+	3	0	-2	7546
Q8WWZ4-1#32	0	1	1	Q8WWZ4-1	139	140	+	1	Q8WWZ4-1	0	1543	ENST00000690296.1	556	5185	++	267	Q8WWZ4-1#32	0	3	ENST00000690296.1	973	976	+	3	0	-2	7547
Q8WWZ4-1#32	0	1	1	Q8WWZ4-1	139	140	+	1	Q8WWZ4-1	40	176	ENST00000524273.1	2	410	++	139	Q8WWZ4-1#32	0	3	ENST00000524273.1	299	302	+	3	0	-2	7548
Q8WWZ4-1#32	0	1	1	Q8WWZ4-1	139	140	+	1	Q8WWZ4-1	0	1322	ENST00000523419.5	84	4050	++	137	Q8WWZ4-1#32	0	3	ENST00000523419.5	501	504	+	3	0	-2	7549
Q8WWZ4-1#32	0	1	1	Q8WWZ4-1	139	140	+	1	Q8WWZ4-1	0	412	ENST00000522406.5	387	1623	++	135	Q8WWZ4-1#32	0	3	ENST00000522406.5	804	807	+	3	0	-2	7550
Q8WWZ4-1#32	0	1	1	Q8WWZ4-1	139	140	+	1	Q8WWZ4-1	0	338	ENST00000518929.5	84	1098	++	132	Q8WWZ4-1#32	0	3	ENST00000518929.5	501	504	+	3	0	-2	7551
Q8WWZ4-1#32	0	1	1	Q8WWZ4-1	139	140	+	1	Q8WWZ4-1	0	1543	ENST00000269081.8	910	5539	++	13	Q8WWZ4-1#32	0	3	ENST00000269081.8	1327	1330	+	3	0	-2	7552
Q8WWZ4-1#33	0	1	1	Q8WWZ4-1	158	159	+	1	Q8WWZ4-1	0	1543	ENST00000690296.1	556	5185	++	267	Q8WWZ4-1#33	0	3	ENST00000690296.1	1030	1033	+	3	0	-2	7553
Q8WWZ4-1#33	0	1	1	Q8WWZ4-1	158	159	+	1	Q8WWZ4-1	40	176	ENST00000524273.1	2	410	++	139	Q8WWZ4-1#33	0	3	ENST00000524273.1	356	359	+	3	0	-2	7554
Q8WWZ4-1#33	0	1	1	Q8WWZ4-1	158	159	+	1	Q8WWZ4-1	0	1322	ENST00000523419.5	84	4050	++	137	Q8WWZ4-1#33	0	3	ENST00000523419.5	558	561	+	3	0	-2	7555
Q8WWZ4-1#33	0	1	1	Q8WWZ4-1	158	159	+	1	Q8WWZ4-1	0	412	ENST00000522406.5	387	1623	++	135	Q8WWZ4-1#33	0	3	ENST00000522406.5	861	864	+	3	0	-2	7556
Q8WWZ4-1#33	0	1	1	Q8WWZ4-1	158	159	+	1	Q8WWZ4-1	0	338	ENST00000518929.5	84	1098	++	132	Q8WWZ4-1#33	0	3	ENST00000518929.5	558	561	+	3	0	-2	7557
Q8WWZ4-1#33	0	1	1	Q8WWZ4-1	158	159	+	1	Q8WWZ4-1	0	1543	ENST00000269081.8	910	5539	++	13	Q8WWZ4-1#33	0	3	ENST00000269081.8	1384	1387	+	3	0	-2	7558
Q8WWZ4-1#34	0	1	1	Q8WWZ4-1	186	187	+	1	Q8WWZ4-1	0	1543	ENST00000690296.1	556	5185	++	267	Q8WWZ4-1#34	0	3	ENST00000690296.1	1114	1117	+	3	0	-2	7559
Q8WWZ4-1#34	0	1	1	Q8WWZ4-1	186	187	+	1	Q8WWZ4-1	0	1322	ENST00000523419.5	84	4050	++	137	Q8WWZ4-1#34	0	3	ENST00000523419.5	642	645	+	3	0	-2	7560
Q8WWZ4-1#34	0	1	1	Q8WWZ4-1	186	187	+	1	Q8WWZ4-1	0	412	ENST00000522406.5	387	1623	++	135	Q8WWZ4-1#34	0	3	ENST00000522406.5	945	948	+	3	0	-2	7561
Q8WWZ4-1#34	0	1	1	Q8WWZ4-1	186	187	+	1	Q8WWZ4-1	0	338	ENST00000518929.5	84	1098	++	132	Q8WWZ4-1#34	0	3	ENST00000518929.5	642	645	+	3	0	-2	7562
Q8WWZ4-1#34	0	1	1	Q8WWZ4-1	186	187	+	1	Q8WWZ4-1	0	1543	ENST00000269081.8	910	5539	++	13	Q8WWZ4-1#34	0	3	ENST00000269081.8	1468	1471	+	3	0	-2	7563
Q8WWZ4-1#35	0	1	1	Q8WWZ4-1	323	324	+	1	Q8WWZ4-1	0	1543	ENST00000690296.1	556	5185	++	267	Q8WWZ4-1#35	0	3	ENST00000690296.1	1525	1528	+	3	0	-2	7564
Q8WWZ4-1#35	0	1	1	Q8WWZ4-1	323	324	+	1	Q8WWZ4-1	0	1322	ENST00000523419.5	84	4050	++	137	Q8WWZ4-1#35	0	3	ENST00000523419.5	1053	1056	+	3	0	-2	7565
Q8WWZ4-1#35	0	1	1	Q8WWZ4-1	323	324	+	1	Q8WWZ4-1	0	412	ENST00000522406.5	387	1623	++	135	Q8WWZ4-1#35	0	3	ENST00000522406.5	1356	1359	+	3	0	-2	7566
Q8WWZ4-1#35	0	1	1	Q8WWZ4-1	323	324	+	1	Q8WWZ4-1	0	338	ENST00000518929.5	84	1098	++	132	Q8WWZ4-1#35	0	3	ENST00000518929.5	1053	1056	+	3	0	-2	7567
Q8WWZ4-1#35	0	1	1	Q8WWZ4-1	323	324	+	1	Q8WWZ4-1	0	1543	ENST00000269081.8	910	5539	++	13	Q8WWZ4-1#35	0	3	ENST00000269081.8	1879	1882	+	3	0	-2	7568
Q8WWZ4-1#36	0	1	1	Q8WWZ4-1	363	364	+	1	Q8WWZ4-1	0	1543	ENST00000690296.1	556	5185	++	267	Q8WWZ4-1#36	0	3	ENST00000690296.1	1645	1648	+	3	0	-2	7569
Q8WWZ4-1#36	0	1	1	Q8WWZ4-1	363	364	+	1	Q8WWZ4-1	0	1322	ENST00000523419.5	84	4050	++	137	Q8WWZ4-1#36	0	3	ENST00000523419.5	1173	1176	+	3	0	-2	7570
Q8WWZ4-1#36	0	1	1	Q8WWZ4-1	363	364	+	1	Q8WWZ4-1	0	412	ENST00000522406.5	387	1623	++	135	Q8WWZ4-1#36	0	3	ENST00000522406.5	1476	1479	+	3	0	-2	7571
Q8WWZ4-1#36	0	1	1	Q8WWZ4-1	363	364	+	1	Q8WWZ4-1	0	1543	ENST00000269081.8	910	5539	++	13	Q8WWZ4-1#36	0	3	ENST00000269081.8	1999	2002	+	3	0	-2	7572
Q8WWZ4-1#37	0	1	1	Q8WWZ4-1	1215	1216	+	1	Q8WWZ4-1	0	1543	ENST00000690296.1	556	5185	++	267	Q8WWZ4-1#37	0	3	ENST00000690296.1	4201	4204	+	3	0	-2	7573
Q8WWZ4-1#37	0	1	1	Q8WWZ4-1	1215	1216	+	1	Q8WWZ4-1	0	1322	ENST00000523419.5	84	4050	++	137	Q8WWZ4-1#37	0	3	ENST00000523419.5	3729	3732	+	3	0	-2	7574
Q8WWZ4-1#37	0	1	1	Q8WWZ4-1	1215	1216	+	1	Q8WWZ4-1	0	1543	ENST00000269081.8	910	5539	++	13	Q8WWZ4-1#37	0	3	ENST00000269081.8	4555	4558	+	3	0	-2	7575
Q86UK0-1#0	0	2595	2595	Q86UK0-1	0	2595	+	2595	Q86UK0-1	0	54	ENST00000412081.1	196	358	++	73	Q86UK0-1#0	0	162	ENST00000412081.1	196	358	+	162	0	2433	7576
Q86UK0-1#0	0	2595	2595	Q86UK0-1	0	2595	+	2595	Q86UK0-1	328	2595	ENST00000389661.4	189	6990	++	57	Q86UK0-1#0	984	7785	ENST00000389661.4	189	6990	+	6801	984	-5190	7577
Q86UK0-1#0	0	2595	2595	Q86UK0-1	0	2595	+	2595	Q86UK0-1	0	2595	ENST00000272895.12	418	8203	++	14	Q86UK0-1#0	0	7785	ENST00000272895.12	418	8203	+	7785	0	-5190	7578
Q86UK0-1#1	0	21	21	Q86UK0-1	22	43	+	21	Q86UK0-1	0	54	ENST00000412081.1	196	358	++	73	Q86UK0-1#1	0	63	ENST00000412081.1	262	325	+	63	0	-42	7579
Q86UK0-1#1	0	21	21	Q86UK0-1	22	43	+	21	Q86UK0-1	0	2595	ENST00000272895.12	418	8203	++	14	Q86UK0-1#1	0	63	ENST00000272895.12	484	547	+	63	0	-42	7580
Q86UK0-1#2	0	21	21	Q86UK0-1	1064	1085	+	21	Q86UK0-1	328	2595	ENST00000389661.4	189	6990	++	57	Q86UK0-1#2	0	63	ENST00000389661.4	2397	2460	+	63	0	-42	7581
Q86UK0-1#2	0	21	21	Q86UK0-1	1064	1085	+	21	Q86UK0-1	0	2595	ENST00000272895.12	418	8203	++	14	Q86UK0-1#2	0	63	ENST00000272895.12	3610	3673	+	63	0	-42	7582
Q86UK0-1#3	0	21	21	Q86UK0-1	1111	1132	+	21	Q86UK0-1	328	2595	ENST00000389661.4	189	6990	++	57	Q86UK0-1#3	0	63	ENST00000389661.4	2538	2601	+	63	0	-42	7583
Q86UK0-1#3	0	21	21	Q86UK0-1	1111	1132	+	21	Q86UK0-1	0	2595	ENST00000272895.12	418	8203	++	14	Q86UK0-1#3	0	63	ENST00000272895.12	3751	3814	+	63	0	-42	7584
Q86UK0-1#4	0	21	21	Q86UK0-1	1144	1165	+	21	Q86UK0-1	328	2595	ENST00000389661.4	189	6990	++	57	Q86UK0-1#4	0	63	ENST00000389661.4	2637	2700	+	63	0	-42	7585
Q86UK0-1#4	0	21	21	Q86UK0-1	1144	1165	+	21	Q86UK0-1	0	2595	ENST00000272895.12	418	8203	++	14	Q86UK0-1#4	0	63	ENST00000272895.12	3850	3913	+	63	0	-42	7586
Q86UK0-1#5	0	21	21	Q86UK0-1	1173	1194	+	21	Q86UK0-1	328	2595	ENST00000389661.4	189	6990	++	57	Q86UK0-1#5	0	63	ENST00000389661.4	2724	2787	+	63	0	-42	7587
Q86UK0-1#5	0	21	21	Q86UK0-1	1173	1194	+	21	Q86UK0-1	0	2595	ENST00000272895.12	418	8203	++	14	Q86UK0-1#5	0	63	ENST00000272895.12	3937	4000	+	63	0	-42	7588
Q86UK0-1#6	0	21	21	Q86UK0-1	1199	1220	+	21	Q86UK0-1	328	2595	ENST00000389661.4	189	6990	++	57	Q86UK0-1#6	0	63	ENST00000389661.4	2802	2865	+	63	0	-42	7589
Q86UK0-1#6	0	21	21	Q86UK0-1	1199	1220	+	21	Q86UK0-1	0	2595	ENST00000272895.12	418	8203	++	14	Q86UK0-1#6	0	63	ENST00000272895.12	4015	4078	+	63	0	-42	7590
Q86UK0-1#7	0	21	21	Q86UK0-1	1249	1270	+	21	Q86UK0-1	328	2595	ENST00000389661.4	189	6990	++	57	Q86UK0-1#7	0	63	ENST00000389661.4	2952	3015	+	63	0	-42	7591
Q86UK0-1#7	0	21	21	Q86UK0-1	1249	1270	+	21	Q86UK0-1	0	2595	ENST00000272895.12	418	8203	++	14	Q86UK0-1#7	0	63	ENST00000272895.12	4165	4228	+	63	0	-42	7592
Q86UK0-1#8	0	21	21	Q86UK0-1	1746	1767	+	21	Q86UK0-1	328	2595	ENST00000389661.4	189	6990	++	57	Q86UK0-1#8	0	63	ENST00000389661.4	4443	4506	+	63	0	-42	7593
Q86UK0-1#8	0	21	21	Q86UK0-1	1746	1767	+	21	Q86UK0-1	0	2595	ENST00000272895.12	418	8203	++	14	Q86UK0-1#8	0	63	ENST00000272895.12	5656	5719	+	63	0	-42	7594
Q86UK0-1#9	0	21	21	Q86UK0-1	1978	1999	+	21	Q86UK0-1	328	2595	ENST00000389661.4	189	6990	++	57	Q86UK0-1#9	0	63	ENST00000389661.4	5139	5202	+	63	0	-42	7595
Q86UK0-1#9	0	21	21	Q86UK0-1	1978	1999	+	21	Q86UK0-1	0	2595	ENST00000272895.12	418	8203	++	14	Q86UK0-1#9	0	63	ENST00000272895.12	6352	6415	+	63	0	-42	7596
Q86UK0-1#10	0	21	21	Q86UK0-1	2034	2055	+	21	Q86UK0-1	328	2595	ENST00000389661.4	189	6990	++	57	Q86UK0-1#10	0	63	ENST00000389661.4	5307	5370	+	63	0	-42	7597
Q86UK0-1#10	0	21	21	Q86UK0-1	2034	2055	+	21	Q86UK0-1	0	2595	ENST00000272895.12	418	8203	++	14	Q86UK0-1#10	0	63	ENST00000272895.12	6520	6583	+	63	0	-42	7598
Q86UK0-1#11	0	21	21	Q86UK0-1	2071	2092	+	21	Q86UK0-1	328	2595	ENST00000389661.4	189	6990	++	57	Q86UK0-1#11	0	63	ENST00000389661.4	5418	5481	+	63	0	-42	7599
Q86UK0-1#11	0	21	21	Q86UK0-1	2071	2092	+	21	Q86UK0-1	0	2595	ENST00000272895.12	418	8203	++	14	Q86UK0-1#11	0	63	ENST00000272895.12	6631	6694	+	63	0	-42	7600
Q86UK0-1#12	0	21	21	Q86UK0-1	2102	2123	+	21	Q86UK0-1	328	2595	ENST00000389661.4	189	6990	++	57	Q86UK0-1#12	0	63	ENST00000389661.4	5511	5574	+	63	0	-42	7601
Q86UK0-1#12	0	21	21	Q86UK0-1	2102	2123	+	21	Q86UK0-1	0	2595	ENST00000272895.12	418	8203	++	14	Q86UK0-1#12	0	63	ENST00000272895.12	6724	6787	+	63	0	-42	7602
Q86UK0-1#13	0	21	21	Q86UK0-1	2186	2207	+	21	Q86UK0-1	328	2595	ENST00000389661.4	189	6990	++	57	Q86UK0-1#13	0	63	ENST00000389661.4	5763	5826	+	63	0	-42	7603
Q86UK0-1#13	0	21	21	Q86UK0-1	2186	2207	+	21	Q86UK0-1	0	2595	ENST00000272895.12	418	8203	++	14	Q86UK0-1#13	0	63	ENST00000272895.12	6976	7039	+	63	0	-42	7604
Q86UK0-1#14	0	21	21	Q86UK0-1	2269	2290	+	21	Q86UK0-1	328	2595	ENST00000389661.4	189	6990	++	57	Q86UK0-1#14	0	63	ENST00000389661.4	6012	6075	+	63	0	-42	7605
Q86UK0-1#14	0	21	21	Q86UK0-1	2269	2290	+	21	Q86UK0-1	0	2595	ENST00000272895.12	418	8203	++	14	Q86UK0-1#14	0	63	ENST00000272895.12	7225	7288	+	63	0	-42	7606
Q86UK0-1#15	0	232	232	Q86UK0-1	1345	1577	+	232	Q86UK0-1	328	2595	ENST00000389661.4	189	6990	++	57	Q86UK0-1#15	0	696	ENST00000389661.4	3240	3936	+	696	0	-464	7607
Q86UK0-1#15	0	232	232	Q86UK0-1	1345	1577	+	232	Q86UK0-1	0	2595	ENST00000272895.12	418	8203	++	14	Q86UK0-1#15	0	696	ENST00000272895.12	4453	5149	+	696	0	-464	7608
Q86UK0-1#16	0	236	236	Q86UK0-1	2253	2489	+	236	Q86UK0-1	328	2595	ENST00000389661.4	189	6990	++	57	Q86UK0-1#16	0	708	ENST00000389661.4	5964	6672	+	708	0	-472	7609
Q86UK0-1#16	0	236	236	Q86UK0-1	2253	2489	+	236	Q86UK0-1	0	2595	ENST00000272895.12	418	8203	++	14	Q86UK0-1#16	0	708	ENST00000272895.12	7177	7885	+	708	0	-472	7610
Q86UK0-1#17	0	25	25	Q86UK0-1	2570	2595	+	25	Q86UK0-1	328	2595	ENST00000389661.4	189	6990	++	57	Q86UK0-1#17	0	75	ENST00000389661.4	6915	6990	+	75	0	-50	7611
Q86UK0-1#17	0	25	25	Q86UK0-1	2570	2595	+	25	Q86UK0-1	0	2595	ENST00000272895.12	418	8203	++	14	Q86UK0-1#17	0	75	ENST00000272895.12	8128	8203	+	75	0	-50	7612
Q86UK0-1#18	0	8	8	Q86UK0-1	1377	1385	+	8	Q86UK0-1	328	2595	ENST00000389661.4	189	6990	++	57	Q86UK0-1#18	0	24	ENST00000389661.4	3336	3360	+	24	0	-16	7613
Q86UK0-1#18	0	8	8	Q86UK0-1	1377	1385	+	8	Q86UK0-1	0	2595	ENST00000272895.12	418	8203	++	14	Q86UK0-1#18	0	24	ENST00000272895.12	4549	4573	+	24	0	-16	7614
Q86UK0-1#19	0	8	8	Q86UK0-1	2289	2297	+	8	Q86UK0-1	328	2595	ENST00000389661.4	189	6990	++	57	Q86UK0-1#19	0	24	ENST00000389661.4	6072	6096	+	24	0	-16	7615
Q86UK0-1#19	0	8	8	Q86UK0-1	2289	2297	+	8	Q86UK0-1	0	2595	ENST00000272895.12	418	8203	++	14	Q86UK0-1#19	0	24	ENST00000272895.12	7285	7309	+	24	0	-16	7616
Q86UK0-1#20	0	1	1	Q86UK0-1	155	156	+	1	Q86UK0-1	0	2595	ENST00000272895.12	418	8203	++	14	Q86UK0-1#20	0	3	ENST00000272895.12	883	886	+	3	0	-2	7617
Q86UK0-1#21	0	1	1	Q86UK0-1	173	174	+	1	Q86UK0-1	0	2595	ENST00000272895.12	418	8203	++	14	Q86UK0-1#21	0	3	ENST00000272895.12	937	940	+	3	0	-2	7618
Q86UK0-1#22	0	1	1	Q86UK0-1	213	214	+	1	Q86UK0-1	0	2595	ENST00000272895.12	418	8203	++	14	Q86UK0-1#22	0	3	ENST00000272895.12	1057	1060	+	3	0	-2	7619
Q86UK0-1#23	0	1	1	Q86UK0-1	274	275	+	1	Q86UK0-1	0	2595	ENST00000272895.12	418	8203	++	14	Q86UK0-1#23	0	3	ENST00000272895.12	1240	1243	+	3	0	-2	7620
Q86UK0-1#24	0	1	1	Q86UK0-1	332	333	+	1	Q86UK0-1	328	2595	ENST00000389661.4	189	6990	++	57	Q86UK0-1#24	0	3	ENST00000389661.4	201	204	+	3	0	-2	7621
Q86UK0-1#24	0	1	1	Q86UK0-1	332	333	+	1	Q86UK0-1	0	2595	ENST00000272895.12	418	8203	++	14	Q86UK0-1#24	0	3	ENST00000272895.12	1414	1417	+	3	0	-2	7622
Q86UK0-1#25	0	1	1	Q86UK0-1	366	367	+	1	Q86UK0-1	328	2595	ENST00000389661.4	189	6990	++	57	Q86UK0-1#25	0	3	ENST00000389661.4	303	306	+	3	0	-2	7623
Q86UK0-1#25	0	1	1	Q86UK0-1	366	367	+	1	Q86UK0-1	0	2595	ENST00000272895.12	418	8203	++	14	Q86UK0-1#25	0	3	ENST00000272895.12	1516	1519	+	3	0	-2	7624
Q86UK0-1#26	0	1	1	Q86UK0-1	382	383	+	1	Q86UK0-1	328	2595	ENST00000389661.4	189	6990	++	57	Q86UK0-1#26	0	3	ENST00000389661.4	351	354	+	3	0	-2	7625
Q86UK0-1#26	0	1	1	Q86UK0-1	382	383	+	1	Q86UK0-1	0	2595	ENST00000272895.12	418	8203	++	14	Q86UK0-1#26	0	3	ENST00000272895.12	1564	1567	+	3	0	-2	7626
Q86UK0-1#27	0	1	1	Q86UK0-1	411	412	+	1	Q86UK0-1	328	2595	ENST00000389661.4	189	6990	++	57	Q86UK0-1#27	0	3	ENST00000389661.4	438	441	+	3	0	-2	7627
Q86UK0-1#27	0	1	1	Q86UK0-1	411	412	+	1	Q86UK0-1	0	2595	ENST00000272895.12	418	8203	++	14	Q86UK0-1#27	0	3	ENST00000272895.12	1651	1654	+	3	0	-2	7628
Q86UK0-1#28	0	1	1	Q86UK0-1	434	435	+	1	Q86UK0-1	328	2595	ENST00000389661.4	189	6990	++	57	Q86UK0-1#28	0	3	ENST00000389661.4	507	510	+	3	0	-2	7629
Q86UK0-1#28	0	1	1	Q86UK0-1	434	435	+	1	Q86UK0-1	0	2595	ENST00000272895.12	418	8203	++	14	Q86UK0-1#28	0	3	ENST00000272895.12	1720	1723	+	3	0	-2	7630
Q86UK0-1#29	0	1	1	Q86UK0-1	527	528	+	1	Q86UK0-1	328	2595	ENST00000389661.4	189	6990	++	57	Q86UK0-1#29	0	3	ENST00000389661.4	786	789	+	3	0	-2	7631
Q86UK0-1#29	0	1	1	Q86UK0-1	527	528	+	1	Q86UK0-1	0	2595	ENST00000272895.12	418	8203	++	14	Q86UK0-1#29	0	3	ENST00000272895.12	1999	2002	+	3	0	-2	7632
Q86UK0-1#30	0	1	1	Q86UK0-1	542	543	+	1	Q86UK0-1	328	2595	ENST00000389661.4	189	6990	++	57	Q86UK0-1#30	0	3	ENST00000389661.4	831	834	+	3	0	-2	7633
Q86UK0-1#30	0	1	1	Q86UK0-1	542	543	+	1	Q86UK0-1	0	2595	ENST00000272895.12	418	8203	++	14	Q86UK0-1#30	0	3	ENST00000272895.12	2044	2047	+	3	0	-2	7634
Q86UK0-1#31	0	1	1	Q86UK0-1	576	577	+	1	Q86UK0-1	328	2595	ENST00000389661.4	189	6990	++	57	Q86UK0-1#31	0	3	ENST00000389661.4	933	936	+	3	0	-2	7635
Q86UK0-1#31	0	1	1	Q86UK0-1	576	577	+	1	Q86UK0-1	0	2595	ENST00000272895.12	418	8203	++	14	Q86UK0-1#31	0	3	ENST00000272895.12	2146	2149	+	3	0	-2	7636
Q86UK0-1#32	0	1	1	Q86UK0-1	607	608	+	1	Q86UK0-1	328	2595	ENST00000389661.4	189	6990	++	57	Q86UK0-1#32	0	3	ENST00000389661.4	1026	1029	+	3	0	-2	7637
Q86UK0-1#32	0	1	1	Q86UK0-1	607	608	+	1	Q86UK0-1	0	2595	ENST00000272895.12	418	8203	++	14	Q86UK0-1#32	0	3	ENST00000272895.12	2239	2242	+	3	0	-2	7638
Q86UK0-1#33	0	1	1	Q86UK0-1	622	623	+	1	Q86UK0-1	328	2595	ENST00000389661.4	189	6990	++	57	Q86UK0-1#33	0	3	ENST00000389661.4	1071	1074	+	3	0	-2	7639
Q86UK0-1#33	0	1	1	Q86UK0-1	622	623	+	1	Q86UK0-1	0	2595	ENST00000272895.12	418	8203	++	14	Q86UK0-1#33	0	3	ENST00000272895.12	2284	2287	+	3	0	-2	7640
Q86UK0-1#34	0	1	1	Q86UK0-1	647	648	+	1	Q86UK0-1	328	2595	ENST00000389661.4	189	6990	++	57	Q86UK0-1#34	0	3	ENST00000389661.4	1146	1149	+	3	0	-2	7641
Q86UK0-1#34	0	1	1	Q86UK0-1	647	648	+	1	Q86UK0-1	0	2595	ENST00000272895.12	418	8203	++	14	Q86UK0-1#34	0	3	ENST00000272895.12	2359	2362	+	3	0	-2	7642
Q86UK0-1#35	0	1	1	Q86UK0-1	751	752	+	1	Q86UK0-1	328	2595	ENST00000389661.4	189	6990	++	57	Q86UK0-1#35	0	3	ENST00000389661.4	1458	1461	+	3	0	-2	7643
Q86UK0-1#35	0	1	1	Q86UK0-1	751	752	+	1	Q86UK0-1	0	2595	ENST00000272895.12	418	8203	++	14	Q86UK0-1#35	0	3	ENST00000272895.12	2671	2674	+	3	0	-2	7644
Q86UK0-1#36	0	1	1	Q86UK0-1	825	826	+	1	Q86UK0-1	328	2595	ENST00000389661.4	189	6990	++	57	Q86UK0-1#36	0	3	ENST00000389661.4	1680	1683	+	3	0	-2	7645
Q86UK0-1#36	0	1	1	Q86UK0-1	825	826	+	1	Q86UK0-1	0	2595	ENST00000272895.12	418	8203	++	14	Q86UK0-1#36	0	3	ENST00000272895.12	2893	2896	+	3	0	-2	7646
Q86UK0-1#37	0	1	1	Q86UK0-1	919	920	+	1	Q86UK0-1	328	2595	ENST00000389661.4	189	6990	++	57	Q86UK0-1#37	0	3	ENST00000389661.4	1962	1965	+	3	0	-2	7647
Q86UK0-1#37	0	1	1	Q86UK0-1	919	920	+	1	Q86UK0-1	0	2595	ENST00000272895.12	418	8203	++	14	Q86UK0-1#37	0	3	ENST00000272895.12	3175	3178	+	3	0	-2	7648
Q86UK0-1#38	0	1	1	Q86UK0-1	962	963	+	1	Q86UK0-1	328	2595	ENST00000389661.4	189	6990	++	57	Q86UK0-1#38	0	3	ENST00000389661.4	2091	2094	+	3	0	-2	7649
Q86UK0-1#38	0	1	1	Q86UK0-1	962	963	+	1	Q86UK0-1	0	2595	ENST00000272895.12	418	8203	++	14	Q86UK0-1#38	0	3	ENST00000272895.12	3304	3307	+	3	0	-2	7650
Q86UK0-1#39	0	1	1	Q86UK0-1	1169	1170	+	1	Q86UK0-1	328	2595	ENST00000389661.4	189	6990	++	57	Q86UK0-1#39	0	3	ENST00000389661.4	2712	2715	+	3	0	-2	7651
Q86UK0-1#39	0	1	1	Q86UK0-1	1169	1170	+	1	Q86UK0-1	0	2595	ENST00000272895.12	418	8203	++	14	Q86UK0-1#39	0	3	ENST00000272895.12	3925	3928	+	3	0	-2	7652
Q86UK0-1#40	0	1	1	Q86UK0-1	1523	1524	+	1	Q86UK0-1	328	2595	ENST00000389661.4	189	6990	++	57	Q86UK0-1#40	0	3	ENST00000389661.4	3774	3777	+	3	0	-2	7653
Q86UK0-1#40	0	1	1	Q86UK0-1	1523	1524	+	1	Q86UK0-1	0	2595	ENST00000272895.12	418	8203	++	14	Q86UK0-1#40	0	3	ENST00000272895.12	4987	4990	+	3	0	-2	7654
Q86UK0-1#41	0	1	1	Q86UK0-1	1662	1663	+	1	Q86UK0-1	328	2595	ENST00000389661.4	189	6990	++	57	Q86UK0-1#41	0	3	ENST00000389661.4	4191	4194	+	3	0	-2	7655
Q86UK0-1#41	0	1	1	Q86UK0-1	1662	1663	+	1	Q86UK0-1	0	2595	ENST00000272895.12	418	8203	++	14	Q86UK0-1#41	0	3	ENST00000272895.12	5404	5407	+	3	0	-2	7656
Q86UK0-1#42	0	1	1	Q86UK0-1	1703	1704	+	1	Q86UK0-1	328	2595	ENST00000389661.4	189	6990	++	57	Q86UK0-1#42	0	3	ENST00000389661.4	4314	4317	+	3	0	-2	7657
Q86UK0-1#42	0	1	1	Q86UK0-1	1703	1704	+	1	Q86UK0-1	0	2595	ENST00000272895.12	418	8203	++	14	Q86UK0-1#42	0	3	ENST00000272895.12	5527	5530	+	3	0	-2	7658
Q86UK0-1#43	0	1	1	Q86UK0-1	1768	1769	+	1	Q86UK0-1	328	2595	ENST00000389661.4	189	6990	++	57	Q86UK0-1#43	0	3	ENST00000389661.4	4509	4512	+	3	0	-2	7659
Q86UK0-1#43	0	1	1	Q86UK0-1	1768	1769	+	1	Q86UK0-1	0	2595	ENST00000272895.12	418	8203	++	14	Q86UK0-1#43	0	3	ENST00000272895.12	5722	5725	+	3	0	-2	7660
Q86UK0-1#44	0	1	1	Q86UK0-1	1818	1819	+	1	Q86UK0-1	328	2595	ENST00000389661.4	189	6990	++	57	Q86UK0-1#44	0	3	ENST00000389661.4	4659	4662	+	3	0	-2	7661
Q86UK0-1#44	0	1	1	Q86UK0-1	1818	1819	+	1	Q86UK0-1	0	2595	ENST00000272895.12	418	8203	++	14	Q86UK0-1#44	0	3	ENST00000272895.12	5872	5875	+	3	0	-2	7662
Q86UK0-1#45	0	1	1	Q86UK0-1	1834	1835	+	1	Q86UK0-1	328	2595	ENST00000389661.4	189	6990	++	57	Q86UK0-1#45	0	3	ENST00000389661.4	4707	4710	+	3	0	-2	7663
Q86UK0-1#45	0	1	1	Q86UK0-1	1834	1835	+	1	Q86UK0-1	0	2595	ENST00000272895.12	418	8203	++	14	Q86UK0-1#45	0	3	ENST00000272895.12	5920	5923	+	3	0	-2	7664
Q86UK0-1#46	0	1	1	Q86UK0-1	1875	1876	+	1	Q86UK0-1	328	2595	ENST00000389661.4	189	6990	++	57	Q86UK0-1#46	0	3	ENST00000389661.4	4830	4833	+	3	0	-2	7665
Q86UK0-1#46	0	1	1	Q86UK0-1	1875	1876	+	1	Q86UK0-1	0	2595	ENST00000272895.12	418	8203	++	14	Q86UK0-1#46	0	3	ENST00000272895.12	6043	6046	+	3	0	-2	7666
Q86UK0-1#47	0	1	1	Q86UK0-1	1920	1921	+	1	Q86UK0-1	328	2595	ENST00000389661.4	189	6990	++	57	Q86UK0-1#47	0	3	ENST00000389661.4	4965	4968	+	3	0	-2	7667
Q86UK0-1#47	0	1	1	Q86UK0-1	1920	1921	+	1	Q86UK0-1	0	2595	ENST00000272895.12	418	8203	++	14	Q86UK0-1#47	0	3	ENST00000272895.12	6178	6181	+	3	0	-2	7668
Q86UK0-1#48	0	1	1	Q86UK0-1	1951	1952	+	1	Q86UK0-1	328	2595	ENST00000389661.4	189	6990	++	57	Q86UK0-1#48	0	3	ENST00000389661.4	5058	5061	+	3	0	-2	7669
Q86UK0-1#48	0	1	1	Q86UK0-1	1951	1952	+	1	Q86UK0-1	0	2595	ENST00000272895.12	418	8203	++	14	Q86UK0-1#48	0	3	ENST00000272895.12	6271	6274	+	3	0	-2	7670
Q86UK0-1#49	0	1	1	Q86UK0-1	2177	2178	+	1	Q86UK0-1	328	2595	ENST00000389661.4	189	6990	++	57	Q86UK0-1#49	0	3	ENST00000389661.4	5736	5739	+	3	0	-2	7671
Q86UK0-1#49	0	1	1	Q86UK0-1	2177	2178	+	1	Q86UK0-1	0	2595	ENST00000272895.12	418	8203	++	14	Q86UK0-1#49	0	3	ENST00000272895.12	6949	6952	+	3	0	-2	7672
Q86UK0-1#50	0	1	1	Q86UK0-1	2207	2208	+	1	Q86UK0-1	328	2595	ENST00000389661.4	189	6990	++	57	Q86UK0-1#50	0	3	ENST00000389661.4	5826	5829	+	3	0	-2	7673
Q86UK0-1#50	0	1	1	Q86UK0-1	2207	2208	+	1	Q86UK0-1	0	2595	ENST00000272895.12	418	8203	++	14	Q86UK0-1#50	0	3	ENST00000272895.12	7039	7042	+	3	0	-2	7674
Q86UK0-1#51	0	1	1	Q86UK0-1	2222	2223	+	1	Q86UK0-1	328	2595	ENST00000389661.4	189	6990	++	57	Q86UK0-1#51	0	3	ENST00000389661.4	5871	5874	+	3	0	-2	7675
Q86UK0-1#51	0	1	1	Q86UK0-1	2222	2223	+	1	Q86UK0-1	0	2595	ENST00000272895.12	418	8203	++	14	Q86UK0-1#51	0	3	ENST00000272895.12	7084	7087	+	3	0	-2	7676
Q86UK0-1#52	0	1	1	Q86UK0-1	2317	2318	+	1	Q86UK0-1	328	2595	ENST00000389661.4	189	6990	++	57	Q86UK0-1#52	0	3	ENST00000389661.4	6156	6159	+	3	0	-2	7677
Q86UK0-1#52	0	1	1	Q86UK0-1	2317	2318	+	1	Q86UK0-1	0	2595	ENST00000272895.12	418	8203	++	14	Q86UK0-1#52	0	3	ENST00000272895.12	7369	7372	+	3	0	-2	7678
Q86UK0-1#53	0	1	1	Q86UK0-1	2541	2542	+	1	Q86UK0-1	328	2595	ENST00000389661.4	189	6990	++	57	Q86UK0-1#53	0	3	ENST00000389661.4	6828	6831	+	3	0	-2	7679
Q86UK0-1#53	0	1	1	Q86UK0-1	2541	2542	+	1	Q86UK0-1	0	2595	ENST00000272895.12	418	8203	++	14	Q86UK0-1#53	0	3	ENST00000272895.12	8041	8044	+	3	0	-2	7680
Q86UK0-1#54	0	1	1	Q86UK0-1	2546	2547	+	1	Q86UK0-1	328	2595	ENST00000389661.4	189	6990	++	57	Q86UK0-1#54	0	3	ENST00000389661.4	6843	6846	+	3	0	-2	7681
Q86UK0-1#54	0	1	1	Q86UK0-1	2546	2547	+	1	Q86UK0-1	0	2595	ENST00000272895.12	418	8203	++	14	Q86UK0-1#54	0	3	ENST00000272895.12	8056	8059	+	3	0	-2	7682
Q86UK0-1#55	0	318	318	Q86UK0-1	0	318	+	318	Q86UK0-1	0	54	ENST00000412081.1	196	358	++	73	Q86UK0-1#55	0	162	ENST00000412081.1	196	358	+	162	0	156	7683
Q86UK0-1#55	0	318	318	Q86UK0-1	0	318	+	318	Q86UK0-1	0	2595	ENST00000272895.12	418	8203	++	14	Q86UK0-1#55	0	954	ENST00000272895.12	418	1372	+	954	0	-636	7684
Q86UK0-1#56	0	10	10	Q86UK0-1	318	328	+	10	Q86UK0-1	0	2595	ENST00000272895.12	418	8203	++	14	Q86UK0-1#56	0	30	ENST00000272895.12	1372	1402	+	30	0	-20	7685
Q86UK0-1#57	0	1	1	Q86UK0-1	198	199	+	1	Q86UK0-1	0	2595	ENST00000272895.12	418	8203	++	14	Q86UK0-1#57	0	3	ENST00000272895.12	1012	1015	+	3	0	-2	7686
Q86UK0-1#58	0	1	1	Q86UK0-1	236	237	+	1	Q86UK0-1	0	2595	ENST00000272895.12	418	8203	++	14	Q86UK0-1#58	0	3	ENST00000272895.12	1126	1129	+	3	0	-2	7687
Q86UK0-1#59	0	1	1	Q86UK0-1	273	274	+	1	Q86UK0-1	0	2595	ENST00000272895.12	418	8203	++	14	Q86UK0-1#59	0	3	ENST00000272895.12	1237	1240	+	3	0	-2	7688
Q86UK0-1#60	0	1	1	Q86UK0-1	286	287	+	1	Q86UK0-1	0	2595	ENST00000272895.12	418	8203	++	14	Q86UK0-1#60	0	3	ENST00000272895.12	1276	1279	+	3	0	-2	7689
Q86UK0-1#61	0	1	1	Q86UK0-1	344	345	+	1	Q86UK0-1	328	2595	ENST00000389661.4	189	6990	++	57	Q86UK0-1#61	0	3	ENST00000389661.4	237	240	+	3	0	-2	7690
Q86UK0-1#61	0	1	1	Q86UK0-1	344	345	+	1	Q86UK0-1	0	2595	ENST00000272895.12	418	8203	++	14	Q86UK0-1#61	0	3	ENST00000272895.12	1450	1453	+	3	0	-2	7691
Q86UK0-1#62	0	1	1	Q86UK0-1	386	387	+	1	Q86UK0-1	328	2595	ENST00000389661.4	189	6990	++	57	Q86UK0-1#62	0	3	ENST00000389661.4	363	366	+	3	0	-2	7692
Q86UK0-1#62	0	1	1	Q86UK0-1	386	387	+	1	Q86UK0-1	0	2595	ENST00000272895.12	418	8203	++	14	Q86UK0-1#62	0	3	ENST00000272895.12	1576	1579	+	3	0	-2	7693
Q86UK0-1#63	0	2162	2162	Q86UK0-1	433	2595	+	2162	Q86UK0-1	328	2595	ENST00000389661.4	189	6990	++	57	Q86UK0-1#63	0	6486	ENST00000389661.4	504	6990	+	6486	0	-4324	7694
Q86UK0-1#63	0	2162	2162	Q86UK0-1	433	2595	+	2162	Q86UK0-1	0	2595	ENST00000272895.12	418	8203	++	14	Q86UK0-1#63	0	6486	ENST00000272895.12	1717	8203	+	6486	0	-4324	7695
Q86UK0-1#64	0	1	1	Q86UK0-1	458	459	+	1	Q86UK0-1	328	2595	ENST00000389661.4	189	6990	++	57	Q86UK0-1#64	0	3	ENST00000389661.4	579	582	+	3	0	-2	7696
Q86UK0-1#64	0	1	1	Q86UK0-1	458	459	+	1	Q86UK0-1	0	2595	ENST00000272895.12	418	8203	++	14	Q86UK0-1#64	0	3	ENST00000272895.12	1792	1795	+	3	0	-2	7697
Q86UK0-1#65	0	1	1	Q86UK0-1	475	476	+	1	Q86UK0-1	328	2595	ENST00000389661.4	189	6990	++	57	Q86UK0-1#65	0	3	ENST00000389661.4	630	633	+	3	0	-2	7698
Q86UK0-1#65	0	1	1	Q86UK0-1	475	476	+	1	Q86UK0-1	0	2595	ENST00000272895.12	418	8203	++	14	Q86UK0-1#65	0	3	ENST00000272895.12	1843	1846	+	3	0	-2	7699
Q86UK0-1#66	0	1	1	Q86UK0-1	549	550	+	1	Q86UK0-1	328	2595	ENST00000389661.4	189	6990	++	57	Q86UK0-1#66	0	3	ENST00000389661.4	852	855	+	3	0	-2	7700
Q86UK0-1#66	0	1	1	Q86UK0-1	549	550	+	1	Q86UK0-1	0	2595	ENST00000272895.12	418	8203	++	14	Q86UK0-1#66	0	3	ENST00000272895.12	2065	2068	+	3	0	-2	7701
Q86UK0-1#67	0	1	1	Q86UK0-1	776	777	+	1	Q86UK0-1	328	2595	ENST00000389661.4	189	6990	++	57	Q86UK0-1#67	0	3	ENST00000389661.4	1533	1536	+	3	0	-2	7702
Q86UK0-1#67	0	1	1	Q86UK0-1	776	777	+	1	Q86UK0-1	0	2595	ENST00000272895.12	418	8203	++	14	Q86UK0-1#67	0	3	ENST00000272895.12	2746	2749	+	3	0	-2	7703
Q86UK0-1#68	0	1	1	Q86UK0-1	1135	1136	+	1	Q86UK0-1	328	2595	ENST00000389661.4	189	6990	++	57	Q86UK0-1#68	0	3	ENST00000389661.4	2610	2613	+	3	0	-2	7704
Q86UK0-1#68	0	1	1	Q86UK0-1	1135	1136	+	1	Q86UK0-1	0	2595	ENST00000272895.12	418	8203	++	14	Q86UK0-1#68	0	3	ENST00000272895.12	3823	3826	+	3	0	-2	7705
Q86UK0-1#69	0	1	1	Q86UK0-1	1178	1179	+	1	Q86UK0-1	328	2595	ENST00000389661.4	189	6990	++	57	Q86UK0-1#69	0	3	ENST00000389661.4	2739	2742	+	3	0	-2	7706
Q86UK0-1#69	0	1	1	Q86UK0-1	1178	1179	+	1	Q86UK0-1	0	2595	ENST00000272895.12	418	8203	++	14	Q86UK0-1#69	0	3	ENST00000272895.12	3952	3955	+	3	0	-2	7707
Q86UK0-1#70	0	1	1	Q86UK0-1	1234	1235	+	1	Q86UK0-1	328	2595	ENST00000389661.4	189	6990	++	57	Q86UK0-1#70	0	3	ENST00000389661.4	2907	2910	+	3	0	-2	7708
Q86UK0-1#70	0	1	1	Q86UK0-1	1234	1235	+	1	Q86UK0-1	0	2595	ENST00000272895.12	418	8203	++	14	Q86UK0-1#70	0	3	ENST00000272895.12	4120	4123	+	3	0	-2	7709
Q86UK0-1#71	0	1	1	Q86UK0-1	1250	1251	+	1	Q86UK0-1	328	2595	ENST00000389661.4	189	6990	++	57	Q86UK0-1#71	0	3	ENST00000389661.4	2955	2958	+	3	0	-2	7710
Q86UK0-1#71	0	1	1	Q86UK0-1	1250	1251	+	1	Q86UK0-1	0	2595	ENST00000272895.12	418	8203	++	14	Q86UK0-1#71	0	3	ENST00000272895.12	4168	4171	+	3	0	-2	7711
Q86UK0-1#72	0	1	1	Q86UK0-1	1379	1380	+	1	Q86UK0-1	328	2595	ENST00000389661.4	189	6990	++	57	Q86UK0-1#72	0	3	ENST00000389661.4	3342	3345	+	3	0	-2	7712
Q86UK0-1#72	0	1	1	Q86UK0-1	1379	1380	+	1	Q86UK0-1	0	2595	ENST00000272895.12	418	8203	++	14	Q86UK0-1#72	0	3	ENST00000272895.12	4555	4558	+	3	0	-2	7713
Q86UK0-1#73	0	1	1	Q86UK0-1	1380	1381	+	1	Q86UK0-1	328	2595	ENST00000389661.4	189	6990	++	57	Q86UK0-1#73	0	3	ENST00000389661.4	3345	3348	+	3	0	-2	7714
Q86UK0-1#73	0	1	1	Q86UK0-1	1380	1381	+	1	Q86UK0-1	0	2595	ENST00000272895.12	418	8203	++	14	Q86UK0-1#73	0	3	ENST00000272895.12	4558	4561	+	3	0	-2	7715
Q86UK0-1#74	0	1	1	Q86UK0-1	1384	1385	+	1	Q86UK0-1	328	2595	ENST00000389661.4	189	6990	++	57	Q86UK0-1#74	0	3	ENST00000389661.4	3357	3360	+	3	0	-2	7716
Q86UK0-1#74	0	1	1	Q86UK0-1	1384	1385	+	1	Q86UK0-1	0	2595	ENST00000272895.12	418	8203	++	14	Q86UK0-1#74	0	3	ENST00000272895.12	4570	4573	+	3	0	-2	7717
Q86UK0-1#75	0	1	1	Q86UK0-1	1493	1494	+	1	Q86UK0-1	328	2595	ENST00000389661.4	189	6990	++	57	Q86UK0-1#75	0	3	ENST00000389661.4	3684	3687	+	3	0	-2	7718
Q86UK0-1#75	0	1	1	Q86UK0-1	1493	1494	+	1	Q86UK0-1	0	2595	ENST00000272895.12	418	8203	++	14	Q86UK0-1#75	0	3	ENST00000272895.12	4897	4900	+	3	0	-2	7719
Q86UK0-1#76	0	1	1	Q86UK0-1	1513	1514	+	1	Q86UK0-1	328	2595	ENST00000389661.4	189	6990	++	57	Q86UK0-1#76	0	3	ENST00000389661.4	3744	3747	+	3	0	-2	7720
Q86UK0-1#76	0	1	1	Q86UK0-1	1513	1514	+	1	Q86UK0-1	0	2595	ENST00000272895.12	418	8203	++	14	Q86UK0-1#76	0	3	ENST00000272895.12	4957	4960	+	3	0	-2	7721
Q86UK0-1#77	0	1	1	Q86UK0-1	1538	1539	+	1	Q86UK0-1	328	2595	ENST00000389661.4	189	6990	++	57	Q86UK0-1#77	0	3	ENST00000389661.4	3819	3822	+	3	0	-2	7722
Q86UK0-1#77	0	1	1	Q86UK0-1	1538	1539	+	1	Q86UK0-1	0	2595	ENST00000272895.12	418	8203	++	14	Q86UK0-1#77	0	3	ENST00000272895.12	5032	5035	+	3	0	-2	7723
Q86UK0-1#78	0	1	1	Q86UK0-1	1545	1546	+	1	Q86UK0-1	328	2595	ENST00000389661.4	189	6990	++	57	Q86UK0-1#78	0	3	ENST00000389661.4	3840	3843	+	3	0	-2	7724
Q86UK0-1#78	0	1	1	Q86UK0-1	1545	1546	+	1	Q86UK0-1	0	2595	ENST00000272895.12	418	8203	++	14	Q86UK0-1#78	0	3	ENST00000272895.12	5053	5056	+	3	0	-2	7725
Q86UK0-1#79	0	1	1	Q86UK0-1	1558	1559	+	1	Q86UK0-1	328	2595	ENST00000389661.4	189	6990	++	57	Q86UK0-1#79	0	3	ENST00000389661.4	3879	3882	+	3	0	-2	7726
Q86UK0-1#79	0	1	1	Q86UK0-1	1558	1559	+	1	Q86UK0-1	0	2595	ENST00000272895.12	418	8203	++	14	Q86UK0-1#79	0	3	ENST00000272895.12	5092	5095	+	3	0	-2	7727
Q86UK0-1#80	0	1	1	Q86UK0-1	1650	1651	+	1	Q86UK0-1	328	2595	ENST00000389661.4	189	6990	++	57	Q86UK0-1#80	0	3	ENST00000389661.4	4155	4158	+	3	0	-2	7728
Q86UK0-1#80	0	1	1	Q86UK0-1	1650	1651	+	1	Q86UK0-1	0	2595	ENST00000272895.12	418	8203	++	14	Q86UK0-1#80	0	3	ENST00000272895.12	5368	5371	+	3	0	-2	7729
Q86UK0-1#81	0	1	1	Q86UK0-1	1797	1798	+	1	Q86UK0-1	328	2595	ENST00000389661.4	189	6990	++	57	Q86UK0-1#81	0	3	ENST00000389661.4	4596	4599	+	3	0	-2	7730
Q86UK0-1#81	0	1	1	Q86UK0-1	1797	1798	+	1	Q86UK0-1	0	2595	ENST00000272895.12	418	8203	++	14	Q86UK0-1#81	0	3	ENST00000272895.12	5809	5812	+	3	0	-2	7731
Q86UK0-1#82	0	646	646	Q86UK0-1	1949	2595	+	646	Q86UK0-1	328	2595	ENST00000389661.4	189	6990	++	57	Q86UK0-1#82	0	1938	ENST00000389661.4	5052	6990	+	1938	0	-1292	7732
Q86UK0-1#82	0	646	646	Q86UK0-1	1949	2595	+	646	Q86UK0-1	0	2595	ENST00000272895.12	418	8203	++	14	Q86UK0-1#82	0	1938	ENST00000272895.12	6265	8203	+	1938	0	-1292	7733
Q86UK0-1#83	0	1	1	Q86UK0-1	1979	1980	+	1	Q86UK0-1	328	2595	ENST00000389661.4	189	6990	++	57	Q86UK0-1#83	0	3	ENST00000389661.4	5142	5145	+	3	0	-2	7734
Q86UK0-1#83	0	1	1	Q86UK0-1	1979	1980	+	1	Q86UK0-1	0	2595	ENST00000272895.12	418	8203	++	14	Q86UK0-1#83	0	3	ENST00000272895.12	6355	6358	+	3	0	-2	7735
Q86UK0-1#84	0	1	1	Q86UK0-1	2063	2064	+	1	Q86UK0-1	328	2595	ENST00000389661.4	189	6990	++	57	Q86UK0-1#84	0	3	ENST00000389661.4	5394	5397	+	3	0	-2	7736
Q86UK0-1#84	0	1	1	Q86UK0-1	2063	2064	+	1	Q86UK0-1	0	2595	ENST00000272895.12	418	8203	++	14	Q86UK0-1#84	0	3	ENST00000272895.12	6607	6610	+	3	0	-2	7737
Q86UK0-1#85	0	1	1	Q86UK0-1	2364	2365	+	1	Q86UK0-1	328	2595	ENST00000389661.4	189	6990	++	57	Q86UK0-1#85	0	3	ENST00000389661.4	6297	6300	+	3	0	-2	7738
Q86UK0-1#85	0	1	1	Q86UK0-1	2364	2365	+	1	Q86UK0-1	0	2595	ENST00000272895.12	418	8203	++	14	Q86UK0-1#85	0	3	ENST00000272895.12	7510	7513	+	3	0	-2	7739
Q86UK0-1#86	0	1	1	Q86UK0-1	650	651	+	1	Q86UK0-1	328	2595	ENST00000389661.4	189	6990	++	57	Q86UK0-1#86	0	3	ENST00000389661.4	1155	1158	+	3	0	-2	7740
Q86UK0-1#86	0	1	1	Q86UK0-1	650	651	+	1	Q86UK0-1	0	2595	ENST00000272895.12	418	8203	++	14	Q86UK0-1#86	0	3	ENST00000272895.12	2368	2371	+	3	0	-2	7741
Q86UK0-1#87	0	1	1	Q86UK0-1	810	811	+	1	Q86UK0-1	328	2595	ENST00000389661.4	189	6990	++	57	Q86UK0-1#87	0	3	ENST00000389661.4	1635	1638	+	3	0	-2	7742
Q86UK0-1#87	0	1	1	Q86UK0-1	810	811	+	1	Q86UK0-1	0	2595	ENST00000272895.12	418	8203	++	14	Q86UK0-1#87	0	3	ENST00000272895.12	2848	2851	+	3	0	-2	7743
Q86UK0-1#88	0	1	1	Q86UK0-1	825	826	+	1	Q86UK0-1	328	2595	ENST00000389661.4	189	6990	++	57	Q86UK0-1#88	0	3	ENST00000389661.4	1680	1683	+	3	0	-2	7744
Q86UK0-1#88	0	1	1	Q86UK0-1	825	826	+	1	Q86UK0-1	0	2595	ENST00000272895.12	418	8203	++	14	Q86UK0-1#88	0	3	ENST00000272895.12	2893	2896	+	3	0	-2	7745
Q86UK0-1#89	0	1	1	Q86UK0-1	2078	2079	+	1	Q86UK0-1	328	2595	ENST00000389661.4	189	6990	++	57	Q86UK0-1#89	0	3	ENST00000389661.4	5439	5442	+	3	0	-2	7746
Q86UK0-1#89	0	1	1	Q86UK0-1	2078	2079	+	1	Q86UK0-1	0	2595	ENST00000272895.12	418	8203	++	14	Q86UK0-1#89	0	3	ENST00000272895.12	6652	6655	+	3	0	-2	7747
Q86UQ4-1#0	0	5058	5058	Q86UQ4-1	0	5058	+	5058	Q86UQ4-1	2694	5058	ENST00000544596.5	1	7096	++	157	Q86UQ4-1#0	8082	15174	ENST00000544596.5	1	7096	+	7092	8082	-10116	7748
Q86UQ4-1#0	0	5058	5058	Q86UQ4-1	0	5058	+	5058	Q86UQ4-1	3735	4914	ENST00000453246.5	1	3538	++	101	Q86UQ4-1#0	11205	14742	ENST00000453246.5	1	3538	+	3537	11205	-9684	7749
Q86UQ4-1#0	0	5058	5058	Q86UQ4-1	0	5058	+	5058	Q86UQ4-1	0	5058	ENST00000435803.6	26	15200	++	87	Q86UQ4-1#0	0	15174	ENST00000435803.6	26	15200	+	15174	0	-10116	7750
Q86UQ4-1#0	0	5058	5058	Q86UQ4-1	0	5058	+	5058	Q86UQ4-1	0	300	ENST00000417403.5	26	926	++	78	Q86UQ4-1#0	0	900	ENST00000417403.5	26	926	+	900	0	4158	7751
Q86UQ4-1#0	0	5058	5058	Q86UQ4-1	0	5058	+	5058	Q86UQ4-1	4449	4634	ENST00000435451.1	1	463	++	84	Q86UQ4-1#0	13347	13902	ENST00000435451.1	1	463	+	462	13347	-8844	7752
Q86UQ4-1#0	0	5058	5058	Q86UQ4-1	0	5058	+	5058	Q86UQ4-1	4197	5058	ENST00000411975.5	0	2493	++	72	Q86UQ4-1#0	12591	15174	ENST00000411975.5	0	2493	+	2493	12591	-10116	7753
Q86UQ4-1#1	0	21	21	Q86UQ4-1	22	43	+	21	Q86UQ4-1	0	5058	ENST00000435803.6	26	15200	++	87	Q86UQ4-1#1	0	63	ENST00000435803.6	92	155	+	63	0	-42	7754
Q86UQ4-1#1	0	21	21	Q86UQ4-1	22	43	+	21	Q86UQ4-1	0	300	ENST00000417403.5	26	926	++	78	Q86UQ4-1#1	0	63	ENST00000417403.5	92	155	+	63	0	-42	7755
Q86UQ4-1#2	0	21	21	Q86UQ4-1	3567	3588	+	21	Q86UQ4-1	2694	5058	ENST00000544596.5	1	7096	++	157	Q86UQ4-1#2	0	63	ENST00000544596.5	2620	2683	+	63	0	-42	7756
Q86UQ4-1#2	0	21	21	Q86UQ4-1	3567	3588	+	21	Q86UQ4-1	0	5058	ENST00000435803.6	26	15200	++	87	Q86UQ4-1#2	0	63	ENST00000435803.6	10727	10790	+	63	0	-42	7757
Q86UQ4-1#3	0	21	21	Q86UQ4-1	3606	3627	+	21	Q86UQ4-1	2694	5058	ENST00000544596.5	1	7096	++	157	Q86UQ4-1#3	0	63	ENST00000544596.5	2737	2800	+	63	0	-42	7758
Q86UQ4-1#3	0	21	21	Q86UQ4-1	3606	3627	+	21	Q86UQ4-1	0	5058	ENST00000435803.6	26	15200	++	87	Q86UQ4-1#3	0	63	ENST00000435803.6	10844	10907	+	63	0	-42	7759
Q86UQ4-1#4	0	21	21	Q86UQ4-1	3647	3668	+	21	Q86UQ4-1	2694	5058	ENST00000544596.5	1	7096	++	157	Q86UQ4-1#4	0	63	ENST00000544596.5	2860	2923	+	63	0	-42	7760
Q86UQ4-1#4	0	21	21	Q86UQ4-1	3647	3668	+	21	Q86UQ4-1	0	5058	ENST00000435803.6	26	15200	++	87	Q86UQ4-1#4	0	63	ENST00000435803.6	10967	11030	+	63	0	-42	7761
Q86UQ4-1#5	0	21	21	Q86UQ4-1	3678	3699	+	21	Q86UQ4-1	2694	5058	ENST00000544596.5	1	7096	++	157	Q86UQ4-1#5	0	63	ENST00000544596.5	2953	3016	+	63	0	-42	7762
Q86UQ4-1#5	0	21	21	Q86UQ4-1	3678	3699	+	21	Q86UQ4-1	0	5058	ENST00000435803.6	26	15200	++	87	Q86UQ4-1#5	0	63	ENST00000435803.6	11060	11123	+	63	0	-42	7763
Q86UQ4-1#6	0	21	21	Q86UQ4-1	3708	3729	+	21	Q86UQ4-1	2694	5058	ENST00000544596.5	1	7096	++	157	Q86UQ4-1#6	0	63	ENST00000544596.5	3043	3106	+	63	0	-42	7764
Q86UQ4-1#6	0	21	21	Q86UQ4-1	3708	3729	+	21	Q86UQ4-1	0	5058	ENST00000435803.6	26	15200	++	87	Q86UQ4-1#6	0	63	ENST00000435803.6	11150	11213	+	63	0	-42	7765
Q86UQ4-1#7	0	21	21	Q86UQ4-1	3751	3772	+	21	Q86UQ4-1	2694	5058	ENST00000544596.5	1	7096	++	157	Q86UQ4-1#7	0	63	ENST00000544596.5	3172	3235	+	63	0	-42	7766
Q86UQ4-1#7	0	21	21	Q86UQ4-1	3751	3772	+	21	Q86UQ4-1	3735	4914	ENST00000453246.5	1	3538	++	101	Q86UQ4-1#7	0	63	ENST00000453246.5	49	112	+	63	0	-42	7767
Q86UQ4-1#7	0	21	21	Q86UQ4-1	3751	3772	+	21	Q86UQ4-1	0	5058	ENST00000435803.6	26	15200	++	87	Q86UQ4-1#7	0	63	ENST00000435803.6	11279	11342	+	63	0	-42	7768
Q86UQ4-1#8	0	21	21	Q86UQ4-1	4225	4246	+	21	Q86UQ4-1	2694	5058	ENST00000544596.5	1	7096	++	157	Q86UQ4-1#8	0	63	ENST00000544596.5	4594	4657	+	63	0	-42	7769
Q86UQ4-1#8	0	21	21	Q86UQ4-1	4225	4246	+	21	Q86UQ4-1	3735	4914	ENST00000453246.5	1	3538	++	101	Q86UQ4-1#8	0	63	ENST00000453246.5	1471	1534	+	63	0	-42	7770
Q86UQ4-1#8	0	21	21	Q86UQ4-1	4225	4246	+	21	Q86UQ4-1	0	5058	ENST00000435803.6	26	15200	++	87	Q86UQ4-1#8	0	63	ENST00000435803.6	12701	12764	+	63	0	-42	7771
Q86UQ4-1#8	0	21	21	Q86UQ4-1	4225	4246	+	21	Q86UQ4-1	4197	5058	ENST00000411975.5	0	2493	++	72	Q86UQ4-1#8	0	63	ENST00000411975.5	84	147	+	63	0	-42	7772
Q86UQ4-1#9	0	21	21	Q86UQ4-1	4457	4478	+	21	Q86UQ4-1	2694	5058	ENST00000544596.5	1	7096	++	157	Q86UQ4-1#9	0	63	ENST00000544596.5	5293	5356	+	63	0	-42	7773
Q86UQ4-1#9	0	21	21	Q86UQ4-1	4457	4478	+	21	Q86UQ4-1	3735	4914	ENST00000453246.5	1	3538	++	101	Q86UQ4-1#9	0	63	ENST00000453246.5	2167	2230	+	63	0	-42	7774
Q86UQ4-1#9	0	21	21	Q86UQ4-1	4457	4478	+	21	Q86UQ4-1	0	5058	ENST00000435803.6	26	15200	++	87	Q86UQ4-1#9	0	63	ENST00000435803.6	13397	13460	+	63	0	-42	7775
Q86UQ4-1#9	0	21	21	Q86UQ4-1	4457	4478	+	21	Q86UQ4-1	4449	4634	ENST00000435451.1	1	463	++	84	Q86UQ4-1#9	0	60	ENST00000435451.1	25	85	+	60	0	-39	7776
Q86UQ4-1#9	0	21	21	Q86UQ4-1	4457	4478	+	21	Q86UQ4-1	4197	5058	ENST00000411975.5	0	2493	++	72	Q86UQ4-1#9	0	63	ENST00000411975.5	690	753	+	63	0	-42	7777
Q86UQ4-1#10	0	21	21	Q86UQ4-1	4503	4524	+	21	Q86UQ4-1	2694	5058	ENST00000544596.5	1	7096	++	157	Q86UQ4-1#10	0	63	ENST00000544596.5	5431	5494	+	63	0	-42	7778
Q86UQ4-1#10	0	21	21	Q86UQ4-1	4503	4524	+	21	Q86UQ4-1	3735	4914	ENST00000453246.5	1	3538	++	101	Q86UQ4-1#10	0	63	ENST00000453246.5	2305	2368	+	63	0	-42	7779
Q86UQ4-1#10	0	21	21	Q86UQ4-1	4503	4524	+	21	Q86UQ4-1	0	5058	ENST00000435803.6	26	15200	++	87	Q86UQ4-1#10	0	63	ENST00000435803.6	13535	13598	+	63	0	-42	7780
Q86UQ4-1#10	0	21	21	Q86UQ4-1	4503	4524	+	21	Q86UQ4-1	4449	4634	ENST00000435451.1	1	463	++	84	Q86UQ4-1#10	15	63	ENST00000435451.1	85	133	+	48	15	-42	7781
Q86UQ4-1#10	0	21	21	Q86UQ4-1	4503	4524	+	21	Q86UQ4-1	4197	5058	ENST00000411975.5	0	2493	++	72	Q86UQ4-1#10	0	63	ENST00000411975.5	828	891	+	63	0	-42	7782
Q86UQ4-1#11	0	21	21	Q86UQ4-1	4535	4556	+	21	Q86UQ4-1	2694	5058	ENST00000544596.5	1	7096	++	157	Q86UQ4-1#11	0	63	ENST00000544596.5	5527	5590	+	63	0	-42	7783
Q86UQ4-1#11	0	21	21	Q86UQ4-1	4535	4556	+	21	Q86UQ4-1	3735	4914	ENST00000453246.5	1	3538	++	101	Q86UQ4-1#11	0	63	ENST00000453246.5	2401	2464	+	63	0	-42	7784
Q86UQ4-1#11	0	21	21	Q86UQ4-1	4535	4556	+	21	Q86UQ4-1	0	5058	ENST00000435803.6	26	15200	++	87	Q86UQ4-1#11	0	63	ENST00000435803.6	13631	13694	+	63	0	-42	7785
Q86UQ4-1#11	0	21	21	Q86UQ4-1	4535	4556	+	21	Q86UQ4-1	4449	4634	ENST00000435451.1	1	463	++	84	Q86UQ4-1#11	0	63	ENST00000435451.1	166	229	+	63	0	-42	7786
Q86UQ4-1#11	0	21	21	Q86UQ4-1	4535	4556	+	21	Q86UQ4-1	4197	5058	ENST00000411975.5	0	2493	++	72	Q86UQ4-1#11	0	63	ENST00000411975.5	924	987	+	63	0	-42	7787
Q86UQ4-1#12	0	21	21	Q86UQ4-1	4567	4588	+	21	Q86UQ4-1	2694	5058	ENST00000544596.5	1	7096	++	157	Q86UQ4-1#12	0	63	ENST00000544596.5	5623	5686	+	63	0	-42	7788
Q86UQ4-1#12	0	21	21	Q86UQ4-1	4567	4588	+	21	Q86UQ4-1	3735	4914	ENST00000453246.5	1	3538	++	101	Q86UQ4-1#12	0	63	ENST00000453246.5	2497	2560	+	63	0	-42	7789
Q86UQ4-1#12	0	21	21	Q86UQ4-1	4567	4588	+	21	Q86UQ4-1	0	5058	ENST00000435803.6	26	15200	++	87	Q86UQ4-1#12	0	63	ENST00000435803.6	13727	13790	+	63	0	-42	7790
Q86UQ4-1#12	0	21	21	Q86UQ4-1	4567	4588	+	21	Q86UQ4-1	4449	4634	ENST00000435451.1	1	463	++	84	Q86UQ4-1#12	0	63	ENST00000435451.1	262	325	+	63	0	-42	7791
Q86UQ4-1#12	0	21	21	Q86UQ4-1	4567	4588	+	21	Q86UQ4-1	4197	5058	ENST00000411975.5	0	2493	++	72	Q86UQ4-1#12	0	63	ENST00000411975.5	1020	1083	+	63	0	-42	7792
Q86UQ4-1#13	0	21	21	Q86UQ4-1	4606	4627	+	21	Q86UQ4-1	2694	5058	ENST00000544596.5	1	7096	++	157	Q86UQ4-1#13	0	63	ENST00000544596.5	5740	5803	+	63	0	-42	7793
Q86UQ4-1#13	0	21	21	Q86UQ4-1	4606	4627	+	21	Q86UQ4-1	3735	4914	ENST00000453246.5	1	3538	++	101	Q86UQ4-1#13	0	63	ENST00000453246.5	2614	2677	+	63	0	-42	7794
Q86UQ4-1#13	0	21	21	Q86UQ4-1	4606	4627	+	21	Q86UQ4-1	0	5058	ENST00000435803.6	26	15200	++	87	Q86UQ4-1#13	0	63	ENST00000435803.6	13844	13907	+	63	0	-42	7795
Q86UQ4-1#13	0	21	21	Q86UQ4-1	4606	4627	+	21	Q86UQ4-1	4449	4634	ENST00000435451.1	1	463	++	84	Q86UQ4-1#13	0	63	ENST00000435451.1	379	442	+	63	0	-42	7796
Q86UQ4-1#13	0	21	21	Q86UQ4-1	4606	4627	+	21	Q86UQ4-1	4197	5058	ENST00000411975.5	0	2493	++	72	Q86UQ4-1#13	0	63	ENST00000411975.5	1137	1200	+	63	0	-42	7797
Q86UQ4-1#14	0	21	21	Q86UQ4-1	4650	4671	+	21	Q86UQ4-1	2694	5058	ENST00000544596.5	1	7096	++	157	Q86UQ4-1#14	0	63	ENST00000544596.5	5872	5935	+	63	0	-42	7798
Q86UQ4-1#14	0	21	21	Q86UQ4-1	4650	4671	+	21	Q86UQ4-1	3735	4914	ENST00000453246.5	1	3538	++	101	Q86UQ4-1#14	0	63	ENST00000453246.5	2746	2809	+	63	0	-42	7799
Q86UQ4-1#14	0	21	21	Q86UQ4-1	4650	4671	+	21	Q86UQ4-1	0	5058	ENST00000435803.6	26	15200	++	87	Q86UQ4-1#14	0	63	ENST00000435803.6	13976	14039	+	63	0	-42	7800
Q86UQ4-1#14	0	21	21	Q86UQ4-1	4650	4671	+	21	Q86UQ4-1	4197	5058	ENST00000411975.5	0	2493	++	72	Q86UQ4-1#14	0	63	ENST00000411975.5	1269	1332	+	63	0	-42	7801
Q86UQ4-1#15	0	233	233	Q86UQ4-1	3841	4074	+	233	Q86UQ4-1	2694	5058	ENST00000544596.5	1	7096	++	157	Q86UQ4-1#15	0	699	ENST00000544596.5	3442	4141	+	699	0	-466	7802
Q86UQ4-1#15	0	233	233	Q86UQ4-1	3841	4074	+	233	Q86UQ4-1	3735	4914	ENST00000453246.5	1	3538	++	101	Q86UQ4-1#15	0	699	ENST00000453246.5	319	1018	+	699	0	-466	7803
Q86UQ4-1#15	0	233	233	Q86UQ4-1	3841	4074	+	233	Q86UQ4-1	0	5058	ENST00000435803.6	26	15200	++	87	Q86UQ4-1#15	0	699	ENST00000435803.6	11549	12248	+	699	0	-466	7804
Q86UQ4-1#16	0	239	239	Q86UQ4-1	4717	4956	+	239	Q86UQ4-1	2694	5058	ENST00000544596.5	1	7096	++	157	Q86UQ4-1#16	0	717	ENST00000544596.5	6073	6790	+	717	0	-478	7805
Q86UQ4-1#16	0	239	239	Q86UQ4-1	4717	4956	+	239	Q86UQ4-1	3735	4914	ENST00000453246.5	1	3538	++	101	Q86UQ4-1#16	0	591	ENST00000453246.5	2947	3538	+	591	0	-352	7806
Q86UQ4-1#16	0	239	239	Q86UQ4-1	4717	4956	+	239	Q86UQ4-1	0	5058	ENST00000435803.6	26	15200	++	87	Q86UQ4-1#16	0	717	ENST00000435803.6	14177	14894	+	717	0	-478	7807
Q86UQ4-1#16	0	239	239	Q86UQ4-1	4717	4956	+	239	Q86UQ4-1	4197	5058	ENST00000411975.5	0	2493	++	72	Q86UQ4-1#16	0	717	ENST00000411975.5	1470	2187	+	717	0	-478	7808
Q86UQ4-1#17	0	8	8	Q86UQ4-1	3874	3882	+	8	Q86UQ4-1	2694	5058	ENST00000544596.5	1	7096	++	157	Q86UQ4-1#17	0	24	ENST00000544596.5	3541	3565	+	24	0	-16	7809
Q86UQ4-1#17	0	8	8	Q86UQ4-1	3874	3882	+	8	Q86UQ4-1	3735	4914	ENST00000453246.5	1	3538	++	101	Q86UQ4-1#17	0	24	ENST00000453246.5	418	442	+	24	0	-16	7810
Q86UQ4-1#17	0	8	8	Q86UQ4-1	3874	3882	+	8	Q86UQ4-1	0	5058	ENST00000435803.6	26	15200	++	87	Q86UQ4-1#17	0	24	ENST00000435803.6	11648	11672	+	24	0	-16	7811
Q86UQ4-1#18	0	8	8	Q86UQ4-1	4753	4761	+	8	Q86UQ4-1	2694	5058	ENST00000544596.5	1	7096	++	157	Q86UQ4-1#18	0	24	ENST00000544596.5	6181	6205	+	24	0	-16	7812
Q86UQ4-1#18	0	8	8	Q86UQ4-1	4753	4761	+	8	Q86UQ4-1	3735	4914	ENST00000453246.5	1	3538	++	101	Q86UQ4-1#18	0	24	ENST00000453246.5	3055	3079	+	24	0	-16	7813
Q86UQ4-1#18	0	8	8	Q86UQ4-1	4753	4761	+	8	Q86UQ4-1	0	5058	ENST00000435803.6	26	15200	++	87	Q86UQ4-1#18	0	24	ENST00000435803.6	14285	14309	+	24	0	-16	7814
Q86UQ4-1#18	0	8	8	Q86UQ4-1	4753	4761	+	8	Q86UQ4-1	4197	5058	ENST00000411975.5	0	2493	++	72	Q86UQ4-1#18	0	24	ENST00000411975.5	1578	1602	+	24	0	-16	7815
Q86UQ4-1#19	0	2736	2736	Q86UQ4-1	0	2736	+	2736	Q86UQ4-1	2694	5058	ENST00000544596.5	1	7096	++	157	Q86UQ4-1#19	8082	8208	ENST00000544596.5	1	127	+	126	8082	-5472	7816
Q86UQ4-1#19	0	2736	2736	Q86UQ4-1	0	2736	+	2736	Q86UQ4-1	0	5058	ENST00000435803.6	26	15200	++	87	Q86UQ4-1#19	0	8208	ENST00000435803.6	26	8234	+	8208	0	-5472	7817
Q86UQ4-1#19	0	2736	2736	Q86UQ4-1	0	2736	+	2736	Q86UQ4-1	0	300	ENST00000417403.5	26	926	++	78	Q86UQ4-1#19	0	900	ENST00000417403.5	26	926	+	900	0	1836	7818
Q86UQ4-1#20	0	2298	2298	Q86UQ4-1	0	2298	+	2298	Q86UQ4-1	0	5058	ENST00000435803.6	26	15200	++	87	Q86UQ4-1#20	0	6894	ENST00000435803.6	26	6920	+	6894	0	-4596	7819
Q86UQ4-1#20	0	2298	2298	Q86UQ4-1	0	2298	+	2298	Q86UQ4-1	0	300	ENST00000417403.5	26	926	++	78	Q86UQ4-1#20	0	900	ENST00000417403.5	26	926	+	900	0	1398	7820
Q86UQ4-1#21	0	18	18	Q86UQ4-1	299	317	+	18	Q86UQ4-1	0	5058	ENST00000435803.6	26	15200	++	87	Q86UQ4-1#21	0	54	ENST00000435803.6	923	977	+	54	0	-36	7821
Q86UQ4-1#21	0	18	18	Q86UQ4-1	299	317	+	18	Q86UQ4-1	0	300	ENST00000417403.5	26	926	++	78	Q86UQ4-1#21	0	3	ENST00000417403.5	923	926	+	3	0	15	7822
Q86UQ4-1#22	0	4741	4741	Q86UQ4-1	317	5058	+	4741	Q86UQ4-1	2694	5058	ENST00000544596.5	1	7096	++	157	Q86UQ4-1#22	7131	14223	ENST00000544596.5	1	7096	+	7092	7131	-9482	7823
Q86UQ4-1#22	0	4741	4741	Q86UQ4-1	317	5058	+	4741	Q86UQ4-1	3735	4914	ENST00000453246.5	1	3538	++	101	Q86UQ4-1#22	10254	13791	ENST00000453246.5	1	3538	+	3537	10254	-9050	7824
Q86UQ4-1#22	0	4741	4741	Q86UQ4-1	317	5058	+	4741	Q86UQ4-1	0	5058	ENST00000435803.6	26	15200	++	87	Q86UQ4-1#22	0	14223	ENST00000435803.6	977	15200	+	14223	0	-9482	7825
Q86UQ4-1#22	0	4741	4741	Q86UQ4-1	317	5058	+	4741	Q86UQ4-1	4449	4634	ENST00000435451.1	1	463	++	84	Q86UQ4-1#22	12396	12951	ENST00000435451.1	1	463	+	462	12396	-8210	7826
Q86UQ4-1#22	0	4741	4741	Q86UQ4-1	317	5058	+	4741	Q86UQ4-1	4197	5058	ENST00000411975.5	0	2493	++	72	Q86UQ4-1#22	11640	14223	ENST00000411975.5	0	2493	+	2493	11640	-9482	7827
Q86UQ4-1#23	0	1	1	Q86UQ4-1	4270	4271	+	1	Q86UQ4-1	2694	5058	ENST00000544596.5	1	7096	++	157	Q86UQ4-1#23	0	3	ENST00000544596.5	4729	4732	+	3	0	-2	7828
Q86UQ4-1#23	0	1	1	Q86UQ4-1	4270	4271	+	1	Q86UQ4-1	3735	4914	ENST00000453246.5	1	3538	++	101	Q86UQ4-1#23	0	3	ENST00000453246.5	1606	1609	+	3	0	-2	7829
Q86UQ4-1#23	0	1	1	Q86UQ4-1	4270	4271	+	1	Q86UQ4-1	0	5058	ENST00000435803.6	26	15200	++	87	Q86UQ4-1#23	0	3	ENST00000435803.6	12836	12839	+	3	0	-2	7830
Q86UQ4-1#23	0	1	1	Q86UQ4-1	4270	4271	+	1	Q86UQ4-1	4197	5058	ENST00000411975.5	0	2493	++	72	Q86UQ4-1#23	0	3	ENST00000411975.5	219	222	+	3	0	-2	7831
Q86UQ4-1#24	0	31	31	Q86UQ4-1	4477	4508	+	31	Q86UQ4-1	2694	5058	ENST00000544596.5	1	7096	++	157	Q86UQ4-1#24	0	93	ENST00000544596.5	5353	5446	+	93	0	-62	7832
Q86UQ4-1#24	0	31	31	Q86UQ4-1	4477	4508	+	31	Q86UQ4-1	3735	4914	ENST00000453246.5	1	3538	++	101	Q86UQ4-1#24	0	93	ENST00000453246.5	2227	2320	+	93	0	-62	7833
Q86UQ4-1#24	0	31	31	Q86UQ4-1	4477	4508	+	31	Q86UQ4-1	0	5058	ENST00000435803.6	26	15200	++	87	Q86UQ4-1#24	0	93	ENST00000435803.6	13457	13550	+	93	0	-62	7834
Q86UQ4-1#24	0	31	31	Q86UQ4-1	4477	4508	+	31	Q86UQ4-1	4197	5058	ENST00000411975.5	0	2493	++	72	Q86UQ4-1#24	0	93	ENST00000411975.5	750	843	+	93	0	-62	7835
Q86UQ4-1#25	0	112	112	Q86UQ4-1	4946	5058	+	112	Q86UQ4-1	2694	5058	ENST00000544596.5	1	7096	++	157	Q86UQ4-1#25	0	336	ENST00000544596.5	6760	7096	+	336	0	-224	7836
Q86UQ4-1#25	0	112	112	Q86UQ4-1	4946	5058	+	112	Q86UQ4-1	0	5058	ENST00000435803.6	26	15200	++	87	Q86UQ4-1#25	0	336	ENST00000435803.6	14864	15200	+	336	0	-224	7837
Q86UQ4-1#25	0	112	112	Q86UQ4-1	4946	5058	+	112	Q86UQ4-1	4197	5058	ENST00000411975.5	0	2493	++	72	Q86UQ4-1#25	0	336	ENST00000411975.5	2157	2493	+	336	0	-224	7838
Q86UQ4-1#26	0	1	1	Q86UQ4-1	505	506	+	1	Q86UQ4-1	0	5058	ENST00000435803.6	26	15200	++	87	Q86UQ4-1#26	0	3	ENST00000435803.6	1541	1544	+	3	0	-2	7839
Q86UQ4-1#27	0	1	1	Q86UQ4-1	554	555	+	1	Q86UQ4-1	0	5058	ENST00000435803.6	26	15200	++	87	Q86UQ4-1#27	0	3	ENST00000435803.6	1688	1691	+	3	0	-2	7840
Q86UQ4-1#28	0	1	1	Q86UQ4-1	766	767	+	1	Q86UQ4-1	0	5058	ENST00000435803.6	26	15200	++	87	Q86UQ4-1#28	0	3	ENST00000435803.6	2324	2327	+	3	0	-2	7841
Q86UQ4-1#29	0	1	1	Q86UQ4-1	798	799	+	1	Q86UQ4-1	0	5058	ENST00000435803.6	26	15200	++	87	Q86UQ4-1#29	0	3	ENST00000435803.6	2420	2423	+	3	0	-2	7842
Q86UQ4-1#30	0	1	1	Q86UQ4-1	1433	1434	+	1	Q86UQ4-1	0	5058	ENST00000435803.6	26	15200	++	87	Q86UQ4-1#30	0	3	ENST00000435803.6	4325	4328	+	3	0	-2	7843
Q86UQ4-1#31	0	1	1	Q86UQ4-1	1507	1508	+	1	Q86UQ4-1	0	5058	ENST00000435803.6	26	15200	++	87	Q86UQ4-1#31	0	3	ENST00000435803.6	4547	4550	+	3	0	-2	7844
Q86UQ4-1#32	0	1	1	Q86UQ4-1	1539	1540	+	1	Q86UQ4-1	0	5058	ENST00000435803.6	26	15200	++	87	Q86UQ4-1#32	0	3	ENST00000435803.6	4643	4646	+	3	0	-2	7845
Q86UQ4-1#33	0	1	1	Q86UQ4-1	1888	1889	+	1	Q86UQ4-1	0	5058	ENST00000435803.6	26	15200	++	87	Q86UQ4-1#33	0	3	ENST00000435803.6	5690	5693	+	3	0	-2	7846
Q86UQ4-1#34	0	1	1	Q86UQ4-1	2032	2033	+	1	Q86UQ4-1	0	5058	ENST00000435803.6	26	15200	++	87	Q86UQ4-1#34	0	3	ENST00000435803.6	6122	6125	+	3	0	-2	7847
Q86UQ4-1#35	0	1	1	Q86UQ4-1	2153	2154	+	1	Q86UQ4-1	0	5058	ENST00000435803.6	26	15200	++	87	Q86UQ4-1#35	0	3	ENST00000435803.6	6485	6488	+	3	0	-2	7848
Q86UQ4-1#36	0	1	1	Q86UQ4-1	2177	2178	+	1	Q86UQ4-1	0	5058	ENST00000435803.6	26	15200	++	87	Q86UQ4-1#36	0	3	ENST00000435803.6	6557	6560	+	3	0	-2	7849
Q86UQ4-1#37	0	1	1	Q86UQ4-1	2211	2212	+	1	Q86UQ4-1	0	5058	ENST00000435803.6	26	15200	++	87	Q86UQ4-1#37	0	3	ENST00000435803.6	6659	6662	+	3	0	-2	7850
Q86UQ4-1#38	0	1	1	Q86UQ4-1	2435	2436	+	1	Q86UQ4-1	0	5058	ENST00000435803.6	26	15200	++	87	Q86UQ4-1#38	0	3	ENST00000435803.6	7331	7334	+	3	0	-2	7851
Q86UQ4-1#39	0	1	1	Q86UQ4-1	2536	2537	+	1	Q86UQ4-1	0	5058	ENST00000435803.6	26	15200	++	87	Q86UQ4-1#39	0	3	ENST00000435803.6	7634	7637	+	3	0	-2	7852
Q86UQ4-1#40	0	1	1	Q86UQ4-1	2673	2674	+	1	Q86UQ4-1	0	5058	ENST00000435803.6	26	15200	++	87	Q86UQ4-1#40	0	3	ENST00000435803.6	8045	8048	+	3	0	-2	7853
Q86UQ4-1#41	0	1	1	Q86UQ4-1	3141	3142	+	1	Q86UQ4-1	2694	5058	ENST00000544596.5	1	7096	++	157	Q86UQ4-1#41	0	3	ENST00000544596.5	1342	1345	+	3	0	-2	7854
Q86UQ4-1#41	0	1	1	Q86UQ4-1	3141	3142	+	1	Q86UQ4-1	0	5058	ENST00000435803.6	26	15200	++	87	Q86UQ4-1#41	0	3	ENST00000435803.6	9449	9452	+	3	0	-2	7855
Q86UQ4-1#42	0	1	1	Q86UQ4-1	3850	3851	+	1	Q86UQ4-1	2694	5058	ENST00000544596.5	1	7096	++	157	Q86UQ4-1#42	0	3	ENST00000544596.5	3469	3472	+	3	0	-2	7856
Q86UQ4-1#42	0	1	1	Q86UQ4-1	3850	3851	+	1	Q86UQ4-1	3735	4914	ENST00000453246.5	1	3538	++	101	Q86UQ4-1#42	0	3	ENST00000453246.5	346	349	+	3	0	-2	7857
Q86UQ4-1#42	0	1	1	Q86UQ4-1	3850	3851	+	1	Q86UQ4-1	0	5058	ENST00000435803.6	26	15200	++	87	Q86UQ4-1#42	0	3	ENST00000435803.6	11576	11579	+	3	0	-2	7858
Q86UQ4-1#43	0	1	1	Q86UQ4-1	4276	4277	+	1	Q86UQ4-1	2694	5058	ENST00000544596.5	1	7096	++	157	Q86UQ4-1#43	0	3	ENST00000544596.5	4750	4753	+	3	0	-2	7859
Q86UQ4-1#43	0	1	1	Q86UQ4-1	4276	4277	+	1	Q86UQ4-1	3735	4914	ENST00000453246.5	1	3538	++	101	Q86UQ4-1#43	0	3	ENST00000453246.5	1624	1627	+	3	0	-2	7860
Q86UQ4-1#43	0	1	1	Q86UQ4-1	4276	4277	+	1	Q86UQ4-1	0	5058	ENST00000435803.6	26	15200	++	87	Q86UQ4-1#43	0	3	ENST00000435803.6	12854	12857	+	3	0	-2	7861
Q86UQ4-1#44	0	1	1	Q86UQ4-1	4301	4302	+	1	Q86UQ4-1	2694	5058	ENST00000544596.5	1	7096	++	157	Q86UQ4-1#44	0	3	ENST00000544596.5	4825	4828	+	3	0	-2	7862
Q86UQ4-1#44	0	1	1	Q86UQ4-1	4301	4302	+	1	Q86UQ4-1	3735	4914	ENST00000453246.5	1	3538	++	101	Q86UQ4-1#44	0	3	ENST00000453246.5	1699	1702	+	3	0	-2	7863
Q86UQ4-1#44	0	1	1	Q86UQ4-1	4301	4302	+	1	Q86UQ4-1	0	5058	ENST00000435803.6	26	15200	++	87	Q86UQ4-1#44	0	3	ENST00000435803.6	12929	12932	+	3	0	-2	7864
Q86UQ4-1#44	0	1	1	Q86UQ4-1	4301	4302	+	1	Q86UQ4-1	4197	5058	ENST00000411975.5	0	2493	++	72	Q86UQ4-1#44	0	3	ENST00000411975.5	222	225	+	3	0	-2	7865
Q86UQ4-1#45	0	1	1	Q86UQ4-1	4334	4335	+	1	Q86UQ4-1	2694	5058	ENST00000544596.5	1	7096	++	157	Q86UQ4-1#45	0	3	ENST00000544596.5	4924	4927	+	3	0	-2	7866
Q86UQ4-1#45	0	1	1	Q86UQ4-1	4334	4335	+	1	Q86UQ4-1	3735	4914	ENST00000453246.5	1	3538	++	101	Q86UQ4-1#45	0	3	ENST00000453246.5	1798	1801	+	3	0	-2	7867
Q86UQ4-1#45	0	1	1	Q86UQ4-1	4334	4335	+	1	Q86UQ4-1	0	5058	ENST00000435803.6	26	15200	++	87	Q86UQ4-1#45	0	3	ENST00000435803.6	13028	13031	+	3	0	-2	7868
Q86UQ4-1#45	0	1	1	Q86UQ4-1	4334	4335	+	1	Q86UQ4-1	4197	5058	ENST00000411975.5	0	2493	++	72	Q86UQ4-1#45	0	3	ENST00000411975.5	321	324	+	3	0	-2	7869
Q86UQ4-1#46	0	1	1	Q86UQ4-1	1415	1416	+	1	Q86UQ4-1	0	5058	ENST00000435803.6	26	15200	++	87	Q86UQ4-1#46	0	3	ENST00000435803.6	4271	4274	+	3	0	-2	7870
Q86UQ4-1#47	0	1	1	Q86UQ4-1	2717	2718	+	1	Q86UQ4-1	2694	5058	ENST00000544596.5	1	7096	++	157	Q86UQ4-1#47	0	3	ENST00000544596.5	70	73	+	3	0	-2	7871
Q86UQ4-1#47	0	1	1	Q86UQ4-1	2717	2718	+	1	Q86UQ4-1	0	5058	ENST00000435803.6	26	15200	++	87	Q86UQ4-1#47	0	3	ENST00000435803.6	8177	8180	+	3	0	-2	7872
Q86UQ4-1#48	0	1	1	Q86UQ4-1	2830	2831	+	1	Q86UQ4-1	2694	5058	ENST00000544596.5	1	7096	++	157	Q86UQ4-1#48	0	3	ENST00000544596.5	409	412	+	3	0	-2	7873
Q86UQ4-1#48	0	1	1	Q86UQ4-1	2830	2831	+	1	Q86UQ4-1	0	5058	ENST00000435803.6	26	15200	++	87	Q86UQ4-1#48	0	3	ENST00000435803.6	8516	8519	+	3	0	-2	7874
Q86UQ4-1#49	0	1	1	Q86UQ4-1	2869	2870	+	1	Q86UQ4-1	2694	5058	ENST00000544596.5	1	7096	++	157	Q86UQ4-1#49	0	3	ENST00000544596.5	526	529	+	3	0	-2	7875
Q86UQ4-1#49	0	1	1	Q86UQ4-1	2869	2870	+	1	Q86UQ4-1	0	5058	ENST00000435803.6	26	15200	++	87	Q86UQ4-1#49	0	3	ENST00000435803.6	8633	8636	+	3	0	-2	7876
Q86UQ4-1#50	0	1	1	Q86UQ4-1	3056	3057	+	1	Q86UQ4-1	2694	5058	ENST00000544596.5	1	7096	++	157	Q86UQ4-1#50	0	3	ENST00000544596.5	1087	1090	+	3	0	-2	7877
Q86UQ4-1#50	0	1	1	Q86UQ4-1	3056	3057	+	1	Q86UQ4-1	0	5058	ENST00000435803.6	26	15200	++	87	Q86UQ4-1#50	0	3	ENST00000435803.6	9194	9197	+	3	0	-2	7878
Q86UQ4-1#51	0	1	1	Q86UQ4-1	4445	4446	+	1	Q86UQ4-1	2694	5058	ENST00000544596.5	1	7096	++	157	Q86UQ4-1#51	0	3	ENST00000544596.5	5257	5260	+	3	0	-2	7879
Q86UQ4-1#51	0	1	1	Q86UQ4-1	4445	4446	+	1	Q86UQ4-1	3735	4914	ENST00000453246.5	1	3538	++	101	Q86UQ4-1#51	0	3	ENST00000453246.5	2131	2134	+	3	0	-2	7880
Q86UQ4-1#51	0	1	1	Q86UQ4-1	4445	4446	+	1	Q86UQ4-1	0	5058	ENST00000435803.6	26	15200	++	87	Q86UQ4-1#51	0	3	ENST00000435803.6	13361	13364	+	3	0	-2	7881
Q86UQ4-1#51	0	1	1	Q86UQ4-1	4445	4446	+	1	Q86UQ4-1	4197	5058	ENST00000411975.5	0	2493	++	72	Q86UQ4-1#51	0	3	ENST00000411975.5	654	657	+	3	0	-2	7882
Q86UQ4-1#52	0	1	1	Q86UQ4-1	4583	4584	+	1	Q86UQ4-1	2694	5058	ENST00000544596.5	1	7096	++	157	Q86UQ4-1#52	0	3	ENST00000544596.5	5671	5674	+	3	0	-2	7883
Q86UQ4-1#52	0	1	1	Q86UQ4-1	4583	4584	+	1	Q86UQ4-1	3735	4914	ENST00000453246.5	1	3538	++	101	Q86UQ4-1#52	0	3	ENST00000453246.5	2545	2548	+	3	0	-2	7884
Q86UQ4-1#52	0	1	1	Q86UQ4-1	4583	4584	+	1	Q86UQ4-1	0	5058	ENST00000435803.6	26	15200	++	87	Q86UQ4-1#52	0	3	ENST00000435803.6	13775	13778	+	3	0	-2	7885
Q86UQ4-1#52	0	1	1	Q86UQ4-1	4583	4584	+	1	Q86UQ4-1	4449	4634	ENST00000435451.1	1	463	++	84	Q86UQ4-1#52	0	3	ENST00000435451.1	310	313	+	3	0	-2	7886
Q86UQ4-1#52	0	1	1	Q86UQ4-1	4583	4584	+	1	Q86UQ4-1	4197	5058	ENST00000411975.5	0	2493	++	72	Q86UQ4-1#52	0	3	ENST00000411975.5	1068	1071	+	3	0	-2	7887
P42771-1#0	0	156	156	P42771-1	0	156	+	156	P42771-1	0	131	ENST00000579122.1	31	424	++	187	P42771-1#0	0	393	ENST00000579122.1	31	424	+	393	0	-237	7888
P42771-1#0	0	156	156	P42771-1	0	156	+	156	P42771-1	51	156	ENST00000578845.2	127	442	++	186	P42771-1#0	153	468	ENST00000578845.2	127	442	+	315	153	-312	7889
P42771-1#0	0	156	156	P42771-1	0	156	+	156	P42771-1	51	156	ENST00000498628.6	484	799	++	126	P42771-1#0	153	468	ENST00000498628.6	484	799	+	315	153	-312	7890
P42771-1#0	0	156	156	P42771-1	0	156	+	156	P42771-1	0	154	ENST00000498124.1	39	501	++	125	P42771-1#0	0	462	ENST00000498124.1	39	501	+	462	0	-306	7891
P42771-1#0	0	156	156	P42771-1	0	156	+	156	P42771-1	51	152	ENST00000497750.1	75	378	++	124	P42771-1#0	153	456	ENST00000497750.1	75	378	+	303	153	-300	7892
P42771-1#0	0	156	156	P42771-1	0	156	+	156	P42771-1	51	156	ENST00000494262.5	624	939	++	121	P42771-1#0	153	468	ENST00000494262.5	624	939	+	315	153	-312	7893
P42771-1#0	0	156	156	P42771-1	0	156	+	156	P42771-1	51	152	ENST00000479692.2	15	318	++	114	P42771-1#0	153	456	ENST00000479692.2	15	318	+	303	153	-300	7894
P42771-1#0	0	156	156	P42771-1	0	156	+	156	P42771-1	0	51	ENST00000380151.3	0	153	++	53	P42771-1#0	0	153	ENST00000380151.3	0	153	+	153	0	3	7895
P42771-1#0	0	156	156	P42771-1	0	156	+	156	P42771-1	0	156	ENST00000304494.10	30	498	++	24	P42771-1#0	0	468	ENST00000304494.10	30	498	+	468	0	-312	7896
P42771-1#1	0	30	30	P42771-1	10	40	+	30	P42771-1	0	131	ENST00000579122.1	31	424	++	187	P42771-1#1	0	90	ENST00000579122.1	61	151	+	90	0	-60	7897
P42771-1#1	0	30	30	P42771-1	10	40	+	30	P42771-1	0	154	ENST00000498124.1	39	501	++	125	P42771-1#1	0	90	ENST00000498124.1	69	159	+	90	0	-60	7898
P42771-1#1	0	30	30	P42771-1	10	40	+	30	P42771-1	0	51	ENST00000380151.3	0	153	++	53	P42771-1#1	0	90	ENST00000380151.3	30	120	+	90	0	-60	7899
P42771-1#1	0	30	30	P42771-1	10	40	+	30	P42771-1	0	156	ENST00000304494.10	30	498	++	24	P42771-1#1	0	90	ENST00000304494.10	60	150	+	90	0	-60	7900
P42771-1#2	0	29	29	P42771-1	43	72	+	29	P42771-1	0	131	ENST00000579122.1	31	424	++	187	P42771-1#2	0	87	ENST00000579122.1	160	247	+	87	0	-58	7901
P42771-1#2	0	29	29	P42771-1	43	72	+	29	P42771-1	51	156	ENST00000578845.2	127	442	++	186	P42771-1#2	24	87	ENST00000578845.2	127	190	+	63	24	-58	7902
P42771-1#2	0	29	29	P42771-1	43	72	+	29	P42771-1	51	156	ENST00000498628.6	484	799	++	126	P42771-1#2	24	87	ENST00000498628.6	484	547	+	63	24	-58	7903
P42771-1#2	0	29	29	P42771-1	43	72	+	29	P42771-1	0	154	ENST00000498124.1	39	501	++	125	P42771-1#2	0	87	ENST00000498124.1	168	255	+	87	0	-58	7904
P42771-1#2	0	29	29	P42771-1	43	72	+	29	P42771-1	51	152	ENST00000497750.1	75	378	++	124	P42771-1#2	24	87	ENST00000497750.1	75	138	+	63	24	-58	7905
P42771-1#2	0	29	29	P42771-1	43	72	+	29	P42771-1	51	156	ENST00000494262.5	624	939	++	121	P42771-1#2	24	87	ENST00000494262.5	624	687	+	63	24	-58	7906
P42771-1#2	0	29	29	P42771-1	43	72	+	29	P42771-1	51	152	ENST00000479692.2	15	318	++	114	P42771-1#2	24	87	ENST00000479692.2	15	78	+	63	24	-58	7907
P42771-1#2	0	29	29	P42771-1	43	72	+	29	P42771-1	0	51	ENST00000380151.3	0	153	++	53	P42771-1#2	0	24	ENST00000380151.3	129	153	+	24	0	5	7908
P42771-1#2	0	29	29	P42771-1	43	72	+	29	P42771-1	0	156	ENST00000304494.10	30	498	++	24	P42771-1#2	0	87	ENST00000304494.10	159	246	+	87	0	-58	7909
P42771-1#3	0	30	30	P42771-1	76	106	+	30	P42771-1	0	131	ENST00000579122.1	31	424	++	187	P42771-1#3	0	90	ENST00000579122.1	259	349	+	90	0	-60	7910
P42771-1#3	0	30	30	P42771-1	76	106	+	30	P42771-1	51	156	ENST00000578845.2	127	442	++	186	P42771-1#3	0	90	ENST00000578845.2	202	292	+	90	0	-60	7911
P42771-1#3	0	30	30	P42771-1	76	106	+	30	P42771-1	51	156	ENST00000498628.6	484	799	++	126	P42771-1#3	0	90	ENST00000498628.6	559	649	+	90	0	-60	7912
P42771-1#3	0	30	30	P42771-1	76	106	+	30	P42771-1	0	154	ENST00000498124.1	39	501	++	125	P42771-1#3	0	90	ENST00000498124.1	267	357	+	90	0	-60	7913
P42771-1#3	0	30	30	P42771-1	76	106	+	30	P42771-1	51	152	ENST00000497750.1	75	378	++	124	P42771-1#3	0	90	ENST00000497750.1	150	240	+	90	0	-60	7914
P42771-1#3	0	30	30	P42771-1	76	106	+	30	P42771-1	51	156	ENST00000494262.5	624	939	++	121	P42771-1#3	0	90	ENST00000494262.5	699	789	+	90	0	-60	7915
P42771-1#3	0	30	30	P42771-1	76	106	+	30	P42771-1	51	152	ENST00000479692.2	15	318	++	114	P42771-1#3	0	90	ENST00000479692.2	90	180	+	90	0	-60	7916
P42771-1#3	0	30	30	P42771-1	76	106	+	30	P42771-1	0	156	ENST00000304494.10	30	498	++	24	P42771-1#3	0	90	ENST00000304494.10	258	348	+	90	0	-60	7917
P42771-1#4	0	30	30	P42771-1	109	139	+	30	P42771-1	0	131	ENST00000579122.1	31	424	++	187	P42771-1#4	0	66	ENST00000579122.1	358	424	+	66	0	-36	7918
P42771-1#4	0	30	30	P42771-1	109	139	+	30	P42771-1	51	156	ENST00000578845.2	127	442	++	186	P42771-1#4	0	90	ENST00000578845.2	301	391	+	90	0	-60	7919
P42771-1#4	0	30	30	P42771-1	109	139	+	30	P42771-1	51	156	ENST00000498628.6	484	799	++	126	P42771-1#4	0	90	ENST00000498628.6	658	748	+	90	0	-60	7920
P42771-1#4	0	30	30	P42771-1	109	139	+	30	P42771-1	0	154	ENST00000498124.1	39	501	++	125	P42771-1#4	0	90	ENST00000498124.1	366	456	+	90	0	-60	7921
P42771-1#4	0	30	30	P42771-1	109	139	+	30	P42771-1	51	152	ENST00000497750.1	75	378	++	124	P42771-1#4	0	90	ENST00000497750.1	249	339	+	90	0	-60	7922
P42771-1#4	0	30	30	P42771-1	109	139	+	30	P42771-1	51	156	ENST00000494262.5	624	939	++	121	P42771-1#4	0	90	ENST00000494262.5	798	888	+	90	0	-60	7923
P42771-1#4	0	30	30	P42771-1	109	139	+	30	P42771-1	51	152	ENST00000479692.2	15	318	++	114	P42771-1#4	0	90	ENST00000479692.2	189	279	+	90	0	-60	7924
P42771-1#4	0	30	30	P42771-1	109	139	+	30	P42771-1	0	156	ENST00000304494.10	30	498	++	24	P42771-1#4	0	90	ENST00000304494.10	357	447	+	90	0	-60	7925
P42771-1#5	0	1	1	P42771-1	0	1	+	1	P42771-1	0	131	ENST00000579122.1	31	424	++	187	P42771-1#5	0	3	ENST00000579122.1	31	34	+	3	0	-2	7926
P42771-1#5	0	1	1	P42771-1	0	1	+	1	P42771-1	0	154	ENST00000498124.1	39	501	++	125	P42771-1#5	0	3	ENST00000498124.1	39	42	+	3	0	-2	7927
P42771-1#5	0	1	1	P42771-1	0	1	+	1	P42771-1	0	51	ENST00000380151.3	0	153	++	53	P42771-1#5	0	3	ENST00000380151.3	0	3	+	3	0	-2	7928
P42771-1#5	0	1	1	P42771-1	0	1	+	1	P42771-1	0	156	ENST00000304494.10	30	498	++	24	P42771-1#5	0	3	ENST00000304494.10	30	33	+	3	0	-2	7929
P42771-1#6	0	1	1	P42771-1	6	7	+	1	P42771-1	0	131	ENST00000579122.1	31	424	++	187	P42771-1#6	0	3	ENST00000579122.1	49	52	+	3	0	-2	7930
P42771-1#6	0	1	1	P42771-1	6	7	+	1	P42771-1	0	154	ENST00000498124.1	39	501	++	125	P42771-1#6	0	3	ENST00000498124.1	57	60	+	3	0	-2	7931
P42771-1#6	0	1	1	P42771-1	6	7	+	1	P42771-1	0	51	ENST00000380151.3	0	153	++	53	P42771-1#6	0	3	ENST00000380151.3	18	21	+	3	0	-2	7932
P42771-1#6	0	1	1	P42771-1	6	7	+	1	P42771-1	0	156	ENST00000304494.10	30	498	++	24	P42771-1#6	0	3	ENST00000304494.10	48	51	+	3	0	-2	7933
P42771-1#7	0	1	1	P42771-1	7	8	+	1	P42771-1	0	131	ENST00000579122.1	31	424	++	187	P42771-1#7	0	3	ENST00000579122.1	52	55	+	3	0	-2	7934
P42771-1#7	0	1	1	P42771-1	7	8	+	1	P42771-1	0	154	ENST00000498124.1	39	501	++	125	P42771-1#7	0	3	ENST00000498124.1	60	63	+	3	0	-2	7935
P42771-1#7	0	1	1	P42771-1	7	8	+	1	P42771-1	0	51	ENST00000380151.3	0	153	++	53	P42771-1#7	0	3	ENST00000380151.3	21	24	+	3	0	-2	7936
P42771-1#7	0	1	1	P42771-1	7	8	+	1	P42771-1	0	156	ENST00000304494.10	30	498	++	24	P42771-1#7	0	3	ENST00000304494.10	51	54	+	3	0	-2	7937
P42771-1#8	0	1	1	P42771-1	139	140	+	1	P42771-1	51	156	ENST00000578845.2	127	442	++	186	P42771-1#8	0	3	ENST00000578845.2	391	394	+	3	0	-2	7938
P42771-1#8	0	1	1	P42771-1	139	140	+	1	P42771-1	51	156	ENST00000498628.6	484	799	++	126	P42771-1#8	0	3	ENST00000498628.6	748	751	+	3	0	-2	7939
P42771-1#8	0	1	1	P42771-1	139	140	+	1	P42771-1	0	154	ENST00000498124.1	39	501	++	125	P42771-1#8	0	3	ENST00000498124.1	456	459	+	3	0	-2	7940
P42771-1#8	0	1	1	P42771-1	139	140	+	1	P42771-1	51	152	ENST00000497750.1	75	378	++	124	P42771-1#8	0	3	ENST00000497750.1	339	342	+	3	0	-2	7941
P42771-1#8	0	1	1	P42771-1	139	140	+	1	P42771-1	51	156	ENST00000494262.5	624	939	++	121	P42771-1#8	0	3	ENST00000494262.5	888	891	+	3	0	-2	7942
P42771-1#8	0	1	1	P42771-1	139	140	+	1	P42771-1	51	152	ENST00000479692.2	15	318	++	114	P42771-1#8	0	3	ENST00000479692.2	279	282	+	3	0	-2	7943
P42771-1#8	0	1	1	P42771-1	139	140	+	1	P42771-1	0	156	ENST00000304494.10	30	498	++	24	P42771-1#8	0	3	ENST00000304494.10	447	450	+	3	0	-2	7944
P42771-1#9	0	1	1	P42771-1	151	152	+	1	P42771-1	51	156	ENST00000578845.2	127	442	++	186	P42771-1#9	0	3	ENST00000578845.2	427	430	+	3	0	-2	7945
P42771-1#9	0	1	1	P42771-1	151	152	+	1	P42771-1	51	156	ENST00000498628.6	484	799	++	126	P42771-1#9	0	3	ENST00000498628.6	784	787	+	3	0	-2	7946
P42771-1#9	0	1	1	P42771-1	151	152	+	1	P42771-1	0	154	ENST00000498124.1	39	501	++	125	P42771-1#9	0	3	ENST00000498124.1	492	495	+	3	0	-2	7947
P42771-1#9	0	1	1	P42771-1	151	152	+	1	P42771-1	51	152	ENST00000497750.1	75	378	++	124	P42771-1#9	0	3	ENST00000497750.1	375	378	+	3	0	-2	7948
P42771-1#9	0	1	1	P42771-1	151	152	+	1	P42771-1	51	156	ENST00000494262.5	624	939	++	121	P42771-1#9	0	3	ENST00000494262.5	924	927	+	3	0	-2	7949
P42771-1#9	0	1	1	P42771-1	151	152	+	1	P42771-1	51	152	ENST00000479692.2	15	318	++	114	P42771-1#9	0	3	ENST00000479692.2	315	318	+	3	0	-2	7950
P42771-1#9	0	1	1	P42771-1	151	152	+	1	P42771-1	0	156	ENST00000304494.10	30	498	++	24	P42771-1#9	0	3	ENST00000304494.10	483	486	+	3	0	-2	7951
P42771-1#10	0	51	51	P42771-1	0	51	+	51	P42771-1	0	131	ENST00000579122.1	31	424	++	187	P42771-1#10	0	153	ENST00000579122.1	31	184	+	153	0	-102	7952
P42771-1#10	0	51	51	P42771-1	0	51	+	51	P42771-1	0	154	ENST00000498124.1	39	501	++	125	P42771-1#10	0	153	ENST00000498124.1	39	192	+	153	0	-102	7953
P42771-1#10	0	51	51	P42771-1	0	51	+	51	P42771-1	0	51	ENST00000380151.3	0	153	++	53	P42771-1#10	0	153	ENST00000380151.3	0	153	+	153	0	-102	7954
P42771-1#10	0	51	51	P42771-1	0	51	+	51	P42771-1	0	156	ENST00000304494.10	30	498	++	24	P42771-1#10	0	153	ENST00000304494.10	30	183	+	153	0	-102	7955
P42771-1#11	0	65	65	P42771-1	51	116	+	65	P42771-1	0	131	ENST00000579122.1	31	424	++	187	P42771-1#11	0	195	ENST00000579122.1	184	379	+	195	0	-130	7956
P42771-1#11	0	65	65	P42771-1	51	116	+	65	P42771-1	51	156	ENST00000578845.2	127	442	++	186	P42771-1#11	0	195	ENST00000578845.2	127	322	+	195	0	-130	7957
P42771-1#11	0	65	65	P42771-1	51	116	+	65	P42771-1	51	156	ENST00000498628.6	484	799	++	126	P42771-1#11	0	195	ENST00000498628.6	484	679	+	195	0	-130	7958
P42771-1#11	0	65	65	P42771-1	51	116	+	65	P42771-1	0	154	ENST00000498124.1	39	501	++	125	P42771-1#11	0	195	ENST00000498124.1	192	387	+	195	0	-130	7959
P42771-1#11	0	65	65	P42771-1	51	116	+	65	P42771-1	51	152	ENST00000497750.1	75	378	++	124	P42771-1#11	0	195	ENST00000497750.1	75	270	+	195	0	-130	7960
P42771-1#11	0	65	65	P42771-1	51	116	+	65	P42771-1	51	156	ENST00000494262.5	624	939	++	121	P42771-1#11	0	195	ENST00000494262.5	624	819	+	195	0	-130	7961
P42771-1#11	0	65	65	P42771-1	51	116	+	65	P42771-1	51	152	ENST00000479692.2	15	318	++	114	P42771-1#11	0	195	ENST00000479692.2	15	210	+	195	0	-130	7962
P42771-1#11	0	65	65	P42771-1	51	116	+	65	P42771-1	0	156	ENST00000304494.10	30	498	++	24	P42771-1#11	0	195	ENST00000304494.10	183	378	+	195	0	-130	7963
P42771-1#12	0	40	40	P42771-1	116	156	+	40	P42771-1	0	131	ENST00000579122.1	31	424	++	187	P42771-1#12	0	45	ENST00000579122.1	379	424	+	45	0	-5	7964
P42771-1#12	0	40	40	P42771-1	116	156	+	40	P42771-1	51	156	ENST00000578845.2	127	442	++	186	P42771-1#12	0	120	ENST00000578845.2	322	442	+	120	0	-80	7965
P42771-1#12	0	40	40	P42771-1	116	156	+	40	P42771-1	51	156	ENST00000498628.6	484	799	++	126	P42771-1#12	0	120	ENST00000498628.6	679	799	+	120	0	-80	7966
P42771-1#12	0	40	40	P42771-1	116	156	+	40	P42771-1	0	154	ENST00000498124.1	39	501	++	125	P42771-1#12	0	114	ENST00000498124.1	387	501	+	114	0	-74	7967
P42771-1#12	0	40	40	P42771-1	116	156	+	40	P42771-1	51	152	ENST00000497750.1	75	378	++	124	P42771-1#12	0	108	ENST00000497750.1	270	378	+	108	0	-68	7968
P42771-1#12	0	40	40	P42771-1	116	156	+	40	P42771-1	51	156	ENST00000494262.5	624	939	++	121	P42771-1#12	0	120	ENST00000494262.5	819	939	+	120	0	-80	7969
P42771-1#12	0	40	40	P42771-1	116	156	+	40	P42771-1	51	152	ENST00000479692.2	15	318	++	114	P42771-1#12	0	108	ENST00000479692.2	210	318	+	108	0	-68	7970
P42771-1#12	0	40	40	P42771-1	116	156	+	40	P42771-1	0	156	ENST00000304494.10	30	498	++	24	P42771-1#12	0	120	ENST00000304494.10	378	498	+	120	0	-80	7971
P42771-1#13	0	4	4	P42771-1	152	156	+	4	P42771-1	51	156	ENST00000578845.2	127	442	++	186	P42771-1#13	0	12	ENST00000578845.2	430	442	+	12	0	-8	7972
P42771-1#13	0	4	4	P42771-1	152	156	+	4	P42771-1	51	156	ENST00000498628.6	484	799	++	126	P42771-1#13	0	12	ENST00000498628.6	787	799	+	12	0	-8	7973
P42771-1#13	0	4	4	P42771-1	152	156	+	4	P42771-1	0	154	ENST00000498124.1	39	501	++	125	P42771-1#13	0	6	ENST00000498124.1	495	501	+	6	0	-2	7974
P42771-1#13	0	4	4	P42771-1	152	156	+	4	P42771-1	51	156	ENST00000494262.5	624	939	++	121	P42771-1#13	0	12	ENST00000494262.5	927	939	+	12	0	-8	7975
P42771-1#13	0	4	4	P42771-1	152	156	+	4	P42771-1	0	156	ENST00000304494.10	30	498	++	24	P42771-1#13	0	12	ENST00000304494.10	486	498	+	12	0	-8	7976
P42771-1#14	0	1	1	P42771-1	13	14	+	1	P42771-1	0	131	ENST00000579122.1	31	424	++	187	P42771-1#14	0	3	ENST00000579122.1	70	73	+	3	0	-2	7977
P42771-1#14	0	1	1	P42771-1	13	14	+	1	P42771-1	0	154	ENST00000498124.1	39	501	++	125	P42771-1#14	0	3	ENST00000498124.1	78	81	+	3	0	-2	7978
P42771-1#14	0	1	1	P42771-1	13	14	+	1	P42771-1	0	51	ENST00000380151.3	0	153	++	53	P42771-1#14	0	3	ENST00000380151.3	39	42	+	3	0	-2	7979
P42771-1#14	0	1	1	P42771-1	13	14	+	1	P42771-1	0	156	ENST00000304494.10	30	498	++	24	P42771-1#14	0	3	ENST00000304494.10	69	72	+	3	0	-2	7980
P42771-1#15	0	1	1	P42771-1	15	16	+	1	P42771-1	0	131	ENST00000579122.1	31	424	++	187	P42771-1#15	0	3	ENST00000579122.1	76	79	+	3	0	-2	7981
P42771-1#15	0	1	1	P42771-1	15	16	+	1	P42771-1	0	154	ENST00000498124.1	39	501	++	125	P42771-1#15	0	3	ENST00000498124.1	84	87	+	3	0	-2	7982
P42771-1#15	0	1	1	P42771-1	15	16	+	1	P42771-1	0	51	ENST00000380151.3	0	153	++	53	P42771-1#15	0	3	ENST00000380151.3	45	48	+	3	0	-2	7983
P42771-1#15	0	1	1	P42771-1	15	16	+	1	P42771-1	0	156	ENST00000304494.10	30	498	++	24	P42771-1#15	0	3	ENST00000304494.10	75	78	+	3	0	-2	7984
P42771-1#16	0	1	1	P42771-1	18	19	+	1	P42771-1	0	131	ENST00000579122.1	31	424	++	187	P42771-1#16	0	3	ENST00000579122.1	85	88	+	3	0	-2	7985
P42771-1#16	0	1	1	P42771-1	18	19	+	1	P42771-1	0	154	ENST00000498124.1	39	501	++	125	P42771-1#16	0	3	ENST00000498124.1	93	96	+	3	0	-2	7986
P42771-1#16	0	1	1	P42771-1	18	19	+	1	P42771-1	0	51	ENST00000380151.3	0	153	++	53	P42771-1#16	0	3	ENST00000380151.3	54	57	+	3	0	-2	7987
P42771-1#16	0	1	1	P42771-1	18	19	+	1	P42771-1	0	156	ENST00000304494.10	30	498	++	24	P42771-1#16	0	3	ENST00000304494.10	84	87	+	3	0	-2	7988
P42771-1#17	0	1	1	P42771-1	19	20	+	1	P42771-1	0	131	ENST00000579122.1	31	424	++	187	P42771-1#17	0	3	ENST00000579122.1	88	91	+	3	0	-2	7989
P42771-1#17	0	1	1	P42771-1	19	20	+	1	P42771-1	0	154	ENST00000498124.1	39	501	++	125	P42771-1#17	0	3	ENST00000498124.1	96	99	+	3	0	-2	7990
P42771-1#17	0	1	1	P42771-1	19	20	+	1	P42771-1	0	51	ENST00000380151.3	0	153	++	53	P42771-1#17	0	3	ENST00000380151.3	57	60	+	3	0	-2	7991
P42771-1#17	0	1	1	P42771-1	19	20	+	1	P42771-1	0	156	ENST00000304494.10	30	498	++	24	P42771-1#17	0	3	ENST00000304494.10	87	90	+	3	0	-2	7992
P42771-1#18	0	1	1	P42771-1	19	20	+	1	P42771-1	0	131	ENST00000579122.1	31	424	++	187	P42771-1#18	0	3	ENST00000579122.1	88	91	+	3	0	-2	7993
P42771-1#18	0	1	1	P42771-1	19	20	+	1	P42771-1	0	154	ENST00000498124.1	39	501	++	125	P42771-1#18	0	3	ENST00000498124.1	96	99	+	3	0	-2	7994
P42771-1#18	0	1	1	P42771-1	19	20	+	1	P42771-1	0	51	ENST00000380151.3	0	153	++	53	P42771-1#18	0	3	ENST00000380151.3	57	60	+	3	0	-2	7995
P42771-1#18	0	1	1	P42771-1	19	20	+	1	P42771-1	0	156	ENST00000304494.10	30	498	++	24	P42771-1#18	0	3	ENST00000304494.10	87	90	+	3	0	-2	7996
P42771-1#19	0	1	1	P42771-1	22	23	+	1	P42771-1	0	131	ENST00000579122.1	31	424	++	187	P42771-1#19	0	3	ENST00000579122.1	97	100	+	3	0	-2	7997
P42771-1#19	0	1	1	P42771-1	22	23	+	1	P42771-1	0	154	ENST00000498124.1	39	501	++	125	P42771-1#19	0	3	ENST00000498124.1	105	108	+	3	0	-2	7998
P42771-1#19	0	1	1	P42771-1	22	23	+	1	P42771-1	0	51	ENST00000380151.3	0	153	++	53	P42771-1#19	0	3	ENST00000380151.3	66	69	+	3	0	-2	7999
P42771-1#19	0	1	1	P42771-1	22	23	+	1	P42771-1	0	156	ENST00000304494.10	30	498	++	24	P42771-1#19	0	3	ENST00000304494.10	96	99	+	3	0	-2	8000
P42771-1#20	0	1	1	P42771-1	23	24	+	1	P42771-1	0	131	ENST00000579122.1	31	424	++	187	P42771-1#20	0	3	ENST00000579122.1	100	103	+	3	0	-2	8001
P42771-1#20	0	1	1	P42771-1	23	24	+	1	P42771-1	0	154	ENST00000498124.1	39	501	++	125	P42771-1#20	0	3	ENST00000498124.1	108	111	+	3	0	-2	8002
P42771-1#20	0	1	1	P42771-1	23	24	+	1	P42771-1	0	51	ENST00000380151.3	0	153	++	53	P42771-1#20	0	3	ENST00000380151.3	69	72	+	3	0	-2	8003
P42771-1#20	0	1	1	P42771-1	23	24	+	1	P42771-1	0	156	ENST00000304494.10	30	498	++	24	P42771-1#20	0	3	ENST00000304494.10	99	102	+	3	0	-2	8004
P42771-1#21	0	1	1	P42771-1	23	24	+	1	P42771-1	0	131	ENST00000579122.1	31	424	++	187	P42771-1#21	0	3	ENST00000579122.1	100	103	+	3	0	-2	8005
P42771-1#21	0	1	1	P42771-1	23	24	+	1	P42771-1	0	154	ENST00000498124.1	39	501	++	125	P42771-1#21	0	3	ENST00000498124.1	108	111	+	3	0	-2	8006
P42771-1#21	0	1	1	P42771-1	23	24	+	1	P42771-1	0	51	ENST00000380151.3	0	153	++	53	P42771-1#21	0	3	ENST00000380151.3	69	72	+	3	0	-2	8007
P42771-1#21	0	1	1	P42771-1	23	24	+	1	P42771-1	0	156	ENST00000304494.10	30	498	++	24	P42771-1#21	0	3	ENST00000304494.10	99	102	+	3	0	-2	8008
P42771-1#22	0	1	1	P42771-1	23	24	+	1	P42771-1	0	131	ENST00000579122.1	31	424	++	187	P42771-1#22	0	3	ENST00000579122.1	100	103	+	3	0	-2	8009
P42771-1#22	0	1	1	P42771-1	23	24	+	1	P42771-1	0	154	ENST00000498124.1	39	501	++	125	P42771-1#22	0	3	ENST00000498124.1	108	111	+	3	0	-2	8010
P42771-1#22	0	1	1	P42771-1	23	24	+	1	P42771-1	0	51	ENST00000380151.3	0	153	++	53	P42771-1#22	0	3	ENST00000380151.3	69	72	+	3	0	-2	8011
P42771-1#22	0	1	1	P42771-1	23	24	+	1	P42771-1	0	156	ENST00000304494.10	30	498	++	24	P42771-1#22	0	3	ENST00000304494.10	99	102	+	3	0	-2	8012
P42771-1#23	0	1	1	P42771-1	25	26	+	1	P42771-1	0	131	ENST00000579122.1	31	424	++	187	P42771-1#23	0	3	ENST00000579122.1	106	109	+	3	0	-2	8013
P42771-1#23	0	1	1	P42771-1	25	26	+	1	P42771-1	0	154	ENST00000498124.1	39	501	++	125	P42771-1#23	0	3	ENST00000498124.1	114	117	+	3	0	-2	8014
P42771-1#23	0	1	1	P42771-1	25	26	+	1	P42771-1	0	51	ENST00000380151.3	0	153	++	53	P42771-1#23	0	3	ENST00000380151.3	75	78	+	3	0	-2	8015
P42771-1#23	0	1	1	P42771-1	25	26	+	1	P42771-1	0	156	ENST00000304494.10	30	498	++	24	P42771-1#23	0	3	ENST00000304494.10	105	108	+	3	0	-2	8016
P42771-1#24	0	1	1	P42771-1	31	32	+	1	P42771-1	0	131	ENST00000579122.1	31	424	++	187	P42771-1#24	0	3	ENST00000579122.1	124	127	+	3	0	-2	8017
P42771-1#24	0	1	1	P42771-1	31	32	+	1	P42771-1	0	154	ENST00000498124.1	39	501	++	125	P42771-1#24	0	3	ENST00000498124.1	132	135	+	3	0	-2	8018
P42771-1#24	0	1	1	P42771-1	31	32	+	1	P42771-1	0	51	ENST00000380151.3	0	153	++	53	P42771-1#24	0	3	ENST00000380151.3	93	96	+	3	0	-2	8019
P42771-1#24	0	1	1	P42771-1	31	32	+	1	P42771-1	0	156	ENST00000304494.10	30	498	++	24	P42771-1#24	0	3	ENST00000304494.10	123	126	+	3	0	-2	8020
P42771-1#25	0	1	1	P42771-1	32	33	+	1	P42771-1	0	131	ENST00000579122.1	31	424	++	187	P42771-1#25	0	3	ENST00000579122.1	127	130	+	3	0	-2	8021
P42771-1#25	0	1	1	P42771-1	32	33	+	1	P42771-1	0	154	ENST00000498124.1	39	501	++	125	P42771-1#25	0	3	ENST00000498124.1	135	138	+	3	0	-2	8022
P42771-1#25	0	1	1	P42771-1	32	33	+	1	P42771-1	0	51	ENST00000380151.3	0	153	++	53	P42771-1#25	0	3	ENST00000380151.3	96	99	+	3	0	-2	8023
P42771-1#25	0	1	1	P42771-1	32	33	+	1	P42771-1	0	156	ENST00000304494.10	30	498	++	24	P42771-1#25	0	3	ENST00000304494.10	126	129	+	3	0	-2	8024
P42771-1#26	0	1	1	P42771-1	34	35	+	1	P42771-1	0	131	ENST00000579122.1	31	424	++	187	P42771-1#26	0	3	ENST00000579122.1	133	136	+	3	0	-2	8025
P42771-1#26	0	1	1	P42771-1	34	35	+	1	P42771-1	0	154	ENST00000498124.1	39	501	++	125	P42771-1#26	0	3	ENST00000498124.1	141	144	+	3	0	-2	8026
P42771-1#26	0	1	1	P42771-1	34	35	+	1	P42771-1	0	51	ENST00000380151.3	0	153	++	53	P42771-1#26	0	3	ENST00000380151.3	102	105	+	3	0	-2	8027
P42771-1#26	0	1	1	P42771-1	34	35	+	1	P42771-1	0	156	ENST00000304494.10	30	498	++	24	P42771-1#26	0	3	ENST00000304494.10	132	135	+	3	0	-2	8028
P42771-1#27	0	1	1	P42771-1	34	35	+	1	P42771-1	0	131	ENST00000579122.1	31	424	++	187	P42771-1#27	0	3	ENST00000579122.1	133	136	+	3	0	-2	8029
P42771-1#27	0	1	1	P42771-1	34	35	+	1	P42771-1	0	154	ENST00000498124.1	39	501	++	125	P42771-1#27	0	3	ENST00000498124.1	141	144	+	3	0	-2	8030
P42771-1#27	0	1	1	P42771-1	34	35	+	1	P42771-1	0	51	ENST00000380151.3	0	153	++	53	P42771-1#27	0	3	ENST00000380151.3	102	105	+	3	0	-2	8031
P42771-1#27	0	1	1	P42771-1	34	35	+	1	P42771-1	0	156	ENST00000304494.10	30	498	++	24	P42771-1#27	0	3	ENST00000304494.10	132	135	+	3	0	-2	8032
P42771-1#28	0	1	1	P42771-1	34	35	+	1	P42771-1	0	131	ENST00000579122.1	31	424	++	187	P42771-1#28	0	3	ENST00000579122.1	133	136	+	3	0	-2	8033
P42771-1#28	0	1	1	P42771-1	34	35	+	1	P42771-1	0	154	ENST00000498124.1	39	501	++	125	P42771-1#28	0	3	ENST00000498124.1	141	144	+	3	0	-2	8034
P42771-1#28	0	1	1	P42771-1	34	35	+	1	P42771-1	0	51	ENST00000380151.3	0	153	++	53	P42771-1#28	0	3	ENST00000380151.3	102	105	+	3	0	-2	8035
P42771-1#28	0	1	1	P42771-1	34	35	+	1	P42771-1	0	156	ENST00000304494.10	30	498	++	24	P42771-1#28	0	3	ENST00000304494.10	132	135	+	3	0	-2	8036
P42771-1#29	0	1	1	P42771-1	47	48	+	1	P42771-1	0	131	ENST00000579122.1	31	424	++	187	P42771-1#29	0	3	ENST00000579122.1	172	175	+	3	0	-2	8037
P42771-1#29	0	1	1	P42771-1	47	48	+	1	P42771-1	0	154	ENST00000498124.1	39	501	++	125	P42771-1#29	0	3	ENST00000498124.1	180	183	+	3	0	-2	8038
P42771-1#29	0	1	1	P42771-1	47	48	+	1	P42771-1	0	51	ENST00000380151.3	0	153	++	53	P42771-1#29	0	3	ENST00000380151.3	141	144	+	3	0	-2	8039
P42771-1#29	0	1	1	P42771-1	47	48	+	1	P42771-1	0	156	ENST00000304494.10	30	498	++	24	P42771-1#29	0	3	ENST00000304494.10	171	174	+	3	0	-2	8040
P42771-1#30	0	1	1	P42771-1	48	49	+	1	P42771-1	0	131	ENST00000579122.1	31	424	++	187	P42771-1#30	0	3	ENST00000579122.1	175	178	+	3	0	-2	8041
P42771-1#30	0	1	1	P42771-1	48	49	+	1	P42771-1	0	154	ENST00000498124.1	39	501	++	125	P42771-1#30	0	3	ENST00000498124.1	183	186	+	3	0	-2	8042
P42771-1#30	0	1	1	P42771-1	48	49	+	1	P42771-1	0	51	ENST00000380151.3	0	153	++	53	P42771-1#30	0	3	ENST00000380151.3	144	147	+	3	0	-2	8043
P42771-1#30	0	1	1	P42771-1	48	49	+	1	P42771-1	0	156	ENST00000304494.10	30	498	++	24	P42771-1#30	0	3	ENST00000304494.10	174	177	+	3	0	-2	8044
P42771-1#31	0	1	1	P42771-1	48	49	+	1	P42771-1	0	131	ENST00000579122.1	31	424	++	187	P42771-1#31	0	3	ENST00000579122.1	175	178	+	3	0	-2	8045
P42771-1#31	0	1	1	P42771-1	48	49	+	1	P42771-1	0	154	ENST00000498124.1	39	501	++	125	P42771-1#31	0	3	ENST00000498124.1	183	186	+	3	0	-2	8046
P42771-1#31	0	1	1	P42771-1	48	49	+	1	P42771-1	0	51	ENST00000380151.3	0	153	++	53	P42771-1#31	0	3	ENST00000380151.3	144	147	+	3	0	-2	8047
P42771-1#31	0	1	1	P42771-1	48	49	+	1	P42771-1	0	156	ENST00000304494.10	30	498	++	24	P42771-1#31	0	3	ENST00000304494.10	174	177	+	3	0	-2	8048
P42771-1#32	0	1	1	P42771-1	49	50	+	1	P42771-1	0	131	ENST00000579122.1	31	424	++	187	P42771-1#32	0	3	ENST00000579122.1	178	181	+	3	0	-2	8049
P42771-1#32	0	1	1	P42771-1	49	50	+	1	P42771-1	0	154	ENST00000498124.1	39	501	++	125	P42771-1#32	0	3	ENST00000498124.1	186	189	+	3	0	-2	8050
P42771-1#32	0	1	1	P42771-1	49	50	+	1	P42771-1	0	51	ENST00000380151.3	0	153	++	53	P42771-1#32	0	3	ENST00000380151.3	147	150	+	3	0	-2	8051
P42771-1#32	0	1	1	P42771-1	49	50	+	1	P42771-1	0	156	ENST00000304494.10	30	498	++	24	P42771-1#32	0	3	ENST00000304494.10	177	180	+	3	0	-2	8052
P42771-1#33	0	1	1	P42771-1	52	53	+	1	P42771-1	0	131	ENST00000579122.1	31	424	++	187	P42771-1#33	0	3	ENST00000579122.1	187	190	+	3	0	-2	8053
P42771-1#33	0	1	1	P42771-1	52	53	+	1	P42771-1	51	156	ENST00000578845.2	127	442	++	186	P42771-1#33	0	3	ENST00000578845.2	130	133	+	3	0	-2	8054
P42771-1#33	0	1	1	P42771-1	52	53	+	1	P42771-1	51	156	ENST00000498628.6	484	799	++	126	P42771-1#33	0	3	ENST00000498628.6	487	490	+	3	0	-2	8055
P42771-1#33	0	1	1	P42771-1	52	53	+	1	P42771-1	0	154	ENST00000498124.1	39	501	++	125	P42771-1#33	0	3	ENST00000498124.1	195	198	+	3	0	-2	8056
P42771-1#33	0	1	1	P42771-1	52	53	+	1	P42771-1	51	152	ENST00000497750.1	75	378	++	124	P42771-1#33	0	3	ENST00000497750.1	78	81	+	3	0	-2	8057
P42771-1#33	0	1	1	P42771-1	52	53	+	1	P42771-1	51	156	ENST00000494262.5	624	939	++	121	P42771-1#33	0	3	ENST00000494262.5	627	630	+	3	0	-2	8058
P42771-1#33	0	1	1	P42771-1	52	53	+	1	P42771-1	51	152	ENST00000479692.2	15	318	++	114	P42771-1#33	0	3	ENST00000479692.2	18	21	+	3	0	-2	8059
P42771-1#33	0	1	1	P42771-1	52	53	+	1	P42771-1	0	156	ENST00000304494.10	30	498	++	24	P42771-1#33	0	3	ENST00000304494.10	186	189	+	3	0	-2	8060
P42771-1#34	0	1	1	P42771-1	55	56	+	1	P42771-1	0	131	ENST00000579122.1	31	424	++	187	P42771-1#34	0	3	ENST00000579122.1	196	199	+	3	0	-2	8061
P42771-1#34	0	1	1	P42771-1	55	56	+	1	P42771-1	51	156	ENST00000578845.2	127	442	++	186	P42771-1#34	0	3	ENST00000578845.2	139	142	+	3	0	-2	8062
P42771-1#34	0	1	1	P42771-1	55	56	+	1	P42771-1	51	156	ENST00000498628.6	484	799	++	126	P42771-1#34	0	3	ENST00000498628.6	496	499	+	3	0	-2	8063
P42771-1#34	0	1	1	P42771-1	55	56	+	1	P42771-1	0	154	ENST00000498124.1	39	501	++	125	P42771-1#34	0	3	ENST00000498124.1	204	207	+	3	0	-2	8064
P42771-1#34	0	1	1	P42771-1	55	56	+	1	P42771-1	51	152	ENST00000497750.1	75	378	++	124	P42771-1#34	0	3	ENST00000497750.1	87	90	+	3	0	-2	8065
P42771-1#34	0	1	1	P42771-1	55	56	+	1	P42771-1	51	156	ENST00000494262.5	624	939	++	121	P42771-1#34	0	3	ENST00000494262.5	636	639	+	3	0	-2	8066
P42771-1#34	0	1	1	P42771-1	55	56	+	1	P42771-1	51	152	ENST00000479692.2	15	318	++	114	P42771-1#34	0	3	ENST00000479692.2	27	30	+	3	0	-2	8067
P42771-1#34	0	1	1	P42771-1	55	56	+	1	P42771-1	0	156	ENST00000304494.10	30	498	++	24	P42771-1#34	0	3	ENST00000304494.10	195	198	+	3	0	-2	8068
P42771-1#35	0	1	1	P42771-1	56	57	+	1	P42771-1	0	131	ENST00000579122.1	31	424	++	187	P42771-1#35	0	3	ENST00000579122.1	199	202	+	3	0	-2	8069
P42771-1#35	0	1	1	P42771-1	56	57	+	1	P42771-1	51	156	ENST00000578845.2	127	442	++	186	P42771-1#35	0	3	ENST00000578845.2	142	145	+	3	0	-2	8070
P42771-1#35	0	1	1	P42771-1	56	57	+	1	P42771-1	51	156	ENST00000498628.6	484	799	++	126	P42771-1#35	0	3	ENST00000498628.6	499	502	+	3	0	-2	8071
P42771-1#35	0	1	1	P42771-1	56	57	+	1	P42771-1	0	154	ENST00000498124.1	39	501	++	125	P42771-1#35	0	3	ENST00000498124.1	207	210	+	3	0	-2	8072
P42771-1#35	0	1	1	P42771-1	56	57	+	1	P42771-1	51	152	ENST00000497750.1	75	378	++	124	P42771-1#35	0	3	ENST00000497750.1	90	93	+	3	0	-2	8073
P42771-1#35	0	1	1	P42771-1	56	57	+	1	P42771-1	51	156	ENST00000494262.5	624	939	++	121	P42771-1#35	0	3	ENST00000494262.5	639	642	+	3	0	-2	8074
P42771-1#35	0	1	1	P42771-1	56	57	+	1	P42771-1	51	152	ENST00000479692.2	15	318	++	114	P42771-1#35	0	3	ENST00000479692.2	30	33	+	3	0	-2	8075
P42771-1#35	0	1	1	P42771-1	56	57	+	1	P42771-1	0	156	ENST00000304494.10	30	498	++	24	P42771-1#35	0	3	ENST00000304494.10	198	201	+	3	0	-2	8076
P42771-1#36	0	1	1	P42771-1	58	59	+	1	P42771-1	0	131	ENST00000579122.1	31	424	++	187	P42771-1#36	0	3	ENST00000579122.1	205	208	+	3	0	-2	8077
P42771-1#36	0	1	1	P42771-1	58	59	+	1	P42771-1	51	156	ENST00000578845.2	127	442	++	186	P42771-1#36	0	3	ENST00000578845.2	148	151	+	3	0	-2	8078
P42771-1#36	0	1	1	P42771-1	58	59	+	1	P42771-1	51	156	ENST00000498628.6	484	799	++	126	P42771-1#36	0	3	ENST00000498628.6	505	508	+	3	0	-2	8079
P42771-1#36	0	1	1	P42771-1	58	59	+	1	P42771-1	0	154	ENST00000498124.1	39	501	++	125	P42771-1#36	0	3	ENST00000498124.1	213	216	+	3	0	-2	8080
P42771-1#36	0	1	1	P42771-1	58	59	+	1	P42771-1	51	152	ENST00000497750.1	75	378	++	124	P42771-1#36	0	3	ENST00000497750.1	96	99	+	3	0	-2	8081
P42771-1#36	0	1	1	P42771-1	58	59	+	1	P42771-1	51	156	ENST00000494262.5	624	939	++	121	P42771-1#36	0	3	ENST00000494262.5	645	648	+	3	0	-2	8082
P42771-1#36	0	1	1	P42771-1	58	59	+	1	P42771-1	51	152	ENST00000479692.2	15	318	++	114	P42771-1#36	0	3	ENST00000479692.2	36	39	+	3	0	-2	8083
P42771-1#36	0	1	1	P42771-1	58	59	+	1	P42771-1	0	156	ENST00000304494.10	30	498	++	24	P42771-1#36	0	3	ENST00000304494.10	204	207	+	3	0	-2	8084
P42771-1#37	0	1	1	P42771-1	59	60	+	1	P42771-1	0	131	ENST00000579122.1	31	424	++	187	P42771-1#37	0	3	ENST00000579122.1	208	211	+	3	0	-2	8085
P42771-1#37	0	1	1	P42771-1	59	60	+	1	P42771-1	51	156	ENST00000578845.2	127	442	++	186	P42771-1#37	0	3	ENST00000578845.2	151	154	+	3	0	-2	8086
P42771-1#37	0	1	1	P42771-1	59	60	+	1	P42771-1	51	156	ENST00000498628.6	484	799	++	126	P42771-1#37	0	3	ENST00000498628.6	508	511	+	3	0	-2	8087
P42771-1#37	0	1	1	P42771-1	59	60	+	1	P42771-1	0	154	ENST00000498124.1	39	501	++	125	P42771-1#37	0	3	ENST00000498124.1	216	219	+	3	0	-2	8088
P42771-1#37	0	1	1	P42771-1	59	60	+	1	P42771-1	51	152	ENST00000497750.1	75	378	++	124	P42771-1#37	0	3	ENST00000497750.1	99	102	+	3	0	-2	8089
P42771-1#37	0	1	1	P42771-1	59	60	+	1	P42771-1	51	156	ENST00000494262.5	624	939	++	121	P42771-1#37	0	3	ENST00000494262.5	648	651	+	3	0	-2	8090
P42771-1#37	0	1	1	P42771-1	59	60	+	1	P42771-1	51	152	ENST00000479692.2	15	318	++	114	P42771-1#37	0	3	ENST00000479692.2	39	42	+	3	0	-2	8091
P42771-1#37	0	1	1	P42771-1	59	60	+	1	P42771-1	0	156	ENST00000304494.10	30	498	++	24	P42771-1#37	0	3	ENST00000304494.10	207	210	+	3	0	-2	8092
P42771-1#38	0	1	1	P42771-1	59	60	+	1	P42771-1	0	131	ENST00000579122.1	31	424	++	187	P42771-1#38	0	3	ENST00000579122.1	208	211	+	3	0	-2	8093
P42771-1#38	0	1	1	P42771-1	59	60	+	1	P42771-1	51	156	ENST00000578845.2	127	442	++	186	P42771-1#38	0	3	ENST00000578845.2	151	154	+	3	0	-2	8094
P42771-1#38	0	1	1	P42771-1	59	60	+	1	P42771-1	51	156	ENST00000498628.6	484	799	++	126	P42771-1#38	0	3	ENST00000498628.6	508	511	+	3	0	-2	8095
P42771-1#38	0	1	1	P42771-1	59	60	+	1	P42771-1	0	154	ENST00000498124.1	39	501	++	125	P42771-1#38	0	3	ENST00000498124.1	216	219	+	3	0	-2	8096
P42771-1#38	0	1	1	P42771-1	59	60	+	1	P42771-1	51	152	ENST00000497750.1	75	378	++	124	P42771-1#38	0	3	ENST00000497750.1	99	102	+	3	0	-2	8097
P42771-1#38	0	1	1	P42771-1	59	60	+	1	P42771-1	51	156	ENST00000494262.5	624	939	++	121	P42771-1#38	0	3	ENST00000494262.5	648	651	+	3	0	-2	8098
P42771-1#38	0	1	1	P42771-1	59	60	+	1	P42771-1	51	152	ENST00000479692.2	15	318	++	114	P42771-1#38	0	3	ENST00000479692.2	39	42	+	3	0	-2	8099
P42771-1#38	0	1	1	P42771-1	59	60	+	1	P42771-1	0	156	ENST00000304494.10	30	498	++	24	P42771-1#38	0	3	ENST00000304494.10	207	210	+	3	0	-2	8100
P42771-1#39	0	2	2	P42771-1	60	62	+	2	P42771-1	0	131	ENST00000579122.1	31	424	++	187	P42771-1#39	0	6	ENST00000579122.1	211	217	+	6	0	-4	8101
P42771-1#39	0	2	2	P42771-1	60	62	+	2	P42771-1	51	156	ENST00000578845.2	127	442	++	186	P42771-1#39	0	6	ENST00000578845.2	154	160	+	6	0	-4	8102
P42771-1#39	0	2	2	P42771-1	60	62	+	2	P42771-1	51	156	ENST00000498628.6	484	799	++	126	P42771-1#39	0	6	ENST00000498628.6	511	517	+	6	0	-4	8103
P42771-1#39	0	2	2	P42771-1	60	62	+	2	P42771-1	0	154	ENST00000498124.1	39	501	++	125	P42771-1#39	0	6	ENST00000498124.1	219	225	+	6	0	-4	8104
P42771-1#39	0	2	2	P42771-1	60	62	+	2	P42771-1	51	152	ENST00000497750.1	75	378	++	124	P42771-1#39	0	6	ENST00000497750.1	102	108	+	6	0	-4	8105
P42771-1#39	0	2	2	P42771-1	60	62	+	2	P42771-1	51	156	ENST00000494262.5	624	939	++	121	P42771-1#39	0	6	ENST00000494262.5	651	657	+	6	0	-4	8106
P42771-1#39	0	2	2	P42771-1	60	62	+	2	P42771-1	51	152	ENST00000479692.2	15	318	++	114	P42771-1#39	0	6	ENST00000479692.2	42	48	+	6	0	-4	8107
P42771-1#39	0	2	2	P42771-1	60	62	+	2	P42771-1	0	156	ENST00000304494.10	30	498	++	24	P42771-1#39	0	6	ENST00000304494.10	210	216	+	6	0	-4	8108
P42771-1#40	0	1	1	P42771-1	61	62	+	1	P42771-1	0	131	ENST00000579122.1	31	424	++	187	P42771-1#40	0	3	ENST00000579122.1	214	217	+	3	0	-2	8109
P42771-1#40	0	1	1	P42771-1	61	62	+	1	P42771-1	51	156	ENST00000578845.2	127	442	++	186	P42771-1#40	0	3	ENST00000578845.2	157	160	+	3	0	-2	8110
P42771-1#40	0	1	1	P42771-1	61	62	+	1	P42771-1	51	156	ENST00000498628.6	484	799	++	126	P42771-1#40	0	3	ENST00000498628.6	514	517	+	3	0	-2	8111
P42771-1#40	0	1	1	P42771-1	61	62	+	1	P42771-1	0	154	ENST00000498124.1	39	501	++	125	P42771-1#40	0	3	ENST00000498124.1	222	225	+	3	0	-2	8112
P42771-1#40	0	1	1	P42771-1	61	62	+	1	P42771-1	51	152	ENST00000497750.1	75	378	++	124	P42771-1#40	0	3	ENST00000497750.1	105	108	+	3	0	-2	8113
P42771-1#40	0	1	1	P42771-1	61	62	+	1	P42771-1	51	156	ENST00000494262.5	624	939	++	121	P42771-1#40	0	3	ENST00000494262.5	654	657	+	3	0	-2	8114
P42771-1#40	0	1	1	P42771-1	61	62	+	1	P42771-1	51	152	ENST00000479692.2	15	318	++	114	P42771-1#40	0	3	ENST00000479692.2	45	48	+	3	0	-2	8115
P42771-1#40	0	1	1	P42771-1	61	62	+	1	P42771-1	0	156	ENST00000304494.10	30	498	++	24	P42771-1#40	0	3	ENST00000304494.10	213	216	+	3	0	-2	8116
P42771-1#41	0	1	1	P42771-1	65	66	+	1	P42771-1	0	131	ENST00000579122.1	31	424	++	187	P42771-1#41	0	3	ENST00000579122.1	226	229	+	3	0	-2	8117
P42771-1#41	0	1	1	P42771-1	65	66	+	1	P42771-1	51	156	ENST00000578845.2	127	442	++	186	P42771-1#41	0	3	ENST00000578845.2	169	172	+	3	0	-2	8118
P42771-1#41	0	1	1	P42771-1	65	66	+	1	P42771-1	51	156	ENST00000498628.6	484	799	++	126	P42771-1#41	0	3	ENST00000498628.6	526	529	+	3	0	-2	8119
P42771-1#41	0	1	1	P42771-1	65	66	+	1	P42771-1	0	154	ENST00000498124.1	39	501	++	125	P42771-1#41	0	3	ENST00000498124.1	234	237	+	3	0	-2	8120
P42771-1#41	0	1	1	P42771-1	65	66	+	1	P42771-1	51	152	ENST00000497750.1	75	378	++	124	P42771-1#41	0	3	ENST00000497750.1	117	120	+	3	0	-2	8121
P42771-1#41	0	1	1	P42771-1	65	66	+	1	P42771-1	51	156	ENST00000494262.5	624	939	++	121	P42771-1#41	0	3	ENST00000494262.5	666	669	+	3	0	-2	8122
P42771-1#41	0	1	1	P42771-1	65	66	+	1	P42771-1	51	152	ENST00000479692.2	15	318	++	114	P42771-1#41	0	3	ENST00000479692.2	57	60	+	3	0	-2	8123
P42771-1#41	0	1	1	P42771-1	65	66	+	1	P42771-1	0	156	ENST00000304494.10	30	498	++	24	P42771-1#41	0	3	ENST00000304494.10	225	228	+	3	0	-2	8124
P42771-1#42	0	5	5	P42771-1	66	71	+	5	P42771-1	0	131	ENST00000579122.1	31	424	++	187	P42771-1#42	0	15	ENST00000579122.1	229	244	+	15	0	-10	8125
P42771-1#42	0	5	5	P42771-1	66	71	+	5	P42771-1	51	156	ENST00000578845.2	127	442	++	186	P42771-1#42	0	15	ENST00000578845.2	172	187	+	15	0	-10	8126
P42771-1#42	0	5	5	P42771-1	66	71	+	5	P42771-1	51	156	ENST00000498628.6	484	799	++	126	P42771-1#42	0	15	ENST00000498628.6	529	544	+	15	0	-10	8127
P42771-1#42	0	5	5	P42771-1	66	71	+	5	P42771-1	0	154	ENST00000498124.1	39	501	++	125	P42771-1#42	0	15	ENST00000498124.1	237	252	+	15	0	-10	8128
P42771-1#42	0	5	5	P42771-1	66	71	+	5	P42771-1	51	152	ENST00000497750.1	75	378	++	124	P42771-1#42	0	15	ENST00000497750.1	120	135	+	15	0	-10	8129
P42771-1#42	0	5	5	P42771-1	66	71	+	5	P42771-1	51	156	ENST00000494262.5	624	939	++	121	P42771-1#42	0	15	ENST00000494262.5	669	684	+	15	0	-10	8130
P42771-1#42	0	5	5	P42771-1	66	71	+	5	P42771-1	51	152	ENST00000479692.2	15	318	++	114	P42771-1#42	0	15	ENST00000479692.2	60	75	+	15	0	-10	8131
P42771-1#42	0	5	5	P42771-1	66	71	+	5	P42771-1	0	156	ENST00000304494.10	30	498	++	24	P42771-1#42	0	15	ENST00000304494.10	228	243	+	15	0	-10	8132
P42771-1#43	0	1	1	P42771-1	66	67	+	1	P42771-1	0	131	ENST00000579122.1	31	424	++	187	P42771-1#43	0	3	ENST00000579122.1	229	232	+	3	0	-2	8133
P42771-1#43	0	1	1	P42771-1	66	67	+	1	P42771-1	51	156	ENST00000578845.2	127	442	++	186	P42771-1#43	0	3	ENST00000578845.2	172	175	+	3	0	-2	8134
P42771-1#43	0	1	1	P42771-1	66	67	+	1	P42771-1	51	156	ENST00000498628.6	484	799	++	126	P42771-1#43	0	3	ENST00000498628.6	529	532	+	3	0	-2	8135
P42771-1#43	0	1	1	P42771-1	66	67	+	1	P42771-1	0	154	ENST00000498124.1	39	501	++	125	P42771-1#43	0	3	ENST00000498124.1	237	240	+	3	0	-2	8136
P42771-1#43	0	1	1	P42771-1	66	67	+	1	P42771-1	51	152	ENST00000497750.1	75	378	++	124	P42771-1#43	0	3	ENST00000497750.1	120	123	+	3	0	-2	8137
P42771-1#43	0	1	1	P42771-1	66	67	+	1	P42771-1	51	156	ENST00000494262.5	624	939	++	121	P42771-1#43	0	3	ENST00000494262.5	669	672	+	3	0	-2	8138
P42771-1#43	0	1	1	P42771-1	66	67	+	1	P42771-1	51	152	ENST00000479692.2	15	318	++	114	P42771-1#43	0	3	ENST00000479692.2	60	63	+	3	0	-2	8139
P42771-1#43	0	1	1	P42771-1	66	67	+	1	P42771-1	0	156	ENST00000304494.10	30	498	++	24	P42771-1#43	0	3	ENST00000304494.10	228	231	+	3	0	-2	8140
P42771-1#44	0	1	1	P42771-1	67	68	+	1	P42771-1	0	131	ENST00000579122.1	31	424	++	187	P42771-1#44	0	3	ENST00000579122.1	232	235	+	3	0	-2	8141
P42771-1#44	0	1	1	P42771-1	67	68	+	1	P42771-1	51	156	ENST00000578845.2	127	442	++	186	P42771-1#44	0	3	ENST00000578845.2	175	178	+	3	0	-2	8142
P42771-1#44	0	1	1	P42771-1	67	68	+	1	P42771-1	51	156	ENST00000498628.6	484	799	++	126	P42771-1#44	0	3	ENST00000498628.6	532	535	+	3	0	-2	8143
P42771-1#44	0	1	1	P42771-1	67	68	+	1	P42771-1	0	154	ENST00000498124.1	39	501	++	125	P42771-1#44	0	3	ENST00000498124.1	240	243	+	3	0	-2	8144
P42771-1#44	0	1	1	P42771-1	67	68	+	1	P42771-1	51	152	ENST00000497750.1	75	378	++	124	P42771-1#44	0	3	ENST00000497750.1	123	126	+	3	0	-2	8145
P42771-1#44	0	1	1	P42771-1	67	68	+	1	P42771-1	51	156	ENST00000494262.5	624	939	++	121	P42771-1#44	0	3	ENST00000494262.5	672	675	+	3	0	-2	8146
P42771-1#44	0	1	1	P42771-1	67	68	+	1	P42771-1	51	152	ENST00000479692.2	15	318	++	114	P42771-1#44	0	3	ENST00000479692.2	63	66	+	3	0	-2	8147
P42771-1#44	0	1	1	P42771-1	67	68	+	1	P42771-1	0	156	ENST00000304494.10	30	498	++	24	P42771-1#44	0	3	ENST00000304494.10	231	234	+	3	0	-2	8148
P42771-1#45	0	1	1	P42771-1	67	68	+	1	P42771-1	0	131	ENST00000579122.1	31	424	++	187	P42771-1#45	0	3	ENST00000579122.1	232	235	+	3	0	-2	8149
P42771-1#45	0	1	1	P42771-1	67	68	+	1	P42771-1	51	156	ENST00000578845.2	127	442	++	186	P42771-1#45	0	3	ENST00000578845.2	175	178	+	3	0	-2	8150
P42771-1#45	0	1	1	P42771-1	67	68	+	1	P42771-1	51	156	ENST00000498628.6	484	799	++	126	P42771-1#45	0	3	ENST00000498628.6	532	535	+	3	0	-2	8151
P42771-1#45	0	1	1	P42771-1	67	68	+	1	P42771-1	0	154	ENST00000498124.1	39	501	++	125	P42771-1#45	0	3	ENST00000498124.1	240	243	+	3	0	-2	8152
P42771-1#45	0	1	1	P42771-1	67	68	+	1	P42771-1	51	152	ENST00000497750.1	75	378	++	124	P42771-1#45	0	3	ENST00000497750.1	123	126	+	3	0	-2	8153
P42771-1#45	0	1	1	P42771-1	67	68	+	1	P42771-1	51	156	ENST00000494262.5	624	939	++	121	P42771-1#45	0	3	ENST00000494262.5	672	675	+	3	0	-2	8154
P42771-1#45	0	1	1	P42771-1	67	68	+	1	P42771-1	51	152	ENST00000479692.2	15	318	++	114	P42771-1#45	0	3	ENST00000479692.2	63	66	+	3	0	-2	8155
P42771-1#45	0	1	1	P42771-1	67	68	+	1	P42771-1	0	156	ENST00000304494.10	30	498	++	24	P42771-1#45	0	3	ENST00000304494.10	231	234	+	3	0	-2	8156
P42771-1#46	0	1	1	P42771-1	67	68	+	1	P42771-1	0	131	ENST00000579122.1	31	424	++	187	P42771-1#46	0	3	ENST00000579122.1	232	235	+	3	0	-2	8157
P42771-1#46	0	1	1	P42771-1	67	68	+	1	P42771-1	51	156	ENST00000578845.2	127	442	++	186	P42771-1#46	0	3	ENST00000578845.2	175	178	+	3	0	-2	8158
P42771-1#46	0	1	1	P42771-1	67	68	+	1	P42771-1	51	156	ENST00000498628.6	484	799	++	126	P42771-1#46	0	3	ENST00000498628.6	532	535	+	3	0	-2	8159
P42771-1#46	0	1	1	P42771-1	67	68	+	1	P42771-1	0	154	ENST00000498124.1	39	501	++	125	P42771-1#46	0	3	ENST00000498124.1	240	243	+	3	0	-2	8160
P42771-1#46	0	1	1	P42771-1	67	68	+	1	P42771-1	51	152	ENST00000497750.1	75	378	++	124	P42771-1#46	0	3	ENST00000497750.1	123	126	+	3	0	-2	8161
P42771-1#46	0	1	1	P42771-1	67	68	+	1	P42771-1	51	156	ENST00000494262.5	624	939	++	121	P42771-1#46	0	3	ENST00000494262.5	672	675	+	3	0	-2	8162
P42771-1#46	0	1	1	P42771-1	67	68	+	1	P42771-1	51	152	ENST00000479692.2	15	318	++	114	P42771-1#46	0	3	ENST00000479692.2	63	66	+	3	0	-2	8163
P42771-1#46	0	1	1	P42771-1	67	68	+	1	P42771-1	0	156	ENST00000304494.10	30	498	++	24	P42771-1#46	0	3	ENST00000304494.10	231	234	+	3	0	-2	8164
P42771-1#47	0	1	1	P42771-1	68	69	+	1	P42771-1	0	131	ENST00000579122.1	31	424	++	187	P42771-1#47	0	3	ENST00000579122.1	235	238	+	3	0	-2	8165
P42771-1#47	0	1	1	P42771-1	68	69	+	1	P42771-1	51	156	ENST00000578845.2	127	442	++	186	P42771-1#47	0	3	ENST00000578845.2	178	181	+	3	0	-2	8166
P42771-1#47	0	1	1	P42771-1	68	69	+	1	P42771-1	51	156	ENST00000498628.6	484	799	++	126	P42771-1#47	0	3	ENST00000498628.6	535	538	+	3	0	-2	8167
P42771-1#47	0	1	1	P42771-1	68	69	+	1	P42771-1	0	154	ENST00000498124.1	39	501	++	125	P42771-1#47	0	3	ENST00000498124.1	243	246	+	3	0	-2	8168
P42771-1#47	0	1	1	P42771-1	68	69	+	1	P42771-1	51	152	ENST00000497750.1	75	378	++	124	P42771-1#47	0	3	ENST00000497750.1	126	129	+	3	0	-2	8169
P42771-1#47	0	1	1	P42771-1	68	69	+	1	P42771-1	51	156	ENST00000494262.5	624	939	++	121	P42771-1#47	0	3	ENST00000494262.5	675	678	+	3	0	-2	8170
P42771-1#47	0	1	1	P42771-1	68	69	+	1	P42771-1	51	152	ENST00000479692.2	15	318	++	114	P42771-1#47	0	3	ENST00000479692.2	66	69	+	3	0	-2	8171
P42771-1#47	0	1	1	P42771-1	68	69	+	1	P42771-1	0	156	ENST00000304494.10	30	498	++	24	P42771-1#47	0	3	ENST00000304494.10	234	237	+	3	0	-2	8172
P42771-1#48	0	1	1	P42771-1	68	69	+	1	P42771-1	0	131	ENST00000579122.1	31	424	++	187	P42771-1#48	0	3	ENST00000579122.1	235	238	+	3	0	-2	8173
P42771-1#48	0	1	1	P42771-1	68	69	+	1	P42771-1	51	156	ENST00000578845.2	127	442	++	186	P42771-1#48	0	3	ENST00000578845.2	178	181	+	3	0	-2	8174
P42771-1#48	0	1	1	P42771-1	68	69	+	1	P42771-1	51	156	ENST00000498628.6	484	799	++	126	P42771-1#48	0	3	ENST00000498628.6	535	538	+	3	0	-2	8175
P42771-1#48	0	1	1	P42771-1	68	69	+	1	P42771-1	0	154	ENST00000498124.1	39	501	++	125	P42771-1#48	0	3	ENST00000498124.1	243	246	+	3	0	-2	8176
P42771-1#48	0	1	1	P42771-1	68	69	+	1	P42771-1	51	152	ENST00000497750.1	75	378	++	124	P42771-1#48	0	3	ENST00000497750.1	126	129	+	3	0	-2	8177
P42771-1#48	0	1	1	P42771-1	68	69	+	1	P42771-1	51	156	ENST00000494262.5	624	939	++	121	P42771-1#48	0	3	ENST00000494262.5	675	678	+	3	0	-2	8178
P42771-1#48	0	1	1	P42771-1	68	69	+	1	P42771-1	51	152	ENST00000479692.2	15	318	++	114	P42771-1#48	0	3	ENST00000479692.2	66	69	+	3	0	-2	8179
P42771-1#48	0	1	1	P42771-1	68	69	+	1	P42771-1	0	156	ENST00000304494.10	30	498	++	24	P42771-1#48	0	3	ENST00000304494.10	234	237	+	3	0	-2	8180
P42771-1#49	0	1	1	P42771-1	68	69	+	1	P42771-1	0	131	ENST00000579122.1	31	424	++	187	P42771-1#49	0	3	ENST00000579122.1	235	238	+	3	0	-2	8181
P42771-1#49	0	1	1	P42771-1	68	69	+	1	P42771-1	51	156	ENST00000578845.2	127	442	++	186	P42771-1#49	0	3	ENST00000578845.2	178	181	+	3	0	-2	8182
P42771-1#49	0	1	1	P42771-1	68	69	+	1	P42771-1	51	156	ENST00000498628.6	484	799	++	126	P42771-1#49	0	3	ENST00000498628.6	535	538	+	3	0	-2	8183
P42771-1#49	0	1	1	P42771-1	68	69	+	1	P42771-1	0	154	ENST00000498124.1	39	501	++	125	P42771-1#49	0	3	ENST00000498124.1	243	246	+	3	0	-2	8184
P42771-1#49	0	1	1	P42771-1	68	69	+	1	P42771-1	51	152	ENST00000497750.1	75	378	++	124	P42771-1#49	0	3	ENST00000497750.1	126	129	+	3	0	-2	8185
P42771-1#49	0	1	1	P42771-1	68	69	+	1	P42771-1	51	156	ENST00000494262.5	624	939	++	121	P42771-1#49	0	3	ENST00000494262.5	675	678	+	3	0	-2	8186
P42771-1#49	0	1	1	P42771-1	68	69	+	1	P42771-1	51	152	ENST00000479692.2	15	318	++	114	P42771-1#49	0	3	ENST00000479692.2	66	69	+	3	0	-2	8187
P42771-1#49	0	1	1	P42771-1	68	69	+	1	P42771-1	0	156	ENST00000304494.10	30	498	++	24	P42771-1#49	0	3	ENST00000304494.10	234	237	+	3	0	-2	8188
P42771-1#50	0	1	1	P42771-1	70	71	+	1	P42771-1	0	131	ENST00000579122.1	31	424	++	187	P42771-1#50	0	3	ENST00000579122.1	241	244	+	3	0	-2	8189
P42771-1#50	0	1	1	P42771-1	70	71	+	1	P42771-1	51	156	ENST00000578845.2	127	442	++	186	P42771-1#50	0	3	ENST00000578845.2	184	187	+	3	0	-2	8190
P42771-1#50	0	1	1	P42771-1	70	71	+	1	P42771-1	51	156	ENST00000498628.6	484	799	++	126	P42771-1#50	0	3	ENST00000498628.6	541	544	+	3	0	-2	8191
P42771-1#50	0	1	1	P42771-1	70	71	+	1	P42771-1	0	154	ENST00000498124.1	39	501	++	125	P42771-1#50	0	3	ENST00000498124.1	249	252	+	3	0	-2	8192
P42771-1#50	0	1	1	P42771-1	70	71	+	1	P42771-1	51	152	ENST00000497750.1	75	378	++	124	P42771-1#50	0	3	ENST00000497750.1	132	135	+	3	0	-2	8193
P42771-1#50	0	1	1	P42771-1	70	71	+	1	P42771-1	51	156	ENST00000494262.5	624	939	++	121	P42771-1#50	0	3	ENST00000494262.5	681	684	+	3	0	-2	8194
P42771-1#50	0	1	1	P42771-1	70	71	+	1	P42771-1	51	152	ENST00000479692.2	15	318	++	114	P42771-1#50	0	3	ENST00000479692.2	72	75	+	3	0	-2	8195
P42771-1#50	0	1	1	P42771-1	70	71	+	1	P42771-1	0	156	ENST00000304494.10	30	498	++	24	P42771-1#50	0	3	ENST00000304494.10	240	243	+	3	0	-2	8196
P42771-1#51	0	1	1	P42771-1	70	71	+	1	P42771-1	0	131	ENST00000579122.1	31	424	++	187	P42771-1#51	0	3	ENST00000579122.1	241	244	+	3	0	-2	8197
P42771-1#51	0	1	1	P42771-1	70	71	+	1	P42771-1	51	156	ENST00000578845.2	127	442	++	186	P42771-1#51	0	3	ENST00000578845.2	184	187	+	3	0	-2	8198
P42771-1#51	0	1	1	P42771-1	70	71	+	1	P42771-1	51	156	ENST00000498628.6	484	799	++	126	P42771-1#51	0	3	ENST00000498628.6	541	544	+	3	0	-2	8199
P42771-1#51	0	1	1	P42771-1	70	71	+	1	P42771-1	0	154	ENST00000498124.1	39	501	++	125	P42771-1#51	0	3	ENST00000498124.1	249	252	+	3	0	-2	8200
P42771-1#51	0	1	1	P42771-1	70	71	+	1	P42771-1	51	152	ENST00000497750.1	75	378	++	124	P42771-1#51	0	3	ENST00000497750.1	132	135	+	3	0	-2	8201
P42771-1#51	0	1	1	P42771-1	70	71	+	1	P42771-1	51	156	ENST00000494262.5	624	939	++	121	P42771-1#51	0	3	ENST00000494262.5	681	684	+	3	0	-2	8202
P42771-1#51	0	1	1	P42771-1	70	71	+	1	P42771-1	51	152	ENST00000479692.2	15	318	++	114	P42771-1#51	0	3	ENST00000479692.2	72	75	+	3	0	-2	8203
P42771-1#51	0	1	1	P42771-1	70	71	+	1	P42771-1	0	156	ENST00000304494.10	30	498	++	24	P42771-1#51	0	3	ENST00000304494.10	240	243	+	3	0	-2	8204
P42771-1#52	0	1	1	P42771-1	71	72	+	1	P42771-1	0	131	ENST00000579122.1	31	424	++	187	P42771-1#52	0	3	ENST00000579122.1	244	247	+	3	0	-2	8205
P42771-1#52	0	1	1	P42771-1	71	72	+	1	P42771-1	51	156	ENST00000578845.2	127	442	++	186	P42771-1#52	0	3	ENST00000578845.2	187	190	+	3	0	-2	8206
P42771-1#52	0	1	1	P42771-1	71	72	+	1	P42771-1	51	156	ENST00000498628.6	484	799	++	126	P42771-1#52	0	3	ENST00000498628.6	544	547	+	3	0	-2	8207
P42771-1#52	0	1	1	P42771-1	71	72	+	1	P42771-1	0	154	ENST00000498124.1	39	501	++	125	P42771-1#52	0	3	ENST00000498124.1	252	255	+	3	0	-2	8208
P42771-1#52	0	1	1	P42771-1	71	72	+	1	P42771-1	51	152	ENST00000497750.1	75	378	++	124	P42771-1#52	0	3	ENST00000497750.1	135	138	+	3	0	-2	8209
P42771-1#52	0	1	1	P42771-1	71	72	+	1	P42771-1	51	156	ENST00000494262.5	624	939	++	121	P42771-1#52	0	3	ENST00000494262.5	684	687	+	3	0	-2	8210
P42771-1#52	0	1	1	P42771-1	71	72	+	1	P42771-1	51	152	ENST00000479692.2	15	318	++	114	P42771-1#52	0	3	ENST00000479692.2	75	78	+	3	0	-2	8211
P42771-1#52	0	1	1	P42771-1	71	72	+	1	P42771-1	0	156	ENST00000304494.10	30	498	++	24	P42771-1#52	0	3	ENST00000304494.10	243	246	+	3	0	-2	8212
P42771-1#53	0	1	1	P42771-1	73	74	+	1	P42771-1	0	131	ENST00000579122.1	31	424	++	187	P42771-1#53	0	3	ENST00000579122.1	250	253	+	3	0	-2	8213
P42771-1#53	0	1	1	P42771-1	73	74	+	1	P42771-1	51	156	ENST00000578845.2	127	442	++	186	P42771-1#53	0	3	ENST00000578845.2	193	196	+	3	0	-2	8214
P42771-1#53	0	1	1	P42771-1	73	74	+	1	P42771-1	51	156	ENST00000498628.6	484	799	++	126	P42771-1#53	0	3	ENST00000498628.6	550	553	+	3	0	-2	8215
P42771-1#53	0	1	1	P42771-1	73	74	+	1	P42771-1	0	154	ENST00000498124.1	39	501	++	125	P42771-1#53	0	3	ENST00000498124.1	258	261	+	3	0	-2	8216
P42771-1#53	0	1	1	P42771-1	73	74	+	1	P42771-1	51	152	ENST00000497750.1	75	378	++	124	P42771-1#53	0	3	ENST00000497750.1	141	144	+	3	0	-2	8217
P42771-1#53	0	1	1	P42771-1	73	74	+	1	P42771-1	51	156	ENST00000494262.5	624	939	++	121	P42771-1#53	0	3	ENST00000494262.5	690	693	+	3	0	-2	8218
P42771-1#53	0	1	1	P42771-1	73	74	+	1	P42771-1	51	152	ENST00000479692.2	15	318	++	114	P42771-1#53	0	3	ENST00000479692.2	81	84	+	3	0	-2	8219
P42771-1#53	0	1	1	P42771-1	73	74	+	1	P42771-1	0	156	ENST00000304494.10	30	498	++	24	P42771-1#53	0	3	ENST00000304494.10	249	252	+	3	0	-2	8220
P42771-1#54	0	1	1	P42771-1	73	74	+	1	P42771-1	0	131	ENST00000579122.1	31	424	++	187	P42771-1#54	0	3	ENST00000579122.1	250	253	+	3	0	-2	8221
P42771-1#54	0	1	1	P42771-1	73	74	+	1	P42771-1	51	156	ENST00000578845.2	127	442	++	186	P42771-1#54	0	3	ENST00000578845.2	193	196	+	3	0	-2	8222
P42771-1#54	0	1	1	P42771-1	73	74	+	1	P42771-1	51	156	ENST00000498628.6	484	799	++	126	P42771-1#54	0	3	ENST00000498628.6	550	553	+	3	0	-2	8223
P42771-1#54	0	1	1	P42771-1	73	74	+	1	P42771-1	0	154	ENST00000498124.1	39	501	++	125	P42771-1#54	0	3	ENST00000498124.1	258	261	+	3	0	-2	8224
P42771-1#54	0	1	1	P42771-1	73	74	+	1	P42771-1	51	152	ENST00000497750.1	75	378	++	124	P42771-1#54	0	3	ENST00000497750.1	141	144	+	3	0	-2	8225
P42771-1#54	0	1	1	P42771-1	73	74	+	1	P42771-1	51	156	ENST00000494262.5	624	939	++	121	P42771-1#54	0	3	ENST00000494262.5	690	693	+	3	0	-2	8226
P42771-1#54	0	1	1	P42771-1	73	74	+	1	P42771-1	51	152	ENST00000479692.2	15	318	++	114	P42771-1#54	0	3	ENST00000479692.2	81	84	+	3	0	-2	8227
P42771-1#54	0	1	1	P42771-1	73	74	+	1	P42771-1	0	156	ENST00000304494.10	30	498	++	24	P42771-1#54	0	3	ENST00000304494.10	249	252	+	3	0	-2	8228
P42771-1#55	0	1	1	P42771-1	73	74	+	1	P42771-1	0	131	ENST00000579122.1	31	424	++	187	P42771-1#55	0	3	ENST00000579122.1	250	253	+	3	0	-2	8229
P42771-1#55	0	1	1	P42771-1	73	74	+	1	P42771-1	51	156	ENST00000578845.2	127	442	++	186	P42771-1#55	0	3	ENST00000578845.2	193	196	+	3	0	-2	8230
P42771-1#55	0	1	1	P42771-1	73	74	+	1	P42771-1	51	156	ENST00000498628.6	484	799	++	126	P42771-1#55	0	3	ENST00000498628.6	550	553	+	3	0	-2	8231
P42771-1#55	0	1	1	P42771-1	73	74	+	1	P42771-1	0	154	ENST00000498124.1	39	501	++	125	P42771-1#55	0	3	ENST00000498124.1	258	261	+	3	0	-2	8232
P42771-1#55	0	1	1	P42771-1	73	74	+	1	P42771-1	51	152	ENST00000497750.1	75	378	++	124	P42771-1#55	0	3	ENST00000497750.1	141	144	+	3	0	-2	8233
P42771-1#55	0	1	1	P42771-1	73	74	+	1	P42771-1	51	156	ENST00000494262.5	624	939	++	121	P42771-1#55	0	3	ENST00000494262.5	690	693	+	3	0	-2	8234
P42771-1#55	0	1	1	P42771-1	73	74	+	1	P42771-1	51	152	ENST00000479692.2	15	318	++	114	P42771-1#55	0	3	ENST00000479692.2	81	84	+	3	0	-2	8235
P42771-1#55	0	1	1	P42771-1	73	74	+	1	P42771-1	0	156	ENST00000304494.10	30	498	++	24	P42771-1#55	0	3	ENST00000304494.10	249	252	+	3	0	-2	8236
P42771-1#56	0	1	1	P42771-1	76	77	+	1	P42771-1	0	131	ENST00000579122.1	31	424	++	187	P42771-1#56	0	3	ENST00000579122.1	259	262	+	3	0	-2	8237
P42771-1#56	0	1	1	P42771-1	76	77	+	1	P42771-1	51	156	ENST00000578845.2	127	442	++	186	P42771-1#56	0	3	ENST00000578845.2	202	205	+	3	0	-2	8238
P42771-1#56	0	1	1	P42771-1	76	77	+	1	P42771-1	51	156	ENST00000498628.6	484	799	++	126	P42771-1#56	0	3	ENST00000498628.6	559	562	+	3	0	-2	8239
P42771-1#56	0	1	1	P42771-1	76	77	+	1	P42771-1	0	154	ENST00000498124.1	39	501	++	125	P42771-1#56	0	3	ENST00000498124.1	267	270	+	3	0	-2	8240
P42771-1#56	0	1	1	P42771-1	76	77	+	1	P42771-1	51	152	ENST00000497750.1	75	378	++	124	P42771-1#56	0	3	ENST00000497750.1	150	153	+	3	0	-2	8241
P42771-1#56	0	1	1	P42771-1	76	77	+	1	P42771-1	51	156	ENST00000494262.5	624	939	++	121	P42771-1#56	0	3	ENST00000494262.5	699	702	+	3	0	-2	8242
P42771-1#56	0	1	1	P42771-1	76	77	+	1	P42771-1	51	152	ENST00000479692.2	15	318	++	114	P42771-1#56	0	3	ENST00000479692.2	90	93	+	3	0	-2	8243
P42771-1#56	0	1	1	P42771-1	76	77	+	1	P42771-1	0	156	ENST00000304494.10	30	498	++	24	P42771-1#56	0	3	ENST00000304494.10	258	261	+	3	0	-2	8244
P42771-1#57	0	1	1	P42771-1	79	80	+	1	P42771-1	0	131	ENST00000579122.1	31	424	++	187	P42771-1#57	0	3	ENST00000579122.1	268	271	+	3	0	-2	8245
P42771-1#57	0	1	1	P42771-1	79	80	+	1	P42771-1	51	156	ENST00000578845.2	127	442	++	186	P42771-1#57	0	3	ENST00000578845.2	211	214	+	3	0	-2	8246
P42771-1#57	0	1	1	P42771-1	79	80	+	1	P42771-1	51	156	ENST00000498628.6	484	799	++	126	P42771-1#57	0	3	ENST00000498628.6	568	571	+	3	0	-2	8247
P42771-1#57	0	1	1	P42771-1	79	80	+	1	P42771-1	0	154	ENST00000498124.1	39	501	++	125	P42771-1#57	0	3	ENST00000498124.1	276	279	+	3	0	-2	8248
P42771-1#57	0	1	1	P42771-1	79	80	+	1	P42771-1	51	152	ENST00000497750.1	75	378	++	124	P42771-1#57	0	3	ENST00000497750.1	159	162	+	3	0	-2	8249
P42771-1#57	0	1	1	P42771-1	79	80	+	1	P42771-1	51	156	ENST00000494262.5	624	939	++	121	P42771-1#57	0	3	ENST00000494262.5	708	711	+	3	0	-2	8250
P42771-1#57	0	1	1	P42771-1	79	80	+	1	P42771-1	51	152	ENST00000479692.2	15	318	++	114	P42771-1#57	0	3	ENST00000479692.2	99	102	+	3	0	-2	8251
P42771-1#57	0	1	1	P42771-1	79	80	+	1	P42771-1	0	156	ENST00000304494.10	30	498	++	24	P42771-1#57	0	3	ENST00000304494.10	267	270	+	3	0	-2	8252
P42771-1#58	0	1	1	P42771-1	79	80	+	1	P42771-1	0	131	ENST00000579122.1	31	424	++	187	P42771-1#58	0	3	ENST00000579122.1	268	271	+	3	0	-2	8253
P42771-1#58	0	1	1	P42771-1	79	80	+	1	P42771-1	51	156	ENST00000578845.2	127	442	++	186	P42771-1#58	0	3	ENST00000578845.2	211	214	+	3	0	-2	8254
P42771-1#58	0	1	1	P42771-1	79	80	+	1	P42771-1	51	156	ENST00000498628.6	484	799	++	126	P42771-1#58	0	3	ENST00000498628.6	568	571	+	3	0	-2	8255
P42771-1#58	0	1	1	P42771-1	79	80	+	1	P42771-1	0	154	ENST00000498124.1	39	501	++	125	P42771-1#58	0	3	ENST00000498124.1	276	279	+	3	0	-2	8256
P42771-1#58	0	1	1	P42771-1	79	80	+	1	P42771-1	51	152	ENST00000497750.1	75	378	++	124	P42771-1#58	0	3	ENST00000497750.1	159	162	+	3	0	-2	8257
P42771-1#58	0	1	1	P42771-1	79	80	+	1	P42771-1	51	156	ENST00000494262.5	624	939	++	121	P42771-1#58	0	3	ENST00000494262.5	708	711	+	3	0	-2	8258
P42771-1#58	0	1	1	P42771-1	79	80	+	1	P42771-1	51	152	ENST00000479692.2	15	318	++	114	P42771-1#58	0	3	ENST00000479692.2	99	102	+	3	0	-2	8259
P42771-1#58	0	1	1	P42771-1	79	80	+	1	P42771-1	0	156	ENST00000304494.10	30	498	++	24	P42771-1#58	0	3	ENST00000304494.10	267	270	+	3	0	-2	8260
P42771-1#59	0	1	1	P42771-1	80	81	+	1	P42771-1	0	131	ENST00000579122.1	31	424	++	187	P42771-1#59	0	3	ENST00000579122.1	271	274	+	3	0	-2	8261
P42771-1#59	0	1	1	P42771-1	80	81	+	1	P42771-1	51	156	ENST00000578845.2	127	442	++	186	P42771-1#59	0	3	ENST00000578845.2	214	217	+	3	0	-2	8262
P42771-1#59	0	1	1	P42771-1	80	81	+	1	P42771-1	51	156	ENST00000498628.6	484	799	++	126	P42771-1#59	0	3	ENST00000498628.6	571	574	+	3	0	-2	8263
P42771-1#59	0	1	1	P42771-1	80	81	+	1	P42771-1	0	154	ENST00000498124.1	39	501	++	125	P42771-1#59	0	3	ENST00000498124.1	279	282	+	3	0	-2	8264
P42771-1#59	0	1	1	P42771-1	80	81	+	1	P42771-1	51	152	ENST00000497750.1	75	378	++	124	P42771-1#59	0	3	ENST00000497750.1	162	165	+	3	0	-2	8265
P42771-1#59	0	1	1	P42771-1	80	81	+	1	P42771-1	51	156	ENST00000494262.5	624	939	++	121	P42771-1#59	0	3	ENST00000494262.5	711	714	+	3	0	-2	8266
P42771-1#59	0	1	1	P42771-1	80	81	+	1	P42771-1	51	152	ENST00000479692.2	15	318	++	114	P42771-1#59	0	3	ENST00000479692.2	102	105	+	3	0	-2	8267
P42771-1#59	0	1	1	P42771-1	80	81	+	1	P42771-1	0	156	ENST00000304494.10	30	498	++	24	P42771-1#59	0	3	ENST00000304494.10	270	273	+	3	0	-2	8268
P42771-1#60	0	1	1	P42771-1	80	81	+	1	P42771-1	0	131	ENST00000579122.1	31	424	++	187	P42771-1#60	0	3	ENST00000579122.1	271	274	+	3	0	-2	8269
P42771-1#60	0	1	1	P42771-1	80	81	+	1	P42771-1	51	156	ENST00000578845.2	127	442	++	186	P42771-1#60	0	3	ENST00000578845.2	214	217	+	3	0	-2	8270
P42771-1#60	0	1	1	P42771-1	80	81	+	1	P42771-1	51	156	ENST00000498628.6	484	799	++	126	P42771-1#60	0	3	ENST00000498628.6	571	574	+	3	0	-2	8271
P42771-1#60	0	1	1	P42771-1	80	81	+	1	P42771-1	0	154	ENST00000498124.1	39	501	++	125	P42771-1#60	0	3	ENST00000498124.1	279	282	+	3	0	-2	8272
P42771-1#60	0	1	1	P42771-1	80	81	+	1	P42771-1	51	152	ENST00000497750.1	75	378	++	124	P42771-1#60	0	3	ENST00000497750.1	162	165	+	3	0	-2	8273
P42771-1#60	0	1	1	P42771-1	80	81	+	1	P42771-1	51	156	ENST00000494262.5	624	939	++	121	P42771-1#60	0	3	ENST00000494262.5	711	714	+	3	0	-2	8274
P42771-1#60	0	1	1	P42771-1	80	81	+	1	P42771-1	51	152	ENST00000479692.2	15	318	++	114	P42771-1#60	0	3	ENST00000479692.2	102	105	+	3	0	-2	8275
P42771-1#60	0	1	1	P42771-1	80	81	+	1	P42771-1	0	156	ENST00000304494.10	30	498	++	24	P42771-1#60	0	3	ENST00000304494.10	270	273	+	3	0	-2	8276
P42771-1#61	0	1	1	P42771-1	82	83	+	1	P42771-1	0	131	ENST00000579122.1	31	424	++	187	P42771-1#61	0	3	ENST00000579122.1	277	280	+	3	0	-2	8277
P42771-1#61	0	1	1	P42771-1	82	83	+	1	P42771-1	51	156	ENST00000578845.2	127	442	++	186	P42771-1#61	0	3	ENST00000578845.2	220	223	+	3	0	-2	8278
P42771-1#61	0	1	1	P42771-1	82	83	+	1	P42771-1	51	156	ENST00000498628.6	484	799	++	126	P42771-1#61	0	3	ENST00000498628.6	577	580	+	3	0	-2	8279
P42771-1#61	0	1	1	P42771-1	82	83	+	1	P42771-1	0	154	ENST00000498124.1	39	501	++	125	P42771-1#61	0	3	ENST00000498124.1	285	288	+	3	0	-2	8280
P42771-1#61	0	1	1	P42771-1	82	83	+	1	P42771-1	51	152	ENST00000497750.1	75	378	++	124	P42771-1#61	0	3	ENST00000497750.1	168	171	+	3	0	-2	8281
P42771-1#61	0	1	1	P42771-1	82	83	+	1	P42771-1	51	156	ENST00000494262.5	624	939	++	121	P42771-1#61	0	3	ENST00000494262.5	717	720	+	3	0	-2	8282
P42771-1#61	0	1	1	P42771-1	82	83	+	1	P42771-1	51	152	ENST00000479692.2	15	318	++	114	P42771-1#61	0	3	ENST00000479692.2	108	111	+	3	0	-2	8283
P42771-1#61	0	1	1	P42771-1	82	83	+	1	P42771-1	0	156	ENST00000304494.10	30	498	++	24	P42771-1#61	0	3	ENST00000304494.10	276	279	+	3	0	-2	8284
P42771-1#62	0	1	1	P42771-1	82	83	+	1	P42771-1	0	131	ENST00000579122.1	31	424	++	187	P42771-1#62	0	3	ENST00000579122.1	277	280	+	3	0	-2	8285
P42771-1#62	0	1	1	P42771-1	82	83	+	1	P42771-1	51	156	ENST00000578845.2	127	442	++	186	P42771-1#62	0	3	ENST00000578845.2	220	223	+	3	0	-2	8286
P42771-1#62	0	1	1	P42771-1	82	83	+	1	P42771-1	51	156	ENST00000498628.6	484	799	++	126	P42771-1#62	0	3	ENST00000498628.6	577	580	+	3	0	-2	8287
P42771-1#62	0	1	1	P42771-1	82	83	+	1	P42771-1	0	154	ENST00000498124.1	39	501	++	125	P42771-1#62	0	3	ENST00000498124.1	285	288	+	3	0	-2	8288
P42771-1#62	0	1	1	P42771-1	82	83	+	1	P42771-1	51	152	ENST00000497750.1	75	378	++	124	P42771-1#62	0	3	ENST00000497750.1	168	171	+	3	0	-2	8289
P42771-1#62	0	1	1	P42771-1	82	83	+	1	P42771-1	51	156	ENST00000494262.5	624	939	++	121	P42771-1#62	0	3	ENST00000494262.5	717	720	+	3	0	-2	8290
P42771-1#62	0	1	1	P42771-1	82	83	+	1	P42771-1	51	152	ENST00000479692.2	15	318	++	114	P42771-1#62	0	3	ENST00000479692.2	108	111	+	3	0	-2	8291
P42771-1#62	0	1	1	P42771-1	82	83	+	1	P42771-1	0	156	ENST00000304494.10	30	498	++	24	P42771-1#62	0	3	ENST00000304494.10	276	279	+	3	0	-2	8292
P42771-1#63	0	1	1	P42771-1	82	83	+	1	P42771-1	0	131	ENST00000579122.1	31	424	++	187	P42771-1#63	0	3	ENST00000579122.1	277	280	+	3	0	-2	8293
P42771-1#63	0	1	1	P42771-1	82	83	+	1	P42771-1	51	156	ENST00000578845.2	127	442	++	186	P42771-1#63	0	3	ENST00000578845.2	220	223	+	3	0	-2	8294
P42771-1#63	0	1	1	P42771-1	82	83	+	1	P42771-1	51	156	ENST00000498628.6	484	799	++	126	P42771-1#63	0	3	ENST00000498628.6	577	580	+	3	0	-2	8295
P42771-1#63	0	1	1	P42771-1	82	83	+	1	P42771-1	0	154	ENST00000498124.1	39	501	++	125	P42771-1#63	0	3	ENST00000498124.1	285	288	+	3	0	-2	8296
P42771-1#63	0	1	1	P42771-1	82	83	+	1	P42771-1	51	152	ENST00000497750.1	75	378	++	124	P42771-1#63	0	3	ENST00000497750.1	168	171	+	3	0	-2	8297
P42771-1#63	0	1	1	P42771-1	82	83	+	1	P42771-1	51	156	ENST00000494262.5	624	939	++	121	P42771-1#63	0	3	ENST00000494262.5	717	720	+	3	0	-2	8298
P42771-1#63	0	1	1	P42771-1	82	83	+	1	P42771-1	51	152	ENST00000479692.2	15	318	++	114	P42771-1#63	0	3	ENST00000479692.2	108	111	+	3	0	-2	8299
P42771-1#63	0	1	1	P42771-1	82	83	+	1	P42771-1	0	156	ENST00000304494.10	30	498	++	24	P42771-1#63	0	3	ENST00000304494.10	276	279	+	3	0	-2	8300
P42771-1#64	0	1	1	P42771-1	83	84	+	1	P42771-1	0	131	ENST00000579122.1	31	424	++	187	P42771-1#64	0	3	ENST00000579122.1	280	283	+	3	0	-2	8301
P42771-1#64	0	1	1	P42771-1	83	84	+	1	P42771-1	51	156	ENST00000578845.2	127	442	++	186	P42771-1#64	0	3	ENST00000578845.2	223	226	+	3	0	-2	8302
P42771-1#64	0	1	1	P42771-1	83	84	+	1	P42771-1	51	156	ENST00000498628.6	484	799	++	126	P42771-1#64	0	3	ENST00000498628.6	580	583	+	3	0	-2	8303
P42771-1#64	0	1	1	P42771-1	83	84	+	1	P42771-1	0	154	ENST00000498124.1	39	501	++	125	P42771-1#64	0	3	ENST00000498124.1	288	291	+	3	0	-2	8304
P42771-1#64	0	1	1	P42771-1	83	84	+	1	P42771-1	51	152	ENST00000497750.1	75	378	++	124	P42771-1#64	0	3	ENST00000497750.1	171	174	+	3	0	-2	8305
P42771-1#64	0	1	1	P42771-1	83	84	+	1	P42771-1	51	156	ENST00000494262.5	624	939	++	121	P42771-1#64	0	3	ENST00000494262.5	720	723	+	3	0	-2	8306
P42771-1#64	0	1	1	P42771-1	83	84	+	1	P42771-1	51	152	ENST00000479692.2	15	318	++	114	P42771-1#64	0	3	ENST00000479692.2	111	114	+	3	0	-2	8307
P42771-1#64	0	1	1	P42771-1	83	84	+	1	P42771-1	0	156	ENST00000304494.10	30	498	++	24	P42771-1#64	0	3	ENST00000304494.10	279	282	+	3	0	-2	8308
P42771-1#65	0	1	1	P42771-1	83	84	+	1	P42771-1	0	131	ENST00000579122.1	31	424	++	187	P42771-1#65	0	3	ENST00000579122.1	280	283	+	3	0	-2	8309
P42771-1#65	0	1	1	P42771-1	83	84	+	1	P42771-1	51	156	ENST00000578845.2	127	442	++	186	P42771-1#65	0	3	ENST00000578845.2	223	226	+	3	0	-2	8310
P42771-1#65	0	1	1	P42771-1	83	84	+	1	P42771-1	51	156	ENST00000498628.6	484	799	++	126	P42771-1#65	0	3	ENST00000498628.6	580	583	+	3	0	-2	8311
P42771-1#65	0	1	1	P42771-1	83	84	+	1	P42771-1	0	154	ENST00000498124.1	39	501	++	125	P42771-1#65	0	3	ENST00000498124.1	288	291	+	3	0	-2	8312
P42771-1#65	0	1	1	P42771-1	83	84	+	1	P42771-1	51	152	ENST00000497750.1	75	378	++	124	P42771-1#65	0	3	ENST00000497750.1	171	174	+	3	0	-2	8313
P42771-1#65	0	1	1	P42771-1	83	84	+	1	P42771-1	51	156	ENST00000494262.5	624	939	++	121	P42771-1#65	0	3	ENST00000494262.5	720	723	+	3	0	-2	8314
P42771-1#65	0	1	1	P42771-1	83	84	+	1	P42771-1	51	152	ENST00000479692.2	15	318	++	114	P42771-1#65	0	3	ENST00000479692.2	111	114	+	3	0	-2	8315
P42771-1#65	0	1	1	P42771-1	83	84	+	1	P42771-1	0	156	ENST00000304494.10	30	498	++	24	P42771-1#65	0	3	ENST00000304494.10	279	282	+	3	0	-2	8316
P42771-1#66	0	1	1	P42771-1	83	84	+	1	P42771-1	0	131	ENST00000579122.1	31	424	++	187	P42771-1#66	0	3	ENST00000579122.1	280	283	+	3	0	-2	8317
P42771-1#66	0	1	1	P42771-1	83	84	+	1	P42771-1	51	156	ENST00000578845.2	127	442	++	186	P42771-1#66	0	3	ENST00000578845.2	223	226	+	3	0	-2	8318
P42771-1#66	0	1	1	P42771-1	83	84	+	1	P42771-1	51	156	ENST00000498628.6	484	799	++	126	P42771-1#66	0	3	ENST00000498628.6	580	583	+	3	0	-2	8319
P42771-1#66	0	1	1	P42771-1	83	84	+	1	P42771-1	0	154	ENST00000498124.1	39	501	++	125	P42771-1#66	0	3	ENST00000498124.1	288	291	+	3	0	-2	8320
P42771-1#66	0	1	1	P42771-1	83	84	+	1	P42771-1	51	152	ENST00000497750.1	75	378	++	124	P42771-1#66	0	3	ENST00000497750.1	171	174	+	3	0	-2	8321
P42771-1#66	0	1	1	P42771-1	83	84	+	1	P42771-1	51	156	ENST00000494262.5	624	939	++	121	P42771-1#66	0	3	ENST00000494262.5	720	723	+	3	0	-2	8322
P42771-1#66	0	1	1	P42771-1	83	84	+	1	P42771-1	51	152	ENST00000479692.2	15	318	++	114	P42771-1#66	0	3	ENST00000479692.2	111	114	+	3	0	-2	8323
P42771-1#66	0	1	1	P42771-1	83	84	+	1	P42771-1	0	156	ENST00000304494.10	30	498	++	24	P42771-1#66	0	3	ENST00000304494.10	279	282	+	3	0	-2	8324
P42771-1#67	0	1	1	P42771-1	83	84	+	1	P42771-1	0	131	ENST00000579122.1	31	424	++	187	P42771-1#67	0	3	ENST00000579122.1	280	283	+	3	0	-2	8325
P42771-1#67	0	1	1	P42771-1	83	84	+	1	P42771-1	51	156	ENST00000578845.2	127	442	++	186	P42771-1#67	0	3	ENST00000578845.2	223	226	+	3	0	-2	8326
P42771-1#67	0	1	1	P42771-1	83	84	+	1	P42771-1	51	156	ENST00000498628.6	484	799	++	126	P42771-1#67	0	3	ENST00000498628.6	580	583	+	3	0	-2	8327
P42771-1#67	0	1	1	P42771-1	83	84	+	1	P42771-1	0	154	ENST00000498124.1	39	501	++	125	P42771-1#67	0	3	ENST00000498124.1	288	291	+	3	0	-2	8328
P42771-1#67	0	1	1	P42771-1	83	84	+	1	P42771-1	51	152	ENST00000497750.1	75	378	++	124	P42771-1#67	0	3	ENST00000497750.1	171	174	+	3	0	-2	8329
P42771-1#67	0	1	1	P42771-1	83	84	+	1	P42771-1	51	156	ENST00000494262.5	624	939	++	121	P42771-1#67	0	3	ENST00000494262.5	720	723	+	3	0	-2	8330
P42771-1#67	0	1	1	P42771-1	83	84	+	1	P42771-1	51	152	ENST00000479692.2	15	318	++	114	P42771-1#67	0	3	ENST00000479692.2	111	114	+	3	0	-2	8331
P42771-1#67	0	1	1	P42771-1	83	84	+	1	P42771-1	0	156	ENST00000304494.10	30	498	++	24	P42771-1#67	0	3	ENST00000304494.10	279	282	+	3	0	-2	8332
P42771-1#68	0	1	1	P42771-1	84	85	+	1	P42771-1	0	131	ENST00000579122.1	31	424	++	187	P42771-1#68	0	3	ENST00000579122.1	283	286	+	3	0	-2	8333
P42771-1#68	0	1	1	P42771-1	84	85	+	1	P42771-1	51	156	ENST00000578845.2	127	442	++	186	P42771-1#68	0	3	ENST00000578845.2	226	229	+	3	0	-2	8334
P42771-1#68	0	1	1	P42771-1	84	85	+	1	P42771-1	51	156	ENST00000498628.6	484	799	++	126	P42771-1#68	0	3	ENST00000498628.6	583	586	+	3	0	-2	8335
P42771-1#68	0	1	1	P42771-1	84	85	+	1	P42771-1	0	154	ENST00000498124.1	39	501	++	125	P42771-1#68	0	3	ENST00000498124.1	291	294	+	3	0	-2	8336
P42771-1#68	0	1	1	P42771-1	84	85	+	1	P42771-1	51	152	ENST00000497750.1	75	378	++	124	P42771-1#68	0	3	ENST00000497750.1	174	177	+	3	0	-2	8337
P42771-1#68	0	1	1	P42771-1	84	85	+	1	P42771-1	51	156	ENST00000494262.5	624	939	++	121	P42771-1#68	0	3	ENST00000494262.5	723	726	+	3	0	-2	8338
P42771-1#68	0	1	1	P42771-1	84	85	+	1	P42771-1	51	152	ENST00000479692.2	15	318	++	114	P42771-1#68	0	3	ENST00000479692.2	114	117	+	3	0	-2	8339
P42771-1#68	0	1	1	P42771-1	84	85	+	1	P42771-1	0	156	ENST00000304494.10	30	498	++	24	P42771-1#68	0	3	ENST00000304494.10	282	285	+	3	0	-2	8340
P42771-1#69	0	1	1	P42771-1	86	87	+	1	P42771-1	0	131	ENST00000579122.1	31	424	++	187	P42771-1#69	0	3	ENST00000579122.1	289	292	+	3	0	-2	8341
P42771-1#69	0	1	1	P42771-1	86	87	+	1	P42771-1	51	156	ENST00000578845.2	127	442	++	186	P42771-1#69	0	3	ENST00000578845.2	232	235	+	3	0	-2	8342
P42771-1#69	0	1	1	P42771-1	86	87	+	1	P42771-1	51	156	ENST00000498628.6	484	799	++	126	P42771-1#69	0	3	ENST00000498628.6	589	592	+	3	0	-2	8343
P42771-1#69	0	1	1	P42771-1	86	87	+	1	P42771-1	0	154	ENST00000498124.1	39	501	++	125	P42771-1#69	0	3	ENST00000498124.1	297	300	+	3	0	-2	8344
P42771-1#69	0	1	1	P42771-1	86	87	+	1	P42771-1	51	152	ENST00000497750.1	75	378	++	124	P42771-1#69	0	3	ENST00000497750.1	180	183	+	3	0	-2	8345
P42771-1#69	0	1	1	P42771-1	86	87	+	1	P42771-1	51	156	ENST00000494262.5	624	939	++	121	P42771-1#69	0	3	ENST00000494262.5	729	732	+	3	0	-2	8346
P42771-1#69	0	1	1	P42771-1	86	87	+	1	P42771-1	51	152	ENST00000479692.2	15	318	++	114	P42771-1#69	0	3	ENST00000479692.2	120	123	+	3	0	-2	8347
P42771-1#69	0	1	1	P42771-1	86	87	+	1	P42771-1	0	156	ENST00000304494.10	30	498	++	24	P42771-1#69	0	3	ENST00000304494.10	288	291	+	3	0	-2	8348
P42771-1#70	0	1	1	P42771-1	86	87	+	1	P42771-1	0	131	ENST00000579122.1	31	424	++	187	P42771-1#70	0	3	ENST00000579122.1	289	292	+	3	0	-2	8349
P42771-1#70	0	1	1	P42771-1	86	87	+	1	P42771-1	51	156	ENST00000578845.2	127	442	++	186	P42771-1#70	0	3	ENST00000578845.2	232	235	+	3	0	-2	8350
P42771-1#70	0	1	1	P42771-1	86	87	+	1	P42771-1	51	156	ENST00000498628.6	484	799	++	126	P42771-1#70	0	3	ENST00000498628.6	589	592	+	3	0	-2	8351
P42771-1#70	0	1	1	P42771-1	86	87	+	1	P42771-1	0	154	ENST00000498124.1	39	501	++	125	P42771-1#70	0	3	ENST00000498124.1	297	300	+	3	0	-2	8352
P42771-1#70	0	1	1	P42771-1	86	87	+	1	P42771-1	51	152	ENST00000497750.1	75	378	++	124	P42771-1#70	0	3	ENST00000497750.1	180	183	+	3	0	-2	8353
P42771-1#70	0	1	1	P42771-1	86	87	+	1	P42771-1	51	156	ENST00000494262.5	624	939	++	121	P42771-1#70	0	3	ENST00000494262.5	729	732	+	3	0	-2	8354
P42771-1#70	0	1	1	P42771-1	86	87	+	1	P42771-1	51	152	ENST00000479692.2	15	318	++	114	P42771-1#70	0	3	ENST00000479692.2	120	123	+	3	0	-2	8355
P42771-1#70	0	1	1	P42771-1	86	87	+	1	P42771-1	0	156	ENST00000304494.10	30	498	++	24	P42771-1#70	0	3	ENST00000304494.10	288	291	+	3	0	-2	8356
P42771-1#71	0	1	1	P42771-1	87	88	+	1	P42771-1	0	131	ENST00000579122.1	31	424	++	187	P42771-1#71	0	3	ENST00000579122.1	292	295	+	3	0	-2	8357
P42771-1#71	0	1	1	P42771-1	87	88	+	1	P42771-1	51	156	ENST00000578845.2	127	442	++	186	P42771-1#71	0	3	ENST00000578845.2	235	238	+	3	0	-2	8358
P42771-1#71	0	1	1	P42771-1	87	88	+	1	P42771-1	51	156	ENST00000498628.6	484	799	++	126	P42771-1#71	0	3	ENST00000498628.6	592	595	+	3	0	-2	8359
P42771-1#71	0	1	1	P42771-1	87	88	+	1	P42771-1	0	154	ENST00000498124.1	39	501	++	125	P42771-1#71	0	3	ENST00000498124.1	300	303	+	3	0	-2	8360
P42771-1#71	0	1	1	P42771-1	87	88	+	1	P42771-1	51	152	ENST00000497750.1	75	378	++	124	P42771-1#71	0	3	ENST00000497750.1	183	186	+	3	0	-2	8361
P42771-1#71	0	1	1	P42771-1	87	88	+	1	P42771-1	51	156	ENST00000494262.5	624	939	++	121	P42771-1#71	0	3	ENST00000494262.5	732	735	+	3	0	-2	8362
P42771-1#71	0	1	1	P42771-1	87	88	+	1	P42771-1	51	152	ENST00000479692.2	15	318	++	114	P42771-1#71	0	3	ENST00000479692.2	123	126	+	3	0	-2	8363
P42771-1#71	0	1	1	P42771-1	87	88	+	1	P42771-1	0	156	ENST00000304494.10	30	498	++	24	P42771-1#71	0	3	ENST00000304494.10	291	294	+	3	0	-2	8364
P42771-1#72	0	1	1	P42771-1	88	89	+	1	P42771-1	0	131	ENST00000579122.1	31	424	++	187	P42771-1#72	0	3	ENST00000579122.1	295	298	+	3	0	-2	8365
P42771-1#72	0	1	1	P42771-1	88	89	+	1	P42771-1	51	156	ENST00000578845.2	127	442	++	186	P42771-1#72	0	3	ENST00000578845.2	238	241	+	3	0	-2	8366
P42771-1#72	0	1	1	P42771-1	88	89	+	1	P42771-1	51	156	ENST00000498628.6	484	799	++	126	P42771-1#72	0	3	ENST00000498628.6	595	598	+	3	0	-2	8367
P42771-1#72	0	1	1	P42771-1	88	89	+	1	P42771-1	0	154	ENST00000498124.1	39	501	++	125	P42771-1#72	0	3	ENST00000498124.1	303	306	+	3	0	-2	8368
P42771-1#72	0	1	1	P42771-1	88	89	+	1	P42771-1	51	152	ENST00000497750.1	75	378	++	124	P42771-1#72	0	3	ENST00000497750.1	186	189	+	3	0	-2	8369
P42771-1#72	0	1	1	P42771-1	88	89	+	1	P42771-1	51	156	ENST00000494262.5	624	939	++	121	P42771-1#72	0	3	ENST00000494262.5	735	738	+	3	0	-2	8370
P42771-1#72	0	1	1	P42771-1	88	89	+	1	P42771-1	51	152	ENST00000479692.2	15	318	++	114	P42771-1#72	0	3	ENST00000479692.2	126	129	+	3	0	-2	8371
P42771-1#72	0	1	1	P42771-1	88	89	+	1	P42771-1	0	156	ENST00000304494.10	30	498	++	24	P42771-1#72	0	3	ENST00000304494.10	294	297	+	3	0	-2	8372
P42771-1#73	0	1	1	P42771-1	88	89	+	1	P42771-1	0	131	ENST00000579122.1	31	424	++	187	P42771-1#73	0	3	ENST00000579122.1	295	298	+	3	0	-2	8373
P42771-1#73	0	1	1	P42771-1	88	89	+	1	P42771-1	51	156	ENST00000578845.2	127	442	++	186	P42771-1#73	0	3	ENST00000578845.2	238	241	+	3	0	-2	8374
P42771-1#73	0	1	1	P42771-1	88	89	+	1	P42771-1	51	156	ENST00000498628.6	484	799	++	126	P42771-1#73	0	3	ENST00000498628.6	595	598	+	3	0	-2	8375
P42771-1#73	0	1	1	P42771-1	88	89	+	1	P42771-1	0	154	ENST00000498124.1	39	501	++	125	P42771-1#73	0	3	ENST00000498124.1	303	306	+	3	0	-2	8376
P42771-1#73	0	1	1	P42771-1	88	89	+	1	P42771-1	51	152	ENST00000497750.1	75	378	++	124	P42771-1#73	0	3	ENST00000497750.1	186	189	+	3	0	-2	8377
P42771-1#73	0	1	1	P42771-1	88	89	+	1	P42771-1	51	156	ENST00000494262.5	624	939	++	121	P42771-1#73	0	3	ENST00000494262.5	735	738	+	3	0	-2	8378
P42771-1#73	0	1	1	P42771-1	88	89	+	1	P42771-1	51	152	ENST00000479692.2	15	318	++	114	P42771-1#73	0	3	ENST00000479692.2	126	129	+	3	0	-2	8379
P42771-1#73	0	1	1	P42771-1	88	89	+	1	P42771-1	0	156	ENST00000304494.10	30	498	++	24	P42771-1#73	0	3	ENST00000304494.10	294	297	+	3	0	-2	8380
P42771-1#74	0	1	1	P42771-1	92	93	+	1	P42771-1	0	131	ENST00000579122.1	31	424	++	187	P42771-1#74	0	3	ENST00000579122.1	307	310	+	3	0	-2	8381
P42771-1#74	0	1	1	P42771-1	92	93	+	1	P42771-1	51	156	ENST00000578845.2	127	442	++	186	P42771-1#74	0	3	ENST00000578845.2	250	253	+	3	0	-2	8382
P42771-1#74	0	1	1	P42771-1	92	93	+	1	P42771-1	51	156	ENST00000498628.6	484	799	++	126	P42771-1#74	0	3	ENST00000498628.6	607	610	+	3	0	-2	8383
P42771-1#74	0	1	1	P42771-1	92	93	+	1	P42771-1	0	154	ENST00000498124.1	39	501	++	125	P42771-1#74	0	3	ENST00000498124.1	315	318	+	3	0	-2	8384
P42771-1#74	0	1	1	P42771-1	92	93	+	1	P42771-1	51	152	ENST00000497750.1	75	378	++	124	P42771-1#74	0	3	ENST00000497750.1	198	201	+	3	0	-2	8385
P42771-1#74	0	1	1	P42771-1	92	93	+	1	P42771-1	51	156	ENST00000494262.5	624	939	++	121	P42771-1#74	0	3	ENST00000494262.5	747	750	+	3	0	-2	8386
P42771-1#74	0	1	1	P42771-1	92	93	+	1	P42771-1	51	152	ENST00000479692.2	15	318	++	114	P42771-1#74	0	3	ENST00000479692.2	138	141	+	3	0	-2	8387
P42771-1#74	0	1	1	P42771-1	92	93	+	1	P42771-1	0	156	ENST00000304494.10	30	498	++	24	P42771-1#74	0	3	ENST00000304494.10	306	309	+	3	0	-2	8388
P42771-1#75	0	1	1	P42771-1	93	94	+	1	P42771-1	0	131	ENST00000579122.1	31	424	++	187	P42771-1#75	0	3	ENST00000579122.1	310	313	+	3	0	-2	8389
P42771-1#75	0	1	1	P42771-1	93	94	+	1	P42771-1	51	156	ENST00000578845.2	127	442	++	186	P42771-1#75	0	3	ENST00000578845.2	253	256	+	3	0	-2	8390
P42771-1#75	0	1	1	P42771-1	93	94	+	1	P42771-1	51	156	ENST00000498628.6	484	799	++	126	P42771-1#75	0	3	ENST00000498628.6	610	613	+	3	0	-2	8391
P42771-1#75	0	1	1	P42771-1	93	94	+	1	P42771-1	0	154	ENST00000498124.1	39	501	++	125	P42771-1#75	0	3	ENST00000498124.1	318	321	+	3	0	-2	8392
P42771-1#75	0	1	1	P42771-1	93	94	+	1	P42771-1	51	152	ENST00000497750.1	75	378	++	124	P42771-1#75	0	3	ENST00000497750.1	201	204	+	3	0	-2	8393
P42771-1#75	0	1	1	P42771-1	93	94	+	1	P42771-1	51	156	ENST00000494262.5	624	939	++	121	P42771-1#75	0	3	ENST00000494262.5	750	753	+	3	0	-2	8394
P42771-1#75	0	1	1	P42771-1	93	94	+	1	P42771-1	51	152	ENST00000479692.2	15	318	++	114	P42771-1#75	0	3	ENST00000479692.2	141	144	+	3	0	-2	8395
P42771-1#75	0	1	1	P42771-1	93	94	+	1	P42771-1	0	156	ENST00000304494.10	30	498	++	24	P42771-1#75	0	3	ENST00000304494.10	309	312	+	3	0	-2	8396
P42771-1#76	0	1	1	P42771-1	94	95	+	1	P42771-1	0	131	ENST00000579122.1	31	424	++	187	P42771-1#76	0	3	ENST00000579122.1	313	316	+	3	0	-2	8397
P42771-1#76	0	1	1	P42771-1	94	95	+	1	P42771-1	51	156	ENST00000578845.2	127	442	++	186	P42771-1#76	0	3	ENST00000578845.2	256	259	+	3	0	-2	8398
P42771-1#76	0	1	1	P42771-1	94	95	+	1	P42771-1	51	156	ENST00000498628.6	484	799	++	126	P42771-1#76	0	3	ENST00000498628.6	613	616	+	3	0	-2	8399
P42771-1#76	0	1	1	P42771-1	94	95	+	1	P42771-1	0	154	ENST00000498124.1	39	501	++	125	P42771-1#76	0	3	ENST00000498124.1	321	324	+	3	0	-2	8400
P42771-1#76	0	1	1	P42771-1	94	95	+	1	P42771-1	51	152	ENST00000497750.1	75	378	++	124	P42771-1#76	0	3	ENST00000497750.1	204	207	+	3	0	-2	8401
P42771-1#76	0	1	1	P42771-1	94	95	+	1	P42771-1	51	156	ENST00000494262.5	624	939	++	121	P42771-1#76	0	3	ENST00000494262.5	753	756	+	3	0	-2	8402
P42771-1#76	0	1	1	P42771-1	94	95	+	1	P42771-1	51	152	ENST00000479692.2	15	318	++	114	P42771-1#76	0	3	ENST00000479692.2	144	147	+	3	0	-2	8403
P42771-1#76	0	1	1	P42771-1	94	95	+	1	P42771-1	0	156	ENST00000304494.10	30	498	++	24	P42771-1#76	0	3	ENST00000304494.10	312	315	+	3	0	-2	8404
P42771-1#77	0	1	1	P42771-1	96	97	+	1	P42771-1	0	131	ENST00000579122.1	31	424	++	187	P42771-1#77	0	3	ENST00000579122.1	319	322	+	3	0	-2	8405
P42771-1#77	0	1	1	P42771-1	96	97	+	1	P42771-1	51	156	ENST00000578845.2	127	442	++	186	P42771-1#77	0	3	ENST00000578845.2	262	265	+	3	0	-2	8406
P42771-1#77	0	1	1	P42771-1	96	97	+	1	P42771-1	51	156	ENST00000498628.6	484	799	++	126	P42771-1#77	0	3	ENST00000498628.6	619	622	+	3	0	-2	8407
P42771-1#77	0	1	1	P42771-1	96	97	+	1	P42771-1	0	154	ENST00000498124.1	39	501	++	125	P42771-1#77	0	3	ENST00000498124.1	327	330	+	3	0	-2	8408
P42771-1#77	0	1	1	P42771-1	96	97	+	1	P42771-1	51	152	ENST00000497750.1	75	378	++	124	P42771-1#77	0	3	ENST00000497750.1	210	213	+	3	0	-2	8409
P42771-1#77	0	1	1	P42771-1	96	97	+	1	P42771-1	51	156	ENST00000494262.5	624	939	++	121	P42771-1#77	0	3	ENST00000494262.5	759	762	+	3	0	-2	8410
P42771-1#77	0	1	1	P42771-1	96	97	+	1	P42771-1	51	152	ENST00000479692.2	15	318	++	114	P42771-1#77	0	3	ENST00000479692.2	150	153	+	3	0	-2	8411
P42771-1#77	0	1	1	P42771-1	96	97	+	1	P42771-1	0	156	ENST00000304494.10	30	498	++	24	P42771-1#77	0	3	ENST00000304494.10	318	321	+	3	0	-2	8412
P42771-1#78	0	1	1	P42771-1	97	98	+	1	P42771-1	0	131	ENST00000579122.1	31	424	++	187	P42771-1#78	0	3	ENST00000579122.1	322	325	+	3	0	-2	8413
P42771-1#78	0	1	1	P42771-1	97	98	+	1	P42771-1	51	156	ENST00000578845.2	127	442	++	186	P42771-1#78	0	3	ENST00000578845.2	265	268	+	3	0	-2	8414
P42771-1#78	0	1	1	P42771-1	97	98	+	1	P42771-1	51	156	ENST00000498628.6	484	799	++	126	P42771-1#78	0	3	ENST00000498628.6	622	625	+	3	0	-2	8415
P42771-1#78	0	1	1	P42771-1	97	98	+	1	P42771-1	0	154	ENST00000498124.1	39	501	++	125	P42771-1#78	0	3	ENST00000498124.1	330	333	+	3	0	-2	8416
P42771-1#78	0	1	1	P42771-1	97	98	+	1	P42771-1	51	152	ENST00000497750.1	75	378	++	124	P42771-1#78	0	3	ENST00000497750.1	213	216	+	3	0	-2	8417
P42771-1#78	0	1	1	P42771-1	97	98	+	1	P42771-1	51	156	ENST00000494262.5	624	939	++	121	P42771-1#78	0	3	ENST00000494262.5	762	765	+	3	0	-2	8418
P42771-1#78	0	1	1	P42771-1	97	98	+	1	P42771-1	51	152	ENST00000479692.2	15	318	++	114	P42771-1#78	0	3	ENST00000479692.2	153	156	+	3	0	-2	8419
P42771-1#78	0	1	1	P42771-1	97	98	+	1	P42771-1	0	156	ENST00000304494.10	30	498	++	24	P42771-1#78	0	3	ENST00000304494.10	321	324	+	3	0	-2	8420
P42771-1#79	0	1	1	P42771-1	97	98	+	1	P42771-1	0	131	ENST00000579122.1	31	424	++	187	P42771-1#79	0	3	ENST00000579122.1	322	325	+	3	0	-2	8421
P42771-1#79	0	1	1	P42771-1	97	98	+	1	P42771-1	51	156	ENST00000578845.2	127	442	++	186	P42771-1#79	0	3	ENST00000578845.2	265	268	+	3	0	-2	8422
P42771-1#79	0	1	1	P42771-1	97	98	+	1	P42771-1	51	156	ENST00000498628.6	484	799	++	126	P42771-1#79	0	3	ENST00000498628.6	622	625	+	3	0	-2	8423
P42771-1#79	0	1	1	P42771-1	97	98	+	1	P42771-1	0	154	ENST00000498124.1	39	501	++	125	P42771-1#79	0	3	ENST00000498124.1	330	333	+	3	0	-2	8424
P42771-1#79	0	1	1	P42771-1	97	98	+	1	P42771-1	51	152	ENST00000497750.1	75	378	++	124	P42771-1#79	0	3	ENST00000497750.1	213	216	+	3	0	-2	8425
P42771-1#79	0	1	1	P42771-1	97	98	+	1	P42771-1	51	156	ENST00000494262.5	624	939	++	121	P42771-1#79	0	3	ENST00000494262.5	762	765	+	3	0	-2	8426
P42771-1#79	0	1	1	P42771-1	97	98	+	1	P42771-1	51	152	ENST00000479692.2	15	318	++	114	P42771-1#79	0	3	ENST00000479692.2	153	156	+	3	0	-2	8427
P42771-1#79	0	1	1	P42771-1	97	98	+	1	P42771-1	0	156	ENST00000304494.10	30	498	++	24	P42771-1#79	0	3	ENST00000304494.10	321	324	+	3	0	-2	8428
P42771-1#80	0	1	1	P42771-1	98	99	+	1	P42771-1	0	131	ENST00000579122.1	31	424	++	187	P42771-1#80	0	3	ENST00000579122.1	325	328	+	3	0	-2	8429
P42771-1#80	0	1	1	P42771-1	98	99	+	1	P42771-1	51	156	ENST00000578845.2	127	442	++	186	P42771-1#80	0	3	ENST00000578845.2	268	271	+	3	0	-2	8430
P42771-1#80	0	1	1	P42771-1	98	99	+	1	P42771-1	51	156	ENST00000498628.6	484	799	++	126	P42771-1#80	0	3	ENST00000498628.6	625	628	+	3	0	-2	8431
P42771-1#80	0	1	1	P42771-1	98	99	+	1	P42771-1	0	154	ENST00000498124.1	39	501	++	125	P42771-1#80	0	3	ENST00000498124.1	333	336	+	3	0	-2	8432
P42771-1#80	0	1	1	P42771-1	98	99	+	1	P42771-1	51	152	ENST00000497750.1	75	378	++	124	P42771-1#80	0	3	ENST00000497750.1	216	219	+	3	0	-2	8433
P42771-1#80	0	1	1	P42771-1	98	99	+	1	P42771-1	51	156	ENST00000494262.5	624	939	++	121	P42771-1#80	0	3	ENST00000494262.5	765	768	+	3	0	-2	8434
P42771-1#80	0	1	1	P42771-1	98	99	+	1	P42771-1	51	152	ENST00000479692.2	15	318	++	114	P42771-1#80	0	3	ENST00000479692.2	156	159	+	3	0	-2	8435
P42771-1#80	0	1	1	P42771-1	98	99	+	1	P42771-1	0	156	ENST00000304494.10	30	498	++	24	P42771-1#80	0	3	ENST00000304494.10	324	327	+	3	0	-2	8436
P42771-1#81	0	1	1	P42771-1	98	99	+	1	P42771-1	0	131	ENST00000579122.1	31	424	++	187	P42771-1#81	0	3	ENST00000579122.1	325	328	+	3	0	-2	8437
P42771-1#81	0	1	1	P42771-1	98	99	+	1	P42771-1	51	156	ENST00000578845.2	127	442	++	186	P42771-1#81	0	3	ENST00000578845.2	268	271	+	3	0	-2	8438
P42771-1#81	0	1	1	P42771-1	98	99	+	1	P42771-1	51	156	ENST00000498628.6	484	799	++	126	P42771-1#81	0	3	ENST00000498628.6	625	628	+	3	0	-2	8439
P42771-1#81	0	1	1	P42771-1	98	99	+	1	P42771-1	0	154	ENST00000498124.1	39	501	++	125	P42771-1#81	0	3	ENST00000498124.1	333	336	+	3	0	-2	8440
P42771-1#81	0	1	1	P42771-1	98	99	+	1	P42771-1	51	152	ENST00000497750.1	75	378	++	124	P42771-1#81	0	3	ENST00000497750.1	216	219	+	3	0	-2	8441
P42771-1#81	0	1	1	P42771-1	98	99	+	1	P42771-1	51	156	ENST00000494262.5	624	939	++	121	P42771-1#81	0	3	ENST00000494262.5	765	768	+	3	0	-2	8442
P42771-1#81	0	1	1	P42771-1	98	99	+	1	P42771-1	51	152	ENST00000479692.2	15	318	++	114	P42771-1#81	0	3	ENST00000479692.2	156	159	+	3	0	-2	8443
P42771-1#81	0	1	1	P42771-1	98	99	+	1	P42771-1	0	156	ENST00000304494.10	30	498	++	24	P42771-1#81	0	3	ENST00000304494.10	324	327	+	3	0	-2	8444
P42771-1#82	0	1	1	P42771-1	98	99	+	1	P42771-1	0	131	ENST00000579122.1	31	424	++	187	P42771-1#82	0	3	ENST00000579122.1	325	328	+	3	0	-2	8445
P42771-1#82	0	1	1	P42771-1	98	99	+	1	P42771-1	51	156	ENST00000578845.2	127	442	++	186	P42771-1#82	0	3	ENST00000578845.2	268	271	+	3	0	-2	8446
P42771-1#82	0	1	1	P42771-1	98	99	+	1	P42771-1	51	156	ENST00000498628.6	484	799	++	126	P42771-1#82	0	3	ENST00000498628.6	625	628	+	3	0	-2	8447
P42771-1#82	0	1	1	P42771-1	98	99	+	1	P42771-1	0	154	ENST00000498124.1	39	501	++	125	P42771-1#82	0	3	ENST00000498124.1	333	336	+	3	0	-2	8448
P42771-1#82	0	1	1	P42771-1	98	99	+	1	P42771-1	51	152	ENST00000497750.1	75	378	++	124	P42771-1#82	0	3	ENST00000497750.1	216	219	+	3	0	-2	8449
P42771-1#82	0	1	1	P42771-1	98	99	+	1	P42771-1	51	156	ENST00000494262.5	624	939	++	121	P42771-1#82	0	3	ENST00000494262.5	765	768	+	3	0	-2	8450
P42771-1#82	0	1	1	P42771-1	98	99	+	1	P42771-1	51	152	ENST00000479692.2	15	318	++	114	P42771-1#82	0	3	ENST00000479692.2	156	159	+	3	0	-2	8451
P42771-1#82	0	1	1	P42771-1	98	99	+	1	P42771-1	0	156	ENST00000304494.10	30	498	++	24	P42771-1#82	0	3	ENST00000304494.10	324	327	+	3	0	-2	8452
P42771-1#83	0	1	1	P42771-1	99	100	+	1	P42771-1	0	131	ENST00000579122.1	31	424	++	187	P42771-1#83	0	3	ENST00000579122.1	328	331	+	3	0	-2	8453
P42771-1#83	0	1	1	P42771-1	99	100	+	1	P42771-1	51	156	ENST00000578845.2	127	442	++	186	P42771-1#83	0	3	ENST00000578845.2	271	274	+	3	0	-2	8454
P42771-1#83	0	1	1	P42771-1	99	100	+	1	P42771-1	51	156	ENST00000498628.6	484	799	++	126	P42771-1#83	0	3	ENST00000498628.6	628	631	+	3	0	-2	8455
P42771-1#83	0	1	1	P42771-1	99	100	+	1	P42771-1	0	154	ENST00000498124.1	39	501	++	125	P42771-1#83	0	3	ENST00000498124.1	336	339	+	3	0	-2	8456
P42771-1#83	0	1	1	P42771-1	99	100	+	1	P42771-1	51	152	ENST00000497750.1	75	378	++	124	P42771-1#83	0	3	ENST00000497750.1	219	222	+	3	0	-2	8457
P42771-1#83	0	1	1	P42771-1	99	100	+	1	P42771-1	51	156	ENST00000494262.5	624	939	++	121	P42771-1#83	0	3	ENST00000494262.5	768	771	+	3	0	-2	8458
P42771-1#83	0	1	1	P42771-1	99	100	+	1	P42771-1	51	152	ENST00000479692.2	15	318	++	114	P42771-1#83	0	3	ENST00000479692.2	159	162	+	3	0	-2	8459
P42771-1#83	0	1	1	P42771-1	99	100	+	1	P42771-1	0	156	ENST00000304494.10	30	498	++	24	P42771-1#83	0	3	ENST00000304494.10	327	330	+	3	0	-2	8460
P42771-1#84	0	1	1	P42771-1	99	100	+	1	P42771-1	0	131	ENST00000579122.1	31	424	++	187	P42771-1#84	0	3	ENST00000579122.1	328	331	+	3	0	-2	8461
P42771-1#84	0	1	1	P42771-1	99	100	+	1	P42771-1	51	156	ENST00000578845.2	127	442	++	186	P42771-1#84	0	3	ENST00000578845.2	271	274	+	3	0	-2	8462
P42771-1#84	0	1	1	P42771-1	99	100	+	1	P42771-1	51	156	ENST00000498628.6	484	799	++	126	P42771-1#84	0	3	ENST00000498628.6	628	631	+	3	0	-2	8463
P42771-1#84	0	1	1	P42771-1	99	100	+	1	P42771-1	0	154	ENST00000498124.1	39	501	++	125	P42771-1#84	0	3	ENST00000498124.1	336	339	+	3	0	-2	8464
P42771-1#84	0	1	1	P42771-1	99	100	+	1	P42771-1	51	152	ENST00000497750.1	75	378	++	124	P42771-1#84	0	3	ENST00000497750.1	219	222	+	3	0	-2	8465
P42771-1#84	0	1	1	P42771-1	99	100	+	1	P42771-1	51	156	ENST00000494262.5	624	939	++	121	P42771-1#84	0	3	ENST00000494262.5	768	771	+	3	0	-2	8466
P42771-1#84	0	1	1	P42771-1	99	100	+	1	P42771-1	51	152	ENST00000479692.2	15	318	++	114	P42771-1#84	0	3	ENST00000479692.2	159	162	+	3	0	-2	8467
P42771-1#84	0	1	1	P42771-1	99	100	+	1	P42771-1	0	156	ENST00000304494.10	30	498	++	24	P42771-1#84	0	3	ENST00000304494.10	327	330	+	3	0	-2	8468
P42771-1#85	0	1	1	P42771-1	100	101	+	1	P42771-1	0	131	ENST00000579122.1	31	424	++	187	P42771-1#85	0	3	ENST00000579122.1	331	334	+	3	0	-2	8469
P42771-1#85	0	1	1	P42771-1	100	101	+	1	P42771-1	51	156	ENST00000578845.2	127	442	++	186	P42771-1#85	0	3	ENST00000578845.2	274	277	+	3	0	-2	8470
P42771-1#85	0	1	1	P42771-1	100	101	+	1	P42771-1	51	156	ENST00000498628.6	484	799	++	126	P42771-1#85	0	3	ENST00000498628.6	631	634	+	3	0	-2	8471
P42771-1#85	0	1	1	P42771-1	100	101	+	1	P42771-1	0	154	ENST00000498124.1	39	501	++	125	P42771-1#85	0	3	ENST00000498124.1	339	342	+	3	0	-2	8472
P42771-1#85	0	1	1	P42771-1	100	101	+	1	P42771-1	51	152	ENST00000497750.1	75	378	++	124	P42771-1#85	0	3	ENST00000497750.1	222	225	+	3	0	-2	8473
P42771-1#85	0	1	1	P42771-1	100	101	+	1	P42771-1	51	156	ENST00000494262.5	624	939	++	121	P42771-1#85	0	3	ENST00000494262.5	771	774	+	3	0	-2	8474
P42771-1#85	0	1	1	P42771-1	100	101	+	1	P42771-1	51	152	ENST00000479692.2	15	318	++	114	P42771-1#85	0	3	ENST00000479692.2	162	165	+	3	0	-2	8475
P42771-1#85	0	1	1	P42771-1	100	101	+	1	P42771-1	0	156	ENST00000304494.10	30	498	++	24	P42771-1#85	0	3	ENST00000304494.10	330	333	+	3	0	-2	8476
P42771-1#86	0	1	1	P42771-1	101	102	+	1	P42771-1	0	131	ENST00000579122.1	31	424	++	187	P42771-1#86	0	3	ENST00000579122.1	334	337	+	3	0	-2	8477
P42771-1#86	0	1	1	P42771-1	101	102	+	1	P42771-1	51	156	ENST00000578845.2	127	442	++	186	P42771-1#86	0	3	ENST00000578845.2	277	280	+	3	0	-2	8478
P42771-1#86	0	1	1	P42771-1	101	102	+	1	P42771-1	51	156	ENST00000498628.6	484	799	++	126	P42771-1#86	0	3	ENST00000498628.6	634	637	+	3	0	-2	8479
P42771-1#86	0	1	1	P42771-1	101	102	+	1	P42771-1	0	154	ENST00000498124.1	39	501	++	125	P42771-1#86	0	3	ENST00000498124.1	342	345	+	3	0	-2	8480
P42771-1#86	0	1	1	P42771-1	101	102	+	1	P42771-1	51	152	ENST00000497750.1	75	378	++	124	P42771-1#86	0	3	ENST00000497750.1	225	228	+	3	0	-2	8481
P42771-1#86	0	1	1	P42771-1	101	102	+	1	P42771-1	51	156	ENST00000494262.5	624	939	++	121	P42771-1#86	0	3	ENST00000494262.5	774	777	+	3	0	-2	8482
P42771-1#86	0	1	1	P42771-1	101	102	+	1	P42771-1	51	152	ENST00000479692.2	15	318	++	114	P42771-1#86	0	3	ENST00000479692.2	165	168	+	3	0	-2	8483
P42771-1#86	0	1	1	P42771-1	101	102	+	1	P42771-1	0	156	ENST00000304494.10	30	498	++	24	P42771-1#86	0	3	ENST00000304494.10	333	336	+	3	0	-2	8484
P42771-1#87	0	1	1	P42771-1	101	102	+	1	P42771-1	0	131	ENST00000579122.1	31	424	++	187	P42771-1#87	0	3	ENST00000579122.1	334	337	+	3	0	-2	8485
P42771-1#87	0	1	1	P42771-1	101	102	+	1	P42771-1	51	156	ENST00000578845.2	127	442	++	186	P42771-1#87	0	3	ENST00000578845.2	277	280	+	3	0	-2	8486
P42771-1#87	0	1	1	P42771-1	101	102	+	1	P42771-1	51	156	ENST00000498628.6	484	799	++	126	P42771-1#87	0	3	ENST00000498628.6	634	637	+	3	0	-2	8487
P42771-1#87	0	1	1	P42771-1	101	102	+	1	P42771-1	0	154	ENST00000498124.1	39	501	++	125	P42771-1#87	0	3	ENST00000498124.1	342	345	+	3	0	-2	8488
P42771-1#87	0	1	1	P42771-1	101	102	+	1	P42771-1	51	152	ENST00000497750.1	75	378	++	124	P42771-1#87	0	3	ENST00000497750.1	225	228	+	3	0	-2	8489
P42771-1#87	0	1	1	P42771-1	101	102	+	1	P42771-1	51	156	ENST00000494262.5	624	939	++	121	P42771-1#87	0	3	ENST00000494262.5	774	777	+	3	0	-2	8490
P42771-1#87	0	1	1	P42771-1	101	102	+	1	P42771-1	51	152	ENST00000479692.2	15	318	++	114	P42771-1#87	0	3	ENST00000479692.2	165	168	+	3	0	-2	8491
P42771-1#87	0	1	1	P42771-1	101	102	+	1	P42771-1	0	156	ENST00000304494.10	30	498	++	24	P42771-1#87	0	3	ENST00000304494.10	333	336	+	3	0	-2	8492
P42771-1#88	0	2	2	P42771-1	103	105	+	2	P42771-1	0	131	ENST00000579122.1	31	424	++	187	P42771-1#88	0	6	ENST00000579122.1	340	346	+	6	0	-4	8493
P42771-1#88	0	2	2	P42771-1	103	105	+	2	P42771-1	51	156	ENST00000578845.2	127	442	++	186	P42771-1#88	0	6	ENST00000578845.2	283	289	+	6	0	-4	8494
P42771-1#88	0	2	2	P42771-1	103	105	+	2	P42771-1	51	156	ENST00000498628.6	484	799	++	126	P42771-1#88	0	6	ENST00000498628.6	640	646	+	6	0	-4	8495
P42771-1#88	0	2	2	P42771-1	103	105	+	2	P42771-1	0	154	ENST00000498124.1	39	501	++	125	P42771-1#88	0	6	ENST00000498124.1	348	354	+	6	0	-4	8496
P42771-1#88	0	2	2	P42771-1	103	105	+	2	P42771-1	51	152	ENST00000497750.1	75	378	++	124	P42771-1#88	0	6	ENST00000497750.1	231	237	+	6	0	-4	8497
P42771-1#88	0	2	2	P42771-1	103	105	+	2	P42771-1	51	156	ENST00000494262.5	624	939	++	121	P42771-1#88	0	6	ENST00000494262.5	780	786	+	6	0	-4	8498
P42771-1#88	0	2	2	P42771-1	103	105	+	2	P42771-1	51	152	ENST00000479692.2	15	318	++	114	P42771-1#88	0	6	ENST00000479692.2	171	177	+	6	0	-4	8499
P42771-1#88	0	2	2	P42771-1	103	105	+	2	P42771-1	0	156	ENST00000304494.10	30	498	++	24	P42771-1#88	0	6	ENST00000304494.10	339	345	+	6	0	-4	8500
P42771-1#89	0	1	1	P42771-1	106	107	+	1	P42771-1	0	131	ENST00000579122.1	31	424	++	187	P42771-1#89	0	3	ENST00000579122.1	349	352	+	3	0	-2	8501
P42771-1#89	0	1	1	P42771-1	106	107	+	1	P42771-1	51	156	ENST00000578845.2	127	442	++	186	P42771-1#89	0	3	ENST00000578845.2	292	295	+	3	0	-2	8502
P42771-1#89	0	1	1	P42771-1	106	107	+	1	P42771-1	51	156	ENST00000498628.6	484	799	++	126	P42771-1#89	0	3	ENST00000498628.6	649	652	+	3	0	-2	8503
P42771-1#89	0	1	1	P42771-1	106	107	+	1	P42771-1	0	154	ENST00000498124.1	39	501	++	125	P42771-1#89	0	3	ENST00000498124.1	357	360	+	3	0	-2	8504
P42771-1#89	0	1	1	P42771-1	106	107	+	1	P42771-1	51	152	ENST00000497750.1	75	378	++	124	P42771-1#89	0	3	ENST00000497750.1	240	243	+	3	0	-2	8505
P42771-1#89	0	1	1	P42771-1	106	107	+	1	P42771-1	51	156	ENST00000494262.5	624	939	++	121	P42771-1#89	0	3	ENST00000494262.5	789	792	+	3	0	-2	8506
P42771-1#89	0	1	1	P42771-1	106	107	+	1	P42771-1	51	152	ENST00000479692.2	15	318	++	114	P42771-1#89	0	3	ENST00000479692.2	180	183	+	3	0	-2	8507
P42771-1#89	0	1	1	P42771-1	106	107	+	1	P42771-1	0	156	ENST00000304494.10	30	498	++	24	P42771-1#89	0	3	ENST00000304494.10	348	351	+	3	0	-2	8508
P42771-1#90	0	1	1	P42771-1	106	107	+	1	P42771-1	0	131	ENST00000579122.1	31	424	++	187	P42771-1#90	0	3	ENST00000579122.1	349	352	+	3	0	-2	8509
P42771-1#90	0	1	1	P42771-1	106	107	+	1	P42771-1	51	156	ENST00000578845.2	127	442	++	186	P42771-1#90	0	3	ENST00000578845.2	292	295	+	3	0	-2	8510
P42771-1#90	0	1	1	P42771-1	106	107	+	1	P42771-1	51	156	ENST00000498628.6	484	799	++	126	P42771-1#90	0	3	ENST00000498628.6	649	652	+	3	0	-2	8511
P42771-1#90	0	1	1	P42771-1	106	107	+	1	P42771-1	0	154	ENST00000498124.1	39	501	++	125	P42771-1#90	0	3	ENST00000498124.1	357	360	+	3	0	-2	8512
P42771-1#90	0	1	1	P42771-1	106	107	+	1	P42771-1	51	152	ENST00000497750.1	75	378	++	124	P42771-1#90	0	3	ENST00000497750.1	240	243	+	3	0	-2	8513
P42771-1#90	0	1	1	P42771-1	106	107	+	1	P42771-1	51	156	ENST00000494262.5	624	939	++	121	P42771-1#90	0	3	ENST00000494262.5	789	792	+	3	0	-2	8514
P42771-1#90	0	1	1	P42771-1	106	107	+	1	P42771-1	51	152	ENST00000479692.2	15	318	++	114	P42771-1#90	0	3	ENST00000479692.2	180	183	+	3	0	-2	8515
P42771-1#90	0	1	1	P42771-1	106	107	+	1	P42771-1	0	156	ENST00000304494.10	30	498	++	24	P42771-1#90	0	3	ENST00000304494.10	348	351	+	3	0	-2	8516
P42771-1#91	0	1	1	P42771-1	107	108	+	1	P42771-1	0	131	ENST00000579122.1	31	424	++	187	P42771-1#91	0	3	ENST00000579122.1	352	355	+	3	0	-2	8517
P42771-1#91	0	1	1	P42771-1	107	108	+	1	P42771-1	51	156	ENST00000578845.2	127	442	++	186	P42771-1#91	0	3	ENST00000578845.2	295	298	+	3	0	-2	8518
P42771-1#91	0	1	1	P42771-1	107	108	+	1	P42771-1	51	156	ENST00000498628.6	484	799	++	126	P42771-1#91	0	3	ENST00000498628.6	652	655	+	3	0	-2	8519
P42771-1#91	0	1	1	P42771-1	107	108	+	1	P42771-1	0	154	ENST00000498124.1	39	501	++	125	P42771-1#91	0	3	ENST00000498124.1	360	363	+	3	0	-2	8520
P42771-1#91	0	1	1	P42771-1	107	108	+	1	P42771-1	51	152	ENST00000497750.1	75	378	++	124	P42771-1#91	0	3	ENST00000497750.1	243	246	+	3	0	-2	8521
P42771-1#91	0	1	1	P42771-1	107	108	+	1	P42771-1	51	156	ENST00000494262.5	624	939	++	121	P42771-1#91	0	3	ENST00000494262.5	792	795	+	3	0	-2	8522
P42771-1#91	0	1	1	P42771-1	107	108	+	1	P42771-1	51	152	ENST00000479692.2	15	318	++	114	P42771-1#91	0	3	ENST00000479692.2	183	186	+	3	0	-2	8523
P42771-1#91	0	1	1	P42771-1	107	108	+	1	P42771-1	0	156	ENST00000304494.10	30	498	++	24	P42771-1#91	0	3	ENST00000304494.10	351	354	+	3	0	-2	8524
P42771-1#92	0	1	1	P42771-1	107	108	+	1	P42771-1	0	131	ENST00000579122.1	31	424	++	187	P42771-1#92	0	3	ENST00000579122.1	352	355	+	3	0	-2	8525
P42771-1#92	0	1	1	P42771-1	107	108	+	1	P42771-1	51	156	ENST00000578845.2	127	442	++	186	P42771-1#92	0	3	ENST00000578845.2	295	298	+	3	0	-2	8526
P42771-1#92	0	1	1	P42771-1	107	108	+	1	P42771-1	51	156	ENST00000498628.6	484	799	++	126	P42771-1#92	0	3	ENST00000498628.6	652	655	+	3	0	-2	8527
P42771-1#92	0	1	1	P42771-1	107	108	+	1	P42771-1	0	154	ENST00000498124.1	39	501	++	125	P42771-1#92	0	3	ENST00000498124.1	360	363	+	3	0	-2	8528
P42771-1#92	0	1	1	P42771-1	107	108	+	1	P42771-1	51	152	ENST00000497750.1	75	378	++	124	P42771-1#92	0	3	ENST00000497750.1	243	246	+	3	0	-2	8529
P42771-1#92	0	1	1	P42771-1	107	108	+	1	P42771-1	51	156	ENST00000494262.5	624	939	++	121	P42771-1#92	0	3	ENST00000494262.5	792	795	+	3	0	-2	8530
P42771-1#92	0	1	1	P42771-1	107	108	+	1	P42771-1	51	152	ENST00000479692.2	15	318	++	114	P42771-1#92	0	3	ENST00000479692.2	183	186	+	3	0	-2	8531
P42771-1#92	0	1	1	P42771-1	107	108	+	1	P42771-1	0	156	ENST00000304494.10	30	498	++	24	P42771-1#92	0	3	ENST00000304494.10	351	354	+	3	0	-2	8532
P42771-1#93	0	1	1	P42771-1	111	112	+	1	P42771-1	0	131	ENST00000579122.1	31	424	++	187	P42771-1#93	0	3	ENST00000579122.1	364	367	+	3	0	-2	8533
P42771-1#93	0	1	1	P42771-1	111	112	+	1	P42771-1	51	156	ENST00000578845.2	127	442	++	186	P42771-1#93	0	3	ENST00000578845.2	307	310	+	3	0	-2	8534
P42771-1#93	0	1	1	P42771-1	111	112	+	1	P42771-1	51	156	ENST00000498628.6	484	799	++	126	P42771-1#93	0	3	ENST00000498628.6	664	667	+	3	0	-2	8535
P42771-1#93	0	1	1	P42771-1	111	112	+	1	P42771-1	0	154	ENST00000498124.1	39	501	++	125	P42771-1#93	0	3	ENST00000498124.1	372	375	+	3	0	-2	8536
P42771-1#93	0	1	1	P42771-1	111	112	+	1	P42771-1	51	152	ENST00000497750.1	75	378	++	124	P42771-1#93	0	3	ENST00000497750.1	255	258	+	3	0	-2	8537
P42771-1#93	0	1	1	P42771-1	111	112	+	1	P42771-1	51	156	ENST00000494262.5	624	939	++	121	P42771-1#93	0	3	ENST00000494262.5	804	807	+	3	0	-2	8538
P42771-1#93	0	1	1	P42771-1	111	112	+	1	P42771-1	51	152	ENST00000479692.2	15	318	++	114	P42771-1#93	0	3	ENST00000479692.2	195	198	+	3	0	-2	8539
P42771-1#93	0	1	1	P42771-1	111	112	+	1	P42771-1	0	156	ENST00000304494.10	30	498	++	24	P42771-1#93	0	3	ENST00000304494.10	363	366	+	3	0	-2	8540
P42771-1#94	0	1	1	P42771-1	113	114	+	1	P42771-1	0	131	ENST00000579122.1	31	424	++	187	P42771-1#94	0	3	ENST00000579122.1	370	373	+	3	0	-2	8541
P42771-1#94	0	1	1	P42771-1	113	114	+	1	P42771-1	51	156	ENST00000578845.2	127	442	++	186	P42771-1#94	0	3	ENST00000578845.2	313	316	+	3	0	-2	8542
P42771-1#94	0	1	1	P42771-1	113	114	+	1	P42771-1	51	156	ENST00000498628.6	484	799	++	126	P42771-1#94	0	3	ENST00000498628.6	670	673	+	3	0	-2	8543
P42771-1#94	0	1	1	P42771-1	113	114	+	1	P42771-1	0	154	ENST00000498124.1	39	501	++	125	P42771-1#94	0	3	ENST00000498124.1	378	381	+	3	0	-2	8544
P42771-1#94	0	1	1	P42771-1	113	114	+	1	P42771-1	51	152	ENST00000497750.1	75	378	++	124	P42771-1#94	0	3	ENST00000497750.1	261	264	+	3	0	-2	8545
P42771-1#94	0	1	1	P42771-1	113	114	+	1	P42771-1	51	156	ENST00000494262.5	624	939	++	121	P42771-1#94	0	3	ENST00000494262.5	810	813	+	3	0	-2	8546
P42771-1#94	0	1	1	P42771-1	113	114	+	1	P42771-1	51	152	ENST00000479692.2	15	318	++	114	P42771-1#94	0	3	ENST00000479692.2	201	204	+	3	0	-2	8547
P42771-1#94	0	1	1	P42771-1	113	114	+	1	P42771-1	0	156	ENST00000304494.10	30	498	++	24	P42771-1#94	0	3	ENST00000304494.10	369	372	+	3	0	-2	8548
P42771-1#95	0	1	1	P42771-1	113	114	+	1	P42771-1	0	131	ENST00000579122.1	31	424	++	187	P42771-1#95	0	3	ENST00000579122.1	370	373	+	3	0	-2	8549
P42771-1#95	0	1	1	P42771-1	113	114	+	1	P42771-1	51	156	ENST00000578845.2	127	442	++	186	P42771-1#95	0	3	ENST00000578845.2	313	316	+	3	0	-2	8550
P42771-1#95	0	1	1	P42771-1	113	114	+	1	P42771-1	51	156	ENST00000498628.6	484	799	++	126	P42771-1#95	0	3	ENST00000498628.6	670	673	+	3	0	-2	8551
P42771-1#95	0	1	1	P42771-1	113	114	+	1	P42771-1	0	154	ENST00000498124.1	39	501	++	125	P42771-1#95	0	3	ENST00000498124.1	378	381	+	3	0	-2	8552
P42771-1#95	0	1	1	P42771-1	113	114	+	1	P42771-1	51	152	ENST00000497750.1	75	378	++	124	P42771-1#95	0	3	ENST00000497750.1	261	264	+	3	0	-2	8553
P42771-1#95	0	1	1	P42771-1	113	114	+	1	P42771-1	51	156	ENST00000494262.5	624	939	++	121	P42771-1#95	0	3	ENST00000494262.5	810	813	+	3	0	-2	8554
P42771-1#95	0	1	1	P42771-1	113	114	+	1	P42771-1	51	152	ENST00000479692.2	15	318	++	114	P42771-1#95	0	3	ENST00000479692.2	201	204	+	3	0	-2	8555
P42771-1#95	0	1	1	P42771-1	113	114	+	1	P42771-1	0	156	ENST00000304494.10	30	498	++	24	P42771-1#95	0	3	ENST00000304494.10	369	372	+	3	0	-2	8556
P42771-1#96	0	1	1	P42771-1	116	117	+	1	P42771-1	0	131	ENST00000579122.1	31	424	++	187	P42771-1#96	0	3	ENST00000579122.1	379	382	+	3	0	-2	8557
P42771-1#96	0	1	1	P42771-1	116	117	+	1	P42771-1	51	156	ENST00000578845.2	127	442	++	186	P42771-1#96	0	3	ENST00000578845.2	322	325	+	3	0	-2	8558
P42771-1#96	0	1	1	P42771-1	116	117	+	1	P42771-1	51	156	ENST00000498628.6	484	799	++	126	P42771-1#96	0	3	ENST00000498628.6	679	682	+	3	0	-2	8559
P42771-1#96	0	1	1	P42771-1	116	117	+	1	P42771-1	0	154	ENST00000498124.1	39	501	++	125	P42771-1#96	0	3	ENST00000498124.1	387	390	+	3	0	-2	8560
P42771-1#96	0	1	1	P42771-1	116	117	+	1	P42771-1	51	152	ENST00000497750.1	75	378	++	124	P42771-1#96	0	3	ENST00000497750.1	270	273	+	3	0	-2	8561
P42771-1#96	0	1	1	P42771-1	116	117	+	1	P42771-1	51	156	ENST00000494262.5	624	939	++	121	P42771-1#96	0	3	ENST00000494262.5	819	822	+	3	0	-2	8562
P42771-1#96	0	1	1	P42771-1	116	117	+	1	P42771-1	51	152	ENST00000479692.2	15	318	++	114	P42771-1#96	0	3	ENST00000479692.2	210	213	+	3	0	-2	8563
P42771-1#96	0	1	1	P42771-1	116	117	+	1	P42771-1	0	156	ENST00000304494.10	30	498	++	24	P42771-1#96	0	3	ENST00000304494.10	378	381	+	3	0	-2	8564
P42771-1#97	0	1	1	P42771-1	117	118	+	1	P42771-1	0	131	ENST00000579122.1	31	424	++	187	P42771-1#97	0	3	ENST00000579122.1	382	385	+	3	0	-2	8565
P42771-1#97	0	1	1	P42771-1	117	118	+	1	P42771-1	51	156	ENST00000578845.2	127	442	++	186	P42771-1#97	0	3	ENST00000578845.2	325	328	+	3	0	-2	8566
P42771-1#97	0	1	1	P42771-1	117	118	+	1	P42771-1	51	156	ENST00000498628.6	484	799	++	126	P42771-1#97	0	3	ENST00000498628.6	682	685	+	3	0	-2	8567
P42771-1#97	0	1	1	P42771-1	117	118	+	1	P42771-1	0	154	ENST00000498124.1	39	501	++	125	P42771-1#97	0	3	ENST00000498124.1	390	393	+	3	0	-2	8568
P42771-1#97	0	1	1	P42771-1	117	118	+	1	P42771-1	51	152	ENST00000497750.1	75	378	++	124	P42771-1#97	0	3	ENST00000497750.1	273	276	+	3	0	-2	8569
P42771-1#97	0	1	1	P42771-1	117	118	+	1	P42771-1	51	156	ENST00000494262.5	624	939	++	121	P42771-1#97	0	3	ENST00000494262.5	822	825	+	3	0	-2	8570
P42771-1#97	0	1	1	P42771-1	117	118	+	1	P42771-1	51	152	ENST00000479692.2	15	318	++	114	P42771-1#97	0	3	ENST00000479692.2	213	216	+	3	0	-2	8571
P42771-1#97	0	1	1	P42771-1	117	118	+	1	P42771-1	0	156	ENST00000304494.10	30	498	++	24	P42771-1#97	0	3	ENST00000304494.10	381	384	+	3	0	-2	8572
P42771-1#98	0	1	1	P42771-1	118	119	+	1	P42771-1	0	131	ENST00000579122.1	31	424	++	187	P42771-1#98	0	3	ENST00000579122.1	385	388	+	3	0	-2	8573
P42771-1#98	0	1	1	P42771-1	118	119	+	1	P42771-1	51	156	ENST00000578845.2	127	442	++	186	P42771-1#98	0	3	ENST00000578845.2	328	331	+	3	0	-2	8574
P42771-1#98	0	1	1	P42771-1	118	119	+	1	P42771-1	51	156	ENST00000498628.6	484	799	++	126	P42771-1#98	0	3	ENST00000498628.6	685	688	+	3	0	-2	8575
P42771-1#98	0	1	1	P42771-1	118	119	+	1	P42771-1	0	154	ENST00000498124.1	39	501	++	125	P42771-1#98	0	3	ENST00000498124.1	393	396	+	3	0	-2	8576
P42771-1#98	0	1	1	P42771-1	118	119	+	1	P42771-1	51	152	ENST00000497750.1	75	378	++	124	P42771-1#98	0	3	ENST00000497750.1	276	279	+	3	0	-2	8577
P42771-1#98	0	1	1	P42771-1	118	119	+	1	P42771-1	51	156	ENST00000494262.5	624	939	++	121	P42771-1#98	0	3	ENST00000494262.5	825	828	+	3	0	-2	8578
P42771-1#98	0	1	1	P42771-1	118	119	+	1	P42771-1	51	152	ENST00000479692.2	15	318	++	114	P42771-1#98	0	3	ENST00000479692.2	216	219	+	3	0	-2	8579
P42771-1#98	0	1	1	P42771-1	118	119	+	1	P42771-1	0	156	ENST00000304494.10	30	498	++	24	P42771-1#98	0	3	ENST00000304494.10	384	387	+	3	0	-2	8580
P42771-1#99	0	1	1	P42771-1	119	120	+	1	P42771-1	0	131	ENST00000579122.1	31	424	++	187	P42771-1#99	0	3	ENST00000579122.1	388	391	+	3	0	-2	8581
P42771-1#99	0	1	1	P42771-1	119	120	+	1	P42771-1	51	156	ENST00000578845.2	127	442	++	186	P42771-1#99	0	3	ENST00000578845.2	331	334	+	3	0	-2	8582
P42771-1#99	0	1	1	P42771-1	119	120	+	1	P42771-1	51	156	ENST00000498628.6	484	799	++	126	P42771-1#99	0	3	ENST00000498628.6	688	691	+	3	0	-2	8583
P42771-1#99	0	1	1	P42771-1	119	120	+	1	P42771-1	0	154	ENST00000498124.1	39	501	++	125	P42771-1#99	0	3	ENST00000498124.1	396	399	+	3	0	-2	8584
P42771-1#99	0	1	1	P42771-1	119	120	+	1	P42771-1	51	152	ENST00000497750.1	75	378	++	124	P42771-1#99	0	3	ENST00000497750.1	279	282	+	3	0	-2	8585
P42771-1#99	0	1	1	P42771-1	119	120	+	1	P42771-1	51	156	ENST00000494262.5	624	939	++	121	P42771-1#99	0	3	ENST00000494262.5	828	831	+	3	0	-2	8586
P42771-1#99	0	1	1	P42771-1	119	120	+	1	P42771-1	51	152	ENST00000479692.2	15	318	++	114	P42771-1#99	0	3	ENST00000479692.2	219	222	+	3	0	-2	8587
P42771-1#99	0	1	1	P42771-1	119	120	+	1	P42771-1	0	156	ENST00000304494.10	30	498	++	24	P42771-1#99	0	3	ENST00000304494.10	387	390	+	3	0	-2	8588
P42771-1#100	0	1	1	P42771-1	119	120	+	1	P42771-1	0	131	ENST00000579122.1	31	424	++	187	P42771-1#100	0	3	ENST00000579122.1	388	391	+	3	0	-2	8589
P42771-1#100	0	1	1	P42771-1	119	120	+	1	P42771-1	51	156	ENST00000578845.2	127	442	++	186	P42771-1#100	0	3	ENST00000578845.2	331	334	+	3	0	-2	8590
P42771-1#100	0	1	1	P42771-1	119	120	+	1	P42771-1	51	156	ENST00000498628.6	484	799	++	126	P42771-1#100	0	3	ENST00000498628.6	688	691	+	3	0	-2	8591
P42771-1#100	0	1	1	P42771-1	119	120	+	1	P42771-1	0	154	ENST00000498124.1	39	501	++	125	P42771-1#100	0	3	ENST00000498124.1	396	399	+	3	0	-2	8592
P42771-1#100	0	1	1	P42771-1	119	120	+	1	P42771-1	51	152	ENST00000497750.1	75	378	++	124	P42771-1#100	0	3	ENST00000497750.1	279	282	+	3	0	-2	8593
P42771-1#100	0	1	1	P42771-1	119	120	+	1	P42771-1	51	156	ENST00000494262.5	624	939	++	121	P42771-1#100	0	3	ENST00000494262.5	828	831	+	3	0	-2	8594
P42771-1#100	0	1	1	P42771-1	119	120	+	1	P42771-1	51	152	ENST00000479692.2	15	318	++	114	P42771-1#100	0	3	ENST00000479692.2	219	222	+	3	0	-2	8595
P42771-1#100	0	1	1	P42771-1	119	120	+	1	P42771-1	0	156	ENST00000304494.10	30	498	++	24	P42771-1#100	0	3	ENST00000304494.10	387	390	+	3	0	-2	8596
P42771-1#101	0	1	1	P42771-1	121	122	+	1	P42771-1	0	131	ENST00000579122.1	31	424	++	187	P42771-1#101	0	3	ENST00000579122.1	394	397	+	3	0	-2	8597
P42771-1#101	0	1	1	P42771-1	121	122	+	1	P42771-1	51	156	ENST00000578845.2	127	442	++	186	P42771-1#101	0	3	ENST00000578845.2	337	340	+	3	0	-2	8598
P42771-1#101	0	1	1	P42771-1	121	122	+	1	P42771-1	51	156	ENST00000498628.6	484	799	++	126	P42771-1#101	0	3	ENST00000498628.6	694	697	+	3	0	-2	8599
P42771-1#101	0	1	1	P42771-1	121	122	+	1	P42771-1	0	154	ENST00000498124.1	39	501	++	125	P42771-1#101	0	3	ENST00000498124.1	402	405	+	3	0	-2	8600
P42771-1#101	0	1	1	P42771-1	121	122	+	1	P42771-1	51	152	ENST00000497750.1	75	378	++	124	P42771-1#101	0	3	ENST00000497750.1	285	288	+	3	0	-2	8601
P42771-1#101	0	1	1	P42771-1	121	122	+	1	P42771-1	51	156	ENST00000494262.5	624	939	++	121	P42771-1#101	0	3	ENST00000494262.5	834	837	+	3	0	-2	8602
P42771-1#101	0	1	1	P42771-1	121	122	+	1	P42771-1	51	152	ENST00000479692.2	15	318	++	114	P42771-1#101	0	3	ENST00000479692.2	225	228	+	3	0	-2	8603
P42771-1#101	0	1	1	P42771-1	121	122	+	1	P42771-1	0	156	ENST00000304494.10	30	498	++	24	P42771-1#101	0	3	ENST00000304494.10	393	396	+	3	0	-2	8604
P42771-1#102	0	1	1	P42771-1	121	122	+	1	P42771-1	0	131	ENST00000579122.1	31	424	++	187	P42771-1#102	0	3	ENST00000579122.1	394	397	+	3	0	-2	8605
P42771-1#102	0	1	1	P42771-1	121	122	+	1	P42771-1	51	156	ENST00000578845.2	127	442	++	186	P42771-1#102	0	3	ENST00000578845.2	337	340	+	3	0	-2	8606
P42771-1#102	0	1	1	P42771-1	121	122	+	1	P42771-1	51	156	ENST00000498628.6	484	799	++	126	P42771-1#102	0	3	ENST00000498628.6	694	697	+	3	0	-2	8607
P42771-1#102	0	1	1	P42771-1	121	122	+	1	P42771-1	0	154	ENST00000498124.1	39	501	++	125	P42771-1#102	0	3	ENST00000498124.1	402	405	+	3	0	-2	8608
P42771-1#102	0	1	1	P42771-1	121	122	+	1	P42771-1	51	152	ENST00000497750.1	75	378	++	124	P42771-1#102	0	3	ENST00000497750.1	285	288	+	3	0	-2	8609
P42771-1#102	0	1	1	P42771-1	121	122	+	1	P42771-1	51	156	ENST00000494262.5	624	939	++	121	P42771-1#102	0	3	ENST00000494262.5	834	837	+	3	0	-2	8610
P42771-1#102	0	1	1	P42771-1	121	122	+	1	P42771-1	51	152	ENST00000479692.2	15	318	++	114	P42771-1#102	0	3	ENST00000479692.2	225	228	+	3	0	-2	8611
P42771-1#102	0	1	1	P42771-1	121	122	+	1	P42771-1	0	156	ENST00000304494.10	30	498	++	24	P42771-1#102	0	3	ENST00000304494.10	393	396	+	3	0	-2	8612
P42771-1#103	0	1	1	P42771-1	122	123	+	1	P42771-1	0	131	ENST00000579122.1	31	424	++	187	P42771-1#103	0	3	ENST00000579122.1	397	400	+	3	0	-2	8613
P42771-1#103	0	1	1	P42771-1	122	123	+	1	P42771-1	51	156	ENST00000578845.2	127	442	++	186	P42771-1#103	0	3	ENST00000578845.2	340	343	+	3	0	-2	8614
P42771-1#103	0	1	1	P42771-1	122	123	+	1	P42771-1	51	156	ENST00000498628.6	484	799	++	126	P42771-1#103	0	3	ENST00000498628.6	697	700	+	3	0	-2	8615
P42771-1#103	0	1	1	P42771-1	122	123	+	1	P42771-1	0	154	ENST00000498124.1	39	501	++	125	P42771-1#103	0	3	ENST00000498124.1	405	408	+	3	0	-2	8616
P42771-1#103	0	1	1	P42771-1	122	123	+	1	P42771-1	51	152	ENST00000497750.1	75	378	++	124	P42771-1#103	0	3	ENST00000497750.1	288	291	+	3	0	-2	8617
P42771-1#103	0	1	1	P42771-1	122	123	+	1	P42771-1	51	156	ENST00000494262.5	624	939	++	121	P42771-1#103	0	3	ENST00000494262.5	837	840	+	3	0	-2	8618
P42771-1#103	0	1	1	P42771-1	122	123	+	1	P42771-1	51	152	ENST00000479692.2	15	318	++	114	P42771-1#103	0	3	ENST00000479692.2	228	231	+	3	0	-2	8619
P42771-1#103	0	1	1	P42771-1	122	123	+	1	P42771-1	0	156	ENST00000304494.10	30	498	++	24	P42771-1#103	0	3	ENST00000304494.10	396	399	+	3	0	-2	8620
P42771-1#104	0	1	1	P42771-1	123	124	+	1	P42771-1	0	131	ENST00000579122.1	31	424	++	187	P42771-1#104	0	3	ENST00000579122.1	400	403	+	3	0	-2	8621
P42771-1#104	0	1	1	P42771-1	123	124	+	1	P42771-1	51	156	ENST00000578845.2	127	442	++	186	P42771-1#104	0	3	ENST00000578845.2	343	346	+	3	0	-2	8622
P42771-1#104	0	1	1	P42771-1	123	124	+	1	P42771-1	51	156	ENST00000498628.6	484	799	++	126	P42771-1#104	0	3	ENST00000498628.6	700	703	+	3	0	-2	8623
P42771-1#104	0	1	1	P42771-1	123	124	+	1	P42771-1	0	154	ENST00000498124.1	39	501	++	125	P42771-1#104	0	3	ENST00000498124.1	408	411	+	3	0	-2	8624
P42771-1#104	0	1	1	P42771-1	123	124	+	1	P42771-1	51	152	ENST00000497750.1	75	378	++	124	P42771-1#104	0	3	ENST00000497750.1	291	294	+	3	0	-2	8625
P42771-1#104	0	1	1	P42771-1	123	124	+	1	P42771-1	51	156	ENST00000494262.5	624	939	++	121	P42771-1#104	0	3	ENST00000494262.5	840	843	+	3	0	-2	8626
P42771-1#104	0	1	1	P42771-1	123	124	+	1	P42771-1	51	152	ENST00000479692.2	15	318	++	114	P42771-1#104	0	3	ENST00000479692.2	231	234	+	3	0	-2	8627
P42771-1#104	0	1	1	P42771-1	123	124	+	1	P42771-1	0	156	ENST00000304494.10	30	498	++	24	P42771-1#104	0	3	ENST00000304494.10	399	402	+	3	0	-2	8628
P42771-1#105	0	1	1	P42771-1	123	124	+	1	P42771-1	0	131	ENST00000579122.1	31	424	++	187	P42771-1#105	0	3	ENST00000579122.1	400	403	+	3	0	-2	8629
P42771-1#105	0	1	1	P42771-1	123	124	+	1	P42771-1	51	156	ENST00000578845.2	127	442	++	186	P42771-1#105	0	3	ENST00000578845.2	343	346	+	3	0	-2	8630
P42771-1#105	0	1	1	P42771-1	123	124	+	1	P42771-1	51	156	ENST00000498628.6	484	799	++	126	P42771-1#105	0	3	ENST00000498628.6	700	703	+	3	0	-2	8631
P42771-1#105	0	1	1	P42771-1	123	124	+	1	P42771-1	0	154	ENST00000498124.1	39	501	++	125	P42771-1#105	0	3	ENST00000498124.1	408	411	+	3	0	-2	8632
P42771-1#105	0	1	1	P42771-1	123	124	+	1	P42771-1	51	152	ENST00000497750.1	75	378	++	124	P42771-1#105	0	3	ENST00000497750.1	291	294	+	3	0	-2	8633
P42771-1#105	0	1	1	P42771-1	123	124	+	1	P42771-1	51	156	ENST00000494262.5	624	939	++	121	P42771-1#105	0	3	ENST00000494262.5	840	843	+	3	0	-2	8634
P42771-1#105	0	1	1	P42771-1	123	124	+	1	P42771-1	51	152	ENST00000479692.2	15	318	++	114	P42771-1#105	0	3	ENST00000479692.2	231	234	+	3	0	-2	8635
P42771-1#105	0	1	1	P42771-1	123	124	+	1	P42771-1	0	156	ENST00000304494.10	30	498	++	24	P42771-1#105	0	3	ENST00000304494.10	399	402	+	3	0	-2	8636
P42771-1#106	0	1	1	P42771-1	125	126	+	1	P42771-1	0	131	ENST00000579122.1	31	424	++	187	P42771-1#106	0	3	ENST00000579122.1	406	409	+	3	0	-2	8637
P42771-1#106	0	1	1	P42771-1	125	126	+	1	P42771-1	51	156	ENST00000578845.2	127	442	++	186	P42771-1#106	0	3	ENST00000578845.2	349	352	+	3	0	-2	8638
P42771-1#106	0	1	1	P42771-1	125	126	+	1	P42771-1	51	156	ENST00000498628.6	484	799	++	126	P42771-1#106	0	3	ENST00000498628.6	706	709	+	3	0	-2	8639
P42771-1#106	0	1	1	P42771-1	125	126	+	1	P42771-1	0	154	ENST00000498124.1	39	501	++	125	P42771-1#106	0	3	ENST00000498124.1	414	417	+	3	0	-2	8640
P42771-1#106	0	1	1	P42771-1	125	126	+	1	P42771-1	51	152	ENST00000497750.1	75	378	++	124	P42771-1#106	0	3	ENST00000497750.1	297	300	+	3	0	-2	8641
P42771-1#106	0	1	1	P42771-1	125	126	+	1	P42771-1	51	156	ENST00000494262.5	624	939	++	121	P42771-1#106	0	3	ENST00000494262.5	846	849	+	3	0	-2	8642
P42771-1#106	0	1	1	P42771-1	125	126	+	1	P42771-1	51	152	ENST00000479692.2	15	318	++	114	P42771-1#106	0	3	ENST00000479692.2	237	240	+	3	0	-2	8643
P42771-1#106	0	1	1	P42771-1	125	126	+	1	P42771-1	0	156	ENST00000304494.10	30	498	++	24	P42771-1#106	0	3	ENST00000304494.10	405	408	+	3	0	-2	8644
P42771-1#107	0	1	1	P42771-1	126	127	+	1	P42771-1	0	131	ENST00000579122.1	31	424	++	187	P42771-1#107	0	3	ENST00000579122.1	409	412	+	3	0	-2	8645
P42771-1#107	0	1	1	P42771-1	126	127	+	1	P42771-1	51	156	ENST00000578845.2	127	442	++	186	P42771-1#107	0	3	ENST00000578845.2	352	355	+	3	0	-2	8646
P42771-1#107	0	1	1	P42771-1	126	127	+	1	P42771-1	51	156	ENST00000498628.6	484	799	++	126	P42771-1#107	0	3	ENST00000498628.6	709	712	+	3	0	-2	8647
P42771-1#107	0	1	1	P42771-1	126	127	+	1	P42771-1	0	154	ENST00000498124.1	39	501	++	125	P42771-1#107	0	3	ENST00000498124.1	417	420	+	3	0	-2	8648
P42771-1#107	0	1	1	P42771-1	126	127	+	1	P42771-1	51	152	ENST00000497750.1	75	378	++	124	P42771-1#107	0	3	ENST00000497750.1	300	303	+	3	0	-2	8649
P42771-1#107	0	1	1	P42771-1	126	127	+	1	P42771-1	51	156	ENST00000494262.5	624	939	++	121	P42771-1#107	0	3	ENST00000494262.5	849	852	+	3	0	-2	8650
P42771-1#107	0	1	1	P42771-1	126	127	+	1	P42771-1	51	152	ENST00000479692.2	15	318	++	114	P42771-1#107	0	3	ENST00000479692.2	240	243	+	3	0	-2	8651
P42771-1#107	0	1	1	P42771-1	126	127	+	1	P42771-1	0	156	ENST00000304494.10	30	498	++	24	P42771-1#107	0	3	ENST00000304494.10	408	411	+	3	0	-2	8652
P42771-1#108	0	1	1	P42771-1	131	132	+	1	P42771-1	51	156	ENST00000578845.2	127	442	++	186	P42771-1#108	0	3	ENST00000578845.2	367	370	+	3	0	-2	8653
P42771-1#108	0	1	1	P42771-1	131	132	+	1	P42771-1	51	156	ENST00000498628.6	484	799	++	126	P42771-1#108	0	3	ENST00000498628.6	724	727	+	3	0	-2	8654
P42771-1#108	0	1	1	P42771-1	131	132	+	1	P42771-1	0	154	ENST00000498124.1	39	501	++	125	P42771-1#108	0	3	ENST00000498124.1	432	435	+	3	0	-2	8655
P42771-1#108	0	1	1	P42771-1	131	132	+	1	P42771-1	51	152	ENST00000497750.1	75	378	++	124	P42771-1#108	0	3	ENST00000497750.1	315	318	+	3	0	-2	8656
P42771-1#108	0	1	1	P42771-1	131	132	+	1	P42771-1	51	156	ENST00000494262.5	624	939	++	121	P42771-1#108	0	3	ENST00000494262.5	864	867	+	3	0	-2	8657
P42771-1#108	0	1	1	P42771-1	131	132	+	1	P42771-1	51	152	ENST00000479692.2	15	318	++	114	P42771-1#108	0	3	ENST00000479692.2	255	258	+	3	0	-2	8658
P42771-1#108	0	1	1	P42771-1	131	132	+	1	P42771-1	0	156	ENST00000304494.10	30	498	++	24	P42771-1#108	0	3	ENST00000304494.10	423	426	+	3	0	-2	8659
P42771-1#109	0	1	1	P42771-1	133	134	+	1	P42771-1	51	156	ENST00000578845.2	127	442	++	186	P42771-1#109	0	3	ENST00000578845.2	373	376	+	3	0	-2	8660
P42771-1#109	0	1	1	P42771-1	133	134	+	1	P42771-1	51	156	ENST00000498628.6	484	799	++	126	P42771-1#109	0	3	ENST00000498628.6	730	733	+	3	0	-2	8661
P42771-1#109	0	1	1	P42771-1	133	134	+	1	P42771-1	0	154	ENST00000498124.1	39	501	++	125	P42771-1#109	0	3	ENST00000498124.1	438	441	+	3	0	-2	8662
P42771-1#109	0	1	1	P42771-1	133	134	+	1	P42771-1	51	152	ENST00000497750.1	75	378	++	124	P42771-1#109	0	3	ENST00000497750.1	321	324	+	3	0	-2	8663
P42771-1#109	0	1	1	P42771-1	133	134	+	1	P42771-1	51	156	ENST00000494262.5	624	939	++	121	P42771-1#109	0	3	ENST00000494262.5	870	873	+	3	0	-2	8664
P42771-1#109	0	1	1	P42771-1	133	134	+	1	P42771-1	51	152	ENST00000479692.2	15	318	++	114	P42771-1#109	0	3	ENST00000479692.2	261	264	+	3	0	-2	8665
P42771-1#109	0	1	1	P42771-1	133	134	+	1	P42771-1	0	156	ENST00000304494.10	30	498	++	24	P42771-1#109	0	3	ENST00000304494.10	429	432	+	3	0	-2	8666
P42771-1#110	0	1	1	P42771-1	141	142	+	1	P42771-1	51	156	ENST00000578845.2	127	442	++	186	P42771-1#110	0	3	ENST00000578845.2	397	400	+	3	0	-2	8667
P42771-1#110	0	1	1	P42771-1	141	142	+	1	P42771-1	51	156	ENST00000498628.6	484	799	++	126	P42771-1#110	0	3	ENST00000498628.6	754	757	+	3	0	-2	8668
P42771-1#110	0	1	1	P42771-1	141	142	+	1	P42771-1	0	154	ENST00000498124.1	39	501	++	125	P42771-1#110	0	3	ENST00000498124.1	462	465	+	3	0	-2	8669
P42771-1#110	0	1	1	P42771-1	141	142	+	1	P42771-1	51	152	ENST00000497750.1	75	378	++	124	P42771-1#110	0	3	ENST00000497750.1	345	348	+	3	0	-2	8670
P42771-1#110	0	1	1	P42771-1	141	142	+	1	P42771-1	51	156	ENST00000494262.5	624	939	++	121	P42771-1#110	0	3	ENST00000494262.5	894	897	+	3	0	-2	8671
P42771-1#110	0	1	1	P42771-1	141	142	+	1	P42771-1	51	152	ENST00000479692.2	15	318	++	114	P42771-1#110	0	3	ENST00000479692.2	285	288	+	3	0	-2	8672
P42771-1#110	0	1	1	P42771-1	141	142	+	1	P42771-1	0	156	ENST00000304494.10	30	498	++	24	P42771-1#110	0	3	ENST00000304494.10	453	456	+	3	0	-2	8673
P42771-1#111	0	1	1	P42771-1	143	144	+	1	P42771-1	51	156	ENST00000578845.2	127	442	++	186	P42771-1#111	0	3	ENST00000578845.2	403	406	+	3	0	-2	8674
P42771-1#111	0	1	1	P42771-1	143	144	+	1	P42771-1	51	156	ENST00000498628.6	484	799	++	126	P42771-1#111	0	3	ENST00000498628.6	760	763	+	3	0	-2	8675
P42771-1#111	0	1	1	P42771-1	143	144	+	1	P42771-1	0	154	ENST00000498124.1	39	501	++	125	P42771-1#111	0	3	ENST00000498124.1	468	471	+	3	0	-2	8676
P42771-1#111	0	1	1	P42771-1	143	144	+	1	P42771-1	51	152	ENST00000497750.1	75	378	++	124	P42771-1#111	0	3	ENST00000497750.1	351	354	+	3	0	-2	8677
P42771-1#111	0	1	1	P42771-1	143	144	+	1	P42771-1	51	156	ENST00000494262.5	624	939	++	121	P42771-1#111	0	3	ENST00000494262.5	900	903	+	3	0	-2	8678
P42771-1#111	0	1	1	P42771-1	143	144	+	1	P42771-1	51	152	ENST00000479692.2	15	318	++	114	P42771-1#111	0	3	ENST00000479692.2	291	294	+	3	0	-2	8679
P42771-1#111	0	1	1	P42771-1	143	144	+	1	P42771-1	0	156	ENST00000304494.10	30	498	++	24	P42771-1#111	0	3	ENST00000304494.10	459	462	+	3	0	-2	8680
P42771-1#112	0	1	1	P42771-1	147	148	+	1	P42771-1	51	156	ENST00000578845.2	127	442	++	186	P42771-1#112	0	3	ENST00000578845.2	415	418	+	3	0	-2	8681
P42771-1#112	0	1	1	P42771-1	147	148	+	1	P42771-1	51	156	ENST00000498628.6	484	799	++	126	P42771-1#112	0	3	ENST00000498628.6	772	775	+	3	0	-2	8682
P42771-1#112	0	1	1	P42771-1	147	148	+	1	P42771-1	0	154	ENST00000498124.1	39	501	++	125	P42771-1#112	0	3	ENST00000498124.1	480	483	+	3	0	-2	8683
P42771-1#112	0	1	1	P42771-1	147	148	+	1	P42771-1	51	152	ENST00000497750.1	75	378	++	124	P42771-1#112	0	3	ENST00000497750.1	363	366	+	3	0	-2	8684
P42771-1#112	0	1	1	P42771-1	147	148	+	1	P42771-1	51	156	ENST00000494262.5	624	939	++	121	P42771-1#112	0	3	ENST00000494262.5	912	915	+	3	0	-2	8685
P42771-1#112	0	1	1	P42771-1	147	148	+	1	P42771-1	51	152	ENST00000479692.2	15	318	++	114	P42771-1#112	0	3	ENST00000479692.2	303	306	+	3	0	-2	8686
P42771-1#112	0	1	1	P42771-1	147	148	+	1	P42771-1	0	156	ENST00000304494.10	30	498	++	24	P42771-1#112	0	3	ENST00000304494.10	471	474	+	3	0	-2	8687
P42771-1#113	0	1	1	P42771-1	149	150	+	1	P42771-1	51	156	ENST00000578845.2	127	442	++	186	P42771-1#113	0	3	ENST00000578845.2	421	424	+	3	0	-2	8688
P42771-1#113	0	1	1	P42771-1	149	150	+	1	P42771-1	51	156	ENST00000498628.6	484	799	++	126	P42771-1#113	0	3	ENST00000498628.6	778	781	+	3	0	-2	8689
P42771-1#113	0	1	1	P42771-1	149	150	+	1	P42771-1	0	154	ENST00000498124.1	39	501	++	125	P42771-1#113	0	3	ENST00000498124.1	486	489	+	3	0	-2	8690
P42771-1#113	0	1	1	P42771-1	149	150	+	1	P42771-1	51	152	ENST00000497750.1	75	378	++	124	P42771-1#113	0	3	ENST00000497750.1	369	372	+	3	0	-2	8691
P42771-1#113	0	1	1	P42771-1	149	150	+	1	P42771-1	51	156	ENST00000494262.5	624	939	++	121	P42771-1#113	0	3	ENST00000494262.5	918	921	+	3	0	-2	8692
P42771-1#113	0	1	1	P42771-1	149	150	+	1	P42771-1	51	152	ENST00000479692.2	15	318	++	114	P42771-1#113	0	3	ENST00000479692.2	309	312	+	3	0	-2	8693
P42771-1#113	0	1	1	P42771-1	149	150	+	1	P42771-1	0	156	ENST00000304494.10	30	498	++	24	P42771-1#113	0	3	ENST00000304494.10	477	480	+	3	0	-2	8694
P42771-1#114	0	3	3	P42771-1	3	6	+	3	P42771-1	0	131	ENST00000579122.1	31	424	++	187	P42771-1#114	0	9	ENST00000579122.1	40	49	+	9	0	-6	8695
P42771-1#114	0	3	3	P42771-1	3	6	+	3	P42771-1	0	154	ENST00000498124.1	39	501	++	125	P42771-1#114	0	9	ENST00000498124.1	48	57	+	9	0	-6	8696
P42771-1#114	0	3	3	P42771-1	3	6	+	3	P42771-1	0	51	ENST00000380151.3	0	153	++	53	P42771-1#114	0	9	ENST00000380151.3	9	18	+	9	0	-6	8697
P42771-1#114	0	3	3	P42771-1	3	6	+	3	P42771-1	0	156	ENST00000304494.10	30	498	++	24	P42771-1#114	0	9	ENST00000304494.10	39	48	+	9	0	-6	8698
P42771-1#115	0	8	8	P42771-1	14	22	+	8	P42771-1	0	131	ENST00000579122.1	31	424	++	187	P42771-1#115	0	24	ENST00000579122.1	73	97	+	24	0	-16	8699
P42771-1#115	0	8	8	P42771-1	14	22	+	8	P42771-1	0	154	ENST00000498124.1	39	501	++	125	P42771-1#115	0	24	ENST00000498124.1	81	105	+	24	0	-16	8700
P42771-1#115	0	8	8	P42771-1	14	22	+	8	P42771-1	0	51	ENST00000380151.3	0	153	++	53	P42771-1#115	0	24	ENST00000380151.3	42	66	+	24	0	-16	8701
P42771-1#115	0	8	8	P42771-1	14	22	+	8	P42771-1	0	156	ENST00000304494.10	30	498	++	24	P42771-1#115	0	24	ENST00000304494.10	72	96	+	24	0	-16	8702
P42771-1#116	0	8	8	P42771-1	24	32	+	8	P42771-1	0	131	ENST00000579122.1	31	424	++	187	P42771-1#116	0	24	ENST00000579122.1	103	127	+	24	0	-16	8703
P42771-1#116	0	8	8	P42771-1	24	32	+	8	P42771-1	0	154	ENST00000498124.1	39	501	++	125	P42771-1#116	0	24	ENST00000498124.1	111	135	+	24	0	-16	8704
P42771-1#116	0	8	8	P42771-1	24	32	+	8	P42771-1	0	51	ENST00000380151.3	0	153	++	53	P42771-1#116	0	24	ENST00000380151.3	72	96	+	24	0	-16	8705
P42771-1#116	0	8	8	P42771-1	24	32	+	8	P42771-1	0	156	ENST00000304494.10	30	498	++	24	P42771-1#116	0	24	ENST00000304494.10	102	126	+	24	0	-16	8706
P42771-1#117	0	3	3	P42771-1	32	35	+	3	P42771-1	0	131	ENST00000579122.1	31	424	++	187	P42771-1#117	0	9	ENST00000579122.1	127	136	+	9	0	-6	8707
P42771-1#117	0	3	3	P42771-1	32	35	+	3	P42771-1	0	154	ENST00000498124.1	39	501	++	125	P42771-1#117	0	9	ENST00000498124.1	135	144	+	9	0	-6	8708
P42771-1#117	0	3	3	P42771-1	32	35	+	3	P42771-1	0	51	ENST00000380151.3	0	153	++	53	P42771-1#117	0	9	ENST00000380151.3	96	105	+	9	0	-6	8709
P42771-1#117	0	3	3	P42771-1	32	35	+	3	P42771-1	0	156	ENST00000304494.10	30	498	++	24	P42771-1#117	0	9	ENST00000304494.10	126	135	+	9	0	-6	8710
P42771-1#118	0	3	3	P42771-1	42	45	+	3	P42771-1	0	131	ENST00000579122.1	31	424	++	187	P42771-1#118	0	9	ENST00000579122.1	157	166	+	9	0	-6	8711
P42771-1#118	0	3	3	P42771-1	42	45	+	3	P42771-1	0	154	ENST00000498124.1	39	501	++	125	P42771-1#118	0	9	ENST00000498124.1	165	174	+	9	0	-6	8712
P42771-1#118	0	3	3	P42771-1	42	45	+	3	P42771-1	0	51	ENST00000380151.3	0	153	++	53	P42771-1#118	0	9	ENST00000380151.3	126	135	+	9	0	-6	8713
P42771-1#118	0	3	3	P42771-1	42	45	+	3	P42771-1	0	156	ENST00000304494.10	30	498	++	24	P42771-1#118	0	9	ENST00000304494.10	156	165	+	9	0	-6	8714
P42771-1#119	0	3	3	P42771-1	47	50	+	3	P42771-1	0	131	ENST00000579122.1	31	424	++	187	P42771-1#119	0	9	ENST00000579122.1	172	181	+	9	0	-6	8715
P42771-1#119	0	3	3	P42771-1	47	50	+	3	P42771-1	0	154	ENST00000498124.1	39	501	++	125	P42771-1#119	0	9	ENST00000498124.1	180	189	+	9	0	-6	8716
P42771-1#119	0	3	3	P42771-1	47	50	+	3	P42771-1	0	51	ENST00000380151.3	0	153	++	53	P42771-1#119	0	9	ENST00000380151.3	141	150	+	9	0	-6	8717
P42771-1#119	0	3	3	P42771-1	47	50	+	3	P42771-1	0	156	ENST00000304494.10	30	498	++	24	P42771-1#119	0	9	ENST00000304494.10	171	180	+	9	0	-6	8718
P42771-1#120	0	8	8	P42771-1	56	64	+	8	P42771-1	0	131	ENST00000579122.1	31	424	++	187	P42771-1#120	0	24	ENST00000579122.1	199	223	+	24	0	-16	8719
P42771-1#120	0	8	8	P42771-1	56	64	+	8	P42771-1	51	156	ENST00000578845.2	127	442	++	186	P42771-1#120	0	24	ENST00000578845.2	142	166	+	24	0	-16	8720
P42771-1#120	0	8	8	P42771-1	56	64	+	8	P42771-1	51	156	ENST00000498628.6	484	799	++	126	P42771-1#120	0	24	ENST00000498628.6	499	523	+	24	0	-16	8721
P42771-1#120	0	8	8	P42771-1	56	64	+	8	P42771-1	0	154	ENST00000498124.1	39	501	++	125	P42771-1#120	0	24	ENST00000498124.1	207	231	+	24	0	-16	8722
P42771-1#120	0	8	8	P42771-1	56	64	+	8	P42771-1	51	152	ENST00000497750.1	75	378	++	124	P42771-1#120	0	24	ENST00000497750.1	90	114	+	24	0	-16	8723
P42771-1#120	0	8	8	P42771-1	56	64	+	8	P42771-1	51	156	ENST00000494262.5	624	939	++	121	P42771-1#120	0	24	ENST00000494262.5	639	663	+	24	0	-16	8724
P42771-1#120	0	8	8	P42771-1	56	64	+	8	P42771-1	51	152	ENST00000479692.2	15	318	++	114	P42771-1#120	0	24	ENST00000479692.2	30	54	+	24	0	-16	8725
P42771-1#120	0	8	8	P42771-1	56	64	+	8	P42771-1	0	156	ENST00000304494.10	30	498	++	24	P42771-1#120	0	24	ENST00000304494.10	198	222	+	24	0	-16	8726
P42771-1#121	0	3	3	P42771-1	64	67	+	3	P42771-1	0	131	ENST00000579122.1	31	424	++	187	P42771-1#121	0	9	ENST00000579122.1	223	232	+	9	0	-6	8727
P42771-1#121	0	3	3	P42771-1	64	67	+	3	P42771-1	51	156	ENST00000578845.2	127	442	++	186	P42771-1#121	0	9	ENST00000578845.2	166	175	+	9	0	-6	8728
P42771-1#121	0	3	3	P42771-1	64	67	+	3	P42771-1	51	156	ENST00000498628.6	484	799	++	126	P42771-1#121	0	9	ENST00000498628.6	523	532	+	9	0	-6	8729
P42771-1#121	0	3	3	P42771-1	64	67	+	3	P42771-1	0	154	ENST00000498124.1	39	501	++	125	P42771-1#121	0	9	ENST00000498124.1	231	240	+	9	0	-6	8730
P42771-1#121	0	3	3	P42771-1	64	67	+	3	P42771-1	51	152	ENST00000497750.1	75	378	++	124	P42771-1#121	0	9	ENST00000497750.1	114	123	+	9	0	-6	8731
P42771-1#121	0	3	3	P42771-1	64	67	+	3	P42771-1	51	156	ENST00000494262.5	624	939	++	121	P42771-1#121	0	9	ENST00000494262.5	663	672	+	9	0	-6	8732
P42771-1#121	0	3	3	P42771-1	64	67	+	3	P42771-1	51	152	ENST00000479692.2	15	318	++	114	P42771-1#121	0	9	ENST00000479692.2	54	63	+	9	0	-6	8733
P42771-1#121	0	3	3	P42771-1	64	67	+	3	P42771-1	0	156	ENST00000304494.10	30	498	++	24	P42771-1#121	0	9	ENST00000304494.10	222	231	+	9	0	-6	8734
P42771-1#122	0	3	3	P42771-1	74	77	+	3	P42771-1	0	131	ENST00000579122.1	31	424	++	187	P42771-1#122	0	9	ENST00000579122.1	253	262	+	9	0	-6	8735
P42771-1#122	0	3	3	P42771-1	74	77	+	3	P42771-1	51	156	ENST00000578845.2	127	442	++	186	P42771-1#122	0	9	ENST00000578845.2	196	205	+	9	0	-6	8736
P42771-1#122	0	3	3	P42771-1	74	77	+	3	P42771-1	51	156	ENST00000498628.6	484	799	++	126	P42771-1#122	0	9	ENST00000498628.6	553	562	+	9	0	-6	8737
P42771-1#122	0	3	3	P42771-1	74	77	+	3	P42771-1	0	154	ENST00000498124.1	39	501	++	125	P42771-1#122	0	9	ENST00000498124.1	261	270	+	9	0	-6	8738
P42771-1#122	0	3	3	P42771-1	74	77	+	3	P42771-1	51	152	ENST00000497750.1	75	378	++	124	P42771-1#122	0	9	ENST00000497750.1	144	153	+	9	0	-6	8739
P42771-1#122	0	3	3	P42771-1	74	77	+	3	P42771-1	51	156	ENST00000494262.5	624	939	++	121	P42771-1#122	0	9	ENST00000494262.5	693	702	+	9	0	-6	8740
P42771-1#122	0	3	3	P42771-1	74	77	+	3	P42771-1	51	152	ENST00000479692.2	15	318	++	114	P42771-1#122	0	9	ENST00000479692.2	84	93	+	9	0	-6	8741
P42771-1#122	0	3	3	P42771-1	74	77	+	3	P42771-1	0	156	ENST00000304494.10	30	498	++	24	P42771-1#122	0	9	ENST00000304494.10	252	261	+	9	0	-6	8742
P42771-1#123	0	8	8	P42771-1	80	88	+	8	P42771-1	0	131	ENST00000579122.1	31	424	++	187	P42771-1#123	0	24	ENST00000579122.1	271	295	+	24	0	-16	8743
P42771-1#123	0	8	8	P42771-1	80	88	+	8	P42771-1	51	156	ENST00000578845.2	127	442	++	186	P42771-1#123	0	24	ENST00000578845.2	214	238	+	24	0	-16	8744
P42771-1#123	0	8	8	P42771-1	80	88	+	8	P42771-1	51	156	ENST00000498628.6	484	799	++	126	P42771-1#123	0	24	ENST00000498628.6	571	595	+	24	0	-16	8745
P42771-1#123	0	8	8	P42771-1	80	88	+	8	P42771-1	0	154	ENST00000498124.1	39	501	++	125	P42771-1#123	0	24	ENST00000498124.1	279	303	+	24	0	-16	8746
P42771-1#123	0	8	8	P42771-1	80	88	+	8	P42771-1	51	152	ENST00000497750.1	75	378	++	124	P42771-1#123	0	24	ENST00000497750.1	162	186	+	24	0	-16	8747
P42771-1#123	0	8	8	P42771-1	80	88	+	8	P42771-1	51	156	ENST00000494262.5	624	939	++	121	P42771-1#123	0	24	ENST00000494262.5	711	735	+	24	0	-16	8748
P42771-1#123	0	8	8	P42771-1	80	88	+	8	P42771-1	51	152	ENST00000479692.2	15	318	++	114	P42771-1#123	0	24	ENST00000479692.2	102	126	+	24	0	-16	8749
P42771-1#123	0	8	8	P42771-1	80	88	+	8	P42771-1	0	156	ENST00000304494.10	30	498	++	24	P42771-1#123	0	24	ENST00000304494.10	270	294	+	24	0	-16	8750
P42771-1#124	0	10	10	P42771-1	90	100	+	10	P42771-1	0	131	ENST00000579122.1	31	424	++	187	P42771-1#124	0	30	ENST00000579122.1	301	331	+	30	0	-20	8751
P42771-1#124	0	10	10	P42771-1	90	100	+	10	P42771-1	51	156	ENST00000578845.2	127	442	++	186	P42771-1#124	0	30	ENST00000578845.2	244	274	+	30	0	-20	8752
P42771-1#124	0	10	10	P42771-1	90	100	+	10	P42771-1	51	156	ENST00000498628.6	484	799	++	126	P42771-1#124	0	30	ENST00000498628.6	601	631	+	30	0	-20	8753
P42771-1#124	0	10	10	P42771-1	90	100	+	10	P42771-1	0	154	ENST00000498124.1	39	501	++	125	P42771-1#124	0	30	ENST00000498124.1	309	339	+	30	0	-20	8754
P42771-1#124	0	10	10	P42771-1	90	100	+	10	P42771-1	51	152	ENST00000497750.1	75	378	++	124	P42771-1#124	0	30	ENST00000497750.1	192	222	+	30	0	-20	8755
P42771-1#124	0	10	10	P42771-1	90	100	+	10	P42771-1	51	156	ENST00000494262.5	624	939	++	121	P42771-1#124	0	30	ENST00000494262.5	741	771	+	30	0	-20	8756
P42771-1#124	0	10	10	P42771-1	90	100	+	10	P42771-1	51	152	ENST00000479692.2	15	318	++	114	P42771-1#124	0	30	ENST00000479692.2	132	162	+	30	0	-20	8757
P42771-1#124	0	10	10	P42771-1	90	100	+	10	P42771-1	0	156	ENST00000304494.10	30	498	++	24	P42771-1#124	0	30	ENST00000304494.10	300	330	+	30	0	-20	8758
P42771-1#125	0	3	3	P42771-1	108	111	+	3	P42771-1	0	131	ENST00000579122.1	31	424	++	187	P42771-1#125	0	9	ENST00000579122.1	355	364	+	9	0	-6	8759
P42771-1#125	0	3	3	P42771-1	108	111	+	3	P42771-1	51	156	ENST00000578845.2	127	442	++	186	P42771-1#125	0	9	ENST00000578845.2	298	307	+	9	0	-6	8760
P42771-1#125	0	3	3	P42771-1	108	111	+	3	P42771-1	51	156	ENST00000498628.6	484	799	++	126	P42771-1#125	0	9	ENST00000498628.6	655	664	+	9	0	-6	8761
P42771-1#125	0	3	3	P42771-1	108	111	+	3	P42771-1	0	154	ENST00000498124.1	39	501	++	125	P42771-1#125	0	9	ENST00000498124.1	363	372	+	9	0	-6	8762
P42771-1#125	0	3	3	P42771-1	108	111	+	3	P42771-1	51	152	ENST00000497750.1	75	378	++	124	P42771-1#125	0	9	ENST00000497750.1	246	255	+	9	0	-6	8763
P42771-1#125	0	3	3	P42771-1	108	111	+	3	P42771-1	51	156	ENST00000494262.5	624	939	++	121	P42771-1#125	0	9	ENST00000494262.5	795	804	+	9	0	-6	8764
P42771-1#125	0	3	3	P42771-1	108	111	+	3	P42771-1	51	152	ENST00000479692.2	15	318	++	114	P42771-1#125	0	9	ENST00000479692.2	186	195	+	9	0	-6	8765
P42771-1#125	0	3	3	P42771-1	108	111	+	3	P42771-1	0	156	ENST00000304494.10	30	498	++	24	P42771-1#125	0	9	ENST00000304494.10	354	363	+	9	0	-6	8766
P42771-1#126	0	8	8	P42771-1	113	121	+	8	P42771-1	0	131	ENST00000579122.1	31	424	++	187	P42771-1#126	0	24	ENST00000579122.1	370	394	+	24	0	-16	8767
P42771-1#126	0	8	8	P42771-1	113	121	+	8	P42771-1	51	156	ENST00000578845.2	127	442	++	186	P42771-1#126	0	24	ENST00000578845.2	313	337	+	24	0	-16	8768
P42771-1#126	0	8	8	P42771-1	113	121	+	8	P42771-1	51	156	ENST00000498628.6	484	799	++	126	P42771-1#126	0	24	ENST00000498628.6	670	694	+	24	0	-16	8769
P42771-1#126	0	8	8	P42771-1	113	121	+	8	P42771-1	0	154	ENST00000498124.1	39	501	++	125	P42771-1#126	0	24	ENST00000498124.1	378	402	+	24	0	-16	8770
P42771-1#126	0	8	8	P42771-1	113	121	+	8	P42771-1	51	152	ENST00000497750.1	75	378	++	124	P42771-1#126	0	24	ENST00000497750.1	261	285	+	24	0	-16	8771
P42771-1#126	0	8	8	P42771-1	113	121	+	8	P42771-1	51	156	ENST00000494262.5	624	939	++	121	P42771-1#126	0	24	ENST00000494262.5	810	834	+	24	0	-16	8772
P42771-1#126	0	8	8	P42771-1	113	121	+	8	P42771-1	51	152	ENST00000479692.2	15	318	++	114	P42771-1#126	0	24	ENST00000479692.2	201	225	+	24	0	-16	8773
P42771-1#126	0	8	8	P42771-1	113	121	+	8	P42771-1	0	156	ENST00000304494.10	30	498	++	24	P42771-1#126	0	24	ENST00000304494.10	369	393	+	24	0	-16	8774
P42771-1#127	0	7	7	P42771-1	123	130	+	7	P42771-1	0	131	ENST00000579122.1	31	424	++	187	P42771-1#127	0	21	ENST00000579122.1	400	421	+	21	0	-14	8775
P42771-1#127	0	7	7	P42771-1	123	130	+	7	P42771-1	51	156	ENST00000578845.2	127	442	++	186	P42771-1#127	0	21	ENST00000578845.2	343	364	+	21	0	-14	8776
P42771-1#127	0	7	7	P42771-1	123	130	+	7	P42771-1	51	156	ENST00000498628.6	484	799	++	126	P42771-1#127	0	21	ENST00000498628.6	700	721	+	21	0	-14	8777
P42771-1#127	0	7	7	P42771-1	123	130	+	7	P42771-1	0	154	ENST00000498124.1	39	501	++	125	P42771-1#127	0	21	ENST00000498124.1	408	429	+	21	0	-14	8778
P42771-1#127	0	7	7	P42771-1	123	130	+	7	P42771-1	51	152	ENST00000497750.1	75	378	++	124	P42771-1#127	0	21	ENST00000497750.1	291	312	+	21	0	-14	8779
P42771-1#127	0	7	7	P42771-1	123	130	+	7	P42771-1	51	156	ENST00000494262.5	624	939	++	121	P42771-1#127	0	21	ENST00000494262.5	840	861	+	21	0	-14	8780
P42771-1#127	0	7	7	P42771-1	123	130	+	7	P42771-1	51	152	ENST00000479692.2	15	318	++	114	P42771-1#127	0	21	ENST00000479692.2	231	252	+	21	0	-14	8781
P42771-1#127	0	7	7	P42771-1	123	130	+	7	P42771-1	0	156	ENST00000304494.10	30	498	++	24	P42771-1#127	0	21	ENST00000304494.10	399	420	+	21	0	-14	8782
P42771-1#128	0	3	3	P42771-1	132	135	+	3	P42771-1	51	156	ENST00000578845.2	127	442	++	186	P42771-1#128	0	9	ENST00000578845.2	370	379	+	9	0	-6	8783
P42771-1#128	0	3	3	P42771-1	132	135	+	3	P42771-1	51	156	ENST00000498628.6	484	799	++	126	P42771-1#128	0	9	ENST00000498628.6	727	736	+	9	0	-6	8784
P42771-1#128	0	3	3	P42771-1	132	135	+	3	P42771-1	0	154	ENST00000498124.1	39	501	++	125	P42771-1#128	0	9	ENST00000498124.1	435	444	+	9	0	-6	8785
P42771-1#128	0	3	3	P42771-1	132	135	+	3	P42771-1	51	152	ENST00000497750.1	75	378	++	124	P42771-1#128	0	9	ENST00000497750.1	318	327	+	9	0	-6	8786
P42771-1#128	0	3	3	P42771-1	132	135	+	3	P42771-1	51	156	ENST00000494262.5	624	939	++	121	P42771-1#128	0	9	ENST00000494262.5	867	876	+	9	0	-6	8787
P42771-1#128	0	3	3	P42771-1	132	135	+	3	P42771-1	51	152	ENST00000479692.2	15	318	++	114	P42771-1#128	0	9	ENST00000479692.2	258	267	+	9	0	-6	8788
P42771-1#128	0	3	3	P42771-1	132	135	+	3	P42771-1	0	156	ENST00000304494.10	30	498	++	24	P42771-1#128	0	9	ENST00000304494.10	426	435	+	9	0	-6	8789
P42771-1#129	0	3	3	P42771-1	140	143	+	3	P42771-1	51	156	ENST00000578845.2	127	442	++	186	P42771-1#129	0	9	ENST00000578845.2	394	403	+	9	0	-6	8790
P42771-1#129	0	3	3	P42771-1	140	143	+	3	P42771-1	51	156	ENST00000498628.6	484	799	++	126	P42771-1#129	0	9	ENST00000498628.6	751	760	+	9	0	-6	8791
P42771-1#129	0	3	3	P42771-1	140	143	+	3	P42771-1	0	154	ENST00000498124.1	39	501	++	125	P42771-1#129	0	9	ENST00000498124.1	459	468	+	9	0	-6	8792
P42771-1#129	0	3	3	P42771-1	140	143	+	3	P42771-1	51	152	ENST00000497750.1	75	378	++	124	P42771-1#129	0	9	ENST00000497750.1	342	351	+	9	0	-6	8793
P42771-1#129	0	3	3	P42771-1	140	143	+	3	P42771-1	51	156	ENST00000494262.5	624	939	++	121	P42771-1#129	0	9	ENST00000494262.5	891	900	+	9	0	-6	8794
P42771-1#129	0	3	3	P42771-1	140	143	+	3	P42771-1	51	152	ENST00000479692.2	15	318	++	114	P42771-1#129	0	9	ENST00000479692.2	282	291	+	9	0	-6	8795
P42771-1#129	0	3	3	P42771-1	140	143	+	3	P42771-1	0	156	ENST00000304494.10	30	498	++	24	P42771-1#129	0	9	ENST00000304494.10	450	459	+	9	0	-6	8796
P42771-1#130	0	3	3	P42771-1	144	147	+	3	P42771-1	51	156	ENST00000578845.2	127	442	++	186	P42771-1#130	0	9	ENST00000578845.2	406	415	+	9	0	-6	8797
P42771-1#130	0	3	3	P42771-1	144	147	+	3	P42771-1	51	156	ENST00000498628.6	484	799	++	126	P42771-1#130	0	9	ENST00000498628.6	763	772	+	9	0	-6	8798
P42771-1#130	0	3	3	P42771-1	144	147	+	3	P42771-1	0	154	ENST00000498124.1	39	501	++	125	P42771-1#130	0	9	ENST00000498124.1	471	480	+	9	0	-6	8799
P42771-1#130	0	3	3	P42771-1	144	147	+	3	P42771-1	51	152	ENST00000497750.1	75	378	++	124	P42771-1#130	0	9	ENST00000497750.1	354	363	+	9	0	-6	8800
P42771-1#130	0	3	3	P42771-1	144	147	+	3	P42771-1	51	156	ENST00000494262.5	624	939	++	121	P42771-1#130	0	9	ENST00000494262.5	903	912	+	9	0	-6	8801
P42771-1#130	0	3	3	P42771-1	144	147	+	3	P42771-1	51	152	ENST00000479692.2	15	318	++	114	P42771-1#130	0	9	ENST00000479692.2	294	303	+	9	0	-6	8802
P42771-1#130	0	3	3	P42771-1	144	147	+	3	P42771-1	0	156	ENST00000304494.10	30	498	++	24	P42771-1#130	0	9	ENST00000304494.10	462	471	+	9	0	-6	8803
P42771-1#131	0	4	4	P42771-1	149	153	+	4	P42771-1	51	156	ENST00000578845.2	127	442	++	186	P42771-1#131	0	12	ENST00000578845.2	421	433	+	12	0	-8	8804
P42771-1#131	0	4	4	P42771-1	149	153	+	4	P42771-1	51	156	ENST00000498628.6	484	799	++	126	P42771-1#131	0	12	ENST00000498628.6	778	790	+	12	0	-8	8805
P42771-1#131	0	4	4	P42771-1	149	153	+	4	P42771-1	0	154	ENST00000498124.1	39	501	++	125	P42771-1#131	0	12	ENST00000498124.1	486	498	+	12	0	-8	8806
P42771-1#131	0	4	4	P42771-1	149	153	+	4	P42771-1	51	152	ENST00000497750.1	75	378	++	124	P42771-1#131	0	9	ENST00000497750.1	369	378	+	9	0	-5	8807
P42771-1#131	0	4	4	P42771-1	149	153	+	4	P42771-1	51	156	ENST00000494262.5	624	939	++	121	P42771-1#131	0	12	ENST00000494262.5	918	930	+	12	0	-8	8808
P42771-1#131	0	4	4	P42771-1	149	153	+	4	P42771-1	51	152	ENST00000479692.2	15	318	++	114	P42771-1#131	0	9	ENST00000479692.2	309	318	+	9	0	-5	8809
P42771-1#131	0	4	4	P42771-1	149	153	+	4	P42771-1	0	156	ENST00000304494.10	30	498	++	24	P42771-1#131	0	12	ENST00000304494.10	477	489	+	12	0	-8	8810
P42771-1#132	0	1	1	P42771-1	53	54	+	1	P42771-1	0	131	ENST00000579122.1	31	424	++	187	P42771-1#132	0	3	ENST00000579122.1	190	193	+	3	0	-2	8811
P42771-1#132	0	1	1	P42771-1	53	54	+	1	P42771-1	51	156	ENST00000578845.2	127	442	++	186	P42771-1#132	0	3	ENST00000578845.2	133	136	+	3	0	-2	8812
P42771-1#132	0	1	1	P42771-1	53	54	+	1	P42771-1	51	156	ENST00000498628.6	484	799	++	126	P42771-1#132	0	3	ENST00000498628.6	490	493	+	3	0	-2	8813
P42771-1#132	0	1	1	P42771-1	53	54	+	1	P42771-1	0	154	ENST00000498124.1	39	501	++	125	P42771-1#132	0	3	ENST00000498124.1	198	201	+	3	0	-2	8814
P42771-1#132	0	1	1	P42771-1	53	54	+	1	P42771-1	51	152	ENST00000497750.1	75	378	++	124	P42771-1#132	0	3	ENST00000497750.1	81	84	+	3	0	-2	8815
P42771-1#132	0	1	1	P42771-1	53	54	+	1	P42771-1	51	156	ENST00000494262.5	624	939	++	121	P42771-1#132	0	3	ENST00000494262.5	630	633	+	3	0	-2	8816
P42771-1#132	0	1	1	P42771-1	53	54	+	1	P42771-1	51	152	ENST00000479692.2	15	318	++	114	P42771-1#132	0	3	ENST00000479692.2	21	24	+	3	0	-2	8817
P42771-1#132	0	1	1	P42771-1	53	54	+	1	P42771-1	0	156	ENST00000304494.10	30	498	++	24	P42771-1#132	0	3	ENST00000304494.10	189	192	+	3	0	-2	8818
P42771-1#133	0	1	1	P42771-1	111	112	+	1	P42771-1	0	131	ENST00000579122.1	31	424	++	187	P42771-1#133	0	3	ENST00000579122.1	364	367	+	3	0	-2	8819
P42771-1#133	0	1	1	P42771-1	111	112	+	1	P42771-1	51	156	ENST00000578845.2	127	442	++	186	P42771-1#133	0	3	ENST00000578845.2	307	310	+	3	0	-2	8820
P42771-1#133	0	1	1	P42771-1	111	112	+	1	P42771-1	51	156	ENST00000498628.6	484	799	++	126	P42771-1#133	0	3	ENST00000498628.6	664	667	+	3	0	-2	8821
P42771-1#133	0	1	1	P42771-1	111	112	+	1	P42771-1	0	154	ENST00000498124.1	39	501	++	125	P42771-1#133	0	3	ENST00000498124.1	372	375	+	3	0	-2	8822
P42771-1#133	0	1	1	P42771-1	111	112	+	1	P42771-1	51	152	ENST00000497750.1	75	378	++	124	P42771-1#133	0	3	ENST00000497750.1	255	258	+	3	0	-2	8823
P42771-1#133	0	1	1	P42771-1	111	112	+	1	P42771-1	51	156	ENST00000494262.5	624	939	++	121	P42771-1#133	0	3	ENST00000494262.5	804	807	+	3	0	-2	8824
P42771-1#133	0	1	1	P42771-1	111	112	+	1	P42771-1	51	152	ENST00000479692.2	15	318	++	114	P42771-1#133	0	3	ENST00000479692.2	195	198	+	3	0	-2	8825
P42771-1#133	0	1	1	P42771-1	111	112	+	1	P42771-1	0	156	ENST00000304494.10	30	498	++	24	P42771-1#133	0	3	ENST00000304494.10	363	366	+	3	0	-2	8826
P30511-1#0	0	21	21	P30511-1	0	21	+	21	P30511-1	0	204	ENST00000434407.6	0	612	++	83	P30511-1#0	0	63	ENST00000434407.6	0	63	+	63	0	-42	8827
P30511-1#0	0	21	21	P30511-1	0	21	+	21	P30511-1	0	346	ENST00000376861.5	384	1422	++	52	P30511-1#0	0	63	ENST00000376861.5	384	447	+	63	0	-42	8828
P30511-1#0	0	21	21	P30511-1	0	21	+	21	P30511-1	0	346	ENST00000334668.8	124	1162	++	30	P30511-1#0	0	63	ENST00000334668.8	124	187	+	63	0	-42	8829
P30511-1#0	0	21	21	P30511-1	0	21	+	21	P30511-1	0	345	ENST00000259951.12	30	1065	++	6	P30511-1#0	0	63	ENST00000259951.12	30	93	+	63	0	-42	8830
P30511-1#1	0	325	325	P30511-1	21	346	+	325	P30511-1	298	334	ENST00000475996.1	1	109	++	112	P30511-1#1	831	939	ENST00000475996.1	1	109	+	108	831	-614	8831
P30511-1#1	0	325	325	P30511-1	21	346	+	325	P30511-1	211	345	ENST00000465459.2	0	402	++	109	P30511-1#1	570	972	ENST00000465459.2	0	402	+	402	570	-647	8832
P30511-1#1	0	325	325	P30511-1	21	346	+	325	P30511-1	325	345	ENST00000444621.1	2	80	++	93	P30511-1#1	912	972	ENST00000444621.1	2	80	+	60	912	-647	8833
P30511-1#1	0	325	325	P30511-1	21	346	+	325	P30511-1	0	204	ENST00000434407.6	0	612	++	83	P30511-1#1	0	549	ENST00000434407.6	63	612	+	549	0	-224	8834
P30511-1#1	0	325	325	P30511-1	21	346	+	325	P30511-1	0	346	ENST00000376861.5	384	1422	++	52	P30511-1#1	0	975	ENST00000376861.5	447	1422	+	975	0	-650	8835
P30511-1#1	0	325	325	P30511-1	21	346	+	325	P30511-1	0	346	ENST00000334668.8	124	1162	++	30	P30511-1#1	0	975	ENST00000334668.8	187	1162	+	975	0	-650	8836
P30511-1#1	0	325	325	P30511-1	21	346	+	325	P30511-1	0	345	ENST00000259951.12	30	1065	++	6	P30511-1#1	0	972	ENST00000259951.12	93	1065	+	972	0	-647	8837
P30511-1#2	0	284	284	P30511-1	21	305	+	284	P30511-1	298	334	ENST00000475996.1	1	109	++	112	P30511-1#2	831	852	ENST00000475996.1	1	22	+	21	831	-568	8838
P30511-1#2	0	284	284	P30511-1	21	305	+	284	P30511-1	211	345	ENST00000465459.2	0	402	++	109	P30511-1#2	570	852	ENST00000465459.2	0	282	+	282	570	-568	8839
P30511-1#2	0	284	284	P30511-1	21	305	+	284	P30511-1	0	204	ENST00000434407.6	0	612	++	83	P30511-1#2	0	549	ENST00000434407.6	63	612	+	549	0	-265	8840
P30511-1#2	0	284	284	P30511-1	21	305	+	284	P30511-1	0	346	ENST00000376861.5	384	1422	++	52	P30511-1#2	0	852	ENST00000376861.5	447	1299	+	852	0	-568	8841
P30511-1#2	0	284	284	P30511-1	21	305	+	284	P30511-1	0	346	ENST00000334668.8	124	1162	++	30	P30511-1#2	0	852	ENST00000334668.8	187	1039	+	852	0	-568	8842
P30511-1#2	0	284	284	P30511-1	21	305	+	284	P30511-1	0	345	ENST00000259951.12	30	1065	++	6	P30511-1#2	0	852	ENST00000259951.12	93	945	+	852	0	-568	8843
P30511-1#3	0	24	24	P30511-1	305	329	+	24	P30511-1	298	334	ENST00000475996.1	1	109	++	112	P30511-1#3	0	72	ENST00000475996.1	22	94	+	72	0	-48	8844
P30511-1#3	0	24	24	P30511-1	305	329	+	24	P30511-1	211	345	ENST00000465459.2	0	402	++	109	P30511-1#3	0	72	ENST00000465459.2	282	354	+	72	0	-48	8845
P30511-1#3	0	24	24	P30511-1	305	329	+	24	P30511-1	325	345	ENST00000444621.1	2	80	++	93	P30511-1#3	60	72	ENST00000444621.1	2	14	+	12	60	-48	8846
P30511-1#3	0	24	24	P30511-1	305	329	+	24	P30511-1	0	346	ENST00000376861.5	384	1422	++	52	P30511-1#3	0	72	ENST00000376861.5	1299	1371	+	72	0	-48	8847
P30511-1#3	0	24	24	P30511-1	305	329	+	24	P30511-1	0	346	ENST00000334668.8	124	1162	++	30	P30511-1#3	0	72	ENST00000334668.8	1039	1111	+	72	0	-48	8848
P30511-1#3	0	24	24	P30511-1	305	329	+	24	P30511-1	0	345	ENST00000259951.12	30	1065	++	6	P30511-1#3	0	72	ENST00000259951.12	945	1017	+	72	0	-48	8849
P30511-1#4	0	17	17	P30511-1	329	346	+	17	P30511-1	298	334	ENST00000475996.1	1	109	++	112	P30511-1#4	0	15	ENST00000475996.1	94	109	+	15	0	2	8850
P30511-1#4	0	17	17	P30511-1	329	346	+	17	P30511-1	211	345	ENST00000465459.2	0	402	++	109	P30511-1#4	0	48	ENST00000465459.2	354	402	+	48	0	-31	8851
P30511-1#4	0	17	17	P30511-1	329	346	+	17	P30511-1	325	345	ENST00000444621.1	2	80	++	93	P30511-1#4	0	48	ENST00000444621.1	14	80	+	48	0	-31	8852
P30511-1#4	0	17	17	P30511-1	329	346	+	17	P30511-1	0	346	ENST00000376861.5	384	1422	++	52	P30511-1#4	0	51	ENST00000376861.5	1371	1422	+	51	0	-34	8853
P30511-1#4	0	17	17	P30511-1	329	346	+	17	P30511-1	0	346	ENST00000334668.8	124	1162	++	30	P30511-1#4	0	51	ENST00000334668.8	1111	1162	+	51	0	-34	8854
P30511-1#4	0	17	17	P30511-1	329	346	+	17	P30511-1	0	345	ENST00000259951.12	30	1065	++	6	P30511-1#4	0	48	ENST00000259951.12	1017	1065	+	48	0	-31	8855
P30511-1#5	0	91	91	P30511-1	205	296	+	91	P30511-1	211	345	ENST00000465459.2	0	402	++	109	P30511-1#5	18	273	ENST00000465459.2	0	255	+	255	18	-182	8856
P30511-1#5	0	91	91	P30511-1	205	296	+	91	P30511-1	0	346	ENST00000376861.5	384	1422	++	52	P30511-1#5	0	273	ENST00000376861.5	999	1272	+	273	0	-182	8857
P30511-1#5	0	91	91	P30511-1	205	296	+	91	P30511-1	0	346	ENST00000334668.8	124	1162	++	30	P30511-1#5	0	273	ENST00000334668.8	739	1012	+	273	0	-182	8858
P30511-1#5	0	91	91	P30511-1	205	296	+	91	P30511-1	0	345	ENST00000259951.12	30	1065	++	6	P30511-1#5	0	273	ENST00000259951.12	645	918	+	273	0	-182	8859
P30511-1#6	0	90	90	P30511-1	21	111	+	90	P30511-1	0	204	ENST00000434407.6	0	612	++	83	P30511-1#6	0	270	ENST00000434407.6	63	333	+	270	0	-180	8860
P30511-1#6	0	90	90	P30511-1	21	111	+	90	P30511-1	0	346	ENST00000376861.5	384	1422	++	52	P30511-1#6	0	270	ENST00000376861.5	447	717	+	270	0	-180	8861
P30511-1#6	0	90	90	P30511-1	21	111	+	90	P30511-1	0	346	ENST00000334668.8	124	1162	++	30	P30511-1#6	0	270	ENST00000334668.8	187	457	+	270	0	-180	8862
P30511-1#6	0	90	90	P30511-1	21	111	+	90	P30511-1	0	345	ENST00000259951.12	30	1065	++	6	P30511-1#6	0	270	ENST00000259951.12	93	363	+	270	0	-180	8863
P30511-1#7	0	92	92	P30511-1	111	203	+	92	P30511-1	0	204	ENST00000434407.6	0	612	++	83	P30511-1#7	0	276	ENST00000434407.6	333	609	+	276	0	-184	8864
P30511-1#7	0	92	92	P30511-1	111	203	+	92	P30511-1	0	346	ENST00000376861.5	384	1422	++	52	P30511-1#7	0	276	ENST00000376861.5	717	993	+	276	0	-184	8865
P30511-1#7	0	92	92	P30511-1	111	203	+	92	P30511-1	0	346	ENST00000334668.8	124	1162	++	30	P30511-1#7	0	276	ENST00000334668.8	457	733	+	276	0	-184	8866
P30511-1#7	0	92	92	P30511-1	111	203	+	92	P30511-1	0	345	ENST00000259951.12	30	1065	++	6	P30511-1#7	0	276	ENST00000259951.12	363	639	+	276	0	-184	8867
P30511-1#8	0	92	92	P30511-1	203	295	+	92	P30511-1	211	345	ENST00000465459.2	0	402	++	109	P30511-1#8	24	276	ENST00000465459.2	0	252	+	252	24	-184	8868
P30511-1#8	0	92	92	P30511-1	203	295	+	92	P30511-1	0	204	ENST00000434407.6	0	612	++	83	P30511-1#8	0	3	ENST00000434407.6	609	612	+	3	0	89	8869
P30511-1#8	0	92	92	P30511-1	203	295	+	92	P30511-1	0	346	ENST00000376861.5	384	1422	++	52	P30511-1#8	0	276	ENST00000376861.5	993	1269	+	276	0	-184	8870
P30511-1#8	0	92	92	P30511-1	203	295	+	92	P30511-1	0	346	ENST00000334668.8	124	1162	++	30	P30511-1#8	0	276	ENST00000334668.8	733	1009	+	276	0	-184	8871
P30511-1#8	0	92	92	P30511-1	203	295	+	92	P30511-1	0	345	ENST00000259951.12	30	1065	++	6	P30511-1#8	0	276	ENST00000259951.12	639	915	+	276	0	-184	8872
P30511-1#9	0	10	10	P30511-1	295	305	+	10	P30511-1	298	334	ENST00000475996.1	1	109	++	112	P30511-1#9	9	30	ENST00000475996.1	1	22	+	21	9	-20	8873
P30511-1#9	0	10	10	P30511-1	295	305	+	10	P30511-1	211	345	ENST00000465459.2	0	402	++	109	P30511-1#9	0	30	ENST00000465459.2	252	282	+	30	0	-20	8874
P30511-1#9	0	10	10	P30511-1	295	305	+	10	P30511-1	0	346	ENST00000376861.5	384	1422	++	52	P30511-1#9	0	30	ENST00000376861.5	1269	1299	+	30	0	-20	8875
P30511-1#9	0	10	10	P30511-1	295	305	+	10	P30511-1	0	346	ENST00000334668.8	124	1162	++	30	P30511-1#9	0	30	ENST00000334668.8	1009	1039	+	30	0	-20	8876
P30511-1#9	0	10	10	P30511-1	295	305	+	10	P30511-1	0	345	ENST00000259951.12	30	1065	++	6	P30511-1#9	0	30	ENST00000259951.12	915	945	+	30	0	-20	8877
P30511-1#10	0	3	3	P30511-1	335	338	+	3	P30511-1	211	345	ENST00000465459.2	0	402	++	109	P30511-1#10	0	9	ENST00000465459.2	372	381	+	9	0	-6	8878
P30511-1#10	0	3	3	P30511-1	335	338	+	3	P30511-1	325	345	ENST00000444621.1	2	80	++	93	P30511-1#10	0	9	ENST00000444621.1	50	59	+	9	0	-6	8879
P30511-1#10	0	3	3	P30511-1	335	338	+	3	P30511-1	0	346	ENST00000376861.5	384	1422	++	52	P30511-1#10	0	9	ENST00000376861.5	1389	1398	+	9	0	-6	8880
P30511-1#10	0	3	3	P30511-1	335	338	+	3	P30511-1	0	346	ENST00000334668.8	124	1162	++	30	P30511-1#10	0	9	ENST00000334668.8	1129	1138	+	9	0	-6	8881
P30511-1#10	0	3	3	P30511-1	335	338	+	3	P30511-1	0	345	ENST00000259951.12	30	1065	++	6	P30511-1#10	0	9	ENST00000259951.12	1035	1044	+	9	0	-6	8882
P30511-1#11	0	1	1	P30511-1	90	91	+	1	P30511-1	0	204	ENST00000434407.6	0	612	++	83	P30511-1#11	0	3	ENST00000434407.6	270	273	+	3	0	-2	8883
P30511-1#11	0	1	1	P30511-1	90	91	+	1	P30511-1	0	346	ENST00000376861.5	384	1422	++	52	P30511-1#11	0	3	ENST00000376861.5	654	657	+	3	0	-2	8884
P30511-1#11	0	1	1	P30511-1	90	91	+	1	P30511-1	0	346	ENST00000334668.8	124	1162	++	30	P30511-1#11	0	3	ENST00000334668.8	394	397	+	3	0	-2	8885
P30511-1#11	0	1	1	P30511-1	90	91	+	1	P30511-1	0	345	ENST00000259951.12	30	1065	++	6	P30511-1#11	0	3	ENST00000259951.12	300	303	+	3	0	-2	8886
P30511-1#12	0	1	1	P30511-1	104	105	+	1	P30511-1	0	204	ENST00000434407.6	0	612	++	83	P30511-1#12	0	3	ENST00000434407.6	312	315	+	3	0	-2	8887
P30511-1#12	0	1	1	P30511-1	104	105	+	1	P30511-1	0	346	ENST00000376861.5	384	1422	++	52	P30511-1#12	0	3	ENST00000376861.5	696	699	+	3	0	-2	8888
P30511-1#12	0	1	1	P30511-1	104	105	+	1	P30511-1	0	346	ENST00000334668.8	124	1162	++	30	P30511-1#12	0	3	ENST00000334668.8	436	439	+	3	0	-2	8889
P30511-1#12	0	1	1	P30511-1	104	105	+	1	P30511-1	0	345	ENST00000259951.12	30	1065	++	6	P30511-1#12	0	3	ENST00000259951.12	342	345	+	3	0	-2	8890
P30511-1#13	0	1	1	P30511-1	163	164	+	1	P30511-1	0	204	ENST00000434407.6	0	612	++	83	P30511-1#13	0	3	ENST00000434407.6	489	492	+	3	0	-2	8891
P30511-1#13	0	1	1	P30511-1	163	164	+	1	P30511-1	0	346	ENST00000376861.5	384	1422	++	52	P30511-1#13	0	3	ENST00000376861.5	873	876	+	3	0	-2	8892
P30511-1#13	0	1	1	P30511-1	163	164	+	1	P30511-1	0	346	ENST00000334668.8	124	1162	++	30	P30511-1#13	0	3	ENST00000334668.8	613	616	+	3	0	-2	8893
P30511-1#13	0	1	1	P30511-1	163	164	+	1	P30511-1	0	345	ENST00000259951.12	30	1065	++	6	P30511-1#13	0	3	ENST00000259951.12	519	522	+	3	0	-2	8894
P30511-1#14	0	1	1	P30511-1	167	168	+	1	P30511-1	0	204	ENST00000434407.6	0	612	++	83	P30511-1#14	0	3	ENST00000434407.6	501	504	+	3	0	-2	8895
P30511-1#14	0	1	1	P30511-1	167	168	+	1	P30511-1	0	346	ENST00000376861.5	384	1422	++	52	P30511-1#14	0	3	ENST00000376861.5	885	888	+	3	0	-2	8896
P30511-1#14	0	1	1	P30511-1	167	168	+	1	P30511-1	0	346	ENST00000334668.8	124	1162	++	30	P30511-1#14	0	3	ENST00000334668.8	625	628	+	3	0	-2	8897
P30511-1#14	0	1	1	P30511-1	167	168	+	1	P30511-1	0	345	ENST00000259951.12	30	1065	++	6	P30511-1#14	0	3	ENST00000259951.12	531	534	+	3	0	-2	8898
P30511-1#15	0	1	1	P30511-1	175	176	+	1	P30511-1	0	204	ENST00000434407.6	0	612	++	83	P30511-1#15	0	3	ENST00000434407.6	525	528	+	3	0	-2	8899
P30511-1#15	0	1	1	P30511-1	175	176	+	1	P30511-1	0	346	ENST00000376861.5	384	1422	++	52	P30511-1#15	0	3	ENST00000376861.5	909	912	+	3	0	-2	8900
P30511-1#15	0	1	1	P30511-1	175	176	+	1	P30511-1	0	346	ENST00000334668.8	124	1162	++	30	P30511-1#15	0	3	ENST00000334668.8	649	652	+	3	0	-2	8901
P30511-1#15	0	1	1	P30511-1	175	176	+	1	P30511-1	0	345	ENST00000259951.12	30	1065	++	6	P30511-1#15	0	3	ENST00000259951.12	555	558	+	3	0	-2	8902
P30511-1#16	0	1	1	P30511-1	106	107	+	1	P30511-1	0	204	ENST00000434407.6	0	612	++	83	P30511-1#16	0	3	ENST00000434407.6	318	321	+	3	0	-2	8903
P30511-1#16	0	1	1	P30511-1	106	107	+	1	P30511-1	0	346	ENST00000376861.5	384	1422	++	52	P30511-1#16	0	3	ENST00000376861.5	702	705	+	3	0	-2	8904
P30511-1#16	0	1	1	P30511-1	106	107	+	1	P30511-1	0	346	ENST00000334668.8	124	1162	++	30	P30511-1#16	0	3	ENST00000334668.8	442	445	+	3	0	-2	8905
P30511-1#16	0	1	1	P30511-1	106	107	+	1	P30511-1	0	345	ENST00000259951.12	30	1065	++	6	P30511-1#16	0	3	ENST00000259951.12	348	351	+	3	0	-2	8906
P30511-1#17	0	64	64	P30511-1	121	185	+	64	P30511-1	0	204	ENST00000434407.6	0	612	++	83	P30511-1#17	0	192	ENST00000434407.6	363	555	+	192	0	-128	8907
P30511-1#17	0	64	64	P30511-1	121	185	+	64	P30511-1	0	346	ENST00000376861.5	384	1422	++	52	P30511-1#17	0	192	ENST00000376861.5	747	939	+	192	0	-128	8908
P30511-1#17	0	64	64	P30511-1	121	185	+	64	P30511-1	0	346	ENST00000334668.8	124	1162	++	30	P30511-1#17	0	192	ENST00000334668.8	487	679	+	192	0	-128	8909
P30511-1#17	0	64	64	P30511-1	121	185	+	64	P30511-1	0	345	ENST00000259951.12	30	1065	++	6	P30511-1#17	0	192	ENST00000259951.12	393	585	+	192	0	-128	8910
P30511-1#18	0	57	57	P30511-1	223	280	+	57	P30511-1	211	345	ENST00000465459.2	0	402	++	109	P30511-1#18	0	171	ENST00000465459.2	36	207	+	171	0	-114	8911
P30511-1#18	0	57	57	P30511-1	223	280	+	57	P30511-1	0	346	ENST00000376861.5	384	1422	++	52	P30511-1#18	0	171	ENST00000376861.5	1053	1224	+	171	0	-114	8912
P30511-1#18	0	57	57	P30511-1	223	280	+	57	P30511-1	0	346	ENST00000334668.8	124	1162	++	30	P30511-1#18	0	171	ENST00000334668.8	793	964	+	171	0	-114	8913
P30511-1#18	0	57	57	P30511-1	223	280	+	57	P30511-1	0	345	ENST00000259951.12	30	1065	++	6	P30511-1#18	0	171	ENST00000259951.12	699	870	+	171	0	-114	8914
P30511-1#19	0	92	92	P30511-1	203	295	+	92	P30511-1	211	345	ENST00000465459.2	0	402	++	109	P30511-1#19	24	276	ENST00000465459.2	0	252	+	252	24	-184	8915
P30511-1#19	0	92	92	P30511-1	203	295	+	92	P30511-1	0	204	ENST00000434407.6	0	612	++	83	P30511-1#19	0	3	ENST00000434407.6	609	612	+	3	0	89	8916
P30511-1#19	0	92	92	P30511-1	203	295	+	92	P30511-1	0	346	ENST00000376861.5	384	1422	++	52	P30511-1#19	0	276	ENST00000376861.5	993	1269	+	276	0	-184	8917
P30511-1#19	0	92	92	P30511-1	203	295	+	92	P30511-1	0	346	ENST00000334668.8	124	1162	++	30	P30511-1#19	0	276	ENST00000334668.8	733	1009	+	276	0	-184	8918
P30511-1#19	0	92	92	P30511-1	203	295	+	92	P30511-1	0	345	ENST00000259951.12	30	1065	++	6	P30511-1#19	0	276	ENST00000259951.12	639	915	+	276	0	-184	8919
P30511-1#20	0	1	1	P30511-1	345	346	+	1	P30511-1	0	346	ENST00000376861.5	384	1422	++	52	P30511-1#20	0	3	ENST00000376861.5	1419	1422	+	3	0	-2	8920
P30511-1#20	0	1	1	P30511-1	345	346	+	1	P30511-1	0	346	ENST00000334668.8	124	1162	++	30	P30511-1#20	0	3	ENST00000334668.8	1159	1162	+	3	0	-2	8921
P30511-1#21	0	1	1	P30511-1	12	13	+	1	P30511-1	0	204	ENST00000434407.6	0	612	++	83	P30511-1#21	0	3	ENST00000434407.6	36	39	+	3	0	-2	8922
P30511-1#21	0	1	1	P30511-1	12	13	+	1	P30511-1	0	346	ENST00000376861.5	384	1422	++	52	P30511-1#21	0	3	ENST00000376861.5	420	423	+	3	0	-2	8923
P30511-1#21	0	1	1	P30511-1	12	13	+	1	P30511-1	0	346	ENST00000334668.8	124	1162	++	30	P30511-1#21	0	3	ENST00000334668.8	160	163	+	3	0	-2	8924
P30511-1#21	0	1	1	P30511-1	12	13	+	1	P30511-1	0	345	ENST00000259951.12	30	1065	++	6	P30511-1#21	0	3	ENST00000259951.12	66	69	+	3	0	-2	8925
P30511-1#22	0	1	1	P30511-1	70	71	+	1	P30511-1	0	204	ENST00000434407.6	0	612	++	83	P30511-1#22	0	3	ENST00000434407.6	210	213	+	3	0	-2	8926
P30511-1#22	0	1	1	P30511-1	70	71	+	1	P30511-1	0	346	ENST00000376861.5	384	1422	++	52	P30511-1#22	0	3	ENST00000376861.5	594	597	+	3	0	-2	8927
P30511-1#22	0	1	1	P30511-1	70	71	+	1	P30511-1	0	346	ENST00000334668.8	124	1162	++	30	P30511-1#22	0	3	ENST00000334668.8	334	337	+	3	0	-2	8928
P30511-1#22	0	1	1	P30511-1	70	71	+	1	P30511-1	0	345	ENST00000259951.12	30	1065	++	6	P30511-1#22	0	3	ENST00000259951.12	240	243	+	3	0	-2	8929
P30511-1#23	0	1	1	P30511-1	271	272	+	1	P30511-1	211	345	ENST00000465459.2	0	402	++	109	P30511-1#23	0	3	ENST00000465459.2	180	183	+	3	0	-2	8930
P30511-1#23	0	1	1	P30511-1	271	272	+	1	P30511-1	0	346	ENST00000376861.5	384	1422	++	52	P30511-1#23	0	3	ENST00000376861.5	1197	1200	+	3	0	-2	8931
P30511-1#23	0	1	1	P30511-1	271	272	+	1	P30511-1	0	346	ENST00000334668.8	124	1162	++	30	P30511-1#23	0	3	ENST00000334668.8	937	940	+	3	0	-2	8932
P30511-1#23	0	1	1	P30511-1	271	272	+	1	P30511-1	0	345	ENST00000259951.12	30	1065	++	6	P30511-1#23	0	3	ENST00000259951.12	843	846	+	3	0	-2	8933
P30511-1#24	0	1	1	P30511-1	82	83	+	1	P30511-1	0	204	ENST00000434407.6	0	612	++	83	P30511-1#24	0	3	ENST00000434407.6	246	249	+	3	0	-2	8934
P30511-1#24	0	1	1	P30511-1	82	83	+	1	P30511-1	0	346	ENST00000376861.5	384	1422	++	52	P30511-1#24	0	3	ENST00000376861.5	630	633	+	3	0	-2	8935
P30511-1#24	0	1	1	P30511-1	82	83	+	1	P30511-1	0	346	ENST00000334668.8	124	1162	++	30	P30511-1#24	0	3	ENST00000334668.8	370	373	+	3	0	-2	8936
P30511-1#24	0	1	1	P30511-1	82	83	+	1	P30511-1	0	345	ENST00000259951.12	30	1065	++	6	P30511-1#24	0	3	ENST00000259951.12	276	279	+	3	0	-2	8937
P30511-1#25	0	3	3	P30511-1	335	338	+	3	P30511-1	211	345	ENST00000465459.2	0	402	++	109	P30511-1#25	0	9	ENST00000465459.2	372	381	+	9	0	-6	8938
P30511-1#25	0	3	3	P30511-1	335	338	+	3	P30511-1	325	345	ENST00000444621.1	2	80	++	93	P30511-1#25	0	9	ENST00000444621.1	50	59	+	9	0	-6	8939
P30511-1#25	0	3	3	P30511-1	335	338	+	3	P30511-1	0	346	ENST00000376861.5	384	1422	++	52	P30511-1#25	0	9	ENST00000376861.5	1389	1398	+	9	0	-6	8940
P30511-1#25	0	3	3	P30511-1	335	338	+	3	P30511-1	0	346	ENST00000334668.8	124	1162	++	30	P30511-1#25	0	9	ENST00000334668.8	1129	1138	+	9	0	-6	8941
P30511-1#25	0	3	3	P30511-1	335	338	+	3	P30511-1	0	345	ENST00000259951.12	30	1065	++	6	P30511-1#25	0	9	ENST00000259951.12	1035	1044	+	9	0	-6	8942
P30511-1#26	0	3	3	P30511-1	335	338	+	3	P30511-1	211	345	ENST00000465459.2	0	402	++	109	P30511-1#26	0	9	ENST00000465459.2	372	381	+	9	0	-6	8943
P30511-1#26	0	3	3	P30511-1	335	338	+	3	P30511-1	325	345	ENST00000444621.1	2	80	++	93	P30511-1#26	0	9	ENST00000444621.1	50	59	+	9	0	-6	8944
P30511-1#26	0	3	3	P30511-1	335	338	+	3	P30511-1	0	346	ENST00000376861.5	384	1422	++	52	P30511-1#26	0	9	ENST00000376861.5	1389	1398	+	9	0	-6	8945
P30511-1#26	0	3	3	P30511-1	335	338	+	3	P30511-1	0	346	ENST00000334668.8	124	1162	++	30	P30511-1#26	0	9	ENST00000334668.8	1129	1138	+	9	0	-6	8946
P30511-1#26	0	3	3	P30511-1	335	338	+	3	P30511-1	0	345	ENST00000259951.12	30	1065	++	6	P30511-1#26	0	9	ENST00000259951.12	1035	1044	+	9	0	-6	8947
P30511-1#27	0	1	1	P30511-1	345	346	+	1	P30511-1	0	346	ENST00000376861.5	384	1422	++	52	P30511-1#27	0	3	ENST00000376861.5	1419	1422	+	3	0	-2	8948
P30511-1#27	0	1	1	P30511-1	345	346	+	1	P30511-1	0	346	ENST00000334668.8	124	1162	++	30	P30511-1#27	0	3	ENST00000334668.8	1159	1162	+	3	0	-2	8949
P30511-1#28	0	1	1	P30511-1	345	346	+	1	P30511-1	0	346	ENST00000376861.5	384	1422	++	52	P30511-1#28	0	3	ENST00000376861.5	1419	1422	+	3	0	-2	8950
P30511-1#28	0	1	1	P30511-1	345	346	+	1	P30511-1	0	346	ENST00000334668.8	124	1162	++	30	P30511-1#28	0	3	ENST00000334668.8	1159	1162	+	3	0	-2	8951
P30511-1#29	0	12	12	P30511-1	23	35	+	12	P30511-1	0	204	ENST00000434407.6	0	612	++	83	P30511-1#29	0	36	ENST00000434407.6	69	105	+	36	0	-24	8952
P30511-1#29	0	12	12	P30511-1	23	35	+	12	P30511-1	0	346	ENST00000376861.5	384	1422	++	52	P30511-1#29	0	36	ENST00000376861.5	453	489	+	36	0	-24	8953
P30511-1#29	0	12	12	P30511-1	23	35	+	12	P30511-1	0	346	ENST00000334668.8	124	1162	++	30	P30511-1#29	0	36	ENST00000334668.8	193	229	+	36	0	-24	8954
P30511-1#29	0	12	12	P30511-1	23	35	+	12	P30511-1	0	345	ENST00000259951.12	30	1065	++	6	P30511-1#29	0	36	ENST00000259951.12	99	135	+	36	0	-24	8955
P30511-1#30	0	3	3	P30511-1	35	38	+	3	P30511-1	0	204	ENST00000434407.6	0	612	++	83	P30511-1#30	0	9	ENST00000434407.6	105	114	+	9	0	-6	8956
P30511-1#30	0	3	3	P30511-1	35	38	+	3	P30511-1	0	346	ENST00000376861.5	384	1422	++	52	P30511-1#30	0	9	ENST00000376861.5	489	498	+	9	0	-6	8957
P30511-1#30	0	3	3	P30511-1	35	38	+	3	P30511-1	0	346	ENST00000334668.8	124	1162	++	30	P30511-1#30	0	9	ENST00000334668.8	229	238	+	9	0	-6	8958
P30511-1#30	0	3	3	P30511-1	35	38	+	3	P30511-1	0	345	ENST00000259951.12	30	1065	++	6	P30511-1#30	0	9	ENST00000259951.12	135	144	+	9	0	-6	8959
P30511-1#31	0	11	11	P30511-1	38	49	+	11	P30511-1	0	204	ENST00000434407.6	0	612	++	83	P30511-1#31	0	33	ENST00000434407.6	114	147	+	33	0	-22	8960
P30511-1#31	0	11	11	P30511-1	38	49	+	11	P30511-1	0	346	ENST00000376861.5	384	1422	++	52	P30511-1#31	0	33	ENST00000376861.5	498	531	+	33	0	-22	8961
P30511-1#31	0	11	11	P30511-1	38	49	+	11	P30511-1	0	346	ENST00000334668.8	124	1162	++	30	P30511-1#31	0	33	ENST00000334668.8	238	271	+	33	0	-22	8962
P30511-1#31	0	11	11	P30511-1	38	49	+	11	P30511-1	0	345	ENST00000259951.12	30	1065	++	6	P30511-1#31	0	33	ENST00000259951.12	144	177	+	33	0	-22	8963
P30511-1#32	0	7	7	P30511-1	51	58	+	7	P30511-1	0	204	ENST00000434407.6	0	612	++	83	P30511-1#32	0	21	ENST00000434407.6	153	174	+	21	0	-14	8964
P30511-1#32	0	7	7	P30511-1	51	58	+	7	P30511-1	0	346	ENST00000376861.5	384	1422	++	52	P30511-1#32	0	21	ENST00000376861.5	537	558	+	21	0	-14	8965
P30511-1#32	0	7	7	P30511-1	51	58	+	7	P30511-1	0	346	ENST00000334668.8	124	1162	++	30	P30511-1#32	0	21	ENST00000334668.8	277	298	+	21	0	-14	8966
P30511-1#32	0	7	7	P30511-1	51	58	+	7	P30511-1	0	345	ENST00000259951.12	30	1065	++	6	P30511-1#32	0	21	ENST00000259951.12	183	204	+	21	0	-14	8967
P30511-1#33	0	3	3	P30511-1	60	63	+	3	P30511-1	0	204	ENST00000434407.6	0	612	++	83	P30511-1#33	0	9	ENST00000434407.6	180	189	+	9	0	-6	8968
P30511-1#33	0	3	3	P30511-1	60	63	+	3	P30511-1	0	346	ENST00000376861.5	384	1422	++	52	P30511-1#33	0	9	ENST00000376861.5	564	573	+	9	0	-6	8969
P30511-1#33	0	3	3	P30511-1	60	63	+	3	P30511-1	0	346	ENST00000334668.8	124	1162	++	30	P30511-1#33	0	9	ENST00000334668.8	304	313	+	9	0	-6	8970
P30511-1#33	0	3	3	P30511-1	60	63	+	3	P30511-1	0	345	ENST00000259951.12	30	1065	++	6	P30511-1#33	0	9	ENST00000259951.12	210	219	+	9	0	-6	8971
P30511-1#34	0	4	4	P30511-1	66	70	+	4	P30511-1	0	204	ENST00000434407.6	0	612	++	83	P30511-1#34	0	12	ENST00000434407.6	198	210	+	12	0	-8	8972
P30511-1#34	0	4	4	P30511-1	66	70	+	4	P30511-1	0	346	ENST00000376861.5	384	1422	++	52	P30511-1#34	0	12	ENST00000376861.5	582	594	+	12	0	-8	8973
P30511-1#34	0	4	4	P30511-1	66	70	+	4	P30511-1	0	346	ENST00000334668.8	124	1162	++	30	P30511-1#34	0	12	ENST00000334668.8	322	334	+	12	0	-8	8974
P30511-1#34	0	4	4	P30511-1	66	70	+	4	P30511-1	0	345	ENST00000259951.12	30	1065	++	6	P30511-1#34	0	12	ENST00000259951.12	228	240	+	12	0	-8	8975
P30511-1#35	0	3	3	P30511-1	70	73	+	3	P30511-1	0	204	ENST00000434407.6	0	612	++	83	P30511-1#35	0	9	ENST00000434407.6	210	219	+	9	0	-6	8976
P30511-1#35	0	3	3	P30511-1	70	73	+	3	P30511-1	0	346	ENST00000376861.5	384	1422	++	52	P30511-1#35	0	9	ENST00000376861.5	594	603	+	9	0	-6	8977
P30511-1#35	0	3	3	P30511-1	70	73	+	3	P30511-1	0	346	ENST00000334668.8	124	1162	++	30	P30511-1#35	0	9	ENST00000334668.8	334	343	+	9	0	-6	8978
P30511-1#35	0	3	3	P30511-1	70	73	+	3	P30511-1	0	345	ENST00000259951.12	30	1065	++	6	P30511-1#35	0	9	ENST00000259951.12	240	249	+	9	0	-6	8979
P30511-1#36	0	28	28	P30511-1	77	105	+	28	P30511-1	0	204	ENST00000434407.6	0	612	++	83	P30511-1#36	0	84	ENST00000434407.6	231	315	+	84	0	-56	8980
P30511-1#36	0	28	28	P30511-1	77	105	+	28	P30511-1	0	346	ENST00000376861.5	384	1422	++	52	P30511-1#36	0	84	ENST00000376861.5	615	699	+	84	0	-56	8981
P30511-1#36	0	28	28	P30511-1	77	105	+	28	P30511-1	0	346	ENST00000334668.8	124	1162	++	30	P30511-1#36	0	84	ENST00000334668.8	355	439	+	84	0	-56	8982
P30511-1#36	0	28	28	P30511-1	77	105	+	28	P30511-1	0	345	ENST00000259951.12	30	1065	++	6	P30511-1#36	0	84	ENST00000259951.12	261	345	+	84	0	-56	8983
P30511-1#37	0	10	10	P30511-1	114	124	+	10	P30511-1	0	204	ENST00000434407.6	0	612	++	83	P30511-1#37	0	30	ENST00000434407.6	342	372	+	30	0	-20	8984
P30511-1#37	0	10	10	P30511-1	114	124	+	10	P30511-1	0	346	ENST00000376861.5	384	1422	++	52	P30511-1#37	0	30	ENST00000376861.5	726	756	+	30	0	-20	8985
P30511-1#37	0	10	10	P30511-1	114	124	+	10	P30511-1	0	346	ENST00000334668.8	124	1162	++	30	P30511-1#37	0	30	ENST00000334668.8	466	496	+	30	0	-20	8986
P30511-1#37	0	10	10	P30511-1	114	124	+	10	P30511-1	0	345	ENST00000259951.12	30	1065	++	6	P30511-1#37	0	30	ENST00000259951.12	372	402	+	30	0	-20	8987
P30511-1#38	0	12	12	P30511-1	127	139	+	12	P30511-1	0	204	ENST00000434407.6	0	612	++	83	P30511-1#38	0	36	ENST00000434407.6	381	417	+	36	0	-24	8988
P30511-1#38	0	12	12	P30511-1	127	139	+	12	P30511-1	0	346	ENST00000376861.5	384	1422	++	52	P30511-1#38	0	36	ENST00000376861.5	765	801	+	36	0	-24	8989
P30511-1#38	0	12	12	P30511-1	127	139	+	12	P30511-1	0	346	ENST00000334668.8	124	1162	++	30	P30511-1#38	0	36	ENST00000334668.8	505	541	+	36	0	-24	8990
P30511-1#38	0	12	12	P30511-1	127	139	+	12	P30511-1	0	345	ENST00000259951.12	30	1065	++	6	P30511-1#38	0	36	ENST00000259951.12	411	447	+	36	0	-24	8991
P30511-1#39	0	6	6	P30511-1	141	147	+	6	P30511-1	0	204	ENST00000434407.6	0	612	++	83	P30511-1#39	0	18	ENST00000434407.6	423	441	+	18	0	-12	8992
P30511-1#39	0	6	6	P30511-1	141	147	+	6	P30511-1	0	346	ENST00000376861.5	384	1422	++	52	P30511-1#39	0	18	ENST00000376861.5	807	825	+	18	0	-12	8993
P30511-1#39	0	6	6	P30511-1	141	147	+	6	P30511-1	0	346	ENST00000334668.8	124	1162	++	30	P30511-1#39	0	18	ENST00000334668.8	547	565	+	18	0	-12	8994
P30511-1#39	0	6	6	P30511-1	141	147	+	6	P30511-1	0	345	ENST00000259951.12	30	1065	++	6	P30511-1#39	0	18	ENST00000259951.12	453	471	+	18	0	-12	8995
P30511-1#40	0	5	5	P30511-1	153	158	+	5	P30511-1	0	204	ENST00000434407.6	0	612	++	83	P30511-1#40	0	15	ENST00000434407.6	459	474	+	15	0	-10	8996
P30511-1#40	0	5	5	P30511-1	153	158	+	5	P30511-1	0	346	ENST00000376861.5	384	1422	++	52	P30511-1#40	0	15	ENST00000376861.5	843	858	+	15	0	-10	8997
P30511-1#40	0	5	5	P30511-1	153	158	+	5	P30511-1	0	346	ENST00000334668.8	124	1162	++	30	P30511-1#40	0	15	ENST00000334668.8	583	598	+	15	0	-10	8998
P30511-1#40	0	5	5	P30511-1	153	158	+	5	P30511-1	0	345	ENST00000259951.12	30	1065	++	6	P30511-1#40	0	15	ENST00000259951.12	489	504	+	15	0	-10	8999
P30511-1#41	0	10	10	P30511-1	160	170	+	10	P30511-1	0	204	ENST00000434407.6	0	612	++	83	P30511-1#41	0	30	ENST00000434407.6	480	510	+	30	0	-20	9000
P30511-1#41	0	10	10	P30511-1	160	170	+	10	P30511-1	0	346	ENST00000376861.5	384	1422	++	52	P30511-1#41	0	30	ENST00000376861.5	864	894	+	30	0	-20	9001
P30511-1#41	0	10	10	P30511-1	160	170	+	10	P30511-1	0	346	ENST00000334668.8	124	1162	++	30	P30511-1#41	0	30	ENST00000334668.8	604	634	+	30	0	-20	9002
P30511-1#41	0	10	10	P30511-1	160	170	+	10	P30511-1	0	345	ENST00000259951.12	30	1065	++	6	P30511-1#41	0	30	ENST00000259951.12	510	540	+	30	0	-20	9003
P30511-1#42	0	10	10	P30511-1	172	182	+	10	P30511-1	0	204	ENST00000434407.6	0	612	++	83	P30511-1#42	0	30	ENST00000434407.6	516	546	+	30	0	-20	9004
P30511-1#42	0	10	10	P30511-1	172	182	+	10	P30511-1	0	346	ENST00000376861.5	384	1422	++	52	P30511-1#42	0	30	ENST00000376861.5	900	930	+	30	0	-20	9005
P30511-1#42	0	10	10	P30511-1	172	182	+	10	P30511-1	0	346	ENST00000334668.8	124	1162	++	30	P30511-1#42	0	30	ENST00000334668.8	640	670	+	30	0	-20	9006
P30511-1#42	0	10	10	P30511-1	172	182	+	10	P30511-1	0	345	ENST00000259951.12	30	1065	++	6	P30511-1#42	0	30	ENST00000259951.12	546	576	+	30	0	-20	9007
P30511-1#43	0	12	12	P30511-1	183	195	+	12	P30511-1	0	204	ENST00000434407.6	0	612	++	83	P30511-1#43	0	36	ENST00000434407.6	549	585	+	36	0	-24	9008
P30511-1#43	0	12	12	P30511-1	183	195	+	12	P30511-1	0	346	ENST00000376861.5	384	1422	++	52	P30511-1#43	0	36	ENST00000376861.5	933	969	+	36	0	-24	9009
P30511-1#43	0	12	12	P30511-1	183	195	+	12	P30511-1	0	346	ENST00000334668.8	124	1162	++	30	P30511-1#43	0	36	ENST00000334668.8	673	709	+	36	0	-24	9010
P30511-1#43	0	12	12	P30511-1	183	195	+	12	P30511-1	0	345	ENST00000259951.12	30	1065	++	6	P30511-1#43	0	36	ENST00000259951.12	579	615	+	36	0	-24	9011
P30511-1#44	0	4	4	P30511-1	196	200	+	4	P30511-1	0	204	ENST00000434407.6	0	612	++	83	P30511-1#44	0	12	ENST00000434407.6	588	600	+	12	0	-8	9012
P30511-1#44	0	4	4	P30511-1	196	200	+	4	P30511-1	0	346	ENST00000376861.5	384	1422	++	52	P30511-1#44	0	12	ENST00000376861.5	972	984	+	12	0	-8	9013
P30511-1#44	0	4	4	P30511-1	196	200	+	4	P30511-1	0	346	ENST00000334668.8	124	1162	++	30	P30511-1#44	0	12	ENST00000334668.8	712	724	+	12	0	-8	9014
P30511-1#44	0	4	4	P30511-1	196	200	+	4	P30511-1	0	345	ENST00000259951.12	30	1065	++	6	P30511-1#44	0	12	ENST00000259951.12	618	630	+	12	0	-8	9015
P30511-1#45	0	8	8	P30511-1	206	214	+	8	P30511-1	211	345	ENST00000465459.2	0	402	++	109	P30511-1#45	15	24	ENST00000465459.2	0	9	+	9	15	-16	9016
P30511-1#45	0	8	8	P30511-1	206	214	+	8	P30511-1	0	346	ENST00000376861.5	384	1422	++	52	P30511-1#45	0	24	ENST00000376861.5	1002	1026	+	24	0	-16	9017
P30511-1#45	0	8	8	P30511-1	206	214	+	8	P30511-1	0	346	ENST00000334668.8	124	1162	++	30	P30511-1#45	0	24	ENST00000334668.8	742	766	+	24	0	-16	9018
P30511-1#45	0	8	8	P30511-1	206	214	+	8	P30511-1	0	345	ENST00000259951.12	30	1065	++	6	P30511-1#45	0	24	ENST00000259951.12	648	672	+	24	0	-16	9019
P30511-1#46	0	17	17	P30511-1	215	232	+	17	P30511-1	211	345	ENST00000465459.2	0	402	++	109	P30511-1#46	0	51	ENST00000465459.2	12	63	+	51	0	-34	9020
P30511-1#46	0	17	17	P30511-1	215	232	+	17	P30511-1	0	346	ENST00000376861.5	384	1422	++	52	P30511-1#46	0	51	ENST00000376861.5	1029	1080	+	51	0	-34	9021
P30511-1#46	0	17	17	P30511-1	215	232	+	17	P30511-1	0	346	ENST00000334668.8	124	1162	++	30	P30511-1#46	0	51	ENST00000334668.8	769	820	+	51	0	-34	9022
P30511-1#46	0	17	17	P30511-1	215	232	+	17	P30511-1	0	345	ENST00000259951.12	30	1065	++	6	P30511-1#46	0	51	ENST00000259951.12	675	726	+	51	0	-34	9023
P30511-1#47	0	6	6	P30511-1	234	240	+	6	P30511-1	211	345	ENST00000465459.2	0	402	++	109	P30511-1#47	0	18	ENST00000465459.2	69	87	+	18	0	-12	9024
P30511-1#47	0	6	6	P30511-1	234	240	+	6	P30511-1	0	346	ENST00000376861.5	384	1422	++	52	P30511-1#47	0	18	ENST00000376861.5	1086	1104	+	18	0	-12	9025
P30511-1#47	0	6	6	P30511-1	234	240	+	6	P30511-1	0	346	ENST00000334668.8	124	1162	++	30	P30511-1#47	0	18	ENST00000334668.8	826	844	+	18	0	-12	9026
P30511-1#47	0	6	6	P30511-1	234	240	+	6	P30511-1	0	345	ENST00000259951.12	30	1065	++	6	P30511-1#47	0	18	ENST00000259951.12	732	750	+	18	0	-12	9027
P30511-1#48	0	3	3	P30511-1	245	248	+	3	P30511-1	211	345	ENST00000465459.2	0	402	++	109	P30511-1#48	0	9	ENST00000465459.2	102	111	+	9	0	-6	9028
P30511-1#48	0	3	3	P30511-1	245	248	+	3	P30511-1	0	346	ENST00000376861.5	384	1422	++	52	P30511-1#48	0	9	ENST00000376861.5	1119	1128	+	9	0	-6	9029
P30511-1#48	0	3	3	P30511-1	245	248	+	3	P30511-1	0	346	ENST00000334668.8	124	1162	++	30	P30511-1#48	0	9	ENST00000334668.8	859	868	+	9	0	-6	9030
P30511-1#48	0	3	3	P30511-1	245	248	+	3	P30511-1	0	345	ENST00000259951.12	30	1065	++	6	P30511-1#48	0	9	ENST00000259951.12	765	774	+	9	0	-6	9031
P30511-1#49	0	3	3	P30511-1	248	251	+	3	P30511-1	211	345	ENST00000465459.2	0	402	++	109	P30511-1#49	0	9	ENST00000465459.2	111	120	+	9	0	-6	9032
P30511-1#49	0	3	3	P30511-1	248	251	+	3	P30511-1	0	346	ENST00000376861.5	384	1422	++	52	P30511-1#49	0	9	ENST00000376861.5	1128	1137	+	9	0	-6	9033
P30511-1#49	0	3	3	P30511-1	248	251	+	3	P30511-1	0	346	ENST00000334668.8	124	1162	++	30	P30511-1#49	0	9	ENST00000334668.8	868	877	+	9	0	-6	9034
P30511-1#49	0	3	3	P30511-1	248	251	+	3	P30511-1	0	345	ENST00000259951.12	30	1065	++	6	P30511-1#49	0	9	ENST00000259951.12	774	783	+	9	0	-6	9035
P30511-1#50	0	3	3	P30511-1	257	260	+	3	P30511-1	211	345	ENST00000465459.2	0	402	++	109	P30511-1#50	0	9	ENST00000465459.2	138	147	+	9	0	-6	9036
P30511-1#50	0	3	3	P30511-1	257	260	+	3	P30511-1	0	346	ENST00000376861.5	384	1422	++	52	P30511-1#50	0	9	ENST00000376861.5	1155	1164	+	9	0	-6	9037
P30511-1#50	0	3	3	P30511-1	257	260	+	3	P30511-1	0	346	ENST00000334668.8	124	1162	++	30	P30511-1#50	0	9	ENST00000334668.8	895	904	+	9	0	-6	9038
P30511-1#50	0	3	3	P30511-1	257	260	+	3	P30511-1	0	345	ENST00000259951.12	30	1065	++	6	P30511-1#50	0	9	ENST00000259951.12	801	810	+	9	0	-6	9039
P30511-1#51	0	10	10	P30511-1	261	271	+	10	P30511-1	211	345	ENST00000465459.2	0	402	++	109	P30511-1#51	0	30	ENST00000465459.2	150	180	+	30	0	-20	9040
P30511-1#51	0	10	10	P30511-1	261	271	+	10	P30511-1	0	346	ENST00000376861.5	384	1422	++	52	P30511-1#51	0	30	ENST00000376861.5	1167	1197	+	30	0	-20	9041
P30511-1#51	0	10	10	P30511-1	261	271	+	10	P30511-1	0	346	ENST00000334668.8	124	1162	++	30	P30511-1#51	0	30	ENST00000334668.8	907	937	+	30	0	-20	9042
P30511-1#51	0	10	10	P30511-1	261	271	+	10	P30511-1	0	345	ENST00000259951.12	30	1065	++	6	P30511-1#51	0	30	ENST00000259951.12	813	843	+	30	0	-20	9043
P30511-1#52	0	3	3	P30511-1	274	277	+	3	P30511-1	211	345	ENST00000465459.2	0	402	++	109	P30511-1#52	0	9	ENST00000465459.2	189	198	+	9	0	-6	9044
P30511-1#52	0	3	3	P30511-1	274	277	+	3	P30511-1	0	346	ENST00000376861.5	384	1422	++	52	P30511-1#52	0	9	ENST00000376861.5	1206	1215	+	9	0	-6	9045
P30511-1#52	0	3	3	P30511-1	274	277	+	3	P30511-1	0	346	ENST00000334668.8	124	1162	++	30	P30511-1#52	0	9	ENST00000334668.8	946	955	+	9	0	-6	9046
P30511-1#52	0	3	3	P30511-1	274	277	+	3	P30511-1	0	345	ENST00000259951.12	30	1065	++	6	P30511-1#52	0	9	ENST00000259951.12	852	861	+	9	0	-6	9047
P30511-1#53	0	6	6	P30511-1	277	283	+	6	P30511-1	211	345	ENST00000465459.2	0	402	++	109	P30511-1#53	0	18	ENST00000465459.2	198	216	+	18	0	-12	9048
P30511-1#53	0	6	6	P30511-1	277	283	+	6	P30511-1	0	346	ENST00000376861.5	384	1422	++	52	P30511-1#53	0	18	ENST00000376861.5	1215	1233	+	18	0	-12	9049
P30511-1#53	0	6	6	P30511-1	277	283	+	6	P30511-1	0	346	ENST00000334668.8	124	1162	++	30	P30511-1#53	0	18	ENST00000334668.8	955	973	+	18	0	-12	9050
P30511-1#53	0	6	6	P30511-1	277	283	+	6	P30511-1	0	345	ENST00000259951.12	30	1065	++	6	P30511-1#53	0	18	ENST00000259951.12	861	879	+	18	0	-12	9051
P30511-1#54	0	3	3	P30511-1	286	289	+	3	P30511-1	211	345	ENST00000465459.2	0	402	++	109	P30511-1#54	0	9	ENST00000465459.2	225	234	+	9	0	-6	9052
P30511-1#54	0	3	3	P30511-1	286	289	+	3	P30511-1	0	346	ENST00000376861.5	384	1422	++	52	P30511-1#54	0	9	ENST00000376861.5	1242	1251	+	9	0	-6	9053
P30511-1#54	0	3	3	P30511-1	286	289	+	3	P30511-1	0	346	ENST00000334668.8	124	1162	++	30	P30511-1#54	0	9	ENST00000334668.8	982	991	+	9	0	-6	9054
P30511-1#54	0	3	3	P30511-1	286	289	+	3	P30511-1	0	345	ENST00000259951.12	30	1065	++	6	P30511-1#54	0	9	ENST00000259951.12	888	897	+	9	0	-6	9055
P30511-1#55	0	3	3	P30511-1	290	293	+	3	P30511-1	211	345	ENST00000465459.2	0	402	++	109	P30511-1#55	0	9	ENST00000465459.2	237	246	+	9	0	-6	9056
P30511-1#55	0	3	3	P30511-1	290	293	+	3	P30511-1	0	346	ENST00000376861.5	384	1422	++	52	P30511-1#55	0	9	ENST00000376861.5	1254	1263	+	9	0	-6	9057
P30511-1#55	0	3	3	P30511-1	290	293	+	3	P30511-1	0	346	ENST00000334668.8	124	1162	++	30	P30511-1#55	0	9	ENST00000334668.8	994	1003	+	9	0	-6	9058
P30511-1#55	0	3	3	P30511-1	290	293	+	3	P30511-1	0	345	ENST00000259951.12	30	1065	++	6	P30511-1#55	0	9	ENST00000259951.12	900	909	+	9	0	-6	9059
P0DMS8-1#0	0	318	318	P0DMS8-1	0	318	+	318	P0DMS8-1	0	116	ENST00000632535.1	58	406	++	226	P0DMS8-1#0	0	348	ENST00000632535.1	58	406	+	348	0	-30	9060
P0DMS8-1#0	0	318	318	P0DMS8-1	0	318	+	318	P0DMS8-1	0	318	ENST00000241356.5	279	1233	++	2	P0DMS8-1#0	0	954	ENST00000241356.5	279	1233	+	954	0	-636	9061
P0DMS8-1#1	0	14	14	P0DMS8-1	0	14	+	14	P0DMS8-1	0	116	ENST00000632535.1	58	406	++	226	P0DMS8-1#1	0	42	ENST00000632535.1	58	100	+	42	0	-28	9062
P0DMS8-1#1	0	14	14	P0DMS8-1	0	14	+	14	P0DMS8-1	0	318	ENST00000241356.5	279	1233	++	2	P0DMS8-1#1	0	42	ENST00000241356.5	279	321	+	42	0	-28	9063
P0DMS8-1#2	0	23	23	P0DMS8-1	14	37	+	23	P0DMS8-1	0	116	ENST00000632535.1	58	406	++	226	P0DMS8-1#2	0	69	ENST00000632535.1	100	169	+	69	0	-46	9064
P0DMS8-1#2	0	23	23	P0DMS8-1	14	37	+	23	P0DMS8-1	0	318	ENST00000241356.5	279	1233	++	2	P0DMS8-1#2	0	69	ENST00000241356.5	321	390	+	69	0	-46	9065
P0DMS8-1#3	0	11	11	P0DMS8-1	37	48	+	11	P0DMS8-1	0	116	ENST00000632535.1	58	406	++	226	P0DMS8-1#3	0	33	ENST00000632535.1	169	202	+	33	0	-22	9066
P0DMS8-1#3	0	11	11	P0DMS8-1	37	48	+	11	P0DMS8-1	0	318	ENST00000241356.5	279	1233	++	2	P0DMS8-1#3	0	33	ENST00000241356.5	390	423	+	33	0	-22	9067
P0DMS8-1#4	0	24	24	P0DMS8-1	48	72	+	24	P0DMS8-1	0	116	ENST00000632535.1	58	406	++	226	P0DMS8-1#4	0	72	ENST00000632535.1	202	274	+	72	0	-48	9068
P0DMS8-1#4	0	24	24	P0DMS8-1	48	72	+	24	P0DMS8-1	0	318	ENST00000241356.5	279	1233	++	2	P0DMS8-1#4	0	72	ENST00000241356.5	423	495	+	72	0	-48	9069
P0DMS8-1#5	0	12	12	P0DMS8-1	72	84	+	12	P0DMS8-1	0	116	ENST00000632535.1	58	406	++	226	P0DMS8-1#5	0	36	ENST00000632535.1	274	310	+	36	0	-24	9070
P0DMS8-1#5	0	12	12	P0DMS8-1	72	84	+	12	P0DMS8-1	0	318	ENST00000241356.5	279	1233	++	2	P0DMS8-1#5	0	36	ENST00000241356.5	495	531	+	36	0	-24	9071
P0DMS8-1#6	0	22	22	P0DMS8-1	84	106	+	22	P0DMS8-1	0	116	ENST00000632535.1	58	406	++	226	P0DMS8-1#6	0	66	ENST00000632535.1	310	376	+	66	0	-44	9072
P0DMS8-1#6	0	22	22	P0DMS8-1	84	106	+	22	P0DMS8-1	0	318	ENST00000241356.5	279	1233	++	2	P0DMS8-1#6	0	66	ENST00000241356.5	531	597	+	66	0	-44	9073
P0DMS8-1#7	0	20	20	P0DMS8-1	106	126	+	20	P0DMS8-1	0	116	ENST00000632535.1	58	406	++	226	P0DMS8-1#7	0	30	ENST00000632535.1	376	406	+	30	0	-10	9074
P0DMS8-1#7	0	20	20	P0DMS8-1	106	126	+	20	P0DMS8-1	0	318	ENST00000241356.5	279	1233	++	2	P0DMS8-1#7	0	60	ENST00000241356.5	597	657	+	60	0	-40	9075
P0DMS8-1#8	0	22	22	P0DMS8-1	126	148	+	22	P0DMS8-1	0	318	ENST00000241356.5	279	1233	++	2	P0DMS8-1#8	0	66	ENST00000241356.5	657	723	+	66	0	-44	9076
P0DMS8-1#9	0	29	29	P0DMS8-1	148	177	+	29	P0DMS8-1	0	318	ENST00000241356.5	279	1233	++	2	P0DMS8-1#9	0	87	ENST00000241356.5	723	810	+	87	0	-58	9077
P0DMS8-1#10	0	21	21	P0DMS8-1	177	198	+	21	P0DMS8-1	0	318	ENST00000241356.5	279	1233	++	2	P0DMS8-1#10	0	63	ENST00000241356.5	810	873	+	63	0	-42	9078
P0DMS8-1#11	0	33	33	P0DMS8-1	198	231	+	33	P0DMS8-1	0	318	ENST00000241356.5	279	1233	++	2	P0DMS8-1#11	0	99	ENST00000241356.5	873	972	+	99	0	-66	9079
P0DMS8-1#12	0	24	24	P0DMS8-1	231	255	+	24	P0DMS8-1	0	318	ENST00000241356.5	279	1233	++	2	P0DMS8-1#12	0	72	ENST00000241356.5	972	1044	+	72	0	-48	9080
P0DMS8-1#13	0	6	6	P0DMS8-1	255	261	+	6	P0DMS8-1	0	318	ENST00000241356.5	279	1233	++	2	P0DMS8-1#13	0	18	ENST00000241356.5	1044	1062	+	18	0	-12	9081
P0DMS8-1#14	0	23	23	P0DMS8-1	261	284	+	23	P0DMS8-1	0	318	ENST00000241356.5	279	1233	++	2	P0DMS8-1#14	0	69	ENST00000241356.5	1062	1131	+	69	0	-46	9082
P0DMS8-1#15	0	34	34	P0DMS8-1	284	318	+	34	P0DMS8-1	0	318	ENST00000241356.5	279	1233	++	2	P0DMS8-1#15	0	102	ENST00000241356.5	1131	1233	+	102	0	-68	9083
P0DMS8-1#16	0	1	1	P0DMS8-1	302	303	+	1	P0DMS8-1	0	318	ENST00000241356.5	279	1233	++	2	P0DMS8-1#16	0	3	ENST00000241356.5	1185	1188	+	3	0	-2	9084
P0DMS8-1#17	0	1	1	P0DMS8-1	2	3	+	1	P0DMS8-1	0	116	ENST00000632535.1	58	406	++	226	P0DMS8-1#17	0	3	ENST00000632535.1	64	67	+	3	0	-2	9085
P0DMS8-1#17	0	1	1	P0DMS8-1	2	3	+	1	P0DMS8-1	0	318	ENST00000241356.5	279	1233	++	2	P0DMS8-1#17	0	3	ENST00000241356.5	285	288	+	3	0	-2	9086
P0DMS8-1#18	0	1	1	P0DMS8-1	3	4	+	1	P0DMS8-1	0	116	ENST00000632535.1	58	406	++	226	P0DMS8-1#18	0	3	ENST00000632535.1	67	70	+	3	0	-2	9087
P0DMS8-1#18	0	1	1	P0DMS8-1	3	4	+	1	P0DMS8-1	0	318	ENST00000241356.5	279	1233	++	2	P0DMS8-1#18	0	3	ENST00000241356.5	288	291	+	3	0	-2	9088
P0DMS8-1#19	0	1	1	P0DMS8-1	11	12	+	1	P0DMS8-1	0	116	ENST00000632535.1	58	406	++	226	P0DMS8-1#19	0	3	ENST00000632535.1	91	94	+	3	0	-2	9089
P0DMS8-1#19	0	1	1	P0DMS8-1	11	12	+	1	P0DMS8-1	0	318	ENST00000241356.5	279	1233	++	2	P0DMS8-1#19	0	3	ENST00000241356.5	312	315	+	3	0	-2	9090
P0DMS8-1#20	0	84	84	P0DMS8-1	82	166	+	84	P0DMS8-1	0	116	ENST00000632535.1	58	406	++	226	P0DMS8-1#20	0	102	ENST00000632535.1	304	406	+	102	0	-18	9091
P0DMS8-1#20	0	84	84	P0DMS8-1	82	166	+	84	P0DMS8-1	0	318	ENST00000241356.5	279	1233	++	2	P0DMS8-1#20	0	252	ENST00000241356.5	525	777	+	252	0	-168	9092
P0DMS8-1#21	0	1	1	P0DMS8-1	104	105	+	1	P0DMS8-1	0	116	ENST00000632535.1	58	406	++	226	P0DMS8-1#21	0	3	ENST00000632535.1	370	373	+	3	0	-2	9093
P0DMS8-1#21	0	1	1	P0DMS8-1	104	105	+	1	P0DMS8-1	0	318	ENST00000241356.5	279	1233	++	2	P0DMS8-1#21	0	3	ENST00000241356.5	591	594	+	3	0	-2	9094
P0DMS8-1#22	0	1	1	P0DMS8-1	247	248	+	1	P0DMS8-1	0	318	ENST00000241356.5	279	1233	++	2	P0DMS8-1#22	0	3	ENST00000241356.5	1020	1023	+	3	0	-2	9095
P0DMS8-1#23	0	1	1	P0DMS8-1	265	266	+	1	P0DMS8-1	0	318	ENST00000241356.5	279	1233	++	2	P0DMS8-1#23	0	3	ENST00000241356.5	1074	1077	+	3	0	-2	9096
P0DMS8-1#24	0	1	1	P0DMS8-1	6	7	+	1	P0DMS8-1	0	116	ENST00000632535.1	58	406	++	226	P0DMS8-1#24	0	3	ENST00000632535.1	76	79	+	3	0	-2	9097
P0DMS8-1#24	0	1	1	P0DMS8-1	6	7	+	1	P0DMS8-1	0	318	ENST00000241356.5	279	1233	++	2	P0DMS8-1#24	0	3	ENST00000241356.5	297	300	+	3	0	-2	9098
P0DMS8-1#25	0	1	1	P0DMS8-1	174	175	+	1	P0DMS8-1	0	318	ENST00000241356.5	279	1233	++	2	P0DMS8-1#25	0	3	ENST00000241356.5	801	804	+	3	0	-2	9099
P42684-1#0	0	1	1	P42684-1	0	1	+	1	P42684-1	0	687	ENST00000511413.5	0	2061	++	130	P42684-1#0	0	3	ENST00000511413.5	0	3	+	3	0	-2	9100
P42684-1#0	0	1	1	P42684-1	0	1	+	1	P42684-1	0	687	ENST00000507173.5	0	1998	++	129	P42684-1#0	0	3	ENST00000507173.5	0	3	+	3	0	-2	9101
P42684-1#0	0	1	1	P42684-1	0	1	+	1	P42684-1	0	1182	ENST00000502732.6	280	3826	++	127	P42684-1#0	0	3	ENST00000502732.6	280	283	+	3	0	-2	9102
P42684-1#0	0	1	1	P42684-1	0	1	+	1	P42684-1	0	1182	ENST00000367623.8	0	3483	++	42	P42684-1#0	0	3	ENST00000367623.8	0	3	+	3	0	-2	9103
P42684-1#1	0	1181	1181	P42684-1	1	1182	+	1181	P42684-1	52	1182	ENST00000512653.5	123	3513	++	131	P42684-1#1	153	3543	ENST00000512653.5	123	3513	+	3390	153	-2362	9104
P42684-1#1	0	1181	1181	P42684-1	1	1182	+	1181	P42684-1	0	687	ENST00000511413.5	0	2061	++	130	P42684-1#1	0	2058	ENST00000511413.5	3	2061	+	2058	0	-877	9105
P42684-1#1	0	1181	1181	P42684-1	1	1182	+	1181	P42684-1	0	687	ENST00000507173.5	0	1998	++	129	P42684-1#1	0	2058	ENST00000507173.5	3	1998	+	1995	0	-877	9106
P42684-1#1	0	1181	1181	P42684-1	1	1182	+	1181	P42684-1	73	687	ENST00000504405.5	111	1953	++	128	P42684-1#1	216	2058	ENST00000504405.5	111	1953	+	1842	216	-877	9107
P42684-1#1	0	1181	1181	P42684-1	1	1182	+	1181	P42684-1	0	1182	ENST00000502732.6	280	3826	++	127	P42684-1#1	0	3543	ENST00000502732.6	283	3826	+	3543	0	-2362	9108
P42684-1#1	0	1181	1181	P42684-1	1	1182	+	1181	P42684-1	0	1182	ENST00000367623.8	0	3483	++	42	P42684-1#1	0	3543	ENST00000367623.8	3	3483	+	3480	0	-2362	9109
P42684-1#1	0	1181	1181	P42684-1	1	1182	+	1181	P42684-1	52	687	ENST00000344730.8	143	2048	++	34	P42684-1#1	153	2058	ENST00000344730.8	143	2048	+	1905	153	-877	9110
P42684-1#2	0	61	61	P42684-1	106	167	+	61	P42684-1	52	1182	ENST00000512653.5	123	3513	++	131	P42684-1#2	0	183	ENST00000512653.5	285	468	+	183	0	-122	9111
P42684-1#2	0	61	61	P42684-1	106	167	+	61	P42684-1	0	687	ENST00000511413.5	0	2061	++	130	P42684-1#2	0	183	ENST00000511413.5	318	501	+	183	0	-122	9112
P42684-1#2	0	61	61	P42684-1	106	167	+	61	P42684-1	0	687	ENST00000507173.5	0	1998	++	129	P42684-1#2	0	183	ENST00000507173.5	255	438	+	183	0	-122	9113
P42684-1#2	0	61	61	P42684-1	106	167	+	61	P42684-1	73	687	ENST00000504405.5	111	1953	++	128	P42684-1#2	0	183	ENST00000504405.5	210	393	+	183	0	-122	9114
P42684-1#2	0	61	61	P42684-1	106	167	+	61	P42684-1	0	1182	ENST00000502732.6	280	3826	++	127	P42684-1#2	0	183	ENST00000502732.6	598	781	+	183	0	-122	9115
P42684-1#2	0	61	61	P42684-1	106	167	+	61	P42684-1	0	1182	ENST00000367623.8	0	3483	++	42	P42684-1#2	0	183	ENST00000367623.8	255	438	+	183	0	-122	9116
P42684-1#2	0	61	61	P42684-1	106	167	+	61	P42684-1	52	687	ENST00000344730.8	143	2048	++	34	P42684-1#2	0	183	ENST00000344730.8	305	488	+	183	0	-122	9117
P42684-1#3	0	91	91	P42684-1	172	263	+	91	P42684-1	52	1182	ENST00000512653.5	123	3513	++	131	P42684-1#3	0	273	ENST00000512653.5	483	756	+	273	0	-182	9118
P42684-1#3	0	91	91	P42684-1	172	263	+	91	P42684-1	0	687	ENST00000511413.5	0	2061	++	130	P42684-1#3	0	273	ENST00000511413.5	516	789	+	273	0	-182	9119
P42684-1#3	0	91	91	P42684-1	172	263	+	91	P42684-1	0	687	ENST00000507173.5	0	1998	++	129	P42684-1#3	0	273	ENST00000507173.5	453	726	+	273	0	-182	9120
P42684-1#3	0	91	91	P42684-1	172	263	+	91	P42684-1	73	687	ENST00000504405.5	111	1953	++	128	P42684-1#3	0	273	ENST00000504405.5	408	681	+	273	0	-182	9121
P42684-1#3	0	91	91	P42684-1	172	263	+	91	P42684-1	0	1182	ENST00000502732.6	280	3826	++	127	P42684-1#3	0	273	ENST00000502732.6	796	1069	+	273	0	-182	9122
P42684-1#3	0	91	91	P42684-1	172	263	+	91	P42684-1	0	1182	ENST00000367623.8	0	3483	++	42	P42684-1#3	0	273	ENST00000367623.8	453	726	+	273	0	-182	9123
P42684-1#3	0	91	91	P42684-1	172	263	+	91	P42684-1	52	687	ENST00000344730.8	143	2048	++	34	P42684-1#3	0	273	ENST00000344730.8	503	776	+	273	0	-182	9124
P42684-1#4	0	252	252	P42684-1	287	539	+	252	P42684-1	52	1182	ENST00000512653.5	123	3513	++	131	P42684-1#4	0	756	ENST00000512653.5	828	1584	+	756	0	-504	9125
P42684-1#4	0	252	252	P42684-1	287	539	+	252	P42684-1	0	687	ENST00000511413.5	0	2061	++	130	P42684-1#4	0	756	ENST00000511413.5	861	1617	+	756	0	-504	9126
P42684-1#4	0	252	252	P42684-1	287	539	+	252	P42684-1	0	687	ENST00000507173.5	0	1998	++	129	P42684-1#4	0	756	ENST00000507173.5	798	1554	+	756	0	-504	9127
P42684-1#4	0	252	252	P42684-1	287	539	+	252	P42684-1	73	687	ENST00000504405.5	111	1953	++	128	P42684-1#4	0	756	ENST00000504405.5	753	1509	+	756	0	-504	9128
P42684-1#4	0	252	252	P42684-1	287	539	+	252	P42684-1	0	1182	ENST00000502732.6	280	3826	++	127	P42684-1#4	0	756	ENST00000502732.6	1141	1897	+	756	0	-504	9129
P42684-1#4	0	252	252	P42684-1	287	539	+	252	P42684-1	0	1182	ENST00000367623.8	0	3483	++	42	P42684-1#4	0	756	ENST00000367623.8	798	1554	+	756	0	-504	9130
P42684-1#4	0	252	252	P42684-1	287	539	+	252	P42684-1	52	687	ENST00000344730.8	143	2048	++	34	P42684-1#4	0	756	ENST00000344730.8	848	1604	+	756	0	-504	9131
P42684-1#5	0	47	47	P42684-1	0	47	+	47	P42684-1	0	687	ENST00000511413.5	0	2061	++	130	P42684-1#5	0	141	ENST00000511413.5	0	141	+	141	0	-94	9132
P42684-1#5	0	47	47	P42684-1	0	47	+	47	P42684-1	0	687	ENST00000507173.5	0	1998	++	129	P42684-1#5	0	141	ENST00000507173.5	0	141	+	141	0	-94	9133
P42684-1#5	0	47	47	P42684-1	0	47	+	47	P42684-1	0	1182	ENST00000502732.6	280	3826	++	127	P42684-1#5	0	141	ENST00000502732.6	280	421	+	141	0	-94	9134
P42684-1#5	0	47	47	P42684-1	0	47	+	47	P42684-1	0	1182	ENST00000367623.8	0	3483	++	42	P42684-1#5	0	141	ENST00000367623.8	0	141	+	141	0	-94	9135
P42684-1#6	0	105	105	P42684-1	1	106	+	105	P42684-1	52	1182	ENST00000512653.5	123	3513	++	131	P42684-1#6	153	315	ENST00000512653.5	123	285	+	162	153	-210	9136
P42684-1#6	0	105	105	P42684-1	1	106	+	105	P42684-1	0	687	ENST00000511413.5	0	2061	++	130	P42684-1#6	0	315	ENST00000511413.5	3	318	+	315	0	-210	9137
P42684-1#6	0	105	105	P42684-1	1	106	+	105	P42684-1	0	687	ENST00000507173.5	0	1998	++	129	P42684-1#6	0	315	ENST00000507173.5	3	255	+	252	0	-210	9138
P42684-1#6	0	105	105	P42684-1	1	106	+	105	P42684-1	73	687	ENST00000504405.5	111	1953	++	128	P42684-1#6	216	315	ENST00000504405.5	111	210	+	99	216	-210	9139
P42684-1#6	0	105	105	P42684-1	1	106	+	105	P42684-1	0	1182	ENST00000502732.6	280	3826	++	127	P42684-1#6	0	315	ENST00000502732.6	283	598	+	315	0	-210	9140
P42684-1#6	0	105	105	P42684-1	1	106	+	105	P42684-1	0	1182	ENST00000367623.8	0	3483	++	42	P42684-1#6	0	315	ENST00000367623.8	3	255	+	252	0	-210	9141
P42684-1#6	0	105	105	P42684-1	1	106	+	105	P42684-1	52	687	ENST00000344730.8	143	2048	++	34	P42684-1#6	153	315	ENST00000344730.8	143	305	+	162	153	-210	9142
P42684-1#7	0	21	21	P42684-1	59	80	+	21	P42684-1	52	1182	ENST00000512653.5	123	3513	++	131	P42684-1#7	0	63	ENST00000512653.5	144	207	+	63	0	-42	9143
P42684-1#7	0	21	21	P42684-1	59	80	+	21	P42684-1	0	687	ENST00000511413.5	0	2061	++	130	P42684-1#7	0	63	ENST00000511413.5	177	240	+	63	0	-42	9144
P42684-1#7	0	21	21	P42684-1	59	80	+	21	P42684-1	0	687	ENST00000507173.5	0	1998	++	129	P42684-1#7	42	63	ENST00000507173.5	156	177	+	21	42	-42	9145
P42684-1#7	0	21	21	P42684-1	59	80	+	21	P42684-1	73	687	ENST00000504405.5	111	1953	++	128	P42684-1#7	42	63	ENST00000504405.5	111	132	+	21	42	-42	9146
P42684-1#7	0	21	21	P42684-1	59	80	+	21	P42684-1	0	1182	ENST00000502732.6	280	3826	++	127	P42684-1#7	0	63	ENST00000502732.6	457	520	+	63	0	-42	9147
P42684-1#7	0	21	21	P42684-1	59	80	+	21	P42684-1	0	1182	ENST00000367623.8	0	3483	++	42	P42684-1#7	42	63	ENST00000367623.8	156	177	+	21	42	-42	9148
P42684-1#7	0	21	21	P42684-1	59	80	+	21	P42684-1	52	687	ENST00000344730.8	143	2048	++	34	P42684-1#7	0	63	ENST00000344730.8	164	227	+	63	0	-42	9149
P42684-1#8	0	31	31	P42684-1	610	641	+	31	P42684-1	52	1182	ENST00000512653.5	123	3513	++	131	P42684-1#8	0	93	ENST00000512653.5	1797	1890	+	93	0	-62	9150
P42684-1#8	0	31	31	P42684-1	610	641	+	31	P42684-1	0	687	ENST00000511413.5	0	2061	++	130	P42684-1#8	0	93	ENST00000511413.5	1830	1923	+	93	0	-62	9151
P42684-1#8	0	31	31	P42684-1	610	641	+	31	P42684-1	0	687	ENST00000507173.5	0	1998	++	129	P42684-1#8	0	93	ENST00000507173.5	1767	1860	+	93	0	-62	9152
P42684-1#8	0	31	31	P42684-1	610	641	+	31	P42684-1	73	687	ENST00000504405.5	111	1953	++	128	P42684-1#8	0	93	ENST00000504405.5	1722	1815	+	93	0	-62	9153
P42684-1#8	0	31	31	P42684-1	610	641	+	31	P42684-1	0	1182	ENST00000502732.6	280	3826	++	127	P42684-1#8	0	93	ENST00000502732.6	2110	2203	+	93	0	-62	9154
P42684-1#8	0	31	31	P42684-1	610	641	+	31	P42684-1	0	1182	ENST00000367623.8	0	3483	++	42	P42684-1#8	0	93	ENST00000367623.8	1767	1860	+	93	0	-62	9155
P42684-1#8	0	31	31	P42684-1	610	641	+	31	P42684-1	52	687	ENST00000344730.8	143	2048	++	34	P42684-1#8	0	93	ENST00000344730.8	1817	1910	+	93	0	-62	9156
P42684-1#9	0	21	21	P42684-1	653	674	+	21	P42684-1	52	1182	ENST00000512653.5	123	3513	++	131	P42684-1#9	0	63	ENST00000512653.5	1926	1989	+	63	0	-42	9157
P42684-1#9	0	21	21	P42684-1	653	674	+	21	P42684-1	0	687	ENST00000511413.5	0	2061	++	130	P42684-1#9	0	63	ENST00000511413.5	1959	2022	+	63	0	-42	9158
P42684-1#9	0	21	21	P42684-1	653	674	+	21	P42684-1	0	687	ENST00000507173.5	0	1998	++	129	P42684-1#9	0	63	ENST00000507173.5	1896	1959	+	63	0	-42	9159
P42684-1#9	0	21	21	P42684-1	653	674	+	21	P42684-1	73	687	ENST00000504405.5	111	1953	++	128	P42684-1#9	0	63	ENST00000504405.5	1851	1914	+	63	0	-42	9160
P42684-1#9	0	21	21	P42684-1	653	674	+	21	P42684-1	0	1182	ENST00000502732.6	280	3826	++	127	P42684-1#9	0	63	ENST00000502732.6	2239	2302	+	63	0	-42	9161
P42684-1#9	0	21	21	P42684-1	653	674	+	21	P42684-1	0	1182	ENST00000367623.8	0	3483	++	42	P42684-1#9	0	63	ENST00000367623.8	1896	1959	+	63	0	-42	9162
P42684-1#9	0	21	21	P42684-1	653	674	+	21	P42684-1	52	687	ENST00000344730.8	143	2048	++	34	P42684-1#9	0	63	ENST00000344730.8	1946	2009	+	63	0	-42	9163
P42684-1#10	0	237	237	P42684-1	693	930	+	237	P42684-1	52	1182	ENST00000512653.5	123	3513	++	131	P42684-1#10	0	711	ENST00000512653.5	2046	2757	+	711	0	-474	9164
P42684-1#10	0	237	237	P42684-1	693	930	+	237	P42684-1	0	1182	ENST00000502732.6	280	3826	++	127	P42684-1#10	0	711	ENST00000502732.6	2359	3070	+	711	0	-474	9165
P42684-1#10	0	237	237	P42684-1	693	930	+	237	P42684-1	0	1182	ENST00000367623.8	0	3483	++	42	P42684-1#10	0	711	ENST00000367623.8	2016	2727	+	711	0	-474	9166
P42684-1#11	0	32	32	P42684-1	762	794	+	32	P42684-1	52	1182	ENST00000512653.5	123	3513	++	131	P42684-1#11	0	96	ENST00000512653.5	2253	2349	+	96	0	-64	9167
P42684-1#11	0	32	32	P42684-1	762	794	+	32	P42684-1	0	1182	ENST00000502732.6	280	3826	++	127	P42684-1#11	0	96	ENST00000502732.6	2566	2662	+	96	0	-64	9168
P42684-1#11	0	32	32	P42684-1	762	794	+	32	P42684-1	0	1182	ENST00000367623.8	0	3483	++	42	P42684-1#11	0	96	ENST00000367623.8	2223	2319	+	96	0	-64	9169
P42684-1#12	0	45	45	P42684-1	806	851	+	45	P42684-1	52	1182	ENST00000512653.5	123	3513	++	131	P42684-1#12	0	135	ENST00000512653.5	2385	2520	+	135	0	-90	9170
P42684-1#12	0	45	45	P42684-1	806	851	+	45	P42684-1	0	1182	ENST00000502732.6	280	3826	++	127	P42684-1#12	0	135	ENST00000502732.6	2698	2833	+	135	0	-90	9171
P42684-1#12	0	45	45	P42684-1	806	851	+	45	P42684-1	0	1182	ENST00000367623.8	0	3483	++	42	P42684-1#12	0	135	ENST00000367623.8	2355	2490	+	135	0	-90	9172
P42684-1#13	0	61	61	P42684-1	963	1024	+	61	P42684-1	52	1182	ENST00000512653.5	123	3513	++	131	P42684-1#13	0	183	ENST00000512653.5	2856	3039	+	183	0	-122	9173
P42684-1#13	0	61	61	P42684-1	963	1024	+	61	P42684-1	0	1182	ENST00000502732.6	280	3826	++	127	P42684-1#13	0	183	ENST00000502732.6	3169	3352	+	183	0	-122	9174
P42684-1#13	0	61	61	P42684-1	963	1024	+	61	P42684-1	0	1182	ENST00000367623.8	0	3483	++	42	P42684-1#13	0	183	ENST00000367623.8	2826	3009	+	183	0	-122	9175
P42684-1#14	0	163	163	P42684-1	1019	1182	+	163	P42684-1	52	1182	ENST00000512653.5	123	3513	++	131	P42684-1#14	0	489	ENST00000512653.5	3024	3513	+	489	0	-326	9176
P42684-1#14	0	163	163	P42684-1	1019	1182	+	163	P42684-1	0	1182	ENST00000502732.6	280	3826	++	127	P42684-1#14	0	489	ENST00000502732.6	3337	3826	+	489	0	-326	9177
P42684-1#14	0	163	163	P42684-1	1019	1182	+	163	P42684-1	0	1182	ENST00000367623.8	0	3483	++	42	P42684-1#14	0	489	ENST00000367623.8	2994	3483	+	489	0	-326	9178
P42684-1#15	0	25	25	P42684-1	426	451	+	25	P42684-1	52	1182	ENST00000512653.5	123	3513	++	131	P42684-1#15	0	75	ENST00000512653.5	1245	1320	+	75	0	-50	9179
P42684-1#15	0	25	25	P42684-1	426	451	+	25	P42684-1	0	687	ENST00000511413.5	0	2061	++	130	P42684-1#15	0	75	ENST00000511413.5	1278	1353	+	75	0	-50	9180
P42684-1#15	0	25	25	P42684-1	426	451	+	25	P42684-1	0	687	ENST00000507173.5	0	1998	++	129	P42684-1#15	0	75	ENST00000507173.5	1215	1290	+	75	0	-50	9181
P42684-1#15	0	25	25	P42684-1	426	451	+	25	P42684-1	73	687	ENST00000504405.5	111	1953	++	128	P42684-1#15	0	75	ENST00000504405.5	1170	1245	+	75	0	-50	9182
P42684-1#15	0	25	25	P42684-1	426	451	+	25	P42684-1	0	1182	ENST00000502732.6	280	3826	++	127	P42684-1#15	0	75	ENST00000502732.6	1558	1633	+	75	0	-50	9183
P42684-1#15	0	25	25	P42684-1	426	451	+	25	P42684-1	0	1182	ENST00000367623.8	0	3483	++	42	P42684-1#15	0	75	ENST00000367623.8	1215	1290	+	75	0	-50	9184
P42684-1#15	0	25	25	P42684-1	426	451	+	25	P42684-1	52	687	ENST00000344730.8	143	2048	++	34	P42684-1#15	0	75	ENST00000344730.8	1265	1340	+	75	0	-50	9185
P42684-1#16	0	3	3	P42684-1	657	660	+	3	P42684-1	52	1182	ENST00000512653.5	123	3513	++	131	P42684-1#16	0	9	ENST00000512653.5	1938	1947	+	9	0	-6	9186
P42684-1#16	0	3	3	P42684-1	657	660	+	3	P42684-1	0	687	ENST00000511413.5	0	2061	++	130	P42684-1#16	0	9	ENST00000511413.5	1971	1980	+	9	0	-6	9187
P42684-1#16	0	3	3	P42684-1	657	660	+	3	P42684-1	0	687	ENST00000507173.5	0	1998	++	129	P42684-1#16	0	9	ENST00000507173.5	1908	1917	+	9	0	-6	9188
P42684-1#16	0	3	3	P42684-1	657	660	+	3	P42684-1	73	687	ENST00000504405.5	111	1953	++	128	P42684-1#16	0	9	ENST00000504405.5	1863	1872	+	9	0	-6	9189
P42684-1#16	0	3	3	P42684-1	657	660	+	3	P42684-1	0	1182	ENST00000502732.6	280	3826	++	127	P42684-1#16	0	9	ENST00000502732.6	2251	2260	+	9	0	-6	9190
P42684-1#16	0	3	3	P42684-1	657	660	+	3	P42684-1	0	1182	ENST00000367623.8	0	3483	++	42	P42684-1#16	0	9	ENST00000367623.8	1908	1917	+	9	0	-6	9191
P42684-1#16	0	3	3	P42684-1	657	660	+	3	P42684-1	52	687	ENST00000344730.8	143	2048	++	34	P42684-1#16	0	9	ENST00000344730.8	1958	1967	+	9	0	-6	9192
P42684-1#17	0	20	20	P42684-1	773	793	+	20	P42684-1	52	1182	ENST00000512653.5	123	3513	++	131	P42684-1#17	0	60	ENST00000512653.5	2286	2346	+	60	0	-40	9193
P42684-1#17	0	20	20	P42684-1	773	793	+	20	P42684-1	0	1182	ENST00000502732.6	280	3826	++	127	P42684-1#17	0	60	ENST00000502732.6	2599	2659	+	60	0	-40	9194
P42684-1#17	0	20	20	P42684-1	773	793	+	20	P42684-1	0	1182	ENST00000367623.8	0	3483	++	42	P42684-1#17	0	60	ENST00000367623.8	2256	2316	+	60	0	-40	9195
P42684-1#18	0	20	20	P42684-1	806	826	+	20	P42684-1	52	1182	ENST00000512653.5	123	3513	++	131	P42684-1#18	0	60	ENST00000512653.5	2385	2445	+	60	0	-40	9196
P42684-1#18	0	20	20	P42684-1	806	826	+	20	P42684-1	0	1182	ENST00000502732.6	280	3826	++	127	P42684-1#18	0	60	ENST00000502732.6	2698	2758	+	60	0	-40	9197
P42684-1#18	0	20	20	P42684-1	806	826	+	20	P42684-1	0	1182	ENST00000367623.8	0	3483	++	42	P42684-1#18	0	60	ENST00000367623.8	2355	2415	+	60	0	-40	9198
P42684-1#19	0	24	24	P42684-1	827	851	+	24	P42684-1	52	1182	ENST00000512653.5	123	3513	++	131	P42684-1#19	0	72	ENST00000512653.5	2448	2520	+	72	0	-48	9199
P42684-1#19	0	24	24	P42684-1	827	851	+	24	P42684-1	0	1182	ENST00000502732.6	280	3826	++	127	P42684-1#19	0	72	ENST00000502732.6	2761	2833	+	72	0	-48	9200
P42684-1#19	0	24	24	P42684-1	827	851	+	24	P42684-1	0	1182	ENST00000367623.8	0	3483	++	42	P42684-1#19	0	72	ENST00000367623.8	2418	2490	+	72	0	-48	9201
P42684-1#20	0	15	15	P42684-1	965	980	+	15	P42684-1	52	1182	ENST00000512653.5	123	3513	++	131	P42684-1#20	0	45	ENST00000512653.5	2862	2907	+	45	0	-30	9202
P42684-1#20	0	15	15	P42684-1	965	980	+	15	P42684-1	0	1182	ENST00000502732.6	280	3826	++	127	P42684-1#20	0	45	ENST00000502732.6	3175	3220	+	45	0	-30	9203
P42684-1#20	0	15	15	P42684-1	965	980	+	15	P42684-1	0	1182	ENST00000367623.8	0	3483	++	42	P42684-1#20	0	45	ENST00000367623.8	2832	2877	+	45	0	-30	9204
P42684-1#21	0	22	22	P42684-1	999	1021	+	22	P42684-1	52	1182	ENST00000512653.5	123	3513	++	131	P42684-1#21	0	66	ENST00000512653.5	2964	3030	+	66	0	-44	9205
P42684-1#21	0	22	22	P42684-1	999	1021	+	22	P42684-1	0	1182	ENST00000502732.6	280	3826	++	127	P42684-1#21	0	66	ENST00000502732.6	3277	3343	+	66	0	-44	9206
P42684-1#21	0	22	22	P42684-1	999	1021	+	22	P42684-1	0	1182	ENST00000367623.8	0	3483	++	42	P42684-1#21	0	66	ENST00000367623.8	2934	3000	+	66	0	-44	9207
P42684-1#22	0	1	1	P42684-1	408	409	+	1	P42684-1	52	1182	ENST00000512653.5	123	3513	++	131	P42684-1#22	0	3	ENST00000512653.5	1191	1194	+	3	0	-2	9208
P42684-1#22	0	1	1	P42684-1	408	409	+	1	P42684-1	0	687	ENST00000511413.5	0	2061	++	130	P42684-1#22	0	3	ENST00000511413.5	1224	1227	+	3	0	-2	9209
P42684-1#22	0	1	1	P42684-1	408	409	+	1	P42684-1	0	687	ENST00000507173.5	0	1998	++	129	P42684-1#22	0	3	ENST00000507173.5	1161	1164	+	3	0	-2	9210
P42684-1#22	0	1	1	P42684-1	408	409	+	1	P42684-1	73	687	ENST00000504405.5	111	1953	++	128	P42684-1#22	0	3	ENST00000504405.5	1116	1119	+	3	0	-2	9211
P42684-1#22	0	1	1	P42684-1	408	409	+	1	P42684-1	0	1182	ENST00000502732.6	280	3826	++	127	P42684-1#22	0	3	ENST00000502732.6	1504	1507	+	3	0	-2	9212
P42684-1#22	0	1	1	P42684-1	408	409	+	1	P42684-1	0	1182	ENST00000367623.8	0	3483	++	42	P42684-1#22	0	3	ENST00000367623.8	1161	1164	+	3	0	-2	9213
P42684-1#22	0	1	1	P42684-1	408	409	+	1	P42684-1	52	687	ENST00000344730.8	143	2048	++	34	P42684-1#22	0	3	ENST00000344730.8	1211	1214	+	3	0	-2	9214
P42684-1#23	0	9	9	P42684-1	293	302	+	9	P42684-1	52	1182	ENST00000512653.5	123	3513	++	131	P42684-1#23	0	27	ENST00000512653.5	846	873	+	27	0	-18	9215
P42684-1#23	0	9	9	P42684-1	293	302	+	9	P42684-1	0	687	ENST00000511413.5	0	2061	++	130	P42684-1#23	0	27	ENST00000511413.5	879	906	+	27	0	-18	9216
P42684-1#23	0	9	9	P42684-1	293	302	+	9	P42684-1	0	687	ENST00000507173.5	0	1998	++	129	P42684-1#23	0	27	ENST00000507173.5	816	843	+	27	0	-18	9217
P42684-1#23	0	9	9	P42684-1	293	302	+	9	P42684-1	73	687	ENST00000504405.5	111	1953	++	128	P42684-1#23	0	27	ENST00000504405.5	771	798	+	27	0	-18	9218
P42684-1#23	0	9	9	P42684-1	293	302	+	9	P42684-1	0	1182	ENST00000502732.6	280	3826	++	127	P42684-1#23	0	27	ENST00000502732.6	1159	1186	+	27	0	-18	9219
P42684-1#23	0	9	9	P42684-1	293	302	+	9	P42684-1	0	1182	ENST00000367623.8	0	3483	++	42	P42684-1#23	0	27	ENST00000367623.8	816	843	+	27	0	-18	9220
P42684-1#23	0	9	9	P42684-1	293	302	+	9	P42684-1	52	687	ENST00000344730.8	143	2048	++	34	P42684-1#23	0	27	ENST00000344730.8	866	893	+	27	0	-18	9221
P42684-1#24	0	1	1	P42684-1	316	317	+	1	P42684-1	52	1182	ENST00000512653.5	123	3513	++	131	P42684-1#24	0	3	ENST00000512653.5	915	918	+	3	0	-2	9222
P42684-1#24	0	1	1	P42684-1	316	317	+	1	P42684-1	0	687	ENST00000511413.5	0	2061	++	130	P42684-1#24	0	3	ENST00000511413.5	948	951	+	3	0	-2	9223
P42684-1#24	0	1	1	P42684-1	316	317	+	1	P42684-1	0	687	ENST00000507173.5	0	1998	++	129	P42684-1#24	0	3	ENST00000507173.5	885	888	+	3	0	-2	9224
P42684-1#24	0	1	1	P42684-1	316	317	+	1	P42684-1	73	687	ENST00000504405.5	111	1953	++	128	P42684-1#24	0	3	ENST00000504405.5	840	843	+	3	0	-2	9225
P42684-1#24	0	1	1	P42684-1	316	317	+	1	P42684-1	0	1182	ENST00000502732.6	280	3826	++	127	P42684-1#24	0	3	ENST00000502732.6	1228	1231	+	3	0	-2	9226
P42684-1#24	0	1	1	P42684-1	316	317	+	1	P42684-1	0	1182	ENST00000367623.8	0	3483	++	42	P42684-1#24	0	3	ENST00000367623.8	885	888	+	3	0	-2	9227
P42684-1#24	0	1	1	P42684-1	316	317	+	1	P42684-1	52	687	ENST00000344730.8	143	2048	++	34	P42684-1#24	0	3	ENST00000344730.8	935	938	+	3	0	-2	9228
P42684-1#25	0	7	7	P42684-1	361	368	+	7	P42684-1	52	1182	ENST00000512653.5	123	3513	++	131	P42684-1#25	0	21	ENST00000512653.5	1050	1071	+	21	0	-14	9229
P42684-1#25	0	7	7	P42684-1	361	368	+	7	P42684-1	0	687	ENST00000511413.5	0	2061	++	130	P42684-1#25	0	21	ENST00000511413.5	1083	1104	+	21	0	-14	9230
P42684-1#25	0	7	7	P42684-1	361	368	+	7	P42684-1	0	687	ENST00000507173.5	0	1998	++	129	P42684-1#25	0	21	ENST00000507173.5	1020	1041	+	21	0	-14	9231
P42684-1#25	0	7	7	P42684-1	361	368	+	7	P42684-1	73	687	ENST00000504405.5	111	1953	++	128	P42684-1#25	0	21	ENST00000504405.5	975	996	+	21	0	-14	9232
P42684-1#25	0	7	7	P42684-1	361	368	+	7	P42684-1	0	1182	ENST00000502732.6	280	3826	++	127	P42684-1#25	0	21	ENST00000502732.6	1363	1384	+	21	0	-14	9233
P42684-1#25	0	7	7	P42684-1	361	368	+	7	P42684-1	0	1182	ENST00000367623.8	0	3483	++	42	P42684-1#25	0	21	ENST00000367623.8	1020	1041	+	21	0	-14	9234
P42684-1#25	0	7	7	P42684-1	361	368	+	7	P42684-1	52	687	ENST00000344730.8	143	2048	++	34	P42684-1#25	0	21	ENST00000344730.8	1070	1091	+	21	0	-14	9235
P42684-1#26	0	1	1	P42684-1	96	97	+	1	P42684-1	52	1182	ENST00000512653.5	123	3513	++	131	P42684-1#26	0	3	ENST00000512653.5	255	258	+	3	0	-2	9236
P42684-1#26	0	1	1	P42684-1	96	97	+	1	P42684-1	0	687	ENST00000511413.5	0	2061	++	130	P42684-1#26	0	3	ENST00000511413.5	288	291	+	3	0	-2	9237
P42684-1#26	0	1	1	P42684-1	96	97	+	1	P42684-1	0	687	ENST00000507173.5	0	1998	++	129	P42684-1#26	0	3	ENST00000507173.5	225	228	+	3	0	-2	9238
P42684-1#26	0	1	1	P42684-1	96	97	+	1	P42684-1	73	687	ENST00000504405.5	111	1953	++	128	P42684-1#26	0	3	ENST00000504405.5	180	183	+	3	0	-2	9239
P42684-1#26	0	1	1	P42684-1	96	97	+	1	P42684-1	0	1182	ENST00000502732.6	280	3826	++	127	P42684-1#26	0	3	ENST00000502732.6	568	571	+	3	0	-2	9240
P42684-1#26	0	1	1	P42684-1	96	97	+	1	P42684-1	0	1182	ENST00000367623.8	0	3483	++	42	P42684-1#26	0	3	ENST00000367623.8	225	228	+	3	0	-2	9241
P42684-1#26	0	1	1	P42684-1	96	97	+	1	P42684-1	52	687	ENST00000344730.8	143	2048	++	34	P42684-1#26	0	3	ENST00000344730.8	275	278	+	3	0	-2	9242
P42684-1#27	0	1	1	P42684-1	115	116	+	1	P42684-1	52	1182	ENST00000512653.5	123	3513	++	131	P42684-1#27	0	3	ENST00000512653.5	312	315	+	3	0	-2	9243
P42684-1#27	0	1	1	P42684-1	115	116	+	1	P42684-1	0	687	ENST00000511413.5	0	2061	++	130	P42684-1#27	0	3	ENST00000511413.5	345	348	+	3	0	-2	9244
P42684-1#27	0	1	1	P42684-1	115	116	+	1	P42684-1	0	687	ENST00000507173.5	0	1998	++	129	P42684-1#27	0	3	ENST00000507173.5	282	285	+	3	0	-2	9245
P42684-1#27	0	1	1	P42684-1	115	116	+	1	P42684-1	73	687	ENST00000504405.5	111	1953	++	128	P42684-1#27	0	3	ENST00000504405.5	237	240	+	3	0	-2	9246
P42684-1#27	0	1	1	P42684-1	115	116	+	1	P42684-1	0	1182	ENST00000502732.6	280	3826	++	127	P42684-1#27	0	3	ENST00000502732.6	625	628	+	3	0	-2	9247
P42684-1#27	0	1	1	P42684-1	115	116	+	1	P42684-1	0	1182	ENST00000367623.8	0	3483	++	42	P42684-1#27	0	3	ENST00000367623.8	282	285	+	3	0	-2	9248
P42684-1#27	0	1	1	P42684-1	115	116	+	1	P42684-1	52	687	ENST00000344730.8	143	2048	++	34	P42684-1#27	0	3	ENST00000344730.8	332	335	+	3	0	-2	9249
P42684-1#28	0	1	1	P42684-1	160	161	+	1	P42684-1	52	1182	ENST00000512653.5	123	3513	++	131	P42684-1#28	0	3	ENST00000512653.5	447	450	+	3	0	-2	9250
P42684-1#28	0	1	1	P42684-1	160	161	+	1	P42684-1	0	687	ENST00000511413.5	0	2061	++	130	P42684-1#28	0	3	ENST00000511413.5	480	483	+	3	0	-2	9251
P42684-1#28	0	1	1	P42684-1	160	161	+	1	P42684-1	0	687	ENST00000507173.5	0	1998	++	129	P42684-1#28	0	3	ENST00000507173.5	417	420	+	3	0	-2	9252
P42684-1#28	0	1	1	P42684-1	160	161	+	1	P42684-1	73	687	ENST00000504405.5	111	1953	++	128	P42684-1#28	0	3	ENST00000504405.5	372	375	+	3	0	-2	9253
P42684-1#28	0	1	1	P42684-1	160	161	+	1	P42684-1	0	1182	ENST00000502732.6	280	3826	++	127	P42684-1#28	0	3	ENST00000502732.6	760	763	+	3	0	-2	9254
P42684-1#28	0	1	1	P42684-1	160	161	+	1	P42684-1	0	1182	ENST00000367623.8	0	3483	++	42	P42684-1#28	0	3	ENST00000367623.8	417	420	+	3	0	-2	9255
P42684-1#28	0	1	1	P42684-1	160	161	+	1	P42684-1	52	687	ENST00000344730.8	143	2048	++	34	P42684-1#28	0	3	ENST00000344730.8	467	470	+	3	0	-2	9256
P42684-1#29	0	1	1	P42684-1	173	174	+	1	P42684-1	52	1182	ENST00000512653.5	123	3513	++	131	P42684-1#29	0	3	ENST00000512653.5	486	489	+	3	0	-2	9257
P42684-1#29	0	1	1	P42684-1	173	174	+	1	P42684-1	0	687	ENST00000511413.5	0	2061	++	130	P42684-1#29	0	3	ENST00000511413.5	519	522	+	3	0	-2	9258
P42684-1#29	0	1	1	P42684-1	173	174	+	1	P42684-1	0	687	ENST00000507173.5	0	1998	++	129	P42684-1#29	0	3	ENST00000507173.5	456	459	+	3	0	-2	9259
P42684-1#29	0	1	1	P42684-1	173	174	+	1	P42684-1	73	687	ENST00000504405.5	111	1953	++	128	P42684-1#29	0	3	ENST00000504405.5	411	414	+	3	0	-2	9260
P42684-1#29	0	1	1	P42684-1	173	174	+	1	P42684-1	0	1182	ENST00000502732.6	280	3826	++	127	P42684-1#29	0	3	ENST00000502732.6	799	802	+	3	0	-2	9261
P42684-1#29	0	1	1	P42684-1	173	174	+	1	P42684-1	0	1182	ENST00000367623.8	0	3483	++	42	P42684-1#29	0	3	ENST00000367623.8	456	459	+	3	0	-2	9262
P42684-1#29	0	1	1	P42684-1	173	174	+	1	P42684-1	52	687	ENST00000344730.8	143	2048	++	34	P42684-1#29	0	3	ENST00000344730.8	506	509	+	3	0	-2	9263
P42684-1#30	0	1	1	P42684-1	184	185	+	1	P42684-1	52	1182	ENST00000512653.5	123	3513	++	131	P42684-1#30	0	3	ENST00000512653.5	519	522	+	3	0	-2	9264
P42684-1#30	0	1	1	P42684-1	184	185	+	1	P42684-1	0	687	ENST00000511413.5	0	2061	++	130	P42684-1#30	0	3	ENST00000511413.5	552	555	+	3	0	-2	9265
P42684-1#30	0	1	1	P42684-1	184	185	+	1	P42684-1	0	687	ENST00000507173.5	0	1998	++	129	P42684-1#30	0	3	ENST00000507173.5	489	492	+	3	0	-2	9266
P42684-1#30	0	1	1	P42684-1	184	185	+	1	P42684-1	73	687	ENST00000504405.5	111	1953	++	128	P42684-1#30	0	3	ENST00000504405.5	444	447	+	3	0	-2	9267
P42684-1#30	0	1	1	P42684-1	184	185	+	1	P42684-1	0	1182	ENST00000502732.6	280	3826	++	127	P42684-1#30	0	3	ENST00000502732.6	832	835	+	3	0	-2	9268
P42684-1#30	0	1	1	P42684-1	184	185	+	1	P42684-1	0	1182	ENST00000367623.8	0	3483	++	42	P42684-1#30	0	3	ENST00000367623.8	489	492	+	3	0	-2	9269
P42684-1#30	0	1	1	P42684-1	184	185	+	1	P42684-1	52	687	ENST00000344730.8	143	2048	++	34	P42684-1#30	0	3	ENST00000344730.8	539	542	+	3	0	-2	9270
P42684-1#31	0	1	1	P42684-1	217	218	+	1	P42684-1	52	1182	ENST00000512653.5	123	3513	++	131	P42684-1#31	0	3	ENST00000512653.5	618	621	+	3	0	-2	9271
P42684-1#31	0	1	1	P42684-1	217	218	+	1	P42684-1	0	687	ENST00000511413.5	0	2061	++	130	P42684-1#31	0	3	ENST00000511413.5	651	654	+	3	0	-2	9272
P42684-1#31	0	1	1	P42684-1	217	218	+	1	P42684-1	0	687	ENST00000507173.5	0	1998	++	129	P42684-1#31	0	3	ENST00000507173.5	588	591	+	3	0	-2	9273
P42684-1#31	0	1	1	P42684-1	217	218	+	1	P42684-1	73	687	ENST00000504405.5	111	1953	++	128	P42684-1#31	0	3	ENST00000504405.5	543	546	+	3	0	-2	9274
P42684-1#31	0	1	1	P42684-1	217	218	+	1	P42684-1	0	1182	ENST00000502732.6	280	3826	++	127	P42684-1#31	0	3	ENST00000502732.6	931	934	+	3	0	-2	9275
P42684-1#31	0	1	1	P42684-1	217	218	+	1	P42684-1	0	1182	ENST00000367623.8	0	3483	++	42	P42684-1#31	0	3	ENST00000367623.8	588	591	+	3	0	-2	9276
P42684-1#31	0	1	1	P42684-1	217	218	+	1	P42684-1	52	687	ENST00000344730.8	143	2048	++	34	P42684-1#31	0	3	ENST00000344730.8	638	641	+	3	0	-2	9277
P42684-1#32	0	1	1	P42684-1	230	231	+	1	P42684-1	52	1182	ENST00000512653.5	123	3513	++	131	P42684-1#32	0	3	ENST00000512653.5	657	660	+	3	0	-2	9278
P42684-1#32	0	1	1	P42684-1	230	231	+	1	P42684-1	0	687	ENST00000511413.5	0	2061	++	130	P42684-1#32	0	3	ENST00000511413.5	690	693	+	3	0	-2	9279
P42684-1#32	0	1	1	P42684-1	230	231	+	1	P42684-1	0	687	ENST00000507173.5	0	1998	++	129	P42684-1#32	0	3	ENST00000507173.5	627	630	+	3	0	-2	9280
P42684-1#32	0	1	1	P42684-1	230	231	+	1	P42684-1	73	687	ENST00000504405.5	111	1953	++	128	P42684-1#32	0	3	ENST00000504405.5	582	585	+	3	0	-2	9281
P42684-1#32	0	1	1	P42684-1	230	231	+	1	P42684-1	0	1182	ENST00000502732.6	280	3826	++	127	P42684-1#32	0	3	ENST00000502732.6	970	973	+	3	0	-2	9282
P42684-1#32	0	1	1	P42684-1	230	231	+	1	P42684-1	0	1182	ENST00000367623.8	0	3483	++	42	P42684-1#32	0	3	ENST00000367623.8	627	630	+	3	0	-2	9283
P42684-1#32	0	1	1	P42684-1	230	231	+	1	P42684-1	52	687	ENST00000344730.8	143	2048	++	34	P42684-1#32	0	3	ENST00000344730.8	677	680	+	3	0	-2	9284
P42684-1#33	0	1	1	P42684-1	260	261	+	1	P42684-1	52	1182	ENST00000512653.5	123	3513	++	131	P42684-1#33	0	3	ENST00000512653.5	747	750	+	3	0	-2	9285
P42684-1#33	0	1	1	P42684-1	260	261	+	1	P42684-1	0	687	ENST00000511413.5	0	2061	++	130	P42684-1#33	0	3	ENST00000511413.5	780	783	+	3	0	-2	9286
P42684-1#33	0	1	1	P42684-1	260	261	+	1	P42684-1	0	687	ENST00000507173.5	0	1998	++	129	P42684-1#33	0	3	ENST00000507173.5	717	720	+	3	0	-2	9287
P42684-1#33	0	1	1	P42684-1	260	261	+	1	P42684-1	73	687	ENST00000504405.5	111	1953	++	128	P42684-1#33	0	3	ENST00000504405.5	672	675	+	3	0	-2	9288
P42684-1#33	0	1	1	P42684-1	260	261	+	1	P42684-1	0	1182	ENST00000502732.6	280	3826	++	127	P42684-1#33	0	3	ENST00000502732.6	1060	1063	+	3	0	-2	9289
P42684-1#33	0	1	1	P42684-1	260	261	+	1	P42684-1	0	1182	ENST00000367623.8	0	3483	++	42	P42684-1#33	0	3	ENST00000367623.8	717	720	+	3	0	-2	9290
P42684-1#33	0	1	1	P42684-1	260	261	+	1	P42684-1	52	687	ENST00000344730.8	143	2048	++	34	P42684-1#33	0	3	ENST00000344730.8	767	770	+	3	0	-2	9291
P42684-1#34	0	1	1	P42684-1	271	272	+	1	P42684-1	52	1182	ENST00000512653.5	123	3513	++	131	P42684-1#34	0	3	ENST00000512653.5	780	783	+	3	0	-2	9292
P42684-1#34	0	1	1	P42684-1	271	272	+	1	P42684-1	0	687	ENST00000511413.5	0	2061	++	130	P42684-1#34	0	3	ENST00000511413.5	813	816	+	3	0	-2	9293
P42684-1#34	0	1	1	P42684-1	271	272	+	1	P42684-1	0	687	ENST00000507173.5	0	1998	++	129	P42684-1#34	0	3	ENST00000507173.5	750	753	+	3	0	-2	9294
P42684-1#34	0	1	1	P42684-1	271	272	+	1	P42684-1	73	687	ENST00000504405.5	111	1953	++	128	P42684-1#34	0	3	ENST00000504405.5	705	708	+	3	0	-2	9295
P42684-1#34	0	1	1	P42684-1	271	272	+	1	P42684-1	0	1182	ENST00000502732.6	280	3826	++	127	P42684-1#34	0	3	ENST00000502732.6	1093	1096	+	3	0	-2	9296
P42684-1#34	0	1	1	P42684-1	271	272	+	1	P42684-1	0	1182	ENST00000367623.8	0	3483	++	42	P42684-1#34	0	3	ENST00000367623.8	750	753	+	3	0	-2	9297
P42684-1#34	0	1	1	P42684-1	271	272	+	1	P42684-1	52	687	ENST00000344730.8	143	2048	++	34	P42684-1#34	0	3	ENST00000344730.8	800	803	+	3	0	-2	9298
P42684-1#35	0	1	1	P42684-1	274	275	+	1	P42684-1	52	1182	ENST00000512653.5	123	3513	++	131	P42684-1#35	0	3	ENST00000512653.5	789	792	+	3	0	-2	9299
P42684-1#35	0	1	1	P42684-1	274	275	+	1	P42684-1	0	687	ENST00000511413.5	0	2061	++	130	P42684-1#35	0	3	ENST00000511413.5	822	825	+	3	0	-2	9300
P42684-1#35	0	1	1	P42684-1	274	275	+	1	P42684-1	0	687	ENST00000507173.5	0	1998	++	129	P42684-1#35	0	3	ENST00000507173.5	759	762	+	3	0	-2	9301
P42684-1#35	0	1	1	P42684-1	274	275	+	1	P42684-1	73	687	ENST00000504405.5	111	1953	++	128	P42684-1#35	0	3	ENST00000504405.5	714	717	+	3	0	-2	9302
P42684-1#35	0	1	1	P42684-1	274	275	+	1	P42684-1	0	1182	ENST00000502732.6	280	3826	++	127	P42684-1#35	0	3	ENST00000502732.6	1102	1105	+	3	0	-2	9303
P42684-1#35	0	1	1	P42684-1	274	275	+	1	P42684-1	0	1182	ENST00000367623.8	0	3483	++	42	P42684-1#35	0	3	ENST00000367623.8	759	762	+	3	0	-2	9304
P42684-1#35	0	1	1	P42684-1	274	275	+	1	P42684-1	52	687	ENST00000344730.8	143	2048	++	34	P42684-1#35	0	3	ENST00000344730.8	809	812	+	3	0	-2	9305
P42684-1#36	0	1	1	P42684-1	298	299	+	1	P42684-1	52	1182	ENST00000512653.5	123	3513	++	131	P42684-1#36	0	3	ENST00000512653.5	861	864	+	3	0	-2	9306
P42684-1#36	0	1	1	P42684-1	298	299	+	1	P42684-1	0	687	ENST00000511413.5	0	2061	++	130	P42684-1#36	0	3	ENST00000511413.5	894	897	+	3	0	-2	9307
P42684-1#36	0	1	1	P42684-1	298	299	+	1	P42684-1	0	687	ENST00000507173.5	0	1998	++	129	P42684-1#36	0	3	ENST00000507173.5	831	834	+	3	0	-2	9308
P42684-1#36	0	1	1	P42684-1	298	299	+	1	P42684-1	73	687	ENST00000504405.5	111	1953	++	128	P42684-1#36	0	3	ENST00000504405.5	786	789	+	3	0	-2	9309
P42684-1#36	0	1	1	P42684-1	298	299	+	1	P42684-1	0	1182	ENST00000502732.6	280	3826	++	127	P42684-1#36	0	3	ENST00000502732.6	1174	1177	+	3	0	-2	9310
P42684-1#36	0	1	1	P42684-1	298	299	+	1	P42684-1	0	1182	ENST00000367623.8	0	3483	++	42	P42684-1#36	0	3	ENST00000367623.8	831	834	+	3	0	-2	9311
P42684-1#36	0	1	1	P42684-1	298	299	+	1	P42684-1	52	687	ENST00000344730.8	143	2048	++	34	P42684-1#36	0	3	ENST00000344730.8	881	884	+	3	0	-2	9312
P42684-1#37	0	1	1	P42684-1	302	303	+	1	P42684-1	52	1182	ENST00000512653.5	123	3513	++	131	P42684-1#37	0	3	ENST00000512653.5	873	876	+	3	0	-2	9313
P42684-1#37	0	1	1	P42684-1	302	303	+	1	P42684-1	0	687	ENST00000511413.5	0	2061	++	130	P42684-1#37	0	3	ENST00000511413.5	906	909	+	3	0	-2	9314
P42684-1#37	0	1	1	P42684-1	302	303	+	1	P42684-1	0	687	ENST00000507173.5	0	1998	++	129	P42684-1#37	0	3	ENST00000507173.5	843	846	+	3	0	-2	9315
P42684-1#37	0	1	1	P42684-1	302	303	+	1	P42684-1	73	687	ENST00000504405.5	111	1953	++	128	P42684-1#37	0	3	ENST00000504405.5	798	801	+	3	0	-2	9316
P42684-1#37	0	1	1	P42684-1	302	303	+	1	P42684-1	0	1182	ENST00000502732.6	280	3826	++	127	P42684-1#37	0	3	ENST00000502732.6	1186	1189	+	3	0	-2	9317
P42684-1#37	0	1	1	P42684-1	302	303	+	1	P42684-1	0	1182	ENST00000367623.8	0	3483	++	42	P42684-1#37	0	3	ENST00000367623.8	843	846	+	3	0	-2	9318
P42684-1#37	0	1	1	P42684-1	302	303	+	1	P42684-1	52	687	ENST00000344730.8	143	2048	++	34	P42684-1#37	0	3	ENST00000344730.8	893	896	+	3	0	-2	9319
P42684-1#38	0	1	1	P42684-1	438	439	+	1	P42684-1	52	1182	ENST00000512653.5	123	3513	++	131	P42684-1#38	0	3	ENST00000512653.5	1281	1284	+	3	0	-2	9320
P42684-1#38	0	1	1	P42684-1	438	439	+	1	P42684-1	0	687	ENST00000511413.5	0	2061	++	130	P42684-1#38	0	3	ENST00000511413.5	1314	1317	+	3	0	-2	9321
P42684-1#38	0	1	1	P42684-1	438	439	+	1	P42684-1	0	687	ENST00000507173.5	0	1998	++	129	P42684-1#38	0	3	ENST00000507173.5	1251	1254	+	3	0	-2	9322
P42684-1#38	0	1	1	P42684-1	438	439	+	1	P42684-1	73	687	ENST00000504405.5	111	1953	++	128	P42684-1#38	0	3	ENST00000504405.5	1206	1209	+	3	0	-2	9323
P42684-1#38	0	1	1	P42684-1	438	439	+	1	P42684-1	0	1182	ENST00000502732.6	280	3826	++	127	P42684-1#38	0	3	ENST00000502732.6	1594	1597	+	3	0	-2	9324
P42684-1#38	0	1	1	P42684-1	438	439	+	1	P42684-1	0	1182	ENST00000367623.8	0	3483	++	42	P42684-1#38	0	3	ENST00000367623.8	1251	1254	+	3	0	-2	9325
P42684-1#38	0	1	1	P42684-1	438	439	+	1	P42684-1	52	687	ENST00000344730.8	143	2048	++	34	P42684-1#38	0	3	ENST00000344730.8	1301	1304	+	3	0	-2	9326
P42684-1#39	0	1	1	P42684-1	458	459	+	1	P42684-1	52	1182	ENST00000512653.5	123	3513	++	131	P42684-1#39	0	3	ENST00000512653.5	1341	1344	+	3	0	-2	9327
P42684-1#39	0	1	1	P42684-1	458	459	+	1	P42684-1	0	687	ENST00000511413.5	0	2061	++	130	P42684-1#39	0	3	ENST00000511413.5	1374	1377	+	3	0	-2	9328
P42684-1#39	0	1	1	P42684-1	458	459	+	1	P42684-1	0	687	ENST00000507173.5	0	1998	++	129	P42684-1#39	0	3	ENST00000507173.5	1311	1314	+	3	0	-2	9329
P42684-1#39	0	1	1	P42684-1	458	459	+	1	P42684-1	73	687	ENST00000504405.5	111	1953	++	128	P42684-1#39	0	3	ENST00000504405.5	1266	1269	+	3	0	-2	9330
P42684-1#39	0	1	1	P42684-1	458	459	+	1	P42684-1	0	1182	ENST00000502732.6	280	3826	++	127	P42684-1#39	0	3	ENST00000502732.6	1654	1657	+	3	0	-2	9331
P42684-1#39	0	1	1	P42684-1	458	459	+	1	P42684-1	0	1182	ENST00000367623.8	0	3483	++	42	P42684-1#39	0	3	ENST00000367623.8	1311	1314	+	3	0	-2	9332
P42684-1#39	0	1	1	P42684-1	458	459	+	1	P42684-1	52	687	ENST00000344730.8	143	2048	++	34	P42684-1#39	0	3	ENST00000344730.8	1361	1364	+	3	0	-2	9333
P42684-1#40	0	1	1	P42684-1	567	568	+	1	P42684-1	52	1182	ENST00000512653.5	123	3513	++	131	P42684-1#40	0	3	ENST00000512653.5	1668	1671	+	3	0	-2	9334
P42684-1#40	0	1	1	P42684-1	567	568	+	1	P42684-1	0	687	ENST00000511413.5	0	2061	++	130	P42684-1#40	0	3	ENST00000511413.5	1701	1704	+	3	0	-2	9335
P42684-1#40	0	1	1	P42684-1	567	568	+	1	P42684-1	0	687	ENST00000507173.5	0	1998	++	129	P42684-1#40	0	3	ENST00000507173.5	1638	1641	+	3	0	-2	9336
P42684-1#40	0	1	1	P42684-1	567	568	+	1	P42684-1	73	687	ENST00000504405.5	111	1953	++	128	P42684-1#40	0	3	ENST00000504405.5	1593	1596	+	3	0	-2	9337
P42684-1#40	0	1	1	P42684-1	567	568	+	1	P42684-1	0	1182	ENST00000502732.6	280	3826	++	127	P42684-1#40	0	3	ENST00000502732.6	1981	1984	+	3	0	-2	9338
P42684-1#40	0	1	1	P42684-1	567	568	+	1	P42684-1	0	1182	ENST00000367623.8	0	3483	++	42	P42684-1#40	0	3	ENST00000367623.8	1638	1641	+	3	0	-2	9339
P42684-1#40	0	1	1	P42684-1	567	568	+	1	P42684-1	52	687	ENST00000344730.8	143	2048	++	34	P42684-1#40	0	3	ENST00000344730.8	1688	1691	+	3	0	-2	9340
P42684-1#41	0	1	1	P42684-1	619	620	+	1	P42684-1	52	1182	ENST00000512653.5	123	3513	++	131	P42684-1#41	0	3	ENST00000512653.5	1824	1827	+	3	0	-2	9341
P42684-1#41	0	1	1	P42684-1	619	620	+	1	P42684-1	0	687	ENST00000511413.5	0	2061	++	130	P42684-1#41	0	3	ENST00000511413.5	1857	1860	+	3	0	-2	9342
P42684-1#41	0	1	1	P42684-1	619	620	+	1	P42684-1	0	687	ENST00000507173.5	0	1998	++	129	P42684-1#41	0	3	ENST00000507173.5	1794	1797	+	3	0	-2	9343
P42684-1#41	0	1	1	P42684-1	619	620	+	1	P42684-1	73	687	ENST00000504405.5	111	1953	++	128	P42684-1#41	0	3	ENST00000504405.5	1749	1752	+	3	0	-2	9344
P42684-1#41	0	1	1	P42684-1	619	620	+	1	P42684-1	0	1182	ENST00000502732.6	280	3826	++	127	P42684-1#41	0	3	ENST00000502732.6	2137	2140	+	3	0	-2	9345
P42684-1#41	0	1	1	P42684-1	619	620	+	1	P42684-1	0	1182	ENST00000367623.8	0	3483	++	42	P42684-1#41	0	3	ENST00000367623.8	1794	1797	+	3	0	-2	9346
P42684-1#41	0	1	1	P42684-1	619	620	+	1	P42684-1	52	687	ENST00000344730.8	143	2048	++	34	P42684-1#41	0	3	ENST00000344730.8	1844	1847	+	3	0	-2	9347
P42684-1#42	0	1	1	P42684-1	630	631	+	1	P42684-1	52	1182	ENST00000512653.5	123	3513	++	131	P42684-1#42	0	3	ENST00000512653.5	1857	1860	+	3	0	-2	9348
P42684-1#42	0	1	1	P42684-1	630	631	+	1	P42684-1	0	687	ENST00000511413.5	0	2061	++	130	P42684-1#42	0	3	ENST00000511413.5	1890	1893	+	3	0	-2	9349
P42684-1#42	0	1	1	P42684-1	630	631	+	1	P42684-1	0	687	ENST00000507173.5	0	1998	++	129	P42684-1#42	0	3	ENST00000507173.5	1827	1830	+	3	0	-2	9350
P42684-1#42	0	1	1	P42684-1	630	631	+	1	P42684-1	73	687	ENST00000504405.5	111	1953	++	128	P42684-1#42	0	3	ENST00000504405.5	1782	1785	+	3	0	-2	9351
P42684-1#42	0	1	1	P42684-1	630	631	+	1	P42684-1	0	1182	ENST00000502732.6	280	3826	++	127	P42684-1#42	0	3	ENST00000502732.6	2170	2173	+	3	0	-2	9352
P42684-1#42	0	1	1	P42684-1	630	631	+	1	P42684-1	0	1182	ENST00000367623.8	0	3483	++	42	P42684-1#42	0	3	ENST00000367623.8	1827	1830	+	3	0	-2	9353
P42684-1#42	0	1	1	P42684-1	630	631	+	1	P42684-1	52	687	ENST00000344730.8	143	2048	++	34	P42684-1#42	0	3	ENST00000344730.8	1877	1880	+	3	0	-2	9354
P42684-1#43	0	1	1	P42684-1	632	633	+	1	P42684-1	52	1182	ENST00000512653.5	123	3513	++	131	P42684-1#43	0	3	ENST00000512653.5	1863	1866	+	3	0	-2	9355
P42684-1#43	0	1	1	P42684-1	632	633	+	1	P42684-1	0	687	ENST00000511413.5	0	2061	++	130	P42684-1#43	0	3	ENST00000511413.5	1896	1899	+	3	0	-2	9356
P42684-1#43	0	1	1	P42684-1	632	633	+	1	P42684-1	0	687	ENST00000507173.5	0	1998	++	129	P42684-1#43	0	3	ENST00000507173.5	1833	1836	+	3	0	-2	9357
P42684-1#43	0	1	1	P42684-1	632	633	+	1	P42684-1	73	687	ENST00000504405.5	111	1953	++	128	P42684-1#43	0	3	ENST00000504405.5	1788	1791	+	3	0	-2	9358
P42684-1#43	0	1	1	P42684-1	632	633	+	1	P42684-1	0	1182	ENST00000502732.6	280	3826	++	127	P42684-1#43	0	3	ENST00000502732.6	2176	2179	+	3	0	-2	9359
P42684-1#43	0	1	1	P42684-1	632	633	+	1	P42684-1	0	1182	ENST00000367623.8	0	3483	++	42	P42684-1#43	0	3	ENST00000367623.8	1833	1836	+	3	0	-2	9360
P42684-1#43	0	1	1	P42684-1	632	633	+	1	P42684-1	52	687	ENST00000344730.8	143	2048	++	34	P42684-1#43	0	3	ENST00000344730.8	1883	1886	+	3	0	-2	9361
P42684-1#44	0	1	1	P42684-1	654	655	+	1	P42684-1	52	1182	ENST00000512653.5	123	3513	++	131	P42684-1#44	0	3	ENST00000512653.5	1929	1932	+	3	0	-2	9362
P42684-1#44	0	1	1	P42684-1	654	655	+	1	P42684-1	0	687	ENST00000511413.5	0	2061	++	130	P42684-1#44	0	3	ENST00000511413.5	1962	1965	+	3	0	-2	9363
P42684-1#44	0	1	1	P42684-1	654	655	+	1	P42684-1	0	687	ENST00000507173.5	0	1998	++	129	P42684-1#44	0	3	ENST00000507173.5	1899	1902	+	3	0	-2	9364
P42684-1#44	0	1	1	P42684-1	654	655	+	1	P42684-1	73	687	ENST00000504405.5	111	1953	++	128	P42684-1#44	0	3	ENST00000504405.5	1854	1857	+	3	0	-2	9365
P42684-1#44	0	1	1	P42684-1	654	655	+	1	P42684-1	0	1182	ENST00000502732.6	280	3826	++	127	P42684-1#44	0	3	ENST00000502732.6	2242	2245	+	3	0	-2	9366
P42684-1#44	0	1	1	P42684-1	654	655	+	1	P42684-1	0	1182	ENST00000367623.8	0	3483	++	42	P42684-1#44	0	3	ENST00000367623.8	1899	1902	+	3	0	-2	9367
P42684-1#44	0	1	1	P42684-1	654	655	+	1	P42684-1	52	687	ENST00000344730.8	143	2048	++	34	P42684-1#44	0	3	ENST00000344730.8	1949	1952	+	3	0	-2	9368
P42684-1#45	0	1	1	P42684-1	668	669	+	1	P42684-1	52	1182	ENST00000512653.5	123	3513	++	131	P42684-1#45	0	3	ENST00000512653.5	1971	1974	+	3	0	-2	9369
P42684-1#45	0	1	1	P42684-1	668	669	+	1	P42684-1	0	687	ENST00000511413.5	0	2061	++	130	P42684-1#45	0	3	ENST00000511413.5	2004	2007	+	3	0	-2	9370
P42684-1#45	0	1	1	P42684-1	668	669	+	1	P42684-1	0	687	ENST00000507173.5	0	1998	++	129	P42684-1#45	0	3	ENST00000507173.5	1941	1944	+	3	0	-2	9371
P42684-1#45	0	1	1	P42684-1	668	669	+	1	P42684-1	73	687	ENST00000504405.5	111	1953	++	128	P42684-1#45	0	3	ENST00000504405.5	1896	1899	+	3	0	-2	9372
P42684-1#45	0	1	1	P42684-1	668	669	+	1	P42684-1	0	1182	ENST00000502732.6	280	3826	++	127	P42684-1#45	0	3	ENST00000502732.6	2284	2287	+	3	0	-2	9373
P42684-1#45	0	1	1	P42684-1	668	669	+	1	P42684-1	0	1182	ENST00000367623.8	0	3483	++	42	P42684-1#45	0	3	ENST00000367623.8	1941	1944	+	3	0	-2	9374
P42684-1#45	0	1	1	P42684-1	668	669	+	1	P42684-1	52	687	ENST00000344730.8	143	2048	++	34	P42684-1#45	0	3	ENST00000344730.8	1991	1994	+	3	0	-2	9375
P42684-1#46	0	1	1	P42684-1	669	670	+	1	P42684-1	52	1182	ENST00000512653.5	123	3513	++	131	P42684-1#46	0	3	ENST00000512653.5	1974	1977	+	3	0	-2	9376
P42684-1#46	0	1	1	P42684-1	669	670	+	1	P42684-1	0	687	ENST00000511413.5	0	2061	++	130	P42684-1#46	0	3	ENST00000511413.5	2007	2010	+	3	0	-2	9377
P42684-1#46	0	1	1	P42684-1	669	670	+	1	P42684-1	0	687	ENST00000507173.5	0	1998	++	129	P42684-1#46	0	3	ENST00000507173.5	1944	1947	+	3	0	-2	9378
P42684-1#46	0	1	1	P42684-1	669	670	+	1	P42684-1	73	687	ENST00000504405.5	111	1953	++	128	P42684-1#46	0	3	ENST00000504405.5	1899	1902	+	3	0	-2	9379
P42684-1#46	0	1	1	P42684-1	669	670	+	1	P42684-1	0	1182	ENST00000502732.6	280	3826	++	127	P42684-1#46	0	3	ENST00000502732.6	2287	2290	+	3	0	-2	9380
P42684-1#46	0	1	1	P42684-1	669	670	+	1	P42684-1	0	1182	ENST00000367623.8	0	3483	++	42	P42684-1#46	0	3	ENST00000367623.8	1944	1947	+	3	0	-2	9381
P42684-1#46	0	1	1	P42684-1	669	670	+	1	P42684-1	52	687	ENST00000344730.8	143	2048	++	34	P42684-1#46	0	3	ENST00000344730.8	1994	1997	+	3	0	-2	9382
P42684-1#47	0	1	1	P42684-1	670	671	+	1	P42684-1	52	1182	ENST00000512653.5	123	3513	++	131	P42684-1#47	0	3	ENST00000512653.5	1977	1980	+	3	0	-2	9383
P42684-1#47	0	1	1	P42684-1	670	671	+	1	P42684-1	0	687	ENST00000511413.5	0	2061	++	130	P42684-1#47	0	3	ENST00000511413.5	2010	2013	+	3	0	-2	9384
P42684-1#47	0	1	1	P42684-1	670	671	+	1	P42684-1	0	687	ENST00000507173.5	0	1998	++	129	P42684-1#47	0	3	ENST00000507173.5	1947	1950	+	3	0	-2	9385
P42684-1#47	0	1	1	P42684-1	670	671	+	1	P42684-1	73	687	ENST00000504405.5	111	1953	++	128	P42684-1#47	0	3	ENST00000504405.5	1902	1905	+	3	0	-2	9386
P42684-1#47	0	1	1	P42684-1	670	671	+	1	P42684-1	0	1182	ENST00000502732.6	280	3826	++	127	P42684-1#47	0	3	ENST00000502732.6	2290	2293	+	3	0	-2	9387
P42684-1#47	0	1	1	P42684-1	670	671	+	1	P42684-1	0	1182	ENST00000367623.8	0	3483	++	42	P42684-1#47	0	3	ENST00000367623.8	1947	1950	+	3	0	-2	9388
P42684-1#47	0	1	1	P42684-1	670	671	+	1	P42684-1	52	687	ENST00000344730.8	143	2048	++	34	P42684-1#47	0	3	ENST00000344730.8	1997	2000	+	3	0	-2	9389
P42684-1#48	0	1	1	P42684-1	682	683	+	1	P42684-1	52	1182	ENST00000512653.5	123	3513	++	131	P42684-1#48	0	3	ENST00000512653.5	2013	2016	+	3	0	-2	9390
P42684-1#48	0	1	1	P42684-1	682	683	+	1	P42684-1	0	687	ENST00000511413.5	0	2061	++	130	P42684-1#48	0	3	ENST00000511413.5	2046	2049	+	3	0	-2	9391
P42684-1#48	0	1	1	P42684-1	682	683	+	1	P42684-1	0	687	ENST00000507173.5	0	1998	++	129	P42684-1#48	0	3	ENST00000507173.5	1983	1986	+	3	0	-2	9392
P42684-1#48	0	1	1	P42684-1	682	683	+	1	P42684-1	73	687	ENST00000504405.5	111	1953	++	128	P42684-1#48	0	3	ENST00000504405.5	1938	1941	+	3	0	-2	9393
P42684-1#48	0	1	1	P42684-1	682	683	+	1	P42684-1	0	1182	ENST00000502732.6	280	3826	++	127	P42684-1#48	0	3	ENST00000502732.6	2326	2329	+	3	0	-2	9394
P42684-1#48	0	1	1	P42684-1	682	683	+	1	P42684-1	0	1182	ENST00000367623.8	0	3483	++	42	P42684-1#48	0	3	ENST00000367623.8	1983	1986	+	3	0	-2	9395
P42684-1#48	0	1	1	P42684-1	682	683	+	1	P42684-1	52	687	ENST00000344730.8	143	2048	++	34	P42684-1#48	0	3	ENST00000344730.8	2033	2036	+	3	0	-2	9396
P42684-1#49	0	1	1	P42684-1	717	718	+	1	P42684-1	52	1182	ENST00000512653.5	123	3513	++	131	P42684-1#49	0	3	ENST00000512653.5	2118	2121	+	3	0	-2	9397
P42684-1#49	0	1	1	P42684-1	717	718	+	1	P42684-1	0	1182	ENST00000502732.6	280	3826	++	127	P42684-1#49	0	3	ENST00000502732.6	2431	2434	+	3	0	-2	9398
P42684-1#49	0	1	1	P42684-1	717	718	+	1	P42684-1	0	1182	ENST00000367623.8	0	3483	++	42	P42684-1#49	0	3	ENST00000367623.8	2088	2091	+	3	0	-2	9399
P42684-1#50	0	1	1	P42684-1	775	776	+	1	P42684-1	52	1182	ENST00000512653.5	123	3513	++	131	P42684-1#50	0	3	ENST00000512653.5	2292	2295	+	3	0	-2	9400
P42684-1#50	0	1	1	P42684-1	775	776	+	1	P42684-1	0	1182	ENST00000502732.6	280	3826	++	127	P42684-1#50	0	3	ENST00000502732.6	2605	2608	+	3	0	-2	9401
P42684-1#50	0	1	1	P42684-1	775	776	+	1	P42684-1	0	1182	ENST00000367623.8	0	3483	++	42	P42684-1#50	0	3	ENST00000367623.8	2262	2265	+	3	0	-2	9402
P42684-1#51	0	1	1	P42684-1	782	783	+	1	P42684-1	52	1182	ENST00000512653.5	123	3513	++	131	P42684-1#51	0	3	ENST00000512653.5	2313	2316	+	3	0	-2	9403
P42684-1#51	0	1	1	P42684-1	782	783	+	1	P42684-1	0	1182	ENST00000502732.6	280	3826	++	127	P42684-1#51	0	3	ENST00000502732.6	2626	2629	+	3	0	-2	9404
P42684-1#51	0	1	1	P42684-1	782	783	+	1	P42684-1	0	1182	ENST00000367623.8	0	3483	++	42	P42684-1#51	0	3	ENST00000367623.8	2283	2286	+	3	0	-2	9405
P42684-1#52	0	1	1	P42684-1	799	800	+	1	P42684-1	52	1182	ENST00000512653.5	123	3513	++	131	P42684-1#52	0	3	ENST00000512653.5	2364	2367	+	3	0	-2	9406
P42684-1#52	0	1	1	P42684-1	799	800	+	1	P42684-1	0	1182	ENST00000502732.6	280	3826	++	127	P42684-1#52	0	3	ENST00000502732.6	2677	2680	+	3	0	-2	9407
P42684-1#52	0	1	1	P42684-1	799	800	+	1	P42684-1	0	1182	ENST00000367623.8	0	3483	++	42	P42684-1#52	0	3	ENST00000367623.8	2334	2337	+	3	0	-2	9408
P42684-1#53	0	1	1	P42684-1	816	817	+	1	P42684-1	52	1182	ENST00000512653.5	123	3513	++	131	P42684-1#53	0	3	ENST00000512653.5	2415	2418	+	3	0	-2	9409
P42684-1#53	0	1	1	P42684-1	816	817	+	1	P42684-1	0	1182	ENST00000502732.6	280	3826	++	127	P42684-1#53	0	3	ENST00000502732.6	2728	2731	+	3	0	-2	9410
P42684-1#53	0	1	1	P42684-1	816	817	+	1	P42684-1	0	1182	ENST00000367623.8	0	3483	++	42	P42684-1#53	0	3	ENST00000367623.8	2385	2388	+	3	0	-2	9411
P42684-1#54	0	1	1	P42684-1	819	820	+	1	P42684-1	52	1182	ENST00000512653.5	123	3513	++	131	P42684-1#54	0	3	ENST00000512653.5	2424	2427	+	3	0	-2	9412
P42684-1#54	0	1	1	P42684-1	819	820	+	1	P42684-1	0	1182	ENST00000502732.6	280	3826	++	127	P42684-1#54	0	3	ENST00000502732.6	2737	2740	+	3	0	-2	9413
P42684-1#54	0	1	1	P42684-1	819	820	+	1	P42684-1	0	1182	ENST00000367623.8	0	3483	++	42	P42684-1#54	0	3	ENST00000367623.8	2394	2397	+	3	0	-2	9414
P42684-1#55	0	1	1	P42684-1	914	915	+	1	P42684-1	52	1182	ENST00000512653.5	123	3513	++	131	P42684-1#55	0	3	ENST00000512653.5	2709	2712	+	3	0	-2	9415
P42684-1#55	0	1	1	P42684-1	914	915	+	1	P42684-1	0	1182	ENST00000502732.6	280	3826	++	127	P42684-1#55	0	3	ENST00000502732.6	3022	3025	+	3	0	-2	9416
P42684-1#55	0	1	1	P42684-1	914	915	+	1	P42684-1	0	1182	ENST00000367623.8	0	3483	++	42	P42684-1#55	0	3	ENST00000367623.8	2679	2682	+	3	0	-2	9417
P42684-1#56	0	1	1	P42684-1	935	936	+	1	P42684-1	52	1182	ENST00000512653.5	123	3513	++	131	P42684-1#56	0	3	ENST00000512653.5	2772	2775	+	3	0	-2	9418
P42684-1#56	0	1	1	P42684-1	935	936	+	1	P42684-1	0	1182	ENST00000502732.6	280	3826	++	127	P42684-1#56	0	3	ENST00000502732.6	3085	3088	+	3	0	-2	9419
P42684-1#56	0	1	1	P42684-1	935	936	+	1	P42684-1	0	1182	ENST00000367623.8	0	3483	++	42	P42684-1#56	0	3	ENST00000367623.8	2742	2745	+	3	0	-2	9420
P42684-1#57	0	1	1	P42684-1	1	2	+	1	P42684-1	0	687	ENST00000511413.5	0	2061	++	130	P42684-1#57	0	3	ENST00000511413.5	3	6	+	3	0	-2	9421
P42684-1#57	0	1	1	P42684-1	1	2	+	1	P42684-1	0	687	ENST00000507173.5	0	1998	++	129	P42684-1#57	0	3	ENST00000507173.5	3	6	+	3	0	-2	9422
P42684-1#57	0	1	1	P42684-1	1	2	+	1	P42684-1	0	1182	ENST00000502732.6	280	3826	++	127	P42684-1#57	0	3	ENST00000502732.6	283	286	+	3	0	-2	9423
P42684-1#57	0	1	1	P42684-1	1	2	+	1	P42684-1	0	1182	ENST00000367623.8	0	3483	++	42	P42684-1#57	0	3	ENST00000367623.8	3	6	+	3	0	-2	9424
P42684-1#58	0	73	73	P42684-1	0	73	+	73	P42684-1	52	1182	ENST00000512653.5	123	3513	++	131	P42684-1#58	156	219	ENST00000512653.5	123	186	+	63	156	-146	9425
P42684-1#58	0	73	73	P42684-1	0	73	+	73	P42684-1	0	687	ENST00000511413.5	0	2061	++	130	P42684-1#58	0	219	ENST00000511413.5	0	219	+	219	0	-146	9426
P42684-1#58	0	73	73	P42684-1	0	73	+	73	P42684-1	0	687	ENST00000507173.5	0	1998	++	129	P42684-1#58	0	156	ENST00000507173.5	0	156	+	156	0	-83	9427
P42684-1#58	0	73	73	P42684-1	0	73	+	73	P42684-1	0	1182	ENST00000502732.6	280	3826	++	127	P42684-1#58	0	219	ENST00000502732.6	280	499	+	219	0	-146	9428
P42684-1#58	0	73	73	P42684-1	0	73	+	73	P42684-1	0	1182	ENST00000367623.8	0	3483	++	42	P42684-1#58	0	156	ENST00000367623.8	0	156	+	156	0	-83	9429
P42684-1#58	0	73	73	P42684-1	0	73	+	73	P42684-1	52	687	ENST00000344730.8	143	2048	++	34	P42684-1#58	156	219	ENST00000344730.8	143	206	+	63	156	-146	9430
P42684-1#59	0	52	52	P42684-1	0	52	+	52	P42684-1	0	687	ENST00000511413.5	0	2061	++	130	P42684-1#59	0	156	ENST00000511413.5	0	156	+	156	0	-104	9431
P42684-1#59	0	52	52	P42684-1	0	52	+	52	P42684-1	0	687	ENST00000507173.5	0	1998	++	129	P42684-1#59	0	156	ENST00000507173.5	0	156	+	156	0	-104	9432
P42684-1#59	0	52	52	P42684-1	0	52	+	52	P42684-1	0	1182	ENST00000502732.6	280	3826	++	127	P42684-1#59	0	156	ENST00000502732.6	280	436	+	156	0	-104	9433
P42684-1#59	0	52	52	P42684-1	0	52	+	52	P42684-1	0	1182	ENST00000367623.8	0	3483	++	42	P42684-1#59	0	156	ENST00000367623.8	0	156	+	156	0	-104	9434
P42684-1#60	0	21	21	P42684-1	52	73	+	21	P42684-1	52	1182	ENST00000512653.5	123	3513	++	131	P42684-1#60	0	63	ENST00000512653.5	123	186	+	63	0	-42	9435
P42684-1#60	0	21	21	P42684-1	52	73	+	21	P42684-1	0	687	ENST00000511413.5	0	2061	++	130	P42684-1#60	0	63	ENST00000511413.5	156	219	+	63	0	-42	9436
P42684-1#60	0	21	21	P42684-1	52	73	+	21	P42684-1	0	1182	ENST00000502732.6	280	3826	++	127	P42684-1#60	0	63	ENST00000502732.6	436	499	+	63	0	-42	9437
P42684-1#60	0	21	21	P42684-1	52	73	+	21	P42684-1	52	687	ENST00000344730.8	143	2048	++	34	P42684-1#60	0	63	ENST00000344730.8	143	206	+	63	0	-42	9438
P42684-1#61	0	15	15	P42684-1	549	564	+	15	P42684-1	52	1182	ENST00000512653.5	123	3513	++	131	P42684-1#61	0	45	ENST00000512653.5	1614	1659	+	45	0	-30	9439
P42684-1#61	0	15	15	P42684-1	549	564	+	15	P42684-1	0	687	ENST00000511413.5	0	2061	++	130	P42684-1#61	0	45	ENST00000511413.5	1647	1692	+	45	0	-30	9440
P42684-1#61	0	15	15	P42684-1	549	564	+	15	P42684-1	0	687	ENST00000507173.5	0	1998	++	129	P42684-1#61	0	45	ENST00000507173.5	1584	1629	+	45	0	-30	9441
P42684-1#61	0	15	15	P42684-1	549	564	+	15	P42684-1	73	687	ENST00000504405.5	111	1953	++	128	P42684-1#61	0	45	ENST00000504405.5	1539	1584	+	45	0	-30	9442
P42684-1#61	0	15	15	P42684-1	549	564	+	15	P42684-1	0	1182	ENST00000502732.6	280	3826	++	127	P42684-1#61	0	45	ENST00000502732.6	1927	1972	+	45	0	-30	9443
P42684-1#61	0	15	15	P42684-1	549	564	+	15	P42684-1	0	1182	ENST00000367623.8	0	3483	++	42	P42684-1#61	0	45	ENST00000367623.8	1584	1629	+	45	0	-30	9444
P42684-1#61	0	15	15	P42684-1	549	564	+	15	P42684-1	52	687	ENST00000344730.8	143	2048	++	34	P42684-1#61	0	45	ENST00000344730.8	1634	1679	+	45	0	-30	9445
P42684-1#62	0	618	618	P42684-1	564	1182	+	618	P42684-1	52	1182	ENST00000512653.5	123	3513	++	131	P42684-1#62	0	1854	ENST00000512653.5	1659	3513	+	1854	0	-1236	9446
P42684-1#62	0	618	618	P42684-1	564	1182	+	618	P42684-1	0	687	ENST00000511413.5	0	2061	++	130	P42684-1#62	0	369	ENST00000511413.5	1692	2061	+	369	0	249	9447
P42684-1#62	0	618	618	P42684-1	564	1182	+	618	P42684-1	0	687	ENST00000507173.5	0	1998	++	129	P42684-1#62	0	369	ENST00000507173.5	1629	1998	+	369	0	249	9448
P42684-1#62	0	618	618	P42684-1	564	1182	+	618	P42684-1	73	687	ENST00000504405.5	111	1953	++	128	P42684-1#62	0	369	ENST00000504405.5	1584	1953	+	369	0	249	9449
P42684-1#62	0	618	618	P42684-1	564	1182	+	618	P42684-1	0	1182	ENST00000502732.6	280	3826	++	127	P42684-1#62	0	1854	ENST00000502732.6	1972	3826	+	1854	0	-1236	9450
P42684-1#62	0	618	618	P42684-1	564	1182	+	618	P42684-1	0	1182	ENST00000367623.8	0	3483	++	42	P42684-1#62	0	1854	ENST00000367623.8	1629	3483	+	1854	0	-1236	9451
P42684-1#62	0	618	618	P42684-1	564	1182	+	618	P42684-1	52	687	ENST00000344730.8	143	2048	++	34	P42684-1#62	0	369	ENST00000344730.8	1679	2048	+	369	0	249	9452
P42684-1#63	0	103	103	P42684-1	687	790	+	103	P42684-1	52	1182	ENST00000512653.5	123	3513	++	131	P42684-1#63	0	309	ENST00000512653.5	2028	2337	+	309	0	-206	9453
P42684-1#63	0	103	103	P42684-1	687	790	+	103	P42684-1	0	1182	ENST00000502732.6	280	3826	++	127	P42684-1#63	0	309	ENST00000502732.6	2341	2650	+	309	0	-206	9454
P42684-1#63	0	103	103	P42684-1	687	790	+	103	P42684-1	0	1182	ENST00000367623.8	0	3483	++	42	P42684-1#63	0	309	ENST00000367623.8	1998	2307	+	309	0	-206	9455
P42684-1#64	0	1	1	P42684-1	77	78	+	1	P42684-1	52	1182	ENST00000512653.5	123	3513	++	131	P42684-1#64	0	3	ENST00000512653.5	198	201	+	3	0	-2	9456
P42684-1#64	0	1	1	P42684-1	77	78	+	1	P42684-1	0	687	ENST00000511413.5	0	2061	++	130	P42684-1#64	0	3	ENST00000511413.5	231	234	+	3	0	-2	9457
P42684-1#64	0	1	1	P42684-1	77	78	+	1	P42684-1	0	687	ENST00000507173.5	0	1998	++	129	P42684-1#64	0	3	ENST00000507173.5	168	171	+	3	0	-2	9458
P42684-1#64	0	1	1	P42684-1	77	78	+	1	P42684-1	73	687	ENST00000504405.5	111	1953	++	128	P42684-1#64	0	3	ENST00000504405.5	123	126	+	3	0	-2	9459
P42684-1#64	0	1	1	P42684-1	77	78	+	1	P42684-1	0	1182	ENST00000502732.6	280	3826	++	127	P42684-1#64	0	3	ENST00000502732.6	511	514	+	3	0	-2	9460
P42684-1#64	0	1	1	P42684-1	77	78	+	1	P42684-1	0	1182	ENST00000367623.8	0	3483	++	42	P42684-1#64	0	3	ENST00000367623.8	168	171	+	3	0	-2	9461
P42684-1#64	0	1	1	P42684-1	77	78	+	1	P42684-1	52	687	ENST00000344730.8	143	2048	++	34	P42684-1#64	0	3	ENST00000344730.8	218	221	+	3	0	-2	9462
P42684-1#65	0	1	1	P42684-1	98	99	+	1	P42684-1	52	1182	ENST00000512653.5	123	3513	++	131	P42684-1#65	0	3	ENST00000512653.5	261	264	+	3	0	-2	9463
P42684-1#65	0	1	1	P42684-1	98	99	+	1	P42684-1	0	687	ENST00000511413.5	0	2061	++	130	P42684-1#65	0	3	ENST00000511413.5	294	297	+	3	0	-2	9464
P42684-1#65	0	1	1	P42684-1	98	99	+	1	P42684-1	0	687	ENST00000507173.5	0	1998	++	129	P42684-1#65	0	3	ENST00000507173.5	231	234	+	3	0	-2	9465
P42684-1#65	0	1	1	P42684-1	98	99	+	1	P42684-1	73	687	ENST00000504405.5	111	1953	++	128	P42684-1#65	0	3	ENST00000504405.5	186	189	+	3	0	-2	9466
P42684-1#65	0	1	1	P42684-1	98	99	+	1	P42684-1	0	1182	ENST00000502732.6	280	3826	++	127	P42684-1#65	0	3	ENST00000502732.6	574	577	+	3	0	-2	9467
P42684-1#65	0	1	1	P42684-1	98	99	+	1	P42684-1	0	1182	ENST00000367623.8	0	3483	++	42	P42684-1#65	0	3	ENST00000367623.8	231	234	+	3	0	-2	9468
P42684-1#65	0	1	1	P42684-1	98	99	+	1	P42684-1	52	687	ENST00000344730.8	143	2048	++	34	P42684-1#65	0	3	ENST00000344730.8	281	284	+	3	0	-2	9469
P42684-1#66	0	1	1	P42684-1	518	519	+	1	P42684-1	52	1182	ENST00000512653.5	123	3513	++	131	P42684-1#66	0	3	ENST00000512653.5	1521	1524	+	3	0	-2	9470
P42684-1#66	0	1	1	P42684-1	518	519	+	1	P42684-1	0	687	ENST00000511413.5	0	2061	++	130	P42684-1#66	0	3	ENST00000511413.5	1554	1557	+	3	0	-2	9471
P42684-1#66	0	1	1	P42684-1	518	519	+	1	P42684-1	0	687	ENST00000507173.5	0	1998	++	129	P42684-1#66	0	3	ENST00000507173.5	1491	1494	+	3	0	-2	9472
P42684-1#66	0	1	1	P42684-1	518	519	+	1	P42684-1	73	687	ENST00000504405.5	111	1953	++	128	P42684-1#66	0	3	ENST00000504405.5	1446	1449	+	3	0	-2	9473
P42684-1#66	0	1	1	P42684-1	518	519	+	1	P42684-1	0	1182	ENST00000502732.6	280	3826	++	127	P42684-1#66	0	3	ENST00000502732.6	1834	1837	+	3	0	-2	9474
P42684-1#66	0	1	1	P42684-1	518	519	+	1	P42684-1	0	1182	ENST00000367623.8	0	3483	++	42	P42684-1#66	0	3	ENST00000367623.8	1491	1494	+	3	0	-2	9475
P42684-1#66	0	1	1	P42684-1	518	519	+	1	P42684-1	52	687	ENST00000344730.8	143	2048	++	34	P42684-1#66	0	3	ENST00000344730.8	1541	1544	+	3	0	-2	9476
P42684-1#67	0	1	1	P42684-1	768	769	+	1	P42684-1	52	1182	ENST00000512653.5	123	3513	++	131	P42684-1#67	0	3	ENST00000512653.5	2271	2274	+	3	0	-2	9477
P42684-1#67	0	1	1	P42684-1	768	769	+	1	P42684-1	0	1182	ENST00000502732.6	280	3826	++	127	P42684-1#67	0	3	ENST00000502732.6	2584	2587	+	3	0	-2	9478
P42684-1#67	0	1	1	P42684-1	768	769	+	1	P42684-1	0	1182	ENST00000367623.8	0	3483	++	42	P42684-1#67	0	3	ENST00000367623.8	2241	2244	+	3	0	-2	9479
P42684-1#68	0	1	1	P42684-1	929	930	+	1	P42684-1	52	1182	ENST00000512653.5	123	3513	++	131	P42684-1#68	0	3	ENST00000512653.5	2754	2757	+	3	0	-2	9480
P42684-1#68	0	1	1	P42684-1	929	930	+	1	P42684-1	0	1182	ENST00000502732.6	280	3826	++	127	P42684-1#68	0	3	ENST00000502732.6	3067	3070	+	3	0	-2	9481
P42684-1#68	0	1	1	P42684-1	929	930	+	1	P42684-1	0	1182	ENST00000367623.8	0	3483	++	42	P42684-1#68	0	3	ENST00000367623.8	2724	2727	+	3	0	-2	9482
P42684-1#69	0	1	1	P42684-1	945	946	+	1	P42684-1	52	1182	ENST00000512653.5	123	3513	++	131	P42684-1#69	0	3	ENST00000512653.5	2802	2805	+	3	0	-2	9483
P42684-1#69	0	1	1	P42684-1	945	946	+	1	P42684-1	0	1182	ENST00000502732.6	280	3826	++	127	P42684-1#69	0	3	ENST00000502732.6	3115	3118	+	3	0	-2	9484
P42684-1#69	0	1	1	P42684-1	945	946	+	1	P42684-1	0	1182	ENST00000367623.8	0	3483	++	42	P42684-1#69	0	3	ENST00000367623.8	2772	2775	+	3	0	-2	9485
P42684-1#70	0	1	1	P42684-1	995	996	+	1	P42684-1	52	1182	ENST00000512653.5	123	3513	++	131	P42684-1#70	0	3	ENST00000512653.5	2952	2955	+	3	0	-2	9486
P42684-1#70	0	1	1	P42684-1	995	996	+	1	P42684-1	0	1182	ENST00000502732.6	280	3826	++	127	P42684-1#70	0	3	ENST00000502732.6	3265	3268	+	3	0	-2	9487
P42684-1#70	0	1	1	P42684-1	995	996	+	1	P42684-1	0	1182	ENST00000367623.8	0	3483	++	42	P42684-1#70	0	3	ENST00000367623.8	2922	2925	+	3	0	-2	9488
P42684-1#71	0	1	1	P42684-1	1084	1085	+	1	P42684-1	52	1182	ENST00000512653.5	123	3513	++	131	P42684-1#71	0	3	ENST00000512653.5	3219	3222	+	3	0	-2	9489
P42684-1#71	0	1	1	P42684-1	1084	1085	+	1	P42684-1	0	1182	ENST00000502732.6	280	3826	++	127	P42684-1#71	0	3	ENST00000502732.6	3532	3535	+	3	0	-2	9490
P42684-1#71	0	1	1	P42684-1	1084	1085	+	1	P42684-1	0	1182	ENST00000367623.8	0	3483	++	42	P42684-1#71	0	3	ENST00000367623.8	3189	3192	+	3	0	-2	9491
P42684-1#72	0	1	1	P42684-1	1100	1101	+	1	P42684-1	52	1182	ENST00000512653.5	123	3513	++	131	P42684-1#72	0	3	ENST00000512653.5	3267	3270	+	3	0	-2	9492
P42684-1#72	0	1	1	P42684-1	1100	1101	+	1	P42684-1	0	1182	ENST00000502732.6	280	3826	++	127	P42684-1#72	0	3	ENST00000502732.6	3580	3583	+	3	0	-2	9493
P42684-1#72	0	1	1	P42684-1	1100	1101	+	1	P42684-1	0	1182	ENST00000367623.8	0	3483	++	42	P42684-1#72	0	3	ENST00000367623.8	3237	3240	+	3	0	-2	9494
P42684-1#73	0	2	2	P42684-1	342	344	+	2	P42684-1	52	1182	ENST00000512653.5	123	3513	++	131	P42684-1#73	0	6	ENST00000512653.5	993	999	+	6	0	-4	9495
P42684-1#73	0	2	2	P42684-1	342	344	+	2	P42684-1	0	687	ENST00000511413.5	0	2061	++	130	P42684-1#73	0	6	ENST00000511413.5	1026	1032	+	6	0	-4	9496
P42684-1#73	0	2	2	P42684-1	342	344	+	2	P42684-1	0	687	ENST00000507173.5	0	1998	++	129	P42684-1#73	0	6	ENST00000507173.5	963	969	+	6	0	-4	9497
P42684-1#73	0	2	2	P42684-1	342	344	+	2	P42684-1	73	687	ENST00000504405.5	111	1953	++	128	P42684-1#73	0	6	ENST00000504405.5	918	924	+	6	0	-4	9498
P42684-1#73	0	2	2	P42684-1	342	344	+	2	P42684-1	0	1182	ENST00000502732.6	280	3826	++	127	P42684-1#73	0	6	ENST00000502732.6	1306	1312	+	6	0	-4	9499
P42684-1#73	0	2	2	P42684-1	342	344	+	2	P42684-1	0	1182	ENST00000367623.8	0	3483	++	42	P42684-1#73	0	6	ENST00000367623.8	963	969	+	6	0	-4	9500
P42684-1#73	0	2	2	P42684-1	342	344	+	2	P42684-1	52	687	ENST00000344730.8	143	2048	++	34	P42684-1#73	0	6	ENST00000344730.8	1013	1019	+	6	0	-4	9501
P42684-1#74	0	1	1	P42684-1	434	435	+	1	P42684-1	52	1182	ENST00000512653.5	123	3513	++	131	P42684-1#74	0	3	ENST00000512653.5	1269	1272	+	3	0	-2	9502
P42684-1#74	0	1	1	P42684-1	434	435	+	1	P42684-1	0	687	ENST00000511413.5	0	2061	++	130	P42684-1#74	0	3	ENST00000511413.5	1302	1305	+	3	0	-2	9503
P42684-1#74	0	1	1	P42684-1	434	435	+	1	P42684-1	0	687	ENST00000507173.5	0	1998	++	129	P42684-1#74	0	3	ENST00000507173.5	1239	1242	+	3	0	-2	9504
P42684-1#74	0	1	1	P42684-1	434	435	+	1	P42684-1	73	687	ENST00000504405.5	111	1953	++	128	P42684-1#74	0	3	ENST00000504405.5	1194	1197	+	3	0	-2	9505
P42684-1#74	0	1	1	P42684-1	434	435	+	1	P42684-1	0	1182	ENST00000502732.6	280	3826	++	127	P42684-1#74	0	3	ENST00000502732.6	1582	1585	+	3	0	-2	9506
P42684-1#74	0	1	1	P42684-1	434	435	+	1	P42684-1	0	1182	ENST00000367623.8	0	3483	++	42	P42684-1#74	0	3	ENST00000367623.8	1239	1242	+	3	0	-2	9507
P42684-1#74	0	1	1	P42684-1	434	435	+	1	P42684-1	52	687	ENST00000344730.8	143	2048	++	34	P42684-1#74	0	3	ENST00000344730.8	1289	1292	+	3	0	-2	9508
P42684-1#75	0	1	1	P42684-1	980	981	+	1	P42684-1	52	1182	ENST00000512653.5	123	3513	++	131	P42684-1#75	0	3	ENST00000512653.5	2907	2910	+	3	0	-2	9509
P42684-1#75	0	1	1	P42684-1	980	981	+	1	P42684-1	0	1182	ENST00000502732.6	280	3826	++	127	P42684-1#75	0	3	ENST00000502732.6	3220	3223	+	3	0	-2	9510
P42684-1#75	0	1	1	P42684-1	980	981	+	1	P42684-1	0	1182	ENST00000367623.8	0	3483	++	42	P42684-1#75	0	3	ENST00000367623.8	2877	2880	+	3	0	-2	9511
P42684-1#76	0	6	6	P42684-1	110	116	+	6	P42684-1	52	1182	ENST00000512653.5	123	3513	++	131	P42684-1#76	0	18	ENST00000512653.5	297	315	+	18	0	-12	9512
P42684-1#76	0	6	6	P42684-1	110	116	+	6	P42684-1	0	687	ENST00000511413.5	0	2061	++	130	P42684-1#76	0	18	ENST00000511413.5	330	348	+	18	0	-12	9513
P42684-1#76	0	6	6	P42684-1	110	116	+	6	P42684-1	0	687	ENST00000507173.5	0	1998	++	129	P42684-1#76	0	18	ENST00000507173.5	267	285	+	18	0	-12	9514
P42684-1#76	0	6	6	P42684-1	110	116	+	6	P42684-1	73	687	ENST00000504405.5	111	1953	++	128	P42684-1#76	0	18	ENST00000504405.5	222	240	+	18	0	-12	9515
P42684-1#76	0	6	6	P42684-1	110	116	+	6	P42684-1	0	1182	ENST00000502732.6	280	3826	++	127	P42684-1#76	0	18	ENST00000502732.6	610	628	+	18	0	-12	9516
P42684-1#76	0	6	6	P42684-1	110	116	+	6	P42684-1	0	1182	ENST00000367623.8	0	3483	++	42	P42684-1#76	0	18	ENST00000367623.8	267	285	+	18	0	-12	9517
P42684-1#76	0	6	6	P42684-1	110	116	+	6	P42684-1	52	687	ENST00000344730.8	143	2048	++	34	P42684-1#76	0	18	ENST00000344730.8	317	335	+	18	0	-12	9518
P42684-1#77	0	7	7	P42684-1	132	139	+	7	P42684-1	52	1182	ENST00000512653.5	123	3513	++	131	P42684-1#77	0	21	ENST00000512653.5	363	384	+	21	0	-14	9519
P42684-1#77	0	7	7	P42684-1	132	139	+	7	P42684-1	0	687	ENST00000511413.5	0	2061	++	130	P42684-1#77	0	21	ENST00000511413.5	396	417	+	21	0	-14	9520
P42684-1#77	0	7	7	P42684-1	132	139	+	7	P42684-1	0	687	ENST00000507173.5	0	1998	++	129	P42684-1#77	0	21	ENST00000507173.5	333	354	+	21	0	-14	9521
P42684-1#77	0	7	7	P42684-1	132	139	+	7	P42684-1	73	687	ENST00000504405.5	111	1953	++	128	P42684-1#77	0	21	ENST00000504405.5	288	309	+	21	0	-14	9522
P42684-1#77	0	7	7	P42684-1	132	139	+	7	P42684-1	0	1182	ENST00000502732.6	280	3826	++	127	P42684-1#77	0	21	ENST00000502732.6	676	697	+	21	0	-14	9523
P42684-1#77	0	7	7	P42684-1	132	139	+	7	P42684-1	0	1182	ENST00000367623.8	0	3483	++	42	P42684-1#77	0	21	ENST00000367623.8	333	354	+	21	0	-14	9524
P42684-1#77	0	7	7	P42684-1	132	139	+	7	P42684-1	52	687	ENST00000344730.8	143	2048	++	34	P42684-1#77	0	21	ENST00000344730.8	383	404	+	21	0	-14	9525
P42684-1#78	0	10	10	P42684-1	140	150	+	10	P42684-1	52	1182	ENST00000512653.5	123	3513	++	131	P42684-1#78	0	30	ENST00000512653.5	387	417	+	30	0	-20	9526
P42684-1#78	0	10	10	P42684-1	140	150	+	10	P42684-1	0	687	ENST00000511413.5	0	2061	++	130	P42684-1#78	0	30	ENST00000511413.5	420	450	+	30	0	-20	9527
P42684-1#78	0	10	10	P42684-1	140	150	+	10	P42684-1	0	687	ENST00000507173.5	0	1998	++	129	P42684-1#78	0	30	ENST00000507173.5	357	387	+	30	0	-20	9528
P42684-1#78	0	10	10	P42684-1	140	150	+	10	P42684-1	73	687	ENST00000504405.5	111	1953	++	128	P42684-1#78	0	30	ENST00000504405.5	312	342	+	30	0	-20	9529
P42684-1#78	0	10	10	P42684-1	140	150	+	10	P42684-1	0	1182	ENST00000502732.6	280	3826	++	127	P42684-1#78	0	30	ENST00000502732.6	700	730	+	30	0	-20	9530
P42684-1#78	0	10	10	P42684-1	140	150	+	10	P42684-1	0	1182	ENST00000367623.8	0	3483	++	42	P42684-1#78	0	30	ENST00000367623.8	357	387	+	30	0	-20	9531
P42684-1#78	0	10	10	P42684-1	140	150	+	10	P42684-1	52	687	ENST00000344730.8	143	2048	++	34	P42684-1#78	0	30	ENST00000344730.8	407	437	+	30	0	-20	9532
P42684-1#79	0	6	6	P42684-1	152	158	+	6	P42684-1	52	1182	ENST00000512653.5	123	3513	++	131	P42684-1#79	0	18	ENST00000512653.5	423	441	+	18	0	-12	9533
P42684-1#79	0	6	6	P42684-1	152	158	+	6	P42684-1	0	687	ENST00000511413.5	0	2061	++	130	P42684-1#79	0	18	ENST00000511413.5	456	474	+	18	0	-12	9534
P42684-1#79	0	6	6	P42684-1	152	158	+	6	P42684-1	0	687	ENST00000507173.5	0	1998	++	129	P42684-1#79	0	18	ENST00000507173.5	393	411	+	18	0	-12	9535
P42684-1#79	0	6	6	P42684-1	152	158	+	6	P42684-1	73	687	ENST00000504405.5	111	1953	++	128	P42684-1#79	0	18	ENST00000504405.5	348	366	+	18	0	-12	9536
P42684-1#79	0	6	6	P42684-1	152	158	+	6	P42684-1	0	1182	ENST00000502732.6	280	3826	++	127	P42684-1#79	0	18	ENST00000502732.6	736	754	+	18	0	-12	9537
P42684-1#79	0	6	6	P42684-1	152	158	+	6	P42684-1	0	1182	ENST00000367623.8	0	3483	++	42	P42684-1#79	0	18	ENST00000367623.8	393	411	+	18	0	-12	9538
P42684-1#79	0	6	6	P42684-1	152	158	+	6	P42684-1	52	687	ENST00000344730.8	143	2048	++	34	P42684-1#79	0	18	ENST00000344730.8	443	461	+	18	0	-12	9539
P42684-1#80	0	3	3	P42684-1	158	161	+	3	P42684-1	52	1182	ENST00000512653.5	123	3513	++	131	P42684-1#80	0	9	ENST00000512653.5	441	450	+	9	0	-6	9540
P42684-1#80	0	3	3	P42684-1	158	161	+	3	P42684-1	0	687	ENST00000511413.5	0	2061	++	130	P42684-1#80	0	9	ENST00000511413.5	474	483	+	9	0	-6	9541
P42684-1#80	0	3	3	P42684-1	158	161	+	3	P42684-1	0	687	ENST00000507173.5	0	1998	++	129	P42684-1#80	0	9	ENST00000507173.5	411	420	+	9	0	-6	9542
P42684-1#80	0	3	3	P42684-1	158	161	+	3	P42684-1	73	687	ENST00000504405.5	111	1953	++	128	P42684-1#80	0	9	ENST00000504405.5	366	375	+	9	0	-6	9543
P42684-1#80	0	3	3	P42684-1	158	161	+	3	P42684-1	0	1182	ENST00000502732.6	280	3826	++	127	P42684-1#80	0	9	ENST00000502732.6	754	763	+	9	0	-6	9544
P42684-1#80	0	3	3	P42684-1	158	161	+	3	P42684-1	0	1182	ENST00000367623.8	0	3483	++	42	P42684-1#80	0	9	ENST00000367623.8	411	420	+	9	0	-6	9545
P42684-1#80	0	3	3	P42684-1	158	161	+	3	P42684-1	52	687	ENST00000344730.8	143	2048	++	34	P42684-1#80	0	9	ENST00000344730.8	461	470	+	9	0	-6	9546
P42684-1#81	0	3	3	P42684-1	161	164	+	3	P42684-1	52	1182	ENST00000512653.5	123	3513	++	131	P42684-1#81	0	9	ENST00000512653.5	450	459	+	9	0	-6	9547
P42684-1#81	0	3	3	P42684-1	161	164	+	3	P42684-1	0	687	ENST00000511413.5	0	2061	++	130	P42684-1#81	0	9	ENST00000511413.5	483	492	+	9	0	-6	9548
P42684-1#81	0	3	3	P42684-1	161	164	+	3	P42684-1	0	687	ENST00000507173.5	0	1998	++	129	P42684-1#81	0	9	ENST00000507173.5	420	429	+	9	0	-6	9549
P42684-1#81	0	3	3	P42684-1	161	164	+	3	P42684-1	73	687	ENST00000504405.5	111	1953	++	128	P42684-1#81	0	9	ENST00000504405.5	375	384	+	9	0	-6	9550
P42684-1#81	0	3	3	P42684-1	161	164	+	3	P42684-1	0	1182	ENST00000502732.6	280	3826	++	127	P42684-1#81	0	9	ENST00000502732.6	763	772	+	9	0	-6	9551
P42684-1#81	0	3	3	P42684-1	161	164	+	3	P42684-1	0	1182	ENST00000367623.8	0	3483	++	42	P42684-1#81	0	9	ENST00000367623.8	420	429	+	9	0	-6	9552
P42684-1#81	0	3	3	P42684-1	161	164	+	3	P42684-1	52	687	ENST00000344730.8	143	2048	++	34	P42684-1#81	0	9	ENST00000344730.8	470	479	+	9	0	-6	9553
P42684-1#82	0	3	3	P42684-1	167	170	+	3	P42684-1	52	1182	ENST00000512653.5	123	3513	++	131	P42684-1#82	0	9	ENST00000512653.5	468	477	+	9	0	-6	9554
P42684-1#82	0	3	3	P42684-1	167	170	+	3	P42684-1	0	687	ENST00000511413.5	0	2061	++	130	P42684-1#82	0	9	ENST00000511413.5	501	510	+	9	0	-6	9555
P42684-1#82	0	3	3	P42684-1	167	170	+	3	P42684-1	0	687	ENST00000507173.5	0	1998	++	129	P42684-1#82	0	9	ENST00000507173.5	438	447	+	9	0	-6	9556
P42684-1#82	0	3	3	P42684-1	167	170	+	3	P42684-1	73	687	ENST00000504405.5	111	1953	++	128	P42684-1#82	0	9	ENST00000504405.5	393	402	+	9	0	-6	9557
P42684-1#82	0	3	3	P42684-1	167	170	+	3	P42684-1	0	1182	ENST00000502732.6	280	3826	++	127	P42684-1#82	0	9	ENST00000502732.6	781	790	+	9	0	-6	9558
P42684-1#82	0	3	3	P42684-1	167	170	+	3	P42684-1	0	1182	ENST00000367623.8	0	3483	++	42	P42684-1#82	0	9	ENST00000367623.8	438	447	+	9	0	-6	9559
P42684-1#82	0	3	3	P42684-1	167	170	+	3	P42684-1	52	687	ENST00000344730.8	143	2048	++	34	P42684-1#82	0	9	ENST00000344730.8	488	497	+	9	0	-6	9560
P42684-1#83	0	4	4	P42684-1	173	177	+	4	P42684-1	52	1182	ENST00000512653.5	123	3513	++	131	P42684-1#83	0	12	ENST00000512653.5	486	498	+	12	0	-8	9561
P42684-1#83	0	4	4	P42684-1	173	177	+	4	P42684-1	0	687	ENST00000511413.5	0	2061	++	130	P42684-1#83	0	12	ENST00000511413.5	519	531	+	12	0	-8	9562
P42684-1#83	0	4	4	P42684-1	173	177	+	4	P42684-1	0	687	ENST00000507173.5	0	1998	++	129	P42684-1#83	0	12	ENST00000507173.5	456	468	+	12	0	-8	9563
P42684-1#83	0	4	4	P42684-1	173	177	+	4	P42684-1	73	687	ENST00000504405.5	111	1953	++	128	P42684-1#83	0	12	ENST00000504405.5	411	423	+	12	0	-8	9564
P42684-1#83	0	4	4	P42684-1	173	177	+	4	P42684-1	0	1182	ENST00000502732.6	280	3826	++	127	P42684-1#83	0	12	ENST00000502732.6	799	811	+	12	0	-8	9565
P42684-1#83	0	4	4	P42684-1	173	177	+	4	P42684-1	0	1182	ENST00000367623.8	0	3483	++	42	P42684-1#83	0	12	ENST00000367623.8	456	468	+	12	0	-8	9566
P42684-1#83	0	4	4	P42684-1	173	177	+	4	P42684-1	52	687	ENST00000344730.8	143	2048	++	34	P42684-1#83	0	12	ENST00000344730.8	506	518	+	12	0	-8	9567
P42684-1#84	0	8	8	P42684-1	179	187	+	8	P42684-1	52	1182	ENST00000512653.5	123	3513	++	131	P42684-1#84	0	24	ENST00000512653.5	504	528	+	24	0	-16	9568
P42684-1#84	0	8	8	P42684-1	179	187	+	8	P42684-1	0	687	ENST00000511413.5	0	2061	++	130	P42684-1#84	0	24	ENST00000511413.5	537	561	+	24	0	-16	9569
P42684-1#84	0	8	8	P42684-1	179	187	+	8	P42684-1	0	687	ENST00000507173.5	0	1998	++	129	P42684-1#84	0	24	ENST00000507173.5	474	498	+	24	0	-16	9570
P42684-1#84	0	8	8	P42684-1	179	187	+	8	P42684-1	73	687	ENST00000504405.5	111	1953	++	128	P42684-1#84	0	24	ENST00000504405.5	429	453	+	24	0	-16	9571
P42684-1#84	0	8	8	P42684-1	179	187	+	8	P42684-1	0	1182	ENST00000502732.6	280	3826	++	127	P42684-1#84	0	24	ENST00000502732.6	817	841	+	24	0	-16	9572
P42684-1#84	0	8	8	P42684-1	179	187	+	8	P42684-1	0	1182	ENST00000367623.8	0	3483	++	42	P42684-1#84	0	24	ENST00000367623.8	474	498	+	24	0	-16	9573
P42684-1#84	0	8	8	P42684-1	179	187	+	8	P42684-1	52	687	ENST00000344730.8	143	2048	++	34	P42684-1#84	0	24	ENST00000344730.8	524	548	+	24	0	-16	9574
P42684-1#85	0	6	6	P42684-1	193	199	+	6	P42684-1	52	1182	ENST00000512653.5	123	3513	++	131	P42684-1#85	0	18	ENST00000512653.5	546	564	+	18	0	-12	9575
P42684-1#85	0	6	6	P42684-1	193	199	+	6	P42684-1	0	687	ENST00000511413.5	0	2061	++	130	P42684-1#85	0	18	ENST00000511413.5	579	597	+	18	0	-12	9576
P42684-1#85	0	6	6	P42684-1	193	199	+	6	P42684-1	0	687	ENST00000507173.5	0	1998	++	129	P42684-1#85	0	18	ENST00000507173.5	516	534	+	18	0	-12	9577
P42684-1#85	0	6	6	P42684-1	193	199	+	6	P42684-1	73	687	ENST00000504405.5	111	1953	++	128	P42684-1#85	0	18	ENST00000504405.5	471	489	+	18	0	-12	9578
P42684-1#85	0	6	6	P42684-1	193	199	+	6	P42684-1	0	1182	ENST00000502732.6	280	3826	++	127	P42684-1#85	0	18	ENST00000502732.6	859	877	+	18	0	-12	9579
P42684-1#85	0	6	6	P42684-1	193	199	+	6	P42684-1	0	1182	ENST00000367623.8	0	3483	++	42	P42684-1#85	0	18	ENST00000367623.8	516	534	+	18	0	-12	9580
P42684-1#85	0	6	6	P42684-1	193	199	+	6	P42684-1	52	687	ENST00000344730.8	143	2048	++	34	P42684-1#85	0	18	ENST00000344730.8	566	584	+	18	0	-12	9581
P42684-1#86	0	7	7	P42684-1	206	213	+	7	P42684-1	52	1182	ENST00000512653.5	123	3513	++	131	P42684-1#86	0	21	ENST00000512653.5	585	606	+	21	0	-14	9582
P42684-1#86	0	7	7	P42684-1	206	213	+	7	P42684-1	0	687	ENST00000511413.5	0	2061	++	130	P42684-1#86	0	21	ENST00000511413.5	618	639	+	21	0	-14	9583
P42684-1#86	0	7	7	P42684-1	206	213	+	7	P42684-1	0	687	ENST00000507173.5	0	1998	++	129	P42684-1#86	0	21	ENST00000507173.5	555	576	+	21	0	-14	9584
P42684-1#86	0	7	7	P42684-1	206	213	+	7	P42684-1	73	687	ENST00000504405.5	111	1953	++	128	P42684-1#86	0	21	ENST00000504405.5	510	531	+	21	0	-14	9585
P42684-1#86	0	7	7	P42684-1	206	213	+	7	P42684-1	0	1182	ENST00000502732.6	280	3826	++	127	P42684-1#86	0	21	ENST00000502732.6	898	919	+	21	0	-14	9586
P42684-1#86	0	7	7	P42684-1	206	213	+	7	P42684-1	0	1182	ENST00000367623.8	0	3483	++	42	P42684-1#86	0	21	ENST00000367623.8	555	576	+	21	0	-14	9587
P42684-1#86	0	7	7	P42684-1	206	213	+	7	P42684-1	52	687	ENST00000344730.8	143	2048	++	34	P42684-1#86	0	21	ENST00000344730.8	605	626	+	21	0	-14	9588
P42684-1#87	0	6	6	P42684-1	215	221	+	6	P42684-1	52	1182	ENST00000512653.5	123	3513	++	131	P42684-1#87	0	18	ENST00000512653.5	612	630	+	18	0	-12	9589
P42684-1#87	0	6	6	P42684-1	215	221	+	6	P42684-1	0	687	ENST00000511413.5	0	2061	++	130	P42684-1#87	0	18	ENST00000511413.5	645	663	+	18	0	-12	9590
P42684-1#87	0	6	6	P42684-1	215	221	+	6	P42684-1	0	687	ENST00000507173.5	0	1998	++	129	P42684-1#87	0	18	ENST00000507173.5	582	600	+	18	0	-12	9591
P42684-1#87	0	6	6	P42684-1	215	221	+	6	P42684-1	73	687	ENST00000504405.5	111	1953	++	128	P42684-1#87	0	18	ENST00000504405.5	537	555	+	18	0	-12	9592
P42684-1#87	0	6	6	P42684-1	215	221	+	6	P42684-1	0	1182	ENST00000502732.6	280	3826	++	127	P42684-1#87	0	18	ENST00000502732.6	925	943	+	18	0	-12	9593
P42684-1#87	0	6	6	P42684-1	215	221	+	6	P42684-1	0	1182	ENST00000367623.8	0	3483	++	42	P42684-1#87	0	18	ENST00000367623.8	582	600	+	18	0	-12	9594
P42684-1#87	0	6	6	P42684-1	215	221	+	6	P42684-1	52	687	ENST00000344730.8	143	2048	++	34	P42684-1#87	0	18	ENST00000344730.8	632	650	+	18	0	-12	9595
P42684-1#88	0	3	3	P42684-1	225	228	+	3	P42684-1	52	1182	ENST00000512653.5	123	3513	++	131	P42684-1#88	0	9	ENST00000512653.5	642	651	+	9	0	-6	9596
P42684-1#88	0	3	3	P42684-1	225	228	+	3	P42684-1	0	687	ENST00000511413.5	0	2061	++	130	P42684-1#88	0	9	ENST00000511413.5	675	684	+	9	0	-6	9597
P42684-1#88	0	3	3	P42684-1	225	228	+	3	P42684-1	0	687	ENST00000507173.5	0	1998	++	129	P42684-1#88	0	9	ENST00000507173.5	612	621	+	9	0	-6	9598
P42684-1#88	0	3	3	P42684-1	225	228	+	3	P42684-1	73	687	ENST00000504405.5	111	1953	++	128	P42684-1#88	0	9	ENST00000504405.5	567	576	+	9	0	-6	9599
P42684-1#88	0	3	3	P42684-1	225	228	+	3	P42684-1	0	1182	ENST00000502732.6	280	3826	++	127	P42684-1#88	0	9	ENST00000502732.6	955	964	+	9	0	-6	9600
P42684-1#88	0	3	3	P42684-1	225	228	+	3	P42684-1	0	1182	ENST00000367623.8	0	3483	++	42	P42684-1#88	0	9	ENST00000367623.8	612	621	+	9	0	-6	9601
P42684-1#88	0	3	3	P42684-1	225	228	+	3	P42684-1	52	687	ENST00000344730.8	143	2048	++	34	P42684-1#88	0	9	ENST00000344730.8	662	671	+	9	0	-6	9602
P42684-1#89	0	4	4	P42684-1	229	233	+	4	P42684-1	52	1182	ENST00000512653.5	123	3513	++	131	P42684-1#89	0	12	ENST00000512653.5	654	666	+	12	0	-8	9603
P42684-1#89	0	4	4	P42684-1	229	233	+	4	P42684-1	0	687	ENST00000511413.5	0	2061	++	130	P42684-1#89	0	12	ENST00000511413.5	687	699	+	12	0	-8	9604
P42684-1#89	0	4	4	P42684-1	229	233	+	4	P42684-1	0	687	ENST00000507173.5	0	1998	++	129	P42684-1#89	0	12	ENST00000507173.5	624	636	+	12	0	-8	9605
P42684-1#89	0	4	4	P42684-1	229	233	+	4	P42684-1	73	687	ENST00000504405.5	111	1953	++	128	P42684-1#89	0	12	ENST00000504405.5	579	591	+	12	0	-8	9606
P42684-1#89	0	4	4	P42684-1	229	233	+	4	P42684-1	0	1182	ENST00000502732.6	280	3826	++	127	P42684-1#89	0	12	ENST00000502732.6	967	979	+	12	0	-8	9607
P42684-1#89	0	4	4	P42684-1	229	233	+	4	P42684-1	0	1182	ENST00000367623.8	0	3483	++	42	P42684-1#89	0	12	ENST00000367623.8	624	636	+	12	0	-8	9608
P42684-1#89	0	4	4	P42684-1	229	233	+	4	P42684-1	52	687	ENST00000344730.8	143	2048	++	34	P42684-1#89	0	12	ENST00000344730.8	674	686	+	12	0	-8	9609
P42684-1#90	0	5	5	P42684-1	235	240	+	5	P42684-1	52	1182	ENST00000512653.5	123	3513	++	131	P42684-1#90	0	15	ENST00000512653.5	672	687	+	15	0	-10	9610
P42684-1#90	0	5	5	P42684-1	235	240	+	5	P42684-1	0	687	ENST00000511413.5	0	2061	++	130	P42684-1#90	0	15	ENST00000511413.5	705	720	+	15	0	-10	9611
P42684-1#90	0	5	5	P42684-1	235	240	+	5	P42684-1	0	687	ENST00000507173.5	0	1998	++	129	P42684-1#90	0	15	ENST00000507173.5	642	657	+	15	0	-10	9612
P42684-1#90	0	5	5	P42684-1	235	240	+	5	P42684-1	73	687	ENST00000504405.5	111	1953	++	128	P42684-1#90	0	15	ENST00000504405.5	597	612	+	15	0	-10	9613
P42684-1#90	0	5	5	P42684-1	235	240	+	5	P42684-1	0	1182	ENST00000502732.6	280	3826	++	127	P42684-1#90	0	15	ENST00000502732.6	985	1000	+	15	0	-10	9614
P42684-1#90	0	5	5	P42684-1	235	240	+	5	P42684-1	0	1182	ENST00000367623.8	0	3483	++	42	P42684-1#90	0	15	ENST00000367623.8	642	657	+	15	0	-10	9615
P42684-1#90	0	5	5	P42684-1	235	240	+	5	P42684-1	52	687	ENST00000344730.8	143	2048	++	34	P42684-1#90	0	15	ENST00000344730.8	692	707	+	15	0	-10	9616
P42684-1#91	0	8	8	P42684-1	240	248	+	8	P42684-1	52	1182	ENST00000512653.5	123	3513	++	131	P42684-1#91	0	24	ENST00000512653.5	687	711	+	24	0	-16	9617
P42684-1#91	0	8	8	P42684-1	240	248	+	8	P42684-1	0	687	ENST00000511413.5	0	2061	++	130	P42684-1#91	0	24	ENST00000511413.5	720	744	+	24	0	-16	9618
P42684-1#91	0	8	8	P42684-1	240	248	+	8	P42684-1	0	687	ENST00000507173.5	0	1998	++	129	P42684-1#91	0	24	ENST00000507173.5	657	681	+	24	0	-16	9619
P42684-1#91	0	8	8	P42684-1	240	248	+	8	P42684-1	73	687	ENST00000504405.5	111	1953	++	128	P42684-1#91	0	24	ENST00000504405.5	612	636	+	24	0	-16	9620
P42684-1#91	0	8	8	P42684-1	240	248	+	8	P42684-1	0	1182	ENST00000502732.6	280	3826	++	127	P42684-1#91	0	24	ENST00000502732.6	1000	1024	+	24	0	-16	9621
P42684-1#91	0	8	8	P42684-1	240	248	+	8	P42684-1	0	1182	ENST00000367623.8	0	3483	++	42	P42684-1#91	0	24	ENST00000367623.8	657	681	+	24	0	-16	9622
P42684-1#91	0	8	8	P42684-1	240	248	+	8	P42684-1	52	687	ENST00000344730.8	143	2048	++	34	P42684-1#91	0	24	ENST00000344730.8	707	731	+	24	0	-16	9623
P42684-1#92	0	3	3	P42684-1	254	257	+	3	P42684-1	52	1182	ENST00000512653.5	123	3513	++	131	P42684-1#92	0	9	ENST00000512653.5	729	738	+	9	0	-6	9624
P42684-1#92	0	3	3	P42684-1	254	257	+	3	P42684-1	0	687	ENST00000511413.5	0	2061	++	130	P42684-1#92	0	9	ENST00000511413.5	762	771	+	9	0	-6	9625
P42684-1#92	0	3	3	P42684-1	254	257	+	3	P42684-1	0	687	ENST00000507173.5	0	1998	++	129	P42684-1#92	0	9	ENST00000507173.5	699	708	+	9	0	-6	9626
P42684-1#92	0	3	3	P42684-1	254	257	+	3	P42684-1	73	687	ENST00000504405.5	111	1953	++	128	P42684-1#92	0	9	ENST00000504405.5	654	663	+	9	0	-6	9627
P42684-1#92	0	3	3	P42684-1	254	257	+	3	P42684-1	0	1182	ENST00000502732.6	280	3826	++	127	P42684-1#92	0	9	ENST00000502732.6	1042	1051	+	9	0	-6	9628
P42684-1#92	0	3	3	P42684-1	254	257	+	3	P42684-1	0	1182	ENST00000367623.8	0	3483	++	42	P42684-1#92	0	9	ENST00000367623.8	699	708	+	9	0	-6	9629
P42684-1#92	0	3	3	P42684-1	254	257	+	3	P42684-1	52	687	ENST00000344730.8	143	2048	++	34	P42684-1#92	0	9	ENST00000344730.8	749	758	+	9	0	-6	9630
P42684-1#93	0	3	3	P42684-1	279	282	+	3	P42684-1	52	1182	ENST00000512653.5	123	3513	++	131	P42684-1#93	0	9	ENST00000512653.5	804	813	+	9	0	-6	9631
P42684-1#93	0	3	3	P42684-1	279	282	+	3	P42684-1	0	687	ENST00000511413.5	0	2061	++	130	P42684-1#93	0	9	ENST00000511413.5	837	846	+	9	0	-6	9632
P42684-1#93	0	3	3	P42684-1	279	282	+	3	P42684-1	0	687	ENST00000507173.5	0	1998	++	129	P42684-1#93	0	9	ENST00000507173.5	774	783	+	9	0	-6	9633
P42684-1#93	0	3	3	P42684-1	279	282	+	3	P42684-1	73	687	ENST00000504405.5	111	1953	++	128	P42684-1#93	0	9	ENST00000504405.5	729	738	+	9	0	-6	9634
P42684-1#93	0	3	3	P42684-1	279	282	+	3	P42684-1	0	1182	ENST00000502732.6	280	3826	++	127	P42684-1#93	0	9	ENST00000502732.6	1117	1126	+	9	0	-6	9635
P42684-1#93	0	3	3	P42684-1	279	282	+	3	P42684-1	0	1182	ENST00000367623.8	0	3483	++	42	P42684-1#93	0	9	ENST00000367623.8	774	783	+	9	0	-6	9636
P42684-1#93	0	3	3	P42684-1	279	282	+	3	P42684-1	52	687	ENST00000344730.8	143	2048	++	34	P42684-1#93	0	9	ENST00000344730.8	824	833	+	9	0	-6	9637
P42684-1#94	0	3	3	P42684-1	284	287	+	3	P42684-1	52	1182	ENST00000512653.5	123	3513	++	131	P42684-1#94	0	9	ENST00000512653.5	819	828	+	9	0	-6	9638
P42684-1#94	0	3	3	P42684-1	284	287	+	3	P42684-1	0	687	ENST00000511413.5	0	2061	++	130	P42684-1#94	0	9	ENST00000511413.5	852	861	+	9	0	-6	9639
P42684-1#94	0	3	3	P42684-1	284	287	+	3	P42684-1	0	687	ENST00000507173.5	0	1998	++	129	P42684-1#94	0	9	ENST00000507173.5	789	798	+	9	0	-6	9640
P42684-1#94	0	3	3	P42684-1	284	287	+	3	P42684-1	73	687	ENST00000504405.5	111	1953	++	128	P42684-1#94	0	9	ENST00000504405.5	744	753	+	9	0	-6	9641
P42684-1#94	0	3	3	P42684-1	284	287	+	3	P42684-1	0	1182	ENST00000502732.6	280	3826	++	127	P42684-1#94	0	9	ENST00000502732.6	1132	1141	+	9	0	-6	9642
P42684-1#94	0	3	3	P42684-1	284	287	+	3	P42684-1	0	1182	ENST00000367623.8	0	3483	++	42	P42684-1#94	0	9	ENST00000367623.8	789	798	+	9	0	-6	9643
P42684-1#94	0	3	3	P42684-1	284	287	+	3	P42684-1	52	687	ENST00000344730.8	143	2048	++	34	P42684-1#94	0	9	ENST00000344730.8	839	848	+	9	0	-6	9644
P42684-1#95	0	6	6	P42684-1	287	293	+	6	P42684-1	52	1182	ENST00000512653.5	123	3513	++	131	P42684-1#95	0	18	ENST00000512653.5	828	846	+	18	0	-12	9645
P42684-1#95	0	6	6	P42684-1	287	293	+	6	P42684-1	0	687	ENST00000511413.5	0	2061	++	130	P42684-1#95	0	18	ENST00000511413.5	861	879	+	18	0	-12	9646
P42684-1#95	0	6	6	P42684-1	287	293	+	6	P42684-1	0	687	ENST00000507173.5	0	1998	++	129	P42684-1#95	0	18	ENST00000507173.5	798	816	+	18	0	-12	9647
P42684-1#95	0	6	6	P42684-1	287	293	+	6	P42684-1	73	687	ENST00000504405.5	111	1953	++	128	P42684-1#95	0	18	ENST00000504405.5	753	771	+	18	0	-12	9648
P42684-1#95	0	6	6	P42684-1	287	293	+	6	P42684-1	0	1182	ENST00000502732.6	280	3826	++	127	P42684-1#95	0	18	ENST00000502732.6	1141	1159	+	18	0	-12	9649
P42684-1#95	0	6	6	P42684-1	287	293	+	6	P42684-1	0	1182	ENST00000367623.8	0	3483	++	42	P42684-1#95	0	18	ENST00000367623.8	798	816	+	18	0	-12	9650
P42684-1#95	0	6	6	P42684-1	287	293	+	6	P42684-1	52	687	ENST00000344730.8	143	2048	++	34	P42684-1#95	0	18	ENST00000344730.8	848	866	+	18	0	-12	9651
P42684-1#96	0	4	4	P42684-1	293	297	+	4	P42684-1	52	1182	ENST00000512653.5	123	3513	++	131	P42684-1#96	0	12	ENST00000512653.5	846	858	+	12	0	-8	9652
P42684-1#96	0	4	4	P42684-1	293	297	+	4	P42684-1	0	687	ENST00000511413.5	0	2061	++	130	P42684-1#96	0	12	ENST00000511413.5	879	891	+	12	0	-8	9653
P42684-1#96	0	4	4	P42684-1	293	297	+	4	P42684-1	0	687	ENST00000507173.5	0	1998	++	129	P42684-1#96	0	12	ENST00000507173.5	816	828	+	12	0	-8	9654
P42684-1#96	0	4	4	P42684-1	293	297	+	4	P42684-1	73	687	ENST00000504405.5	111	1953	++	128	P42684-1#96	0	12	ENST00000504405.5	771	783	+	12	0	-8	9655
P42684-1#96	0	4	4	P42684-1	293	297	+	4	P42684-1	0	1182	ENST00000502732.6	280	3826	++	127	P42684-1#96	0	12	ENST00000502732.6	1159	1171	+	12	0	-8	9656
P42684-1#96	0	4	4	P42684-1	293	297	+	4	P42684-1	0	1182	ENST00000367623.8	0	3483	++	42	P42684-1#96	0	12	ENST00000367623.8	816	828	+	12	0	-8	9657
P42684-1#96	0	4	4	P42684-1	293	297	+	4	P42684-1	52	687	ENST00000344730.8	143	2048	++	34	P42684-1#96	0	12	ENST00000344730.8	866	878	+	12	0	-8	9658
P42684-1#97	0	8	8	P42684-1	299	307	+	8	P42684-1	52	1182	ENST00000512653.5	123	3513	++	131	P42684-1#97	0	24	ENST00000512653.5	864	888	+	24	0	-16	9659
P42684-1#97	0	8	8	P42684-1	299	307	+	8	P42684-1	0	687	ENST00000511413.5	0	2061	++	130	P42684-1#97	0	24	ENST00000511413.5	897	921	+	24	0	-16	9660
P42684-1#97	0	8	8	P42684-1	299	307	+	8	P42684-1	0	687	ENST00000507173.5	0	1998	++	129	P42684-1#97	0	24	ENST00000507173.5	834	858	+	24	0	-16	9661
P42684-1#97	0	8	8	P42684-1	299	307	+	8	P42684-1	73	687	ENST00000504405.5	111	1953	++	128	P42684-1#97	0	24	ENST00000504405.5	789	813	+	24	0	-16	9662
P42684-1#97	0	8	8	P42684-1	299	307	+	8	P42684-1	0	1182	ENST00000502732.6	280	3826	++	127	P42684-1#97	0	24	ENST00000502732.6	1177	1201	+	24	0	-16	9663
P42684-1#97	0	8	8	P42684-1	299	307	+	8	P42684-1	0	1182	ENST00000367623.8	0	3483	++	42	P42684-1#97	0	24	ENST00000367623.8	834	858	+	24	0	-16	9664
P42684-1#97	0	8	8	P42684-1	299	307	+	8	P42684-1	52	687	ENST00000344730.8	143	2048	++	34	P42684-1#97	0	24	ENST00000344730.8	884	908	+	24	0	-16	9665
P42684-1#98	0	3	3	P42684-1	307	310	+	3	P42684-1	52	1182	ENST00000512653.5	123	3513	++	131	P42684-1#98	0	9	ENST00000512653.5	888	897	+	9	0	-6	9666
P42684-1#98	0	3	3	P42684-1	307	310	+	3	P42684-1	0	687	ENST00000511413.5	0	2061	++	130	P42684-1#98	0	9	ENST00000511413.5	921	930	+	9	0	-6	9667
P42684-1#98	0	3	3	P42684-1	307	310	+	3	P42684-1	0	687	ENST00000507173.5	0	1998	++	129	P42684-1#98	0	9	ENST00000507173.5	858	867	+	9	0	-6	9668
P42684-1#98	0	3	3	P42684-1	307	310	+	3	P42684-1	73	687	ENST00000504405.5	111	1953	++	128	P42684-1#98	0	9	ENST00000504405.5	813	822	+	9	0	-6	9669
P42684-1#98	0	3	3	P42684-1	307	310	+	3	P42684-1	0	1182	ENST00000502732.6	280	3826	++	127	P42684-1#98	0	9	ENST00000502732.6	1201	1210	+	9	0	-6	9670
P42684-1#98	0	3	3	P42684-1	307	310	+	3	P42684-1	0	1182	ENST00000367623.8	0	3483	++	42	P42684-1#98	0	9	ENST00000367623.8	858	867	+	9	0	-6	9671
P42684-1#98	0	3	3	P42684-1	307	310	+	3	P42684-1	52	687	ENST00000344730.8	143	2048	++	34	P42684-1#98	0	9	ENST00000344730.8	908	917	+	9	0	-6	9672
P42684-1#99	0	7	7	P42684-1	311	318	+	7	P42684-1	52	1182	ENST00000512653.5	123	3513	++	131	P42684-1#99	0	21	ENST00000512653.5	900	921	+	21	0	-14	9673
P42684-1#99	0	7	7	P42684-1	311	318	+	7	P42684-1	0	687	ENST00000511413.5	0	2061	++	130	P42684-1#99	0	21	ENST00000511413.5	933	954	+	21	0	-14	9674
P42684-1#99	0	7	7	P42684-1	311	318	+	7	P42684-1	0	687	ENST00000507173.5	0	1998	++	129	P42684-1#99	0	21	ENST00000507173.5	870	891	+	21	0	-14	9675
P42684-1#99	0	7	7	P42684-1	311	318	+	7	P42684-1	73	687	ENST00000504405.5	111	1953	++	128	P42684-1#99	0	21	ENST00000504405.5	825	846	+	21	0	-14	9676
P42684-1#99	0	7	7	P42684-1	311	318	+	7	P42684-1	0	1182	ENST00000502732.6	280	3826	++	127	P42684-1#99	0	21	ENST00000502732.6	1213	1234	+	21	0	-14	9677
P42684-1#99	0	7	7	P42684-1	311	318	+	7	P42684-1	0	1182	ENST00000367623.8	0	3483	++	42	P42684-1#99	0	21	ENST00000367623.8	870	891	+	21	0	-14	9678
P42684-1#99	0	7	7	P42684-1	311	318	+	7	P42684-1	52	687	ENST00000344730.8	143	2048	++	34	P42684-1#99	0	21	ENST00000344730.8	920	941	+	21	0	-14	9679
P42684-1#100	0	12	12	P42684-1	325	337	+	12	P42684-1	52	1182	ENST00000512653.5	123	3513	++	131	P42684-1#100	0	36	ENST00000512653.5	942	978	+	36	0	-24	9680
P42684-1#100	0	12	12	P42684-1	325	337	+	12	P42684-1	0	687	ENST00000511413.5	0	2061	++	130	P42684-1#100	0	36	ENST00000511413.5	975	1011	+	36	0	-24	9681
P42684-1#100	0	12	12	P42684-1	325	337	+	12	P42684-1	0	687	ENST00000507173.5	0	1998	++	129	P42684-1#100	0	36	ENST00000507173.5	912	948	+	36	0	-24	9682
P42684-1#100	0	12	12	P42684-1	325	337	+	12	P42684-1	73	687	ENST00000504405.5	111	1953	++	128	P42684-1#100	0	36	ENST00000504405.5	867	903	+	36	0	-24	9683
P42684-1#100	0	12	12	P42684-1	325	337	+	12	P42684-1	0	1182	ENST00000502732.6	280	3826	++	127	P42684-1#100	0	36	ENST00000502732.6	1255	1291	+	36	0	-24	9684
P42684-1#100	0	12	12	P42684-1	325	337	+	12	P42684-1	0	1182	ENST00000367623.8	0	3483	++	42	P42684-1#100	0	36	ENST00000367623.8	912	948	+	36	0	-24	9685
P42684-1#100	0	12	12	P42684-1	325	337	+	12	P42684-1	52	687	ENST00000344730.8	143	2048	++	34	P42684-1#100	0	36	ENST00000344730.8	962	998	+	36	0	-24	9686
P42684-1#101	0	5	5	P42684-1	346	351	+	5	P42684-1	52	1182	ENST00000512653.5	123	3513	++	131	P42684-1#101	0	15	ENST00000512653.5	1005	1020	+	15	0	-10	9687
P42684-1#101	0	5	5	P42684-1	346	351	+	5	P42684-1	0	687	ENST00000511413.5	0	2061	++	130	P42684-1#101	0	15	ENST00000511413.5	1038	1053	+	15	0	-10	9688
P42684-1#101	0	5	5	P42684-1	346	351	+	5	P42684-1	0	687	ENST00000507173.5	0	1998	++	129	P42684-1#101	0	15	ENST00000507173.5	975	990	+	15	0	-10	9689
P42684-1#101	0	5	5	P42684-1	346	351	+	5	P42684-1	73	687	ENST00000504405.5	111	1953	++	128	P42684-1#101	0	15	ENST00000504405.5	930	945	+	15	0	-10	9690
P42684-1#101	0	5	5	P42684-1	346	351	+	5	P42684-1	0	1182	ENST00000502732.6	280	3826	++	127	P42684-1#101	0	15	ENST00000502732.6	1318	1333	+	15	0	-10	9691
P42684-1#101	0	5	5	P42684-1	346	351	+	5	P42684-1	0	1182	ENST00000367623.8	0	3483	++	42	P42684-1#101	0	15	ENST00000367623.8	975	990	+	15	0	-10	9692
P42684-1#101	0	5	5	P42684-1	346	351	+	5	P42684-1	52	687	ENST00000344730.8	143	2048	++	34	P42684-1#101	0	15	ENST00000344730.8	1025	1040	+	15	0	-10	9693
P42684-1#102	0	4	4	P42684-1	352	356	+	4	P42684-1	52	1182	ENST00000512653.5	123	3513	++	131	P42684-1#102	0	12	ENST00000512653.5	1023	1035	+	12	0	-8	9694
P42684-1#102	0	4	4	P42684-1	352	356	+	4	P42684-1	0	687	ENST00000511413.5	0	2061	++	130	P42684-1#102	0	12	ENST00000511413.5	1056	1068	+	12	0	-8	9695
P42684-1#102	0	4	4	P42684-1	352	356	+	4	P42684-1	0	687	ENST00000507173.5	0	1998	++	129	P42684-1#102	0	12	ENST00000507173.5	993	1005	+	12	0	-8	9696
P42684-1#102	0	4	4	P42684-1	352	356	+	4	P42684-1	73	687	ENST00000504405.5	111	1953	++	128	P42684-1#102	0	12	ENST00000504405.5	948	960	+	12	0	-8	9697
P42684-1#102	0	4	4	P42684-1	352	356	+	4	P42684-1	0	1182	ENST00000502732.6	280	3826	++	127	P42684-1#102	0	12	ENST00000502732.6	1336	1348	+	12	0	-8	9698
P42684-1#102	0	4	4	P42684-1	352	356	+	4	P42684-1	0	1182	ENST00000367623.8	0	3483	++	42	P42684-1#102	0	12	ENST00000367623.8	993	1005	+	12	0	-8	9699
P42684-1#102	0	4	4	P42684-1	352	356	+	4	P42684-1	52	687	ENST00000344730.8	143	2048	++	34	P42684-1#102	0	12	ENST00000344730.8	1043	1055	+	12	0	-8	9700
P42684-1#103	0	5	5	P42684-1	357	362	+	5	P42684-1	52	1182	ENST00000512653.5	123	3513	++	131	P42684-1#103	0	15	ENST00000512653.5	1038	1053	+	15	0	-10	9701
P42684-1#103	0	5	5	P42684-1	357	362	+	5	P42684-1	0	687	ENST00000511413.5	0	2061	++	130	P42684-1#103	0	15	ENST00000511413.5	1071	1086	+	15	0	-10	9702
P42684-1#103	0	5	5	P42684-1	357	362	+	5	P42684-1	0	687	ENST00000507173.5	0	1998	++	129	P42684-1#103	0	15	ENST00000507173.5	1008	1023	+	15	0	-10	9703
P42684-1#103	0	5	5	P42684-1	357	362	+	5	P42684-1	73	687	ENST00000504405.5	111	1953	++	128	P42684-1#103	0	15	ENST00000504405.5	963	978	+	15	0	-10	9704
P42684-1#103	0	5	5	P42684-1	357	362	+	5	P42684-1	0	1182	ENST00000502732.6	280	3826	++	127	P42684-1#103	0	15	ENST00000502732.6	1351	1366	+	15	0	-10	9705
P42684-1#103	0	5	5	P42684-1	357	362	+	5	P42684-1	0	1182	ENST00000367623.8	0	3483	++	42	P42684-1#103	0	15	ENST00000367623.8	1008	1023	+	15	0	-10	9706
P42684-1#103	0	5	5	P42684-1	357	362	+	5	P42684-1	52	687	ENST00000344730.8	143	2048	++	34	P42684-1#103	0	15	ENST00000344730.8	1058	1073	+	15	0	-10	9707
P42684-1#104	0	7	7	P42684-1	368	375	+	7	P42684-1	52	1182	ENST00000512653.5	123	3513	++	131	P42684-1#104	0	21	ENST00000512653.5	1071	1092	+	21	0	-14	9708
P42684-1#104	0	7	7	P42684-1	368	375	+	7	P42684-1	0	687	ENST00000511413.5	0	2061	++	130	P42684-1#104	0	21	ENST00000511413.5	1104	1125	+	21	0	-14	9709
P42684-1#104	0	7	7	P42684-1	368	375	+	7	P42684-1	0	687	ENST00000507173.5	0	1998	++	129	P42684-1#104	0	21	ENST00000507173.5	1041	1062	+	21	0	-14	9710
P42684-1#104	0	7	7	P42684-1	368	375	+	7	P42684-1	73	687	ENST00000504405.5	111	1953	++	128	P42684-1#104	0	21	ENST00000504405.5	996	1017	+	21	0	-14	9711
P42684-1#104	0	7	7	P42684-1	368	375	+	7	P42684-1	0	1182	ENST00000502732.6	280	3826	++	127	P42684-1#104	0	21	ENST00000502732.6	1384	1405	+	21	0	-14	9712
P42684-1#104	0	7	7	P42684-1	368	375	+	7	P42684-1	0	1182	ENST00000367623.8	0	3483	++	42	P42684-1#104	0	21	ENST00000367623.8	1041	1062	+	21	0	-14	9713
P42684-1#104	0	7	7	P42684-1	368	375	+	7	P42684-1	52	687	ENST00000344730.8	143	2048	++	34	P42684-1#104	0	21	ENST00000344730.8	1091	1112	+	21	0	-14	9714
P42684-1#105	0	3	3	P42684-1	377	380	+	3	P42684-1	52	1182	ENST00000512653.5	123	3513	++	131	P42684-1#105	0	9	ENST00000512653.5	1098	1107	+	9	0	-6	9715
P42684-1#105	0	3	3	P42684-1	377	380	+	3	P42684-1	0	687	ENST00000511413.5	0	2061	++	130	P42684-1#105	0	9	ENST00000511413.5	1131	1140	+	9	0	-6	9716
P42684-1#105	0	3	3	P42684-1	377	380	+	3	P42684-1	0	687	ENST00000507173.5	0	1998	++	129	P42684-1#105	0	9	ENST00000507173.5	1068	1077	+	9	0	-6	9717
P42684-1#105	0	3	3	P42684-1	377	380	+	3	P42684-1	73	687	ENST00000504405.5	111	1953	++	128	P42684-1#105	0	9	ENST00000504405.5	1023	1032	+	9	0	-6	9718
P42684-1#105	0	3	3	P42684-1	377	380	+	3	P42684-1	0	1182	ENST00000502732.6	280	3826	++	127	P42684-1#105	0	9	ENST00000502732.6	1411	1420	+	9	0	-6	9719
P42684-1#105	0	3	3	P42684-1	377	380	+	3	P42684-1	0	1182	ENST00000367623.8	0	3483	++	42	P42684-1#105	0	9	ENST00000367623.8	1068	1077	+	9	0	-6	9720
P42684-1#105	0	3	3	P42684-1	377	380	+	3	P42684-1	52	687	ENST00000344730.8	143	2048	++	34	P42684-1#105	0	9	ENST00000344730.8	1118	1127	+	9	0	-6	9721
P42684-1#106	0	20	20	P42684-1	382	402	+	20	P42684-1	52	1182	ENST00000512653.5	123	3513	++	131	P42684-1#106	0	60	ENST00000512653.5	1113	1173	+	60	0	-40	9722
P42684-1#106	0	20	20	P42684-1	382	402	+	20	P42684-1	0	687	ENST00000511413.5	0	2061	++	130	P42684-1#106	0	60	ENST00000511413.5	1146	1206	+	60	0	-40	9723
P42684-1#106	0	20	20	P42684-1	382	402	+	20	P42684-1	0	687	ENST00000507173.5	0	1998	++	129	P42684-1#106	0	60	ENST00000507173.5	1083	1143	+	60	0	-40	9724
P42684-1#106	0	20	20	P42684-1	382	402	+	20	P42684-1	73	687	ENST00000504405.5	111	1953	++	128	P42684-1#106	0	60	ENST00000504405.5	1038	1098	+	60	0	-40	9725
P42684-1#106	0	20	20	P42684-1	382	402	+	20	P42684-1	0	1182	ENST00000502732.6	280	3826	++	127	P42684-1#106	0	60	ENST00000502732.6	1426	1486	+	60	0	-40	9726
P42684-1#106	0	20	20	P42684-1	382	402	+	20	P42684-1	0	1182	ENST00000367623.8	0	3483	++	42	P42684-1#106	0	60	ENST00000367623.8	1083	1143	+	60	0	-40	9727
P42684-1#106	0	20	20	P42684-1	382	402	+	20	P42684-1	52	687	ENST00000344730.8	143	2048	++	34	P42684-1#106	0	60	ENST00000344730.8	1133	1193	+	60	0	-40	9728
P42684-1#107	0	3	3	P42684-1	411	414	+	3	P42684-1	52	1182	ENST00000512653.5	123	3513	++	131	P42684-1#107	0	9	ENST00000512653.5	1200	1209	+	9	0	-6	9729
P42684-1#107	0	3	3	P42684-1	411	414	+	3	P42684-1	0	687	ENST00000511413.5	0	2061	++	130	P42684-1#107	0	9	ENST00000511413.5	1233	1242	+	9	0	-6	9730
P42684-1#107	0	3	3	P42684-1	411	414	+	3	P42684-1	0	687	ENST00000507173.5	0	1998	++	129	P42684-1#107	0	9	ENST00000507173.5	1170	1179	+	9	0	-6	9731
P42684-1#107	0	3	3	P42684-1	411	414	+	3	P42684-1	73	687	ENST00000504405.5	111	1953	++	128	P42684-1#107	0	9	ENST00000504405.5	1125	1134	+	9	0	-6	9732
P42684-1#107	0	3	3	P42684-1	411	414	+	3	P42684-1	0	1182	ENST00000502732.6	280	3826	++	127	P42684-1#107	0	9	ENST00000502732.6	1513	1522	+	9	0	-6	9733
P42684-1#107	0	3	3	P42684-1	411	414	+	3	P42684-1	0	1182	ENST00000367623.8	0	3483	++	42	P42684-1#107	0	9	ENST00000367623.8	1170	1179	+	9	0	-6	9734
P42684-1#107	0	3	3	P42684-1	411	414	+	3	P42684-1	52	687	ENST00000344730.8	143	2048	++	34	P42684-1#107	0	9	ENST00000344730.8	1220	1229	+	9	0	-6	9735
P42684-1#108	0	3	3	P42684-1	414	417	+	3	P42684-1	52	1182	ENST00000512653.5	123	3513	++	131	P42684-1#108	0	9	ENST00000512653.5	1209	1218	+	9	0	-6	9736
P42684-1#108	0	3	3	P42684-1	414	417	+	3	P42684-1	0	687	ENST00000511413.5	0	2061	++	130	P42684-1#108	0	9	ENST00000511413.5	1242	1251	+	9	0	-6	9737
P42684-1#108	0	3	3	P42684-1	414	417	+	3	P42684-1	0	687	ENST00000507173.5	0	1998	++	129	P42684-1#108	0	9	ENST00000507173.5	1179	1188	+	9	0	-6	9738
P42684-1#108	0	3	3	P42684-1	414	417	+	3	P42684-1	73	687	ENST00000504405.5	111	1953	++	128	P42684-1#108	0	9	ENST00000504405.5	1134	1143	+	9	0	-6	9739
P42684-1#108	0	3	3	P42684-1	414	417	+	3	P42684-1	0	1182	ENST00000502732.6	280	3826	++	127	P42684-1#108	0	9	ENST00000502732.6	1522	1531	+	9	0	-6	9740
P42684-1#108	0	3	3	P42684-1	414	417	+	3	P42684-1	0	1182	ENST00000367623.8	0	3483	++	42	P42684-1#108	0	9	ENST00000367623.8	1179	1188	+	9	0	-6	9741
P42684-1#108	0	3	3	P42684-1	414	417	+	3	P42684-1	52	687	ENST00000344730.8	143	2048	++	34	P42684-1#108	0	9	ENST00000344730.8	1229	1238	+	9	0	-6	9742
P42684-1#109	0	3	3	P42684-1	418	421	+	3	P42684-1	52	1182	ENST00000512653.5	123	3513	++	131	P42684-1#109	0	9	ENST00000512653.5	1221	1230	+	9	0	-6	9743
P42684-1#109	0	3	3	P42684-1	418	421	+	3	P42684-1	0	687	ENST00000511413.5	0	2061	++	130	P42684-1#109	0	9	ENST00000511413.5	1254	1263	+	9	0	-6	9744
P42684-1#109	0	3	3	P42684-1	418	421	+	3	P42684-1	0	687	ENST00000507173.5	0	1998	++	129	P42684-1#109	0	9	ENST00000507173.5	1191	1200	+	9	0	-6	9745
P42684-1#109	0	3	3	P42684-1	418	421	+	3	P42684-1	73	687	ENST00000504405.5	111	1953	++	128	P42684-1#109	0	9	ENST00000504405.5	1146	1155	+	9	0	-6	9746
P42684-1#109	0	3	3	P42684-1	418	421	+	3	P42684-1	0	1182	ENST00000502732.6	280	3826	++	127	P42684-1#109	0	9	ENST00000502732.6	1534	1543	+	9	0	-6	9747
P42684-1#109	0	3	3	P42684-1	418	421	+	3	P42684-1	0	1182	ENST00000367623.8	0	3483	++	42	P42684-1#109	0	9	ENST00000367623.8	1191	1200	+	9	0	-6	9748
P42684-1#109	0	3	3	P42684-1	418	421	+	3	P42684-1	52	687	ENST00000344730.8	143	2048	++	34	P42684-1#109	0	9	ENST00000344730.8	1241	1250	+	9	0	-6	9749
P42684-1#110	0	3	3	P42684-1	422	425	+	3	P42684-1	52	1182	ENST00000512653.5	123	3513	++	131	P42684-1#110	0	9	ENST00000512653.5	1233	1242	+	9	0	-6	9750
P42684-1#110	0	3	3	P42684-1	422	425	+	3	P42684-1	0	687	ENST00000511413.5	0	2061	++	130	P42684-1#110	0	9	ENST00000511413.5	1266	1275	+	9	0	-6	9751
P42684-1#110	0	3	3	P42684-1	422	425	+	3	P42684-1	0	687	ENST00000507173.5	0	1998	++	129	P42684-1#110	0	9	ENST00000507173.5	1203	1212	+	9	0	-6	9752
P42684-1#110	0	3	3	P42684-1	422	425	+	3	P42684-1	73	687	ENST00000504405.5	111	1953	++	128	P42684-1#110	0	9	ENST00000504405.5	1158	1167	+	9	0	-6	9753
P42684-1#110	0	3	3	P42684-1	422	425	+	3	P42684-1	0	1182	ENST00000502732.6	280	3826	++	127	P42684-1#110	0	9	ENST00000502732.6	1546	1555	+	9	0	-6	9754
P42684-1#110	0	3	3	P42684-1	422	425	+	3	P42684-1	0	1182	ENST00000367623.8	0	3483	++	42	P42684-1#110	0	9	ENST00000367623.8	1203	1212	+	9	0	-6	9755
P42684-1#110	0	3	3	P42684-1	422	425	+	3	P42684-1	52	687	ENST00000344730.8	143	2048	++	34	P42684-1#110	0	9	ENST00000344730.8	1253	1262	+	9	0	-6	9756
P42684-1#111	0	3	3	P42684-1	434	437	+	3	P42684-1	52	1182	ENST00000512653.5	123	3513	++	131	P42684-1#111	0	9	ENST00000512653.5	1269	1278	+	9	0	-6	9757
P42684-1#111	0	3	3	P42684-1	434	437	+	3	P42684-1	0	687	ENST00000511413.5	0	2061	++	130	P42684-1#111	0	9	ENST00000511413.5	1302	1311	+	9	0	-6	9758
P42684-1#111	0	3	3	P42684-1	434	437	+	3	P42684-1	0	687	ENST00000507173.5	0	1998	++	129	P42684-1#111	0	9	ENST00000507173.5	1239	1248	+	9	0	-6	9759
P42684-1#111	0	3	3	P42684-1	434	437	+	3	P42684-1	73	687	ENST00000504405.5	111	1953	++	128	P42684-1#111	0	9	ENST00000504405.5	1194	1203	+	9	0	-6	9760
P42684-1#111	0	3	3	P42684-1	434	437	+	3	P42684-1	0	1182	ENST00000502732.6	280	3826	++	127	P42684-1#111	0	9	ENST00000502732.6	1582	1591	+	9	0	-6	9761
P42684-1#111	0	3	3	P42684-1	434	437	+	3	P42684-1	0	1182	ENST00000367623.8	0	3483	++	42	P42684-1#111	0	9	ENST00000367623.8	1239	1248	+	9	0	-6	9762
P42684-1#111	0	3	3	P42684-1	434	437	+	3	P42684-1	52	687	ENST00000344730.8	143	2048	++	34	P42684-1#111	0	9	ENST00000344730.8	1289	1298	+	9	0	-6	9763
P42684-1#112	0	3	3	P42684-1	437	440	+	3	P42684-1	52	1182	ENST00000512653.5	123	3513	++	131	P42684-1#112	0	9	ENST00000512653.5	1278	1287	+	9	0	-6	9764
P42684-1#112	0	3	3	P42684-1	437	440	+	3	P42684-1	0	687	ENST00000511413.5	0	2061	++	130	P42684-1#112	0	9	ENST00000511413.5	1311	1320	+	9	0	-6	9765
P42684-1#112	0	3	3	P42684-1	437	440	+	3	P42684-1	0	687	ENST00000507173.5	0	1998	++	129	P42684-1#112	0	9	ENST00000507173.5	1248	1257	+	9	0	-6	9766
P42684-1#112	0	3	3	P42684-1	437	440	+	3	P42684-1	73	687	ENST00000504405.5	111	1953	++	128	P42684-1#112	0	9	ENST00000504405.5	1203	1212	+	9	0	-6	9767
P42684-1#112	0	3	3	P42684-1	437	440	+	3	P42684-1	0	1182	ENST00000502732.6	280	3826	++	127	P42684-1#112	0	9	ENST00000502732.6	1591	1600	+	9	0	-6	9768
P42684-1#112	0	3	3	P42684-1	437	440	+	3	P42684-1	0	1182	ENST00000367623.8	0	3483	++	42	P42684-1#112	0	9	ENST00000367623.8	1248	1257	+	9	0	-6	9769
P42684-1#112	0	3	3	P42684-1	437	440	+	3	P42684-1	52	687	ENST00000344730.8	143	2048	++	34	P42684-1#112	0	9	ENST00000344730.8	1298	1307	+	9	0	-6	9770
P42684-1#113	0	3	3	P42684-1	448	451	+	3	P42684-1	52	1182	ENST00000512653.5	123	3513	++	131	P42684-1#113	0	9	ENST00000512653.5	1311	1320	+	9	0	-6	9771
P42684-1#113	0	3	3	P42684-1	448	451	+	3	P42684-1	0	687	ENST00000511413.5	0	2061	++	130	P42684-1#113	0	9	ENST00000511413.5	1344	1353	+	9	0	-6	9772
P42684-1#113	0	3	3	P42684-1	448	451	+	3	P42684-1	0	687	ENST00000507173.5	0	1998	++	129	P42684-1#113	0	9	ENST00000507173.5	1281	1290	+	9	0	-6	9773
P42684-1#113	0	3	3	P42684-1	448	451	+	3	P42684-1	73	687	ENST00000504405.5	111	1953	++	128	P42684-1#113	0	9	ENST00000504405.5	1236	1245	+	9	0	-6	9774
P42684-1#113	0	3	3	P42684-1	448	451	+	3	P42684-1	0	1182	ENST00000502732.6	280	3826	++	127	P42684-1#113	0	9	ENST00000502732.6	1624	1633	+	9	0	-6	9775
P42684-1#113	0	3	3	P42684-1	448	451	+	3	P42684-1	0	1182	ENST00000367623.8	0	3483	++	42	P42684-1#113	0	9	ENST00000367623.8	1281	1290	+	9	0	-6	9776
P42684-1#113	0	3	3	P42684-1	448	451	+	3	P42684-1	52	687	ENST00000344730.8	143	2048	++	34	P42684-1#113	0	9	ENST00000344730.8	1331	1340	+	9	0	-6	9777
P42684-1#114	0	6	6	P42684-1	453	459	+	6	P42684-1	52	1182	ENST00000512653.5	123	3513	++	131	P42684-1#114	0	18	ENST00000512653.5	1326	1344	+	18	0	-12	9778
P42684-1#114	0	6	6	P42684-1	453	459	+	6	P42684-1	0	687	ENST00000511413.5	0	2061	++	130	P42684-1#114	0	18	ENST00000511413.5	1359	1377	+	18	0	-12	9779
P42684-1#114	0	6	6	P42684-1	453	459	+	6	P42684-1	0	687	ENST00000507173.5	0	1998	++	129	P42684-1#114	0	18	ENST00000507173.5	1296	1314	+	18	0	-12	9780
P42684-1#114	0	6	6	P42684-1	453	459	+	6	P42684-1	73	687	ENST00000504405.5	111	1953	++	128	P42684-1#114	0	18	ENST00000504405.5	1251	1269	+	18	0	-12	9781
P42684-1#114	0	6	6	P42684-1	453	459	+	6	P42684-1	0	1182	ENST00000502732.6	280	3826	++	127	P42684-1#114	0	18	ENST00000502732.6	1639	1657	+	18	0	-12	9782
P42684-1#114	0	6	6	P42684-1	453	459	+	6	P42684-1	0	1182	ENST00000367623.8	0	3483	++	42	P42684-1#114	0	18	ENST00000367623.8	1296	1314	+	18	0	-12	9783
P42684-1#114	0	6	6	P42684-1	453	459	+	6	P42684-1	52	687	ENST00000344730.8	143	2048	++	34	P42684-1#114	0	18	ENST00000344730.8	1346	1364	+	18	0	-12	9784
P42684-1#115	0	16	16	P42684-1	463	479	+	16	P42684-1	52	1182	ENST00000512653.5	123	3513	++	131	P42684-1#115	0	48	ENST00000512653.5	1356	1404	+	48	0	-32	9785
P42684-1#115	0	16	16	P42684-1	463	479	+	16	P42684-1	0	687	ENST00000511413.5	0	2061	++	130	P42684-1#115	0	48	ENST00000511413.5	1389	1437	+	48	0	-32	9786
P42684-1#115	0	16	16	P42684-1	463	479	+	16	P42684-1	0	687	ENST00000507173.5	0	1998	++	129	P42684-1#115	0	48	ENST00000507173.5	1326	1374	+	48	0	-32	9787
P42684-1#115	0	16	16	P42684-1	463	479	+	16	P42684-1	73	687	ENST00000504405.5	111	1953	++	128	P42684-1#115	0	48	ENST00000504405.5	1281	1329	+	48	0	-32	9788
P42684-1#115	0	16	16	P42684-1	463	479	+	16	P42684-1	0	1182	ENST00000502732.6	280	3826	++	127	P42684-1#115	0	48	ENST00000502732.6	1669	1717	+	48	0	-32	9789
P42684-1#115	0	16	16	P42684-1	463	479	+	16	P42684-1	0	1182	ENST00000367623.8	0	3483	++	42	P42684-1#115	0	48	ENST00000367623.8	1326	1374	+	48	0	-32	9790
P42684-1#115	0	16	16	P42684-1	463	479	+	16	P42684-1	52	687	ENST00000344730.8	143	2048	++	34	P42684-1#115	0	48	ENST00000344730.8	1376	1424	+	48	0	-32	9791
P42684-1#116	0	3	3	P42684-1	490	493	+	3	P42684-1	52	1182	ENST00000512653.5	123	3513	++	131	P42684-1#116	0	9	ENST00000512653.5	1437	1446	+	9	0	-6	9792
P42684-1#116	0	3	3	P42684-1	490	493	+	3	P42684-1	0	687	ENST00000511413.5	0	2061	++	130	P42684-1#116	0	9	ENST00000511413.5	1470	1479	+	9	0	-6	9793
P42684-1#116	0	3	3	P42684-1	490	493	+	3	P42684-1	0	687	ENST00000507173.5	0	1998	++	129	P42684-1#116	0	9	ENST00000507173.5	1407	1416	+	9	0	-6	9794
P42684-1#116	0	3	3	P42684-1	490	493	+	3	P42684-1	73	687	ENST00000504405.5	111	1953	++	128	P42684-1#116	0	9	ENST00000504405.5	1362	1371	+	9	0	-6	9795
P42684-1#116	0	3	3	P42684-1	490	493	+	3	P42684-1	0	1182	ENST00000502732.6	280	3826	++	127	P42684-1#116	0	9	ENST00000502732.6	1750	1759	+	9	0	-6	9796
P42684-1#116	0	3	3	P42684-1	490	493	+	3	P42684-1	0	1182	ENST00000367623.8	0	3483	++	42	P42684-1#116	0	9	ENST00000367623.8	1407	1416	+	9	0	-6	9797
P42684-1#116	0	3	3	P42684-1	490	493	+	3	P42684-1	52	687	ENST00000344730.8	143	2048	++	34	P42684-1#116	0	9	ENST00000344730.8	1457	1466	+	9	0	-6	9798
P42684-1#117	0	6	6	P42684-1	493	499	+	6	P42684-1	52	1182	ENST00000512653.5	123	3513	++	131	P42684-1#117	0	18	ENST00000512653.5	1446	1464	+	18	0	-12	9799
P42684-1#117	0	6	6	P42684-1	493	499	+	6	P42684-1	0	687	ENST00000511413.5	0	2061	++	130	P42684-1#117	0	18	ENST00000511413.5	1479	1497	+	18	0	-12	9800
P42684-1#117	0	6	6	P42684-1	493	499	+	6	P42684-1	0	687	ENST00000507173.5	0	1998	++	129	P42684-1#117	0	18	ENST00000507173.5	1416	1434	+	18	0	-12	9801
P42684-1#117	0	6	6	P42684-1	493	499	+	6	P42684-1	73	687	ENST00000504405.5	111	1953	++	128	P42684-1#117	0	18	ENST00000504405.5	1371	1389	+	18	0	-12	9802
P42684-1#117	0	6	6	P42684-1	493	499	+	6	P42684-1	0	1182	ENST00000502732.6	280	3826	++	127	P42684-1#117	0	18	ENST00000502732.6	1759	1777	+	18	0	-12	9803
P42684-1#117	0	6	6	P42684-1	493	499	+	6	P42684-1	0	1182	ENST00000367623.8	0	3483	++	42	P42684-1#117	0	18	ENST00000367623.8	1416	1434	+	18	0	-12	9804
P42684-1#117	0	6	6	P42684-1	493	499	+	6	P42684-1	52	687	ENST00000344730.8	143	2048	++	34	P42684-1#117	0	18	ENST00000344730.8	1466	1484	+	18	0	-12	9805
P42684-1#118	0	10	10	P42684-1	511	521	+	10	P42684-1	52	1182	ENST00000512653.5	123	3513	++	131	P42684-1#118	0	30	ENST00000512653.5	1500	1530	+	30	0	-20	9806
P42684-1#118	0	10	10	P42684-1	511	521	+	10	P42684-1	0	687	ENST00000511413.5	0	2061	++	130	P42684-1#118	0	30	ENST00000511413.5	1533	1563	+	30	0	-20	9807
P42684-1#118	0	10	10	P42684-1	511	521	+	10	P42684-1	0	687	ENST00000507173.5	0	1998	++	129	P42684-1#118	0	30	ENST00000507173.5	1470	1500	+	30	0	-20	9808
P42684-1#118	0	10	10	P42684-1	511	521	+	10	P42684-1	73	687	ENST00000504405.5	111	1953	++	128	P42684-1#118	0	30	ENST00000504405.5	1425	1455	+	30	0	-20	9809
P42684-1#118	0	10	10	P42684-1	511	521	+	10	P42684-1	0	1182	ENST00000502732.6	280	3826	++	127	P42684-1#118	0	30	ENST00000502732.6	1813	1843	+	30	0	-20	9810
P42684-1#118	0	10	10	P42684-1	511	521	+	10	P42684-1	0	1182	ENST00000367623.8	0	3483	++	42	P42684-1#118	0	30	ENST00000367623.8	1470	1500	+	30	0	-20	9811
P42684-1#118	0	10	10	P42684-1	511	521	+	10	P42684-1	52	687	ENST00000344730.8	143	2048	++	34	P42684-1#118	0	30	ENST00000344730.8	1520	1550	+	30	0	-20	9812
P42684-1#119	0	3	3	P42684-1	525	528	+	3	P42684-1	52	1182	ENST00000512653.5	123	3513	++	131	P42684-1#119	0	9	ENST00000512653.5	1542	1551	+	9	0	-6	9813
P42684-1#119	0	3	3	P42684-1	525	528	+	3	P42684-1	0	687	ENST00000511413.5	0	2061	++	130	P42684-1#119	0	9	ENST00000511413.5	1575	1584	+	9	0	-6	9814
P42684-1#119	0	3	3	P42684-1	525	528	+	3	P42684-1	0	687	ENST00000507173.5	0	1998	++	129	P42684-1#119	0	9	ENST00000507173.5	1512	1521	+	9	0	-6	9815
P42684-1#119	0	3	3	P42684-1	525	528	+	3	P42684-1	73	687	ENST00000504405.5	111	1953	++	128	P42684-1#119	0	9	ENST00000504405.5	1467	1476	+	9	0	-6	9816
P42684-1#119	0	3	3	P42684-1	525	528	+	3	P42684-1	0	1182	ENST00000502732.6	280	3826	++	127	P42684-1#119	0	9	ENST00000502732.6	1855	1864	+	9	0	-6	9817
P42684-1#119	0	3	3	P42684-1	525	528	+	3	P42684-1	0	1182	ENST00000367623.8	0	3483	++	42	P42684-1#119	0	9	ENST00000367623.8	1512	1521	+	9	0	-6	9818
P42684-1#119	0	3	3	P42684-1	525	528	+	3	P42684-1	52	687	ENST00000344730.8	143	2048	++	34	P42684-1#119	0	9	ENST00000344730.8	1562	1571	+	9	0	-6	9819
P42684-1#120	0	14	14	P42684-1	531	545	+	14	P42684-1	52	1182	ENST00000512653.5	123	3513	++	131	P42684-1#120	0	42	ENST00000512653.5	1560	1602	+	42	0	-28	9820
P42684-1#120	0	14	14	P42684-1	531	545	+	14	P42684-1	0	687	ENST00000511413.5	0	2061	++	130	P42684-1#120	0	42	ENST00000511413.5	1593	1635	+	42	0	-28	9821
P42684-1#120	0	14	14	P42684-1	531	545	+	14	P42684-1	0	687	ENST00000507173.5	0	1998	++	129	P42684-1#120	0	42	ENST00000507173.5	1530	1572	+	42	0	-28	9822
P42684-1#120	0	14	14	P42684-1	531	545	+	14	P42684-1	73	687	ENST00000504405.5	111	1953	++	128	P42684-1#120	0	42	ENST00000504405.5	1485	1527	+	42	0	-28	9823
P42684-1#120	0	14	14	P42684-1	531	545	+	14	P42684-1	0	1182	ENST00000502732.6	280	3826	++	127	P42684-1#120	0	42	ENST00000502732.6	1873	1915	+	42	0	-28	9824
P42684-1#120	0	14	14	P42684-1	531	545	+	14	P42684-1	0	1182	ENST00000367623.8	0	3483	++	42	P42684-1#120	0	42	ENST00000367623.8	1530	1572	+	42	0	-28	9825
P42684-1#120	0	14	14	P42684-1	531	545	+	14	P42684-1	52	687	ENST00000344730.8	143	2048	++	34	P42684-1#120	0	42	ENST00000344730.8	1580	1622	+	42	0	-28	9826
P42684-1#121	0	3	3	P42684-1	1068	1071	+	3	P42684-1	52	1182	ENST00000512653.5	123	3513	++	131	P42684-1#121	0	9	ENST00000512653.5	3171	3180	+	9	0	-6	9827
P42684-1#121	0	3	3	P42684-1	1068	1071	+	3	P42684-1	0	1182	ENST00000502732.6	280	3826	++	127	P42684-1#121	0	9	ENST00000502732.6	3484	3493	+	9	0	-6	9828
P42684-1#121	0	3	3	P42684-1	1068	1071	+	3	P42684-1	0	1182	ENST00000367623.8	0	3483	++	42	P42684-1#121	0	9	ENST00000367623.8	3141	3150	+	9	0	-6	9829
P42684-1#122	0	3	3	P42684-1	1075	1078	+	3	P42684-1	52	1182	ENST00000512653.5	123	3513	++	131	P42684-1#122	0	9	ENST00000512653.5	3192	3201	+	9	0	-6	9830
P42684-1#122	0	3	3	P42684-1	1075	1078	+	3	P42684-1	0	1182	ENST00000502732.6	280	3826	++	127	P42684-1#122	0	9	ENST00000502732.6	3505	3514	+	9	0	-6	9831
P42684-1#122	0	3	3	P42684-1	1075	1078	+	3	P42684-1	0	1182	ENST00000367623.8	0	3483	++	42	P42684-1#122	0	9	ENST00000367623.8	3162	3171	+	9	0	-6	9832
P42684-1#123	0	4	4	P42684-1	1079	1083	+	4	P42684-1	52	1182	ENST00000512653.5	123	3513	++	131	P42684-1#123	0	12	ENST00000512653.5	3204	3216	+	12	0	-8	9833
P42684-1#123	0	4	4	P42684-1	1079	1083	+	4	P42684-1	0	1182	ENST00000502732.6	280	3826	++	127	P42684-1#123	0	12	ENST00000502732.6	3517	3529	+	12	0	-8	9834
P42684-1#123	0	4	4	P42684-1	1079	1083	+	4	P42684-1	0	1182	ENST00000367623.8	0	3483	++	42	P42684-1#123	0	12	ENST00000367623.8	3174	3186	+	12	0	-8	9835
P42684-1#124	0	14	14	P42684-1	1085	1099	+	14	P42684-1	52	1182	ENST00000512653.5	123	3513	++	131	P42684-1#124	0	42	ENST00000512653.5	3222	3264	+	42	0	-28	9836
P42684-1#124	0	14	14	P42684-1	1085	1099	+	14	P42684-1	0	1182	ENST00000502732.6	280	3826	++	127	P42684-1#124	0	42	ENST00000502732.6	3535	3577	+	42	0	-28	9837
P42684-1#124	0	14	14	P42684-1	1085	1099	+	14	P42684-1	0	1182	ENST00000367623.8	0	3483	++	42	P42684-1#124	0	42	ENST00000367623.8	3192	3234	+	42	0	-28	9838
P42684-1#125	0	18	18	P42684-1	1105	1123	+	18	P42684-1	52	1182	ENST00000512653.5	123	3513	++	131	P42684-1#125	0	54	ENST00000512653.5	3282	3336	+	54	0	-36	9839
P42684-1#125	0	18	18	P42684-1	1105	1123	+	18	P42684-1	0	1182	ENST00000502732.6	280	3826	++	127	P42684-1#125	0	54	ENST00000502732.6	3595	3649	+	54	0	-36	9840
P42684-1#125	0	18	18	P42684-1	1105	1123	+	18	P42684-1	0	1182	ENST00000367623.8	0	3483	++	42	P42684-1#125	0	54	ENST00000367623.8	3252	3306	+	54	0	-36	9841
P42684-1#126	0	3	3	P42684-1	1123	1126	+	3	P42684-1	52	1182	ENST00000512653.5	123	3513	++	131	P42684-1#126	0	9	ENST00000512653.5	3336	3345	+	9	0	-6	9842
P42684-1#126	0	3	3	P42684-1	1123	1126	+	3	P42684-1	0	1182	ENST00000502732.6	280	3826	++	127	P42684-1#126	0	9	ENST00000502732.6	3649	3658	+	9	0	-6	9843
P42684-1#126	0	3	3	P42684-1	1123	1126	+	3	P42684-1	0	1182	ENST00000367623.8	0	3483	++	42	P42684-1#126	0	9	ENST00000367623.8	3306	3315	+	9	0	-6	9844
P42684-1#127	0	23	23	P42684-1	1129	1152	+	23	P42684-1	52	1182	ENST00000512653.5	123	3513	++	131	P42684-1#127	0	69	ENST00000512653.5	3354	3423	+	69	0	-46	9845
P42684-1#127	0	23	23	P42684-1	1129	1152	+	23	P42684-1	0	1182	ENST00000502732.6	280	3826	++	127	P42684-1#127	0	69	ENST00000502732.6	3667	3736	+	69	0	-46	9846
P42684-1#127	0	23	23	P42684-1	1129	1152	+	23	P42684-1	0	1182	ENST00000367623.8	0	3483	++	42	P42684-1#127	0	69	ENST00000367623.8	3324	3393	+	69	0	-46	9847
P42684-1#128	0	4	4	P42684-1	1154	1158	+	4	P42684-1	52	1182	ENST00000512653.5	123	3513	++	131	P42684-1#128	0	12	ENST00000512653.5	3429	3441	+	12	0	-8	9848
P42684-1#128	0	4	4	P42684-1	1154	1158	+	4	P42684-1	0	1182	ENST00000502732.6	280	3826	++	127	P42684-1#128	0	12	ENST00000502732.6	3742	3754	+	12	0	-8	9849
P42684-1#128	0	4	4	P42684-1	1154	1158	+	4	P42684-1	0	1182	ENST00000367623.8	0	3483	++	42	P42684-1#128	0	12	ENST00000367623.8	3399	3411	+	12	0	-8	9850
P42684-1#129	0	17	17	P42684-1	1164	1181	+	17	P42684-1	52	1182	ENST00000512653.5	123	3513	++	131	P42684-1#129	0	51	ENST00000512653.5	3459	3510	+	51	0	-34	9851
P42684-1#129	0	17	17	P42684-1	1164	1181	+	17	P42684-1	0	1182	ENST00000502732.6	280	3826	++	127	P42684-1#129	0	51	ENST00000502732.6	3772	3823	+	51	0	-34	9852
P42684-1#129	0	17	17	P42684-1	1164	1181	+	17	P42684-1	0	1182	ENST00000367623.8	0	3483	++	42	P42684-1#129	0	51	ENST00000367623.8	3429	3480	+	51	0	-34	9853
P42684-1#130	0	1	1	P42684-1	646	647	+	1	P42684-1	52	1182	ENST00000512653.5	123	3513	++	131	P42684-1#130	0	3	ENST00000512653.5	1905	1908	+	3	0	-2	9854
P42684-1#130	0	1	1	P42684-1	646	647	+	1	P42684-1	0	687	ENST00000511413.5	0	2061	++	130	P42684-1#130	0	3	ENST00000511413.5	1938	1941	+	3	0	-2	9855
P42684-1#130	0	1	1	P42684-1	646	647	+	1	P42684-1	0	687	ENST00000507173.5	0	1998	++	129	P42684-1#130	0	3	ENST00000507173.5	1875	1878	+	3	0	-2	9856
P42684-1#130	0	1	1	P42684-1	646	647	+	1	P42684-1	73	687	ENST00000504405.5	111	1953	++	128	P42684-1#130	0	3	ENST00000504405.5	1830	1833	+	3	0	-2	9857
P42684-1#130	0	1	1	P42684-1	646	647	+	1	P42684-1	0	1182	ENST00000502732.6	280	3826	++	127	P42684-1#130	0	3	ENST00000502732.6	2218	2221	+	3	0	-2	9858
P42684-1#130	0	1	1	P42684-1	646	647	+	1	P42684-1	0	1182	ENST00000367623.8	0	3483	++	42	P42684-1#130	0	3	ENST00000367623.8	1875	1878	+	3	0	-2	9859
P42684-1#130	0	1	1	P42684-1	646	647	+	1	P42684-1	52	687	ENST00000344730.8	143	2048	++	34	P42684-1#130	0	3	ENST00000344730.8	1925	1928	+	3	0	-2	9860
P42684-1#131	0	1	1	P42684-1	11	12	+	1	P42684-1	0	687	ENST00000511413.5	0	2061	++	130	P42684-1#131	0	3	ENST00000511413.5	33	36	+	3	0	-2	9861
P42684-1#131	0	1	1	P42684-1	11	12	+	1	P42684-1	0	687	ENST00000507173.5	0	1998	++	129	P42684-1#131	0	3	ENST00000507173.5	33	36	+	3	0	-2	9862
P42684-1#131	0	1	1	P42684-1	11	12	+	1	P42684-1	0	1182	ENST00000502732.6	280	3826	++	127	P42684-1#131	0	3	ENST00000502732.6	313	316	+	3	0	-2	9863
P42684-1#131	0	1	1	P42684-1	11	12	+	1	P42684-1	0	1182	ENST00000367623.8	0	3483	++	42	P42684-1#131	0	3	ENST00000367623.8	33	36	+	3	0	-2	9864
P42684-1#132	0	1	1	P42684-1	682	683	+	1	P42684-1	52	1182	ENST00000512653.5	123	3513	++	131	P42684-1#132	0	3	ENST00000512653.5	2013	2016	+	3	0	-2	9865
P42684-1#132	0	1	1	P42684-1	682	683	+	1	P42684-1	0	687	ENST00000511413.5	0	2061	++	130	P42684-1#132	0	3	ENST00000511413.5	2046	2049	+	3	0	-2	9866
P42684-1#132	0	1	1	P42684-1	682	683	+	1	P42684-1	0	687	ENST00000507173.5	0	1998	++	129	P42684-1#132	0	3	ENST00000507173.5	1983	1986	+	3	0	-2	9867
P42684-1#132	0	1	1	P42684-1	682	683	+	1	P42684-1	73	687	ENST00000504405.5	111	1953	++	128	P42684-1#132	0	3	ENST00000504405.5	1938	1941	+	3	0	-2	9868
P42684-1#132	0	1	1	P42684-1	682	683	+	1	P42684-1	0	1182	ENST00000502732.6	280	3826	++	127	P42684-1#132	0	3	ENST00000502732.6	2326	2329	+	3	0	-2	9869
P42684-1#132	0	1	1	P42684-1	682	683	+	1	P42684-1	0	1182	ENST00000367623.8	0	3483	++	42	P42684-1#132	0	3	ENST00000367623.8	1983	1986	+	3	0	-2	9870
P42684-1#132	0	1	1	P42684-1	682	683	+	1	P42684-1	52	687	ENST00000344730.8	143	2048	++	34	P42684-1#132	0	3	ENST00000344730.8	2033	2036	+	3	0	-2	9871
P42684-1#133	0	1	1	P42684-1	661	662	+	1	P42684-1	52	1182	ENST00000512653.5	123	3513	++	131	P42684-1#133	0	3	ENST00000512653.5	1950	1953	+	3	0	-2	9872
P42684-1#133	0	1	1	P42684-1	661	662	+	1	P42684-1	0	687	ENST00000511413.5	0	2061	++	130	P42684-1#133	0	3	ENST00000511413.5	1983	1986	+	3	0	-2	9873
P42684-1#133	0	1	1	P42684-1	661	662	+	1	P42684-1	0	687	ENST00000507173.5	0	1998	++	129	P42684-1#133	0	3	ENST00000507173.5	1920	1923	+	3	0	-2	9874
P42684-1#133	0	1	1	P42684-1	661	662	+	1	P42684-1	73	687	ENST00000504405.5	111	1953	++	128	P42684-1#133	0	3	ENST00000504405.5	1875	1878	+	3	0	-2	9875
P42684-1#133	0	1	1	P42684-1	661	662	+	1	P42684-1	0	1182	ENST00000502732.6	280	3826	++	127	P42684-1#133	0	3	ENST00000502732.6	2263	2266	+	3	0	-2	9876
P42684-1#133	0	1	1	P42684-1	661	662	+	1	P42684-1	0	1182	ENST00000367623.8	0	3483	++	42	P42684-1#133	0	3	ENST00000367623.8	1920	1923	+	3	0	-2	9877
P42684-1#133	0	1	1	P42684-1	661	662	+	1	P42684-1	52	687	ENST00000344730.8	143	2048	++	34	P42684-1#133	0	3	ENST00000344730.8	1970	1973	+	3	0	-2	9878
P42684-1#134	0	1	1	P42684-1	667	668	+	1	P42684-1	52	1182	ENST00000512653.5	123	3513	++	131	P42684-1#134	0	3	ENST00000512653.5	1968	1971	+	3	0	-2	9879
P42684-1#134	0	1	1	P42684-1	667	668	+	1	P42684-1	0	687	ENST00000511413.5	0	2061	++	130	P42684-1#134	0	3	ENST00000511413.5	2001	2004	+	3	0	-2	9880
P42684-1#134	0	1	1	P42684-1	667	668	+	1	P42684-1	0	687	ENST00000507173.5	0	1998	++	129	P42684-1#134	0	3	ENST00000507173.5	1938	1941	+	3	0	-2	9881
P42684-1#134	0	1	1	P42684-1	667	668	+	1	P42684-1	73	687	ENST00000504405.5	111	1953	++	128	P42684-1#134	0	3	ENST00000504405.5	1893	1896	+	3	0	-2	9882
P42684-1#134	0	1	1	P42684-1	667	668	+	1	P42684-1	0	1182	ENST00000502732.6	280	3826	++	127	P42684-1#134	0	3	ENST00000502732.6	2281	2284	+	3	0	-2	9883
P42684-1#134	0	1	1	P42684-1	667	668	+	1	P42684-1	0	1182	ENST00000367623.8	0	3483	++	42	P42684-1#134	0	3	ENST00000367623.8	1938	1941	+	3	0	-2	9884
P42684-1#134	0	1	1	P42684-1	667	668	+	1	P42684-1	52	687	ENST00000344730.8	143	2048	++	34	P42684-1#134	0	3	ENST00000344730.8	1988	1991	+	3	0	-2	9885
Q96D53-1#0	0	544	544	Q96D53-1	0	544	+	544	Q96D53-1	0	74	ENST00000679315.1	109	331	++	263	Q96D53-1#0	0	222	ENST00000679315.1	109	331	+	222	0	322	9886
Q96D53-1#0	0	544	544	Q96D53-1	0	544	+	544	Q96D53-1	0	544	ENST00000679130.1	149	1781	++	262	Q96D53-1#0	0	1632	ENST00000679130.1	149	1781	+	1632	0	-1088	9887
Q96D53-1#0	0	544	544	Q96D53-1	0	544	+	544	Q96D53-1	109	169	ENST00000679070.1	229	409	++	261	Q96D53-1#0	327	507	ENST00000679070.1	229	409	+	180	327	37	9888
Q96D53-1#0	0	544	544	Q96D53-1	0	544	+	544	Q96D53-1	164	544	ENST00000679012.1	609	1749	++	260	Q96D53-1#0	492	1632	ENST00000679012.1	609	1749	+	1140	492	-1088	9889
Q96D53-1#0	0	544	544	Q96D53-1	0	544	+	544	Q96D53-1	0	297	ENST00000678569.1	101	992	++	259	Q96D53-1#0	0	891	ENST00000678569.1	101	992	+	891	0	-347	9890
Q96D53-1#0	0	544	544	Q96D53-1	0	544	+	544	Q96D53-1	0	544	ENST00000678467.1	117	1749	++	258	Q96D53-1#0	0	1632	ENST00000678467.1	117	1749	+	1632	0	-1088	9891
Q96D53-1#0	0	544	544	Q96D53-1	0	544	+	544	Q96D53-1	0	544	ENST00000678419.1	81	1713	++	257	Q96D53-1#0	0	1632	ENST00000678419.1	81	1713	+	1632	0	-1088	9892
Q96D53-1#0	0	544	544	Q96D53-1	0	544	+	544	Q96D53-1	0	544	ENST00000678404.1	295	1927	++	256	Q96D53-1#0	0	1632	ENST00000678404.1	295	1927	+	1632	0	-1088	9893
Q96D53-1#0	0	544	544	Q96D53-1	0	544	+	544	Q96D53-1	0	155	ENST00000678316.1	139	604	++	255	Q96D53-1#0	0	465	ENST00000678316.1	139	604	+	465	0	79	9894
Q96D53-1#0	0	544	544	Q96D53-1	0	544	+	544	Q96D53-1	0	74	ENST00000678057.1	205	427	++	254	Q96D53-1#0	0	222	ENST00000678057.1	205	427	+	222	0	322	9895
Q96D53-1#0	0	544	544	Q96D53-1	0	544	+	544	Q96D53-1	0	122	ENST00000677800.1	25	391	++	253	Q96D53-1#0	0	366	ENST00000677800.1	25	391	+	366	0	178	9896
Q96D53-1#0	0	544	544	Q96D53-1	0	544	+	544	Q96D53-1	0	169	ENST00000677633.1	120	627	++	252	Q96D53-1#0	0	507	ENST00000677633.1	120	627	+	507	0	37	9897
Q96D53-1#0	0	544	544	Q96D53-1	0	544	+	544	Q96D53-1	109	544	ENST00000677517.1	213	1518	++	251	Q96D53-1#0	327	1632	ENST00000677517.1	213	1518	+	1305	327	-1088	9898
Q96D53-1#0	0	544	544	Q96D53-1	0	544	+	544	Q96D53-1	109	544	ENST00000677496.1	217	1522	++	250	Q96D53-1#0	327	1632	ENST00000677496.1	217	1522	+	1305	327	-1088	9899
Q96D53-1#0	0	544	544	Q96D53-1	0	544	+	544	Q96D53-1	0	544	ENST00000677018.1	141	1773	++	249	Q96D53-1#0	0	1632	ENST00000677018.1	141	1773	+	1632	0	-1088	9900
Q96D53-1#0	0	544	544	Q96D53-1	0	544	+	544	Q96D53-1	0	100	ENST00000676578.1	78	375	++	248	Q96D53-1#0	0	300	ENST00000676578.1	78	375	+	297	0	244	9901
Q96D53-1#0	0	544	544	Q96D53-1	0	544	+	544	Q96D53-1	0	381	ENST00000676555.1	101	1244	++	247	Q96D53-1#0	0	1143	ENST00000676555.1	101	1244	+	1143	0	-599	9902
Q96D53-1#0	0	544	544	Q96D53-1	0	544	+	544	Q96D53-1	0	544	ENST00000601967.6	45	1677	++	217	Q96D53-1#0	0	1632	ENST00000601967.6	45	1677	+	1632	0	-1088	9903
Q96D53-1#0	0	544	544	Q96D53-1	0	544	+	544	Q96D53-1	0	74	ENST00000601304.5	153	375	++	214	Q96D53-1#0	0	222	ENST00000601304.5	153	375	+	222	0	322	9904
Q96D53-1#0	0	544	544	Q96D53-1	0	544	+	544	Q96D53-1	0	121	ENST00000600707.5	30	393	++	210	Q96D53-1#0	0	363	ENST00000600707.5	30	393	+	363	0	181	9905
Q96D53-1#0	0	544	544	Q96D53-1	0	544	+	544	Q96D53-1	109	169	ENST00000600080.5	253	433	++	209	Q96D53-1#0	327	507	ENST00000600080.5	253	433	+	180	327	37	9906
Q96D53-1#0	0	544	544	Q96D53-1	0	544	+	544	Q96D53-1	0	87	ENST00000599643.5	52	313	++	207	Q96D53-1#0	0	261	ENST00000599643.5	52	313	+	261	0	283	9907
Q96D53-1#0	0	544	544	Q96D53-1	0	544	+	544	Q96D53-1	0	110	ENST00000596357.1	42	372	++	203	Q96D53-1#0	0	330	ENST00000596357.1	42	372	+	330	0	214	9908
Q96D53-1#0	0	544	544	Q96D53-1	0	544	+	544	Q96D53-1	109	313	ENST00000595254.5	254	866	++	200	Q96D53-1#0	327	939	ENST00000595254.5	254	866	+	612	327	-395	9909
Q96D53-1#0	0	544	544	Q96D53-1	0	544	+	544	Q96D53-1	0	544	ENST00000594720.6	38	1670	++	197	Q96D53-1#0	0	1632	ENST00000594720.6	38	1670	+	1632	0	-1088	9910
Q96D53-1#0	0	544	544	Q96D53-1	0	544	+	544	Q96D53-1	0	544	ENST00000594490.6	29	1583	++	196	Q96D53-1#0	0	1632	ENST00000594490.6	29	1583	+	1554	0	-1088	9911
Q96D53-1#0	0	544	544	Q96D53-1	0	544	+	544	Q96D53-1	0	157	ENST00000594084.5	121	592	++	195	Q96D53-1#0	0	471	ENST00000594084.5	121	592	+	471	0	73	9912
Q96D53-1#0	0	544	544	Q96D53-1	0	544	+	544	Q96D53-1	0	544	ENST00000324464.8	303	1935	++	27	Q96D53-1#0	0	1632	ENST00000324464.8	303	1935	+	1632	0	-1088	9913
Q96D53-1#0	0	544	544	Q96D53-1	0	544	+	544	Q96D53-1	0	544	ENST00000243583.10	24	1533	++	3	Q96D53-1#0	0	1632	ENST00000243583.10	24	1533	+	1509	0	-1088	9914
Q96D53-1#1	0	17	17	Q96D53-1	91	108	+	17	Q96D53-1	0	544	ENST00000679130.1	149	1781	++	262	Q96D53-1#1	0	51	ENST00000679130.1	422	473	+	51	0	-34	9915
Q96D53-1#1	0	17	17	Q96D53-1	91	108	+	17	Q96D53-1	0	297	ENST00000678569.1	101	992	++	259	Q96D53-1#1	0	51	ENST00000678569.1	374	425	+	51	0	-34	9916
Q96D53-1#1	0	17	17	Q96D53-1	91	108	+	17	Q96D53-1	0	544	ENST00000678467.1	117	1749	++	258	Q96D53-1#1	0	51	ENST00000678467.1	390	441	+	51	0	-34	9917
Q96D53-1#1	0	17	17	Q96D53-1	91	108	+	17	Q96D53-1	0	544	ENST00000678419.1	81	1713	++	257	Q96D53-1#1	0	51	ENST00000678419.1	354	405	+	51	0	-34	9918
Q96D53-1#1	0	17	17	Q96D53-1	91	108	+	17	Q96D53-1	0	544	ENST00000678404.1	295	1927	++	256	Q96D53-1#1	0	51	ENST00000678404.1	568	619	+	51	0	-34	9919
Q96D53-1#1	0	17	17	Q96D53-1	91	108	+	17	Q96D53-1	0	155	ENST00000678316.1	139	604	++	255	Q96D53-1#1	0	51	ENST00000678316.1	412	463	+	51	0	-34	9920
Q96D53-1#1	0	17	17	Q96D53-1	91	108	+	17	Q96D53-1	0	122	ENST00000677800.1	25	391	++	253	Q96D53-1#1	0	51	ENST00000677800.1	298	349	+	51	0	-34	9921
Q96D53-1#1	0	17	17	Q96D53-1	91	108	+	17	Q96D53-1	0	169	ENST00000677633.1	120	627	++	252	Q96D53-1#1	0	51	ENST00000677633.1	393	444	+	51	0	-34	9922
Q96D53-1#1	0	17	17	Q96D53-1	91	108	+	17	Q96D53-1	0	544	ENST00000677018.1	141	1773	++	249	Q96D53-1#1	0	51	ENST00000677018.1	414	465	+	51	0	-34	9923
Q96D53-1#1	0	17	17	Q96D53-1	91	108	+	17	Q96D53-1	0	100	ENST00000676578.1	78	375	++	248	Q96D53-1#1	0	27	ENST00000676578.1	348	375	+	27	0	-10	9924
Q96D53-1#1	0	17	17	Q96D53-1	91	108	+	17	Q96D53-1	0	381	ENST00000676555.1	101	1244	++	247	Q96D53-1#1	0	51	ENST00000676555.1	374	425	+	51	0	-34	9925
Q96D53-1#1	0	17	17	Q96D53-1	91	108	+	17	Q96D53-1	0	544	ENST00000601967.6	45	1677	++	217	Q96D53-1#1	0	51	ENST00000601967.6	318	369	+	51	0	-34	9926
Q96D53-1#1	0	17	17	Q96D53-1	91	108	+	17	Q96D53-1	0	121	ENST00000600707.5	30	393	++	210	Q96D53-1#1	0	51	ENST00000600707.5	303	354	+	51	0	-34	9927
Q96D53-1#1	0	17	17	Q96D53-1	91	108	+	17	Q96D53-1	0	110	ENST00000596357.1	42	372	++	203	Q96D53-1#1	0	51	ENST00000596357.1	315	366	+	51	0	-34	9928
Q96D53-1#1	0	17	17	Q96D53-1	91	108	+	17	Q96D53-1	0	544	ENST00000594720.6	38	1670	++	197	Q96D53-1#1	0	51	ENST00000594720.6	311	362	+	51	0	-34	9929
Q96D53-1#1	0	17	17	Q96D53-1	91	108	+	17	Q96D53-1	0	544	ENST00000594490.6	29	1583	++	196	Q96D53-1#1	0	15	ENST00000594490.6	302	317	+	15	0	2	9930
Q96D53-1#1	0	17	17	Q96D53-1	91	108	+	17	Q96D53-1	0	157	ENST00000594084.5	121	592	++	195	Q96D53-1#1	0	51	ENST00000594084.5	394	445	+	51	0	-34	9931
Q96D53-1#1	0	17	17	Q96D53-1	91	108	+	17	Q96D53-1	0	544	ENST00000324464.8	303	1935	++	27	Q96D53-1#1	0	51	ENST00000324464.8	576	627	+	51	0	-34	9932
Q96D53-1#1	0	17	17	Q96D53-1	91	108	+	17	Q96D53-1	0	544	ENST00000243583.10	24	1533	++	3	Q96D53-1#1	0	51	ENST00000243583.10	297	348	+	51	0	-34	9933
Q96D53-1#2	0	233	233	Q96D53-1	190	423	+	233	Q96D53-1	0	544	ENST00000679130.1	149	1781	++	262	Q96D53-1#2	0	699	ENST00000679130.1	719	1418	+	699	0	-466	9934
Q96D53-1#2	0	233	233	Q96D53-1	190	423	+	233	Q96D53-1	164	544	ENST00000679012.1	609	1749	++	260	Q96D53-1#2	0	699	ENST00000679012.1	687	1386	+	699	0	-466	9935
Q96D53-1#2	0	233	233	Q96D53-1	190	423	+	233	Q96D53-1	0	297	ENST00000678569.1	101	992	++	259	Q96D53-1#2	0	321	ENST00000678569.1	671	992	+	321	0	-88	9936
Q96D53-1#2	0	233	233	Q96D53-1	190	423	+	233	Q96D53-1	0	544	ENST00000678467.1	117	1749	++	258	Q96D53-1#2	0	699	ENST00000678467.1	687	1386	+	699	0	-466	9937
Q96D53-1#2	0	233	233	Q96D53-1	190	423	+	233	Q96D53-1	0	544	ENST00000678419.1	81	1713	++	257	Q96D53-1#2	0	699	ENST00000678419.1	651	1350	+	699	0	-466	9938
Q96D53-1#2	0	233	233	Q96D53-1	190	423	+	233	Q96D53-1	0	544	ENST00000678404.1	295	1927	++	256	Q96D53-1#2	0	699	ENST00000678404.1	865	1564	+	699	0	-466	9939
Q96D53-1#2	0	233	233	Q96D53-1	190	423	+	233	Q96D53-1	109	544	ENST00000677517.1	213	1518	++	251	Q96D53-1#2	0	699	ENST00000677517.1	456	1155	+	699	0	-466	9940
Q96D53-1#2	0	233	233	Q96D53-1	190	423	+	233	Q96D53-1	109	544	ENST00000677496.1	217	1522	++	250	Q96D53-1#2	0	699	ENST00000677496.1	460	1159	+	699	0	-466	9941
Q96D53-1#2	0	233	233	Q96D53-1	190	423	+	233	Q96D53-1	0	544	ENST00000677018.1	141	1773	++	249	Q96D53-1#2	0	699	ENST00000677018.1	711	1410	+	699	0	-466	9942
Q96D53-1#2	0	233	233	Q96D53-1	190	423	+	233	Q96D53-1	0	381	ENST00000676555.1	101	1244	++	247	Q96D53-1#2	0	573	ENST00000676555.1	671	1244	+	573	0	-340	9943
Q96D53-1#2	0	233	233	Q96D53-1	190	423	+	233	Q96D53-1	0	544	ENST00000601967.6	45	1677	++	217	Q96D53-1#2	0	699	ENST00000601967.6	615	1314	+	699	0	-466	9944
Q96D53-1#2	0	233	233	Q96D53-1	190	423	+	233	Q96D53-1	109	313	ENST00000595254.5	254	866	++	200	Q96D53-1#2	0	369	ENST00000595254.5	497	866	+	369	0	-136	9945
Q96D53-1#2	0	233	233	Q96D53-1	190	423	+	233	Q96D53-1	0	544	ENST00000594720.6	38	1670	++	197	Q96D53-1#2	0	699	ENST00000594720.6	608	1307	+	699	0	-466	9946
Q96D53-1#2	0	233	233	Q96D53-1	190	423	+	233	Q96D53-1	0	544	ENST00000594490.6	29	1583	++	196	Q96D53-1#2	0	699	ENST00000594490.6	521	1220	+	699	0	-466	9947
Q96D53-1#2	0	233	233	Q96D53-1	190	423	+	233	Q96D53-1	0	544	ENST00000324464.8	303	1935	++	27	Q96D53-1#2	0	699	ENST00000324464.8	873	1572	+	699	0	-466	9948
Q96D53-1#2	0	233	233	Q96D53-1	190	423	+	233	Q96D53-1	0	544	ENST00000243583.10	24	1533	++	3	Q96D53-1#2	0	699	ENST00000243583.10	471	1170	+	699	0	-466	9949
Q96D53-1#3	0	42	42	Q96D53-1	44	86	+	42	Q96D53-1	0	74	ENST00000679315.1	109	331	++	263	Q96D53-1#3	0	90	ENST00000679315.1	241	331	+	90	0	-48	9950
Q96D53-1#3	0	42	42	Q96D53-1	44	86	+	42	Q96D53-1	0	544	ENST00000679130.1	149	1781	++	262	Q96D53-1#3	0	126	ENST00000679130.1	281	407	+	126	0	-84	9951
Q96D53-1#3	0	42	42	Q96D53-1	44	86	+	42	Q96D53-1	0	297	ENST00000678569.1	101	992	++	259	Q96D53-1#3	0	126	ENST00000678569.1	233	359	+	126	0	-84	9952
Q96D53-1#3	0	42	42	Q96D53-1	44	86	+	42	Q96D53-1	0	544	ENST00000678467.1	117	1749	++	258	Q96D53-1#3	0	126	ENST00000678467.1	249	375	+	126	0	-84	9953
Q96D53-1#3	0	42	42	Q96D53-1	44	86	+	42	Q96D53-1	0	544	ENST00000678419.1	81	1713	++	257	Q96D53-1#3	0	126	ENST00000678419.1	213	339	+	126	0	-84	9954
Q96D53-1#3	0	42	42	Q96D53-1	44	86	+	42	Q96D53-1	0	544	ENST00000678404.1	295	1927	++	256	Q96D53-1#3	0	126	ENST00000678404.1	427	553	+	126	0	-84	9955
Q96D53-1#3	0	42	42	Q96D53-1	44	86	+	42	Q96D53-1	0	155	ENST00000678316.1	139	604	++	255	Q96D53-1#3	0	126	ENST00000678316.1	271	397	+	126	0	-84	9956
Q96D53-1#3	0	42	42	Q96D53-1	44	86	+	42	Q96D53-1	0	74	ENST00000678057.1	205	427	++	254	Q96D53-1#3	0	90	ENST00000678057.1	337	427	+	90	0	-48	9957
Q96D53-1#3	0	42	42	Q96D53-1	44	86	+	42	Q96D53-1	0	122	ENST00000677800.1	25	391	++	253	Q96D53-1#3	0	126	ENST00000677800.1	157	283	+	126	0	-84	9958
Q96D53-1#3	0	42	42	Q96D53-1	44	86	+	42	Q96D53-1	0	169	ENST00000677633.1	120	627	++	252	Q96D53-1#3	0	126	ENST00000677633.1	252	378	+	126	0	-84	9959
Q96D53-1#3	0	42	42	Q96D53-1	44	86	+	42	Q96D53-1	0	544	ENST00000677018.1	141	1773	++	249	Q96D53-1#3	0	126	ENST00000677018.1	273	399	+	126	0	-84	9960
Q96D53-1#3	0	42	42	Q96D53-1	44	86	+	42	Q96D53-1	0	100	ENST00000676578.1	78	375	++	248	Q96D53-1#3	0	126	ENST00000676578.1	210	333	+	123	0	-84	9961
Q96D53-1#3	0	42	42	Q96D53-1	44	86	+	42	Q96D53-1	0	381	ENST00000676555.1	101	1244	++	247	Q96D53-1#3	0	126	ENST00000676555.1	233	359	+	126	0	-84	9962
Q96D53-1#3	0	42	42	Q96D53-1	44	86	+	42	Q96D53-1	0	544	ENST00000601967.6	45	1677	++	217	Q96D53-1#3	0	126	ENST00000601967.6	177	303	+	126	0	-84	9963
Q96D53-1#3	0	42	42	Q96D53-1	44	86	+	42	Q96D53-1	0	74	ENST00000601304.5	153	375	++	214	Q96D53-1#3	0	90	ENST00000601304.5	285	375	+	90	0	-48	9964
Q96D53-1#3	0	42	42	Q96D53-1	44	86	+	42	Q96D53-1	0	121	ENST00000600707.5	30	393	++	210	Q96D53-1#3	0	126	ENST00000600707.5	162	288	+	126	0	-84	9965
Q96D53-1#3	0	42	42	Q96D53-1	44	86	+	42	Q96D53-1	0	87	ENST00000599643.5	52	313	++	207	Q96D53-1#3	0	126	ENST00000599643.5	184	310	+	126	0	-84	9966
Q96D53-1#3	0	42	42	Q96D53-1	44	86	+	42	Q96D53-1	0	110	ENST00000596357.1	42	372	++	203	Q96D53-1#3	0	126	ENST00000596357.1	174	300	+	126	0	-84	9967
Q96D53-1#3	0	42	42	Q96D53-1	44	86	+	42	Q96D53-1	0	544	ENST00000594720.6	38	1670	++	197	Q96D53-1#3	0	126	ENST00000594720.6	170	296	+	126	0	-84	9968
Q96D53-1#3	0	42	42	Q96D53-1	44	86	+	42	Q96D53-1	0	544	ENST00000594490.6	29	1583	++	196	Q96D53-1#3	0	126	ENST00000594490.6	161	287	+	126	0	-84	9969
Q96D53-1#3	0	42	42	Q96D53-1	44	86	+	42	Q96D53-1	0	157	ENST00000594084.5	121	592	++	195	Q96D53-1#3	0	126	ENST00000594084.5	253	379	+	126	0	-84	9970
Q96D53-1#3	0	42	42	Q96D53-1	44	86	+	42	Q96D53-1	0	544	ENST00000324464.8	303	1935	++	27	Q96D53-1#3	0	126	ENST00000324464.8	435	561	+	126	0	-84	9971
Q96D53-1#3	0	42	42	Q96D53-1	44	86	+	42	Q96D53-1	0	544	ENST00000243583.10	24	1533	++	3	Q96D53-1#3	0	126	ENST00000243583.10	156	282	+	126	0	-84	9972
Q96D53-1#4	0	4	4	Q96D53-1	154	158	+	4	Q96D53-1	0	544	ENST00000679130.1	149	1781	++	262	Q96D53-1#4	0	12	ENST00000679130.1	611	623	+	12	0	-8	9973
Q96D53-1#4	0	4	4	Q96D53-1	154	158	+	4	Q96D53-1	109	169	ENST00000679070.1	229	409	++	261	Q96D53-1#4	0	12	ENST00000679070.1	364	376	+	12	0	-8	9974
Q96D53-1#4	0	4	4	Q96D53-1	154	158	+	4	Q96D53-1	0	297	ENST00000678569.1	101	992	++	259	Q96D53-1#4	0	12	ENST00000678569.1	563	575	+	12	0	-8	9975
Q96D53-1#4	0	4	4	Q96D53-1	154	158	+	4	Q96D53-1	0	544	ENST00000678467.1	117	1749	++	258	Q96D53-1#4	0	12	ENST00000678467.1	579	591	+	12	0	-8	9976
Q96D53-1#4	0	4	4	Q96D53-1	154	158	+	4	Q96D53-1	0	544	ENST00000678419.1	81	1713	++	257	Q96D53-1#4	0	12	ENST00000678419.1	543	555	+	12	0	-8	9977
Q96D53-1#4	0	4	4	Q96D53-1	154	158	+	4	Q96D53-1	0	544	ENST00000678404.1	295	1927	++	256	Q96D53-1#4	0	12	ENST00000678404.1	757	769	+	12	0	-8	9978
Q96D53-1#4	0	4	4	Q96D53-1	154	158	+	4	Q96D53-1	0	155	ENST00000678316.1	139	604	++	255	Q96D53-1#4	0	3	ENST00000678316.1	601	604	+	3	0	1	9979
Q96D53-1#4	0	4	4	Q96D53-1	154	158	+	4	Q96D53-1	0	169	ENST00000677633.1	120	627	++	252	Q96D53-1#4	0	12	ENST00000677633.1	582	594	+	12	0	-8	9980
Q96D53-1#4	0	4	4	Q96D53-1	154	158	+	4	Q96D53-1	109	544	ENST00000677517.1	213	1518	++	251	Q96D53-1#4	0	12	ENST00000677517.1	348	360	+	12	0	-8	9981
Q96D53-1#4	0	4	4	Q96D53-1	154	158	+	4	Q96D53-1	109	544	ENST00000677496.1	217	1522	++	250	Q96D53-1#4	0	12	ENST00000677496.1	352	364	+	12	0	-8	9982
Q96D53-1#4	0	4	4	Q96D53-1	154	158	+	4	Q96D53-1	0	544	ENST00000677018.1	141	1773	++	249	Q96D53-1#4	0	12	ENST00000677018.1	603	615	+	12	0	-8	9983
Q96D53-1#4	0	4	4	Q96D53-1	154	158	+	4	Q96D53-1	0	381	ENST00000676555.1	101	1244	++	247	Q96D53-1#4	0	12	ENST00000676555.1	563	575	+	12	0	-8	9984
Q96D53-1#4	0	4	4	Q96D53-1	154	158	+	4	Q96D53-1	0	544	ENST00000601967.6	45	1677	++	217	Q96D53-1#4	0	12	ENST00000601967.6	507	519	+	12	0	-8	9985
Q96D53-1#4	0	4	4	Q96D53-1	154	158	+	4	Q96D53-1	109	169	ENST00000600080.5	253	433	++	209	Q96D53-1#4	0	12	ENST00000600080.5	388	400	+	12	0	-8	9986
Q96D53-1#4	0	4	4	Q96D53-1	154	158	+	4	Q96D53-1	109	313	ENST00000595254.5	254	866	++	200	Q96D53-1#4	0	12	ENST00000595254.5	389	401	+	12	0	-8	9987
Q96D53-1#4	0	4	4	Q96D53-1	154	158	+	4	Q96D53-1	0	544	ENST00000594720.6	38	1670	++	197	Q96D53-1#4	0	12	ENST00000594720.6	500	512	+	12	0	-8	9988
Q96D53-1#4	0	4	4	Q96D53-1	154	158	+	4	Q96D53-1	0	544	ENST00000594490.6	29	1583	++	196	Q96D53-1#4	0	12	ENST00000594490.6	413	425	+	12	0	-8	9989
Q96D53-1#4	0	4	4	Q96D53-1	154	158	+	4	Q96D53-1	0	157	ENST00000594084.5	121	592	++	195	Q96D53-1#4	0	9	ENST00000594084.5	583	592	+	9	0	-5	9990
Q96D53-1#4	0	4	4	Q96D53-1	154	158	+	4	Q96D53-1	0	544	ENST00000324464.8	303	1935	++	27	Q96D53-1#4	0	12	ENST00000324464.8	765	777	+	12	0	-8	9991
Q96D53-1#5	0	4	4	Q96D53-1	215	219	+	4	Q96D53-1	0	544	ENST00000679130.1	149	1781	++	262	Q96D53-1#5	0	12	ENST00000679130.1	794	806	+	12	0	-8	9992
Q96D53-1#5	0	4	4	Q96D53-1	215	219	+	4	Q96D53-1	164	544	ENST00000679012.1	609	1749	++	260	Q96D53-1#5	0	12	ENST00000679012.1	762	774	+	12	0	-8	9993
Q96D53-1#5	0	4	4	Q96D53-1	215	219	+	4	Q96D53-1	0	297	ENST00000678569.1	101	992	++	259	Q96D53-1#5	0	12	ENST00000678569.1	746	758	+	12	0	-8	9994
Q96D53-1#5	0	4	4	Q96D53-1	215	219	+	4	Q96D53-1	0	544	ENST00000678467.1	117	1749	++	258	Q96D53-1#5	0	12	ENST00000678467.1	762	774	+	12	0	-8	9995
Q96D53-1#5	0	4	4	Q96D53-1	215	219	+	4	Q96D53-1	0	544	ENST00000678419.1	81	1713	++	257	Q96D53-1#5	0	12	ENST00000678419.1	726	738	+	12	0	-8	9996
Q96D53-1#5	0	4	4	Q96D53-1	215	219	+	4	Q96D53-1	0	544	ENST00000678404.1	295	1927	++	256	Q96D53-1#5	0	12	ENST00000678404.1	940	952	+	12	0	-8	9997
Q96D53-1#5	0	4	4	Q96D53-1	215	219	+	4	Q96D53-1	109	544	ENST00000677517.1	213	1518	++	251	Q96D53-1#5	0	12	ENST00000677517.1	531	543	+	12	0	-8	9998
Q96D53-1#5	0	4	4	Q96D53-1	215	219	+	4	Q96D53-1	109	544	ENST00000677496.1	217	1522	++	250	Q96D53-1#5	0	12	ENST00000677496.1	535	547	+	12	0	-8	9999
Q96D53-1#5	0	4	4	Q96D53-1	215	219	+	4	Q96D53-1	0	544	ENST00000677018.1	141	1773	++	249	Q96D53-1#5	0	12	ENST00000677018.1	786	798	+	12	0	-8	10000
Q96D53-1#5	0	4	4	Q96D53-1	215	219	+	4	Q96D53-1	0	381	ENST00000676555.1	101	1244	++	247	Q96D53-1#5	0	12	ENST00000676555.1	746	758	+	12	0	-8	10001
Q96D53-1#5	0	4	4	Q96D53-1	215	219	+	4	Q96D53-1	0	544	ENST00000601967.6	45	1677	++	217	Q96D53-1#5	0	12	ENST00000601967.6	690	702	+	12	0	-8	10002
Q96D53-1#5	0	4	4	Q96D53-1	215	219	+	4	Q96D53-1	109	313	ENST00000595254.5	254	866	++	200	Q96D53-1#5	0	12	ENST00000595254.5	572	584	+	12	0	-8	10003
Q96D53-1#5	0	4	4	Q96D53-1	215	219	+	4	Q96D53-1	0	544	ENST00000594720.6	38	1670	++	197	Q96D53-1#5	0	12	ENST00000594720.6	683	695	+	12	0	-8	10004
Q96D53-1#5	0	4	4	Q96D53-1	215	219	+	4	Q96D53-1	0	544	ENST00000594490.6	29	1583	++	196	Q96D53-1#5	0	12	ENST00000594490.6	596	608	+	12	0	-8	10005
Q96D53-1#5	0	4	4	Q96D53-1	215	219	+	4	Q96D53-1	0	544	ENST00000324464.8	303	1935	++	27	Q96D53-1#5	0	12	ENST00000324464.8	948	960	+	12	0	-8	10006
Q96D53-1#5	0	4	4	Q96D53-1	215	219	+	4	Q96D53-1	0	544	ENST00000243583.10	24	1533	++	3	Q96D53-1#5	0	12	ENST00000243583.10	546	558	+	12	0	-8	10007
Q96D53-1#6	0	36	36	Q96D53-1	50	86	+	36	Q96D53-1	0	74	ENST00000679315.1	109	331	++	263	Q96D53-1#6	0	72	ENST00000679315.1	259	331	+	72	0	-36	10008
Q96D53-1#6	0	36	36	Q96D53-1	50	86	+	36	Q96D53-1	0	544	ENST00000679130.1	149	1781	++	262	Q96D53-1#6	0	108	ENST00000679130.1	299	407	+	108	0	-72	10009
Q96D53-1#6	0	36	36	Q96D53-1	50	86	+	36	Q96D53-1	0	297	ENST00000678569.1	101	992	++	259	Q96D53-1#6	0	108	ENST00000678569.1	251	359	+	108	0	-72	10010
Q96D53-1#6	0	36	36	Q96D53-1	50	86	+	36	Q96D53-1	0	544	ENST00000678467.1	117	1749	++	258	Q96D53-1#6	0	108	ENST00000678467.1	267	375	+	108	0	-72	10011
Q96D53-1#6	0	36	36	Q96D53-1	50	86	+	36	Q96D53-1	0	544	ENST00000678419.1	81	1713	++	257	Q96D53-1#6	0	108	ENST00000678419.1	231	339	+	108	0	-72	10012
Q96D53-1#6	0	36	36	Q96D53-1	50	86	+	36	Q96D53-1	0	544	ENST00000678404.1	295	1927	++	256	Q96D53-1#6	0	108	ENST00000678404.1	445	553	+	108	0	-72	10013
Q96D53-1#6	0	36	36	Q96D53-1	50	86	+	36	Q96D53-1	0	155	ENST00000678316.1	139	604	++	255	Q96D53-1#6	0	108	ENST00000678316.1	289	397	+	108	0	-72	10014
Q96D53-1#6	0	36	36	Q96D53-1	50	86	+	36	Q96D53-1	0	74	ENST00000678057.1	205	427	++	254	Q96D53-1#6	0	72	ENST00000678057.1	355	427	+	72	0	-36	10015
Q96D53-1#6	0	36	36	Q96D53-1	50	86	+	36	Q96D53-1	0	122	ENST00000677800.1	25	391	++	253	Q96D53-1#6	0	108	ENST00000677800.1	175	283	+	108	0	-72	10016
Q96D53-1#6	0	36	36	Q96D53-1	50	86	+	36	Q96D53-1	0	169	ENST00000677633.1	120	627	++	252	Q96D53-1#6	0	108	ENST00000677633.1	270	378	+	108	0	-72	10017
Q96D53-1#6	0	36	36	Q96D53-1	50	86	+	36	Q96D53-1	0	544	ENST00000677018.1	141	1773	++	249	Q96D53-1#6	0	108	ENST00000677018.1	291	399	+	108	0	-72	10018
Q96D53-1#6	0	36	36	Q96D53-1	50	86	+	36	Q96D53-1	0	100	ENST00000676578.1	78	375	++	248	Q96D53-1#6	0	108	ENST00000676578.1	228	333	+	105	0	-72	10019
Q96D53-1#6	0	36	36	Q96D53-1	50	86	+	36	Q96D53-1	0	381	ENST00000676555.1	101	1244	++	247	Q96D53-1#6	0	108	ENST00000676555.1	251	359	+	108	0	-72	10020
Q96D53-1#6	0	36	36	Q96D53-1	50	86	+	36	Q96D53-1	0	544	ENST00000601967.6	45	1677	++	217	Q96D53-1#6	0	108	ENST00000601967.6	195	303	+	108	0	-72	10021
Q96D53-1#6	0	36	36	Q96D53-1	50	86	+	36	Q96D53-1	0	74	ENST00000601304.5	153	375	++	214	Q96D53-1#6	0	72	ENST00000601304.5	303	375	+	72	0	-36	10022
Q96D53-1#6	0	36	36	Q96D53-1	50	86	+	36	Q96D53-1	0	121	ENST00000600707.5	30	393	++	210	Q96D53-1#6	0	108	ENST00000600707.5	180	288	+	108	0	-72	10023
Q96D53-1#6	0	36	36	Q96D53-1	50	86	+	36	Q96D53-1	0	87	ENST00000599643.5	52	313	++	207	Q96D53-1#6	0	108	ENST00000599643.5	202	310	+	108	0	-72	10024
Q96D53-1#6	0	36	36	Q96D53-1	50	86	+	36	Q96D53-1	0	110	ENST00000596357.1	42	372	++	203	Q96D53-1#6	0	108	ENST00000596357.1	192	300	+	108	0	-72	10025
Q96D53-1#6	0	36	36	Q96D53-1	50	86	+	36	Q96D53-1	0	544	ENST00000594720.6	38	1670	++	197	Q96D53-1#6	0	108	ENST00000594720.6	188	296	+	108	0	-72	10026
Q96D53-1#6	0	36	36	Q96D53-1	50	86	+	36	Q96D53-1	0	544	ENST00000594490.6	29	1583	++	196	Q96D53-1#6	0	108	ENST00000594490.6	179	287	+	108	0	-72	10027
Q96D53-1#6	0	36	36	Q96D53-1	50	86	+	36	Q96D53-1	0	157	ENST00000594084.5	121	592	++	195	Q96D53-1#6	0	108	ENST00000594084.5	271	379	+	108	0	-72	10028
Q96D53-1#6	0	36	36	Q96D53-1	50	86	+	36	Q96D53-1	0	544	ENST00000324464.8	303	1935	++	27	Q96D53-1#6	0	108	ENST00000324464.8	453	561	+	108	0	-72	10029
Q96D53-1#6	0	36	36	Q96D53-1	50	86	+	36	Q96D53-1	0	544	ENST00000243583.10	24	1533	++	3	Q96D53-1#6	0	108	ENST00000243583.10	174	282	+	108	0	-72	10030
Q96D53-1#7	0	1	1	Q96D53-1	366	367	+	1	Q96D53-1	0	544	ENST00000679130.1	149	1781	++	262	Q96D53-1#7	0	3	ENST00000679130.1	1247	1250	+	3	0	-2	10031
Q96D53-1#7	0	1	1	Q96D53-1	366	367	+	1	Q96D53-1	164	544	ENST00000679012.1	609	1749	++	260	Q96D53-1#7	0	3	ENST00000679012.1	1215	1218	+	3	0	-2	10032
Q96D53-1#7	0	1	1	Q96D53-1	366	367	+	1	Q96D53-1	0	544	ENST00000678467.1	117	1749	++	258	Q96D53-1#7	0	3	ENST00000678467.1	1215	1218	+	3	0	-2	10033
Q96D53-1#7	0	1	1	Q96D53-1	366	367	+	1	Q96D53-1	0	544	ENST00000678419.1	81	1713	++	257	Q96D53-1#7	0	3	ENST00000678419.1	1179	1182	+	3	0	-2	10034
Q96D53-1#7	0	1	1	Q96D53-1	366	367	+	1	Q96D53-1	0	544	ENST00000678404.1	295	1927	++	256	Q96D53-1#7	0	3	ENST00000678404.1	1393	1396	+	3	0	-2	10035
Q96D53-1#7	0	1	1	Q96D53-1	366	367	+	1	Q96D53-1	109	544	ENST00000677517.1	213	1518	++	251	Q96D53-1#7	0	3	ENST00000677517.1	984	987	+	3	0	-2	10036
Q96D53-1#7	0	1	1	Q96D53-1	366	367	+	1	Q96D53-1	109	544	ENST00000677496.1	217	1522	++	250	Q96D53-1#7	0	3	ENST00000677496.1	988	991	+	3	0	-2	10037
Q96D53-1#7	0	1	1	Q96D53-1	366	367	+	1	Q96D53-1	0	544	ENST00000677018.1	141	1773	++	249	Q96D53-1#7	0	3	ENST00000677018.1	1239	1242	+	3	0	-2	10038
Q96D53-1#7	0	1	1	Q96D53-1	366	367	+	1	Q96D53-1	0	381	ENST00000676555.1	101	1244	++	247	Q96D53-1#7	0	3	ENST00000676555.1	1199	1202	+	3	0	-2	10039
Q96D53-1#7	0	1	1	Q96D53-1	366	367	+	1	Q96D53-1	0	544	ENST00000601967.6	45	1677	++	217	Q96D53-1#7	0	3	ENST00000601967.6	1143	1146	+	3	0	-2	10040
Q96D53-1#7	0	1	1	Q96D53-1	366	367	+	1	Q96D53-1	0	544	ENST00000594720.6	38	1670	++	197	Q96D53-1#7	0	3	ENST00000594720.6	1136	1139	+	3	0	-2	10041
Q96D53-1#7	0	1	1	Q96D53-1	366	367	+	1	Q96D53-1	0	544	ENST00000594490.6	29	1583	++	196	Q96D53-1#7	0	3	ENST00000594490.6	1049	1052	+	3	0	-2	10042
Q96D53-1#7	0	1	1	Q96D53-1	366	367	+	1	Q96D53-1	0	544	ENST00000324464.8	303	1935	++	27	Q96D53-1#7	0	3	ENST00000324464.8	1401	1404	+	3	0	-2	10043
Q96D53-1#7	0	1	1	Q96D53-1	366	367	+	1	Q96D53-1	0	544	ENST00000243583.10	24	1533	++	3	Q96D53-1#7	0	3	ENST00000243583.10	999	1002	+	3	0	-2	10044
Q96D53-1#8	0	1	1	Q96D53-1	218	219	+	1	Q96D53-1	0	544	ENST00000679130.1	149	1781	++	262	Q96D53-1#8	0	3	ENST00000679130.1	803	806	+	3	0	-2	10045
Q96D53-1#8	0	1	1	Q96D53-1	218	219	+	1	Q96D53-1	164	544	ENST00000679012.1	609	1749	++	260	Q96D53-1#8	0	3	ENST00000679012.1	771	774	+	3	0	-2	10046
Q96D53-1#8	0	1	1	Q96D53-1	218	219	+	1	Q96D53-1	0	297	ENST00000678569.1	101	992	++	259	Q96D53-1#8	0	3	ENST00000678569.1	755	758	+	3	0	-2	10047
Q96D53-1#8	0	1	1	Q96D53-1	218	219	+	1	Q96D53-1	0	544	ENST00000678467.1	117	1749	++	258	Q96D53-1#8	0	3	ENST00000678467.1	771	774	+	3	0	-2	10048
Q96D53-1#8	0	1	1	Q96D53-1	218	219	+	1	Q96D53-1	0	544	ENST00000678419.1	81	1713	++	257	Q96D53-1#8	0	3	ENST00000678419.1	735	738	+	3	0	-2	10049
Q96D53-1#8	0	1	1	Q96D53-1	218	219	+	1	Q96D53-1	0	544	ENST00000678404.1	295	1927	++	256	Q96D53-1#8	0	3	ENST00000678404.1	949	952	+	3	0	-2	10050
Q96D53-1#8	0	1	1	Q96D53-1	218	219	+	1	Q96D53-1	109	544	ENST00000677517.1	213	1518	++	251	Q96D53-1#8	0	3	ENST00000677517.1	540	543	+	3	0	-2	10051
Q96D53-1#8	0	1	1	Q96D53-1	218	219	+	1	Q96D53-1	109	544	ENST00000677496.1	217	1522	++	250	Q96D53-1#8	0	3	ENST00000677496.1	544	547	+	3	0	-2	10052
Q96D53-1#8	0	1	1	Q96D53-1	218	219	+	1	Q96D53-1	0	544	ENST00000677018.1	141	1773	++	249	Q96D53-1#8	0	3	ENST00000677018.1	795	798	+	3	0	-2	10053
Q96D53-1#8	0	1	1	Q96D53-1	218	219	+	1	Q96D53-1	0	381	ENST00000676555.1	101	1244	++	247	Q96D53-1#8	0	3	ENST00000676555.1	755	758	+	3	0	-2	10054
Q96D53-1#8	0	1	1	Q96D53-1	218	219	+	1	Q96D53-1	0	544	ENST00000601967.6	45	1677	++	217	Q96D53-1#8	0	3	ENST00000601967.6	699	702	+	3	0	-2	10055
Q96D53-1#8	0	1	1	Q96D53-1	218	219	+	1	Q96D53-1	109	313	ENST00000595254.5	254	866	++	200	Q96D53-1#8	0	3	ENST00000595254.5	581	584	+	3	0	-2	10056
Q96D53-1#8	0	1	1	Q96D53-1	218	219	+	1	Q96D53-1	0	544	ENST00000594720.6	38	1670	++	197	Q96D53-1#8	0	3	ENST00000594720.6	692	695	+	3	0	-2	10057
Q96D53-1#8	0	1	1	Q96D53-1	218	219	+	1	Q96D53-1	0	544	ENST00000594490.6	29	1583	++	196	Q96D53-1#8	0	3	ENST00000594490.6	605	608	+	3	0	-2	10058
Q96D53-1#8	0	1	1	Q96D53-1	218	219	+	1	Q96D53-1	0	544	ENST00000324464.8	303	1935	++	27	Q96D53-1#8	0	3	ENST00000324464.8	957	960	+	3	0	-2	10059
Q96D53-1#8	0	1	1	Q96D53-1	218	219	+	1	Q96D53-1	0	544	ENST00000243583.10	24	1533	++	3	Q96D53-1#8	0	3	ENST00000243583.10	555	558	+	3	0	-2	10060
Q96D53-1#9	0	1	1	Q96D53-1	236	237	+	1	Q96D53-1	0	544	ENST00000679130.1	149	1781	++	262	Q96D53-1#9	0	3	ENST00000679130.1	857	860	+	3	0	-2	10061
Q96D53-1#9	0	1	1	Q96D53-1	236	237	+	1	Q96D53-1	164	544	ENST00000679012.1	609	1749	++	260	Q96D53-1#9	0	3	ENST00000679012.1	825	828	+	3	0	-2	10062
Q96D53-1#9	0	1	1	Q96D53-1	236	237	+	1	Q96D53-1	0	297	ENST00000678569.1	101	992	++	259	Q96D53-1#9	0	3	ENST00000678569.1	809	812	+	3	0	-2	10063
Q96D53-1#9	0	1	1	Q96D53-1	236	237	+	1	Q96D53-1	0	544	ENST00000678467.1	117	1749	++	258	Q96D53-1#9	0	3	ENST00000678467.1	825	828	+	3	0	-2	10064
Q96D53-1#9	0	1	1	Q96D53-1	236	237	+	1	Q96D53-1	0	544	ENST00000678419.1	81	1713	++	257	Q96D53-1#9	0	3	ENST00000678419.1	789	792	+	3	0	-2	10065
Q96D53-1#9	0	1	1	Q96D53-1	236	237	+	1	Q96D53-1	0	544	ENST00000678404.1	295	1927	++	256	Q96D53-1#9	0	3	ENST00000678404.1	1003	1006	+	3	0	-2	10066
Q96D53-1#9	0	1	1	Q96D53-1	236	237	+	1	Q96D53-1	109	544	ENST00000677517.1	213	1518	++	251	Q96D53-1#9	0	3	ENST00000677517.1	594	597	+	3	0	-2	10067
Q96D53-1#9	0	1	1	Q96D53-1	236	237	+	1	Q96D53-1	109	544	ENST00000677496.1	217	1522	++	250	Q96D53-1#9	0	3	ENST00000677496.1	598	601	+	3	0	-2	10068
Q96D53-1#9	0	1	1	Q96D53-1	236	237	+	1	Q96D53-1	0	544	ENST00000677018.1	141	1773	++	249	Q96D53-1#9	0	3	ENST00000677018.1	849	852	+	3	0	-2	10069
Q96D53-1#9	0	1	1	Q96D53-1	236	237	+	1	Q96D53-1	0	381	ENST00000676555.1	101	1244	++	247	Q96D53-1#9	0	3	ENST00000676555.1	809	812	+	3	0	-2	10070
Q96D53-1#9	0	1	1	Q96D53-1	236	237	+	1	Q96D53-1	0	544	ENST00000601967.6	45	1677	++	217	Q96D53-1#9	0	3	ENST00000601967.6	753	756	+	3	0	-2	10071
Q96D53-1#9	0	1	1	Q96D53-1	236	237	+	1	Q96D53-1	109	313	ENST00000595254.5	254	866	++	200	Q96D53-1#9	0	3	ENST00000595254.5	635	638	+	3	0	-2	10072
Q96D53-1#9	0	1	1	Q96D53-1	236	237	+	1	Q96D53-1	0	544	ENST00000594720.6	38	1670	++	197	Q96D53-1#9	0	3	ENST00000594720.6	746	749	+	3	0	-2	10073
Q96D53-1#9	0	1	1	Q96D53-1	236	237	+	1	Q96D53-1	0	544	ENST00000594490.6	29	1583	++	196	Q96D53-1#9	0	3	ENST00000594490.6	659	662	+	3	0	-2	10074
Q96D53-1#9	0	1	1	Q96D53-1	236	237	+	1	Q96D53-1	0	544	ENST00000324464.8	303	1935	++	27	Q96D53-1#9	0	3	ENST00000324464.8	1011	1014	+	3	0	-2	10075
Q96D53-1#9	0	1	1	Q96D53-1	236	237	+	1	Q96D53-1	0	544	ENST00000243583.10	24	1533	++	3	Q96D53-1#9	0	3	ENST00000243583.10	609	612	+	3	0	-2	10076
Q96D53-1#10	0	4	4	Q96D53-1	323	327	+	4	Q96D53-1	0	544	ENST00000679130.1	149	1781	++	262	Q96D53-1#10	0	12	ENST00000679130.1	1118	1130	+	12	0	-8	10077
Q96D53-1#10	0	4	4	Q96D53-1	323	327	+	4	Q96D53-1	164	544	ENST00000679012.1	609	1749	++	260	Q96D53-1#10	0	12	ENST00000679012.1	1086	1098	+	12	0	-8	10078
Q96D53-1#10	0	4	4	Q96D53-1	323	327	+	4	Q96D53-1	0	544	ENST00000678467.1	117	1749	++	258	Q96D53-1#10	0	12	ENST00000678467.1	1086	1098	+	12	0	-8	10079
Q96D53-1#10	0	4	4	Q96D53-1	323	327	+	4	Q96D53-1	0	544	ENST00000678419.1	81	1713	++	257	Q96D53-1#10	0	12	ENST00000678419.1	1050	1062	+	12	0	-8	10080
Q96D53-1#10	0	4	4	Q96D53-1	323	327	+	4	Q96D53-1	0	544	ENST00000678404.1	295	1927	++	256	Q96D53-1#10	0	12	ENST00000678404.1	1264	1276	+	12	0	-8	10081
Q96D53-1#10	0	4	4	Q96D53-1	323	327	+	4	Q96D53-1	109	544	ENST00000677517.1	213	1518	++	251	Q96D53-1#10	0	12	ENST00000677517.1	855	867	+	12	0	-8	10082
Q96D53-1#10	0	4	4	Q96D53-1	323	327	+	4	Q96D53-1	109	544	ENST00000677496.1	217	1522	++	250	Q96D53-1#10	0	12	ENST00000677496.1	859	871	+	12	0	-8	10083
Q96D53-1#10	0	4	4	Q96D53-1	323	327	+	4	Q96D53-1	0	544	ENST00000677018.1	141	1773	++	249	Q96D53-1#10	0	12	ENST00000677018.1	1110	1122	+	12	0	-8	10084
Q96D53-1#10	0	4	4	Q96D53-1	323	327	+	4	Q96D53-1	0	381	ENST00000676555.1	101	1244	++	247	Q96D53-1#10	0	12	ENST00000676555.1	1070	1082	+	12	0	-8	10085
Q96D53-1#10	0	4	4	Q96D53-1	323	327	+	4	Q96D53-1	0	544	ENST00000601967.6	45	1677	++	217	Q96D53-1#10	0	12	ENST00000601967.6	1014	1026	+	12	0	-8	10086
Q96D53-1#10	0	4	4	Q96D53-1	323	327	+	4	Q96D53-1	0	544	ENST00000594720.6	38	1670	++	197	Q96D53-1#10	0	12	ENST00000594720.6	1007	1019	+	12	0	-8	10087
Q96D53-1#10	0	4	4	Q96D53-1	323	327	+	4	Q96D53-1	0	544	ENST00000594490.6	29	1583	++	196	Q96D53-1#10	0	12	ENST00000594490.6	920	932	+	12	0	-8	10088
Q96D53-1#10	0	4	4	Q96D53-1	323	327	+	4	Q96D53-1	0	544	ENST00000324464.8	303	1935	++	27	Q96D53-1#10	0	12	ENST00000324464.8	1272	1284	+	12	0	-8	10089
Q96D53-1#10	0	4	4	Q96D53-1	323	327	+	4	Q96D53-1	0	544	ENST00000243583.10	24	1533	++	3	Q96D53-1#10	0	12	ENST00000243583.10	870	882	+	12	0	-8	10090
Q96D53-1#11	0	1	1	Q96D53-1	371	372	+	1	Q96D53-1	0	544	ENST00000679130.1	149	1781	++	262	Q96D53-1#11	0	3	ENST00000679130.1	1262	1265	+	3	0	-2	10091
Q96D53-1#11	0	1	1	Q96D53-1	371	372	+	1	Q96D53-1	164	544	ENST00000679012.1	609	1749	++	260	Q96D53-1#11	0	3	ENST00000679012.1	1230	1233	+	3	0	-2	10092
Q96D53-1#11	0	1	1	Q96D53-1	371	372	+	1	Q96D53-1	0	544	ENST00000678467.1	117	1749	++	258	Q96D53-1#11	0	3	ENST00000678467.1	1230	1233	+	3	0	-2	10093
Q96D53-1#11	0	1	1	Q96D53-1	371	372	+	1	Q96D53-1	0	544	ENST00000678419.1	81	1713	++	257	Q96D53-1#11	0	3	ENST00000678419.1	1194	1197	+	3	0	-2	10094
Q96D53-1#11	0	1	1	Q96D53-1	371	372	+	1	Q96D53-1	0	544	ENST00000678404.1	295	1927	++	256	Q96D53-1#11	0	3	ENST00000678404.1	1408	1411	+	3	0	-2	10095
Q96D53-1#11	0	1	1	Q96D53-1	371	372	+	1	Q96D53-1	109	544	ENST00000677517.1	213	1518	++	251	Q96D53-1#11	0	3	ENST00000677517.1	999	1002	+	3	0	-2	10096
Q96D53-1#11	0	1	1	Q96D53-1	371	372	+	1	Q96D53-1	109	544	ENST00000677496.1	217	1522	++	250	Q96D53-1#11	0	3	ENST00000677496.1	1003	1006	+	3	0	-2	10097
Q96D53-1#11	0	1	1	Q96D53-1	371	372	+	1	Q96D53-1	0	544	ENST00000677018.1	141	1773	++	249	Q96D53-1#11	0	3	ENST00000677018.1	1254	1257	+	3	0	-2	10098
Q96D53-1#11	0	1	1	Q96D53-1	371	372	+	1	Q96D53-1	0	381	ENST00000676555.1	101	1244	++	247	Q96D53-1#11	0	3	ENST00000676555.1	1214	1217	+	3	0	-2	10099
Q96D53-1#11	0	1	1	Q96D53-1	371	372	+	1	Q96D53-1	0	544	ENST00000601967.6	45	1677	++	217	Q96D53-1#11	0	3	ENST00000601967.6	1158	1161	+	3	0	-2	10100
Q96D53-1#11	0	1	1	Q96D53-1	371	372	+	1	Q96D53-1	0	544	ENST00000594720.6	38	1670	++	197	Q96D53-1#11	0	3	ENST00000594720.6	1151	1154	+	3	0	-2	10101
Q96D53-1#11	0	1	1	Q96D53-1	371	372	+	1	Q96D53-1	0	544	ENST00000594490.6	29	1583	++	196	Q96D53-1#11	0	3	ENST00000594490.6	1064	1067	+	3	0	-2	10102
Q96D53-1#11	0	1	1	Q96D53-1	371	372	+	1	Q96D53-1	0	544	ENST00000324464.8	303	1935	++	27	Q96D53-1#11	0	3	ENST00000324464.8	1416	1419	+	3	0	-2	10103
Q96D53-1#11	0	1	1	Q96D53-1	371	372	+	1	Q96D53-1	0	544	ENST00000243583.10	24	1533	++	3	Q96D53-1#11	0	3	ENST00000243583.10	1014	1017	+	3	0	-2	10104
Q96D53-1#12	0	1	1	Q96D53-1	385	386	+	1	Q96D53-1	0	544	ENST00000679130.1	149	1781	++	262	Q96D53-1#12	0	3	ENST00000679130.1	1304	1307	+	3	0	-2	10105
Q96D53-1#12	0	1	1	Q96D53-1	385	386	+	1	Q96D53-1	164	544	ENST00000679012.1	609	1749	++	260	Q96D53-1#12	0	3	ENST00000679012.1	1272	1275	+	3	0	-2	10106
Q96D53-1#12	0	1	1	Q96D53-1	385	386	+	1	Q96D53-1	0	544	ENST00000678467.1	117	1749	++	258	Q96D53-1#12	0	3	ENST00000678467.1	1272	1275	+	3	0	-2	10107
Q96D53-1#12	0	1	1	Q96D53-1	385	386	+	1	Q96D53-1	0	544	ENST00000678419.1	81	1713	++	257	Q96D53-1#12	0	3	ENST00000678419.1	1236	1239	+	3	0	-2	10108
Q96D53-1#12	0	1	1	Q96D53-1	385	386	+	1	Q96D53-1	0	544	ENST00000678404.1	295	1927	++	256	Q96D53-1#12	0	3	ENST00000678404.1	1450	1453	+	3	0	-2	10109
Q96D53-1#12	0	1	1	Q96D53-1	385	386	+	1	Q96D53-1	109	544	ENST00000677517.1	213	1518	++	251	Q96D53-1#12	0	3	ENST00000677517.1	1041	1044	+	3	0	-2	10110
Q96D53-1#12	0	1	1	Q96D53-1	385	386	+	1	Q96D53-1	109	544	ENST00000677496.1	217	1522	++	250	Q96D53-1#12	0	3	ENST00000677496.1	1045	1048	+	3	0	-2	10111
Q96D53-1#12	0	1	1	Q96D53-1	385	386	+	1	Q96D53-1	0	544	ENST00000677018.1	141	1773	++	249	Q96D53-1#12	0	3	ENST00000677018.1	1296	1299	+	3	0	-2	10112
Q96D53-1#12	0	1	1	Q96D53-1	385	386	+	1	Q96D53-1	0	544	ENST00000601967.6	45	1677	++	217	Q96D53-1#12	0	3	ENST00000601967.6	1200	1203	+	3	0	-2	10113
Q96D53-1#12	0	1	1	Q96D53-1	385	386	+	1	Q96D53-1	0	544	ENST00000594720.6	38	1670	++	197	Q96D53-1#12	0	3	ENST00000594720.6	1193	1196	+	3	0	-2	10114
Q96D53-1#12	0	1	1	Q96D53-1	385	386	+	1	Q96D53-1	0	544	ENST00000594490.6	29	1583	++	196	Q96D53-1#12	0	3	ENST00000594490.6	1106	1109	+	3	0	-2	10115
Q96D53-1#12	0	1	1	Q96D53-1	385	386	+	1	Q96D53-1	0	544	ENST00000324464.8	303	1935	++	27	Q96D53-1#12	0	3	ENST00000324464.8	1458	1461	+	3	0	-2	10116
Q96D53-1#12	0	1	1	Q96D53-1	385	386	+	1	Q96D53-1	0	544	ENST00000243583.10	24	1533	++	3	Q96D53-1#12	0	3	ENST00000243583.10	1056	1059	+	3	0	-2	10117
Q96D53-1#13	0	41	41	Q96D53-1	122	163	+	41	Q96D53-1	0	544	ENST00000679130.1	149	1781	++	262	Q96D53-1#13	0	123	ENST00000679130.1	515	638	+	123	0	-82	10118
Q96D53-1#13	0	41	41	Q96D53-1	122	163	+	41	Q96D53-1	109	169	ENST00000679070.1	229	409	++	261	Q96D53-1#13	0	123	ENST00000679070.1	268	391	+	123	0	-82	10119
Q96D53-1#13	0	41	41	Q96D53-1	122	163	+	41	Q96D53-1	0	297	ENST00000678569.1	101	992	++	259	Q96D53-1#13	0	123	ENST00000678569.1	467	590	+	123	0	-82	10120
Q96D53-1#13	0	41	41	Q96D53-1	122	163	+	41	Q96D53-1	0	544	ENST00000678467.1	117	1749	++	258	Q96D53-1#13	0	123	ENST00000678467.1	483	606	+	123	0	-82	10121
Q96D53-1#13	0	41	41	Q96D53-1	122	163	+	41	Q96D53-1	0	544	ENST00000678419.1	81	1713	++	257	Q96D53-1#13	0	123	ENST00000678419.1	447	570	+	123	0	-82	10122
Q96D53-1#13	0	41	41	Q96D53-1	122	163	+	41	Q96D53-1	0	544	ENST00000678404.1	295	1927	++	256	Q96D53-1#13	0	123	ENST00000678404.1	661	784	+	123	0	-82	10123
Q96D53-1#13	0	41	41	Q96D53-1	122	163	+	41	Q96D53-1	0	155	ENST00000678316.1	139	604	++	255	Q96D53-1#13	0	99	ENST00000678316.1	505	604	+	99	0	-58	10124
Q96D53-1#13	0	41	41	Q96D53-1	122	163	+	41	Q96D53-1	0	169	ENST00000677633.1	120	627	++	252	Q96D53-1#13	0	123	ENST00000677633.1	486	609	+	123	0	-82	10125
Q96D53-1#13	0	41	41	Q96D53-1	122	163	+	41	Q96D53-1	109	544	ENST00000677517.1	213	1518	++	251	Q96D53-1#13	0	123	ENST00000677517.1	252	375	+	123	0	-82	10126
Q96D53-1#13	0	41	41	Q96D53-1	122	163	+	41	Q96D53-1	109	544	ENST00000677496.1	217	1522	++	250	Q96D53-1#13	0	123	ENST00000677496.1	256	379	+	123	0	-82	10127
Q96D53-1#13	0	41	41	Q96D53-1	122	163	+	41	Q96D53-1	0	544	ENST00000677018.1	141	1773	++	249	Q96D53-1#13	0	123	ENST00000677018.1	507	630	+	123	0	-82	10128
Q96D53-1#13	0	41	41	Q96D53-1	122	163	+	41	Q96D53-1	0	381	ENST00000676555.1	101	1244	++	247	Q96D53-1#13	0	123	ENST00000676555.1	467	590	+	123	0	-82	10129
Q96D53-1#13	0	41	41	Q96D53-1	122	163	+	41	Q96D53-1	0	544	ENST00000601967.6	45	1677	++	217	Q96D53-1#13	0	123	ENST00000601967.6	411	534	+	123	0	-82	10130
Q96D53-1#13	0	41	41	Q96D53-1	122	163	+	41	Q96D53-1	109	169	ENST00000600080.5	253	433	++	209	Q96D53-1#13	0	123	ENST00000600080.5	292	415	+	123	0	-82	10131
Q96D53-1#13	0	41	41	Q96D53-1	122	163	+	41	Q96D53-1	109	313	ENST00000595254.5	254	866	++	200	Q96D53-1#13	0	123	ENST00000595254.5	293	416	+	123	0	-82	10132
Q96D53-1#13	0	41	41	Q96D53-1	122	163	+	41	Q96D53-1	0	544	ENST00000594720.6	38	1670	++	197	Q96D53-1#13	0	123	ENST00000594720.6	404	527	+	123	0	-82	10133
Q96D53-1#13	0	41	41	Q96D53-1	122	163	+	41	Q96D53-1	0	544	ENST00000594490.6	29	1583	++	196	Q96D53-1#13	0	123	ENST00000594490.6	317	440	+	123	0	-82	10134
Q96D53-1#13	0	41	41	Q96D53-1	122	163	+	41	Q96D53-1	0	157	ENST00000594084.5	121	592	++	195	Q96D53-1#13	0	105	ENST00000594084.5	487	592	+	105	0	-64	10135
Q96D53-1#13	0	41	41	Q96D53-1	122	163	+	41	Q96D53-1	0	544	ENST00000324464.8	303	1935	++	27	Q96D53-1#13	0	123	ENST00000324464.8	669	792	+	123	0	-82	10136
Q96D53-1#14	0	1	1	Q96D53-1	77	78	+	1	Q96D53-1	0	544	ENST00000679130.1	149	1781	++	262	Q96D53-1#14	0	3	ENST00000679130.1	380	383	+	3	0	-2	10137
Q96D53-1#14	0	1	1	Q96D53-1	77	78	+	1	Q96D53-1	0	297	ENST00000678569.1	101	992	++	259	Q96D53-1#14	0	3	ENST00000678569.1	332	335	+	3	0	-2	10138
Q96D53-1#14	0	1	1	Q96D53-1	77	78	+	1	Q96D53-1	0	544	ENST00000678467.1	117	1749	++	258	Q96D53-1#14	0	3	ENST00000678467.1	348	351	+	3	0	-2	10139
Q96D53-1#14	0	1	1	Q96D53-1	77	78	+	1	Q96D53-1	0	544	ENST00000678419.1	81	1713	++	257	Q96D53-1#14	0	3	ENST00000678419.1	312	315	+	3	0	-2	10140
Q96D53-1#14	0	1	1	Q96D53-1	77	78	+	1	Q96D53-1	0	544	ENST00000678404.1	295	1927	++	256	Q96D53-1#14	0	3	ENST00000678404.1	526	529	+	3	0	-2	10141
Q96D53-1#14	0	1	1	Q96D53-1	77	78	+	1	Q96D53-1	0	155	ENST00000678316.1	139	604	++	255	Q96D53-1#14	0	3	ENST00000678316.1	370	373	+	3	0	-2	10142
Q96D53-1#14	0	1	1	Q96D53-1	77	78	+	1	Q96D53-1	0	122	ENST00000677800.1	25	391	++	253	Q96D53-1#14	0	3	ENST00000677800.1	256	259	+	3	0	-2	10143
Q96D53-1#14	0	1	1	Q96D53-1	77	78	+	1	Q96D53-1	0	169	ENST00000677633.1	120	627	++	252	Q96D53-1#14	0	3	ENST00000677633.1	351	354	+	3	0	-2	10144
Q96D53-1#14	0	1	1	Q96D53-1	77	78	+	1	Q96D53-1	0	544	ENST00000677018.1	141	1773	++	249	Q96D53-1#14	0	3	ENST00000677018.1	372	375	+	3	0	-2	10145
Q96D53-1#14	0	1	1	Q96D53-1	77	78	+	1	Q96D53-1	0	100	ENST00000676578.1	78	375	++	248	Q96D53-1#14	0	3	ENST00000676578.1	309	312	+	3	0	-2	10146
Q96D53-1#14	0	1	1	Q96D53-1	77	78	+	1	Q96D53-1	0	381	ENST00000676555.1	101	1244	++	247	Q96D53-1#14	0	3	ENST00000676555.1	332	335	+	3	0	-2	10147
Q96D53-1#14	0	1	1	Q96D53-1	77	78	+	1	Q96D53-1	0	544	ENST00000601967.6	45	1677	++	217	Q96D53-1#14	0	3	ENST00000601967.6	276	279	+	3	0	-2	10148
Q96D53-1#14	0	1	1	Q96D53-1	77	78	+	1	Q96D53-1	0	121	ENST00000600707.5	30	393	++	210	Q96D53-1#14	0	3	ENST00000600707.5	261	264	+	3	0	-2	10149
Q96D53-1#14	0	1	1	Q96D53-1	77	78	+	1	Q96D53-1	0	87	ENST00000599643.5	52	313	++	207	Q96D53-1#14	0	3	ENST00000599643.5	283	286	+	3	0	-2	10150
Q96D53-1#14	0	1	1	Q96D53-1	77	78	+	1	Q96D53-1	0	110	ENST00000596357.1	42	372	++	203	Q96D53-1#14	0	3	ENST00000596357.1	273	276	+	3	0	-2	10151
Q96D53-1#14	0	1	1	Q96D53-1	77	78	+	1	Q96D53-1	0	544	ENST00000594720.6	38	1670	++	197	Q96D53-1#14	0	3	ENST00000594720.6	269	272	+	3	0	-2	10152
Q96D53-1#14	0	1	1	Q96D53-1	77	78	+	1	Q96D53-1	0	544	ENST00000594490.6	29	1583	++	196	Q96D53-1#14	0	3	ENST00000594490.6	260	263	+	3	0	-2	10153
Q96D53-1#14	0	1	1	Q96D53-1	77	78	+	1	Q96D53-1	0	157	ENST00000594084.5	121	592	++	195	Q96D53-1#14	0	3	ENST00000594084.5	352	355	+	3	0	-2	10154
Q96D53-1#14	0	1	1	Q96D53-1	77	78	+	1	Q96D53-1	0	544	ENST00000324464.8	303	1935	++	27	Q96D53-1#14	0	3	ENST00000324464.8	534	537	+	3	0	-2	10155
Q96D53-1#14	0	1	1	Q96D53-1	77	78	+	1	Q96D53-1	0	544	ENST00000243583.10	24	1533	++	3	Q96D53-1#14	0	3	ENST00000243583.10	255	258	+	3	0	-2	10156
Q96D53-1#15	0	1	1	Q96D53-1	97	98	+	1	Q96D53-1	0	544	ENST00000679130.1	149	1781	++	262	Q96D53-1#15	0	3	ENST00000679130.1	440	443	+	3	0	-2	10157
Q96D53-1#15	0	1	1	Q96D53-1	97	98	+	1	Q96D53-1	0	297	ENST00000678569.1	101	992	++	259	Q96D53-1#15	0	3	ENST00000678569.1	392	395	+	3	0	-2	10158
Q96D53-1#15	0	1	1	Q96D53-1	97	98	+	1	Q96D53-1	0	544	ENST00000678467.1	117	1749	++	258	Q96D53-1#15	0	3	ENST00000678467.1	408	411	+	3	0	-2	10159
Q96D53-1#15	0	1	1	Q96D53-1	97	98	+	1	Q96D53-1	0	544	ENST00000678419.1	81	1713	++	257	Q96D53-1#15	0	3	ENST00000678419.1	372	375	+	3	0	-2	10160
Q96D53-1#15	0	1	1	Q96D53-1	97	98	+	1	Q96D53-1	0	544	ENST00000678404.1	295	1927	++	256	Q96D53-1#15	0	3	ENST00000678404.1	586	589	+	3	0	-2	10161
Q96D53-1#15	0	1	1	Q96D53-1	97	98	+	1	Q96D53-1	0	155	ENST00000678316.1	139	604	++	255	Q96D53-1#15	0	3	ENST00000678316.1	430	433	+	3	0	-2	10162
Q96D53-1#15	0	1	1	Q96D53-1	97	98	+	1	Q96D53-1	0	122	ENST00000677800.1	25	391	++	253	Q96D53-1#15	0	3	ENST00000677800.1	316	319	+	3	0	-2	10163
Q96D53-1#15	0	1	1	Q96D53-1	97	98	+	1	Q96D53-1	0	169	ENST00000677633.1	120	627	++	252	Q96D53-1#15	0	3	ENST00000677633.1	411	414	+	3	0	-2	10164
Q96D53-1#15	0	1	1	Q96D53-1	97	98	+	1	Q96D53-1	0	544	ENST00000677018.1	141	1773	++	249	Q96D53-1#15	0	3	ENST00000677018.1	432	435	+	3	0	-2	10165
Q96D53-1#15	0	1	1	Q96D53-1	97	98	+	1	Q96D53-1	0	100	ENST00000676578.1	78	375	++	248	Q96D53-1#15	0	3	ENST00000676578.1	366	369	+	3	0	-2	10166
Q96D53-1#15	0	1	1	Q96D53-1	97	98	+	1	Q96D53-1	0	381	ENST00000676555.1	101	1244	++	247	Q96D53-1#15	0	3	ENST00000676555.1	392	395	+	3	0	-2	10167
Q96D53-1#15	0	1	1	Q96D53-1	97	98	+	1	Q96D53-1	0	544	ENST00000601967.6	45	1677	++	217	Q96D53-1#15	0	3	ENST00000601967.6	336	339	+	3	0	-2	10168
Q96D53-1#15	0	1	1	Q96D53-1	97	98	+	1	Q96D53-1	0	121	ENST00000600707.5	30	393	++	210	Q96D53-1#15	0	3	ENST00000600707.5	321	324	+	3	0	-2	10169
Q96D53-1#15	0	1	1	Q96D53-1	97	98	+	1	Q96D53-1	0	110	ENST00000596357.1	42	372	++	203	Q96D53-1#15	0	3	ENST00000596357.1	333	336	+	3	0	-2	10170
Q96D53-1#15	0	1	1	Q96D53-1	97	98	+	1	Q96D53-1	0	544	ENST00000594720.6	38	1670	++	197	Q96D53-1#15	0	3	ENST00000594720.6	329	332	+	3	0	-2	10171
Q96D53-1#15	0	1	1	Q96D53-1	97	98	+	1	Q96D53-1	0	157	ENST00000594084.5	121	592	++	195	Q96D53-1#15	0	3	ENST00000594084.5	412	415	+	3	0	-2	10172
Q96D53-1#15	0	1	1	Q96D53-1	97	98	+	1	Q96D53-1	0	544	ENST00000324464.8	303	1935	++	27	Q96D53-1#15	0	3	ENST00000324464.8	594	597	+	3	0	-2	10173
Q96D53-1#15	0	1	1	Q96D53-1	97	98	+	1	Q96D53-1	0	544	ENST00000243583.10	24	1533	++	3	Q96D53-1#15	0	3	ENST00000243583.10	315	318	+	3	0	-2	10174
Q96D53-1#16	0	1	1	Q96D53-1	173	174	+	1	Q96D53-1	0	544	ENST00000679130.1	149	1781	++	262	Q96D53-1#16	0	3	ENST00000679130.1	668	671	+	3	0	-2	10175
Q96D53-1#16	0	1	1	Q96D53-1	173	174	+	1	Q96D53-1	164	544	ENST00000679012.1	609	1749	++	260	Q96D53-1#16	0	3	ENST00000679012.1	636	639	+	3	0	-2	10176
Q96D53-1#16	0	1	1	Q96D53-1	173	174	+	1	Q96D53-1	0	297	ENST00000678569.1	101	992	++	259	Q96D53-1#16	0	3	ENST00000678569.1	620	623	+	3	0	-2	10177
Q96D53-1#16	0	1	1	Q96D53-1	173	174	+	1	Q96D53-1	0	544	ENST00000678467.1	117	1749	++	258	Q96D53-1#16	0	3	ENST00000678467.1	636	639	+	3	0	-2	10178
Q96D53-1#16	0	1	1	Q96D53-1	173	174	+	1	Q96D53-1	0	544	ENST00000678419.1	81	1713	++	257	Q96D53-1#16	0	3	ENST00000678419.1	600	603	+	3	0	-2	10179
Q96D53-1#16	0	1	1	Q96D53-1	173	174	+	1	Q96D53-1	0	544	ENST00000678404.1	295	1927	++	256	Q96D53-1#16	0	3	ENST00000678404.1	814	817	+	3	0	-2	10180
Q96D53-1#16	0	1	1	Q96D53-1	173	174	+	1	Q96D53-1	109	544	ENST00000677517.1	213	1518	++	251	Q96D53-1#16	0	3	ENST00000677517.1	405	408	+	3	0	-2	10181
Q96D53-1#16	0	1	1	Q96D53-1	173	174	+	1	Q96D53-1	109	544	ENST00000677496.1	217	1522	++	250	Q96D53-1#16	0	3	ENST00000677496.1	409	412	+	3	0	-2	10182
Q96D53-1#16	0	1	1	Q96D53-1	173	174	+	1	Q96D53-1	0	544	ENST00000677018.1	141	1773	++	249	Q96D53-1#16	0	3	ENST00000677018.1	660	663	+	3	0	-2	10183
Q96D53-1#16	0	1	1	Q96D53-1	173	174	+	1	Q96D53-1	0	381	ENST00000676555.1	101	1244	++	247	Q96D53-1#16	0	3	ENST00000676555.1	620	623	+	3	0	-2	10184
Q96D53-1#16	0	1	1	Q96D53-1	173	174	+	1	Q96D53-1	0	544	ENST00000601967.6	45	1677	++	217	Q96D53-1#16	0	3	ENST00000601967.6	564	567	+	3	0	-2	10185
Q96D53-1#16	0	1	1	Q96D53-1	173	174	+	1	Q96D53-1	109	313	ENST00000595254.5	254	866	++	200	Q96D53-1#16	0	3	ENST00000595254.5	446	449	+	3	0	-2	10186
Q96D53-1#16	0	1	1	Q96D53-1	173	174	+	1	Q96D53-1	0	544	ENST00000594720.6	38	1670	++	197	Q96D53-1#16	0	3	ENST00000594720.6	557	560	+	3	0	-2	10187
Q96D53-1#16	0	1	1	Q96D53-1	173	174	+	1	Q96D53-1	0	544	ENST00000594490.6	29	1583	++	196	Q96D53-1#16	0	3	ENST00000594490.6	470	473	+	3	0	-2	10188
Q96D53-1#16	0	1	1	Q96D53-1	173	174	+	1	Q96D53-1	0	544	ENST00000324464.8	303	1935	++	27	Q96D53-1#16	0	3	ENST00000324464.8	822	825	+	3	0	-2	10189
Q96D53-1#16	0	1	1	Q96D53-1	173	174	+	1	Q96D53-1	0	544	ENST00000243583.10	24	1533	++	3	Q96D53-1#16	0	3	ENST00000243583.10	420	423	+	3	0	-2	10190
Q96D53-1#17	0	1	1	Q96D53-1	177	178	+	1	Q96D53-1	0	544	ENST00000679130.1	149	1781	++	262	Q96D53-1#17	0	3	ENST00000679130.1	680	683	+	3	0	-2	10191
Q96D53-1#17	0	1	1	Q96D53-1	177	178	+	1	Q96D53-1	164	544	ENST00000679012.1	609	1749	++	260	Q96D53-1#17	0	3	ENST00000679012.1	648	651	+	3	0	-2	10192
Q96D53-1#17	0	1	1	Q96D53-1	177	178	+	1	Q96D53-1	0	297	ENST00000678569.1	101	992	++	259	Q96D53-1#17	0	3	ENST00000678569.1	632	635	+	3	0	-2	10193
Q96D53-1#17	0	1	1	Q96D53-1	177	178	+	1	Q96D53-1	0	544	ENST00000678467.1	117	1749	++	258	Q96D53-1#17	0	3	ENST00000678467.1	648	651	+	3	0	-2	10194
Q96D53-1#17	0	1	1	Q96D53-1	177	178	+	1	Q96D53-1	0	544	ENST00000678419.1	81	1713	++	257	Q96D53-1#17	0	3	ENST00000678419.1	612	615	+	3	0	-2	10195
Q96D53-1#17	0	1	1	Q96D53-1	177	178	+	1	Q96D53-1	0	544	ENST00000678404.1	295	1927	++	256	Q96D53-1#17	0	3	ENST00000678404.1	826	829	+	3	0	-2	10196
Q96D53-1#17	0	1	1	Q96D53-1	177	178	+	1	Q96D53-1	109	544	ENST00000677517.1	213	1518	++	251	Q96D53-1#17	0	3	ENST00000677517.1	417	420	+	3	0	-2	10197
Q96D53-1#17	0	1	1	Q96D53-1	177	178	+	1	Q96D53-1	109	544	ENST00000677496.1	217	1522	++	250	Q96D53-1#17	0	3	ENST00000677496.1	421	424	+	3	0	-2	10198
Q96D53-1#17	0	1	1	Q96D53-1	177	178	+	1	Q96D53-1	0	544	ENST00000677018.1	141	1773	++	249	Q96D53-1#17	0	3	ENST00000677018.1	672	675	+	3	0	-2	10199
Q96D53-1#17	0	1	1	Q96D53-1	177	178	+	1	Q96D53-1	0	381	ENST00000676555.1	101	1244	++	247	Q96D53-1#17	0	3	ENST00000676555.1	632	635	+	3	0	-2	10200
Q96D53-1#17	0	1	1	Q96D53-1	177	178	+	1	Q96D53-1	0	544	ENST00000601967.6	45	1677	++	217	Q96D53-1#17	0	3	ENST00000601967.6	576	579	+	3	0	-2	10201
Q96D53-1#17	0	1	1	Q96D53-1	177	178	+	1	Q96D53-1	109	313	ENST00000595254.5	254	866	++	200	Q96D53-1#17	0	3	ENST00000595254.5	458	461	+	3	0	-2	10202
Q96D53-1#17	0	1	1	Q96D53-1	177	178	+	1	Q96D53-1	0	544	ENST00000594720.6	38	1670	++	197	Q96D53-1#17	0	3	ENST00000594720.6	569	572	+	3	0	-2	10203
Q96D53-1#17	0	1	1	Q96D53-1	177	178	+	1	Q96D53-1	0	544	ENST00000594490.6	29	1583	++	196	Q96D53-1#17	0	3	ENST00000594490.6	482	485	+	3	0	-2	10204
Q96D53-1#17	0	1	1	Q96D53-1	177	178	+	1	Q96D53-1	0	544	ENST00000324464.8	303	1935	++	27	Q96D53-1#17	0	3	ENST00000324464.8	834	837	+	3	0	-2	10205
Q96D53-1#17	0	1	1	Q96D53-1	177	178	+	1	Q96D53-1	0	544	ENST00000243583.10	24	1533	++	3	Q96D53-1#17	0	3	ENST00000243583.10	432	435	+	3	0	-2	10206
Q96D53-1#18	0	1	1	Q96D53-1	285	286	+	1	Q96D53-1	0	544	ENST00000679130.1	149	1781	++	262	Q96D53-1#18	0	3	ENST00000679130.1	1004	1007	+	3	0	-2	10207
Q96D53-1#18	0	1	1	Q96D53-1	285	286	+	1	Q96D53-1	164	544	ENST00000679012.1	609	1749	++	260	Q96D53-1#18	0	3	ENST00000679012.1	972	975	+	3	0	-2	10208
Q96D53-1#18	0	1	1	Q96D53-1	285	286	+	1	Q96D53-1	0	297	ENST00000678569.1	101	992	++	259	Q96D53-1#18	0	3	ENST00000678569.1	956	959	+	3	0	-2	10209
Q96D53-1#18	0	1	1	Q96D53-1	285	286	+	1	Q96D53-1	0	544	ENST00000678467.1	117	1749	++	258	Q96D53-1#18	0	3	ENST00000678467.1	972	975	+	3	0	-2	10210
Q96D53-1#18	0	1	1	Q96D53-1	285	286	+	1	Q96D53-1	0	544	ENST00000678419.1	81	1713	++	257	Q96D53-1#18	0	3	ENST00000678419.1	936	939	+	3	0	-2	10211
Q96D53-1#18	0	1	1	Q96D53-1	285	286	+	1	Q96D53-1	0	544	ENST00000678404.1	295	1927	++	256	Q96D53-1#18	0	3	ENST00000678404.1	1150	1153	+	3	0	-2	10212
Q96D53-1#18	0	1	1	Q96D53-1	285	286	+	1	Q96D53-1	109	544	ENST00000677517.1	213	1518	++	251	Q96D53-1#18	0	3	ENST00000677517.1	741	744	+	3	0	-2	10213
Q96D53-1#18	0	1	1	Q96D53-1	285	286	+	1	Q96D53-1	109	544	ENST00000677496.1	217	1522	++	250	Q96D53-1#18	0	3	ENST00000677496.1	745	748	+	3	0	-2	10214
Q96D53-1#18	0	1	1	Q96D53-1	285	286	+	1	Q96D53-1	0	544	ENST00000677018.1	141	1773	++	249	Q96D53-1#18	0	3	ENST00000677018.1	996	999	+	3	0	-2	10215
Q96D53-1#18	0	1	1	Q96D53-1	285	286	+	1	Q96D53-1	0	381	ENST00000676555.1	101	1244	++	247	Q96D53-1#18	0	3	ENST00000676555.1	956	959	+	3	0	-2	10216
Q96D53-1#18	0	1	1	Q96D53-1	285	286	+	1	Q96D53-1	0	544	ENST00000601967.6	45	1677	++	217	Q96D53-1#18	0	3	ENST00000601967.6	900	903	+	3	0	-2	10217
Q96D53-1#18	0	1	1	Q96D53-1	285	286	+	1	Q96D53-1	109	313	ENST00000595254.5	254	866	++	200	Q96D53-1#18	0	3	ENST00000595254.5	782	785	+	3	0	-2	10218
Q96D53-1#18	0	1	1	Q96D53-1	285	286	+	1	Q96D53-1	0	544	ENST00000594720.6	38	1670	++	197	Q96D53-1#18	0	3	ENST00000594720.6	893	896	+	3	0	-2	10219
Q96D53-1#18	0	1	1	Q96D53-1	285	286	+	1	Q96D53-1	0	544	ENST00000594490.6	29	1583	++	196	Q96D53-1#18	0	3	ENST00000594490.6	806	809	+	3	0	-2	10220
Q96D53-1#18	0	1	1	Q96D53-1	285	286	+	1	Q96D53-1	0	544	ENST00000324464.8	303	1935	++	27	Q96D53-1#18	0	3	ENST00000324464.8	1158	1161	+	3	0	-2	10221
Q96D53-1#18	0	1	1	Q96D53-1	285	286	+	1	Q96D53-1	0	544	ENST00000243583.10	24	1533	++	3	Q96D53-1#18	0	3	ENST00000243583.10	756	759	+	3	0	-2	10222
Q96D53-1#19	0	1	1	Q96D53-1	309	310	+	1	Q96D53-1	0	544	ENST00000679130.1	149	1781	++	262	Q96D53-1#19	0	3	ENST00000679130.1	1076	1079	+	3	0	-2	10223
Q96D53-1#19	0	1	1	Q96D53-1	309	310	+	1	Q96D53-1	164	544	ENST00000679012.1	609	1749	++	260	Q96D53-1#19	0	3	ENST00000679012.1	1044	1047	+	3	0	-2	10224
Q96D53-1#19	0	1	1	Q96D53-1	309	310	+	1	Q96D53-1	0	544	ENST00000678467.1	117	1749	++	258	Q96D53-1#19	0	3	ENST00000678467.1	1044	1047	+	3	0	-2	10225
Q96D53-1#19	0	1	1	Q96D53-1	309	310	+	1	Q96D53-1	0	544	ENST00000678419.1	81	1713	++	257	Q96D53-1#19	0	3	ENST00000678419.1	1008	1011	+	3	0	-2	10226
Q96D53-1#19	0	1	1	Q96D53-1	309	310	+	1	Q96D53-1	0	544	ENST00000678404.1	295	1927	++	256	Q96D53-1#19	0	3	ENST00000678404.1	1222	1225	+	3	0	-2	10227
Q96D53-1#19	0	1	1	Q96D53-1	309	310	+	1	Q96D53-1	109	544	ENST00000677517.1	213	1518	++	251	Q96D53-1#19	0	3	ENST00000677517.1	813	816	+	3	0	-2	10228
Q96D53-1#19	0	1	1	Q96D53-1	309	310	+	1	Q96D53-1	109	544	ENST00000677496.1	217	1522	++	250	Q96D53-1#19	0	3	ENST00000677496.1	817	820	+	3	0	-2	10229
Q96D53-1#19	0	1	1	Q96D53-1	309	310	+	1	Q96D53-1	0	544	ENST00000677018.1	141	1773	++	249	Q96D53-1#19	0	3	ENST00000677018.1	1068	1071	+	3	0	-2	10230
Q96D53-1#19	0	1	1	Q96D53-1	309	310	+	1	Q96D53-1	0	381	ENST00000676555.1	101	1244	++	247	Q96D53-1#19	0	3	ENST00000676555.1	1028	1031	+	3	0	-2	10231
Q96D53-1#19	0	1	1	Q96D53-1	309	310	+	1	Q96D53-1	0	544	ENST00000601967.6	45	1677	++	217	Q96D53-1#19	0	3	ENST00000601967.6	972	975	+	3	0	-2	10232
Q96D53-1#19	0	1	1	Q96D53-1	309	310	+	1	Q96D53-1	109	313	ENST00000595254.5	254	866	++	200	Q96D53-1#19	0	3	ENST00000595254.5	854	857	+	3	0	-2	10233
Q96D53-1#19	0	1	1	Q96D53-1	309	310	+	1	Q96D53-1	0	544	ENST00000594720.6	38	1670	++	197	Q96D53-1#19	0	3	ENST00000594720.6	965	968	+	3	0	-2	10234
Q96D53-1#19	0	1	1	Q96D53-1	309	310	+	1	Q96D53-1	0	544	ENST00000594490.6	29	1583	++	196	Q96D53-1#19	0	3	ENST00000594490.6	878	881	+	3	0	-2	10235
Q96D53-1#19	0	1	1	Q96D53-1	309	310	+	1	Q96D53-1	0	544	ENST00000324464.8	303	1935	++	27	Q96D53-1#19	0	3	ENST00000324464.8	1230	1233	+	3	0	-2	10236
Q96D53-1#19	0	1	1	Q96D53-1	309	310	+	1	Q96D53-1	0	544	ENST00000243583.10	24	1533	++	3	Q96D53-1#19	0	3	ENST00000243583.10	828	831	+	3	0	-2	10237
Q96D53-1#20	0	1	1	Q96D53-1	317	318	+	1	Q96D53-1	0	544	ENST00000679130.1	149	1781	++	262	Q96D53-1#20	0	3	ENST00000679130.1	1100	1103	+	3	0	-2	10238
Q96D53-1#20	0	1	1	Q96D53-1	317	318	+	1	Q96D53-1	164	544	ENST00000679012.1	609	1749	++	260	Q96D53-1#20	0	3	ENST00000679012.1	1068	1071	+	3	0	-2	10239
Q96D53-1#20	0	1	1	Q96D53-1	317	318	+	1	Q96D53-1	0	544	ENST00000678467.1	117	1749	++	258	Q96D53-1#20	0	3	ENST00000678467.1	1068	1071	+	3	0	-2	10240
Q96D53-1#20	0	1	1	Q96D53-1	317	318	+	1	Q96D53-1	0	544	ENST00000678419.1	81	1713	++	257	Q96D53-1#20	0	3	ENST00000678419.1	1032	1035	+	3	0	-2	10241
Q96D53-1#20	0	1	1	Q96D53-1	317	318	+	1	Q96D53-1	0	544	ENST00000678404.1	295	1927	++	256	Q96D53-1#20	0	3	ENST00000678404.1	1246	1249	+	3	0	-2	10242
Q96D53-1#20	0	1	1	Q96D53-1	317	318	+	1	Q96D53-1	109	544	ENST00000677517.1	213	1518	++	251	Q96D53-1#20	0	3	ENST00000677517.1	837	840	+	3	0	-2	10243
Q96D53-1#20	0	1	1	Q96D53-1	317	318	+	1	Q96D53-1	109	544	ENST00000677496.1	217	1522	++	250	Q96D53-1#20	0	3	ENST00000677496.1	841	844	+	3	0	-2	10244
Q96D53-1#20	0	1	1	Q96D53-1	317	318	+	1	Q96D53-1	0	544	ENST00000677018.1	141	1773	++	249	Q96D53-1#20	0	3	ENST00000677018.1	1092	1095	+	3	0	-2	10245
Q96D53-1#20	0	1	1	Q96D53-1	317	318	+	1	Q96D53-1	0	381	ENST00000676555.1	101	1244	++	247	Q96D53-1#20	0	3	ENST00000676555.1	1052	1055	+	3	0	-2	10246
Q96D53-1#20	0	1	1	Q96D53-1	317	318	+	1	Q96D53-1	0	544	ENST00000601967.6	45	1677	++	217	Q96D53-1#20	0	3	ENST00000601967.6	996	999	+	3	0	-2	10247
Q96D53-1#20	0	1	1	Q96D53-1	317	318	+	1	Q96D53-1	0	544	ENST00000594720.6	38	1670	++	197	Q96D53-1#20	0	3	ENST00000594720.6	989	992	+	3	0	-2	10248
Q96D53-1#20	0	1	1	Q96D53-1	317	318	+	1	Q96D53-1	0	544	ENST00000594490.6	29	1583	++	196	Q96D53-1#20	0	3	ENST00000594490.6	902	905	+	3	0	-2	10249
Q96D53-1#20	0	1	1	Q96D53-1	317	318	+	1	Q96D53-1	0	544	ENST00000324464.8	303	1935	++	27	Q96D53-1#20	0	3	ENST00000324464.8	1254	1257	+	3	0	-2	10250
Q96D53-1#20	0	1	1	Q96D53-1	317	318	+	1	Q96D53-1	0	544	ENST00000243583.10	24	1533	++	3	Q96D53-1#20	0	3	ENST00000243583.10	852	855	+	3	0	-2	10251
Q96D53-1#21	0	1	1	Q96D53-1	319	320	+	1	Q96D53-1	0	544	ENST00000679130.1	149	1781	++	262	Q96D53-1#21	0	3	ENST00000679130.1	1106	1109	+	3	0	-2	10252
Q96D53-1#21	0	1	1	Q96D53-1	319	320	+	1	Q96D53-1	164	544	ENST00000679012.1	609	1749	++	260	Q96D53-1#21	0	3	ENST00000679012.1	1074	1077	+	3	0	-2	10253
Q96D53-1#21	0	1	1	Q96D53-1	319	320	+	1	Q96D53-1	0	544	ENST00000678467.1	117	1749	++	258	Q96D53-1#21	0	3	ENST00000678467.1	1074	1077	+	3	0	-2	10254
Q96D53-1#21	0	1	1	Q96D53-1	319	320	+	1	Q96D53-1	0	544	ENST00000678419.1	81	1713	++	257	Q96D53-1#21	0	3	ENST00000678419.1	1038	1041	+	3	0	-2	10255
Q96D53-1#21	0	1	1	Q96D53-1	319	320	+	1	Q96D53-1	0	544	ENST00000678404.1	295	1927	++	256	Q96D53-1#21	0	3	ENST00000678404.1	1252	1255	+	3	0	-2	10256
Q96D53-1#21	0	1	1	Q96D53-1	319	320	+	1	Q96D53-1	109	544	ENST00000677517.1	213	1518	++	251	Q96D53-1#21	0	3	ENST00000677517.1	843	846	+	3	0	-2	10257
Q96D53-1#21	0	1	1	Q96D53-1	319	320	+	1	Q96D53-1	109	544	ENST00000677496.1	217	1522	++	250	Q96D53-1#21	0	3	ENST00000677496.1	847	850	+	3	0	-2	10258
Q96D53-1#21	0	1	1	Q96D53-1	319	320	+	1	Q96D53-1	0	544	ENST00000677018.1	141	1773	++	249	Q96D53-1#21	0	3	ENST00000677018.1	1098	1101	+	3	0	-2	10259
Q96D53-1#21	0	1	1	Q96D53-1	319	320	+	1	Q96D53-1	0	381	ENST00000676555.1	101	1244	++	247	Q96D53-1#21	0	3	ENST00000676555.1	1058	1061	+	3	0	-2	10260
Q96D53-1#21	0	1	1	Q96D53-1	319	320	+	1	Q96D53-1	0	544	ENST00000601967.6	45	1677	++	217	Q96D53-1#21	0	3	ENST00000601967.6	1002	1005	+	3	0	-2	10261
Q96D53-1#21	0	1	1	Q96D53-1	319	320	+	1	Q96D53-1	0	544	ENST00000594720.6	38	1670	++	197	Q96D53-1#21	0	3	ENST00000594720.6	995	998	+	3	0	-2	10262
Q96D53-1#21	0	1	1	Q96D53-1	319	320	+	1	Q96D53-1	0	544	ENST00000594490.6	29	1583	++	196	Q96D53-1#21	0	3	ENST00000594490.6	908	911	+	3	0	-2	10263
Q96D53-1#21	0	1	1	Q96D53-1	319	320	+	1	Q96D53-1	0	544	ENST00000324464.8	303	1935	++	27	Q96D53-1#21	0	3	ENST00000324464.8	1260	1263	+	3	0	-2	10264
Q96D53-1#21	0	1	1	Q96D53-1	319	320	+	1	Q96D53-1	0	544	ENST00000243583.10	24	1533	++	3	Q96D53-1#21	0	3	ENST00000243583.10	858	861	+	3	0	-2	10265
Q96D53-1#22	0	1	1	Q96D53-1	342	343	+	1	Q96D53-1	0	544	ENST00000679130.1	149	1781	++	262	Q96D53-1#22	0	3	ENST00000679130.1	1175	1178	+	3	0	-2	10266
Q96D53-1#22	0	1	1	Q96D53-1	342	343	+	1	Q96D53-1	164	544	ENST00000679012.1	609	1749	++	260	Q96D53-1#22	0	3	ENST00000679012.1	1143	1146	+	3	0	-2	10267
Q96D53-1#22	0	1	1	Q96D53-1	342	343	+	1	Q96D53-1	0	544	ENST00000678467.1	117	1749	++	258	Q96D53-1#22	0	3	ENST00000678467.1	1143	1146	+	3	0	-2	10268
Q96D53-1#22	0	1	1	Q96D53-1	342	343	+	1	Q96D53-1	0	544	ENST00000678419.1	81	1713	++	257	Q96D53-1#22	0	3	ENST00000678419.1	1107	1110	+	3	0	-2	10269
Q96D53-1#22	0	1	1	Q96D53-1	342	343	+	1	Q96D53-1	0	544	ENST00000678404.1	295	1927	++	256	Q96D53-1#22	0	3	ENST00000678404.1	1321	1324	+	3	0	-2	10270
Q96D53-1#22	0	1	1	Q96D53-1	342	343	+	1	Q96D53-1	109	544	ENST00000677517.1	213	1518	++	251	Q96D53-1#22	0	3	ENST00000677517.1	912	915	+	3	0	-2	10271
Q96D53-1#22	0	1	1	Q96D53-1	342	343	+	1	Q96D53-1	109	544	ENST00000677496.1	217	1522	++	250	Q96D53-1#22	0	3	ENST00000677496.1	916	919	+	3	0	-2	10272
Q96D53-1#22	0	1	1	Q96D53-1	342	343	+	1	Q96D53-1	0	544	ENST00000677018.1	141	1773	++	249	Q96D53-1#22	0	3	ENST00000677018.1	1167	1170	+	3	0	-2	10273
Q96D53-1#22	0	1	1	Q96D53-1	342	343	+	1	Q96D53-1	0	381	ENST00000676555.1	101	1244	++	247	Q96D53-1#22	0	3	ENST00000676555.1	1127	1130	+	3	0	-2	10274
Q96D53-1#22	0	1	1	Q96D53-1	342	343	+	1	Q96D53-1	0	544	ENST00000601967.6	45	1677	++	217	Q96D53-1#22	0	3	ENST00000601967.6	1071	1074	+	3	0	-2	10275
Q96D53-1#22	0	1	1	Q96D53-1	342	343	+	1	Q96D53-1	0	544	ENST00000594720.6	38	1670	++	197	Q96D53-1#22	0	3	ENST00000594720.6	1064	1067	+	3	0	-2	10276
Q96D53-1#22	0	1	1	Q96D53-1	342	343	+	1	Q96D53-1	0	544	ENST00000594490.6	29	1583	++	196	Q96D53-1#22	0	3	ENST00000594490.6	977	980	+	3	0	-2	10277
Q96D53-1#22	0	1	1	Q96D53-1	342	343	+	1	Q96D53-1	0	544	ENST00000324464.8	303	1935	++	27	Q96D53-1#22	0	3	ENST00000324464.8	1329	1332	+	3	0	-2	10278
Q96D53-1#22	0	1	1	Q96D53-1	342	343	+	1	Q96D53-1	0	544	ENST00000243583.10	24	1533	++	3	Q96D53-1#22	0	3	ENST00000243583.10	927	930	+	3	0	-2	10279
Q96D53-1#23	0	1	1	Q96D53-1	351	352	+	1	Q96D53-1	0	544	ENST00000679130.1	149	1781	++	262	Q96D53-1#23	0	3	ENST00000679130.1	1202	1205	+	3	0	-2	10280
Q96D53-1#23	0	1	1	Q96D53-1	351	352	+	1	Q96D53-1	164	544	ENST00000679012.1	609	1749	++	260	Q96D53-1#23	0	3	ENST00000679012.1	1170	1173	+	3	0	-2	10281
Q96D53-1#23	0	1	1	Q96D53-1	351	352	+	1	Q96D53-1	0	544	ENST00000678467.1	117	1749	++	258	Q96D53-1#23	0	3	ENST00000678467.1	1170	1173	+	3	0	-2	10282
Q96D53-1#23	0	1	1	Q96D53-1	351	352	+	1	Q96D53-1	0	544	ENST00000678419.1	81	1713	++	257	Q96D53-1#23	0	3	ENST00000678419.1	1134	1137	+	3	0	-2	10283
Q96D53-1#23	0	1	1	Q96D53-1	351	352	+	1	Q96D53-1	0	544	ENST00000678404.1	295	1927	++	256	Q96D53-1#23	0	3	ENST00000678404.1	1348	1351	+	3	0	-2	10284
Q96D53-1#23	0	1	1	Q96D53-1	351	352	+	1	Q96D53-1	109	544	ENST00000677517.1	213	1518	++	251	Q96D53-1#23	0	3	ENST00000677517.1	939	942	+	3	0	-2	10285
Q96D53-1#23	0	1	1	Q96D53-1	351	352	+	1	Q96D53-1	109	544	ENST00000677496.1	217	1522	++	250	Q96D53-1#23	0	3	ENST00000677496.1	943	946	+	3	0	-2	10286
Q96D53-1#23	0	1	1	Q96D53-1	351	352	+	1	Q96D53-1	0	544	ENST00000677018.1	141	1773	++	249	Q96D53-1#23	0	3	ENST00000677018.1	1194	1197	+	3	0	-2	10287
Q96D53-1#23	0	1	1	Q96D53-1	351	352	+	1	Q96D53-1	0	381	ENST00000676555.1	101	1244	++	247	Q96D53-1#23	0	3	ENST00000676555.1	1154	1157	+	3	0	-2	10288
Q96D53-1#23	0	1	1	Q96D53-1	351	352	+	1	Q96D53-1	0	544	ENST00000601967.6	45	1677	++	217	Q96D53-1#23	0	3	ENST00000601967.6	1098	1101	+	3	0	-2	10289
Q96D53-1#23	0	1	1	Q96D53-1	351	352	+	1	Q96D53-1	0	544	ENST00000594720.6	38	1670	++	197	Q96D53-1#23	0	3	ENST00000594720.6	1091	1094	+	3	0	-2	10290
Q96D53-1#23	0	1	1	Q96D53-1	351	352	+	1	Q96D53-1	0	544	ENST00000594490.6	29	1583	++	196	Q96D53-1#23	0	3	ENST00000594490.6	1004	1007	+	3	0	-2	10291
Q96D53-1#23	0	1	1	Q96D53-1	351	352	+	1	Q96D53-1	0	544	ENST00000324464.8	303	1935	++	27	Q96D53-1#23	0	3	ENST00000324464.8	1356	1359	+	3	0	-2	10292
Q96D53-1#23	0	1	1	Q96D53-1	351	352	+	1	Q96D53-1	0	544	ENST00000243583.10	24	1533	++	3	Q96D53-1#23	0	3	ENST00000243583.10	954	957	+	3	0	-2	10293
Q96D53-1#24	0	1	1	Q96D53-1	461	462	+	1	Q96D53-1	0	544	ENST00000679130.1	149	1781	++	262	Q96D53-1#24	0	3	ENST00000679130.1	1532	1535	+	3	0	-2	10294
Q96D53-1#24	0	1	1	Q96D53-1	461	462	+	1	Q96D53-1	164	544	ENST00000679012.1	609	1749	++	260	Q96D53-1#24	0	3	ENST00000679012.1	1500	1503	+	3	0	-2	10295
Q96D53-1#24	0	1	1	Q96D53-1	461	462	+	1	Q96D53-1	0	544	ENST00000678467.1	117	1749	++	258	Q96D53-1#24	0	3	ENST00000678467.1	1500	1503	+	3	0	-2	10296
Q96D53-1#24	0	1	1	Q96D53-1	461	462	+	1	Q96D53-1	0	544	ENST00000678419.1	81	1713	++	257	Q96D53-1#24	0	3	ENST00000678419.1	1464	1467	+	3	0	-2	10297
Q96D53-1#24	0	1	1	Q96D53-1	461	462	+	1	Q96D53-1	0	544	ENST00000678404.1	295	1927	++	256	Q96D53-1#24	0	3	ENST00000678404.1	1678	1681	+	3	0	-2	10298
Q96D53-1#24	0	1	1	Q96D53-1	461	462	+	1	Q96D53-1	109	544	ENST00000677517.1	213	1518	++	251	Q96D53-1#24	0	3	ENST00000677517.1	1269	1272	+	3	0	-2	10299
Q96D53-1#24	0	1	1	Q96D53-1	461	462	+	1	Q96D53-1	109	544	ENST00000677496.1	217	1522	++	250	Q96D53-1#24	0	3	ENST00000677496.1	1273	1276	+	3	0	-2	10300
Q96D53-1#24	0	1	1	Q96D53-1	461	462	+	1	Q96D53-1	0	544	ENST00000677018.1	141	1773	++	249	Q96D53-1#24	0	3	ENST00000677018.1	1524	1527	+	3	0	-2	10301
Q96D53-1#24	0	1	1	Q96D53-1	461	462	+	1	Q96D53-1	0	544	ENST00000601967.6	45	1677	++	217	Q96D53-1#24	0	3	ENST00000601967.6	1428	1431	+	3	0	-2	10302
Q96D53-1#24	0	1	1	Q96D53-1	461	462	+	1	Q96D53-1	0	544	ENST00000594720.6	38	1670	++	197	Q96D53-1#24	0	3	ENST00000594720.6	1421	1424	+	3	0	-2	10303
Q96D53-1#24	0	1	1	Q96D53-1	461	462	+	1	Q96D53-1	0	544	ENST00000594490.6	29	1583	++	196	Q96D53-1#24	0	3	ENST00000594490.6	1334	1337	+	3	0	-2	10304
Q96D53-1#24	0	1	1	Q96D53-1	461	462	+	1	Q96D53-1	0	544	ENST00000324464.8	303	1935	++	27	Q96D53-1#24	0	3	ENST00000324464.8	1686	1689	+	3	0	-2	10305
Q96D53-1#24	0	1	1	Q96D53-1	461	462	+	1	Q96D53-1	0	544	ENST00000243583.10	24	1533	++	3	Q96D53-1#24	0	3	ENST00000243583.10	1284	1287	+	3	0	-2	10306
Q96D53-1#25	0	1	1	Q96D53-1	476	477	+	1	Q96D53-1	0	544	ENST00000679130.1	149	1781	++	262	Q96D53-1#25	0	3	ENST00000679130.1	1577	1580	+	3	0	-2	10307
Q96D53-1#25	0	1	1	Q96D53-1	476	477	+	1	Q96D53-1	164	544	ENST00000679012.1	609	1749	++	260	Q96D53-1#25	0	3	ENST00000679012.1	1545	1548	+	3	0	-2	10308
Q96D53-1#25	0	1	1	Q96D53-1	476	477	+	1	Q96D53-1	0	544	ENST00000678467.1	117	1749	++	258	Q96D53-1#25	0	3	ENST00000678467.1	1545	1548	+	3	0	-2	10309
Q96D53-1#25	0	1	1	Q96D53-1	476	477	+	1	Q96D53-1	0	544	ENST00000678419.1	81	1713	++	257	Q96D53-1#25	0	3	ENST00000678419.1	1509	1512	+	3	0	-2	10310
Q96D53-1#25	0	1	1	Q96D53-1	476	477	+	1	Q96D53-1	0	544	ENST00000678404.1	295	1927	++	256	Q96D53-1#25	0	3	ENST00000678404.1	1723	1726	+	3	0	-2	10311
Q96D53-1#25	0	1	1	Q96D53-1	476	477	+	1	Q96D53-1	109	544	ENST00000677517.1	213	1518	++	251	Q96D53-1#25	0	3	ENST00000677517.1	1314	1317	+	3	0	-2	10312
Q96D53-1#25	0	1	1	Q96D53-1	476	477	+	1	Q96D53-1	109	544	ENST00000677496.1	217	1522	++	250	Q96D53-1#25	0	3	ENST00000677496.1	1318	1321	+	3	0	-2	10313
Q96D53-1#25	0	1	1	Q96D53-1	476	477	+	1	Q96D53-1	0	544	ENST00000677018.1	141	1773	++	249	Q96D53-1#25	0	3	ENST00000677018.1	1569	1572	+	3	0	-2	10314
Q96D53-1#25	0	1	1	Q96D53-1	476	477	+	1	Q96D53-1	0	544	ENST00000601967.6	45	1677	++	217	Q96D53-1#25	0	3	ENST00000601967.6	1473	1476	+	3	0	-2	10315
Q96D53-1#25	0	1	1	Q96D53-1	476	477	+	1	Q96D53-1	0	544	ENST00000594720.6	38	1670	++	197	Q96D53-1#25	0	3	ENST00000594720.6	1466	1469	+	3	0	-2	10316
Q96D53-1#25	0	1	1	Q96D53-1	476	477	+	1	Q96D53-1	0	544	ENST00000594490.6	29	1583	++	196	Q96D53-1#25	0	3	ENST00000594490.6	1379	1382	+	3	0	-2	10317
Q96D53-1#25	0	1	1	Q96D53-1	476	477	+	1	Q96D53-1	0	544	ENST00000324464.8	303	1935	++	27	Q96D53-1#25	0	3	ENST00000324464.8	1731	1734	+	3	0	-2	10318
Q96D53-1#25	0	1	1	Q96D53-1	476	477	+	1	Q96D53-1	0	544	ENST00000243583.10	24	1533	++	3	Q96D53-1#25	0	3	ENST00000243583.10	1329	1332	+	3	0	-2	10319
Q96D53-1#26	0	1	1	Q96D53-1	497	498	+	1	Q96D53-1	0	544	ENST00000679130.1	149	1781	++	262	Q96D53-1#26	0	3	ENST00000679130.1	1640	1643	+	3	0	-2	10320
Q96D53-1#26	0	1	1	Q96D53-1	497	498	+	1	Q96D53-1	164	544	ENST00000679012.1	609	1749	++	260	Q96D53-1#26	0	3	ENST00000679012.1	1608	1611	+	3	0	-2	10321
Q96D53-1#26	0	1	1	Q96D53-1	497	498	+	1	Q96D53-1	0	544	ENST00000678467.1	117	1749	++	258	Q96D53-1#26	0	3	ENST00000678467.1	1608	1611	+	3	0	-2	10322
Q96D53-1#26	0	1	1	Q96D53-1	497	498	+	1	Q96D53-1	0	544	ENST00000678419.1	81	1713	++	257	Q96D53-1#26	0	3	ENST00000678419.1	1572	1575	+	3	0	-2	10323
Q96D53-1#26	0	1	1	Q96D53-1	497	498	+	1	Q96D53-1	0	544	ENST00000678404.1	295	1927	++	256	Q96D53-1#26	0	3	ENST00000678404.1	1786	1789	+	3	0	-2	10324
Q96D53-1#26	0	1	1	Q96D53-1	497	498	+	1	Q96D53-1	109	544	ENST00000677517.1	213	1518	++	251	Q96D53-1#26	0	3	ENST00000677517.1	1377	1380	+	3	0	-2	10325
Q96D53-1#26	0	1	1	Q96D53-1	497	498	+	1	Q96D53-1	109	544	ENST00000677496.1	217	1522	++	250	Q96D53-1#26	0	3	ENST00000677496.1	1381	1384	+	3	0	-2	10326
Q96D53-1#26	0	1	1	Q96D53-1	497	498	+	1	Q96D53-1	0	544	ENST00000677018.1	141	1773	++	249	Q96D53-1#26	0	3	ENST00000677018.1	1632	1635	+	3	0	-2	10327
Q96D53-1#26	0	1	1	Q96D53-1	497	498	+	1	Q96D53-1	0	544	ENST00000601967.6	45	1677	++	217	Q96D53-1#26	0	3	ENST00000601967.6	1536	1539	+	3	0	-2	10328
Q96D53-1#26	0	1	1	Q96D53-1	497	498	+	1	Q96D53-1	0	544	ENST00000594720.6	38	1670	++	197	Q96D53-1#26	0	3	ENST00000594720.6	1529	1532	+	3	0	-2	10329
Q96D53-1#26	0	1	1	Q96D53-1	497	498	+	1	Q96D53-1	0	544	ENST00000594490.6	29	1583	++	196	Q96D53-1#26	0	3	ENST00000594490.6	1442	1445	+	3	0	-2	10330
Q96D53-1#26	0	1	1	Q96D53-1	497	498	+	1	Q96D53-1	0	544	ENST00000324464.8	303	1935	++	27	Q96D53-1#26	0	3	ENST00000324464.8	1794	1797	+	3	0	-2	10331
Q96D53-1#26	0	1	1	Q96D53-1	497	498	+	1	Q96D53-1	0	544	ENST00000243583.10	24	1533	++	3	Q96D53-1#26	0	3	ENST00000243583.10	1392	1395	+	3	0	-2	10332
Q96D53-1#27	0	3	3	Q96D53-1	163	166	+	3	Q96D53-1	0	544	ENST00000679130.1	149	1781	++	262	Q96D53-1#27	0	9	ENST00000679130.1	638	647	+	9	0	-6	10333
Q96D53-1#27	0	3	3	Q96D53-1	163	166	+	3	Q96D53-1	109	169	ENST00000679070.1	229	409	++	261	Q96D53-1#27	0	9	ENST00000679070.1	391	400	+	9	0	-6	10334
Q96D53-1#27	0	3	3	Q96D53-1	163	166	+	3	Q96D53-1	164	544	ENST00000679012.1	609	1749	++	260	Q96D53-1#27	3	9	ENST00000679012.1	609	615	+	6	3	-6	10335
Q96D53-1#27	0	3	3	Q96D53-1	163	166	+	3	Q96D53-1	0	297	ENST00000678569.1	101	992	++	259	Q96D53-1#27	0	9	ENST00000678569.1	590	599	+	9	0	-6	10336
Q96D53-1#27	0	3	3	Q96D53-1	163	166	+	3	Q96D53-1	0	544	ENST00000678467.1	117	1749	++	258	Q96D53-1#27	0	9	ENST00000678467.1	606	615	+	9	0	-6	10337
Q96D53-1#27	0	3	3	Q96D53-1	163	166	+	3	Q96D53-1	0	544	ENST00000678419.1	81	1713	++	257	Q96D53-1#27	0	9	ENST00000678419.1	570	579	+	9	0	-6	10338
Q96D53-1#27	0	3	3	Q96D53-1	163	166	+	3	Q96D53-1	0	544	ENST00000678404.1	295	1927	++	256	Q96D53-1#27	0	9	ENST00000678404.1	784	793	+	9	0	-6	10339
Q96D53-1#27	0	3	3	Q96D53-1	163	166	+	3	Q96D53-1	0	169	ENST00000677633.1	120	627	++	252	Q96D53-1#27	0	9	ENST00000677633.1	609	618	+	9	0	-6	10340
Q96D53-1#27	0	3	3	Q96D53-1	163	166	+	3	Q96D53-1	109	544	ENST00000677517.1	213	1518	++	251	Q96D53-1#27	0	9	ENST00000677517.1	375	384	+	9	0	-6	10341
Q96D53-1#27	0	3	3	Q96D53-1	163	166	+	3	Q96D53-1	109	544	ENST00000677496.1	217	1522	++	250	Q96D53-1#27	0	9	ENST00000677496.1	379	388	+	9	0	-6	10342
Q96D53-1#27	0	3	3	Q96D53-1	163	166	+	3	Q96D53-1	0	544	ENST00000677018.1	141	1773	++	249	Q96D53-1#27	0	9	ENST00000677018.1	630	639	+	9	0	-6	10343
Q96D53-1#27	0	3	3	Q96D53-1	163	166	+	3	Q96D53-1	0	381	ENST00000676555.1	101	1244	++	247	Q96D53-1#27	0	9	ENST00000676555.1	590	599	+	9	0	-6	10344
Q96D53-1#27	0	3	3	Q96D53-1	163	166	+	3	Q96D53-1	0	544	ENST00000601967.6	45	1677	++	217	Q96D53-1#27	0	9	ENST00000601967.6	534	543	+	9	0	-6	10345
Q96D53-1#27	0	3	3	Q96D53-1	163	166	+	3	Q96D53-1	109	169	ENST00000600080.5	253	433	++	209	Q96D53-1#27	0	9	ENST00000600080.5	415	424	+	9	0	-6	10346
Q96D53-1#27	0	3	3	Q96D53-1	163	166	+	3	Q96D53-1	109	313	ENST00000595254.5	254	866	++	200	Q96D53-1#27	0	9	ENST00000595254.5	416	425	+	9	0	-6	10347
Q96D53-1#27	0	3	3	Q96D53-1	163	166	+	3	Q96D53-1	0	544	ENST00000594720.6	38	1670	++	197	Q96D53-1#27	0	9	ENST00000594720.6	527	536	+	9	0	-6	10348
Q96D53-1#27	0	3	3	Q96D53-1	163	166	+	3	Q96D53-1	0	544	ENST00000594490.6	29	1583	++	196	Q96D53-1#27	0	9	ENST00000594490.6	440	449	+	9	0	-6	10349
Q96D53-1#27	0	3	3	Q96D53-1	163	166	+	3	Q96D53-1	0	544	ENST00000324464.8	303	1935	++	27	Q96D53-1#27	0	9	ENST00000324464.8	792	801	+	9	0	-6	10350
Q96D53-1#27	0	3	3	Q96D53-1	163	166	+	3	Q96D53-1	0	544	ENST00000243583.10	24	1533	++	3	Q96D53-1#27	0	9	ENST00000243583.10	390	399	+	9	0	-6	10351
Q9NTW7-1#0	0	645	645	Q9NTW7-1	0	645	+	645	Q9NTW7-1	295	413	ENST00000456175.5	1	355	++	103	Q9NTW7-1#0	885	1239	ENST00000456175.5	1	355	+	354	885	-594	10352
Q9NTW7-1#0	0	645	645	Q9NTW7-1	0	645	+	645	Q9NTW7-1	251	418	ENST00000395989.7	261	762	++	65	Q9NTW7-1#0	753	1254	ENST00000395989.7	261	762	+	501	753	-609	10353
Q9NTW7-1#0	0	645	645	Q9NTW7-1	0	645	+	645	Q9NTW7-1	251	325	ENST00000395979.1	188	410	++	64	Q9NTW7-1#0	753	975	ENST00000395979.1	188	410	+	222	753	-330	10354
Q9NTW7-1#0	0	645	645	Q9NTW7-1	0	645	+	645	Q9NTW7-1	238	645	ENST00000371523.8	464	1685	++	46	Q9NTW7-1#0	714	1935	ENST00000371523.8	464	1685	+	1221	714	-1290	10355
Q9NTW7-1#0	0	645	645	Q9NTW7-1	0	645	+	645	Q9NTW7-1	0	410	ENST00000371518.6	143	1373	++	45	Q9NTW7-1#0	0	1230	ENST00000371518.6	143	1373	+	1230	0	-585	10356
Q9NTW7-1#0	0	645	645	Q9NTW7-1	0	645	+	645	Q9NTW7-1	0	645	ENST00000361387.6	61	1996	++	40	Q9NTW7-1#0	0	1935	ENST00000361387.6	61	1996	+	1935	0	-1290	10357
Q9NTW7-1#1	0	23	23	Q9NTW7-1	174	197	+	23	Q9NTW7-1	0	410	ENST00000371518.6	143	1373	++	45	Q9NTW7-1#1	0	69	ENST00000371518.6	665	734	+	69	0	-46	10358
Q9NTW7-1#1	0	23	23	Q9NTW7-1	174	197	+	23	Q9NTW7-1	0	645	ENST00000361387.6	61	1996	++	40	Q9NTW7-1#1	0	69	ENST00000361387.6	583	652	+	69	0	-46	10359
Q9NTW7-1#2	0	23	23	Q9NTW7-1	202	225	+	23	Q9NTW7-1	0	410	ENST00000371518.6	143	1373	++	45	Q9NTW7-1#2	0	69	ENST00000371518.6	749	818	+	69	0	-46	10360
Q9NTW7-1#2	0	23	23	Q9NTW7-1	202	225	+	23	Q9NTW7-1	0	645	ENST00000361387.6	61	1996	++	40	Q9NTW7-1#2	0	69	ENST00000361387.6	667	736	+	69	0	-46	10361
Q9NTW7-1#3	0	23	23	Q9NTW7-1	230	253	+	23	Q9NTW7-1	251	418	ENST00000395989.7	261	762	++	65	Q9NTW7-1#3	63	69	ENST00000395989.7	261	267	+	6	63	-46	10362
Q9NTW7-1#3	0	23	23	Q9NTW7-1	230	253	+	23	Q9NTW7-1	251	325	ENST00000395979.1	188	410	++	64	Q9NTW7-1#3	63	69	ENST00000395979.1	188	194	+	6	63	-46	10363
Q9NTW7-1#3	0	23	23	Q9NTW7-1	230	253	+	23	Q9NTW7-1	238	645	ENST00000371523.8	464	1685	++	46	Q9NTW7-1#3	24	69	ENST00000371523.8	464	509	+	45	24	-46	10364
Q9NTW7-1#3	0	23	23	Q9NTW7-1	230	253	+	23	Q9NTW7-1	0	410	ENST00000371518.6	143	1373	++	45	Q9NTW7-1#3	0	69	ENST00000371518.6	833	902	+	69	0	-46	10365
Q9NTW7-1#3	0	23	23	Q9NTW7-1	230	253	+	23	Q9NTW7-1	0	645	ENST00000361387.6	61	1996	++	40	Q9NTW7-1#3	0	69	ENST00000361387.6	751	820	+	69	0	-46	10366
Q9NTW7-1#4	0	26	26	Q9NTW7-1	298	324	+	26	Q9NTW7-1	295	413	ENST00000456175.5	1	355	++	103	Q9NTW7-1#4	0	78	ENST00000456175.5	10	88	+	78	0	-52	10367
Q9NTW7-1#4	0	26	26	Q9NTW7-1	298	324	+	26	Q9NTW7-1	251	418	ENST00000395989.7	261	762	++	65	Q9NTW7-1#4	0	78	ENST00000395989.7	402	480	+	78	0	-52	10368
Q9NTW7-1#4	0	26	26	Q9NTW7-1	298	324	+	26	Q9NTW7-1	251	325	ENST00000395979.1	188	410	++	64	Q9NTW7-1#4	0	78	ENST00000395979.1	329	407	+	78	0	-52	10369
Q9NTW7-1#4	0	26	26	Q9NTW7-1	298	324	+	26	Q9NTW7-1	238	645	ENST00000371523.8	464	1685	++	46	Q9NTW7-1#4	0	78	ENST00000371523.8	644	722	+	78	0	-52	10370
Q9NTW7-1#4	0	26	26	Q9NTW7-1	298	324	+	26	Q9NTW7-1	0	410	ENST00000371518.6	143	1373	++	45	Q9NTW7-1#4	0	78	ENST00000371518.6	1037	1115	+	78	0	-52	10371
Q9NTW7-1#4	0	26	26	Q9NTW7-1	298	324	+	26	Q9NTW7-1	0	645	ENST00000361387.6	61	1996	++	40	Q9NTW7-1#4	0	78	ENST00000361387.6	955	1033	+	78	0	-52	10372
Q9NTW7-1#5	0	23	23	Q9NTW7-1	329	352	+	23	Q9NTW7-1	295	413	ENST00000456175.5	1	355	++	103	Q9NTW7-1#5	0	69	ENST00000456175.5	103	172	+	69	0	-46	10373
Q9NTW7-1#5	0	23	23	Q9NTW7-1	329	352	+	23	Q9NTW7-1	251	418	ENST00000395989.7	261	762	++	65	Q9NTW7-1#5	0	69	ENST00000395989.7	495	564	+	69	0	-46	10374
Q9NTW7-1#5	0	23	23	Q9NTW7-1	329	352	+	23	Q9NTW7-1	238	645	ENST00000371523.8	464	1685	++	46	Q9NTW7-1#5	0	69	ENST00000371523.8	737	806	+	69	0	-46	10375
Q9NTW7-1#5	0	23	23	Q9NTW7-1	329	352	+	23	Q9NTW7-1	0	410	ENST00000371518.6	143	1373	++	45	Q9NTW7-1#5	0	69	ENST00000371518.6	1130	1199	+	69	0	-46	10376
Q9NTW7-1#5	0	23	23	Q9NTW7-1	329	352	+	23	Q9NTW7-1	0	645	ENST00000361387.6	61	1996	++	40	Q9NTW7-1#5	0	69	ENST00000361387.6	1048	1117	+	69	0	-46	10377
Q9NTW7-1#6	0	23	23	Q9NTW7-1	357	380	+	23	Q9NTW7-1	295	413	ENST00000456175.5	1	355	++	103	Q9NTW7-1#6	0	69	ENST00000456175.5	187	256	+	69	0	-46	10378
Q9NTW7-1#6	0	23	23	Q9NTW7-1	357	380	+	23	Q9NTW7-1	251	418	ENST00000395989.7	261	762	++	65	Q9NTW7-1#6	0	69	ENST00000395989.7	579	648	+	69	0	-46	10379
Q9NTW7-1#6	0	23	23	Q9NTW7-1	357	380	+	23	Q9NTW7-1	238	645	ENST00000371523.8	464	1685	++	46	Q9NTW7-1#6	0	69	ENST00000371523.8	821	890	+	69	0	-46	10380
Q9NTW7-1#6	0	23	23	Q9NTW7-1	357	380	+	23	Q9NTW7-1	0	410	ENST00000371518.6	143	1373	++	45	Q9NTW7-1#6	0	69	ENST00000371518.6	1214	1283	+	69	0	-46	10381
Q9NTW7-1#6	0	23	23	Q9NTW7-1	357	380	+	23	Q9NTW7-1	0	645	ENST00000361387.6	61	1996	++	40	Q9NTW7-1#6	0	69	ENST00000361387.6	1132	1201	+	69	0	-46	10382
Q9NTW7-1#7	0	23	23	Q9NTW7-1	385	408	+	23	Q9NTW7-1	295	413	ENST00000456175.5	1	355	++	103	Q9NTW7-1#7	0	69	ENST00000456175.5	271	340	+	69	0	-46	10383
Q9NTW7-1#7	0	23	23	Q9NTW7-1	385	408	+	23	Q9NTW7-1	251	418	ENST00000395989.7	261	762	++	65	Q9NTW7-1#7	0	69	ENST00000395989.7	663	732	+	69	0	-46	10384
Q9NTW7-1#7	0	23	23	Q9NTW7-1	385	408	+	23	Q9NTW7-1	238	645	ENST00000371523.8	464	1685	++	46	Q9NTW7-1#7	0	69	ENST00000371523.8	905	974	+	69	0	-46	10385
Q9NTW7-1#7	0	23	23	Q9NTW7-1	385	408	+	23	Q9NTW7-1	0	410	ENST00000371518.6	143	1373	++	45	Q9NTW7-1#7	0	69	ENST00000371518.6	1298	1367	+	69	0	-46	10386
Q9NTW7-1#7	0	23	23	Q9NTW7-1	385	408	+	23	Q9NTW7-1	0	645	ENST00000361387.6	61	1996	++	40	Q9NTW7-1#7	0	69	ENST00000361387.6	1216	1285	+	69	0	-46	10387
Q9NTW7-1#8	0	23	23	Q9NTW7-1	413	436	+	23	Q9NTW7-1	251	418	ENST00000395989.7	261	762	++	65	Q9NTW7-1#8	0	15	ENST00000395989.7	747	762	+	15	0	8	10388
Q9NTW7-1#8	0	23	23	Q9NTW7-1	413	436	+	23	Q9NTW7-1	238	645	ENST00000371523.8	464	1685	++	46	Q9NTW7-1#8	0	69	ENST00000371523.8	989	1058	+	69	0	-46	10389
Q9NTW7-1#8	0	23	23	Q9NTW7-1	413	436	+	23	Q9NTW7-1	0	645	ENST00000361387.6	61	1996	++	40	Q9NTW7-1#8	0	69	ENST00000361387.6	1300	1369	+	69	0	-46	10390
Q9NTW7-1#9	0	24	24	Q9NTW7-1	441	465	+	24	Q9NTW7-1	238	645	ENST00000371523.8	464	1685	++	46	Q9NTW7-1#9	0	72	ENST00000371523.8	1073	1145	+	72	0	-48	10391
Q9NTW7-1#9	0	24	24	Q9NTW7-1	441	465	+	24	Q9NTW7-1	0	645	ENST00000361387.6	61	1996	++	40	Q9NTW7-1#9	0	72	ENST00000361387.6	1384	1456	+	72	0	-48	10392
Q9NTW7-1#10	0	23	23	Q9NTW7-1	466	489	+	23	Q9NTW7-1	238	645	ENST00000371523.8	464	1685	++	46	Q9NTW7-1#10	0	69	ENST00000371523.8	1148	1217	+	69	0	-46	10393
Q9NTW7-1#10	0	23	23	Q9NTW7-1	466	489	+	23	Q9NTW7-1	0	645	ENST00000361387.6	61	1996	++	40	Q9NTW7-1#10	0	69	ENST00000361387.6	1459	1528	+	69	0	-46	10394
Q9NTW7-1#11	0	23	23	Q9NTW7-1	494	517	+	23	Q9NTW7-1	238	645	ENST00000371523.8	464	1685	++	46	Q9NTW7-1#11	0	69	ENST00000371523.8	1232	1301	+	69	0	-46	10395
Q9NTW7-1#11	0	23	23	Q9NTW7-1	494	517	+	23	Q9NTW7-1	0	645	ENST00000361387.6	61	1996	++	40	Q9NTW7-1#11	0	69	ENST00000361387.6	1543	1612	+	69	0	-46	10396
Q9NTW7-1#12	0	24	24	Q9NTW7-1	522	546	+	24	Q9NTW7-1	238	645	ENST00000371523.8	464	1685	++	46	Q9NTW7-1#12	0	72	ENST00000371523.8	1316	1388	+	72	0	-48	10397
Q9NTW7-1#12	0	24	24	Q9NTW7-1	522	546	+	24	Q9NTW7-1	0	645	ENST00000361387.6	61	1996	++	40	Q9NTW7-1#12	0	72	ENST00000361387.6	1627	1699	+	72	0	-48	10398
Q9NTW7-1#13	0	23	23	Q9NTW7-1	579	602	+	23	Q9NTW7-1	238	645	ENST00000371523.8	464	1685	++	46	Q9NTW7-1#13	0	69	ENST00000371523.8	1487	1556	+	69	0	-46	10399
Q9NTW7-1#13	0	23	23	Q9NTW7-1	579	602	+	23	Q9NTW7-1	0	645	ENST00000361387.6	61	1996	++	40	Q9NTW7-1#13	0	69	ENST00000361387.6	1798	1867	+	69	0	-46	10400
Q9NTW7-1#14	0	25	25	Q9NTW7-1	542	567	+	25	Q9NTW7-1	238	645	ENST00000371523.8	464	1685	++	46	Q9NTW7-1#14	0	75	ENST00000371523.8	1376	1451	+	75	0	-50	10401
Q9NTW7-1#14	0	25	25	Q9NTW7-1	542	567	+	25	Q9NTW7-1	0	645	ENST00000361387.6	61	1996	++	40	Q9NTW7-1#14	0	75	ENST00000361387.6	1687	1762	+	75	0	-50	10402
Q9NTW7-1#15	0	46	46	Q9NTW7-1	599	645	+	46	Q9NTW7-1	238	645	ENST00000371523.8	464	1685	++	46	Q9NTW7-1#15	0	138	ENST00000371523.8	1547	1685	+	138	0	-92	10403
Q9NTW7-1#15	0	46	46	Q9NTW7-1	599	645	+	46	Q9NTW7-1	0	645	ENST00000361387.6	61	1996	++	40	Q9NTW7-1#15	0	138	ENST00000361387.6	1858	1996	+	138	0	-92	10404
Q9NTW7-1#16	0	18	18	Q9NTW7-1	542	560	+	18	Q9NTW7-1	238	645	ENST00000371523.8	464	1685	++	46	Q9NTW7-1#16	0	54	ENST00000371523.8	1376	1430	+	54	0	-36	10405
Q9NTW7-1#16	0	18	18	Q9NTW7-1	542	560	+	18	Q9NTW7-1	0	645	ENST00000361387.6	61	1996	++	40	Q9NTW7-1#16	0	54	ENST00000361387.6	1687	1741	+	54	0	-36	10406
Q9NTW7-1#17	0	25	25	Q9NTW7-1	607	632	+	25	Q9NTW7-1	238	645	ENST00000371523.8	464	1685	++	46	Q9NTW7-1#17	0	75	ENST00000371523.8	1571	1646	+	75	0	-50	10407
Q9NTW7-1#17	0	25	25	Q9NTW7-1	607	632	+	25	Q9NTW7-1	0	645	ENST00000361387.6	61	1996	++	40	Q9NTW7-1#17	0	75	ENST00000361387.6	1882	1957	+	75	0	-50	10408
Q9NTW7-1#18	0	219	219	Q9NTW7-1	0	219	+	219	Q9NTW7-1	0	410	ENST00000371518.6	143	1373	++	45	Q9NTW7-1#18	0	657	ENST00000371518.6	143	800	+	657	0	-438	10409
Q9NTW7-1#18	0	219	219	Q9NTW7-1	0	219	+	219	Q9NTW7-1	0	645	ENST00000361387.6	61	1996	++	40	Q9NTW7-1#18	0	657	ENST00000361387.6	61	718	+	657	0	-438	10410
Q9NTW7-1#19	0	3	3	Q9NTW7-1	15	18	+	3	Q9NTW7-1	0	410	ENST00000371518.6	143	1373	++	45	Q9NTW7-1#19	0	9	ENST00000371518.6	188	197	+	9	0	-6	10411
Q9NTW7-1#19	0	3	3	Q9NTW7-1	15	18	+	3	Q9NTW7-1	0	645	ENST00000361387.6	61	1996	++	40	Q9NTW7-1#19	0	9	ENST00000361387.6	106	115	+	9	0	-6	10412
Q9NTW7-1#20	0	54	54	Q9NTW7-1	95	149	+	54	Q9NTW7-1	0	410	ENST00000371518.6	143	1373	++	45	Q9NTW7-1#20	0	162	ENST00000371518.6	428	590	+	162	0	-108	10413
Q9NTW7-1#20	0	54	54	Q9NTW7-1	95	149	+	54	Q9NTW7-1	0	645	ENST00000361387.6	61	1996	++	40	Q9NTW7-1#20	0	162	ENST00000361387.6	346	508	+	162	0	-108	10414
Q9NTW7-1#21	0	35	35	Q9NTW7-1	219	254	+	35	Q9NTW7-1	251	418	ENST00000395989.7	261	762	++	65	Q9NTW7-1#21	96	105	ENST00000395989.7	261	270	+	9	96	-70	10415
Q9NTW7-1#21	0	35	35	Q9NTW7-1	219	254	+	35	Q9NTW7-1	251	325	ENST00000395979.1	188	410	++	64	Q9NTW7-1#21	96	105	ENST00000395979.1	188	197	+	9	96	-70	10416
Q9NTW7-1#21	0	35	35	Q9NTW7-1	219	254	+	35	Q9NTW7-1	238	645	ENST00000371523.8	464	1685	++	46	Q9NTW7-1#21	57	105	ENST00000371523.8	464	512	+	48	57	-70	10417
Q9NTW7-1#21	0	35	35	Q9NTW7-1	219	254	+	35	Q9NTW7-1	0	410	ENST00000371518.6	143	1373	++	45	Q9NTW7-1#21	0	105	ENST00000371518.6	800	905	+	105	0	-70	10418
Q9NTW7-1#21	0	35	35	Q9NTW7-1	219	254	+	35	Q9NTW7-1	0	645	ENST00000361387.6	61	1996	++	40	Q9NTW7-1#21	0	105	ENST00000361387.6	718	823	+	105	0	-70	10419
Q9NTW7-1#22	0	155	155	Q9NTW7-1	235	390	+	155	Q9NTW7-1	295	413	ENST00000456175.5	1	355	++	103	Q9NTW7-1#22	180	465	ENST00000456175.5	1	286	+	285	180	-310	10420
Q9NTW7-1#22	0	155	155	Q9NTW7-1	235	390	+	155	Q9NTW7-1	251	418	ENST00000395989.7	261	762	++	65	Q9NTW7-1#22	48	465	ENST00000395989.7	261	678	+	417	48	-310	10421
Q9NTW7-1#22	0	155	155	Q9NTW7-1	235	390	+	155	Q9NTW7-1	251	325	ENST00000395979.1	188	410	++	64	Q9NTW7-1#22	48	270	ENST00000395979.1	188	410	+	222	48	-115	10422
Q9NTW7-1#22	0	155	155	Q9NTW7-1	235	390	+	155	Q9NTW7-1	238	645	ENST00000371523.8	464	1685	++	46	Q9NTW7-1#22	9	465	ENST00000371523.8	464	920	+	456	9	-310	10423
Q9NTW7-1#22	0	155	155	Q9NTW7-1	235	390	+	155	Q9NTW7-1	0	410	ENST00000371518.6	143	1373	++	45	Q9NTW7-1#22	0	465	ENST00000371518.6	848	1313	+	465	0	-310	10424
Q9NTW7-1#22	0	155	155	Q9NTW7-1	235	390	+	155	Q9NTW7-1	0	645	ENST00000361387.6	61	1996	++	40	Q9NTW7-1#22	0	465	ENST00000361387.6	766	1231	+	465	0	-310	10425
Q9NTW7-1#23	0	5	5	Q9NTW7-1	410	415	+	5	Q9NTW7-1	295	413	ENST00000456175.5	1	355	++	103	Q9NTW7-1#23	0	9	ENST00000456175.5	346	355	+	9	0	-4	10426
Q9NTW7-1#23	0	5	5	Q9NTW7-1	410	415	+	5	Q9NTW7-1	251	418	ENST00000395989.7	261	762	++	65	Q9NTW7-1#23	0	15	ENST00000395989.7	738	753	+	15	0	-10	10427
Q9NTW7-1#23	0	5	5	Q9NTW7-1	410	415	+	5	Q9NTW7-1	238	645	ENST00000371523.8	464	1685	++	46	Q9NTW7-1#23	0	15	ENST00000371523.8	980	995	+	15	0	-10	10428
Q9NTW7-1#23	0	5	5	Q9NTW7-1	410	415	+	5	Q9NTW7-1	0	645	ENST00000361387.6	61	1996	++	40	Q9NTW7-1#23	0	15	ENST00000361387.6	1291	1306	+	15	0	-10	10429
Q9NTW7-1#24	0	234	234	Q9NTW7-1	411	645	+	234	Q9NTW7-1	295	413	ENST00000456175.5	1	355	++	103	Q9NTW7-1#24	0	6	ENST00000456175.5	349	355	+	6	0	228	10430
Q9NTW7-1#24	0	234	234	Q9NTW7-1	411	645	+	234	Q9NTW7-1	251	418	ENST00000395989.7	261	762	++	65	Q9NTW7-1#24	0	21	ENST00000395989.7	741	762	+	21	0	213	10431
Q9NTW7-1#24	0	234	234	Q9NTW7-1	411	645	+	234	Q9NTW7-1	238	645	ENST00000371523.8	464	1685	++	46	Q9NTW7-1#24	0	702	ENST00000371523.8	983	1685	+	702	0	-468	10432
Q9NTW7-1#24	0	234	234	Q9NTW7-1	411	645	+	234	Q9NTW7-1	0	645	ENST00000361387.6	61	1996	++	40	Q9NTW7-1#24	0	702	ENST00000361387.6	1294	1996	+	702	0	-468	10433
Q9NTW7-1#25	0	230	230	Q9NTW7-1	415	645	+	230	Q9NTW7-1	251	418	ENST00000395989.7	261	762	++	65	Q9NTW7-1#25	0	9	ENST00000395989.7	753	762	+	9	0	221	10434
Q9NTW7-1#25	0	230	230	Q9NTW7-1	415	645	+	230	Q9NTW7-1	238	645	ENST00000371523.8	464	1685	++	46	Q9NTW7-1#25	0	690	ENST00000371523.8	995	1685	+	690	0	-460	10435
Q9NTW7-1#25	0	230	230	Q9NTW7-1	415	645	+	230	Q9NTW7-1	0	645	ENST00000361387.6	61	1996	++	40	Q9NTW7-1#25	0	690	ENST00000361387.6	1306	1996	+	690	0	-460	10436
Q9NTW7-1#26	0	1	1	Q9NTW7-1	67	68	+	1	Q9NTW7-1	0	410	ENST00000371518.6	143	1373	++	45	Q9NTW7-1#26	0	3	ENST00000371518.6	344	347	+	3	0	-2	10437
Q9NTW7-1#26	0	1	1	Q9NTW7-1	67	68	+	1	Q9NTW7-1	0	645	ENST00000361387.6	61	1996	++	40	Q9NTW7-1#26	0	3	ENST00000361387.6	262	265	+	3	0	-2	10438
Q9NTW7-1#27	0	1	1	Q9NTW7-1	138	139	+	1	Q9NTW7-1	0	410	ENST00000371518.6	143	1373	++	45	Q9NTW7-1#27	0	3	ENST00000371518.6	557	560	+	3	0	-2	10439
Q9NTW7-1#27	0	1	1	Q9NTW7-1	138	139	+	1	Q9NTW7-1	0	645	ENST00000361387.6	61	1996	++	40	Q9NTW7-1#27	0	3	ENST00000361387.6	475	478	+	3	0	-2	10440
Q9NTW7-1#28	0	1	1	Q9NTW7-1	592	593	+	1	Q9NTW7-1	238	645	ENST00000371523.8	464	1685	++	46	Q9NTW7-1#28	0	3	ENST00000371523.8	1526	1529	+	3	0	-2	10441
Q9NTW7-1#28	0	1	1	Q9NTW7-1	592	593	+	1	Q9NTW7-1	0	645	ENST00000361387.6	61	1996	++	40	Q9NTW7-1#28	0	3	ENST00000361387.6	1837	1840	+	3	0	-2	10442
Q9NTW7-1#29	0	1	1	Q9NTW7-1	608	609	+	1	Q9NTW7-1	238	645	ENST00000371523.8	464	1685	++	46	Q9NTW7-1#29	0	3	ENST00000371523.8	1574	1577	+	3	0	-2	10443
Q9NTW7-1#29	0	1	1	Q9NTW7-1	608	609	+	1	Q9NTW7-1	0	645	ENST00000361387.6	61	1996	++	40	Q9NTW7-1#29	0	3	ENST00000361387.6	1885	1888	+	3	0	-2	10444
Q9NTW7-1#30	0	1	1	Q9NTW7-1	239	240	+	1	Q9NTW7-1	238	645	ENST00000371523.8	464	1685	++	46	Q9NTW7-1#30	0	3	ENST00000371523.8	467	470	+	3	0	-2	10445
Q9NTW7-1#30	0	1	1	Q9NTW7-1	239	240	+	1	Q9NTW7-1	0	410	ENST00000371518.6	143	1373	++	45	Q9NTW7-1#30	0	3	ENST00000371518.6	860	863	+	3	0	-2	10446
Q9NTW7-1#30	0	1	1	Q9NTW7-1	239	240	+	1	Q9NTW7-1	0	645	ENST00000361387.6	61	1996	++	40	Q9NTW7-1#30	0	3	ENST00000361387.6	778	781	+	3	0	-2	10447
Q9NTW7-1#31	0	1	1	Q9NTW7-1	520	521	+	1	Q9NTW7-1	238	645	ENST00000371523.8	464	1685	++	46	Q9NTW7-1#31	0	3	ENST00000371523.8	1310	1313	+	3	0	-2	10448
Q9NTW7-1#31	0	1	1	Q9NTW7-1	520	521	+	1	Q9NTW7-1	0	645	ENST00000361387.6	61	1996	++	40	Q9NTW7-1#31	0	3	ENST00000361387.6	1621	1624	+	3	0	-2	10449
Q9NTW7-1#32	0	3	3	Q9NTW7-1	177	180	+	3	Q9NTW7-1	0	410	ENST00000371518.6	143	1373	++	45	Q9NTW7-1#32	0	9	ENST00000371518.6	674	683	+	9	0	-6	10450
Q9NTW7-1#32	0	3	3	Q9NTW7-1	177	180	+	3	Q9NTW7-1	0	645	ENST00000361387.6	61	1996	++	40	Q9NTW7-1#32	0	9	ENST00000361387.6	592	601	+	9	0	-6	10451
Q9NTW7-1#33	0	7	7	Q9NTW7-1	186	193	+	7	Q9NTW7-1	0	410	ENST00000371518.6	143	1373	++	45	Q9NTW7-1#33	0	21	ENST00000371518.6	701	722	+	21	0	-14	10452
Q9NTW7-1#33	0	7	7	Q9NTW7-1	186	193	+	7	Q9NTW7-1	0	645	ENST00000361387.6	61	1996	++	40	Q9NTW7-1#33	0	21	ENST00000361387.6	619	640	+	21	0	-14	10453
Q9NTW7-1#34	0	3	3	Q9NTW7-1	193	196	+	3	Q9NTW7-1	0	410	ENST00000371518.6	143	1373	++	45	Q9NTW7-1#34	0	9	ENST00000371518.6	722	731	+	9	0	-6	10454
Q9NTW7-1#34	0	3	3	Q9NTW7-1	193	196	+	3	Q9NTW7-1	0	645	ENST00000361387.6	61	1996	++	40	Q9NTW7-1#34	0	9	ENST00000361387.6	640	649	+	9	0	-6	10455
Q9NTW7-1#35	0	3	3	Q9NTW7-1	201	204	+	3	Q9NTW7-1	0	410	ENST00000371518.6	143	1373	++	45	Q9NTW7-1#35	0	9	ENST00000371518.6	746	755	+	9	0	-6	10456
Q9NTW7-1#35	0	3	3	Q9NTW7-1	201	204	+	3	Q9NTW7-1	0	645	ENST00000361387.6	61	1996	++	40	Q9NTW7-1#35	0	9	ENST00000361387.6	664	673	+	9	0	-6	10457
Q9NTW7-1#36	0	3	3	Q9NTW7-1	205	208	+	3	Q9NTW7-1	0	410	ENST00000371518.6	143	1373	++	45	Q9NTW7-1#36	0	9	ENST00000371518.6	758	767	+	9	0	-6	10458
Q9NTW7-1#36	0	3	3	Q9NTW7-1	205	208	+	3	Q9NTW7-1	0	645	ENST00000361387.6	61	1996	++	40	Q9NTW7-1#36	0	9	ENST00000361387.6	676	685	+	9	0	-6	10459
Q9NTW7-1#37	0	4	4	Q9NTW7-1	210	214	+	4	Q9NTW7-1	0	410	ENST00000371518.6	143	1373	++	45	Q9NTW7-1#37	0	12	ENST00000371518.6	773	785	+	12	0	-8	10460
Q9NTW7-1#37	0	4	4	Q9NTW7-1	210	214	+	4	Q9NTW7-1	0	645	ENST00000361387.6	61	1996	++	40	Q9NTW7-1#37	0	12	ENST00000361387.6	691	703	+	12	0	-8	10461
Q9NTW7-1#38	0	10	10	Q9NTW7-1	214	224	+	10	Q9NTW7-1	0	410	ENST00000371518.6	143	1373	++	45	Q9NTW7-1#38	0	30	ENST00000371518.6	785	815	+	30	0	-20	10462
Q9NTW7-1#38	0	10	10	Q9NTW7-1	214	224	+	10	Q9NTW7-1	0	645	ENST00000361387.6	61	1996	++	40	Q9NTW7-1#38	0	30	ENST00000361387.6	703	733	+	30	0	-20	10463
Q9NTW7-1#39	0	4	4	Q9NTW7-1	233	237	+	4	Q9NTW7-1	0	410	ENST00000371518.6	143	1373	++	45	Q9NTW7-1#39	0	12	ENST00000371518.6	842	854	+	12	0	-8	10464
Q9NTW7-1#39	0	4	4	Q9NTW7-1	233	237	+	4	Q9NTW7-1	0	645	ENST00000361387.6	61	1996	++	40	Q9NTW7-1#39	0	12	ENST00000361387.6	760	772	+	12	0	-8	10465
Q9NTW7-1#40	0	4	4	Q9NTW7-1	238	242	+	4	Q9NTW7-1	238	645	ENST00000371523.8	464	1685	++	46	Q9NTW7-1#40	0	12	ENST00000371523.8	464	476	+	12	0	-8	10466
Q9NTW7-1#40	0	4	4	Q9NTW7-1	238	242	+	4	Q9NTW7-1	0	410	ENST00000371518.6	143	1373	++	45	Q9NTW7-1#40	0	12	ENST00000371518.6	857	869	+	12	0	-8	10467
Q9NTW7-1#40	0	4	4	Q9NTW7-1	238	242	+	4	Q9NTW7-1	0	645	ENST00000361387.6	61	1996	++	40	Q9NTW7-1#40	0	12	ENST00000361387.6	775	787	+	12	0	-8	10468
Q9NTW7-1#41	0	8	8	Q9NTW7-1	242	250	+	8	Q9NTW7-1	238	645	ENST00000371523.8	464	1685	++	46	Q9NTW7-1#41	0	24	ENST00000371523.8	476	500	+	24	0	-16	10469
Q9NTW7-1#41	0	8	8	Q9NTW7-1	242	250	+	8	Q9NTW7-1	0	410	ENST00000371518.6	143	1373	++	45	Q9NTW7-1#41	0	24	ENST00000371518.6	869	893	+	24	0	-16	10470
Q9NTW7-1#41	0	8	8	Q9NTW7-1	242	250	+	8	Q9NTW7-1	0	645	ENST00000361387.6	61	1996	++	40	Q9NTW7-1#41	0	24	ENST00000361387.6	787	811	+	24	0	-16	10471
Q9NTW7-1#42	0	3	3	Q9NTW7-1	493	496	+	3	Q9NTW7-1	238	645	ENST00000371523.8	464	1685	++	46	Q9NTW7-1#42	0	9	ENST00000371523.8	1229	1238	+	9	0	-6	10472
Q9NTW7-1#42	0	3	3	Q9NTW7-1	493	496	+	3	Q9NTW7-1	0	645	ENST00000361387.6	61	1996	++	40	Q9NTW7-1#42	0	9	ENST00000361387.6	1540	1549	+	9	0	-6	10473
Q9NTW7-1#43	0	4	4	Q9NTW7-1	497	501	+	4	Q9NTW7-1	238	645	ENST00000371523.8	464	1685	++	46	Q9NTW7-1#43	0	12	ENST00000371523.8	1241	1253	+	12	0	-8	10474
Q9NTW7-1#43	0	4	4	Q9NTW7-1	497	501	+	4	Q9NTW7-1	0	645	ENST00000361387.6	61	1996	++	40	Q9NTW7-1#43	0	12	ENST00000361387.6	1552	1564	+	12	0	-8	10475
Q9NTW7-1#44	0	4	4	Q9NTW7-1	502	506	+	4	Q9NTW7-1	238	645	ENST00000371523.8	464	1685	++	46	Q9NTW7-1#44	0	12	ENST00000371523.8	1256	1268	+	12	0	-8	10476
Q9NTW7-1#44	0	4	4	Q9NTW7-1	502	506	+	4	Q9NTW7-1	0	645	ENST00000361387.6	61	1996	++	40	Q9NTW7-1#44	0	12	ENST00000361387.6	1567	1579	+	12	0	-8	10477
Q9NTW7-1#45	0	8	8	Q9NTW7-1	506	514	+	8	Q9NTW7-1	238	645	ENST00000371523.8	464	1685	++	46	Q9NTW7-1#45	0	24	ENST00000371523.8	1268	1292	+	24	0	-16	10478
Q9NTW7-1#45	0	8	8	Q9NTW7-1	506	514	+	8	Q9NTW7-1	0	645	ENST00000361387.6	61	1996	++	40	Q9NTW7-1#45	0	24	ENST00000361387.6	1579	1603	+	24	0	-16	10479
Q9NTW7-1#46	0	3	3	Q9NTW7-1	514	517	+	3	Q9NTW7-1	238	645	ENST00000371523.8	464	1685	++	46	Q9NTW7-1#46	0	9	ENST00000371523.8	1292	1301	+	9	0	-6	10480
Q9NTW7-1#46	0	3	3	Q9NTW7-1	514	517	+	3	Q9NTW7-1	0	645	ENST00000361387.6	61	1996	++	40	Q9NTW7-1#46	0	9	ENST00000361387.6	1603	1612	+	9	0	-6	10481
Q9NTW7-1#47	0	3	3	Q9NTW7-1	521	524	+	3	Q9NTW7-1	238	645	ENST00000371523.8	464	1685	++	46	Q9NTW7-1#47	0	9	ENST00000371523.8	1313	1322	+	9	0	-6	10482
Q9NTW7-1#47	0	3	3	Q9NTW7-1	521	524	+	3	Q9NTW7-1	0	645	ENST00000361387.6	61	1996	++	40	Q9NTW7-1#47	0	9	ENST00000361387.6	1624	1633	+	9	0	-6	10483
Q9NTW7-1#48	0	4	4	Q9NTW7-1	525	529	+	4	Q9NTW7-1	238	645	ENST00000371523.8	464	1685	++	46	Q9NTW7-1#48	0	12	ENST00000371523.8	1325	1337	+	12	0	-8	10484
Q9NTW7-1#48	0	4	4	Q9NTW7-1	525	529	+	4	Q9NTW7-1	0	645	ENST00000361387.6	61	1996	++	40	Q9NTW7-1#48	0	12	ENST00000361387.6	1636	1648	+	12	0	-8	10485
Q9NTW7-1#49	0	4	4	Q9NTW7-1	530	534	+	4	Q9NTW7-1	238	645	ENST00000371523.8	464	1685	++	46	Q9NTW7-1#49	0	12	ENST00000371523.8	1340	1352	+	12	0	-8	10486
Q9NTW7-1#49	0	4	4	Q9NTW7-1	530	534	+	4	Q9NTW7-1	0	645	ENST00000361387.6	61	1996	++	40	Q9NTW7-1#49	0	12	ENST00000361387.6	1651	1663	+	12	0	-8	10487
Q9NTW7-1#50	0	12	12	Q9NTW7-1	534	546	+	12	Q9NTW7-1	238	645	ENST00000371523.8	464	1685	++	46	Q9NTW7-1#50	0	36	ENST00000371523.8	1352	1388	+	36	0	-24	10488
Q9NTW7-1#50	0	12	12	Q9NTW7-1	534	546	+	12	Q9NTW7-1	0	645	ENST00000361387.6	61	1996	++	40	Q9NTW7-1#50	0	36	ENST00000361387.6	1663	1699	+	36	0	-24	10489
Q9NTW7-1#51	0	1	1	Q9NTW7-1	544	545	+	1	Q9NTW7-1	238	645	ENST00000371523.8	464	1685	++	46	Q9NTW7-1#51	0	3	ENST00000371523.8	1382	1385	+	3	0	-2	10490
Q9NTW7-1#51	0	1	1	Q9NTW7-1	544	545	+	1	Q9NTW7-1	0	645	ENST00000361387.6	61	1996	++	40	Q9NTW7-1#51	0	3	ENST00000361387.6	1693	1696	+	3	0	-2	10491
Q9NTW7-1#52	0	1	1	Q9NTW7-1	285	286	+	1	Q9NTW7-1	251	418	ENST00000395989.7	261	762	++	65	Q9NTW7-1#52	0	3	ENST00000395989.7	363	366	+	3	0	-2	10492
Q9NTW7-1#52	0	1	1	Q9NTW7-1	285	286	+	1	Q9NTW7-1	251	325	ENST00000395979.1	188	410	++	64	Q9NTW7-1#52	0	3	ENST00000395979.1	290	293	+	3	0	-2	10493
Q9NTW7-1#52	0	1	1	Q9NTW7-1	285	286	+	1	Q9NTW7-1	238	645	ENST00000371523.8	464	1685	++	46	Q9NTW7-1#52	0	3	ENST00000371523.8	605	608	+	3	0	-2	10494
Q9NTW7-1#52	0	1	1	Q9NTW7-1	285	286	+	1	Q9NTW7-1	0	410	ENST00000371518.6	143	1373	++	45	Q9NTW7-1#52	0	3	ENST00000371518.6	998	1001	+	3	0	-2	10495
Q9NTW7-1#52	0	1	1	Q9NTW7-1	285	286	+	1	Q9NTW7-1	0	645	ENST00000361387.6	61	1996	++	40	Q9NTW7-1#52	0	3	ENST00000361387.6	916	919	+	3	0	-2	10496
Q9NTW7-1#53	0	1	1	Q9NTW7-1	396	397	+	1	Q9NTW7-1	295	413	ENST00000456175.5	1	355	++	103	Q9NTW7-1#53	0	3	ENST00000456175.5	304	307	+	3	0	-2	10497
Q9NTW7-1#53	0	1	1	Q9NTW7-1	396	397	+	1	Q9NTW7-1	251	418	ENST00000395989.7	261	762	++	65	Q9NTW7-1#53	0	3	ENST00000395989.7	696	699	+	3	0	-2	10498
Q9NTW7-1#53	0	1	1	Q9NTW7-1	396	397	+	1	Q9NTW7-1	238	645	ENST00000371523.8	464	1685	++	46	Q9NTW7-1#53	0	3	ENST00000371523.8	938	941	+	3	0	-2	10499
Q9NTW7-1#53	0	1	1	Q9NTW7-1	396	397	+	1	Q9NTW7-1	0	410	ENST00000371518.6	143	1373	++	45	Q9NTW7-1#53	0	3	ENST00000371518.6	1331	1334	+	3	0	-2	10500
Q9NTW7-1#53	0	1	1	Q9NTW7-1	396	397	+	1	Q9NTW7-1	0	645	ENST00000361387.6	61	1996	++	40	Q9NTW7-1#53	0	3	ENST00000361387.6	1249	1252	+	3	0	-2	10501
Q9NTW7-1#54	0	1	1	Q9NTW7-1	424	425	+	1	Q9NTW7-1	238	645	ENST00000371523.8	464	1685	++	46	Q9NTW7-1#54	0	3	ENST00000371523.8	1022	1025	+	3	0	-2	10502
Q9NTW7-1#54	0	1	1	Q9NTW7-1	424	425	+	1	Q9NTW7-1	0	645	ENST00000361387.6	61	1996	++	40	Q9NTW7-1#54	0	3	ENST00000361387.6	1333	1336	+	3	0	-2	10503
Q9NTW7-1#55	0	1	1	Q9NTW7-1	450	451	+	1	Q9NTW7-1	238	645	ENST00000371523.8	464	1685	++	46	Q9NTW7-1#55	0	3	ENST00000371523.8	1100	1103	+	3	0	-2	10504
Q9NTW7-1#55	0	1	1	Q9NTW7-1	450	451	+	1	Q9NTW7-1	0	645	ENST00000361387.6	61	1996	++	40	Q9NTW7-1#55	0	3	ENST00000361387.6	1411	1414	+	3	0	-2	10505
