#srcQName	srcQStart	srcQEnd	srcQSize	srcTName	srcTStart	srcTEnd	srcStrand	srcAligned	mappingQName	mappingQStart	mappingQEnd	mappingTName	mappingTStart	mappingTEnd	mappingStrand	mappingId	mappedQName	mappedQStart	mappedQEnd	mappedTName	mappedTStart	mappedTEnd	mappedStrand	mappedAligned	qStartTrunc	qEndTrunc	mappedPslLine
Q9BXI3#0	0	368	368	Q9BXI3	0	368	+	368	Q9BXI3	0	368	Q9BXI3	0	368	+	89	Q9BXI3#0	0	368	Q9BXI3	0	368	+	368	0	0	0
Q9BXI3#1	0	22	22	Q9BXI3	0	22	+	22	Q9BXI3	0	368	Q9BXI3	0	368	+	89	Q9BXI3#1	0	22	Q9BXI3	0	22	+	22	0	0	1
Q9BXI3#2	0	1	1	Q9BXI3	210	211	+	1	Q9BXI3	0	368	Q9BXI3	0	368	+	89	Q9BXI3#2	0	1	Q9BXI3	210	211	+	1	0	0	2
Q9BXI3#3	0	3	3	Q9BXI3	8	11	+	3	Q9BXI3	0	368	Q9BXI3	0	368	+	89	Q9BXI3#3	0	3	Q9BXI3	8	11	+	3	0	0	3
Q96P26-1#0	0	610	610	Q96P26-1	0	610	+	610	Q96P26-1	0	595	Q96P26-4	0	595	+	84	Q96P26-1#0	0	595	Q96P26-4	0	595	+	595	0	15	4
Q96P26-1#0	0	610	610	Q96P26-1	0	610	+	610	Q96P26-1	208	610	Q96P26-3	0	402	+	83	Q96P26-1#0	208	610	Q96P26-3	0	402	+	402	208	0	5
Q96P26-1#0	0	610	610	Q96P26-1	0	610	+	610	Q96P26-1	0	610	Q96P26-2	0	550	+	82	Q96P26-1#0	0	610	Q96P26-2	0	550	+	550	0	0	6
Q96P26-1#0	0	610	610	Q96P26-1	0	610	+	610	Q96P26-1	0	610	Q96P26-1	0	610	+	81	Q96P26-1#0	0	610	Q96P26-1	0	610	+	610	0	0	7
Q96P26-1#1	0	34	34	Q96P26-1	0	34	+	34	Q96P26-1	0	595	Q96P26-4	0	595	+	84	Q96P26-1#1	0	34	Q96P26-4	0	34	+	34	0	0	8
Q96P26-1#1	0	34	34	Q96P26-1	0	34	+	34	Q96P26-1	0	610	Q96P26-2	0	550	+	82	Q96P26-1#1	0	34	Q96P26-2	0	34	+	34	0	0	9
Q96P26-1#1	0	34	34	Q96P26-1	0	34	+	34	Q96P26-1	0	610	Q96P26-1	0	610	+	81	Q96P26-1#1	0	34	Q96P26-1	0	34	+	34	0	0	10
Q96P26-1#2	0	177	177	Q96P26-1	100	277	+	177	Q96P26-1	0	595	Q96P26-4	0	595	+	84	Q96P26-1#2	0	177	Q96P26-4	100	277	+	177	0	0	11
Q96P26-1#2	0	177	177	Q96P26-1	100	277	+	177	Q96P26-1	208	610	Q96P26-3	0	402	+	83	Q96P26-1#2	108	177	Q96P26-3	0	69	+	69	108	0	12
Q96P26-1#2	0	177	177	Q96P26-1	100	277	+	177	Q96P26-1	0	610	Q96P26-2	0	550	+	82	Q96P26-1#2	0	177	Q96P26-2	40	217	+	177	0	0	13
Q96P26-1#2	0	177	177	Q96P26-1	100	277	+	177	Q96P26-1	0	610	Q96P26-1	0	610	+	81	Q96P26-1#2	0	177	Q96P26-1	100	277	+	177	0	0	14
Q96P26-1#3	0	23	23	Q96P26-1	11	34	+	23	Q96P26-1	0	595	Q96P26-4	0	595	+	84	Q96P26-1#3	0	23	Q96P26-4	11	34	+	23	0	0	15
Q96P26-1#3	0	23	23	Q96P26-1	11	34	+	23	Q96P26-1	0	610	Q96P26-2	0	550	+	82	Q96P26-1#3	0	23	Q96P26-2	11	34	+	23	0	0	16
Q96P26-1#3	0	23	23	Q96P26-1	11	34	+	23	Q96P26-1	0	610	Q96P26-1	0	610	+	81	Q96P26-1#3	0	23	Q96P26-1	11	34	+	23	0	0	17
Q96P26-1#4	0	71	71	Q96P26-1	100	171	+	71	Q96P26-1	0	595	Q96P26-4	0	595	+	84	Q96P26-1#4	0	71	Q96P26-4	100	171	+	71	0	0	18
Q96P26-1#4	0	71	71	Q96P26-1	100	171	+	71	Q96P26-1	0	610	Q96P26-2	0	550	+	82	Q96P26-1#4	0	71	Q96P26-2	40	111	+	71	0	0	19
Q96P26-1#4	0	71	71	Q96P26-1	100	171	+	71	Q96P26-1	0	610	Q96P26-1	0	610	+	81	Q96P26-1#4	0	71	Q96P26-1	100	171	+	71	0	0	20
Q96P26-1#5	0	30	30	Q96P26-1	171	201	+	30	Q96P26-1	0	595	Q96P26-4	0	595	+	84	Q96P26-1#5	0	30	Q96P26-4	171	201	+	30	0	0	21
Q96P26-1#5	0	30	30	Q96P26-1	171	201	+	30	Q96P26-1	0	610	Q96P26-2	0	550	+	82	Q96P26-1#5	0	30	Q96P26-2	111	141	+	30	0	0	22
Q96P26-1#5	0	30	30	Q96P26-1	171	201	+	30	Q96P26-1	0	610	Q96P26-1	0	610	+	81	Q96P26-1#5	0	30	Q96P26-1	171	201	+	30	0	0	23
Q96P26-1#6	0	36	36	Q96P26-1	230	266	+	36	Q96P26-1	0	595	Q96P26-4	0	595	+	84	Q96P26-1#6	0	36	Q96P26-4	230	266	+	36	0	0	24
Q96P26-1#6	0	36	36	Q96P26-1	230	266	+	36	Q96P26-1	208	610	Q96P26-3	0	402	+	83	Q96P26-1#6	0	36	Q96P26-3	22	58	+	36	0	0	25
Q96P26-1#6	0	36	36	Q96P26-1	230	266	+	36	Q96P26-1	0	610	Q96P26-2	0	550	+	82	Q96P26-1#6	0	36	Q96P26-2	170	206	+	36	0	0	26
Q96P26-1#6	0	36	36	Q96P26-1	230	266	+	36	Q96P26-1	0	610	Q96P26-1	0	610	+	81	Q96P26-1#6	0	36	Q96P26-1	230	266	+	36	0	0	27
Q96P26-1#7	0	1	1	Q96P26-1	466	467	+	1	Q96P26-1	0	595	Q96P26-4	0	595	+	84	Q96P26-1#7	0	1	Q96P26-4	466	467	+	1	0	0	28
Q96P26-1#7	0	1	1	Q96P26-1	466	467	+	1	Q96P26-1	208	610	Q96P26-3	0	402	+	83	Q96P26-1#7	0	1	Q96P26-3	258	259	+	1	0	0	29
Q96P26-1#7	0	1	1	Q96P26-1	466	467	+	1	Q96P26-1	0	610	Q96P26-2	0	550	+	82	Q96P26-1#7	0	1	Q96P26-2	406	407	+	1	0	0	30
Q96P26-1#7	0	1	1	Q96P26-1	466	467	+	1	Q96P26-1	0	610	Q96P26-1	0	610	+	81	Q96P26-1#7	0	1	Q96P26-1	466	467	+	1	0	0	31
Q96P26-1#8	0	208	208	Q96P26-1	0	208	+	208	Q96P26-1	0	595	Q96P26-4	0	595	+	84	Q96P26-1#8	0	208	Q96P26-4	0	208	+	208	0	0	32
Q96P26-1#8	0	208	208	Q96P26-1	0	208	+	208	Q96P26-1	0	610	Q96P26-2	0	550	+	82	Q96P26-1#8	0	208	Q96P26-2	0	148	+	148	0	0	33
Q96P26-1#8	0	208	208	Q96P26-1	0	208	+	208	Q96P26-1	0	610	Q96P26-1	0	610	+	81	Q96P26-1#8	0	208	Q96P26-1	0	208	+	208	0	0	34
Q96P26-1#9	0	60	60	Q96P26-1	40	100	+	60	Q96P26-1	0	595	Q96P26-4	0	595	+	84	Q96P26-1#9	0	60	Q96P26-4	40	100	+	60	0	0	35
Q96P26-1#9	0	60	60	Q96P26-1	40	100	+	60	Q96P26-1	0	610	Q96P26-1	0	610	+	81	Q96P26-1#9	0	60	Q96P26-1	40	100	+	60	0	0	36
Q96P26-1#10	0	15	15	Q96P26-1	595	610	+	15	Q96P26-1	208	610	Q96P26-3	0	402	+	83	Q96P26-1#10	0	15	Q96P26-3	387	402	+	15	0	0	37
Q96P26-1#10	0	15	15	Q96P26-1	595	610	+	15	Q96P26-1	0	610	Q96P26-2	0	550	+	82	Q96P26-1#10	0	15	Q96P26-2	535	550	+	15	0	0	38
Q96P26-1#10	0	15	15	Q96P26-1	595	610	+	15	Q96P26-1	0	610	Q96P26-1	0	610	+	81	Q96P26-1#10	0	15	Q96P26-1	595	610	+	15	0	0	39
Q96P26-1#11	0	1	1	Q96P26-1	172	173	+	1	Q96P26-1	0	595	Q96P26-4	0	595	+	84	Q96P26-1#11	0	1	Q96P26-4	172	173	+	1	0	0	40
Q96P26-1#11	0	1	1	Q96P26-1	172	173	+	1	Q96P26-1	0	610	Q96P26-2	0	550	+	82	Q96P26-1#11	0	1	Q96P26-2	112	113	+	1	0	0	41
Q96P26-1#11	0	1	1	Q96P26-1	172	173	+	1	Q96P26-1	0	610	Q96P26-1	0	610	+	81	Q96P26-1#11	0	1	Q96P26-1	172	173	+	1	0	0	42
Q96P26-1#12	0	1	1	Q96P26-1	286	287	+	1	Q96P26-1	0	595	Q96P26-4	0	595	+	84	Q96P26-1#12	0	1	Q96P26-4	286	287	+	1	0	0	43
Q96P26-1#12	0	1	1	Q96P26-1	286	287	+	1	Q96P26-1	208	610	Q96P26-3	0	402	+	83	Q96P26-1#12	0	1	Q96P26-3	78	79	+	1	0	0	44
Q96P26-1#12	0	1	1	Q96P26-1	286	287	+	1	Q96P26-1	0	610	Q96P26-2	0	550	+	82	Q96P26-1#12	0	1	Q96P26-2	226	227	+	1	0	0	45
Q96P26-1#12	0	1	1	Q96P26-1	286	287	+	1	Q96P26-1	0	610	Q96P26-1	0	610	+	81	Q96P26-1#12	0	1	Q96P26-1	286	287	+	1	0	0	46
Q96P26-1#13	0	1	1	Q96P26-1	296	297	+	1	Q96P26-1	0	595	Q96P26-4	0	595	+	84	Q96P26-1#13	0	1	Q96P26-4	296	297	+	1	0	0	47
Q96P26-1#13	0	1	1	Q96P26-1	296	297	+	1	Q96P26-1	208	610	Q96P26-3	0	402	+	83	Q96P26-1#13	0	1	Q96P26-3	88	89	+	1	0	0	48
Q96P26-1#13	0	1	1	Q96P26-1	296	297	+	1	Q96P26-1	0	610	Q96P26-2	0	550	+	82	Q96P26-1#13	0	1	Q96P26-2	236	237	+	1	0	0	49
Q96P26-1#13	0	1	1	Q96P26-1	296	297	+	1	Q96P26-1	0	610	Q96P26-1	0	610	+	81	Q96P26-1#13	0	1	Q96P26-1	296	297	+	1	0	0	50
Q96P26-1#14	0	1	1	Q96P26-1	350	351	+	1	Q96P26-1	0	595	Q96P26-4	0	595	+	84	Q96P26-1#14	0	1	Q96P26-4	350	351	+	1	0	0	51
Q96P26-1#14	0	1	1	Q96P26-1	350	351	+	1	Q96P26-1	208	610	Q96P26-3	0	402	+	83	Q96P26-1#14	0	1	Q96P26-3	142	143	+	1	0	0	52
Q96P26-1#14	0	1	1	Q96P26-1	350	351	+	1	Q96P26-1	0	610	Q96P26-2	0	550	+	82	Q96P26-1#14	0	1	Q96P26-2	290	291	+	1	0	0	53
Q96P26-1#14	0	1	1	Q96P26-1	350	351	+	1	Q96P26-1	0	610	Q96P26-1	0	610	+	81	Q96P26-1#14	0	1	Q96P26-1	350	351	+	1	0	0	54
Q96P26-1#15	0	1	1	Q96P26-1	361	362	+	1	Q96P26-1	0	595	Q96P26-4	0	595	+	84	Q96P26-1#15	0	1	Q96P26-4	361	362	+	1	0	0	55
Q96P26-1#15	0	1	1	Q96P26-1	361	362	+	1	Q96P26-1	208	610	Q96P26-3	0	402	+	83	Q96P26-1#15	0	1	Q96P26-3	153	154	+	1	0	0	56
Q96P26-1#15	0	1	1	Q96P26-1	361	362	+	1	Q96P26-1	0	610	Q96P26-2	0	550	+	82	Q96P26-1#15	0	1	Q96P26-2	301	302	+	1	0	0	57
Q96P26-1#15	0	1	1	Q96P26-1	361	362	+	1	Q96P26-1	0	610	Q96P26-1	0	610	+	81	Q96P26-1#15	0	1	Q96P26-1	361	362	+	1	0	0	58
Q96P26-1#16	0	1	1	Q96P26-1	527	528	+	1	Q96P26-1	0	595	Q96P26-4	0	595	+	84	Q96P26-1#16	0	1	Q96P26-4	527	528	+	1	0	0	59
Q96P26-1#16	0	1	1	Q96P26-1	527	528	+	1	Q96P26-1	208	610	Q96P26-3	0	402	+	83	Q96P26-1#16	0	1	Q96P26-3	319	320	+	1	0	0	60
Q96P26-1#16	0	1	1	Q96P26-1	527	528	+	1	Q96P26-1	0	610	Q96P26-2	0	550	+	82	Q96P26-1#16	0	1	Q96P26-2	467	468	+	1	0	0	61
Q96P26-1#16	0	1	1	Q96P26-1	527	528	+	1	Q96P26-1	0	610	Q96P26-1	0	610	+	81	Q96P26-1#16	0	1	Q96P26-1	527	528	+	1	0	0	62
Q96P26-1#17	0	1	1	Q96P26-1	551	552	+	1	Q96P26-1	0	595	Q96P26-4	0	595	+	84	Q96P26-1#17	0	1	Q96P26-4	551	552	+	1	0	0	63
Q96P26-1#17	0	1	1	Q96P26-1	551	552	+	1	Q96P26-1	208	610	Q96P26-3	0	402	+	83	Q96P26-1#17	0	1	Q96P26-3	343	344	+	1	0	0	64
Q96P26-1#17	0	1	1	Q96P26-1	551	552	+	1	Q96P26-1	0	610	Q96P26-2	0	550	+	82	Q96P26-1#17	0	1	Q96P26-2	491	492	+	1	0	0	65
Q96P26-1#17	0	1	1	Q96P26-1	551	552	+	1	Q96P26-1	0	610	Q96P26-1	0	610	+	81	Q96P26-1#17	0	1	Q96P26-1	551	552	+	1	0	0	66
Q9H0P0-4#0	0	336	336	Q9H0P0-4	0	336	+	336	Q9H0P0-4	0	336	Q9H0P0-4	0	336	+	94	Q9H0P0-4#0	0	336	Q9H0P0-4	0	336	+	336	0	0	67
Q9H0P0-4#0	0	336	336	Q9H0P0-4	0	336	+	336	Q9H0P0-4	51	336	Q9H0P0-3	0	285	+	93	Q9H0P0-4#0	51	336	Q9H0P0-3	0	285	+	285	51	0	68
Q9H0P0-4#0	0	336	336	Q9H0P0-4	0	336	+	336	Q9H0P0-4	50	336	Q9H0P0-2	0	286	+	92	Q9H0P0-4#0	50	336	Q9H0P0-2	0	286	+	286	50	0	69
Q9H0P0-4#0	0	336	336	Q9H0P0-4	0	336	+	336	Q9H0P0-4	50	336	Q9H0P0-1	11	297	+	91	Q9H0P0-4#0	50	336	Q9H0P0-1	11	297	+	286	50	0	70
Q9H0P0-4#1	0	1	1	Q9H0P0-4	87	88	+	1	Q9H0P0-4	0	336	Q9H0P0-4	0	336	+	94	Q9H0P0-4#1	0	1	Q9H0P0-4	87	88	+	1	0	0	71
Q9H0P0-4#1	0	1	1	Q9H0P0-4	87	88	+	1	Q9H0P0-4	51	336	Q9H0P0-3	0	285	+	93	Q9H0P0-4#1	0	1	Q9H0P0-3	36	37	+	1	0	0	72
Q9H0P0-4#1	0	1	1	Q9H0P0-4	87	88	+	1	Q9H0P0-4	50	336	Q9H0P0-2	0	286	+	92	Q9H0P0-4#1	0	1	Q9H0P0-2	37	38	+	1	0	0	73
Q9H0P0-4#1	0	1	1	Q9H0P0-4	87	88	+	1	Q9H0P0-4	50	336	Q9H0P0-1	11	297	+	91	Q9H0P0-4#1	0	1	Q9H0P0-1	48	49	+	1	0	0	74
Q9H0P0-4#2	0	1	1	Q9H0P0-4	89	90	+	1	Q9H0P0-4	0	336	Q9H0P0-4	0	336	+	94	Q9H0P0-4#2	0	1	Q9H0P0-4	89	90	+	1	0	0	75
Q9H0P0-4#2	0	1	1	Q9H0P0-4	89	90	+	1	Q9H0P0-4	51	336	Q9H0P0-3	0	285	+	93	Q9H0P0-4#2	0	1	Q9H0P0-3	38	39	+	1	0	0	76
Q9H0P0-4#2	0	1	1	Q9H0P0-4	89	90	+	1	Q9H0P0-4	50	336	Q9H0P0-2	0	286	+	92	Q9H0P0-4#2	0	1	Q9H0P0-2	39	40	+	1	0	0	77
Q9H0P0-4#2	0	1	1	Q9H0P0-4	89	90	+	1	Q9H0P0-4	50	336	Q9H0P0-1	11	297	+	91	Q9H0P0-4#2	0	1	Q9H0P0-1	50	51	+	1	0	0	78
Q9H0P0-4#3	0	1	1	Q9H0P0-4	87	88	+	1	Q9H0P0-4	0	336	Q9H0P0-4	0	336	+	94	Q9H0P0-4#3	0	1	Q9H0P0-4	87	88	+	1	0	0	79
Q9H0P0-4#3	0	1	1	Q9H0P0-4	87	88	+	1	Q9H0P0-4	51	336	Q9H0P0-3	0	285	+	93	Q9H0P0-4#3	0	1	Q9H0P0-3	36	37	+	1	0	0	80
Q9H0P0-4#3	0	1	1	Q9H0P0-4	87	88	+	1	Q9H0P0-4	50	336	Q9H0P0-2	0	286	+	92	Q9H0P0-4#3	0	1	Q9H0P0-2	37	38	+	1	0	0	81
Q9H0P0-4#3	0	1	1	Q9H0P0-4	87	88	+	1	Q9H0P0-4	50	336	Q9H0P0-1	11	297	+	91	Q9H0P0-4#3	0	1	Q9H0P0-1	48	49	+	1	0	0	82
Q9H0P0-4#4	0	1	1	Q9H0P0-4	89	90	+	1	Q9H0P0-4	0	336	Q9H0P0-4	0	336	+	94	Q9H0P0-4#4	0	1	Q9H0P0-4	89	90	+	1	0	0	83
Q9H0P0-4#4	0	1	1	Q9H0P0-4	89	90	+	1	Q9H0P0-4	51	336	Q9H0P0-3	0	285	+	93	Q9H0P0-4#4	0	1	Q9H0P0-3	38	39	+	1	0	0	84
Q9H0P0-4#4	0	1	1	Q9H0P0-4	89	90	+	1	Q9H0P0-4	50	336	Q9H0P0-2	0	286	+	92	Q9H0P0-4#4	0	1	Q9H0P0-2	39	40	+	1	0	0	85
Q9H0P0-4#4	0	1	1	Q9H0P0-4	89	90	+	1	Q9H0P0-4	50	336	Q9H0P0-1	11	297	+	91	Q9H0P0-4#4	0	1	Q9H0P0-1	50	51	+	1	0	0	86
Q9H0P0-4#5	0	1	1	Q9H0P0-4	134	135	+	1	Q9H0P0-4	0	336	Q9H0P0-4	0	336	+	94	Q9H0P0-4#5	0	1	Q9H0P0-4	134	135	+	1	0	0	87
Q9H0P0-4#5	0	1	1	Q9H0P0-4	134	135	+	1	Q9H0P0-4	51	336	Q9H0P0-3	0	285	+	93	Q9H0P0-4#5	0	1	Q9H0P0-3	83	84	+	1	0	0	88
Q9H0P0-4#5	0	1	1	Q9H0P0-4	134	135	+	1	Q9H0P0-4	50	336	Q9H0P0-2	0	286	+	92	Q9H0P0-4#5	0	1	Q9H0P0-2	84	85	+	1	0	0	89
Q9H0P0-4#5	0	1	1	Q9H0P0-4	134	135	+	1	Q9H0P0-4	50	336	Q9H0P0-1	11	297	+	91	Q9H0P0-4#5	0	1	Q9H0P0-1	95	96	+	1	0	0	90
Q9H0P0-4#6	0	1	1	Q9H0P0-4	134	135	+	1	Q9H0P0-4	0	336	Q9H0P0-4	0	336	+	94	Q9H0P0-4#6	0	1	Q9H0P0-4	134	135	+	1	0	0	91
Q9H0P0-4#6	0	1	1	Q9H0P0-4	134	135	+	1	Q9H0P0-4	51	336	Q9H0P0-3	0	285	+	93	Q9H0P0-4#6	0	1	Q9H0P0-3	83	84	+	1	0	0	92
Q9H0P0-4#6	0	1	1	Q9H0P0-4	134	135	+	1	Q9H0P0-4	50	336	Q9H0P0-2	0	286	+	92	Q9H0P0-4#6	0	1	Q9H0P0-2	84	85	+	1	0	0	93
Q9H0P0-4#6	0	1	1	Q9H0P0-4	134	135	+	1	Q9H0P0-4	50	336	Q9H0P0-1	11	297	+	91	Q9H0P0-4#6	0	1	Q9H0P0-1	95	96	+	1	0	0	94
Q9H0P0-4#7	0	1	1	Q9H0P0-4	155	156	+	1	Q9H0P0-4	0	336	Q9H0P0-4	0	336	+	94	Q9H0P0-4#7	0	1	Q9H0P0-4	155	156	+	1	0	0	95
Q9H0P0-4#7	0	1	1	Q9H0P0-4	155	156	+	1	Q9H0P0-4	51	336	Q9H0P0-3	0	285	+	93	Q9H0P0-4#7	0	1	Q9H0P0-3	104	105	+	1	0	0	96
Q9H0P0-4#7	0	1	1	Q9H0P0-4	155	156	+	1	Q9H0P0-4	50	336	Q9H0P0-2	0	286	+	92	Q9H0P0-4#7	0	1	Q9H0P0-2	105	106	+	1	0	0	97
Q9H0P0-4#7	0	1	1	Q9H0P0-4	155	156	+	1	Q9H0P0-4	50	336	Q9H0P0-1	11	297	+	91	Q9H0P0-4#7	0	1	Q9H0P0-1	116	117	+	1	0	0	98
Q9H0P0-4#8	0	2	2	Q9H0P0-4	202	204	+	2	Q9H0P0-4	0	336	Q9H0P0-4	0	336	+	94	Q9H0P0-4#8	0	2	Q9H0P0-4	202	204	+	2	0	0	99
Q9H0P0-4#8	0	2	2	Q9H0P0-4	202	204	+	2	Q9H0P0-4	51	336	Q9H0P0-3	0	285	+	93	Q9H0P0-4#8	0	2	Q9H0P0-3	151	153	+	2	0	0	100
Q9H0P0-4#8	0	2	2	Q9H0P0-4	202	204	+	2	Q9H0P0-4	50	336	Q9H0P0-2	0	286	+	92	Q9H0P0-4#8	0	2	Q9H0P0-2	152	154	+	2	0	0	101
Q9H0P0-4#8	0	2	2	Q9H0P0-4	202	204	+	2	Q9H0P0-4	50	336	Q9H0P0-1	11	297	+	91	Q9H0P0-4#8	0	2	Q9H0P0-1	163	165	+	2	0	0	102
Q9H0P0-4#9	0	1	1	Q9H0P0-4	251	252	+	1	Q9H0P0-4	0	336	Q9H0P0-4	0	336	+	94	Q9H0P0-4#9	0	1	Q9H0P0-4	251	252	+	1	0	0	103
Q9H0P0-4#9	0	1	1	Q9H0P0-4	251	252	+	1	Q9H0P0-4	51	336	Q9H0P0-3	0	285	+	93	Q9H0P0-4#9	0	1	Q9H0P0-3	200	201	+	1	0	0	104
Q9H0P0-4#9	0	1	1	Q9H0P0-4	251	252	+	1	Q9H0P0-4	50	336	Q9H0P0-2	0	286	+	92	Q9H0P0-4#9	0	1	Q9H0P0-2	201	202	+	1	0	0	105
Q9H0P0-4#9	0	1	1	Q9H0P0-4	251	252	+	1	Q9H0P0-4	50	336	Q9H0P0-1	11	297	+	91	Q9H0P0-4#9	0	1	Q9H0P0-1	212	213	+	1	0	0	106
Q9H0P0-4#10	0	1	1	Q9H0P0-4	276	277	+	1	Q9H0P0-4	0	336	Q9H0P0-4	0	336	+	94	Q9H0P0-4#10	0	1	Q9H0P0-4	276	277	+	1	0	0	107
Q9H0P0-4#10	0	1	1	Q9H0P0-4	276	277	+	1	Q9H0P0-4	51	336	Q9H0P0-3	0	285	+	93	Q9H0P0-4#10	0	1	Q9H0P0-3	225	226	+	1	0	0	108
Q9H0P0-4#10	0	1	1	Q9H0P0-4	276	277	+	1	Q9H0P0-4	50	336	Q9H0P0-2	0	286	+	92	Q9H0P0-4#10	0	1	Q9H0P0-2	226	227	+	1	0	0	109
Q9H0P0-4#10	0	1	1	Q9H0P0-4	276	277	+	1	Q9H0P0-4	50	336	Q9H0P0-1	11	297	+	91	Q9H0P0-4#10	0	1	Q9H0P0-1	237	238	+	1	0	0	110
Q9H0P0-4#11	0	1	1	Q9H0P0-4	277	278	+	1	Q9H0P0-4	0	336	Q9H0P0-4	0	336	+	94	Q9H0P0-4#11	0	1	Q9H0P0-4	277	278	+	1	0	0	111
Q9H0P0-4#11	0	1	1	Q9H0P0-4	277	278	+	1	Q9H0P0-4	51	336	Q9H0P0-3	0	285	+	93	Q9H0P0-4#11	0	1	Q9H0P0-3	226	227	+	1	0	0	112
Q9H0P0-4#11	0	1	1	Q9H0P0-4	277	278	+	1	Q9H0P0-4	50	336	Q9H0P0-2	0	286	+	92	Q9H0P0-4#11	0	1	Q9H0P0-2	227	228	+	1	0	0	113
Q9H0P0-4#11	0	1	1	Q9H0P0-4	277	278	+	1	Q9H0P0-4	50	336	Q9H0P0-1	11	297	+	91	Q9H0P0-4#11	0	1	Q9H0P0-1	238	239	+	1	0	0	114
Q9H0P0-4#12	0	51	51	Q9H0P0-4	0	51	+	51	Q9H0P0-4	0	336	Q9H0P0-4	0	336	+	94	Q9H0P0-4#12	0	51	Q9H0P0-4	0	51	+	51	0	0	115
Q9H0P0-4#12	0	51	51	Q9H0P0-4	0	51	+	51	Q9H0P0-4	50	336	Q9H0P0-2	0	286	+	92	Q9H0P0-4#12	50	51	Q9H0P0-2	0	1	+	1	50	0	116
Q9H0P0-4#12	0	51	51	Q9H0P0-4	0	51	+	51	Q9H0P0-4	50	336	Q9H0P0-1	11	297	+	91	Q9H0P0-4#12	50	51	Q9H0P0-1	11	12	+	1	50	0	117
Q9H0P0-4#13	0	50	50	Q9H0P0-4	0	50	+	50	Q9H0P0-4	0	336	Q9H0P0-4	0	336	+	94	Q9H0P0-4#13	0	50	Q9H0P0-4	0	50	+	50	0	0	118
Q9H0P0-4#14	0	50	50	Q9H0P0-4	0	50	+	50	Q9H0P0-4	0	336	Q9H0P0-4	0	336	+	94	Q9H0P0-4#14	0	50	Q9H0P0-4	0	50	+	50	0	0	119
Q9H0P0-4#15	0	1	1	Q9H0P0-4	94	95	+	1	Q9H0P0-4	0	336	Q9H0P0-4	0	336	+	94	Q9H0P0-4#15	0	1	Q9H0P0-4	94	95	+	1	0	0	120
Q9H0P0-4#15	0	1	1	Q9H0P0-4	94	95	+	1	Q9H0P0-4	51	336	Q9H0P0-3	0	285	+	93	Q9H0P0-4#15	0	1	Q9H0P0-3	43	44	+	1	0	0	121
Q9H0P0-4#15	0	1	1	Q9H0P0-4	94	95	+	1	Q9H0P0-4	50	336	Q9H0P0-2	0	286	+	92	Q9H0P0-4#15	0	1	Q9H0P0-2	44	45	+	1	0	0	122
Q9H0P0-4#15	0	1	1	Q9H0P0-4	94	95	+	1	Q9H0P0-4	50	336	Q9H0P0-1	11	297	+	91	Q9H0P0-4#15	0	1	Q9H0P0-1	55	56	+	1	0	0	123
Q9H0P0-4#16	0	1	1	Q9H0P0-4	112	113	+	1	Q9H0P0-4	0	336	Q9H0P0-4	0	336	+	94	Q9H0P0-4#16	0	1	Q9H0P0-4	112	113	+	1	0	0	124
Q9H0P0-4#16	0	1	1	Q9H0P0-4	112	113	+	1	Q9H0P0-4	51	336	Q9H0P0-3	0	285	+	93	Q9H0P0-4#16	0	1	Q9H0P0-3	61	62	+	1	0	0	125
Q9H0P0-4#16	0	1	1	Q9H0P0-4	112	113	+	1	Q9H0P0-4	50	336	Q9H0P0-2	0	286	+	92	Q9H0P0-4#16	0	1	Q9H0P0-2	62	63	+	1	0	0	126
Q9H0P0-4#16	0	1	1	Q9H0P0-4	112	113	+	1	Q9H0P0-4	50	336	Q9H0P0-1	11	297	+	91	Q9H0P0-4#16	0	1	Q9H0P0-1	73	74	+	1	0	0	127
Q9H0P0-4#17	0	1	1	Q9H0P0-4	136	137	+	1	Q9H0P0-4	0	336	Q9H0P0-4	0	336	+	94	Q9H0P0-4#17	0	1	Q9H0P0-4	136	137	+	1	0	0	128
Q9H0P0-4#17	0	1	1	Q9H0P0-4	136	137	+	1	Q9H0P0-4	51	336	Q9H0P0-3	0	285	+	93	Q9H0P0-4#17	0	1	Q9H0P0-3	85	86	+	1	0	0	129
Q9H0P0-4#17	0	1	1	Q9H0P0-4	136	137	+	1	Q9H0P0-4	50	336	Q9H0P0-2	0	286	+	92	Q9H0P0-4#17	0	1	Q9H0P0-2	86	87	+	1	0	0	130
Q9H0P0-4#17	0	1	1	Q9H0P0-4	136	137	+	1	Q9H0P0-4	50	336	Q9H0P0-1	11	297	+	91	Q9H0P0-4#17	0	1	Q9H0P0-1	97	98	+	1	0	0	131
Q9H0P0-4#18	0	1	1	Q9H0P0-4	180	181	+	1	Q9H0P0-4	0	336	Q9H0P0-4	0	336	+	94	Q9H0P0-4#18	0	1	Q9H0P0-4	180	181	+	1	0	0	132
Q9H0P0-4#18	0	1	1	Q9H0P0-4	180	181	+	1	Q9H0P0-4	51	336	Q9H0P0-3	0	285	+	93	Q9H0P0-4#18	0	1	Q9H0P0-3	129	130	+	1	0	0	133
Q9H0P0-4#18	0	1	1	Q9H0P0-4	180	181	+	1	Q9H0P0-4	50	336	Q9H0P0-2	0	286	+	92	Q9H0P0-4#18	0	1	Q9H0P0-2	130	131	+	1	0	0	134
Q9H0P0-4#18	0	1	1	Q9H0P0-4	180	181	+	1	Q9H0P0-4	50	336	Q9H0P0-1	11	297	+	91	Q9H0P0-4#18	0	1	Q9H0P0-1	141	142	+	1	0	0	135
Q9H0P0-4#19	0	1	1	Q9H0P0-4	206	207	+	1	Q9H0P0-4	0	336	Q9H0P0-4	0	336	+	94	Q9H0P0-4#19	0	1	Q9H0P0-4	206	207	+	1	0	0	136
Q9H0P0-4#19	0	1	1	Q9H0P0-4	206	207	+	1	Q9H0P0-4	51	336	Q9H0P0-3	0	285	+	93	Q9H0P0-4#19	0	1	Q9H0P0-3	155	156	+	1	0	0	137
Q9H0P0-4#19	0	1	1	Q9H0P0-4	206	207	+	1	Q9H0P0-4	50	336	Q9H0P0-2	0	286	+	92	Q9H0P0-4#19	0	1	Q9H0P0-2	156	157	+	1	0	0	138
Q9H0P0-4#19	0	1	1	Q9H0P0-4	206	207	+	1	Q9H0P0-4	50	336	Q9H0P0-1	11	297	+	91	Q9H0P0-4#19	0	1	Q9H0P0-1	167	168	+	1	0	0	139
Q9H0P0-4#20	0	1	1	Q9H0P0-4	228	229	+	1	Q9H0P0-4	0	336	Q9H0P0-4	0	336	+	94	Q9H0P0-4#20	0	1	Q9H0P0-4	228	229	+	1	0	0	140
Q9H0P0-4#20	0	1	1	Q9H0P0-4	228	229	+	1	Q9H0P0-4	51	336	Q9H0P0-3	0	285	+	93	Q9H0P0-4#20	0	1	Q9H0P0-3	177	178	+	1	0	0	141
Q9H0P0-4#20	0	1	1	Q9H0P0-4	228	229	+	1	Q9H0P0-4	50	336	Q9H0P0-2	0	286	+	92	Q9H0P0-4#20	0	1	Q9H0P0-2	178	179	+	1	0	0	142
Q9H0P0-4#20	0	1	1	Q9H0P0-4	228	229	+	1	Q9H0P0-4	50	336	Q9H0P0-1	11	297	+	91	Q9H0P0-4#20	0	1	Q9H0P0-1	189	190	+	1	0	0	143
Q9H0P0-4#21	0	1	1	Q9H0P0-4	279	280	+	1	Q9H0P0-4	0	336	Q9H0P0-4	0	336	+	94	Q9H0P0-4#21	0	1	Q9H0P0-4	279	280	+	1	0	0	144
Q9H0P0-4#21	0	1	1	Q9H0P0-4	279	280	+	1	Q9H0P0-4	51	336	Q9H0P0-3	0	285	+	93	Q9H0P0-4#21	0	1	Q9H0P0-3	228	229	+	1	0	0	145
Q9H0P0-4#21	0	1	1	Q9H0P0-4	279	280	+	1	Q9H0P0-4	50	336	Q9H0P0-2	0	286	+	92	Q9H0P0-4#21	0	1	Q9H0P0-2	229	230	+	1	0	0	146
Q9H0P0-4#21	0	1	1	Q9H0P0-4	279	280	+	1	Q9H0P0-4	50	336	Q9H0P0-1	11	297	+	91	Q9H0P0-4#21	0	1	Q9H0P0-1	240	241	+	1	0	0	147
Q9H0P0-4#22	0	1	1	Q9H0P0-4	296	297	+	1	Q9H0P0-4	0	336	Q9H0P0-4	0	336	+	94	Q9H0P0-4#22	0	1	Q9H0P0-4	296	297	+	1	0	0	148
Q9H0P0-4#22	0	1	1	Q9H0P0-4	296	297	+	1	Q9H0P0-4	51	336	Q9H0P0-3	0	285	+	93	Q9H0P0-4#22	0	1	Q9H0P0-3	245	246	+	1	0	0	149
Q9H0P0-4#22	0	1	1	Q9H0P0-4	296	297	+	1	Q9H0P0-4	50	336	Q9H0P0-2	0	286	+	92	Q9H0P0-4#22	0	1	Q9H0P0-2	246	247	+	1	0	0	150
Q9H0P0-4#22	0	1	1	Q9H0P0-4	296	297	+	1	Q9H0P0-4	50	336	Q9H0P0-1	11	297	+	91	Q9H0P0-4#22	0	1	Q9H0P0-1	257	258	+	1	0	0	151
Q9H0P0-4#23	0	1	1	Q9H0P0-4	87	88	+	1	Q9H0P0-4	0	336	Q9H0P0-4	0	336	+	94	Q9H0P0-4#23	0	1	Q9H0P0-4	87	88	+	1	0	0	152
Q9H0P0-4#23	0	1	1	Q9H0P0-4	87	88	+	1	Q9H0P0-4	51	336	Q9H0P0-3	0	285	+	93	Q9H0P0-4#23	0	1	Q9H0P0-3	36	37	+	1	0	0	153
Q9H0P0-4#23	0	1	1	Q9H0P0-4	87	88	+	1	Q9H0P0-4	50	336	Q9H0P0-2	0	286	+	92	Q9H0P0-4#23	0	1	Q9H0P0-2	37	38	+	1	0	0	154
Q9H0P0-4#23	0	1	1	Q9H0P0-4	87	88	+	1	Q9H0P0-4	50	336	Q9H0P0-1	11	297	+	91	Q9H0P0-4#23	0	1	Q9H0P0-1	48	49	+	1	0	0	155
Q9H0P0-4#24	0	1	1	Q9H0P0-4	88	89	+	1	Q9H0P0-4	0	336	Q9H0P0-4	0	336	+	94	Q9H0P0-4#24	0	1	Q9H0P0-4	88	89	+	1	0	0	156
Q9H0P0-4#24	0	1	1	Q9H0P0-4	88	89	+	1	Q9H0P0-4	51	336	Q9H0P0-3	0	285	+	93	Q9H0P0-4#24	0	1	Q9H0P0-3	37	38	+	1	0	0	157
Q9H0P0-4#24	0	1	1	Q9H0P0-4	88	89	+	1	Q9H0P0-4	50	336	Q9H0P0-2	0	286	+	92	Q9H0P0-4#24	0	1	Q9H0P0-2	38	39	+	1	0	0	158
Q9H0P0-4#24	0	1	1	Q9H0P0-4	88	89	+	1	Q9H0P0-4	50	336	Q9H0P0-1	11	297	+	91	Q9H0P0-4#24	0	1	Q9H0P0-1	49	50	+	1	0	0	159
Q9H0P0-4#25	0	1	1	Q9H0P0-4	89	90	+	1	Q9H0P0-4	0	336	Q9H0P0-4	0	336	+	94	Q9H0P0-4#25	0	1	Q9H0P0-4	89	90	+	1	0	0	160
Q9H0P0-4#25	0	1	1	Q9H0P0-4	89	90	+	1	Q9H0P0-4	51	336	Q9H0P0-3	0	285	+	93	Q9H0P0-4#25	0	1	Q9H0P0-3	38	39	+	1	0	0	161
Q9H0P0-4#25	0	1	1	Q9H0P0-4	89	90	+	1	Q9H0P0-4	50	336	Q9H0P0-2	0	286	+	92	Q9H0P0-4#25	0	1	Q9H0P0-2	39	40	+	1	0	0	162
Q9H0P0-4#25	0	1	1	Q9H0P0-4	89	90	+	1	Q9H0P0-4	50	336	Q9H0P0-1	11	297	+	91	Q9H0P0-4#25	0	1	Q9H0P0-1	50	51	+	1	0	0	163
Q9H0P0-4#26	0	1	1	Q9H0P0-4	134	135	+	1	Q9H0P0-4	0	336	Q9H0P0-4	0	336	+	94	Q9H0P0-4#26	0	1	Q9H0P0-4	134	135	+	1	0	0	164
Q9H0P0-4#26	0	1	1	Q9H0P0-4	134	135	+	1	Q9H0P0-4	51	336	Q9H0P0-3	0	285	+	93	Q9H0P0-4#26	0	1	Q9H0P0-3	83	84	+	1	0	0	165
Q9H0P0-4#26	0	1	1	Q9H0P0-4	134	135	+	1	Q9H0P0-4	50	336	Q9H0P0-2	0	286	+	92	Q9H0P0-4#26	0	1	Q9H0P0-2	84	85	+	1	0	0	166
Q9H0P0-4#26	0	1	1	Q9H0P0-4	134	135	+	1	Q9H0P0-4	50	336	Q9H0P0-1	11	297	+	91	Q9H0P0-4#26	0	1	Q9H0P0-1	95	96	+	1	0	0	167
Q9H0P0-4#27	0	1	1	Q9H0P0-4	231	232	+	1	Q9H0P0-4	0	336	Q9H0P0-4	0	336	+	94	Q9H0P0-4#27	0	1	Q9H0P0-4	231	232	+	1	0	0	168
Q9H0P0-4#27	0	1	1	Q9H0P0-4	231	232	+	1	Q9H0P0-4	51	336	Q9H0P0-3	0	285	+	93	Q9H0P0-4#27	0	1	Q9H0P0-3	180	181	+	1	0	0	169
Q9H0P0-4#27	0	1	1	Q9H0P0-4	231	232	+	1	Q9H0P0-4	50	336	Q9H0P0-2	0	286	+	92	Q9H0P0-4#27	0	1	Q9H0P0-2	181	182	+	1	0	0	170
Q9H0P0-4#27	0	1	1	Q9H0P0-4	231	232	+	1	Q9H0P0-4	50	336	Q9H0P0-1	11	297	+	91	Q9H0P0-4#27	0	1	Q9H0P0-1	192	193	+	1	0	0	171
Q9H0P0-4#28	0	1	1	Q9H0P0-4	232	233	+	1	Q9H0P0-4	0	336	Q9H0P0-4	0	336	+	94	Q9H0P0-4#28	0	1	Q9H0P0-4	232	233	+	1	0	0	172
Q9H0P0-4#28	0	1	1	Q9H0P0-4	232	233	+	1	Q9H0P0-4	51	336	Q9H0P0-3	0	285	+	93	Q9H0P0-4#28	0	1	Q9H0P0-3	181	182	+	1	0	0	173
Q9H0P0-4#28	0	1	1	Q9H0P0-4	232	233	+	1	Q9H0P0-4	50	336	Q9H0P0-2	0	286	+	92	Q9H0P0-4#28	0	1	Q9H0P0-2	182	183	+	1	0	0	174
Q9H0P0-4#28	0	1	1	Q9H0P0-4	232	233	+	1	Q9H0P0-4	50	336	Q9H0P0-1	11	297	+	91	Q9H0P0-4#28	0	1	Q9H0P0-1	193	194	+	1	0	0	175
Q9H0P0-4#29	0	1	1	Q9H0P0-4	233	234	+	1	Q9H0P0-4	0	336	Q9H0P0-4	0	336	+	94	Q9H0P0-4#29	0	1	Q9H0P0-4	233	234	+	1	0	0	176
Q9H0P0-4#29	0	1	1	Q9H0P0-4	233	234	+	1	Q9H0P0-4	51	336	Q9H0P0-3	0	285	+	93	Q9H0P0-4#29	0	1	Q9H0P0-3	182	183	+	1	0	0	177
Q9H0P0-4#29	0	1	1	Q9H0P0-4	233	234	+	1	Q9H0P0-4	50	336	Q9H0P0-2	0	286	+	92	Q9H0P0-4#29	0	1	Q9H0P0-2	183	184	+	1	0	0	178
Q9H0P0-4#29	0	1	1	Q9H0P0-4	233	234	+	1	Q9H0P0-4	50	336	Q9H0P0-1	11	297	+	91	Q9H0P0-4#29	0	1	Q9H0P0-1	194	195	+	1	0	0	179
Q9H0P0-4#30	0	1	1	Q9H0P0-4	94	95	+	1	Q9H0P0-4	0	336	Q9H0P0-4	0	336	+	94	Q9H0P0-4#30	0	1	Q9H0P0-4	94	95	+	1	0	0	180
Q9H0P0-4#30	0	1	1	Q9H0P0-4	94	95	+	1	Q9H0P0-4	51	336	Q9H0P0-3	0	285	+	93	Q9H0P0-4#30	0	1	Q9H0P0-3	43	44	+	1	0	0	181
Q9H0P0-4#30	0	1	1	Q9H0P0-4	94	95	+	1	Q9H0P0-4	50	336	Q9H0P0-2	0	286	+	92	Q9H0P0-4#30	0	1	Q9H0P0-2	44	45	+	1	0	0	182
Q9H0P0-4#30	0	1	1	Q9H0P0-4	94	95	+	1	Q9H0P0-4	50	336	Q9H0P0-1	11	297	+	91	Q9H0P0-4#30	0	1	Q9H0P0-1	55	56	+	1	0	0	183
Q9H0P0-4#31	0	1	1	Q9H0P0-4	143	144	+	1	Q9H0P0-4	0	336	Q9H0P0-4	0	336	+	94	Q9H0P0-4#31	0	1	Q9H0P0-4	143	144	+	1	0	0	184
Q9H0P0-4#31	0	1	1	Q9H0P0-4	143	144	+	1	Q9H0P0-4	51	336	Q9H0P0-3	0	285	+	93	Q9H0P0-4#31	0	1	Q9H0P0-3	92	93	+	1	0	0	185
Q9H0P0-4#31	0	1	1	Q9H0P0-4	143	144	+	1	Q9H0P0-4	50	336	Q9H0P0-2	0	286	+	92	Q9H0P0-4#31	0	1	Q9H0P0-2	93	94	+	1	0	0	186
Q9H0P0-4#31	0	1	1	Q9H0P0-4	143	144	+	1	Q9H0P0-4	50	336	Q9H0P0-1	11	297	+	91	Q9H0P0-4#31	0	1	Q9H0P0-1	104	105	+	1	0	0	187
Q9H0P0-4#32	0	1	1	Q9H0P0-4	328	329	+	1	Q9H0P0-4	0	336	Q9H0P0-4	0	336	+	94	Q9H0P0-4#32	0	1	Q9H0P0-4	328	329	+	1	0	0	188
Q9H0P0-4#32	0	1	1	Q9H0P0-4	328	329	+	1	Q9H0P0-4	51	336	Q9H0P0-3	0	285	+	93	Q9H0P0-4#32	0	1	Q9H0P0-3	277	278	+	1	0	0	189
Q9H0P0-4#32	0	1	1	Q9H0P0-4	328	329	+	1	Q9H0P0-4	50	336	Q9H0P0-2	0	286	+	92	Q9H0P0-4#32	0	1	Q9H0P0-2	278	279	+	1	0	0	190
Q9H0P0-4#32	0	1	1	Q9H0P0-4	328	329	+	1	Q9H0P0-4	50	336	Q9H0P0-1	11	297	+	91	Q9H0P0-4#32	0	1	Q9H0P0-1	289	290	+	1	0	0	191
Q9H0P0-4#33	0	14	14	Q9H0P0-4	64	78	+	14	Q9H0P0-4	0	336	Q9H0P0-4	0	336	+	94	Q9H0P0-4#33	0	14	Q9H0P0-4	64	78	+	14	0	0	192
Q9H0P0-4#33	0	14	14	Q9H0P0-4	64	78	+	14	Q9H0P0-4	51	336	Q9H0P0-3	0	285	+	93	Q9H0P0-4#33	0	14	Q9H0P0-3	13	27	+	14	0	0	193
Q9H0P0-4#33	0	14	14	Q9H0P0-4	64	78	+	14	Q9H0P0-4	50	336	Q9H0P0-2	0	286	+	92	Q9H0P0-4#33	0	14	Q9H0P0-2	14	28	+	14	0	0	194
Q9H0P0-4#33	0	14	14	Q9H0P0-4	64	78	+	14	Q9H0P0-4	50	336	Q9H0P0-1	11	297	+	91	Q9H0P0-4#33	0	14	Q9H0P0-1	25	39	+	14	0	0	195
Q9H0P0-4#34	0	3	3	Q9H0P0-4	79	82	+	3	Q9H0P0-4	0	336	Q9H0P0-4	0	336	+	94	Q9H0P0-4#34	0	3	Q9H0P0-4	79	82	+	3	0	0	196
Q9H0P0-4#34	0	3	3	Q9H0P0-4	79	82	+	3	Q9H0P0-4	51	336	Q9H0P0-3	0	285	+	93	Q9H0P0-4#34	0	3	Q9H0P0-3	28	31	+	3	0	0	197
Q9H0P0-4#34	0	3	3	Q9H0P0-4	79	82	+	3	Q9H0P0-4	50	336	Q9H0P0-2	0	286	+	92	Q9H0P0-4#34	0	3	Q9H0P0-2	29	32	+	3	0	0	198
Q9H0P0-4#34	0	3	3	Q9H0P0-4	79	82	+	3	Q9H0P0-4	50	336	Q9H0P0-1	11	297	+	91	Q9H0P0-4#34	0	3	Q9H0P0-1	40	43	+	3	0	0	199
Q9H0P0-4#35	0	5	5	Q9H0P0-4	82	87	+	5	Q9H0P0-4	0	336	Q9H0P0-4	0	336	+	94	Q9H0P0-4#35	0	5	Q9H0P0-4	82	87	+	5	0	0	200
Q9H0P0-4#35	0	5	5	Q9H0P0-4	82	87	+	5	Q9H0P0-4	51	336	Q9H0P0-3	0	285	+	93	Q9H0P0-4#35	0	5	Q9H0P0-3	31	36	+	5	0	0	201
Q9H0P0-4#35	0	5	5	Q9H0P0-4	82	87	+	5	Q9H0P0-4	50	336	Q9H0P0-2	0	286	+	92	Q9H0P0-4#35	0	5	Q9H0P0-2	32	37	+	5	0	0	202
Q9H0P0-4#35	0	5	5	Q9H0P0-4	82	87	+	5	Q9H0P0-4	50	336	Q9H0P0-1	11	297	+	91	Q9H0P0-4#35	0	5	Q9H0P0-1	43	48	+	5	0	0	203
Q9H0P0-4#36	0	3	3	Q9H0P0-4	89	92	+	3	Q9H0P0-4	0	336	Q9H0P0-4	0	336	+	94	Q9H0P0-4#36	0	3	Q9H0P0-4	89	92	+	3	0	0	204
Q9H0P0-4#36	0	3	3	Q9H0P0-4	89	92	+	3	Q9H0P0-4	51	336	Q9H0P0-3	0	285	+	93	Q9H0P0-4#36	0	3	Q9H0P0-3	38	41	+	3	0	0	205
Q9H0P0-4#36	0	3	3	Q9H0P0-4	89	92	+	3	Q9H0P0-4	50	336	Q9H0P0-2	0	286	+	92	Q9H0P0-4#36	0	3	Q9H0P0-2	39	42	+	3	0	0	206
Q9H0P0-4#36	0	3	3	Q9H0P0-4	89	92	+	3	Q9H0P0-4	50	336	Q9H0P0-1	11	297	+	91	Q9H0P0-4#36	0	3	Q9H0P0-1	50	53	+	3	0	0	207
Q9H0P0-4#37	0	3	3	Q9H0P0-4	95	98	+	3	Q9H0P0-4	0	336	Q9H0P0-4	0	336	+	94	Q9H0P0-4#37	0	3	Q9H0P0-4	95	98	+	3	0	0	208
Q9H0P0-4#37	0	3	3	Q9H0P0-4	95	98	+	3	Q9H0P0-4	51	336	Q9H0P0-3	0	285	+	93	Q9H0P0-4#37	0	3	Q9H0P0-3	44	47	+	3	0	0	209
Q9H0P0-4#37	0	3	3	Q9H0P0-4	95	98	+	3	Q9H0P0-4	50	336	Q9H0P0-2	0	286	+	92	Q9H0P0-4#37	0	3	Q9H0P0-2	45	48	+	3	0	0	210
Q9H0P0-4#37	0	3	3	Q9H0P0-4	95	98	+	3	Q9H0P0-4	50	336	Q9H0P0-1	11	297	+	91	Q9H0P0-4#37	0	3	Q9H0P0-1	56	59	+	3	0	0	211
Q9H0P0-4#38	0	6	6	Q9H0P0-4	105	111	+	6	Q9H0P0-4	0	336	Q9H0P0-4	0	336	+	94	Q9H0P0-4#38	0	6	Q9H0P0-4	105	111	+	6	0	0	212
Q9H0P0-4#38	0	6	6	Q9H0P0-4	105	111	+	6	Q9H0P0-4	51	336	Q9H0P0-3	0	285	+	93	Q9H0P0-4#38	0	6	Q9H0P0-3	54	60	+	6	0	0	213
Q9H0P0-4#38	0	6	6	Q9H0P0-4	105	111	+	6	Q9H0P0-4	50	336	Q9H0P0-2	0	286	+	92	Q9H0P0-4#38	0	6	Q9H0P0-2	55	61	+	6	0	0	214
Q9H0P0-4#38	0	6	6	Q9H0P0-4	105	111	+	6	Q9H0P0-4	50	336	Q9H0P0-1	11	297	+	91	Q9H0P0-4#38	0	6	Q9H0P0-1	66	72	+	6	0	0	215
Q9H0P0-4#39	0	18	18	Q9H0P0-4	117	135	+	18	Q9H0P0-4	0	336	Q9H0P0-4	0	336	+	94	Q9H0P0-4#39	0	18	Q9H0P0-4	117	135	+	18	0	0	216
Q9H0P0-4#39	0	18	18	Q9H0P0-4	117	135	+	18	Q9H0P0-4	51	336	Q9H0P0-3	0	285	+	93	Q9H0P0-4#39	0	18	Q9H0P0-3	66	84	+	18	0	0	217
Q9H0P0-4#39	0	18	18	Q9H0P0-4	117	135	+	18	Q9H0P0-4	50	336	Q9H0P0-2	0	286	+	92	Q9H0P0-4#39	0	18	Q9H0P0-2	67	85	+	18	0	0	218
Q9H0P0-4#39	0	18	18	Q9H0P0-4	117	135	+	18	Q9H0P0-4	50	336	Q9H0P0-1	11	297	+	91	Q9H0P0-4#39	0	18	Q9H0P0-1	78	96	+	18	0	0	219
Q9H0P0-4#40	0	3	3	Q9H0P0-4	137	140	+	3	Q9H0P0-4	0	336	Q9H0P0-4	0	336	+	94	Q9H0P0-4#40	0	3	Q9H0P0-4	137	140	+	3	0	0	220
Q9H0P0-4#40	0	3	3	Q9H0P0-4	137	140	+	3	Q9H0P0-4	51	336	Q9H0P0-3	0	285	+	93	Q9H0P0-4#40	0	3	Q9H0P0-3	86	89	+	3	0	0	221
Q9H0P0-4#40	0	3	3	Q9H0P0-4	137	140	+	3	Q9H0P0-4	50	336	Q9H0P0-2	0	286	+	92	Q9H0P0-4#40	0	3	Q9H0P0-2	87	90	+	3	0	0	222
Q9H0P0-4#40	0	3	3	Q9H0P0-4	137	140	+	3	Q9H0P0-4	50	336	Q9H0P0-1	11	297	+	91	Q9H0P0-4#40	0	3	Q9H0P0-1	98	101	+	3	0	0	223
Q9H0P0-4#41	0	22	22	Q9H0P0-4	141	163	+	22	Q9H0P0-4	0	336	Q9H0P0-4	0	336	+	94	Q9H0P0-4#41	0	22	Q9H0P0-4	141	163	+	22	0	0	224
Q9H0P0-4#41	0	22	22	Q9H0P0-4	141	163	+	22	Q9H0P0-4	51	336	Q9H0P0-3	0	285	+	93	Q9H0P0-4#41	0	22	Q9H0P0-3	90	112	+	22	0	0	225
Q9H0P0-4#41	0	22	22	Q9H0P0-4	141	163	+	22	Q9H0P0-4	50	336	Q9H0P0-2	0	286	+	92	Q9H0P0-4#41	0	22	Q9H0P0-2	91	113	+	22	0	0	226
Q9H0P0-4#41	0	22	22	Q9H0P0-4	141	163	+	22	Q9H0P0-4	50	336	Q9H0P0-1	11	297	+	91	Q9H0P0-4#41	0	22	Q9H0P0-1	102	124	+	22	0	0	227
Q9H0P0-4#42	0	3	3	Q9H0P0-4	166	169	+	3	Q9H0P0-4	0	336	Q9H0P0-4	0	336	+	94	Q9H0P0-4#42	0	3	Q9H0P0-4	166	169	+	3	0	0	228
Q9H0P0-4#42	0	3	3	Q9H0P0-4	166	169	+	3	Q9H0P0-4	51	336	Q9H0P0-3	0	285	+	93	Q9H0P0-4#42	0	3	Q9H0P0-3	115	118	+	3	0	0	229
Q9H0P0-4#42	0	3	3	Q9H0P0-4	166	169	+	3	Q9H0P0-4	50	336	Q9H0P0-2	0	286	+	92	Q9H0P0-4#42	0	3	Q9H0P0-2	116	119	+	3	0	0	230
Q9H0P0-4#42	0	3	3	Q9H0P0-4	166	169	+	3	Q9H0P0-4	50	336	Q9H0P0-1	11	297	+	91	Q9H0P0-4#42	0	3	Q9H0P0-1	127	130	+	3	0	0	231
Q9H0P0-4#43	0	6	6	Q9H0P0-4	169	175	+	6	Q9H0P0-4	0	336	Q9H0P0-4	0	336	+	94	Q9H0P0-4#43	0	6	Q9H0P0-4	169	175	+	6	0	0	232
Q9H0P0-4#43	0	6	6	Q9H0P0-4	169	175	+	6	Q9H0P0-4	51	336	Q9H0P0-3	0	285	+	93	Q9H0P0-4#43	0	6	Q9H0P0-3	118	124	+	6	0	0	233
Q9H0P0-4#43	0	6	6	Q9H0P0-4	169	175	+	6	Q9H0P0-4	50	336	Q9H0P0-2	0	286	+	92	Q9H0P0-4#43	0	6	Q9H0P0-2	119	125	+	6	0	0	234
Q9H0P0-4#43	0	6	6	Q9H0P0-4	169	175	+	6	Q9H0P0-4	50	336	Q9H0P0-1	11	297	+	91	Q9H0P0-4#43	0	6	Q9H0P0-1	130	136	+	6	0	0	235
Q9H0P0-4#44	0	10	10	Q9H0P0-4	184	194	+	10	Q9H0P0-4	0	336	Q9H0P0-4	0	336	+	94	Q9H0P0-4#44	0	10	Q9H0P0-4	184	194	+	10	0	0	236
Q9H0P0-4#44	0	10	10	Q9H0P0-4	184	194	+	10	Q9H0P0-4	51	336	Q9H0P0-3	0	285	+	93	Q9H0P0-4#44	0	10	Q9H0P0-3	133	143	+	10	0	0	237
Q9H0P0-4#44	0	10	10	Q9H0P0-4	184	194	+	10	Q9H0P0-4	50	336	Q9H0P0-2	0	286	+	92	Q9H0P0-4#44	0	10	Q9H0P0-2	134	144	+	10	0	0	238
Q9H0P0-4#44	0	10	10	Q9H0P0-4	184	194	+	10	Q9H0P0-4	50	336	Q9H0P0-1	11	297	+	91	Q9H0P0-4#44	0	10	Q9H0P0-1	145	155	+	10	0	0	239
Q9H0P0-4#45	0	8	8	Q9H0P0-4	198	206	+	8	Q9H0P0-4	0	336	Q9H0P0-4	0	336	+	94	Q9H0P0-4#45	0	8	Q9H0P0-4	198	206	+	8	0	0	240
Q9H0P0-4#45	0	8	8	Q9H0P0-4	198	206	+	8	Q9H0P0-4	51	336	Q9H0P0-3	0	285	+	93	Q9H0P0-4#45	0	8	Q9H0P0-3	147	155	+	8	0	0	241
Q9H0P0-4#45	0	8	8	Q9H0P0-4	198	206	+	8	Q9H0P0-4	50	336	Q9H0P0-2	0	286	+	92	Q9H0P0-4#45	0	8	Q9H0P0-2	148	156	+	8	0	0	242
Q9H0P0-4#45	0	8	8	Q9H0P0-4	198	206	+	8	Q9H0P0-4	50	336	Q9H0P0-1	11	297	+	91	Q9H0P0-4#45	0	8	Q9H0P0-1	159	167	+	8	0	0	243
Q9H0P0-4#46	0	10	10	Q9H0P0-4	206	216	+	10	Q9H0P0-4	0	336	Q9H0P0-4	0	336	+	94	Q9H0P0-4#46	0	10	Q9H0P0-4	206	216	+	10	0	0	244
Q9H0P0-4#46	0	10	10	Q9H0P0-4	206	216	+	10	Q9H0P0-4	51	336	Q9H0P0-3	0	285	+	93	Q9H0P0-4#46	0	10	Q9H0P0-3	155	165	+	10	0	0	245
Q9H0P0-4#46	0	10	10	Q9H0P0-4	206	216	+	10	Q9H0P0-4	50	336	Q9H0P0-2	0	286	+	92	Q9H0P0-4#46	0	10	Q9H0P0-2	156	166	+	10	0	0	246
Q9H0P0-4#46	0	10	10	Q9H0P0-4	206	216	+	10	Q9H0P0-4	50	336	Q9H0P0-1	11	297	+	91	Q9H0P0-4#46	0	10	Q9H0P0-1	167	177	+	10	0	0	247
Q9H0P0-4#47	0	6	6	Q9H0P0-4	223	229	+	6	Q9H0P0-4	0	336	Q9H0P0-4	0	336	+	94	Q9H0P0-4#47	0	6	Q9H0P0-4	223	229	+	6	0	0	248
Q9H0P0-4#47	0	6	6	Q9H0P0-4	223	229	+	6	Q9H0P0-4	51	336	Q9H0P0-3	0	285	+	93	Q9H0P0-4#47	0	6	Q9H0P0-3	172	178	+	6	0	0	249
Q9H0P0-4#47	0	6	6	Q9H0P0-4	223	229	+	6	Q9H0P0-4	50	336	Q9H0P0-2	0	286	+	92	Q9H0P0-4#47	0	6	Q9H0P0-2	173	179	+	6	0	0	250
Q9H0P0-4#47	0	6	6	Q9H0P0-4	223	229	+	6	Q9H0P0-4	50	336	Q9H0P0-1	11	297	+	91	Q9H0P0-4#47	0	6	Q9H0P0-1	184	190	+	6	0	0	251
Q9H0P0-4#48	0	3	3	Q9H0P0-4	230	233	+	3	Q9H0P0-4	0	336	Q9H0P0-4	0	336	+	94	Q9H0P0-4#48	0	3	Q9H0P0-4	230	233	+	3	0	0	252
Q9H0P0-4#48	0	3	3	Q9H0P0-4	230	233	+	3	Q9H0P0-4	51	336	Q9H0P0-3	0	285	+	93	Q9H0P0-4#48	0	3	Q9H0P0-3	179	182	+	3	0	0	253
Q9H0P0-4#48	0	3	3	Q9H0P0-4	230	233	+	3	Q9H0P0-4	50	336	Q9H0P0-2	0	286	+	92	Q9H0P0-4#48	0	3	Q9H0P0-2	180	183	+	3	0	0	254
Q9H0P0-4#48	0	3	3	Q9H0P0-4	230	233	+	3	Q9H0P0-4	50	336	Q9H0P0-1	11	297	+	91	Q9H0P0-4#48	0	3	Q9H0P0-1	191	194	+	3	0	0	255
Q9H0P0-4#49	0	6	6	Q9H0P0-4	236	242	+	6	Q9H0P0-4	0	336	Q9H0P0-4	0	336	+	94	Q9H0P0-4#49	0	6	Q9H0P0-4	236	242	+	6	0	0	256
Q9H0P0-4#49	0	6	6	Q9H0P0-4	236	242	+	6	Q9H0P0-4	51	336	Q9H0P0-3	0	285	+	93	Q9H0P0-4#49	0	6	Q9H0P0-3	185	191	+	6	0	0	257
Q9H0P0-4#49	0	6	6	Q9H0P0-4	236	242	+	6	Q9H0P0-4	50	336	Q9H0P0-2	0	286	+	92	Q9H0P0-4#49	0	6	Q9H0P0-2	186	192	+	6	0	0	258
Q9H0P0-4#49	0	6	6	Q9H0P0-4	236	242	+	6	Q9H0P0-4	50	336	Q9H0P0-1	11	297	+	91	Q9H0P0-4#49	0	6	Q9H0P0-1	197	203	+	6	0	0	259
Q9H0P0-4#50	0	7	7	Q9H0P0-4	251	258	+	7	Q9H0P0-4	0	336	Q9H0P0-4	0	336	+	94	Q9H0P0-4#50	0	7	Q9H0P0-4	251	258	+	7	0	0	260
Q9H0P0-4#50	0	7	7	Q9H0P0-4	251	258	+	7	Q9H0P0-4	51	336	Q9H0P0-3	0	285	+	93	Q9H0P0-4#50	0	7	Q9H0P0-3	200	207	+	7	0	0	261
Q9H0P0-4#50	0	7	7	Q9H0P0-4	251	258	+	7	Q9H0P0-4	50	336	Q9H0P0-2	0	286	+	92	Q9H0P0-4#50	0	7	Q9H0P0-2	201	208	+	7	0	0	262
Q9H0P0-4#50	0	7	7	Q9H0P0-4	251	258	+	7	Q9H0P0-4	50	336	Q9H0P0-1	11	297	+	91	Q9H0P0-4#50	0	7	Q9H0P0-1	212	219	+	7	0	0	263
Q9H0P0-4#51	0	5	5	Q9H0P0-4	259	264	+	5	Q9H0P0-4	0	336	Q9H0P0-4	0	336	+	94	Q9H0P0-4#51	0	5	Q9H0P0-4	259	264	+	5	0	0	264
Q9H0P0-4#51	0	5	5	Q9H0P0-4	259	264	+	5	Q9H0P0-4	51	336	Q9H0P0-3	0	285	+	93	Q9H0P0-4#51	0	5	Q9H0P0-3	208	213	+	5	0	0	265
Q9H0P0-4#51	0	5	5	Q9H0P0-4	259	264	+	5	Q9H0P0-4	50	336	Q9H0P0-2	0	286	+	92	Q9H0P0-4#51	0	5	Q9H0P0-2	209	214	+	5	0	0	266
Q9H0P0-4#51	0	5	5	Q9H0P0-4	259	264	+	5	Q9H0P0-4	50	336	Q9H0P0-1	11	297	+	91	Q9H0P0-4#51	0	5	Q9H0P0-1	220	225	+	5	0	0	267
Q9H0P0-4#52	0	4	4	Q9H0P0-4	264	268	+	4	Q9H0P0-4	0	336	Q9H0P0-4	0	336	+	94	Q9H0P0-4#52	0	4	Q9H0P0-4	264	268	+	4	0	0	268
Q9H0P0-4#52	0	4	4	Q9H0P0-4	264	268	+	4	Q9H0P0-4	51	336	Q9H0P0-3	0	285	+	93	Q9H0P0-4#52	0	4	Q9H0P0-3	213	217	+	4	0	0	269
Q9H0P0-4#52	0	4	4	Q9H0P0-4	264	268	+	4	Q9H0P0-4	50	336	Q9H0P0-2	0	286	+	92	Q9H0P0-4#52	0	4	Q9H0P0-2	214	218	+	4	0	0	270
Q9H0P0-4#52	0	4	4	Q9H0P0-4	264	268	+	4	Q9H0P0-4	50	336	Q9H0P0-1	11	297	+	91	Q9H0P0-4#52	0	4	Q9H0P0-1	225	229	+	4	0	0	271
Q9H0P0-4#53	0	9	9	Q9H0P0-4	270	279	+	9	Q9H0P0-4	0	336	Q9H0P0-4	0	336	+	94	Q9H0P0-4#53	0	9	Q9H0P0-4	270	279	+	9	0	0	272
Q9H0P0-4#53	0	9	9	Q9H0P0-4	270	279	+	9	Q9H0P0-4	51	336	Q9H0P0-3	0	285	+	93	Q9H0P0-4#53	0	9	Q9H0P0-3	219	228	+	9	0	0	273
Q9H0P0-4#53	0	9	9	Q9H0P0-4	270	279	+	9	Q9H0P0-4	50	336	Q9H0P0-2	0	286	+	92	Q9H0P0-4#53	0	9	Q9H0P0-2	220	229	+	9	0	0	274
Q9H0P0-4#53	0	9	9	Q9H0P0-4	270	279	+	9	Q9H0P0-4	50	336	Q9H0P0-1	11	297	+	91	Q9H0P0-4#53	0	9	Q9H0P0-1	231	240	+	9	0	0	275
Q9H0P0-4#54	0	4	4	Q9H0P0-4	279	283	+	4	Q9H0P0-4	0	336	Q9H0P0-4	0	336	+	94	Q9H0P0-4#54	0	4	Q9H0P0-4	279	283	+	4	0	0	276
Q9H0P0-4#54	0	4	4	Q9H0P0-4	279	283	+	4	Q9H0P0-4	51	336	Q9H0P0-3	0	285	+	93	Q9H0P0-4#54	0	4	Q9H0P0-3	228	232	+	4	0	0	277
Q9H0P0-4#54	0	4	4	Q9H0P0-4	279	283	+	4	Q9H0P0-4	50	336	Q9H0P0-2	0	286	+	92	Q9H0P0-4#54	0	4	Q9H0P0-2	229	233	+	4	0	0	278
Q9H0P0-4#54	0	4	4	Q9H0P0-4	279	283	+	4	Q9H0P0-4	50	336	Q9H0P0-1	11	297	+	91	Q9H0P0-4#54	0	4	Q9H0P0-1	240	244	+	4	0	0	279
Q9H0P0-4#55	0	4	4	Q9H0P0-4	283	287	+	4	Q9H0P0-4	0	336	Q9H0P0-4	0	336	+	94	Q9H0P0-4#55	0	4	Q9H0P0-4	283	287	+	4	0	0	280
Q9H0P0-4#55	0	4	4	Q9H0P0-4	283	287	+	4	Q9H0P0-4	51	336	Q9H0P0-3	0	285	+	93	Q9H0P0-4#55	0	4	Q9H0P0-3	232	236	+	4	0	0	281
Q9H0P0-4#55	0	4	4	Q9H0P0-4	283	287	+	4	Q9H0P0-4	50	336	Q9H0P0-2	0	286	+	92	Q9H0P0-4#55	0	4	Q9H0P0-2	233	237	+	4	0	0	282
Q9H0P0-4#55	0	4	4	Q9H0P0-4	283	287	+	4	Q9H0P0-4	50	336	Q9H0P0-1	11	297	+	91	Q9H0P0-4#55	0	4	Q9H0P0-1	244	248	+	4	0	0	283
Q9H0P0-4#56	0	9	9	Q9H0P0-4	291	300	+	9	Q9H0P0-4	0	336	Q9H0P0-4	0	336	+	94	Q9H0P0-4#56	0	9	Q9H0P0-4	291	300	+	9	0	0	284
Q9H0P0-4#56	0	9	9	Q9H0P0-4	291	300	+	9	Q9H0P0-4	51	336	Q9H0P0-3	0	285	+	93	Q9H0P0-4#56	0	9	Q9H0P0-3	240	249	+	9	0	0	285
Q9H0P0-4#56	0	9	9	Q9H0P0-4	291	300	+	9	Q9H0P0-4	50	336	Q9H0P0-2	0	286	+	92	Q9H0P0-4#56	0	9	Q9H0P0-2	241	250	+	9	0	0	286
Q9H0P0-4#56	0	9	9	Q9H0P0-4	291	300	+	9	Q9H0P0-4	50	336	Q9H0P0-1	11	297	+	91	Q9H0P0-4#56	0	9	Q9H0P0-1	252	261	+	9	0	0	287
Q9H0P0-4#57	0	9	9	Q9H0P0-4	303	312	+	9	Q9H0P0-4	0	336	Q9H0P0-4	0	336	+	94	Q9H0P0-4#57	0	9	Q9H0P0-4	303	312	+	9	0	0	288
Q9H0P0-4#57	0	9	9	Q9H0P0-4	303	312	+	9	Q9H0P0-4	51	336	Q9H0P0-3	0	285	+	93	Q9H0P0-4#57	0	9	Q9H0P0-3	252	261	+	9	0	0	289
Q9H0P0-4#57	0	9	9	Q9H0P0-4	303	312	+	9	Q9H0P0-4	50	336	Q9H0P0-2	0	286	+	92	Q9H0P0-4#57	0	9	Q9H0P0-2	253	262	+	9	0	0	290
Q9H0P0-4#57	0	9	9	Q9H0P0-4	303	312	+	9	Q9H0P0-4	50	336	Q9H0P0-1	11	297	+	91	Q9H0P0-4#57	0	9	Q9H0P0-1	264	273	+	9	0	0	291
Q9H0P0-4#58	0	6	6	Q9H0P0-4	314	320	+	6	Q9H0P0-4	0	336	Q9H0P0-4	0	336	+	94	Q9H0P0-4#58	0	6	Q9H0P0-4	314	320	+	6	0	0	292
Q9H0P0-4#58	0	6	6	Q9H0P0-4	314	320	+	6	Q9H0P0-4	51	336	Q9H0P0-3	0	285	+	93	Q9H0P0-4#58	0	6	Q9H0P0-3	263	269	+	6	0	0	293
Q9H0P0-4#58	0	6	6	Q9H0P0-4	314	320	+	6	Q9H0P0-4	50	336	Q9H0P0-2	0	286	+	92	Q9H0P0-4#58	0	6	Q9H0P0-2	264	270	+	6	0	0	294
Q9H0P0-4#58	0	6	6	Q9H0P0-4	314	320	+	6	Q9H0P0-4	50	336	Q9H0P0-1	11	297	+	91	Q9H0P0-4#58	0	6	Q9H0P0-1	275	281	+	6	0	0	295
Q9H0P0-4#59	0	10	10	Q9H0P0-4	325	335	+	10	Q9H0P0-4	0	336	Q9H0P0-4	0	336	+	94	Q9H0P0-4#59	0	10	Q9H0P0-4	325	335	+	10	0	0	296
Q9H0P0-4#59	0	10	10	Q9H0P0-4	325	335	+	10	Q9H0P0-4	51	336	Q9H0P0-3	0	285	+	93	Q9H0P0-4#59	0	10	Q9H0P0-3	274	284	+	10	0	0	297
Q9H0P0-4#59	0	10	10	Q9H0P0-4	325	335	+	10	Q9H0P0-4	50	336	Q9H0P0-2	0	286	+	92	Q9H0P0-4#59	0	10	Q9H0P0-2	275	285	+	10	0	0	298
Q9H0P0-4#59	0	10	10	Q9H0P0-4	325	335	+	10	Q9H0P0-4	50	336	Q9H0P0-1	11	297	+	91	Q9H0P0-4#59	0	10	Q9H0P0-1	286	296	+	10	0	0	299
Q969T7-1#0	0	300	300	Q969T7-1	0	300	+	300	Q969T7-1	8	300	Q969T7-2	0	292	+	78	Q969T7-1#0	8	300	Q969T7-2	0	292	+	292	8	0	300
Q969T7-1#0	0	300	300	Q969T7-1	0	300	+	300	Q969T7-1	0	300	Q969T7-1	0	300	+	77	Q969T7-1#0	0	300	Q969T7-1	0	300	+	300	0	0	301
Q969T7-1#1	0	1	1	Q969T7-1	40	41	+	1	Q969T7-1	8	300	Q969T7-2	0	292	+	78	Q969T7-1#1	0	1	Q969T7-2	32	33	+	1	0	0	302
Q969T7-1#1	0	1	1	Q969T7-1	40	41	+	1	Q969T7-1	0	300	Q969T7-1	0	300	+	77	Q969T7-1#1	0	1	Q969T7-1	40	41	+	1	0	0	303
Q969T7-1#2	0	1	1	Q969T7-1	42	43	+	1	Q969T7-1	8	300	Q969T7-2	0	292	+	78	Q969T7-1#2	0	1	Q969T7-2	34	35	+	1	0	0	304
Q969T7-1#2	0	1	1	Q969T7-1	42	43	+	1	Q969T7-1	0	300	Q969T7-1	0	300	+	77	Q969T7-1#2	0	1	Q969T7-1	42	43	+	1	0	0	305
Q969T7-1#3	0	1	1	Q969T7-1	40	41	+	1	Q969T7-1	8	300	Q969T7-2	0	292	+	78	Q969T7-1#3	0	1	Q969T7-2	32	33	+	1	0	0	306
Q969T7-1#3	0	1	1	Q969T7-1	40	41	+	1	Q969T7-1	0	300	Q969T7-1	0	300	+	77	Q969T7-1#3	0	1	Q969T7-1	40	41	+	1	0	0	307
Q969T7-1#4	0	1	1	Q969T7-1	42	43	+	1	Q969T7-1	8	300	Q969T7-2	0	292	+	78	Q969T7-1#4	0	1	Q969T7-2	34	35	+	1	0	0	308
Q969T7-1#4	0	1	1	Q969T7-1	42	43	+	1	Q969T7-1	0	300	Q969T7-1	0	300	+	77	Q969T7-1#4	0	1	Q969T7-1	42	43	+	1	0	0	309
Q969T7-1#5	0	1	1	Q969T7-1	87	88	+	1	Q969T7-1	8	300	Q969T7-2	0	292	+	78	Q969T7-1#5	0	1	Q969T7-2	79	80	+	1	0	0	310
Q969T7-1#5	0	1	1	Q969T7-1	87	88	+	1	Q969T7-1	0	300	Q969T7-1	0	300	+	77	Q969T7-1#5	0	1	Q969T7-1	87	88	+	1	0	0	311
Q969T7-1#6	0	1	1	Q969T7-1	87	88	+	1	Q969T7-1	8	300	Q969T7-2	0	292	+	78	Q969T7-1#6	0	1	Q969T7-2	79	80	+	1	0	0	312
Q969T7-1#6	0	1	1	Q969T7-1	87	88	+	1	Q969T7-1	0	300	Q969T7-1	0	300	+	77	Q969T7-1#6	0	1	Q969T7-1	87	88	+	1	0	0	313
Q969T7-1#7	0	2	2	Q969T7-1	155	157	+	2	Q969T7-1	8	300	Q969T7-2	0	292	+	78	Q969T7-1#7	0	2	Q969T7-2	147	149	+	2	0	0	314
Q969T7-1#7	0	2	2	Q969T7-1	155	157	+	2	Q969T7-1	0	300	Q969T7-1	0	300	+	77	Q969T7-1#7	0	2	Q969T7-1	155	157	+	2	0	0	315
Q969T7-1#8	0	1	1	Q969T7-1	204	205	+	1	Q969T7-1	8	300	Q969T7-2	0	292	+	78	Q969T7-1#8	0	1	Q969T7-2	196	197	+	1	0	0	316
Q969T7-1#8	0	1	1	Q969T7-1	204	205	+	1	Q969T7-1	0	300	Q969T7-1	0	300	+	77	Q969T7-1#8	0	1	Q969T7-1	204	205	+	1	0	0	317
Q969T7-1#9	0	1	1	Q969T7-1	229	230	+	1	Q969T7-1	8	300	Q969T7-2	0	292	+	78	Q969T7-1#9	0	1	Q969T7-2	221	222	+	1	0	0	318
Q969T7-1#9	0	1	1	Q969T7-1	229	230	+	1	Q969T7-1	0	300	Q969T7-1	0	300	+	77	Q969T7-1#9	0	1	Q969T7-1	229	230	+	1	0	0	319
Q969T7-1#10	0	1	1	Q969T7-1	255	256	+	1	Q969T7-1	8	300	Q969T7-2	0	292	+	78	Q969T7-1#10	0	1	Q969T7-2	247	248	+	1	0	0	320
Q969T7-1#10	0	1	1	Q969T7-1	255	256	+	1	Q969T7-1	0	300	Q969T7-1	0	300	+	77	Q969T7-1#10	0	1	Q969T7-1	255	256	+	1	0	0	321
Q969T7-1#11	0	8	8	Q969T7-1	0	8	+	8	Q969T7-1	0	300	Q969T7-1	0	300	+	77	Q969T7-1#11	0	8	Q969T7-1	0	8	+	8	0	0	322
Q969T7-1#12	0	1	1	Q969T7-1	208	209	+	1	Q969T7-1	8	300	Q969T7-2	0	292	+	78	Q969T7-1#12	0	1	Q969T7-2	200	201	+	1	0	0	323
Q969T7-1#12	0	1	1	Q969T7-1	208	209	+	1	Q969T7-1	0	300	Q969T7-1	0	300	+	77	Q969T7-1#12	0	1	Q969T7-1	208	209	+	1	0	0	324
Q969T7-1#13	0	1	1	Q969T7-1	212	213	+	1	Q969T7-1	8	300	Q969T7-2	0	292	+	78	Q969T7-1#13	0	1	Q969T7-2	204	205	+	1	0	0	325
Q969T7-1#13	0	1	1	Q969T7-1	212	213	+	1	Q969T7-1	0	300	Q969T7-1	0	300	+	77	Q969T7-1#13	0	1	Q969T7-1	212	213	+	1	0	0	326
Q969T7-1#14	0	3	3	Q969T7-1	0	3	+	3	Q969T7-1	0	300	Q969T7-1	0	300	+	77	Q969T7-1#14	0	3	Q969T7-1	0	3	+	3	0	0	327
Q969T7-1#15	0	3	3	Q969T7-1	6	9	+	3	Q969T7-1	8	300	Q969T7-2	0	292	+	78	Q969T7-1#15	2	3	Q969T7-2	0	1	+	1	2	0	328
Q969T7-1#15	0	3	3	Q969T7-1	6	9	+	3	Q969T7-1	0	300	Q969T7-1	0	300	+	77	Q969T7-1#15	0	3	Q969T7-1	6	9	+	3	0	0	329
Q969T7-1#16	0	14	14	Q969T7-1	17	31	+	14	Q969T7-1	8	300	Q969T7-2	0	292	+	78	Q969T7-1#16	0	14	Q969T7-2	9	23	+	14	0	0	330
Q969T7-1#16	0	14	14	Q969T7-1	17	31	+	14	Q969T7-1	0	300	Q969T7-1	0	300	+	77	Q969T7-1#16	0	14	Q969T7-1	17	31	+	14	0	0	331
Q969T7-1#17	0	3	3	Q969T7-1	32	35	+	3	Q969T7-1	8	300	Q969T7-2	0	292	+	78	Q969T7-1#17	0	3	Q969T7-2	24	27	+	3	0	0	332
Q969T7-1#17	0	3	3	Q969T7-1	32	35	+	3	Q969T7-1	0	300	Q969T7-1	0	300	+	77	Q969T7-1#17	0	3	Q969T7-1	32	35	+	3	0	0	333
Q969T7-1#18	0	6	6	Q969T7-1	35	41	+	6	Q969T7-1	8	300	Q969T7-2	0	292	+	78	Q969T7-1#18	0	6	Q969T7-2	27	33	+	6	0	0	334
Q969T7-1#18	0	6	6	Q969T7-1	35	41	+	6	Q969T7-1	0	300	Q969T7-1	0	300	+	77	Q969T7-1#18	0	6	Q969T7-1	35	41	+	6	0	0	335
Q969T7-1#19	0	5	5	Q969T7-1	41	46	+	5	Q969T7-1	8	300	Q969T7-2	0	292	+	78	Q969T7-1#19	0	5	Q969T7-2	33	38	+	5	0	0	336
Q969T7-1#19	0	5	5	Q969T7-1	41	46	+	5	Q969T7-1	0	300	Q969T7-1	0	300	+	77	Q969T7-1#19	0	5	Q969T7-1	41	46	+	5	0	0	337
Q969T7-1#20	0	3	3	Q969T7-1	48	51	+	3	Q969T7-1	8	300	Q969T7-2	0	292	+	78	Q969T7-1#20	0	3	Q969T7-2	40	43	+	3	0	0	338
Q969T7-1#20	0	3	3	Q969T7-1	48	51	+	3	Q969T7-1	0	300	Q969T7-1	0	300	+	77	Q969T7-1#20	0	3	Q969T7-1	48	51	+	3	0	0	339
Q969T7-1#21	0	3	3	Q969T7-1	58	61	+	3	Q969T7-1	8	300	Q969T7-2	0	292	+	78	Q969T7-1#21	0	3	Q969T7-2	50	53	+	3	0	0	340
Q969T7-1#21	0	3	3	Q969T7-1	58	61	+	3	Q969T7-1	0	300	Q969T7-1	0	300	+	77	Q969T7-1#21	0	3	Q969T7-1	58	61	+	3	0	0	341
Q969T7-1#22	0	4	4	Q969T7-1	61	65	+	4	Q969T7-1	8	300	Q969T7-2	0	292	+	78	Q969T7-1#22	0	4	Q969T7-2	53	57	+	4	0	0	342
Q969T7-1#22	0	4	4	Q969T7-1	61	65	+	4	Q969T7-1	0	300	Q969T7-1	0	300	+	77	Q969T7-1#22	0	4	Q969T7-1	61	65	+	4	0	0	343
Q969T7-1#23	0	18	18	Q969T7-1	70	88	+	18	Q969T7-1	8	300	Q969T7-2	0	292	+	78	Q969T7-1#23	0	18	Q969T7-2	62	80	+	18	0	0	344
Q969T7-1#23	0	18	18	Q969T7-1	70	88	+	18	Q969T7-1	0	300	Q969T7-1	0	300	+	77	Q969T7-1#23	0	18	Q969T7-1	70	88	+	18	0	0	345
Q969T7-1#24	0	20	20	Q969T7-1	94	114	+	20	Q969T7-1	8	300	Q969T7-2	0	292	+	78	Q969T7-1#24	0	20	Q969T7-2	86	106	+	20	0	0	346
Q969T7-1#24	0	20	20	Q969T7-1	94	114	+	20	Q969T7-1	0	300	Q969T7-1	0	300	+	77	Q969T7-1#24	0	20	Q969T7-1	94	114	+	20	0	0	347
Q969T7-1#25	0	9	9	Q969T7-1	120	129	+	9	Q969T7-1	8	300	Q969T7-2	0	292	+	78	Q969T7-1#25	0	9	Q969T7-2	112	121	+	9	0	0	348
Q969T7-1#25	0	9	9	Q969T7-1	120	129	+	9	Q969T7-1	0	300	Q969T7-1	0	300	+	77	Q969T7-1#25	0	9	Q969T7-1	120	129	+	9	0	0	349
Q969T7-1#26	0	10	10	Q969T7-1	137	147	+	10	Q969T7-1	8	300	Q969T7-2	0	292	+	78	Q969T7-1#26	0	10	Q969T7-2	129	139	+	10	0	0	350
Q969T7-1#26	0	10	10	Q969T7-1	137	147	+	10	Q969T7-1	0	300	Q969T7-1	0	300	+	77	Q969T7-1#26	0	10	Q969T7-1	137	147	+	10	0	0	351
Q969T7-1#27	0	8	8	Q969T7-1	151	159	+	8	Q969T7-1	8	300	Q969T7-2	0	292	+	78	Q969T7-1#27	0	8	Q969T7-2	143	151	+	8	0	0	352
Q969T7-1#27	0	8	8	Q969T7-1	151	159	+	8	Q969T7-1	0	300	Q969T7-1	0	300	+	77	Q969T7-1#27	0	8	Q969T7-1	151	159	+	8	0	0	353
Q969T7-1#28	0	10	10	Q969T7-1	159	169	+	10	Q969T7-1	8	300	Q969T7-2	0	292	+	78	Q969T7-1#28	0	10	Q969T7-2	151	161	+	10	0	0	354
Q969T7-1#28	0	10	10	Q969T7-1	159	169	+	10	Q969T7-1	0	300	Q969T7-1	0	300	+	77	Q969T7-1#28	0	10	Q969T7-1	159	169	+	10	0	0	355
Q969T7-1#29	0	10	10	Q969T7-1	176	186	+	10	Q969T7-1	8	300	Q969T7-2	0	292	+	78	Q969T7-1#29	0	10	Q969T7-2	168	178	+	10	0	0	356
Q969T7-1#29	0	10	10	Q969T7-1	176	186	+	10	Q969T7-1	0	300	Q969T7-1	0	300	+	77	Q969T7-1#29	0	10	Q969T7-1	176	186	+	10	0	0	357
Q969T7-1#30	0	8	8	Q969T7-1	189	197	+	8	Q969T7-1	8	300	Q969T7-2	0	292	+	78	Q969T7-1#30	0	8	Q969T7-2	181	189	+	8	0	0	358
Q969T7-1#30	0	8	8	Q969T7-1	189	197	+	8	Q969T7-1	0	300	Q969T7-1	0	300	+	77	Q969T7-1#30	0	8	Q969T7-1	189	197	+	8	0	0	359
Q969T7-1#31	0	3	3	Q969T7-1	206	209	+	3	Q969T7-1	8	300	Q969T7-2	0	292	+	78	Q969T7-1#31	0	3	Q969T7-2	198	201	+	3	0	0	360
Q969T7-1#31	0	3	3	Q969T7-1	206	209	+	3	Q969T7-1	0	300	Q969T7-1	0	300	+	77	Q969T7-1#31	0	3	Q969T7-1	206	209	+	3	0	0	361
Q969T7-1#32	0	9	9	Q969T7-1	223	232	+	9	Q969T7-1	8	300	Q969T7-2	0	292	+	78	Q969T7-1#32	0	9	Q969T7-2	215	224	+	9	0	0	362
Q969T7-1#32	0	9	9	Q969T7-1	223	232	+	9	Q969T7-1	0	300	Q969T7-1	0	300	+	77	Q969T7-1#32	0	9	Q969T7-1	223	232	+	9	0	0	363
Q969T7-1#33	0	4	4	Q969T7-1	232	236	+	4	Q969T7-1	8	300	Q969T7-2	0	292	+	78	Q969T7-1#33	0	4	Q969T7-2	224	228	+	4	0	0	364
Q969T7-1#33	0	4	4	Q969T7-1	232	236	+	4	Q969T7-1	0	300	Q969T7-1	0	300	+	77	Q969T7-1#33	0	4	Q969T7-1	232	236	+	4	0	0	365
Q969T7-1#34	0	4	4	Q969T7-1	236	240	+	4	Q969T7-1	8	300	Q969T7-2	0	292	+	78	Q969T7-1#34	0	4	Q969T7-2	228	232	+	4	0	0	366
Q969T7-1#34	0	4	4	Q969T7-1	236	240	+	4	Q969T7-1	0	300	Q969T7-1	0	300	+	77	Q969T7-1#34	0	4	Q969T7-1	236	240	+	4	0	0	367
Q969T7-1#35	0	8	8	Q969T7-1	245	253	+	8	Q969T7-1	8	300	Q969T7-2	0	292	+	78	Q969T7-1#35	0	8	Q969T7-2	237	245	+	8	0	0	368
Q969T7-1#35	0	8	8	Q969T7-1	245	253	+	8	Q969T7-1	0	300	Q969T7-1	0	300	+	77	Q969T7-1#35	0	8	Q969T7-1	245	253	+	8	0	0	369
Q969T7-1#36	0	11	11	Q969T7-1	256	267	+	11	Q969T7-1	8	300	Q969T7-2	0	292	+	78	Q969T7-1#36	0	11	Q969T7-2	248	259	+	11	0	0	370
Q969T7-1#36	0	11	11	Q969T7-1	256	267	+	11	Q969T7-1	0	300	Q969T7-1	0	300	+	77	Q969T7-1#36	0	11	Q969T7-1	256	267	+	11	0	0	371
Q969T7-1#37	0	6	6	Q969T7-1	268	274	+	6	Q969T7-1	8	300	Q969T7-2	0	292	+	78	Q969T7-1#37	0	6	Q969T7-2	260	266	+	6	0	0	372
Q969T7-1#37	0	6	6	Q969T7-1	268	274	+	6	Q969T7-1	0	300	Q969T7-1	0	300	+	77	Q969T7-1#37	0	6	Q969T7-1	268	274	+	6	0	0	373
Q969T7-1#38	0	11	11	Q969T7-1	278	289	+	11	Q969T7-1	8	300	Q969T7-2	0	292	+	78	Q969T7-1#38	0	11	Q969T7-2	270	281	+	11	0	0	374
Q969T7-1#38	0	11	11	Q969T7-1	278	289	+	11	Q969T7-1	0	300	Q969T7-1	0	300	+	77	Q969T7-1#38	0	11	Q969T7-1	278	289	+	11	0	0	375
P30511-1#0	0	21	21	P30511-1	0	21	+	21	P30511-1	0	345	P30511-3	0	345	+	31	P30511-1#0	0	21	P30511-3	0	21	+	21	0	0	376
P30511-1#0	0	21	21	P30511-1	0	21	+	21	P30511-1	0	346	P30511-2	0	254	+	30	P30511-1#0	0	21	P30511-2	0	21	+	21	0	0	377
P30511-1#0	0	21	21	P30511-1	0	21	+	21	P30511-1	0	346	P30511-1	0	346	+	29	P30511-1#0	0	21	P30511-1	0	21	+	21	0	0	378
P30511-1#1	0	325	325	P30511-1	21	346	+	325	P30511-1	0	345	P30511-3	0	345	+	31	P30511-1#1	0	324	P30511-3	21	345	+	324	0	1	379
P30511-1#1	0	325	325	P30511-1	21	346	+	325	P30511-1	0	346	P30511-2	0	254	+	30	P30511-1#1	0	325	P30511-2	21	254	+	233	0	0	380
P30511-1#1	0	325	325	P30511-1	21	346	+	325	P30511-1	0	346	P30511-1	0	346	+	29	P30511-1#1	0	325	P30511-1	21	346	+	325	0	0	381
P30511-1#2	0	284	284	P30511-1	21	305	+	284	P30511-1	0	345	P30511-3	0	345	+	31	P30511-1#2	0	284	P30511-3	21	305	+	284	0	0	382
P30511-1#2	0	284	284	P30511-1	21	305	+	284	P30511-1	0	346	P30511-2	0	254	+	30	P30511-1#2	0	284	P30511-2	21	213	+	192	0	0	383
P30511-1#2	0	284	284	P30511-1	21	305	+	284	P30511-1	0	346	P30511-1	0	346	+	29	P30511-1#2	0	284	P30511-1	21	305	+	284	0	0	384
P30511-1#3	0	24	24	P30511-1	305	329	+	24	P30511-1	0	345	P30511-3	0	345	+	31	P30511-1#3	0	24	P30511-3	305	329	+	24	0	0	385
P30511-1#3	0	24	24	P30511-1	305	329	+	24	P30511-1	0	346	P30511-2	0	254	+	30	P30511-1#3	0	24	P30511-2	213	237	+	24	0	0	386
P30511-1#3	0	24	24	P30511-1	305	329	+	24	P30511-1	0	346	P30511-1	0	346	+	29	P30511-1#3	0	24	P30511-1	305	329	+	24	0	0	387
P30511-1#4	0	17	17	P30511-1	329	346	+	17	P30511-1	0	345	P30511-3	0	345	+	31	P30511-1#4	0	16	P30511-3	329	345	+	16	0	1	388
P30511-1#4	0	17	17	P30511-1	329	346	+	17	P30511-1	0	346	P30511-2	0	254	+	30	P30511-1#4	0	17	P30511-2	237	254	+	17	0	0	389
P30511-1#4	0	17	17	P30511-1	329	346	+	17	P30511-1	0	346	P30511-1	0	346	+	29	P30511-1#4	0	17	P30511-1	329	346	+	17	0	0	390
P30511-1#5	0	91	91	P30511-1	205	296	+	91	P30511-1	0	345	P30511-3	0	345	+	31	P30511-1#5	0	91	P30511-3	205	296	+	91	0	0	391
P30511-1#5	0	91	91	P30511-1	205	296	+	91	P30511-1	0	346	P30511-2	0	254	+	30	P30511-1#5	90	91	P30511-2	203	204	+	1	90	0	392
P30511-1#5	0	91	91	P30511-1	205	296	+	91	P30511-1	0	346	P30511-1	0	346	+	29	P30511-1#5	0	91	P30511-1	205	296	+	91	0	0	393
P30511-1#6	0	90	90	P30511-1	21	111	+	90	P30511-1	0	345	P30511-3	0	345	+	31	P30511-1#6	0	90	P30511-3	21	111	+	90	0	0	394
P30511-1#6	0	90	90	P30511-1	21	111	+	90	P30511-1	0	346	P30511-2	0	254	+	30	P30511-1#6	0	90	P30511-2	21	111	+	90	0	0	395
P30511-1#6	0	90	90	P30511-1	21	111	+	90	P30511-1	0	346	P30511-1	0	346	+	29	P30511-1#6	0	90	P30511-1	21	111	+	90	0	0	396
P30511-1#7	0	92	92	P30511-1	111	203	+	92	P30511-1	0	345	P30511-3	0	345	+	31	P30511-1#7	0	92	P30511-3	111	203	+	92	0	0	397
P30511-1#7	0	92	92	P30511-1	111	203	+	92	P30511-1	0	346	P30511-2	0	254	+	30	P30511-1#7	0	92	P30511-2	111	203	+	92	0	0	398
P30511-1#7	0	92	92	P30511-1	111	203	+	92	P30511-1	0	346	P30511-1	0	346	+	29	P30511-1#7	0	92	P30511-1	111	203	+	92	0	0	399
P30511-1#8	0	92	92	P30511-1	203	295	+	92	P30511-1	0	345	P30511-3	0	345	+	31	P30511-1#8	0	92	P30511-3	203	295	+	92	0	0	400
P30511-1#8	0	92	92	P30511-1	203	295	+	92	P30511-1	0	346	P30511-1	0	346	+	29	P30511-1#8	0	92	P30511-1	203	295	+	92	0	0	401
P30511-1#9	0	10	10	P30511-1	295	305	+	10	P30511-1	0	345	P30511-3	0	345	+	31	P30511-1#9	0	10	P30511-3	295	305	+	10	0	0	402
P30511-1#9	0	10	10	P30511-1	295	305	+	10	P30511-1	0	346	P30511-2	0	254	+	30	P30511-1#9	0	10	P30511-2	203	213	+	10	0	0	403
P30511-1#9	0	10	10	P30511-1	295	305	+	10	P30511-1	0	346	P30511-1	0	346	+	29	P30511-1#9	0	10	P30511-1	295	305	+	10	0	0	404
P30511-1#10	0	3	3	P30511-1	335	338	+	3	P30511-1	0	345	P30511-3	0	345	+	31	P30511-1#10	0	3	P30511-3	335	338	+	3	0	0	405
P30511-1#10	0	3	3	P30511-1	335	338	+	3	P30511-1	0	346	P30511-2	0	254	+	30	P30511-1#10	0	3	P30511-2	243	246	+	3	0	0	406
P30511-1#10	0	3	3	P30511-1	335	338	+	3	P30511-1	0	346	P30511-1	0	346	+	29	P30511-1#10	0	3	P30511-1	335	338	+	3	0	0	407
P30511-1#11	0	1	1	P30511-1	90	91	+	1	P30511-1	0	345	P30511-3	0	345	+	31	P30511-1#11	0	1	P30511-3	90	91	+	1	0	0	408
P30511-1#11	0	1	1	P30511-1	90	91	+	1	P30511-1	0	346	P30511-2	0	254	+	30	P30511-1#11	0	1	P30511-2	90	91	+	1	0	0	409
P30511-1#11	0	1	1	P30511-1	90	91	+	1	P30511-1	0	346	P30511-1	0	346	+	29	P30511-1#11	0	1	P30511-1	90	91	+	1	0	0	410
P30511-1#12	0	1	1	P30511-1	104	105	+	1	P30511-1	0	345	P30511-3	0	345	+	31	P30511-1#12	0	1	P30511-3	104	105	+	1	0	0	411
P30511-1#12	0	1	1	P30511-1	104	105	+	1	P30511-1	0	346	P30511-2	0	254	+	30	P30511-1#12	0	1	P30511-2	104	105	+	1	0	0	412
P30511-1#12	0	1	1	P30511-1	104	105	+	1	P30511-1	0	346	P30511-1	0	346	+	29	P30511-1#12	0	1	P30511-1	104	105	+	1	0	0	413
P30511-1#13	0	1	1	P30511-1	163	164	+	1	P30511-1	0	345	P30511-3	0	345	+	31	P30511-1#13	0	1	P30511-3	163	164	+	1	0	0	414
P30511-1#13	0	1	1	P30511-1	163	164	+	1	P30511-1	0	346	P30511-2	0	254	+	30	P30511-1#13	0	1	P30511-2	163	164	+	1	0	0	415
P30511-1#13	0	1	1	P30511-1	163	164	+	1	P30511-1	0	346	P30511-1	0	346	+	29	P30511-1#13	0	1	P30511-1	163	164	+	1	0	0	416
P30511-1#14	0	1	1	P30511-1	167	168	+	1	P30511-1	0	345	P30511-3	0	345	+	31	P30511-1#14	0	1	P30511-3	167	168	+	1	0	0	417
P30511-1#14	0	1	1	P30511-1	167	168	+	1	P30511-1	0	346	P30511-2	0	254	+	30	P30511-1#14	0	1	P30511-2	167	168	+	1	0	0	418
P30511-1#14	0	1	1	P30511-1	167	168	+	1	P30511-1	0	346	P30511-1	0	346	+	29	P30511-1#14	0	1	P30511-1	167	168	+	1	0	0	419
P30511-1#15	0	1	1	P30511-1	175	176	+	1	P30511-1	0	345	P30511-3	0	345	+	31	P30511-1#15	0	1	P30511-3	175	176	+	1	0	0	420
P30511-1#15	0	1	1	P30511-1	175	176	+	1	P30511-1	0	346	P30511-2	0	254	+	30	P30511-1#15	0	1	P30511-2	175	176	+	1	0	0	421
P30511-1#15	0	1	1	P30511-1	175	176	+	1	P30511-1	0	346	P30511-1	0	346	+	29	P30511-1#15	0	1	P30511-1	175	176	+	1	0	0	422
P30511-1#16	0	1	1	P30511-1	106	107	+	1	P30511-1	0	345	P30511-3	0	345	+	31	P30511-1#16	0	1	P30511-3	106	107	+	1	0	0	423
P30511-1#16	0	1	1	P30511-1	106	107	+	1	P30511-1	0	346	P30511-2	0	254	+	30	P30511-1#16	0	1	P30511-2	106	107	+	1	0	0	424
P30511-1#16	0	1	1	P30511-1	106	107	+	1	P30511-1	0	346	P30511-1	0	346	+	29	P30511-1#16	0	1	P30511-1	106	107	+	1	0	0	425
P30511-1#17	0	64	64	P30511-1	121	185	+	64	P30511-1	0	345	P30511-3	0	345	+	31	P30511-1#17	0	64	P30511-3	121	185	+	64	0	0	426
P30511-1#17	0	64	64	P30511-1	121	185	+	64	P30511-1	0	346	P30511-2	0	254	+	30	P30511-1#17	0	64	P30511-2	121	185	+	64	0	0	427
P30511-1#17	0	64	64	P30511-1	121	185	+	64	P30511-1	0	346	P30511-1	0	346	+	29	P30511-1#17	0	64	P30511-1	121	185	+	64	0	0	428
P30511-1#18	0	57	57	P30511-1	223	280	+	57	P30511-1	0	345	P30511-3	0	345	+	31	P30511-1#18	0	57	P30511-3	223	280	+	57	0	0	429
P30511-1#18	0	57	57	P30511-1	223	280	+	57	P30511-1	0	346	P30511-1	0	346	+	29	P30511-1#18	0	57	P30511-1	223	280	+	57	0	0	430
P30511-1#19	0	92	92	P30511-1	203	295	+	92	P30511-1	0	345	P30511-3	0	345	+	31	P30511-1#19	0	92	P30511-3	203	295	+	92	0	0	431
P30511-1#19	0	92	92	P30511-1	203	295	+	92	P30511-1	0	346	P30511-1	0	346	+	29	P30511-1#19	0	92	P30511-1	203	295	+	92	0	0	432
P30511-1#20	0	1	1	P30511-1	345	346	+	1	P30511-1	0	346	P30511-2	0	254	+	30	P30511-1#20	0	1	P30511-2	253	254	+	1	0	0	433
P30511-1#20	0	1	1	P30511-1	345	346	+	1	P30511-1	0	346	P30511-1	0	346	+	29	P30511-1#20	0	1	P30511-1	345	346	+	1	0	0	434
P30511-1#21	0	1	1	P30511-1	12	13	+	1	P30511-1	0	345	P30511-3	0	345	+	31	P30511-1#21	0	1	P30511-3	12	13	+	1	0	0	435
P30511-1#21	0	1	1	P30511-1	12	13	+	1	P30511-1	0	346	P30511-2	0	254	+	30	P30511-1#21	0	1	P30511-2	12	13	+	1	0	0	436
P30511-1#21	0	1	1	P30511-1	12	13	+	1	P30511-1	0	346	P30511-1	0	346	+	29	P30511-1#21	0	1	P30511-1	12	13	+	1	0	0	437
P30511-1#22	0	1	1	P30511-1	70	71	+	1	P30511-1	0	345	P30511-3	0	345	+	31	P30511-1#22	0	1	P30511-3	70	71	+	1	0	0	438
P30511-1#22	0	1	1	P30511-1	70	71	+	1	P30511-1	0	346	P30511-2	0	254	+	30	P30511-1#22	0	1	P30511-2	70	71	+	1	0	0	439
P30511-1#22	0	1	1	P30511-1	70	71	+	1	P30511-1	0	346	P30511-1	0	346	+	29	P30511-1#22	0	1	P30511-1	70	71	+	1	0	0	440
P30511-1#23	0	1	1	P30511-1	271	272	+	1	P30511-1	0	345	P30511-3	0	345	+	31	P30511-1#23	0	1	P30511-3	271	272	+	1	0	0	441
P30511-1#23	0	1	1	P30511-1	271	272	+	1	P30511-1	0	346	P30511-1	0	346	+	29	P30511-1#23	0	1	P30511-1	271	272	+	1	0	0	442
P30511-1#24	0	1	1	P30511-1	82	83	+	1	P30511-1	0	345	P30511-3	0	345	+	31	P30511-1#24	0	1	P30511-3	82	83	+	1	0	0	443
P30511-1#24	0	1	1	P30511-1	82	83	+	1	P30511-1	0	346	P30511-2	0	254	+	30	P30511-1#24	0	1	P30511-2	82	83	+	1	0	0	444
P30511-1#24	0	1	1	P30511-1	82	83	+	1	P30511-1	0	346	P30511-1	0	346	+	29	P30511-1#24	0	1	P30511-1	82	83	+	1	0	0	445
P30511-1#25	0	3	3	P30511-1	335	338	+	3	P30511-1	0	345	P30511-3	0	345	+	31	P30511-1#25	0	3	P30511-3	335	338	+	3	0	0	446
P30511-1#25	0	3	3	P30511-1	335	338	+	3	P30511-1	0	346	P30511-2	0	254	+	30	P30511-1#25	0	3	P30511-2	243	246	+	3	0	0	447
P30511-1#25	0	3	3	P30511-1	335	338	+	3	P30511-1	0	346	P30511-1	0	346	+	29	P30511-1#25	0	3	P30511-1	335	338	+	3	0	0	448
P30511-1#26	0	3	3	P30511-1	335	338	+	3	P30511-1	0	345	P30511-3	0	345	+	31	P30511-1#26	0	3	P30511-3	335	338	+	3	0	0	449
P30511-1#26	0	3	3	P30511-1	335	338	+	3	P30511-1	0	346	P30511-2	0	254	+	30	P30511-1#26	0	3	P30511-2	243	246	+	3	0	0	450
P30511-1#26	0	3	3	P30511-1	335	338	+	3	P30511-1	0	346	P30511-1	0	346	+	29	P30511-1#26	0	3	P30511-1	335	338	+	3	0	0	451
P30511-1#27	0	1	1	P30511-1	345	346	+	1	P30511-1	0	346	P30511-2	0	254	+	30	P30511-1#27	0	1	P30511-2	253	254	+	1	0	0	452
P30511-1#27	0	1	1	P30511-1	345	346	+	1	P30511-1	0	346	P30511-1	0	346	+	29	P30511-1#27	0	1	P30511-1	345	346	+	1	0	0	453
P30511-1#28	0	1	1	P30511-1	345	346	+	1	P30511-1	0	346	P30511-2	0	254	+	30	P30511-1#28	0	1	P30511-2	253	254	+	1	0	0	454
P30511-1#28	0	1	1	P30511-1	345	346	+	1	P30511-1	0	346	P30511-1	0	346	+	29	P30511-1#28	0	1	P30511-1	345	346	+	1	0	0	455
P30511-1#29	0	12	12	P30511-1	23	35	+	12	P30511-1	0	345	P30511-3	0	345	+	31	P30511-1#29	0	12	P30511-3	23	35	+	12	0	0	456
P30511-1#29	0	12	12	P30511-1	23	35	+	12	P30511-1	0	346	P30511-2	0	254	+	30	P30511-1#29	0	12	P30511-2	23	35	+	12	0	0	457
P30511-1#29	0	12	12	P30511-1	23	35	+	12	P30511-1	0	346	P30511-1	0	346	+	29	P30511-1#29	0	12	P30511-1	23	35	+	12	0	0	458
P30511-1#30	0	3	3	P30511-1	35	38	+	3	P30511-1	0	345	P30511-3	0	345	+	31	P30511-1#30	0	3	P30511-3	35	38	+	3	0	0	459
P30511-1#30	0	3	3	P30511-1	35	38	+	3	P30511-1	0	346	P30511-2	0	254	+	30	P30511-1#30	0	3	P30511-2	35	38	+	3	0	0	460
P30511-1#30	0	3	3	P30511-1	35	38	+	3	P30511-1	0	346	P30511-1	0	346	+	29	P30511-1#30	0	3	P30511-1	35	38	+	3	0	0	461
P30511-1#31	0	11	11	P30511-1	38	49	+	11	P30511-1	0	345	P30511-3	0	345	+	31	P30511-1#31	0	11	P30511-3	38	49	+	11	0	0	462
P30511-1#31	0	11	11	P30511-1	38	49	+	11	P30511-1	0	346	P30511-2	0	254	+	30	P30511-1#31	0	11	P30511-2	38	49	+	11	0	0	463
P30511-1#31	0	11	11	P30511-1	38	49	+	11	P30511-1	0	346	P30511-1	0	346	+	29	P30511-1#31	0	11	P30511-1	38	49	+	11	0	0	464
P30511-1#32	0	7	7	P30511-1	51	58	+	7	P30511-1	0	345	P30511-3	0	345	+	31	P30511-1#32	0	7	P30511-3	51	58	+	7	0	0	465
P30511-1#32	0	7	7	P30511-1	51	58	+	7	P30511-1	0	346	P30511-2	0	254	+	30	P30511-1#32	0	7	P30511-2	51	58	+	7	0	0	466
P30511-1#32	0	7	7	P30511-1	51	58	+	7	P30511-1	0	346	P30511-1	0	346	+	29	P30511-1#32	0	7	P30511-1	51	58	+	7	0	0	467
P30511-1#33	0	3	3	P30511-1	60	63	+	3	P30511-1	0	345	P30511-3	0	345	+	31	P30511-1#33	0	3	P30511-3	60	63	+	3	0	0	468
P30511-1#33	0	3	3	P30511-1	60	63	+	3	P30511-1	0	346	P30511-2	0	254	+	30	P30511-1#33	0	3	P30511-2	60	63	+	3	0	0	469
P30511-1#33	0	3	3	P30511-1	60	63	+	3	P30511-1	0	346	P30511-1	0	346	+	29	P30511-1#33	0	3	P30511-1	60	63	+	3	0	0	470
P30511-1#34	0	4	4	P30511-1	66	70	+	4	P30511-1	0	345	P30511-3	0	345	+	31	P30511-1#34	0	4	P30511-3	66	70	+	4	0	0	471
P30511-1#34	0	4	4	P30511-1	66	70	+	4	P30511-1	0	346	P30511-2	0	254	+	30	P30511-1#34	0	4	P30511-2	66	70	+	4	0	0	472
P30511-1#34	0	4	4	P30511-1	66	70	+	4	P30511-1	0	346	P30511-1	0	346	+	29	P30511-1#34	0	4	P30511-1	66	70	+	4	0	0	473
P30511-1#35	0	3	3	P30511-1	70	73	+	3	P30511-1	0	345	P30511-3	0	345	+	31	P30511-1#35	0	3	P30511-3	70	73	+	3	0	0	474
P30511-1#35	0	3	3	P30511-1	70	73	+	3	P30511-1	0	346	P30511-2	0	254	+	30	P30511-1#35	0	3	P30511-2	70	73	+	3	0	0	475
P30511-1#35	0	3	3	P30511-1	70	73	+	3	P30511-1	0	346	P30511-1	0	346	+	29	P30511-1#35	0	3	P30511-1	70	73	+	3	0	0	476
P30511-1#36	0	28	28	P30511-1	77	105	+	28	P30511-1	0	345	P30511-3	0	345	+	31	P30511-1#36	0	28	P30511-3	77	105	+	28	0	0	477
P30511-1#36	0	28	28	P30511-1	77	105	+	28	P30511-1	0	346	P30511-2	0	254	+	30	P30511-1#36	0	28	P30511-2	77	105	+	28	0	0	478
P30511-1#36	0	28	28	P30511-1	77	105	+	28	P30511-1	0	346	P30511-1	0	346	+	29	P30511-1#36	0	28	P30511-1	77	105	+	28	0	0	479
P30511-1#37	0	10	10	P30511-1	114	124	+	10	P30511-1	0	345	P30511-3	0	345	+	31	P30511-1#37	0	10	P30511-3	114	124	+	10	0	0	480
P30511-1#37	0	10	10	P30511-1	114	124	+	10	P30511-1	0	346	P30511-2	0	254	+	30	P30511-1#37	0	10	P30511-2	114	124	+	10	0	0	481
P30511-1#37	0	10	10	P30511-1	114	124	+	10	P30511-1	0	346	P30511-1	0	346	+	29	P30511-1#37	0	10	P30511-1	114	124	+	10	0	0	482
P30511-1#38	0	12	12	P30511-1	127	139	+	12	P30511-1	0	345	P30511-3	0	345	+	31	P30511-1#38	0	12	P30511-3	127	139	+	12	0	0	483
P30511-1#38	0	12	12	P30511-1	127	139	+	12	P30511-1	0	346	P30511-2	0	254	+	30	P30511-1#38	0	12	P30511-2	127	139	+	12	0	0	484
P30511-1#38	0	12	12	P30511-1	127	139	+	12	P30511-1	0	346	P30511-1	0	346	+	29	P30511-1#38	0	12	P30511-1	127	139	+	12	0	0	485
P30511-1#39	0	6	6	P30511-1	141	147	+	6	P30511-1	0	345	P30511-3	0	345	+	31	P30511-1#39	0	6	P30511-3	141	147	+	6	0	0	486
P30511-1#39	0	6	6	P30511-1	141	147	+	6	P30511-1	0	346	P30511-2	0	254	+	30	P30511-1#39	0	6	P30511-2	141	147	+	6	0	0	487
P30511-1#39	0	6	6	P30511-1	141	147	+	6	P30511-1	0	346	P30511-1	0	346	+	29	P30511-1#39	0	6	P30511-1	141	147	+	6	0	0	488
P30511-1#40	0	5	5	P30511-1	153	158	+	5	P30511-1	0	345	P30511-3	0	345	+	31	P30511-1#40	0	5	P30511-3	153	158	+	5	0	0	489
P30511-1#40	0	5	5	P30511-1	153	158	+	5	P30511-1	0	346	P30511-2	0	254	+	30	P30511-1#40	0	5	P30511-2	153	158	+	5	0	0	490
P30511-1#40	0	5	5	P30511-1	153	158	+	5	P30511-1	0	346	P30511-1	0	346	+	29	P30511-1#40	0	5	P30511-1	153	158	+	5	0	0	491
P30511-1#41	0	10	10	P30511-1	160	170	+	10	P30511-1	0	345	P30511-3	0	345	+	31	P30511-1#41	0	10	P30511-3	160	170	+	10	0	0	492
P30511-1#41	0	10	10	P30511-1	160	170	+	10	P30511-1	0	346	P30511-2	0	254	+	30	P30511-1#41	0	10	P30511-2	160	170	+	10	0	0	493
P30511-1#41	0	10	10	P30511-1	160	170	+	10	P30511-1	0	346	P30511-1	0	346	+	29	P30511-1#41	0	10	P30511-1	160	170	+	10	0	0	494
P30511-1#42	0	10	10	P30511-1	172	182	+	10	P30511-1	0	345	P30511-3	0	345	+	31	P30511-1#42	0	10	P30511-3	172	182	+	10	0	0	495
P30511-1#42	0	10	10	P30511-1	172	182	+	10	P30511-1	0	346	P30511-2	0	254	+	30	P30511-1#42	0	10	P30511-2	172	182	+	10	0	0	496
P30511-1#42	0	10	10	P30511-1	172	182	+	10	P30511-1	0	346	P30511-1	0	346	+	29	P30511-1#42	0	10	P30511-1	172	182	+	10	0	0	497
P30511-1#43	0	12	12	P30511-1	183	195	+	12	P30511-1	0	345	P30511-3	0	345	+	31	P30511-1#43	0	12	P30511-3	183	195	+	12	0	0	498
P30511-1#43	0	12	12	P30511-1	183	195	+	12	P30511-1	0	346	P30511-2	0	254	+	30	P30511-1#43	0	12	P30511-2	183	195	+	12	0	0	499
P30511-1#43	0	12	12	P30511-1	183	195	+	12	P30511-1	0	346	P30511-1	0	346	+	29	P30511-1#43	0	12	P30511-1	183	195	+	12	0	0	500
P30511-1#44	0	4	4	P30511-1	196	200	+	4	P30511-1	0	345	P30511-3	0	345	+	31	P30511-1#44	0	4	P30511-3	196	200	+	4	0	0	501
P30511-1#44	0	4	4	P30511-1	196	200	+	4	P30511-1	0	346	P30511-2	0	254	+	30	P30511-1#44	0	4	P30511-2	196	200	+	4	0	0	502
P30511-1#44	0	4	4	P30511-1	196	200	+	4	P30511-1	0	346	P30511-1	0	346	+	29	P30511-1#44	0	4	P30511-1	196	200	+	4	0	0	503
P30511-1#45	0	8	8	P30511-1	206	214	+	8	P30511-1	0	345	P30511-3	0	345	+	31	P30511-1#45	0	8	P30511-3	206	214	+	8	0	0	504
P30511-1#45	0	8	8	P30511-1	206	214	+	8	P30511-1	0	346	P30511-1	0	346	+	29	P30511-1#45	0	8	P30511-1	206	214	+	8	0	0	505
P30511-1#46	0	17	17	P30511-1	215	232	+	17	P30511-1	0	345	P30511-3	0	345	+	31	P30511-1#46	0	17	P30511-3	215	232	+	17	0	0	506
P30511-1#46	0	17	17	P30511-1	215	232	+	17	P30511-1	0	346	P30511-1	0	346	+	29	P30511-1#46	0	17	P30511-1	215	232	+	17	0	0	507
P30511-1#47	0	6	6	P30511-1	234	240	+	6	P30511-1	0	345	P30511-3	0	345	+	31	P30511-1#47	0	6	P30511-3	234	240	+	6	0	0	508
P30511-1#47	0	6	6	P30511-1	234	240	+	6	P30511-1	0	346	P30511-1	0	346	+	29	P30511-1#47	0	6	P30511-1	234	240	+	6	0	0	509
P30511-1#48	0	3	3	P30511-1	245	248	+	3	P30511-1	0	345	P30511-3	0	345	+	31	P30511-1#48	0	3	P30511-3	245	248	+	3	0	0	510
P30511-1#48	0	3	3	P30511-1	245	248	+	3	P30511-1	0	346	P30511-1	0	346	+	29	P30511-1#48	0	3	P30511-1	245	248	+	3	0	0	511
P30511-1#49	0	3	3	P30511-1	248	251	+	3	P30511-1	0	345	P30511-3	0	345	+	31	P30511-1#49	0	3	P30511-3	248	251	+	3	0	0	512
P30511-1#49	0	3	3	P30511-1	248	251	+	3	P30511-1	0	346	P30511-1	0	346	+	29	P30511-1#49	0	3	P30511-1	248	251	+	3	0	0	513
P30511-1#50	0	3	3	P30511-1	257	260	+	3	P30511-1	0	345	P30511-3	0	345	+	31	P30511-1#50	0	3	P30511-3	257	260	+	3	0	0	514
P30511-1#50	0	3	3	P30511-1	257	260	+	3	P30511-1	0	346	P30511-1	0	346	+	29	P30511-1#50	0	3	P30511-1	257	260	+	3	0	0	515
P30511-1#51	0	10	10	P30511-1	261	271	+	10	P30511-1	0	345	P30511-3	0	345	+	31	P30511-1#51	0	10	P30511-3	261	271	+	10	0	0	516
P30511-1#51	0	10	10	P30511-1	261	271	+	10	P30511-1	0	346	P30511-1	0	346	+	29	P30511-1#51	0	10	P30511-1	261	271	+	10	0	0	517
P30511-1#52	0	3	3	P30511-1	274	277	+	3	P30511-1	0	345	P30511-3	0	345	+	31	P30511-1#52	0	3	P30511-3	274	277	+	3	0	0	518
P30511-1#52	0	3	3	P30511-1	274	277	+	3	P30511-1	0	346	P30511-1	0	346	+	29	P30511-1#52	0	3	P30511-1	274	277	+	3	0	0	519
P30511-1#53	0	6	6	P30511-1	277	283	+	6	P30511-1	0	345	P30511-3	0	345	+	31	P30511-1#53	0	6	P30511-3	277	283	+	6	0	0	520
P30511-1#53	0	6	6	P30511-1	277	283	+	6	P30511-1	0	346	P30511-1	0	346	+	29	P30511-1#53	0	6	P30511-1	277	283	+	6	0	0	521
P30511-1#54	0	3	3	P30511-1	286	289	+	3	P30511-1	0	345	P30511-3	0	345	+	31	P30511-1#54	0	3	P30511-3	286	289	+	3	0	0	522
P30511-1#54	0	3	3	P30511-1	286	289	+	3	P30511-1	0	346	P30511-1	0	346	+	29	P30511-1#54	0	3	P30511-1	286	289	+	3	0	0	523
P30511-1#55	0	3	3	P30511-1	290	293	+	3	P30511-1	0	345	P30511-3	0	345	+	31	P30511-1#55	0	3	P30511-3	290	293	+	3	0	0	524
P30511-1#55	0	3	3	P30511-1	290	293	+	3	P30511-1	0	346	P30511-1	0	346	+	29	P30511-1#55	0	3	P30511-1	290	293	+	3	0	0	525
Q99732-1#0	0	161	161	Q99732-1	0	161	+	161	Q99732-1	0	126	Q99732-3	0	126	+	87	Q99732-1#0	0	126	Q99732-3	0	126	+	126	0	35	526
Q99732-1#0	0	161	161	Q99732-1	0	161	+	161	Q99732-1	0	126	Q99732-2	0	126	+	86	Q99732-1#0	0	126	Q99732-2	0	126	+	126	0	35	527
Q99732-1#0	0	161	161	Q99732-1	0	161	+	161	Q99732-1	0	161	Q99732-1	0	161	+	85	Q99732-1#0	0	161	Q99732-1	0	161	+	161	0	0	528
Q99732-1#1	0	85	85	Q99732-1	75	160	+	85	Q99732-1	0	126	Q99732-3	0	126	+	87	Q99732-1#1	0	51	Q99732-3	75	126	+	51	0	34	529
Q99732-1#1	0	85	85	Q99732-1	75	160	+	85	Q99732-1	0	126	Q99732-2	0	126	+	86	Q99732-1#1	0	51	Q99732-2	75	126	+	51	0	34	530
Q99732-1#1	0	85	85	Q99732-1	75	160	+	85	Q99732-1	0	161	Q99732-1	0	161	+	85	Q99732-1#1	0	85	Q99732-1	75	160	+	85	0	0	531
Q99732-1#2	0	22	22	Q99732-1	0	22	+	22	Q99732-1	0	126	Q99732-3	0	126	+	87	Q99732-1#2	0	22	Q99732-3	0	22	+	22	0	0	532
Q99732-1#2	0	22	22	Q99732-1	0	22	+	22	Q99732-1	0	126	Q99732-2	0	126	+	86	Q99732-1#2	0	22	Q99732-2	0	22	+	22	0	0	533
Q99732-1#2	0	22	22	Q99732-1	0	22	+	22	Q99732-1	0	161	Q99732-1	0	161	+	85	Q99732-1#2	0	22	Q99732-1	0	22	+	22	0	0	534
Q99732-1#3	0	24	24	Q99732-1	110	134	+	24	Q99732-1	0	126	Q99732-3	0	126	+	87	Q99732-1#3	0	16	Q99732-3	110	126	+	16	0	8	535
Q99732-1#3	0	24	24	Q99732-1	110	134	+	24	Q99732-1	0	126	Q99732-2	0	126	+	86	Q99732-1#3	0	16	Q99732-2	110	126	+	16	0	8	536
Q99732-1#3	0	24	24	Q99732-1	110	134	+	24	Q99732-1	0	161	Q99732-1	0	161	+	85	Q99732-1#3	0	24	Q99732-1	110	134	+	24	0	0	537
Q99732-1#4	0	4	4	Q99732-1	16	20	+	4	Q99732-1	0	126	Q99732-3	0	126	+	87	Q99732-1#4	0	4	Q99732-3	16	20	+	4	0	0	538
Q99732-1#4	0	4	4	Q99732-1	16	20	+	4	Q99732-1	0	126	Q99732-2	0	126	+	86	Q99732-1#4	0	4	Q99732-2	16	20	+	4	0	0	539
Q99732-1#4	0	4	4	Q99732-1	16	20	+	4	Q99732-1	0	161	Q99732-1	0	161	+	85	Q99732-1#4	0	4	Q99732-1	16	20	+	4	0	0	540
Q99732-1#5	0	4	4	Q99732-1	19	23	+	4	Q99732-1	0	126	Q99732-3	0	126	+	87	Q99732-1#5	0	4	Q99732-3	19	23	+	4	0	0	541
Q99732-1#5	0	4	4	Q99732-1	19	23	+	4	Q99732-1	0	126	Q99732-2	0	126	+	86	Q99732-1#5	0	4	Q99732-2	19	23	+	4	0	0	542
Q99732-1#5	0	4	4	Q99732-1	19	23	+	4	Q99732-1	0	161	Q99732-1	0	161	+	85	Q99732-1#5	0	4	Q99732-1	19	23	+	4	0	0	543
Q99732-1#6	0	16	16	Q99732-1	6	22	+	16	Q99732-1	0	126	Q99732-3	0	126	+	87	Q99732-1#6	0	16	Q99732-3	6	22	+	16	0	0	544
Q99732-1#6	0	16	16	Q99732-1	6	22	+	16	Q99732-1	0	126	Q99732-2	0	126	+	86	Q99732-1#6	0	16	Q99732-2	6	22	+	16	0	0	545
Q99732-1#6	0	16	16	Q99732-1	6	22	+	16	Q99732-1	0	161	Q99732-1	0	161	+	85	Q99732-1#6	0	16	Q99732-1	6	22	+	16	0	0	546
Q99732-1#7	0	1	1	Q99732-1	95	96	+	1	Q99732-1	0	126	Q99732-3	0	126	+	87	Q99732-1#7	0	1	Q99732-3	95	96	+	1	0	0	547
Q99732-1#7	0	1	1	Q99732-1	95	96	+	1	Q99732-1	0	126	Q99732-2	0	126	+	86	Q99732-1#7	0	1	Q99732-2	95	96	+	1	0	0	548
Q99732-1#7	0	1	1	Q99732-1	95	96	+	1	Q99732-1	0	161	Q99732-1	0	161	+	85	Q99732-1#7	0	1	Q99732-1	95	96	+	1	0	0	549
Q99732-1#8	0	1	1	Q99732-1	98	99	+	1	Q99732-1	0	126	Q99732-3	0	126	+	87	Q99732-1#8	0	1	Q99732-3	98	99	+	1	0	0	550
Q99732-1#8	0	1	1	Q99732-1	98	99	+	1	Q99732-1	0	126	Q99732-2	0	126	+	86	Q99732-1#8	0	1	Q99732-2	98	99	+	1	0	0	551
Q99732-1#8	0	1	1	Q99732-1	98	99	+	1	Q99732-1	0	161	Q99732-1	0	161	+	85	Q99732-1#8	0	1	Q99732-1	98	99	+	1	0	0	552
Q99732-1#9	0	1	1	Q99732-1	147	148	+	1	Q99732-1	0	161	Q99732-1	0	161	+	85	Q99732-1#9	0	1	Q99732-1	147	148	+	1	0	0	553
Q99732-1#10	0	1	1	Q99732-1	150	151	+	1	Q99732-1	0	161	Q99732-1	0	161	+	85	Q99732-1#10	0	1	Q99732-1	150	151	+	1	0	0	554
Q99732-1#11	0	35	35	Q99732-1	126	161	+	35	Q99732-1	0	161	Q99732-1	0	161	+	85	Q99732-1#11	0	35	Q99732-1	126	161	+	35	0	0	555
Q99732-1#12	0	35	35	Q99732-1	126	161	+	35	Q99732-1	0	161	Q99732-1	0	161	+	85	Q99732-1#12	0	35	Q99732-1	126	161	+	35	0	0	556
Q99732-1#13	0	1	1	Q99732-1	22	23	+	1	Q99732-1	0	126	Q99732-3	0	126	+	87	Q99732-1#13	0	1	Q99732-3	22	23	+	1	0	0	557
Q99732-1#13	0	1	1	Q99732-1	22	23	+	1	Q99732-1	0	126	Q99732-2	0	126	+	86	Q99732-1#13	0	1	Q99732-2	22	23	+	1	0	0	558
Q99732-1#13	0	1	1	Q99732-1	22	23	+	1	Q99732-1	0	161	Q99732-1	0	161	+	85	Q99732-1#13	0	1	Q99732-1	22	23	+	1	0	0	559
Q99732-1#14	0	1	1	Q99732-1	48	49	+	1	Q99732-1	0	126	Q99732-3	0	126	+	87	Q99732-1#14	0	1	Q99732-3	48	49	+	1	0	0	560
Q99732-1#14	0	1	1	Q99732-1	48	49	+	1	Q99732-1	0	126	Q99732-2	0	126	+	86	Q99732-1#14	0	1	Q99732-2	48	49	+	1	0	0	561
Q99732-1#14	0	1	1	Q99732-1	48	49	+	1	Q99732-1	0	161	Q99732-1	0	161	+	85	Q99732-1#14	0	1	Q99732-1	48	49	+	1	0	0	562
Q99732-1#15	0	1	1	Q99732-1	91	92	+	1	Q99732-1	0	126	Q99732-3	0	126	+	87	Q99732-1#15	0	1	Q99732-3	91	92	+	1	0	0	563
Q99732-1#15	0	1	1	Q99732-1	91	92	+	1	Q99732-1	0	126	Q99732-2	0	126	+	86	Q99732-1#15	0	1	Q99732-2	91	92	+	1	0	0	564
Q99732-1#15	0	1	1	Q99732-1	91	92	+	1	Q99732-1	0	161	Q99732-1	0	161	+	85	Q99732-1#15	0	1	Q99732-1	91	92	+	1	0	0	565
Q99732-1#16	0	1	1	Q99732-1	111	112	+	1	Q99732-1	0	126	Q99732-3	0	126	+	87	Q99732-1#16	0	1	Q99732-3	111	112	+	1	0	0	566
Q99732-1#16	0	1	1	Q99732-1	111	112	+	1	Q99732-1	0	126	Q99732-2	0	126	+	86	Q99732-1#16	0	1	Q99732-2	111	112	+	1	0	0	567
Q99732-1#16	0	1	1	Q99732-1	111	112	+	1	Q99732-1	0	161	Q99732-1	0	161	+	85	Q99732-1#16	0	1	Q99732-1	111	112	+	1	0	0	568
Q99732-1#17	0	1	1	Q99732-1	114	115	+	1	Q99732-1	0	126	Q99732-3	0	126	+	87	Q99732-1#17	0	1	Q99732-3	114	115	+	1	0	0	569
Q99732-1#17	0	1	1	Q99732-1	114	115	+	1	Q99732-1	0	126	Q99732-2	0	126	+	86	Q99732-1#17	0	1	Q99732-2	114	115	+	1	0	0	570
Q99732-1#17	0	1	1	Q99732-1	114	115	+	1	Q99732-1	0	161	Q99732-1	0	161	+	85	Q99732-1#17	0	1	Q99732-1	114	115	+	1	0	0	571
Q99732-1#18	0	1	1	Q99732-1	115	116	+	1	Q99732-1	0	126	Q99732-3	0	126	+	87	Q99732-1#18	0	1	Q99732-3	115	116	+	1	0	0	572
Q99732-1#18	0	1	1	Q99732-1	115	116	+	1	Q99732-1	0	126	Q99732-2	0	126	+	86	Q99732-1#18	0	1	Q99732-2	115	116	+	1	0	0	573
Q99732-1#18	0	1	1	Q99732-1	115	116	+	1	Q99732-1	0	161	Q99732-1	0	161	+	85	Q99732-1#18	0	1	Q99732-1	115	116	+	1	0	0	574
Q99732-1#19	0	1	1	Q99732-1	121	122	+	1	Q99732-1	0	126	Q99732-3	0	126	+	87	Q99732-1#19	0	1	Q99732-3	121	122	+	1	0	0	575
Q99732-1#19	0	1	1	Q99732-1	121	122	+	1	Q99732-1	0	126	Q99732-2	0	126	+	86	Q99732-1#19	0	1	Q99732-2	121	122	+	1	0	0	576
Q99732-1#19	0	1	1	Q99732-1	121	122	+	1	Q99732-1	0	161	Q99732-1	0	161	+	85	Q99732-1#19	0	1	Q99732-1	121	122	+	1	0	0	577
Q99732-1#20	0	4	4	Q99732-1	16	20	+	4	Q99732-1	0	126	Q99732-3	0	126	+	87	Q99732-1#20	0	4	Q99732-3	16	20	+	4	0	0	578
Q99732-1#20	0	4	4	Q99732-1	16	20	+	4	Q99732-1	0	126	Q99732-2	0	126	+	86	Q99732-1#20	0	4	Q99732-2	16	20	+	4	0	0	579
Q99732-1#20	0	4	4	Q99732-1	16	20	+	4	Q99732-1	0	161	Q99732-1	0	161	+	85	Q99732-1#20	0	4	Q99732-1	16	20	+	4	0	0	580
Q99732-1#21	0	3	3	Q99732-1	16	19	+	3	Q99732-1	0	126	Q99732-3	0	126	+	87	Q99732-1#21	0	3	Q99732-3	16	19	+	3	0	0	581
Q99732-1#21	0	3	3	Q99732-1	16	19	+	3	Q99732-1	0	126	Q99732-2	0	126	+	86	Q99732-1#21	0	3	Q99732-2	16	19	+	3	0	0	582
Q99732-1#21	0	3	3	Q99732-1	16	19	+	3	Q99732-1	0	161	Q99732-1	0	161	+	85	Q99732-1#21	0	3	Q99732-1	16	19	+	3	0	0	583
Q99732-1#22	0	1	1	Q99732-1	22	23	+	1	Q99732-1	0	126	Q99732-3	0	126	+	87	Q99732-1#22	0	1	Q99732-3	22	23	+	1	0	0	584
Q99732-1#22	0	1	1	Q99732-1	22	23	+	1	Q99732-1	0	126	Q99732-2	0	126	+	86	Q99732-1#22	0	1	Q99732-2	22	23	+	1	0	0	585
Q99732-1#22	0	1	1	Q99732-1	22	23	+	1	Q99732-1	0	161	Q99732-1	0	161	+	85	Q99732-1#22	0	1	Q99732-1	22	23	+	1	0	0	586
Q99732-1#23	0	1	1	Q99732-1	22	23	+	1	Q99732-1	0	126	Q99732-3	0	126	+	87	Q99732-1#23	0	1	Q99732-3	22	23	+	1	0	0	587
Q99732-1#23	0	1	1	Q99732-1	22	23	+	1	Q99732-1	0	126	Q99732-2	0	126	+	86	Q99732-1#23	0	1	Q99732-2	22	23	+	1	0	0	588
Q99732-1#23	0	1	1	Q99732-1	22	23	+	1	Q99732-1	0	161	Q99732-1	0	161	+	85	Q99732-1#23	0	1	Q99732-1	22	23	+	1	0	0	589
Q99732-1#24	0	1	1	Q99732-1	60	61	+	1	Q99732-1	0	126	Q99732-3	0	126	+	87	Q99732-1#24	0	1	Q99732-3	60	61	+	1	0	0	590
Q99732-1#24	0	1	1	Q99732-1	60	61	+	1	Q99732-1	0	126	Q99732-2	0	126	+	86	Q99732-1#24	0	1	Q99732-2	60	61	+	1	0	0	591
Q99732-1#24	0	1	1	Q99732-1	60	61	+	1	Q99732-1	0	161	Q99732-1	0	161	+	85	Q99732-1#24	0	1	Q99732-1	60	61	+	1	0	0	592
Q99732-1#25	0	1	1	Q99732-1	95	96	+	1	Q99732-1	0	126	Q99732-3	0	126	+	87	Q99732-1#25	0	1	Q99732-3	95	96	+	1	0	0	593
Q99732-1#25	0	1	1	Q99732-1	95	96	+	1	Q99732-1	0	126	Q99732-2	0	126	+	86	Q99732-1#25	0	1	Q99732-2	95	96	+	1	0	0	594
Q99732-1#25	0	1	1	Q99732-1	95	96	+	1	Q99732-1	0	161	Q99732-1	0	161	+	85	Q99732-1#25	0	1	Q99732-1	95	96	+	1	0	0	595
Q99732-1#26	0	1	1	Q99732-1	134	135	+	1	Q99732-1	0	161	Q99732-1	0	161	+	85	Q99732-1#26	0	1	Q99732-1	134	135	+	1	0	0	596
Q99732-1#27	0	1	1	Q99732-1	143	144	+	1	Q99732-1	0	161	Q99732-1	0	161	+	85	Q99732-1#27	0	1	Q99732-1	143	144	+	1	0	0	597
Q99732-1#28	0	1	1	Q99732-1	147	148	+	1	Q99732-1	0	161	Q99732-1	0	161	+	85	Q99732-1#28	0	1	Q99732-1	147	148	+	1	0	0	598
Q6PF04-1#0	0	617	617	Q6PF04-1	0	617	+	617	Q6PF04-1	36	617	Q6PF04-2	0	581	+	47	Q6PF04-1#0	36	617	Q6PF04-2	0	581	+	581	36	0	599
Q6PF04-1#0	0	617	617	Q6PF04-1	0	617	+	617	Q6PF04-1	0	617	Q6PF04-1	0	617	+	46	Q6PF04-1#0	0	617	Q6PF04-1	0	617	+	617	0	0	600
Q6PF04-1#1	0	71	71	Q6PF04-1	7	78	+	71	Q6PF04-1	36	617	Q6PF04-2	0	581	+	47	Q6PF04-1#1	29	71	Q6PF04-2	0	42	+	42	29	0	601
Q6PF04-1#1	0	71	71	Q6PF04-1	7	78	+	71	Q6PF04-1	0	617	Q6PF04-1	0	617	+	46	Q6PF04-1#1	0	71	Q6PF04-1	7	78	+	71	0	0	602
Q6PF04-1#2	0	23	23	Q6PF04-1	203	226	+	23	Q6PF04-1	36	617	Q6PF04-2	0	581	+	47	Q6PF04-1#2	0	23	Q6PF04-2	167	190	+	23	0	0	603
Q6PF04-1#2	0	23	23	Q6PF04-1	203	226	+	23	Q6PF04-1	0	617	Q6PF04-1	0	617	+	46	Q6PF04-1#2	0	23	Q6PF04-1	203	226	+	23	0	0	604
Q6PF04-1#3	0	23	23	Q6PF04-1	231	254	+	23	Q6PF04-1	36	617	Q6PF04-2	0	581	+	47	Q6PF04-1#3	0	23	Q6PF04-2	195	218	+	23	0	0	605
Q6PF04-1#3	0	23	23	Q6PF04-1	231	254	+	23	Q6PF04-1	0	617	Q6PF04-1	0	617	+	46	Q6PF04-1#3	0	23	Q6PF04-1	231	254	+	23	0	0	606
Q6PF04-1#4	0	23	23	Q6PF04-1	259	282	+	23	Q6PF04-1	36	617	Q6PF04-2	0	581	+	47	Q6PF04-1#4	0	23	Q6PF04-2	223	246	+	23	0	0	607
Q6PF04-1#4	0	23	23	Q6PF04-1	259	282	+	23	Q6PF04-1	0	617	Q6PF04-1	0	617	+	46	Q6PF04-1#4	0	23	Q6PF04-1	259	282	+	23	0	0	608
Q6PF04-1#5	0	23	23	Q6PF04-1	287	310	+	23	Q6PF04-1	36	617	Q6PF04-2	0	581	+	47	Q6PF04-1#5	0	23	Q6PF04-2	251	274	+	23	0	0	609
Q6PF04-1#5	0	23	23	Q6PF04-1	287	310	+	23	Q6PF04-1	0	617	Q6PF04-1	0	617	+	46	Q6PF04-1#5	0	23	Q6PF04-1	287	310	+	23	0	0	610
Q6PF04-1#6	0	23	23	Q6PF04-1	315	338	+	23	Q6PF04-1	36	617	Q6PF04-2	0	581	+	47	Q6PF04-1#6	0	23	Q6PF04-2	279	302	+	23	0	0	611
Q6PF04-1#6	0	23	23	Q6PF04-1	315	338	+	23	Q6PF04-1	0	617	Q6PF04-1	0	617	+	46	Q6PF04-1#6	0	23	Q6PF04-1	315	338	+	23	0	0	612
Q6PF04-1#7	0	23	23	Q6PF04-1	343	366	+	23	Q6PF04-1	36	617	Q6PF04-2	0	581	+	47	Q6PF04-1#7	0	23	Q6PF04-2	307	330	+	23	0	0	613
Q6PF04-1#7	0	23	23	Q6PF04-1	343	366	+	23	Q6PF04-1	0	617	Q6PF04-1	0	617	+	46	Q6PF04-1#7	0	23	Q6PF04-1	343	366	+	23	0	0	614
Q6PF04-1#8	0	23	23	Q6PF04-1	371	394	+	23	Q6PF04-1	36	617	Q6PF04-2	0	581	+	47	Q6PF04-1#8	0	23	Q6PF04-2	335	358	+	23	0	0	615
Q6PF04-1#8	0	23	23	Q6PF04-1	371	394	+	23	Q6PF04-1	0	617	Q6PF04-1	0	617	+	46	Q6PF04-1#8	0	23	Q6PF04-1	371	394	+	23	0	0	616
Q6PF04-1#9	0	23	23	Q6PF04-1	399	422	+	23	Q6PF04-1	36	617	Q6PF04-2	0	581	+	47	Q6PF04-1#9	0	23	Q6PF04-2	363	386	+	23	0	0	617
Q6PF04-1#9	0	23	23	Q6PF04-1	399	422	+	23	Q6PF04-1	0	617	Q6PF04-1	0	617	+	46	Q6PF04-1#9	0	23	Q6PF04-1	399	422	+	23	0	0	618
Q6PF04-1#10	0	23	23	Q6PF04-1	427	450	+	23	Q6PF04-1	36	617	Q6PF04-2	0	581	+	47	Q6PF04-1#10	0	23	Q6PF04-2	391	414	+	23	0	0	619
Q6PF04-1#10	0	23	23	Q6PF04-1	427	450	+	23	Q6PF04-1	0	617	Q6PF04-1	0	617	+	46	Q6PF04-1#10	0	23	Q6PF04-1	427	450	+	23	0	0	620
Q6PF04-1#11	0	23	23	Q6PF04-1	455	478	+	23	Q6PF04-1	36	617	Q6PF04-2	0	581	+	47	Q6PF04-1#11	0	23	Q6PF04-2	419	442	+	23	0	0	621
Q6PF04-1#11	0	23	23	Q6PF04-1	455	478	+	23	Q6PF04-1	0	617	Q6PF04-1	0	617	+	46	Q6PF04-1#11	0	23	Q6PF04-1	455	478	+	23	0	0	622
Q6PF04-1#12	0	23	23	Q6PF04-1	483	506	+	23	Q6PF04-1	36	617	Q6PF04-2	0	581	+	47	Q6PF04-1#12	0	23	Q6PF04-2	447	470	+	23	0	0	623
Q6PF04-1#12	0	23	23	Q6PF04-1	483	506	+	23	Q6PF04-1	0	617	Q6PF04-1	0	617	+	46	Q6PF04-1#12	0	23	Q6PF04-1	483	506	+	23	0	0	624
Q6PF04-1#13	0	24	24	Q6PF04-1	511	535	+	24	Q6PF04-1	36	617	Q6PF04-2	0	581	+	47	Q6PF04-1#13	0	24	Q6PF04-2	475	499	+	24	0	0	625
Q6PF04-1#13	0	24	24	Q6PF04-1	511	535	+	24	Q6PF04-1	0	617	Q6PF04-1	0	617	+	46	Q6PF04-1#13	0	24	Q6PF04-1	511	535	+	24	0	0	626
Q6PF04-1#14	0	36	36	Q6PF04-1	0	36	+	36	Q6PF04-1	0	617	Q6PF04-1	0	617	+	46	Q6PF04-1#14	0	36	Q6PF04-1	0	36	+	36	0	0	627
Q6PF04-1#15	0	1	1	Q6PF04-1	83	84	+	1	Q6PF04-1	36	617	Q6PF04-2	0	581	+	47	Q6PF04-1#15	0	1	Q6PF04-2	47	48	+	1	0	0	628
Q6PF04-1#15	0	1	1	Q6PF04-1	83	84	+	1	Q6PF04-1	0	617	Q6PF04-1	0	617	+	46	Q6PF04-1#15	0	1	Q6PF04-1	83	84	+	1	0	0	629
Q6PF04-1#16	0	1	1	Q6PF04-1	92	93	+	1	Q6PF04-1	36	617	Q6PF04-2	0	581	+	47	Q6PF04-1#16	0	1	Q6PF04-2	56	57	+	1	0	0	630
Q6PF04-1#16	0	1	1	Q6PF04-1	92	93	+	1	Q6PF04-1	0	617	Q6PF04-1	0	617	+	46	Q6PF04-1#16	0	1	Q6PF04-1	92	93	+	1	0	0	631
Q6PF04-1#17	0	1	1	Q6PF04-1	134	135	+	1	Q6PF04-1	36	617	Q6PF04-2	0	581	+	47	Q6PF04-1#17	0	1	Q6PF04-2	98	99	+	1	0	0	632
Q6PF04-1#17	0	1	1	Q6PF04-1	134	135	+	1	Q6PF04-1	0	617	Q6PF04-1	0	617	+	46	Q6PF04-1#17	0	1	Q6PF04-1	134	135	+	1	0	0	633
Q6PF04-1#18	0	1	1	Q6PF04-1	162	163	+	1	Q6PF04-1	36	617	Q6PF04-2	0	581	+	47	Q6PF04-1#18	0	1	Q6PF04-2	126	127	+	1	0	0	634
Q6PF04-1#18	0	1	1	Q6PF04-1	162	163	+	1	Q6PF04-1	0	617	Q6PF04-1	0	617	+	46	Q6PF04-1#18	0	1	Q6PF04-1	162	163	+	1	0	0	635
Q6PF04-1#19	0	1	1	Q6PF04-1	610	611	+	1	Q6PF04-1	36	617	Q6PF04-2	0	581	+	47	Q6PF04-1#19	0	1	Q6PF04-2	574	575	+	1	0	0	636
Q6PF04-1#19	0	1	1	Q6PF04-1	610	611	+	1	Q6PF04-1	0	617	Q6PF04-1	0	617	+	46	Q6PF04-1#19	0	1	Q6PF04-1	610	611	+	1	0	0	637
O95336#0	0	1	1	O95336	0	1	+	1	O95336	0	258	O95336	0	258	+	7	O95336#0	0	1	O95336	0	1	+	1	0	0	638
O95336#1	0	257	257	O95336	1	258	+	257	O95336	0	258	O95336	0	258	+	7	O95336#1	0	257	O95336	1	258	+	257	0	0	639
O95336#2	0	1	1	O95336	1	2	+	1	O95336	0	258	O95336	0	258	+	7	O95336#2	0	1	O95336	1	2	+	1	0	0	640
O95336#3	0	1	1	O95336	48	49	+	1	O95336	0	258	O95336	0	258	+	7	O95336#3	0	1	O95336	48	49	+	1	0	0	641
O95336#4	0	1	1	O95336	179	180	+	1	O95336	0	258	O95336	0	258	+	7	O95336#4	0	1	O95336	179	180	+	1	0	0	642
P20848#0	0	21	21	P20848	0	21	+	21	P20848	0	421	P20848	0	421	+	24	P20848#0	0	21	P20848	0	21	+	21	0	0	643
P20848#1	0	400	400	P20848	21	421	+	400	P20848	0	421	P20848	0	421	+	24	P20848#1	0	400	P20848	21	421	+	400	0	0	644
P20848#2	0	2	2	P20848	384	386	+	2	P20848	0	421	P20848	0	421	+	24	P20848#2	0	2	P20848	384	386	+	2	0	0	645
P20848#3	0	1	1	P20848	55	56	+	1	P20848	0	421	P20848	0	421	+	24	P20848#3	0	1	P20848	55	56	+	1	0	0	646
P20848#4	0	1	1	P20848	109	110	+	1	P20848	0	421	P20848	0	421	+	24	P20848#4	0	1	P20848	109	110	+	1	0	0	647
P20848#5	0	1	1	P20848	147	148	+	1	P20848	0	421	P20848	0	421	+	24	P20848#5	0	1	P20848	147	148	+	1	0	0	648
P20848#6	0	1	1	P20848	273	274	+	1	P20848	0	421	P20848	0	421	+	24	P20848#6	0	1	P20848	273	274	+	1	0	0	649
P20848#7	0	1	1	P20848	329	330	+	1	P20848	0	421	P20848	0	421	+	24	P20848#7	0	1	P20848	329	330	+	1	0	0	650
P20848#8	0	1	1	P20848	341	342	+	1	P20848	0	421	P20848	0	421	+	24	P20848#8	0	1	P20848	341	342	+	1	0	0	651
P20848#9	0	1	1	P20848	8	9	+	1	P20848	0	421	P20848	0	421	+	24	P20848#9	0	1	P20848	8	9	+	1	0	0	652
P20848#10	0	1	1	P20848	28	29	+	1	P20848	0	421	P20848	0	421	+	24	P20848#10	0	1	P20848	28	29	+	1	0	0	653
P20848#11	0	10	10	P20848	66	76	+	10	P20848	0	421	P20848	0	421	+	24	P20848#11	0	10	P20848	66	76	+	10	0	0	654
P20848#12	0	1	1	P20848	88	89	+	1	P20848	0	421	P20848	0	421	+	24	P20848#12	0	1	P20848	88	89	+	1	0	0	655
P20848#13	0	1	1	P20848	228	229	+	1	P20848	0	421	P20848	0	421	+	24	P20848#13	0	1	P20848	228	229	+	1	0	0	656
P20848#14	0	2	2	P20848	402	404	+	2	P20848	0	421	P20848	0	421	+	24	P20848#14	0	2	P20848	402	404	+	2	0	0	657
P01009-1#0	0	24	24	P01009-1	0	24	+	24	P01009-1	0	306	P01009-3	0	306	+	18	P01009-1#0	0	24	P01009-3	0	24	+	24	0	0	658
P01009-1#0	0	24	24	P01009-1	0	24	+	24	P01009-1	0	355	P01009-2	0	355	+	17	P01009-1#0	0	24	P01009-2	0	24	+	24	0	0	659
P01009-1#0	0	24	24	P01009-1	0	24	+	24	P01009-1	0	418	P01009-1	0	418	+	16	P01009-1#0	0	24	P01009-1	0	24	+	24	0	0	660
P01009-1#1	0	394	394	P01009-1	24	418	+	394	P01009-1	0	306	P01009-3	0	306	+	18	P01009-1#1	0	282	P01009-3	24	306	+	282	0	112	661
P01009-1#1	0	394	394	P01009-1	24	418	+	394	P01009-1	0	355	P01009-2	0	355	+	17	P01009-1#1	0	331	P01009-2	24	355	+	331	0	63	662
P01009-1#1	0	394	394	P01009-1	24	418	+	394	P01009-1	0	418	P01009-1	0	418	+	16	P01009-1#1	0	394	P01009-1	24	418	+	394	0	0	663
P01009-1#2	0	44	44	P01009-1	374	418	+	44	P01009-1	0	418	P01009-1	0	418	+	16	P01009-1#2	0	44	P01009-1	374	418	+	44	0	0	664
P01009-1#3	0	25	25	P01009-1	367	392	+	25	P01009-1	0	418	P01009-1	0	418	+	16	P01009-1#3	0	25	P01009-1	367	392	+	25	0	0	665
P01009-1#4	0	2	2	P01009-1	351	353	+	2	P01009-1	0	355	P01009-2	0	355	+	17	P01009-1#4	0	2	P01009-2	351	353	+	2	0	0	666
P01009-1#4	0	2	2	P01009-1	351	353	+	2	P01009-1	0	418	P01009-1	0	418	+	16	P01009-1#4	0	2	P01009-1	351	353	+	2	0	0	667
P01009-1#5	0	2	2	P01009-1	353	355	+	2	P01009-1	0	355	P01009-2	0	355	+	17	P01009-1#5	0	2	P01009-2	353	355	+	2	0	0	668
P01009-1#5	0	2	2	P01009-1	353	355	+	2	P01009-1	0	418	P01009-1	0	418	+	16	P01009-1#5	0	2	P01009-1	353	355	+	2	0	0	669
P01009-1#6	0	2	2	P01009-1	381	383	+	2	P01009-1	0	418	P01009-1	0	418	+	16	P01009-1#6	0	2	P01009-1	381	383	+	2	0	0	670
P01009-1#7	0	1	1	P01009-1	37	38	+	1	P01009-1	0	306	P01009-3	0	306	+	18	P01009-1#7	0	1	P01009-3	37	38	+	1	0	0	671
P01009-1#7	0	1	1	P01009-1	37	38	+	1	P01009-1	0	355	P01009-2	0	355	+	17	P01009-1#7	0	1	P01009-2	37	38	+	1	0	0	672
P01009-1#7	0	1	1	P01009-1	37	38	+	1	P01009-1	0	418	P01009-1	0	418	+	16	P01009-1#7	0	1	P01009-1	37	38	+	1	0	0	673
P01009-1#8	0	1	1	P01009-1	255	256	+	1	P01009-1	0	306	P01009-3	0	306	+	18	P01009-1#8	0	1	P01009-3	255	256	+	1	0	0	674
P01009-1#8	0	1	1	P01009-1	255	256	+	1	P01009-1	0	355	P01009-2	0	355	+	17	P01009-1#8	0	1	P01009-2	255	256	+	1	0	0	675
P01009-1#8	0	1	1	P01009-1	255	256	+	1	P01009-1	0	418	P01009-1	0	418	+	16	P01009-1#8	0	1	P01009-1	255	256	+	1	0	0	676
P01009-1#9	0	1	1	P01009-1	382	383	+	1	P01009-1	0	418	P01009-1	0	418	+	16	P01009-1#9	0	1	P01009-1	382	383	+	1	0	0	677
P01009-1#10	0	1	1	P01009-1	69	70	+	1	P01009-1	0	306	P01009-3	0	306	+	18	P01009-1#10	0	1	P01009-3	69	70	+	1	0	0	678
P01009-1#10	0	1	1	P01009-1	69	70	+	1	P01009-1	0	355	P01009-2	0	355	+	17	P01009-1#10	0	1	P01009-2	69	70	+	1	0	0	679
P01009-1#10	0	1	1	P01009-1	69	70	+	1	P01009-1	0	418	P01009-1	0	418	+	16	P01009-1#10	0	1	P01009-1	69	70	+	1	0	0	680
P01009-1#11	0	1	1	P01009-1	106	107	+	1	P01009-1	0	306	P01009-3	0	306	+	18	P01009-1#11	0	1	P01009-3	106	107	+	1	0	0	681
P01009-1#11	0	1	1	P01009-1	106	107	+	1	P01009-1	0	355	P01009-2	0	355	+	17	P01009-1#11	0	1	P01009-2	106	107	+	1	0	0	682
P01009-1#11	0	1	1	P01009-1	106	107	+	1	P01009-1	0	418	P01009-1	0	418	+	16	P01009-1#11	0	1	P01009-1	106	107	+	1	0	0	683
P01009-1#12	0	1	1	P01009-1	270	271	+	1	P01009-1	0	306	P01009-3	0	306	+	18	P01009-1#12	0	1	P01009-3	270	271	+	1	0	0	684
P01009-1#12	0	1	1	P01009-1	270	271	+	1	P01009-1	0	355	P01009-2	0	355	+	17	P01009-1#12	0	1	P01009-2	270	271	+	1	0	0	685
P01009-1#12	0	1	1	P01009-1	270	271	+	1	P01009-1	0	418	P01009-1	0	418	+	16	P01009-1#12	0	1	P01009-1	270	271	+	1	0	0	686
P01009-1#13	0	112	112	P01009-1	306	418	+	112	P01009-1	0	355	P01009-2	0	355	+	17	P01009-1#13	0	49	P01009-2	306	355	+	49	0	63	687
P01009-1#13	0	112	112	P01009-1	306	418	+	112	P01009-1	0	418	P01009-1	0	418	+	16	P01009-1#13	0	112	P01009-1	306	418	+	112	0	0	688
P01009-1#14	0	63	63	P01009-1	355	418	+	63	P01009-1	0	418	P01009-1	0	418	+	16	P01009-1#14	0	63	P01009-1	355	418	+	63	0	0	689
P01009-1#15	0	1	1	P01009-1	3	4	+	1	P01009-1	0	306	P01009-3	0	306	+	18	P01009-1#15	0	1	P01009-3	3	4	+	1	0	0	690
P01009-1#15	0	1	1	P01009-1	3	4	+	1	P01009-1	0	355	P01009-2	0	355	+	17	P01009-1#15	0	1	P01009-2	3	4	+	1	0	0	691
P01009-1#15	0	1	1	P01009-1	3	4	+	1	P01009-1	0	418	P01009-1	0	418	+	16	P01009-1#15	0	1	P01009-1	3	4	+	1	0	0	692
P01009-1#16	0	1	1	P01009-1	25	26	+	1	P01009-1	0	306	P01009-3	0	306	+	18	P01009-1#16	0	1	P01009-3	25	26	+	1	0	0	693
P01009-1#16	0	1	1	P01009-1	25	26	+	1	P01009-1	0	355	P01009-2	0	355	+	17	P01009-1#16	0	1	P01009-2	25	26	+	1	0	0	694
P01009-1#16	0	1	1	P01009-1	25	26	+	1	P01009-1	0	418	P01009-1	0	418	+	16	P01009-1#16	0	1	P01009-1	25	26	+	1	0	0	695
P01009-1#17	0	1	1	P01009-1	36	37	+	1	P01009-1	0	306	P01009-3	0	306	+	18	P01009-1#17	0	1	P01009-3	36	37	+	1	0	0	696
P01009-1#17	0	1	1	P01009-1	36	37	+	1	P01009-1	0	355	P01009-2	0	355	+	17	P01009-1#17	0	1	P01009-2	36	37	+	1	0	0	697
P01009-1#17	0	1	1	P01009-1	36	37	+	1	P01009-1	0	418	P01009-1	0	418	+	16	P01009-1#17	0	1	P01009-1	36	37	+	1	0	0	698
P01009-1#18	0	1	1	P01009-1	57	58	+	1	P01009-1	0	306	P01009-3	0	306	+	18	P01009-1#18	0	1	P01009-3	57	58	+	1	0	0	699
P01009-1#18	0	1	1	P01009-1	57	58	+	1	P01009-1	0	355	P01009-2	0	355	+	17	P01009-1#18	0	1	P01009-2	57	58	+	1	0	0	700
P01009-1#18	0	1	1	P01009-1	57	58	+	1	P01009-1	0	418	P01009-1	0	418	+	16	P01009-1#18	0	1	P01009-1	57	58	+	1	0	0	701
P01009-1#19	0	1	1	P01009-1	62	63	+	1	P01009-1	0	306	P01009-3	0	306	+	18	P01009-1#19	0	1	P01009-3	62	63	+	1	0	0	702
P01009-1#19	0	1	1	P01009-1	62	63	+	1	P01009-1	0	355	P01009-2	0	355	+	17	P01009-1#19	0	1	P01009-2	62	63	+	1	0	0	703
P01009-1#19	0	1	1	P01009-1	62	63	+	1	P01009-1	0	418	P01009-1	0	418	+	16	P01009-1#19	0	1	P01009-1	62	63	+	1	0	0	704
P01009-1#20	0	1	1	P01009-1	64	65	+	1	P01009-1	0	306	P01009-3	0	306	+	18	P01009-1#20	0	1	P01009-3	64	65	+	1	0	0	705
P01009-1#20	0	1	1	P01009-1	64	65	+	1	P01009-1	0	355	P01009-2	0	355	+	17	P01009-1#20	0	1	P01009-2	64	65	+	1	0	0	706
P01009-1#20	0	1	1	P01009-1	64	65	+	1	P01009-1	0	418	P01009-1	0	418	+	16	P01009-1#20	0	1	P01009-1	64	65	+	1	0	0	707
P01009-1#21	0	1	1	P01009-1	68	69	+	1	P01009-1	0	306	P01009-3	0	306	+	18	P01009-1#21	0	1	P01009-3	68	69	+	1	0	0	708
P01009-1#21	0	1	1	P01009-1	68	69	+	1	P01009-1	0	355	P01009-2	0	355	+	17	P01009-1#21	0	1	P01009-2	68	69	+	1	0	0	709
P01009-1#21	0	1	1	P01009-1	68	69	+	1	P01009-1	0	418	P01009-1	0	418	+	16	P01009-1#21	0	1	P01009-1	68	69	+	1	0	0	710
P01009-1#22	0	1	1	P01009-1	74	75	+	1	P01009-1	0	306	P01009-3	0	306	+	18	P01009-1#22	0	1	P01009-3	74	75	+	1	0	0	711
P01009-1#22	0	1	1	P01009-1	74	75	+	1	P01009-1	0	355	P01009-2	0	355	+	17	P01009-1#22	0	1	P01009-2	74	75	+	1	0	0	712
P01009-1#22	0	1	1	P01009-1	74	75	+	1	P01009-1	0	418	P01009-1	0	418	+	16	P01009-1#22	0	1	P01009-1	74	75	+	1	0	0	713
P01009-1#23	0	1	1	P01009-1	76	77	+	1	P01009-1	0	306	P01009-3	0	306	+	18	P01009-1#23	0	1	P01009-3	76	77	+	1	0	0	714
P01009-1#23	0	1	1	P01009-1	76	77	+	1	P01009-1	0	355	P01009-2	0	355	+	17	P01009-1#23	0	1	P01009-2	76	77	+	1	0	0	715
P01009-1#23	0	1	1	P01009-1	76	77	+	1	P01009-1	0	418	P01009-1	0	418	+	16	P01009-1#23	0	1	P01009-1	76	77	+	1	0	0	716
P01009-1#24	0	1	1	P01009-1	83	84	+	1	P01009-1	0	306	P01009-3	0	306	+	18	P01009-1#24	0	1	P01009-3	83	84	+	1	0	0	717
P01009-1#24	0	1	1	P01009-1	83	84	+	1	P01009-1	0	355	P01009-2	0	355	+	17	P01009-1#24	0	1	P01009-2	83	84	+	1	0	0	718
P01009-1#24	0	1	1	P01009-1	83	84	+	1	P01009-1	0	418	P01009-1	0	418	+	16	P01009-1#24	0	1	P01009-1	83	84	+	1	0	0	719
P01009-1#25	0	1	1	P01009-1	90	91	+	1	P01009-1	0	306	P01009-3	0	306	+	18	P01009-1#25	0	1	P01009-3	90	91	+	1	0	0	720
P01009-1#25	0	1	1	P01009-1	90	91	+	1	P01009-1	0	355	P01009-2	0	355	+	17	P01009-1#25	0	1	P01009-2	90	91	+	1	0	0	721
P01009-1#25	0	1	1	P01009-1	90	91	+	1	P01009-1	0	418	P01009-1	0	418	+	16	P01009-1#25	0	1	P01009-1	90	91	+	1	0	0	722
P01009-1#26	0	1	1	P01009-1	91	92	+	1	P01009-1	0	306	P01009-3	0	306	+	18	P01009-1#26	0	1	P01009-3	91	92	+	1	0	0	723
P01009-1#26	0	1	1	P01009-1	91	92	+	1	P01009-1	0	355	P01009-2	0	355	+	17	P01009-1#26	0	1	P01009-2	91	92	+	1	0	0	724
P01009-1#26	0	1	1	P01009-1	91	92	+	1	P01009-1	0	418	P01009-1	0	418	+	16	P01009-1#26	0	1	P01009-1	91	92	+	1	0	0	725
P01009-1#27	0	1	1	P01009-1	108	109	+	1	P01009-1	0	306	P01009-3	0	306	+	18	P01009-1#27	0	1	P01009-3	108	109	+	1	0	0	726
P01009-1#27	0	1	1	P01009-1	108	109	+	1	P01009-1	0	355	P01009-2	0	355	+	17	P01009-1#27	0	1	P01009-2	108	109	+	1	0	0	727
P01009-1#27	0	1	1	P01009-1	108	109	+	1	P01009-1	0	418	P01009-1	0	418	+	16	P01009-1#27	0	1	P01009-1	108	109	+	1	0	0	728
P01009-1#28	0	1	1	P01009-1	111	112	+	1	P01009-1	0	306	P01009-3	0	306	+	18	P01009-1#28	0	1	P01009-3	111	112	+	1	0	0	729
P01009-1#28	0	1	1	P01009-1	111	112	+	1	P01009-1	0	355	P01009-2	0	355	+	17	P01009-1#28	0	1	P01009-2	111	112	+	1	0	0	730
P01009-1#28	0	1	1	P01009-1	111	112	+	1	P01009-1	0	418	P01009-1	0	418	+	16	P01009-1#28	0	1	P01009-1	111	112	+	1	0	0	731
P01009-1#29	0	1	1	P01009-1	115	116	+	1	P01009-1	0	306	P01009-3	0	306	+	18	P01009-1#29	0	1	P01009-3	115	116	+	1	0	0	732
P01009-1#29	0	1	1	P01009-1	115	116	+	1	P01009-1	0	355	P01009-2	0	355	+	17	P01009-1#29	0	1	P01009-2	115	116	+	1	0	0	733
P01009-1#29	0	1	1	P01009-1	115	116	+	1	P01009-1	0	418	P01009-1	0	418	+	16	P01009-1#29	0	1	P01009-1	115	116	+	1	0	0	734
P01009-1#30	0	1	1	P01009-1	124	125	+	1	P01009-1	0	306	P01009-3	0	306	+	18	P01009-1#30	0	1	P01009-3	124	125	+	1	0	0	735
P01009-1#30	0	1	1	P01009-1	124	125	+	1	P01009-1	0	355	P01009-2	0	355	+	17	P01009-1#30	0	1	P01009-2	124	125	+	1	0	0	736
P01009-1#30	0	1	1	P01009-1	124	125	+	1	P01009-1	0	418	P01009-1	0	418	+	16	P01009-1#30	0	1	P01009-1	124	125	+	1	0	0	737
P01009-1#31	0	1	1	P01009-1	138	139	+	1	P01009-1	0	306	P01009-3	0	306	+	18	P01009-1#31	0	1	P01009-3	138	139	+	1	0	0	738
P01009-1#31	0	1	1	P01009-1	138	139	+	1	P01009-1	0	355	P01009-2	0	355	+	17	P01009-1#31	0	1	P01009-2	138	139	+	1	0	0	739
P01009-1#31	0	1	1	P01009-1	138	139	+	1	P01009-1	0	418	P01009-1	0	418	+	16	P01009-1#31	0	1	P01009-1	138	139	+	1	0	0	740
P01009-1#32	0	1	1	P01009-1	171	172	+	1	P01009-1	0	306	P01009-3	0	306	+	18	P01009-1#32	0	1	P01009-3	171	172	+	1	0	0	741
P01009-1#32	0	1	1	P01009-1	171	172	+	1	P01009-1	0	355	P01009-2	0	355	+	17	P01009-1#32	0	1	P01009-2	171	172	+	1	0	0	742
P01009-1#32	0	1	1	P01009-1	171	172	+	1	P01009-1	0	418	P01009-1	0	418	+	16	P01009-1#32	0	1	P01009-1	171	172	+	1	0	0	743
P01009-1#33	0	1	1	P01009-1	171	172	+	1	P01009-1	0	306	P01009-3	0	306	+	18	P01009-1#33	0	1	P01009-3	171	172	+	1	0	0	744
P01009-1#33	0	1	1	P01009-1	171	172	+	1	P01009-1	0	355	P01009-2	0	355	+	17	P01009-1#33	0	1	P01009-2	171	172	+	1	0	0	745
P01009-1#33	0	1	1	P01009-1	171	172	+	1	P01009-1	0	418	P01009-1	0	418	+	16	P01009-1#33	0	1	P01009-1	171	172	+	1	0	0	746
P01009-1#34	0	1	1	P01009-1	179	180	+	1	P01009-1	0	306	P01009-3	0	306	+	18	P01009-1#34	0	1	P01009-3	179	180	+	1	0	0	747
P01009-1#34	0	1	1	P01009-1	179	180	+	1	P01009-1	0	355	P01009-2	0	355	+	17	P01009-1#34	0	1	P01009-2	179	180	+	1	0	0	748
P01009-1#34	0	1	1	P01009-1	179	180	+	1	P01009-1	0	418	P01009-1	0	418	+	16	P01009-1#34	0	1	P01009-1	179	180	+	1	0	0	749
P01009-1#35	0	9	9	P01009-1	189	198	+	9	P01009-1	0	306	P01009-3	0	306	+	18	P01009-1#35	0	9	P01009-3	189	198	+	9	0	0	750
P01009-1#35	0	9	9	P01009-1	189	198	+	9	P01009-1	0	355	P01009-2	0	355	+	17	P01009-1#35	0	9	P01009-2	189	198	+	9	0	0	751
P01009-1#35	0	9	9	P01009-1	189	198	+	9	P01009-1	0	418	P01009-1	0	418	+	16	P01009-1#35	0	9	P01009-1	189	198	+	9	0	0	752
P01009-1#36	0	1	1	P01009-1	227	228	+	1	P01009-1	0	306	P01009-3	0	306	+	18	P01009-1#36	0	1	P01009-3	227	228	+	1	0	0	753
P01009-1#36	0	1	1	P01009-1	227	228	+	1	P01009-1	0	355	P01009-2	0	355	+	17	P01009-1#36	0	1	P01009-2	227	228	+	1	0	0	754
P01009-1#36	0	1	1	P01009-1	227	228	+	1	P01009-1	0	418	P01009-1	0	418	+	16	P01009-1#36	0	1	P01009-1	227	228	+	1	0	0	755
P01009-1#37	0	1	1	P01009-1	236	237	+	1	P01009-1	0	306	P01009-3	0	306	+	18	P01009-1#37	0	1	P01009-3	236	237	+	1	0	0	756
P01009-1#37	0	1	1	P01009-1	236	237	+	1	P01009-1	0	355	P01009-2	0	355	+	17	P01009-1#37	0	1	P01009-2	236	237	+	1	0	0	757
P01009-1#37	0	1	1	P01009-1	236	237	+	1	P01009-1	0	418	P01009-1	0	418	+	16	P01009-1#37	0	1	P01009-1	236	237	+	1	0	0	758
P01009-1#38	0	1	1	P01009-1	246	247	+	1	P01009-1	0	306	P01009-3	0	306	+	18	P01009-1#38	0	1	P01009-3	246	247	+	1	0	0	759
P01009-1#38	0	1	1	P01009-1	246	247	+	1	P01009-1	0	355	P01009-2	0	355	+	17	P01009-1#38	0	1	P01009-2	246	247	+	1	0	0	760
P01009-1#38	0	1	1	P01009-1	246	247	+	1	P01009-1	0	418	P01009-1	0	418	+	16	P01009-1#38	0	1	P01009-1	246	247	+	1	0	0	761
P01009-1#39	0	1	1	P01009-1	279	280	+	1	P01009-1	0	306	P01009-3	0	306	+	18	P01009-1#39	0	1	P01009-3	279	280	+	1	0	0	762
P01009-1#39	0	1	1	P01009-1	279	280	+	1	P01009-1	0	355	P01009-2	0	355	+	17	P01009-1#39	0	1	P01009-2	279	280	+	1	0	0	763
P01009-1#39	0	1	1	P01009-1	279	280	+	1	P01009-1	0	418	P01009-1	0	418	+	16	P01009-1#39	0	1	P01009-1	279	280	+	1	0	0	764
P01009-1#40	0	1	1	P01009-1	287	288	+	1	P01009-1	0	306	P01009-3	0	306	+	18	P01009-1#40	0	1	P01009-3	287	288	+	1	0	0	765
P01009-1#40	0	1	1	P01009-1	287	288	+	1	P01009-1	0	355	P01009-2	0	355	+	17	P01009-1#40	0	1	P01009-2	287	288	+	1	0	0	766
P01009-1#40	0	1	1	P01009-1	287	288	+	1	P01009-1	0	418	P01009-1	0	418	+	16	P01009-1#40	0	1	P01009-1	287	288	+	1	0	0	767
P01009-1#41	0	1	1	P01009-1	304	305	+	1	P01009-1	0	306	P01009-3	0	306	+	18	P01009-1#41	0	1	P01009-3	304	305	+	1	0	0	768
P01009-1#41	0	1	1	P01009-1	304	305	+	1	P01009-1	0	355	P01009-2	0	355	+	17	P01009-1#41	0	1	P01009-2	304	305	+	1	0	0	769
P01009-1#41	0	1	1	P01009-1	304	305	+	1	P01009-1	0	418	P01009-1	0	418	+	16	P01009-1#41	0	1	P01009-1	304	305	+	1	0	0	770
P01009-1#42	0	1	1	P01009-1	353	354	+	1	P01009-1	0	355	P01009-2	0	355	+	17	P01009-1#42	0	1	P01009-2	353	354	+	1	0	0	771
P01009-1#42	0	1	1	P01009-1	353	354	+	1	P01009-1	0	418	P01009-1	0	418	+	16	P01009-1#42	0	1	P01009-1	353	354	+	1	0	0	772
P01009-1#43	0	1	1	P01009-1	359	360	+	1	P01009-1	0	418	P01009-1	0	418	+	16	P01009-1#43	0	1	P01009-1	359	360	+	1	0	0	773
P01009-1#44	0	1	1	P01009-1	364	365	+	1	P01009-1	0	418	P01009-1	0	418	+	16	P01009-1#44	0	1	P01009-1	364	365	+	1	0	0	774
P01009-1#45	0	1	1	P01009-1	365	366	+	1	P01009-1	0	418	P01009-1	0	418	+	16	P01009-1#45	0	1	P01009-1	365	366	+	1	0	0	775
P01009-1#46	0	1	1	P01009-1	381	382	+	1	P01009-1	0	418	P01009-1	0	418	+	16	P01009-1#46	0	1	P01009-1	381	382	+	1	0	0	776
P01009-1#47	0	1	1	P01009-1	385	386	+	1	P01009-1	0	418	P01009-1	0	418	+	16	P01009-1#47	0	1	P01009-1	385	386	+	1	0	0	777
P01009-1#48	0	1	1	P01009-1	385	386	+	1	P01009-1	0	418	P01009-1	0	418	+	16	P01009-1#48	0	1	P01009-1	385	386	+	1	0	0	778
P01009-1#49	0	1	1	P01009-1	386	387	+	1	P01009-1	0	418	P01009-1	0	418	+	16	P01009-1#49	0	1	P01009-1	386	387	+	1	0	0	779
P01009-1#50	0	1	1	P01009-1	392	393	+	1	P01009-1	0	418	P01009-1	0	418	+	16	P01009-1#50	0	1	P01009-1	392	393	+	1	0	0	780
P01009-1#51	0	1	1	P01009-1	399	400	+	1	P01009-1	0	418	P01009-1	0	418	+	16	P01009-1#51	0	1	P01009-1	399	400	+	1	0	0	781
P01009-1#52	0	1	1	P01009-1	414	415	+	1	P01009-1	0	418	P01009-1	0	418	+	16	P01009-1#52	0	1	P01009-1	414	415	+	1	0	0	782
P01009-1#53	0	1	1	P01009-1	381	382	+	1	P01009-1	0	418	P01009-1	0	418	+	16	P01009-1#53	0	1	P01009-1	381	382	+	1	0	0	783
P01009-1#54	0	1	1	P01009-1	11	12	+	1	P01009-1	0	306	P01009-3	0	306	+	18	P01009-1#54	0	1	P01009-3	11	12	+	1	0	0	784
P01009-1#54	0	1	1	P01009-1	11	12	+	1	P01009-1	0	355	P01009-2	0	355	+	17	P01009-1#54	0	1	P01009-2	11	12	+	1	0	0	785
P01009-1#54	0	1	1	P01009-1	11	12	+	1	P01009-1	0	418	P01009-1	0	418	+	16	P01009-1#54	0	1	P01009-1	11	12	+	1	0	0	786
P01009-1#55	0	1	1	P01009-1	22	23	+	1	P01009-1	0	306	P01009-3	0	306	+	18	P01009-1#55	0	1	P01009-3	22	23	+	1	0	0	787
P01009-1#55	0	1	1	P01009-1	22	23	+	1	P01009-1	0	355	P01009-2	0	355	+	17	P01009-1#55	0	1	P01009-2	22	23	+	1	0	0	788
P01009-1#55	0	1	1	P01009-1	22	23	+	1	P01009-1	0	418	P01009-1	0	418	+	16	P01009-1#55	0	1	P01009-1	22	23	+	1	0	0	789
P01009-1#56	0	1	1	P01009-1	25	26	+	1	P01009-1	0	306	P01009-3	0	306	+	18	P01009-1#56	0	1	P01009-3	25	26	+	1	0	0	790
P01009-1#56	0	1	1	P01009-1	25	26	+	1	P01009-1	0	355	P01009-2	0	355	+	17	P01009-1#56	0	1	P01009-2	25	26	+	1	0	0	791
P01009-1#56	0	1	1	P01009-1	25	26	+	1	P01009-1	0	418	P01009-1	0	418	+	16	P01009-1#56	0	1	P01009-1	25	26	+	1	0	0	792
P01009-1#57	0	1	1	P01009-1	38	39	+	1	P01009-1	0	306	P01009-3	0	306	+	18	P01009-1#57	0	1	P01009-3	38	39	+	1	0	0	793
P01009-1#57	0	1	1	P01009-1	38	39	+	1	P01009-1	0	355	P01009-2	0	355	+	17	P01009-1#57	0	1	P01009-2	38	39	+	1	0	0	794
P01009-1#57	0	1	1	P01009-1	38	39	+	1	P01009-1	0	418	P01009-1	0	418	+	16	P01009-1#57	0	1	P01009-1	38	39	+	1	0	0	795
P01009-1#58	0	1	1	P01009-1	60	61	+	1	P01009-1	0	306	P01009-3	0	306	+	18	P01009-1#58	0	1	P01009-3	60	61	+	1	0	0	796
P01009-1#58	0	1	1	P01009-1	60	61	+	1	P01009-1	0	355	P01009-2	0	355	+	17	P01009-1#58	0	1	P01009-2	60	61	+	1	0	0	797
P01009-1#58	0	1	1	P01009-1	60	61	+	1	P01009-1	0	418	P01009-1	0	418	+	16	P01009-1#58	0	1	P01009-1	60	61	+	1	0	0	798
P01009-1#59	0	1	1	P01009-1	95	96	+	1	P01009-1	0	306	P01009-3	0	306	+	18	P01009-1#59	0	1	P01009-3	95	96	+	1	0	0	799
P01009-1#59	0	1	1	P01009-1	95	96	+	1	P01009-1	0	355	P01009-2	0	355	+	17	P01009-1#59	0	1	P01009-2	95	96	+	1	0	0	800
P01009-1#59	0	1	1	P01009-1	95	96	+	1	P01009-1	0	418	P01009-1	0	418	+	16	P01009-1#59	0	1	P01009-1	95	96	+	1	0	0	801
P01009-1#60	0	2	2	P01009-1	138	140	+	2	P01009-1	0	306	P01009-3	0	306	+	18	P01009-1#60	0	2	P01009-3	138	140	+	2	0	0	802
P01009-1#60	0	2	2	P01009-1	138	140	+	2	P01009-1	0	355	P01009-2	0	355	+	17	P01009-1#60	0	2	P01009-2	138	140	+	2	0	0	803
P01009-1#60	0	2	2	P01009-1	138	140	+	2	P01009-1	0	418	P01009-1	0	418	+	16	P01009-1#60	0	2	P01009-1	138	140	+	2	0	0	804
P01009-1#61	0	1	1	P01009-1	173	174	+	1	P01009-1	0	306	P01009-3	0	306	+	18	P01009-1#61	0	1	P01009-3	173	174	+	1	0	0	805
P01009-1#61	0	1	1	P01009-1	173	174	+	1	P01009-1	0	355	P01009-2	0	355	+	17	P01009-1#61	0	1	P01009-2	173	174	+	1	0	0	806
P01009-1#61	0	1	1	P01009-1	173	174	+	1	P01009-1	0	418	P01009-1	0	418	+	16	P01009-1#61	0	1	P01009-1	173	174	+	1	0	0	807
P01009-1#62	0	1	1	P01009-1	228	229	+	1	P01009-1	0	306	P01009-3	0	306	+	18	P01009-1#62	0	1	P01009-3	228	229	+	1	0	0	808
P01009-1#62	0	1	1	P01009-1	228	229	+	1	P01009-1	0	355	P01009-2	0	355	+	17	P01009-1#62	0	1	P01009-2	228	229	+	1	0	0	809
P01009-1#62	0	1	1	P01009-1	228	229	+	1	P01009-1	0	418	P01009-1	0	418	+	16	P01009-1#62	0	1	P01009-1	228	229	+	1	0	0	810
P01009-1#63	0	1	1	P01009-1	272	273	+	1	P01009-1	0	306	P01009-3	0	306	+	18	P01009-1#63	0	1	P01009-3	272	273	+	1	0	0	811
P01009-1#63	0	1	1	P01009-1	272	273	+	1	P01009-1	0	355	P01009-2	0	355	+	17	P01009-1#63	0	1	P01009-2	272	273	+	1	0	0	812
P01009-1#63	0	1	1	P01009-1	272	273	+	1	P01009-1	0	418	P01009-1	0	418	+	16	P01009-1#63	0	1	P01009-1	272	273	+	1	0	0	813
P01009-1#64	0	1	1	P01009-1	279	280	+	1	P01009-1	0	306	P01009-3	0	306	+	18	P01009-1#64	0	1	P01009-3	279	280	+	1	0	0	814
P01009-1#64	0	1	1	P01009-1	279	280	+	1	P01009-1	0	355	P01009-2	0	355	+	17	P01009-1#64	0	1	P01009-2	279	280	+	1	0	0	815
P01009-1#64	0	1	1	P01009-1	279	280	+	1	P01009-1	0	418	P01009-1	0	418	+	16	P01009-1#64	0	1	P01009-1	279	280	+	1	0	0	816
P01009-1#65	0	1	1	P01009-1	325	326	+	1	P01009-1	0	355	P01009-2	0	355	+	17	P01009-1#65	0	1	P01009-2	325	326	+	1	0	0	817
P01009-1#65	0	1	1	P01009-1	325	326	+	1	P01009-1	0	418	P01009-1	0	418	+	16	P01009-1#65	0	1	P01009-1	325	326	+	1	0	0	818
P01009-1#66	0	1	1	P01009-1	409	410	+	1	P01009-1	0	418	P01009-1	0	418	+	16	P01009-1#66	0	1	P01009-1	409	410	+	1	0	0	819
P01009-1#67	0	1	1	P01009-1	413	414	+	1	P01009-1	0	418	P01009-1	0	418	+	16	P01009-1#67	0	1	P01009-1	413	414	+	1	0	0	820
P01009-1#68	0	3	3	P01009-1	47	50	+	3	P01009-1	0	306	P01009-3	0	306	+	18	P01009-1#68	0	3	P01009-3	47	50	+	3	0	0	821
P01009-1#68	0	3	3	P01009-1	47	50	+	3	P01009-1	0	355	P01009-2	0	355	+	17	P01009-1#68	0	3	P01009-2	47	50	+	3	0	0	822
P01009-1#68	0	3	3	P01009-1	47	50	+	3	P01009-1	0	418	P01009-1	0	418	+	16	P01009-1#68	0	3	P01009-1	47	50	+	3	0	0	823
P01009-1#69	0	18	18	P01009-1	50	68	+	18	P01009-1	0	306	P01009-3	0	306	+	18	P01009-1#69	0	18	P01009-3	50	68	+	18	0	0	824
P01009-1#69	0	18	18	P01009-1	50	68	+	18	P01009-1	0	355	P01009-2	0	355	+	17	P01009-1#69	0	18	P01009-2	50	68	+	18	0	0	825
P01009-1#69	0	18	18	P01009-1	50	68	+	18	P01009-1	0	418	P01009-1	0	418	+	16	P01009-1#69	0	18	P01009-1	50	68	+	18	0	0	826
P01009-1#70	0	3	3	P01009-1	69	72	+	3	P01009-1	0	306	P01009-3	0	306	+	18	P01009-1#70	0	3	P01009-3	69	72	+	3	0	0	827
P01009-1#70	0	3	3	P01009-1	69	72	+	3	P01009-1	0	355	P01009-2	0	355	+	17	P01009-1#70	0	3	P01009-2	69	72	+	3	0	0	828
P01009-1#70	0	3	3	P01009-1	69	72	+	3	P01009-1	0	418	P01009-1	0	418	+	16	P01009-1#70	0	3	P01009-1	69	72	+	3	0	0	829
P01009-1#71	0	3	3	P01009-1	73	76	+	3	P01009-1	0	306	P01009-3	0	306	+	18	P01009-1#71	0	3	P01009-3	73	76	+	3	0	0	830
P01009-1#71	0	3	3	P01009-1	73	76	+	3	P01009-1	0	355	P01009-2	0	355	+	17	P01009-1#71	0	3	P01009-2	73	76	+	3	0	0	831
P01009-1#71	0	3	3	P01009-1	73	76	+	3	P01009-1	0	418	P01009-1	0	418	+	16	P01009-1#71	0	3	P01009-1	73	76	+	3	0	0	832
P01009-1#72	0	12	12	P01009-1	77	89	+	12	P01009-1	0	306	P01009-3	0	306	+	18	P01009-1#72	0	12	P01009-3	77	89	+	12	0	0	833
P01009-1#72	0	12	12	P01009-1	77	89	+	12	P01009-1	0	355	P01009-2	0	355	+	17	P01009-1#72	0	12	P01009-2	77	89	+	12	0	0	834
P01009-1#72	0	12	12	P01009-1	77	89	+	12	P01009-1	0	418	P01009-1	0	418	+	16	P01009-1#72	0	12	P01009-1	77	89	+	12	0	0	835
P01009-1#73	0	10	10	P01009-1	93	103	+	10	P01009-1	0	306	P01009-3	0	306	+	18	P01009-1#73	0	10	P01009-3	93	103	+	10	0	0	836
P01009-1#73	0	10	10	P01009-1	93	103	+	10	P01009-1	0	355	P01009-2	0	355	+	17	P01009-1#73	0	10	P01009-2	93	103	+	10	0	0	837
P01009-1#73	0	10	10	P01009-1	93	103	+	10	P01009-1	0	418	P01009-1	0	418	+	16	P01009-1#73	0	10	P01009-1	93	103	+	10	0	0	838
P01009-1#74	0	3	3	P01009-1	107	110	+	3	P01009-1	0	306	P01009-3	0	306	+	18	P01009-1#74	0	3	P01009-3	107	110	+	3	0	0	839
P01009-1#74	0	3	3	P01009-1	107	110	+	3	P01009-1	0	355	P01009-2	0	355	+	17	P01009-1#74	0	3	P01009-2	107	110	+	3	0	0	840
P01009-1#74	0	3	3	P01009-1	107	110	+	3	P01009-1	0	418	P01009-1	0	418	+	16	P01009-1#74	0	3	P01009-1	107	110	+	3	0	0	841
P01009-1#75	0	15	15	P01009-1	112	127	+	15	P01009-1	0	306	P01009-3	0	306	+	18	P01009-1#75	0	15	P01009-3	112	127	+	15	0	0	842
P01009-1#75	0	15	15	P01009-1	112	127	+	15	P01009-1	0	355	P01009-2	0	355	+	17	P01009-1#75	0	15	P01009-2	112	127	+	15	0	0	843
P01009-1#75	0	15	15	P01009-1	112	127	+	15	P01009-1	0	418	P01009-1	0	418	+	16	P01009-1#75	0	15	P01009-1	112	127	+	15	0	0	844
P01009-1#76	0	4	4	P01009-1	129	133	+	4	P01009-1	0	306	P01009-3	0	306	+	18	P01009-1#76	0	4	P01009-3	129	133	+	4	0	0	845
P01009-1#76	0	4	4	P01009-1	129	133	+	4	P01009-1	0	355	P01009-2	0	355	+	17	P01009-1#76	0	4	P01009-2	129	133	+	4	0	0	846
P01009-1#76	0	4	4	P01009-1	129	133	+	4	P01009-1	0	418	P01009-1	0	418	+	16	P01009-1#76	0	4	P01009-1	129	133	+	4	0	0	847
P01009-1#77	0	11	11	P01009-1	134	145	+	11	P01009-1	0	306	P01009-3	0	306	+	18	P01009-1#77	0	11	P01009-3	134	145	+	11	0	0	848
P01009-1#77	0	11	11	P01009-1	134	145	+	11	P01009-1	0	355	P01009-2	0	355	+	17	P01009-1#77	0	11	P01009-2	134	145	+	11	0	0	849
P01009-1#77	0	11	11	P01009-1	134	145	+	11	P01009-1	0	418	P01009-1	0	418	+	16	P01009-1#77	0	11	P01009-1	134	145	+	11	0	0	850
P01009-1#78	0	3	3	P01009-1	145	148	+	3	P01009-1	0	306	P01009-3	0	306	+	18	P01009-1#78	0	3	P01009-3	145	148	+	3	0	0	851
P01009-1#78	0	3	3	P01009-1	145	148	+	3	P01009-1	0	355	P01009-2	0	355	+	17	P01009-1#78	0	3	P01009-2	145	148	+	3	0	0	852
P01009-1#78	0	3	3	P01009-1	145	148	+	3	P01009-1	0	418	P01009-1	0	418	+	16	P01009-1#78	0	3	P01009-1	145	148	+	3	0	0	853
P01009-1#79	0	11	11	P01009-1	151	162	+	11	P01009-1	0	306	P01009-3	0	306	+	18	P01009-1#79	0	11	P01009-3	151	162	+	11	0	0	854
P01009-1#79	0	11	11	P01009-1	151	162	+	11	P01009-1	0	355	P01009-2	0	355	+	17	P01009-1#79	0	11	P01009-2	151	162	+	11	0	0	855
P01009-1#79	0	11	11	P01009-1	151	162	+	11	P01009-1	0	418	P01009-1	0	418	+	16	P01009-1#79	0	11	P01009-1	151	162	+	11	0	0	856
P01009-1#80	0	6	6	P01009-1	163	169	+	6	P01009-1	0	306	P01009-3	0	306	+	18	P01009-1#80	0	6	P01009-3	163	169	+	6	0	0	857
P01009-1#80	0	6	6	P01009-1	163	169	+	6	P01009-1	0	355	P01009-2	0	355	+	17	P01009-1#80	0	6	P01009-2	163	169	+	6	0	0	858
P01009-1#80	0	6	6	P01009-1	163	169	+	6	P01009-1	0	418	P01009-1	0	418	+	16	P01009-1#80	0	6	P01009-1	163	169	+	6	0	0	859
P01009-1#81	0	3	3	P01009-1	170	173	+	3	P01009-1	0	306	P01009-3	0	306	+	18	P01009-1#81	0	3	P01009-3	170	173	+	3	0	0	860
P01009-1#81	0	3	3	P01009-1	170	173	+	3	P01009-1	0	355	P01009-2	0	355	+	17	P01009-1#81	0	3	P01009-2	170	173	+	3	0	0	861
P01009-1#81	0	3	3	P01009-1	170	173	+	3	P01009-1	0	418	P01009-1	0	418	+	16	P01009-1#81	0	3	P01009-1	170	173	+	3	0	0	862
P01009-1#82	0	15	15	P01009-1	173	188	+	15	P01009-1	0	306	P01009-3	0	306	+	18	P01009-1#82	0	15	P01009-3	173	188	+	15	0	0	863
P01009-1#82	0	15	15	P01009-1	173	188	+	15	P01009-1	0	355	P01009-2	0	355	+	17	P01009-1#82	0	15	P01009-2	173	188	+	15	0	0	864
P01009-1#82	0	15	15	P01009-1	173	188	+	15	P01009-1	0	418	P01009-1	0	418	+	16	P01009-1#82	0	15	P01009-1	173	188	+	15	0	0	865
P01009-1#83	0	3	3	P01009-1	188	191	+	3	P01009-1	0	306	P01009-3	0	306	+	18	P01009-1#83	0	3	P01009-3	188	191	+	3	0	0	866
P01009-1#83	0	3	3	P01009-1	188	191	+	3	P01009-1	0	355	P01009-2	0	355	+	17	P01009-1#83	0	3	P01009-2	188	191	+	3	0	0	867
P01009-1#83	0	3	3	P01009-1	188	191	+	3	P01009-1	0	418	P01009-1	0	418	+	16	P01009-1#83	0	3	P01009-1	188	191	+	3	0	0	868
P01009-1#84	0	15	15	P01009-1	205	220	+	15	P01009-1	0	306	P01009-3	0	306	+	18	P01009-1#84	0	15	P01009-3	205	220	+	15	0	0	869
P01009-1#84	0	15	15	P01009-1	205	220	+	15	P01009-1	0	355	P01009-2	0	355	+	17	P01009-1#84	0	15	P01009-2	205	220	+	15	0	0	870
P01009-1#84	0	15	15	P01009-1	205	220	+	15	P01009-1	0	418	P01009-1	0	418	+	16	P01009-1#84	0	15	P01009-1	205	220	+	15	0	0	871
P01009-1#85	0	3	3	P01009-1	223	226	+	3	P01009-1	0	306	P01009-3	0	306	+	18	P01009-1#85	0	3	P01009-3	223	226	+	3	0	0	872
P01009-1#85	0	3	3	P01009-1	223	226	+	3	P01009-1	0	355	P01009-2	0	355	+	17	P01009-1#85	0	3	P01009-2	223	226	+	3	0	0	873
P01009-1#85	0	3	3	P01009-1	223	226	+	3	P01009-1	0	418	P01009-1	0	418	+	16	P01009-1#85	0	3	P01009-1	223	226	+	3	0	0	874
P01009-1#86	0	8	8	P01009-1	227	235	+	8	P01009-1	0	306	P01009-3	0	306	+	18	P01009-1#86	0	8	P01009-3	227	235	+	8	0	0	875
P01009-1#86	0	8	8	P01009-1	227	235	+	8	P01009-1	0	355	P01009-2	0	355	+	17	P01009-1#86	0	8	P01009-2	227	235	+	8	0	0	876
P01009-1#86	0	8	8	P01009-1	227	235	+	8	P01009-1	0	418	P01009-1	0	418	+	16	P01009-1#86	0	8	P01009-1	227	235	+	8	0	0	877
P01009-1#87	0	19	19	P01009-1	237	256	+	19	P01009-1	0	306	P01009-3	0	306	+	18	P01009-1#87	0	19	P01009-3	237	256	+	19	0	0	878
P01009-1#87	0	19	19	P01009-1	237	256	+	19	P01009-1	0	355	P01009-2	0	355	+	17	P01009-1#87	0	19	P01009-2	237	256	+	19	0	0	879
P01009-1#87	0	19	19	P01009-1	237	256	+	19	P01009-1	0	418	P01009-1	0	418	+	16	P01009-1#87	0	19	P01009-1	237	256	+	19	0	0	880
P01009-1#88	0	4	4	P01009-1	256	260	+	4	P01009-1	0	306	P01009-3	0	306	+	18	P01009-1#88	0	4	P01009-3	256	260	+	4	0	0	881
P01009-1#88	0	4	4	P01009-1	256	260	+	4	P01009-1	0	355	P01009-2	0	355	+	17	P01009-1#88	0	4	P01009-2	256	260	+	4	0	0	882
P01009-1#88	0	4	4	P01009-1	256	260	+	4	P01009-1	0	418	P01009-1	0	418	+	16	P01009-1#88	0	4	P01009-1	256	260	+	4	0	0	883
P01009-1#89	0	19	19	P01009-1	260	279	+	19	P01009-1	0	306	P01009-3	0	306	+	18	P01009-1#89	0	19	P01009-3	260	279	+	19	0	0	884
P01009-1#89	0	19	19	P01009-1	260	279	+	19	P01009-1	0	355	P01009-2	0	355	+	17	P01009-1#89	0	19	P01009-2	260	279	+	19	0	0	885
P01009-1#89	0	19	19	P01009-1	260	279	+	19	P01009-1	0	418	P01009-1	0	418	+	16	P01009-1#89	0	19	P01009-1	260	279	+	19	0	0	886
P01009-1#90	0	3	3	P01009-1	279	282	+	3	P01009-1	0	306	P01009-3	0	306	+	18	P01009-1#90	0	3	P01009-3	279	282	+	3	0	0	887
P01009-1#90	0	3	3	P01009-1	279	282	+	3	P01009-1	0	355	P01009-2	0	355	+	17	P01009-1#90	0	3	P01009-2	279	282	+	3	0	0	888
P01009-1#90	0	3	3	P01009-1	279	282	+	3	P01009-1	0	418	P01009-1	0	418	+	16	P01009-1#90	0	3	P01009-1	279	282	+	3	0	0	889
P01009-1#91	0	7	7	P01009-1	283	290	+	7	P01009-1	0	306	P01009-3	0	306	+	18	P01009-1#91	0	7	P01009-3	283	290	+	7	0	0	890
P01009-1#91	0	7	7	P01009-1	283	290	+	7	P01009-1	0	355	P01009-2	0	355	+	17	P01009-1#91	0	7	P01009-2	283	290	+	7	0	0	891
P01009-1#91	0	7	7	P01009-1	283	290	+	7	P01009-1	0	418	P01009-1	0	418	+	16	P01009-1#91	0	7	P01009-1	283	290	+	7	0	0	892
P01009-1#92	0	9	9	P01009-1	292	301	+	9	P01009-1	0	306	P01009-3	0	306	+	18	P01009-1#92	0	9	P01009-3	292	301	+	9	0	0	893
P01009-1#92	0	9	9	P01009-1	292	301	+	9	P01009-1	0	355	P01009-2	0	355	+	17	P01009-1#92	0	9	P01009-2	292	301	+	9	0	0	894
P01009-1#92	0	9	9	P01009-1	292	301	+	9	P01009-1	0	418	P01009-1	0	418	+	16	P01009-1#92	0	9	P01009-1	292	301	+	9	0	0	895
P01009-1#93	0	8	8	P01009-1	305	313	+	8	P01009-1	0	306	P01009-3	0	306	+	18	P01009-1#93	0	1	P01009-3	305	306	+	1	0	7	896
P01009-1#93	0	8	8	P01009-1	305	313	+	8	P01009-1	0	355	P01009-2	0	355	+	17	P01009-1#93	0	8	P01009-2	305	313	+	8	0	0	897
P01009-1#93	0	8	8	P01009-1	305	313	+	8	P01009-1	0	418	P01009-1	0	418	+	16	P01009-1#93	0	8	P01009-1	305	313	+	8	0	0	898
P01009-1#94	0	8	8	P01009-1	314	322	+	8	P01009-1	0	355	P01009-2	0	355	+	17	P01009-1#94	0	8	P01009-2	314	322	+	8	0	0	899
P01009-1#94	0	8	8	P01009-1	314	322	+	8	P01009-1	0	418	P01009-1	0	418	+	16	P01009-1#94	0	8	P01009-1	314	322	+	8	0	0	900
P01009-1#95	0	6	6	P01009-1	323	329	+	6	P01009-1	0	355	P01009-2	0	355	+	17	P01009-1#95	0	6	P01009-2	323	329	+	6	0	0	901
P01009-1#95	0	6	6	P01009-1	323	329	+	6	P01009-1	0	418	P01009-1	0	418	+	16	P01009-1#95	0	6	P01009-1	323	329	+	6	0	0	902
P01009-1#96	0	3	3	P01009-1	333	336	+	3	P01009-1	0	355	P01009-2	0	355	+	17	P01009-1#96	0	3	P01009-2	333	336	+	3	0	0	903
P01009-1#96	0	3	3	P01009-1	333	336	+	3	P01009-1	0	418	P01009-1	0	418	+	16	P01009-1#96	0	3	P01009-1	333	336	+	3	0	0	904
P01009-1#97	0	3	3	P01009-1	336	339	+	3	P01009-1	0	355	P01009-2	0	355	+	17	P01009-1#97	0	3	P01009-2	336	339	+	3	0	0	905
P01009-1#97	0	3	3	P01009-1	336	339	+	3	P01009-1	0	418	P01009-1	0	418	+	16	P01009-1#97	0	3	P01009-1	336	339	+	3	0	0	906
P01009-1#98	0	3	3	P01009-1	342	345	+	3	P01009-1	0	355	P01009-2	0	355	+	17	P01009-1#98	0	3	P01009-2	342	345	+	3	0	0	907
P01009-1#98	0	3	3	P01009-1	342	345	+	3	P01009-1	0	418	P01009-1	0	418	+	16	P01009-1#98	0	3	P01009-1	342	345	+	3	0	0	908
P01009-1#99	0	3	3	P01009-1	346	349	+	3	P01009-1	0	355	P01009-2	0	355	+	17	P01009-1#99	0	3	P01009-2	346	349	+	3	0	0	909
P01009-1#99	0	3	3	P01009-1	346	349	+	3	P01009-1	0	418	P01009-1	0	418	+	16	P01009-1#99	0	3	P01009-1	346	349	+	3	0	0	910
P01009-1#100	0	14	14	P01009-1	350	364	+	14	P01009-1	0	355	P01009-2	0	355	+	17	P01009-1#100	0	5	P01009-2	350	355	+	5	0	9	911
P01009-1#100	0	14	14	P01009-1	350	364	+	14	P01009-1	0	418	P01009-1	0	418	+	16	P01009-1#100	0	14	P01009-1	350	364	+	14	0	0	912
P01009-1#101	0	16	16	P01009-1	365	381	+	16	P01009-1	0	418	P01009-1	0	418	+	16	P01009-1#101	0	16	P01009-1	365	381	+	16	0	0	913
P01009-1#102	0	3	3	P01009-1	386	389	+	3	P01009-1	0	418	P01009-1	0	418	+	16	P01009-1#102	0	3	P01009-1	386	389	+	3	0	0	914
P01009-1#103	0	7	7	P01009-1	393	400	+	7	P01009-1	0	418	P01009-1	0	418	+	16	P01009-1#103	0	7	P01009-1	393	400	+	7	0	0	915
P01009-1#104	0	3	3	P01009-1	400	403	+	3	P01009-1	0	418	P01009-1	0	418	+	16	P01009-1#104	0	3	P01009-1	400	403	+	3	0	0	916
P01009-1#105	0	9	9	P01009-1	405	414	+	9	P01009-1	0	418	P01009-1	0	418	+	16	P01009-1#105	0	9	P01009-1	405	414	+	9	0	0	917
P29274#0	0	412	412	P29274	0	412	+	412	P29274	0	412	P29274	0	412	+	27	P29274#0	0	412	P29274	0	412	+	412	0	0	918
P29274#1	0	7	7	P29274	0	7	+	7	P29274	0	412	P29274	0	412	+	27	P29274#1	0	7	P29274	0	7	+	7	0	0	919
P29274#2	0	25	25	P29274	7	32	+	25	P29274	0	412	P29274	0	412	+	27	P29274#2	0	25	P29274	7	32	+	25	0	0	920
P29274#3	0	10	10	P29274	32	42	+	10	P29274	0	412	P29274	0	412	+	27	P29274#3	0	10	P29274	32	42	+	10	0	0	921
P29274#4	0	24	24	P29274	42	66	+	24	P29274	0	412	P29274	0	412	+	27	P29274#4	0	24	P29274	42	66	+	24	0	0	922
P29274#5	0	11	11	P29274	66	77	+	11	P29274	0	412	P29274	0	412	+	27	P29274#5	0	11	P29274	66	77	+	11	0	0	923
P29274#6	0	23	23	P29274	77	100	+	23	P29274	0	412	P29274	0	412	+	27	P29274#6	0	23	P29274	77	100	+	23	0	0	924
P29274#7	0	20	20	P29274	100	120	+	20	P29274	0	412	P29274	0	412	+	27	P29274#7	0	20	P29274	100	120	+	20	0	0	925
P29274#8	0	23	23	P29274	120	143	+	23	P29274	0	412	P29274	0	412	+	27	P29274#8	0	23	P29274	120	143	+	23	0	0	926
P29274#9	0	30	30	P29274	143	173	+	30	P29274	0	412	P29274	0	412	+	27	P29274#9	0	30	P29274	143	173	+	30	0	0	927
P29274#10	0	25	25	P29274	173	198	+	25	P29274	0	412	P29274	0	412	+	27	P29274#10	0	25	P29274	173	198	+	25	0	0	928
P29274#11	0	36	36	P29274	198	234	+	36	P29274	0	412	P29274	0	412	+	27	P29274#11	0	36	P29274	198	234	+	36	0	0	929
P29274#12	0	24	24	P29274	234	258	+	24	P29274	0	412	P29274	0	412	+	27	P29274#12	0	24	P29274	234	258	+	24	0	0	930
P29274#13	0	8	8	P29274	258	266	+	8	P29274	0	412	P29274	0	412	+	27	P29274#13	0	8	P29274	258	266	+	8	0	0	931
P29274#14	0	24	24	P29274	266	290	+	24	P29274	0	412	P29274	0	412	+	27	P29274#14	0	24	P29274	266	290	+	24	0	0	932
P29274#15	0	122	122	P29274	290	412	+	122	P29274	0	412	P29274	0	412	+	27	P29274#15	0	122	P29274	290	412	+	122	0	0	933
P29274#16	0	22	22	P29274	390	412	+	22	P29274	0	412	P29274	0	412	+	27	P29274#16	0	22	P29274	390	412	+	22	0	0	934
P29274#17	0	1	1	P29274	168	169	+	1	P29274	0	412	P29274	0	412	+	27	P29274#17	0	1	P29274	168	169	+	1	0	0	935
P29274#18	0	1	1	P29274	252	253	+	1	P29274	0	412	P29274	0	412	+	27	P29274#18	0	1	P29274	252	253	+	1	0	0	936
P29274#19	0	1	1	P29274	276	277	+	1	P29274	0	412	P29274	0	412	+	27	P29274#19	0	1	P29274	276	277	+	1	0	0	937
P29274#20	0	1	1	P29274	277	278	+	1	P29274	0	412	P29274	0	412	+	27	P29274#20	0	1	P29274	277	278	+	1	0	0	938
P29274#21	0	1	1	P29274	153	154	+	1	P29274	0	412	P29274	0	412	+	27	P29274#21	0	1	P29274	153	154	+	1	0	0	939
P29274#22	0	89	89	P29274	70	159	+	89	P29274	0	412	P29274	0	412	+	27	P29274#22	0	89	P29274	70	159	+	89	0	0	940
P29274#23	0	73	73	P29274	73	146	+	73	P29274	0	412	P29274	0	412	+	27	P29274#23	0	73	P29274	73	146	+	73	0	0	941
P29274#24	0	90	90	P29274	76	166	+	90	P29274	0	412	P29274	0	412	+	27	P29274#24	0	90	P29274	76	166	+	90	0	0	942
P29274#25	0	4	4	P29274	258	262	+	4	P29274	0	412	P29274	0	412	+	27	P29274#25	0	4	P29274	258	262	+	4	0	0	943
P29274#26	0	1	1	P29274	49	50	+	1	P29274	0	412	P29274	0	412	+	27	P29274#26	0	1	P29274	49	50	+	1	0	0	944
P29274#27	0	1	1	P29274	299	300	+	1	P29274	0	412	P29274	0	412	+	27	P29274#27	0	1	P29274	299	300	+	1	0	0	945
P29274#28	0	1	1	P29274	391	392	+	1	P29274	0	412	P29274	0	412	+	27	P29274#28	0	1	P29274	391	392	+	1	0	0	946
P29274#29	0	32	32	P29274	1	33	+	32	P29274	0	412	P29274	0	412	+	27	P29274#29	0	32	P29274	1	33	+	32	0	0	947
P29274#30	0	3	3	P29274	34	37	+	3	P29274	0	412	P29274	0	412	+	27	P29274#30	0	3	P29274	34	37	+	3	0	0	948
P29274#31	0	18	18	P29274	39	57	+	18	P29274	0	412	P29274	0	412	+	27	P29274#31	0	18	P29274	39	57	+	18	0	0	949
P29274#32	0	9	9	P29274	58	67	+	9	P29274	0	412	P29274	0	412	+	27	P29274#32	0	9	P29274	58	67	+	9	0	0	950
P29274#33	0	3	3	P29274	70	73	+	3	P29274	0	412	P29274	0	412	+	27	P29274#33	0	3	P29274	70	73	+	3	0	0	951
P29274#34	0	34	34	P29274	73	107	+	34	P29274	0	412	P29274	0	412	+	27	P29274#34	0	34	P29274	73	107	+	34	0	0	952
P29274#35	0	7	7	P29274	108	115	+	7	P29274	0	412	P29274	0	412	+	27	P29274#35	0	7	P29274	108	115	+	7	0	0	953
P29274#36	0	19	19	P29274	117	136	+	19	P29274	0	412	P29274	0	412	+	27	P29274#36	0	19	P29274	117	136	+	19	0	0	954
P29274#37	0	4	4	P29274	137	141	+	4	P29274	0	412	P29274	0	412	+	27	P29274#37	0	4	P29274	137	141	+	4	0	0	955
P29274#38	0	5	5	P29274	143	148	+	5	P29274	0	412	P29274	0	412	+	27	P29274#38	0	5	P29274	143	148	+	5	0	0	956
P29274#39	0	7	7	P29274	150	157	+	7	P29274	0	412	P29274	0	412	+	27	P29274#39	0	7	P29274	150	157	+	7	0	0	957
P29274#40	0	3	3	P29274	162	165	+	3	P29274	0	412	P29274	0	412	+	27	P29274#40	0	3	P29274	162	165	+	3	0	0	958
P29274#41	0	4	4	P29274	167	171	+	4	P29274	0	412	P29274	0	412	+	27	P29274#41	0	4	P29274	167	171	+	4	0	0	959
P29274#42	0	6	6	P29274	173	179	+	6	P29274	0	412	P29274	0	412	+	27	P29274#42	0	6	P29274	173	179	+	6	0	0	960
P29274#43	0	4	4	P29274	181	185	+	4	P29274	0	412	P29274	0	412	+	27	P29274#43	0	4	P29274	181	185	+	4	0	0	961
P29274#44	0	22	22	P29274	186	208	+	22	P29274	0	412	P29274	0	412	+	27	P29274#44	0	22	P29274	186	208	+	22	0	0	962
P29274#45	0	4	4	P29274	212	216	+	4	P29274	0	412	P29274	0	412	+	27	P29274#45	0	4	P29274	212	216	+	4	0	0	963
P29274#46	0	40	40	P29274	218	258	+	40	P29274	0	412	P29274	0	412	+	27	P29274#46	0	40	P29274	218	258	+	40	0	0	964
P29274#47	0	3	3	P29274	259	262	+	3	P29274	0	412	P29274	0	412	+	27	P29274#47	0	3	P29274	259	262	+	3	0	0	965
P29274#48	0	25	25	P29274	266	291	+	25	P29274	0	412	P29274	0	412	+	27	P29274#48	0	25	P29274	266	291	+	25	0	0	966
P29274#49	0	11	11	P29274	292	303	+	11	P29274	0	412	P29274	0	412	+	27	P29274#49	0	11	P29274	292	303	+	11	0	0	967
P29274#50	0	4	4	P29274	303	307	+	4	P29274	0	412	P29274	0	412	+	27	P29274#50	0	4	P29274	303	307	+	4	0	0	968
P29274#51	0	3	3	P29274	307	310	+	3	P29274	0	412	P29274	0	412	+	27	P29274#51	0	3	P29274	307	310	+	3	0	0	969
P29274#52	0	6	6	P29274	311	317	+	6	P29274	0	412	P29274	0	412	+	27	P29274#52	0	6	P29274	311	317	+	6	0	0	970
P51809-1#0	0	1	1	P51809-1	0	1	+	1	P51809-1	0	220	P51809-3	0	179	+	43	P51809-1#0	0	1	P51809-3	0	1	+	1	0	0	971
P51809-1#0	0	1	1	P51809-1	0	1	+	1	P51809-1	0	144	P51809-2	0	144	+	42	P51809-1#0	0	1	P51809-2	0	1	+	1	0	0	972
P51809-1#0	0	1	1	P51809-1	0	1	+	1	P51809-1	0	220	P51809-1	0	220	+	41	P51809-1#0	0	1	P51809-1	0	1	+	1	0	0	973
P51809-1#1	0	219	219	P51809-1	1	220	+	219	P51809-1	0	220	P51809-3	0	179	+	43	P51809-1#1	0	219	P51809-3	1	179	+	178	0	0	974
P51809-1#1	0	219	219	P51809-1	1	220	+	219	P51809-1	0	144	P51809-2	0	144	+	42	P51809-1#1	0	143	P51809-2	1	144	+	143	0	76	975
P51809-1#1	0	219	219	P51809-1	1	220	+	219	P51809-1	0	220	P51809-1	0	220	+	41	P51809-1#1	0	219	P51809-1	1	220	+	219	0	0	976
P51809-1#2	0	187	187	P51809-1	1	188	+	187	P51809-1	0	220	P51809-3	0	179	+	43	P51809-1#2	0	187	P51809-3	1	147	+	146	0	0	977
P51809-1#2	0	187	187	P51809-1	1	188	+	187	P51809-1	0	144	P51809-2	0	144	+	42	P51809-1#2	0	143	P51809-2	1	144	+	143	0	44	978
P51809-1#2	0	187	187	P51809-1	1	188	+	187	P51809-1	0	220	P51809-1	0	220	+	41	P51809-1#2	0	187	P51809-1	1	188	+	187	0	0	979
P51809-1#3	0	21	21	P51809-1	188	209	+	21	P51809-1	0	220	P51809-3	0	179	+	43	P51809-1#3	0	21	P51809-3	147	168	+	21	0	0	980
P51809-1#3	0	21	21	P51809-1	188	209	+	21	P51809-1	0	220	P51809-1	0	220	+	41	P51809-1#3	0	21	P51809-1	188	209	+	21	0	0	981
P51809-1#4	0	11	11	P51809-1	209	220	+	11	P51809-1	0	220	P51809-3	0	179	+	43	P51809-1#4	0	11	P51809-3	168	179	+	11	0	0	982
P51809-1#4	0	11	11	P51809-1	209	220	+	11	P51809-1	0	220	P51809-1	0	220	+	41	P51809-1#4	0	11	P51809-1	209	220	+	11	0	0	983
P51809-1#5	0	104	104	P51809-1	6	110	+	104	P51809-1	0	220	P51809-3	0	179	+	43	P51809-1#5	0	104	P51809-3	6	69	+	63	0	0	984
P51809-1#5	0	104	104	P51809-1	6	110	+	104	P51809-1	0	144	P51809-2	0	144	+	42	P51809-1#5	0	104	P51809-2	6	110	+	104	0	0	985
P51809-1#5	0	104	104	P51809-1	6	110	+	104	P51809-1	0	220	P51809-1	0	220	+	41	P51809-1#5	0	104	P51809-1	6	110	+	104	0	0	986
P51809-1#6	0	61	61	P51809-1	124	185	+	61	P51809-1	0	220	P51809-3	0	179	+	43	P51809-1#6	0	61	P51809-3	83	144	+	61	0	0	987
P51809-1#6	0	61	61	P51809-1	124	185	+	61	P51809-1	0	144	P51809-2	0	144	+	42	P51809-1#6	0	20	P51809-2	124	144	+	20	0	41	988
P51809-1#6	0	61	61	P51809-1	124	185	+	61	P51809-1	0	220	P51809-1	0	220	+	41	P51809-1#6	0	61	P51809-1	124	185	+	61	0	0	989
P51809-1#7	0	1	1	P51809-1	1	2	+	1	P51809-1	0	220	P51809-3	0	179	+	43	P51809-1#7	0	1	P51809-3	1	2	+	1	0	0	990
P51809-1#7	0	1	1	P51809-1	1	2	+	1	P51809-1	0	144	P51809-2	0	144	+	42	P51809-1#7	0	1	P51809-2	1	2	+	1	0	0	991
P51809-1#7	0	1	1	P51809-1	1	2	+	1	P51809-1	0	220	P51809-1	0	220	+	41	P51809-1#7	0	1	P51809-1	1	2	+	1	0	0	992
P51809-1#8	0	1	1	P51809-1	166	167	+	1	P51809-1	0	220	P51809-3	0	179	+	43	P51809-1#8	0	1	P51809-3	125	126	+	1	0	0	993
P51809-1#8	0	1	1	P51809-1	166	167	+	1	P51809-1	0	220	P51809-1	0	220	+	41	P51809-1#8	0	1	P51809-1	166	167	+	1	0	0	994
P51809-1#9	0	1	1	P51809-1	167	168	+	1	P51809-1	0	220	P51809-3	0	179	+	43	P51809-1#9	0	1	P51809-3	126	127	+	1	0	0	995
P51809-1#9	0	1	1	P51809-1	167	168	+	1	P51809-1	0	220	P51809-1	0	220	+	41	P51809-1#9	0	1	P51809-1	167	168	+	1	0	0	996
P51809-1#10	0	41	41	P51809-1	27	68	+	41	P51809-1	0	144	P51809-2	0	144	+	42	P51809-1#10	0	41	P51809-2	27	68	+	41	0	0	997
P51809-1#10	0	41	41	P51809-1	27	68	+	41	P51809-1	0	220	P51809-1	0	220	+	41	P51809-1#10	0	41	P51809-1	27	68	+	41	0	0	998
P51809-1#11	0	76	76	P51809-1	144	220	+	76	P51809-1	0	220	P51809-3	0	179	+	43	P51809-1#11	0	76	P51809-3	103	179	+	76	0	0	999
P51809-1#11	0	76	76	P51809-1	144	220	+	76	P51809-1	0	220	P51809-1	0	220	+	41	P51809-1#11	0	76	P51809-1	144	220	+	76	0	0	1000
P51809-1#12	0	1	1	P51809-1	97	98	+	1	P51809-1	0	220	P51809-3	0	179	+	43	P51809-1#12	0	1	P51809-3	56	57	+	1	0	0	1001
P51809-1#12	0	1	1	P51809-1	97	98	+	1	P51809-1	0	144	P51809-2	0	144	+	42	P51809-1#12	0	1	P51809-2	97	98	+	1	0	0	1002
P51809-1#12	0	1	1	P51809-1	97	98	+	1	P51809-1	0	220	P51809-1	0	220	+	41	P51809-1#12	0	1	P51809-1	97	98	+	1	0	0	1003
P51809-1#13	0	6	6	P51809-1	4	10	+	6	P51809-1	0	220	P51809-3	0	179	+	43	P51809-1#13	0	6	P51809-3	4	10	+	6	0	0	1004
P51809-1#13	0	6	6	P51809-1	4	10	+	6	P51809-1	0	144	P51809-2	0	144	+	42	P51809-1#13	0	6	P51809-2	4	10	+	6	0	0	1005
P51809-1#13	0	6	6	P51809-1	4	10	+	6	P51809-1	0	220	P51809-1	0	220	+	41	P51809-1#13	0	6	P51809-1	4	10	+	6	0	0	1006
P51809-1#14	0	7	7	P51809-1	12	19	+	7	P51809-1	0	220	P51809-3	0	179	+	43	P51809-1#14	0	7	P51809-3	12	19	+	7	0	0	1007
P51809-1#14	0	7	7	P51809-1	12	19	+	7	P51809-1	0	144	P51809-2	0	144	+	42	P51809-1#14	0	7	P51809-2	12	19	+	7	0	0	1008
P51809-1#14	0	7	7	P51809-1	12	19	+	7	P51809-1	0	220	P51809-1	0	220	+	41	P51809-1#14	0	7	P51809-1	12	19	+	7	0	0	1009
P51809-1#15	0	3	3	P51809-1	20	23	+	3	P51809-1	0	220	P51809-3	0	179	+	43	P51809-1#15	0	3	P51809-3	20	23	+	3	0	0	1010
P51809-1#15	0	3	3	P51809-1	20	23	+	3	P51809-1	0	144	P51809-2	0	144	+	42	P51809-1#15	0	3	P51809-2	20	23	+	3	0	0	1011
P51809-1#15	0	3	3	P51809-1	20	23	+	3	P51809-1	0	220	P51809-1	0	220	+	41	P51809-1#15	0	3	P51809-1	20	23	+	3	0	0	1012
P51809-1#16	0	8	8	P51809-1	25	33	+	8	P51809-1	0	220	P51809-3	0	179	+	43	P51809-1#16	0	2	P51809-3	25	27	+	2	0	6	1013
P51809-1#16	0	8	8	P51809-1	25	33	+	8	P51809-1	0	144	P51809-2	0	144	+	42	P51809-1#16	0	8	P51809-2	25	33	+	8	0	0	1014
P51809-1#16	0	8	8	P51809-1	25	33	+	8	P51809-1	0	220	P51809-1	0	220	+	41	P51809-1#16	0	8	P51809-1	25	33	+	8	0	0	1015
P51809-1#17	0	3	3	P51809-1	37	40	+	3	P51809-1	0	144	P51809-2	0	144	+	42	P51809-1#17	0	3	P51809-2	37	40	+	3	0	0	1016
P51809-1#17	0	3	3	P51809-1	37	40	+	3	P51809-1	0	220	P51809-1	0	220	+	41	P51809-1#17	0	3	P51809-1	37	40	+	3	0	0	1017
P51809-1#18	0	6	6	P51809-1	41	47	+	6	P51809-1	0	144	P51809-2	0	144	+	42	P51809-1#18	0	6	P51809-2	41	47	+	6	0	0	1018
P51809-1#18	0	6	6	P51809-1	41	47	+	6	P51809-1	0	220	P51809-1	0	220	+	41	P51809-1#18	0	6	P51809-1	41	47	+	6	0	0	1019
P51809-1#19	0	8	8	P51809-1	49	57	+	8	P51809-1	0	144	P51809-2	0	144	+	42	P51809-1#19	0	8	P51809-2	49	57	+	8	0	0	1020
P51809-1#19	0	8	8	P51809-1	49	57	+	8	P51809-1	0	220	P51809-1	0	220	+	41	P51809-1#19	0	8	P51809-1	49	57	+	8	0	0	1021
P51809-1#20	0	11	11	P51809-1	59	70	+	11	P51809-1	0	220	P51809-3	0	179	+	43	P51809-1#20	9	11	P51809-3	27	29	+	2	9	0	1022
P51809-1#20	0	11	11	P51809-1	59	70	+	11	P51809-1	0	144	P51809-2	0	144	+	42	P51809-1#20	0	11	P51809-2	59	70	+	11	0	0	1023
P51809-1#20	0	11	11	P51809-1	59	70	+	11	P51809-1	0	220	P51809-1	0	220	+	41	P51809-1#20	0	11	P51809-1	59	70	+	11	0	0	1024
P51809-1#21	0	18	18	P51809-1	71	89	+	18	P51809-1	0	220	P51809-3	0	179	+	43	P51809-1#21	0	18	P51809-3	30	48	+	18	0	0	1025
P51809-1#21	0	18	18	P51809-1	71	89	+	18	P51809-1	0	144	P51809-2	0	144	+	42	P51809-1#21	0	18	P51809-2	71	89	+	18	0	0	1026
P51809-1#21	0	18	18	P51809-1	71	89	+	18	P51809-1	0	220	P51809-1	0	220	+	41	P51809-1#21	0	18	P51809-1	71	89	+	18	0	0	1027
P51809-1#22	0	5	5	P51809-1	90	95	+	5	P51809-1	0	220	P51809-3	0	179	+	43	P51809-1#22	0	5	P51809-3	49	54	+	5	0	0	1028
P51809-1#22	0	5	5	P51809-1	90	95	+	5	P51809-1	0	144	P51809-2	0	144	+	42	P51809-1#22	0	5	P51809-2	90	95	+	5	0	0	1029
P51809-1#22	0	5	5	P51809-1	90	95	+	5	P51809-1	0	220	P51809-1	0	220	+	41	P51809-1#22	0	5	P51809-1	90	95	+	5	0	0	1030
P51809-1#23	0	15	15	P51809-1	102	117	+	15	P51809-1	0	220	P51809-3	0	179	+	43	P51809-1#23	0	15	P51809-3	61	76	+	15	0	0	1031
P51809-1#23	0	15	15	P51809-1	102	117	+	15	P51809-1	0	144	P51809-2	0	144	+	42	P51809-1#23	0	15	P51809-2	102	117	+	15	0	0	1032
P51809-1#23	0	15	15	P51809-1	102	117	+	15	P51809-1	0	220	P51809-1	0	220	+	41	P51809-1#23	0	15	P51809-1	102	117	+	15	0	0	1033
Q6PD74-1#0	0	315	315	Q6PD74-1	0	315	+	315	Q6PD74-1	109	315	Q6PD74-2	0	206	+	45	Q6PD74-1#0	109	315	Q6PD74-2	0	206	+	206	109	0	1034
Q6PD74-1#0	0	315	315	Q6PD74-1	0	315	+	315	Q6PD74-1	0	315	Q6PD74-1	0	315	+	44	Q6PD74-1#0	0	315	Q6PD74-1	0	315	+	315	0	0	1035
Q6PD74-1#1	0	38	38	Q6PD74-1	196	234	+	38	Q6PD74-1	109	315	Q6PD74-2	0	206	+	45	Q6PD74-1#1	0	38	Q6PD74-2	87	125	+	38	0	0	1036
Q6PD74-1#1	0	38	38	Q6PD74-1	196	234	+	38	Q6PD74-1	0	315	Q6PD74-1	0	315	+	44	Q6PD74-1#1	0	38	Q6PD74-1	196	234	+	38	0	0	1037
Q6PD74-1#2	0	15	15	Q6PD74-1	219	234	+	15	Q6PD74-1	109	315	Q6PD74-2	0	206	+	45	Q6PD74-1#2	0	15	Q6PD74-2	110	125	+	15	0	0	1038
Q6PD74-1#2	0	15	15	Q6PD74-1	219	234	+	15	Q6PD74-1	0	315	Q6PD74-1	0	315	+	44	Q6PD74-1#2	0	15	Q6PD74-1	219	234	+	15	0	0	1039
Q6PD74-1#3	0	1	1	Q6PD74-1	309	310	+	1	Q6PD74-1	109	315	Q6PD74-2	0	206	+	45	Q6PD74-1#3	0	1	Q6PD74-2	200	201	+	1	0	0	1040
Q6PD74-1#3	0	1	1	Q6PD74-1	309	310	+	1	Q6PD74-1	0	315	Q6PD74-1	0	315	+	44	Q6PD74-1#3	0	1	Q6PD74-1	309	310	+	1	0	0	1041
Q6PD74-1#4	0	1	1	Q6PD74-1	310	311	+	1	Q6PD74-1	109	315	Q6PD74-2	0	206	+	45	Q6PD74-1#4	0	1	Q6PD74-2	201	202	+	1	0	0	1042
Q6PD74-1#4	0	1	1	Q6PD74-1	310	311	+	1	Q6PD74-1	0	315	Q6PD74-1	0	315	+	44	Q6PD74-1#4	0	1	Q6PD74-1	310	311	+	1	0	0	1043
Q6PD74-1#5	0	109	109	Q6PD74-1	0	109	+	109	Q6PD74-1	0	315	Q6PD74-1	0	315	+	44	Q6PD74-1#5	0	109	Q6PD74-1	0	109	+	109	0	0	1044
Q6PD74-1#6	0	1	1	Q6PD74-1	131	132	+	1	Q6PD74-1	109	315	Q6PD74-2	0	206	+	45	Q6PD74-1#6	0	1	Q6PD74-2	22	23	+	1	0	0	1045
Q6PD74-1#6	0	1	1	Q6PD74-1	131	132	+	1	Q6PD74-1	0	315	Q6PD74-1	0	315	+	44	Q6PD74-1#6	0	1	Q6PD74-1	131	132	+	1	0	0	1046
Q6PD74-1#7	0	1	1	Q6PD74-1	25	26	+	1	Q6PD74-1	0	315	Q6PD74-1	0	315	+	44	Q6PD74-1#7	0	1	Q6PD74-1	25	26	+	1	0	0	1047
Q6PD74-1#8	0	1	1	Q6PD74-1	76	77	+	1	Q6PD74-1	0	315	Q6PD74-1	0	315	+	44	Q6PD74-1#8	0	1	Q6PD74-1	76	77	+	1	0	0	1048
Q6PD74-1#9	0	1	1	Q6PD74-1	87	88	+	1	Q6PD74-1	0	315	Q6PD74-1	0	315	+	44	Q6PD74-1#9	0	1	Q6PD74-1	87	88	+	1	0	0	1049
Q6PD74-1#10	0	1	1	Q6PD74-1	130	131	+	1	Q6PD74-1	109	315	Q6PD74-2	0	206	+	45	Q6PD74-1#10	0	1	Q6PD74-2	21	22	+	1	0	0	1050
Q6PD74-1#10	0	1	1	Q6PD74-1	130	131	+	1	Q6PD74-1	0	315	Q6PD74-1	0	315	+	44	Q6PD74-1#10	0	1	Q6PD74-1	130	131	+	1	0	0	1051
Q6PD74-1#11	0	1	1	Q6PD74-1	264	265	+	1	Q6PD74-1	109	315	Q6PD74-2	0	206	+	45	Q6PD74-1#11	0	1	Q6PD74-2	155	156	+	1	0	0	1052
Q6PD74-1#11	0	1	1	Q6PD74-1	264	265	+	1	Q6PD74-1	0	315	Q6PD74-1	0	315	+	44	Q6PD74-1#11	0	1	Q6PD74-1	264	265	+	1	0	0	1053
Q6PD74-1#12	0	1	1	Q6PD74-1	312	313	+	1	Q6PD74-1	109	315	Q6PD74-2	0	206	+	45	Q6PD74-1#12	0	1	Q6PD74-2	203	204	+	1	0	0	1054
Q6PD74-1#12	0	1	1	Q6PD74-1	312	313	+	1	Q6PD74-1	0	315	Q6PD74-1	0	315	+	44	Q6PD74-1#12	0	1	Q6PD74-1	312	313	+	1	0	0	1055
Q8N1M1-2#0	0	668	668	Q8N1M1-2	0	668	+	668	Q8N1M1-2	106	668	Q8N1M1-6	0	562	+	71	Q8N1M1-2#0	106	668	Q8N1M1-6	0	562	+	562	106	0	1056
Q8N1M1-2#0	0	668	668	Q8N1M1-2	0	668	+	668	Q8N1M1-2	162	668	Q8N1M1-5	0	455	+	70	Q8N1M1-2#0	162	668	Q8N1M1-5	0	455	+	455	162	0	1057
Q8N1M1-2#0	0	668	668	Q8N1M1-2	0	668	+	668	Q8N1M1-2	106	160	Q8N1M1-4	0	54	+	69	Q8N1M1-2#0	106	160	Q8N1M1-4	0	54	+	54	106	508	1058
Q8N1M1-2#0	0	668	668	Q8N1M1-2	0	668	+	668	Q8N1M1-2	0	668	Q8N1M1-2	0	668	+	68	Q8N1M1-2#0	0	668	Q8N1M1-2	0	668	+	668	0	0	1059
Q8N1M1-2#0	0	668	668	Q8N1M1-2	0	668	+	668	Q8N1M1-2	0	367	Q8N1M1-1	0	367	+	67	Q8N1M1-2#0	0	367	Q8N1M1-1	0	367	+	367	0	301	1060
Q8N1M1-2#1	0	25	25	Q8N1M1-2	0	25	+	25	Q8N1M1-2	0	668	Q8N1M1-2	0	668	+	68	Q8N1M1-2#1	0	25	Q8N1M1-2	0	25	+	25	0	0	1061
Q8N1M1-2#1	0	25	25	Q8N1M1-2	0	25	+	25	Q8N1M1-2	0	367	Q8N1M1-1	0	367	+	67	Q8N1M1-2#1	0	25	Q8N1M1-1	0	25	+	25	0	0	1062
Q8N1M1-2#2	0	21	21	Q8N1M1-2	25	46	+	21	Q8N1M1-2	0	668	Q8N1M1-2	0	668	+	68	Q8N1M1-2#2	0	21	Q8N1M1-2	25	46	+	21	0	0	1063
Q8N1M1-2#2	0	21	21	Q8N1M1-2	25	46	+	21	Q8N1M1-2	0	367	Q8N1M1-1	0	367	+	67	Q8N1M1-2#2	0	21	Q8N1M1-1	25	46	+	21	0	0	1064
Q8N1M1-2#3	0	24	24	Q8N1M1-2	46	70	+	24	Q8N1M1-2	0	668	Q8N1M1-2	0	668	+	68	Q8N1M1-2#3	0	24	Q8N1M1-2	46	70	+	24	0	0	1065
Q8N1M1-2#3	0	24	24	Q8N1M1-2	46	70	+	24	Q8N1M1-2	0	367	Q8N1M1-1	0	367	+	67	Q8N1M1-2#3	0	24	Q8N1M1-1	46	70	+	24	0	0	1066
Q8N1M1-2#4	0	21	21	Q8N1M1-2	70	91	+	21	Q8N1M1-2	0	668	Q8N1M1-2	0	668	+	68	Q8N1M1-2#4	0	21	Q8N1M1-2	70	91	+	21	0	0	1067
Q8N1M1-2#4	0	21	21	Q8N1M1-2	70	91	+	21	Q8N1M1-2	0	367	Q8N1M1-1	0	367	+	67	Q8N1M1-2#4	0	21	Q8N1M1-1	70	91	+	21	0	0	1068
Q8N1M1-2#5	0	87	87	Q8N1M1-2	91	178	+	87	Q8N1M1-2	106	668	Q8N1M1-6	0	562	+	71	Q8N1M1-2#5	15	87	Q8N1M1-6	0	72	+	72	15	0	1069
Q8N1M1-2#5	0	87	87	Q8N1M1-2	91	178	+	87	Q8N1M1-2	162	668	Q8N1M1-5	0	455	+	70	Q8N1M1-2#5	71	87	Q8N1M1-5	0	16	+	16	71	0	1070
Q8N1M1-2#5	0	87	87	Q8N1M1-2	91	178	+	87	Q8N1M1-2	106	160	Q8N1M1-4	0	54	+	69	Q8N1M1-2#5	15	69	Q8N1M1-4	0	54	+	54	15	18	1071
Q8N1M1-2#5	0	87	87	Q8N1M1-2	91	178	+	87	Q8N1M1-2	0	668	Q8N1M1-2	0	668	+	68	Q8N1M1-2#5	0	87	Q8N1M1-2	91	178	+	87	0	0	1072
Q8N1M1-2#5	0	87	87	Q8N1M1-2	91	178	+	87	Q8N1M1-2	0	367	Q8N1M1-1	0	367	+	67	Q8N1M1-2#5	0	87	Q8N1M1-1	91	178	+	87	0	0	1073
Q8N1M1-2#6	0	21	21	Q8N1M1-2	178	199	+	21	Q8N1M1-2	106	668	Q8N1M1-6	0	562	+	71	Q8N1M1-2#6	0	21	Q8N1M1-6	72	93	+	21	0	0	1074
Q8N1M1-2#6	0	21	21	Q8N1M1-2	178	199	+	21	Q8N1M1-2	162	668	Q8N1M1-5	0	455	+	70	Q8N1M1-2#6	0	21	Q8N1M1-5	16	37	+	21	0	0	1075
Q8N1M1-2#6	0	21	21	Q8N1M1-2	178	199	+	21	Q8N1M1-2	0	668	Q8N1M1-2	0	668	+	68	Q8N1M1-2#6	0	21	Q8N1M1-2	178	199	+	21	0	0	1076
Q8N1M1-2#6	0	21	21	Q8N1M1-2	178	199	+	21	Q8N1M1-2	0	367	Q8N1M1-1	0	367	+	67	Q8N1M1-2#6	0	21	Q8N1M1-1	178	199	+	21	0	0	1077
Q8N1M1-2#7	0	29	29	Q8N1M1-2	199	228	+	29	Q8N1M1-2	106	668	Q8N1M1-6	0	562	+	71	Q8N1M1-2#7	0	29	Q8N1M1-6	93	122	+	29	0	0	1078
Q8N1M1-2#7	0	29	29	Q8N1M1-2	199	228	+	29	Q8N1M1-2	162	668	Q8N1M1-5	0	455	+	70	Q8N1M1-2#7	0	29	Q8N1M1-5	37	66	+	29	0	0	1079
Q8N1M1-2#7	0	29	29	Q8N1M1-2	199	228	+	29	Q8N1M1-2	0	668	Q8N1M1-2	0	668	+	68	Q8N1M1-2#7	0	29	Q8N1M1-2	199	228	+	29	0	0	1080
Q8N1M1-2#7	0	29	29	Q8N1M1-2	199	228	+	29	Q8N1M1-2	0	367	Q8N1M1-1	0	367	+	67	Q8N1M1-2#7	0	29	Q8N1M1-1	199	228	+	29	0	0	1081
Q8N1M1-2#8	0	21	21	Q8N1M1-2	228	249	+	21	Q8N1M1-2	106	668	Q8N1M1-6	0	562	+	71	Q8N1M1-2#8	0	21	Q8N1M1-6	122	143	+	21	0	0	1082
Q8N1M1-2#8	0	21	21	Q8N1M1-2	228	249	+	21	Q8N1M1-2	162	668	Q8N1M1-5	0	455	+	70	Q8N1M1-2#8	0	10	Q8N1M1-5	66	76	+	10	0	11	1083
Q8N1M1-2#8	0	21	21	Q8N1M1-2	228	249	+	21	Q8N1M1-2	0	668	Q8N1M1-2	0	668	+	68	Q8N1M1-2#8	0	21	Q8N1M1-2	228	249	+	21	0	0	1084
Q8N1M1-2#8	0	21	21	Q8N1M1-2	228	249	+	21	Q8N1M1-2	0	367	Q8N1M1-1	0	367	+	67	Q8N1M1-2#8	0	21	Q8N1M1-1	228	249	+	21	0	0	1085
Q8N1M1-2#9	0	21	21	Q8N1M1-2	249	270	+	21	Q8N1M1-2	106	668	Q8N1M1-6	0	562	+	71	Q8N1M1-2#9	0	21	Q8N1M1-6	143	164	+	21	0	0	1086
Q8N1M1-2#9	0	21	21	Q8N1M1-2	249	270	+	21	Q8N1M1-2	0	668	Q8N1M1-2	0	668	+	68	Q8N1M1-2#9	0	21	Q8N1M1-2	249	270	+	21	0	0	1087
Q8N1M1-2#9	0	21	21	Q8N1M1-2	249	270	+	21	Q8N1M1-2	0	367	Q8N1M1-1	0	367	+	67	Q8N1M1-2#9	0	21	Q8N1M1-1	249	270	+	21	0	0	1088
Q8N1M1-2#10	0	21	21	Q8N1M1-2	270	291	+	21	Q8N1M1-2	106	668	Q8N1M1-6	0	562	+	71	Q8N1M1-2#10	0	21	Q8N1M1-6	164	185	+	21	0	0	1089
Q8N1M1-2#10	0	21	21	Q8N1M1-2	270	291	+	21	Q8N1M1-2	162	668	Q8N1M1-5	0	455	+	70	Q8N1M1-2#10	19	21	Q8N1M1-5	76	78	+	2	19	0	1090
Q8N1M1-2#10	0	21	21	Q8N1M1-2	270	291	+	21	Q8N1M1-2	0	668	Q8N1M1-2	0	668	+	68	Q8N1M1-2#10	0	21	Q8N1M1-2	270	291	+	21	0	0	1091
Q8N1M1-2#10	0	21	21	Q8N1M1-2	270	291	+	21	Q8N1M1-2	0	367	Q8N1M1-1	0	367	+	67	Q8N1M1-2#10	0	21	Q8N1M1-1	270	291	+	21	0	0	1092
Q8N1M1-2#11	0	377	377	Q8N1M1-2	291	668	+	377	Q8N1M1-2	106	668	Q8N1M1-6	0	562	+	71	Q8N1M1-2#11	0	377	Q8N1M1-6	185	562	+	377	0	0	1093
Q8N1M1-2#11	0	377	377	Q8N1M1-2	291	668	+	377	Q8N1M1-2	162	668	Q8N1M1-5	0	455	+	70	Q8N1M1-2#11	0	377	Q8N1M1-5	78	455	+	377	0	0	1094
Q8N1M1-2#11	0	377	377	Q8N1M1-2	291	668	+	377	Q8N1M1-2	0	668	Q8N1M1-2	0	668	+	68	Q8N1M1-2#11	0	377	Q8N1M1-2	291	668	+	377	0	0	1095
Q8N1M1-2#11	0	377	377	Q8N1M1-2	291	668	+	377	Q8N1M1-2	0	367	Q8N1M1-1	0	367	+	67	Q8N1M1-2#11	0	76	Q8N1M1-1	291	367	+	76	0	301	1096
Q8N1M1-2#12	0	55	55	Q8N1M1-2	399	454	+	55	Q8N1M1-2	106	668	Q8N1M1-6	0	562	+	71	Q8N1M1-2#12	0	55	Q8N1M1-6	293	348	+	55	0	0	1097
Q8N1M1-2#12	0	55	55	Q8N1M1-2	399	454	+	55	Q8N1M1-2	162	668	Q8N1M1-5	0	455	+	70	Q8N1M1-2#12	0	55	Q8N1M1-5	186	241	+	55	0	0	1098
Q8N1M1-2#12	0	55	55	Q8N1M1-2	399	454	+	55	Q8N1M1-2	0	668	Q8N1M1-2	0	668	+	68	Q8N1M1-2#12	0	55	Q8N1M1-2	399	454	+	55	0	0	1099
Q8N1M1-2#13	0	21	21	Q8N1M1-2	472	493	+	21	Q8N1M1-2	106	668	Q8N1M1-6	0	562	+	71	Q8N1M1-2#13	0	21	Q8N1M1-6	366	387	+	21	0	0	1100
Q8N1M1-2#13	0	21	21	Q8N1M1-2	472	493	+	21	Q8N1M1-2	162	668	Q8N1M1-5	0	455	+	70	Q8N1M1-2#13	0	21	Q8N1M1-5	259	280	+	21	0	0	1101
Q8N1M1-2#13	0	21	21	Q8N1M1-2	472	493	+	21	Q8N1M1-2	0	668	Q8N1M1-2	0	668	+	68	Q8N1M1-2#13	0	21	Q8N1M1-2	472	493	+	21	0	0	1102
Q8N1M1-2#14	0	39	39	Q8N1M1-2	531	570	+	39	Q8N1M1-2	106	668	Q8N1M1-6	0	562	+	71	Q8N1M1-2#14	0	39	Q8N1M1-6	425	464	+	39	0	0	1103
Q8N1M1-2#14	0	39	39	Q8N1M1-2	531	570	+	39	Q8N1M1-2	162	668	Q8N1M1-5	0	455	+	70	Q8N1M1-2#14	0	39	Q8N1M1-5	318	357	+	39	0	0	1104
Q8N1M1-2#14	0	39	39	Q8N1M1-2	531	570	+	39	Q8N1M1-2	0	668	Q8N1M1-2	0	668	+	68	Q8N1M1-2#14	0	39	Q8N1M1-2	531	570	+	39	0	0	1105
Q8N1M1-2#15	0	17	17	Q8N1M1-2	399	416	+	17	Q8N1M1-2	106	668	Q8N1M1-6	0	562	+	71	Q8N1M1-2#15	0	17	Q8N1M1-6	293	310	+	17	0	0	1106
Q8N1M1-2#15	0	17	17	Q8N1M1-2	399	416	+	17	Q8N1M1-2	162	668	Q8N1M1-5	0	455	+	70	Q8N1M1-2#15	0	17	Q8N1M1-5	186	203	+	17	0	0	1107
Q8N1M1-2#15	0	17	17	Q8N1M1-2	399	416	+	17	Q8N1M1-2	0	668	Q8N1M1-2	0	668	+	68	Q8N1M1-2#15	0	17	Q8N1M1-2	399	416	+	17	0	0	1108
Q8N1M1-2#16	0	19	19	Q8N1M1-2	531	550	+	19	Q8N1M1-2	106	668	Q8N1M1-6	0	562	+	71	Q8N1M1-2#16	0	19	Q8N1M1-6	425	444	+	19	0	0	1109
Q8N1M1-2#16	0	19	19	Q8N1M1-2	531	550	+	19	Q8N1M1-2	162	668	Q8N1M1-5	0	455	+	70	Q8N1M1-2#16	0	19	Q8N1M1-5	318	337	+	19	0	0	1110
Q8N1M1-2#16	0	19	19	Q8N1M1-2	531	550	+	19	Q8N1M1-2	0	668	Q8N1M1-2	0	668	+	68	Q8N1M1-2#16	0	19	Q8N1M1-2	531	550	+	19	0	0	1111
Q8N1M1-2#17	0	162	162	Q8N1M1-2	0	162	+	162	Q8N1M1-2	106	668	Q8N1M1-6	0	562	+	71	Q8N1M1-2#17	106	162	Q8N1M1-6	0	56	+	56	106	0	1112
Q8N1M1-2#17	0	162	162	Q8N1M1-2	0	162	+	162	Q8N1M1-2	106	160	Q8N1M1-4	0	54	+	69	Q8N1M1-2#17	106	160	Q8N1M1-4	0	54	+	54	106	2	1113
Q8N1M1-2#17	0	162	162	Q8N1M1-2	0	162	+	162	Q8N1M1-2	0	668	Q8N1M1-2	0	668	+	68	Q8N1M1-2#17	0	162	Q8N1M1-2	0	162	+	162	0	0	1114
Q8N1M1-2#17	0	162	162	Q8N1M1-2	0	162	+	162	Q8N1M1-2	0	367	Q8N1M1-1	0	367	+	67	Q8N1M1-2#17	0	162	Q8N1M1-1	0	162	+	162	0	0	1115
Q8N1M1-2#18	0	106	106	Q8N1M1-2	0	106	+	106	Q8N1M1-2	0	668	Q8N1M1-2	0	668	+	68	Q8N1M1-2#18	0	106	Q8N1M1-2	0	106	+	106	0	0	1116
Q8N1M1-2#18	0	106	106	Q8N1M1-2	0	106	+	106	Q8N1M1-2	0	367	Q8N1M1-1	0	367	+	67	Q8N1M1-2#18	0	106	Q8N1M1-1	0	106	+	106	0	0	1117
Q8N1M1-2#19	0	18	18	Q8N1M1-2	160	178	+	18	Q8N1M1-2	106	668	Q8N1M1-6	0	562	+	71	Q8N1M1-2#19	0	18	Q8N1M1-6	54	72	+	18	0	0	1118
Q8N1M1-2#19	0	18	18	Q8N1M1-2	160	178	+	18	Q8N1M1-2	162	668	Q8N1M1-5	0	455	+	70	Q8N1M1-2#19	2	18	Q8N1M1-5	0	16	+	16	2	0	1119
Q8N1M1-2#19	0	18	18	Q8N1M1-2	160	178	+	18	Q8N1M1-2	0	668	Q8N1M1-2	0	668	+	68	Q8N1M1-2#19	0	18	Q8N1M1-2	160	178	+	18	0	0	1120
Q8N1M1-2#19	0	18	18	Q8N1M1-2	160	178	+	18	Q8N1M1-2	0	367	Q8N1M1-1	0	367	+	67	Q8N1M1-2#19	0	18	Q8N1M1-1	160	178	+	18	0	0	1121
Q8N1M1-2#20	0	490	490	Q8N1M1-2	178	668	+	490	Q8N1M1-2	106	668	Q8N1M1-6	0	562	+	71	Q8N1M1-2#20	0	490	Q8N1M1-6	72	562	+	490	0	0	1122
Q8N1M1-2#20	0	490	490	Q8N1M1-2	178	668	+	490	Q8N1M1-2	162	668	Q8N1M1-5	0	455	+	70	Q8N1M1-2#20	0	490	Q8N1M1-5	16	455	+	439	0	0	1123
Q8N1M1-2#20	0	490	490	Q8N1M1-2	178	668	+	490	Q8N1M1-2	0	668	Q8N1M1-2	0	668	+	68	Q8N1M1-2#20	0	490	Q8N1M1-2	178	668	+	490	0	0	1124
Q8N1M1-2#20	0	490	490	Q8N1M1-2	178	668	+	490	Q8N1M1-2	0	367	Q8N1M1-1	0	367	+	67	Q8N1M1-2#20	0	189	Q8N1M1-1	178	367	+	189	0	301	1125
Q8N1M1-2#21	0	51	51	Q8N1M1-2	238	289	+	51	Q8N1M1-2	106	668	Q8N1M1-6	0	562	+	71	Q8N1M1-2#21	0	51	Q8N1M1-6	132	183	+	51	0	0	1126
Q8N1M1-2#21	0	51	51	Q8N1M1-2	238	289	+	51	Q8N1M1-2	0	668	Q8N1M1-2	0	668	+	68	Q8N1M1-2#21	0	51	Q8N1M1-2	238	289	+	51	0	0	1127
Q8N1M1-2#21	0	51	51	Q8N1M1-2	238	289	+	51	Q8N1M1-2	0	367	Q8N1M1-1	0	367	+	67	Q8N1M1-2#21	0	51	Q8N1M1-1	238	289	+	51	0	0	1128
Q8N1M1-2#22	0	31	31	Q8N1M1-2	367	398	+	31	Q8N1M1-2	106	668	Q8N1M1-6	0	562	+	71	Q8N1M1-2#22	0	31	Q8N1M1-6	261	292	+	31	0	0	1129
Q8N1M1-2#22	0	31	31	Q8N1M1-2	367	398	+	31	Q8N1M1-2	162	668	Q8N1M1-5	0	455	+	70	Q8N1M1-2#22	0	31	Q8N1M1-5	154	185	+	31	0	0	1130
Q8N1M1-2#22	0	31	31	Q8N1M1-2	367	398	+	31	Q8N1M1-2	0	668	Q8N1M1-2	0	668	+	68	Q8N1M1-2#22	0	31	Q8N1M1-2	367	398	+	31	0	0	1131
Q8N1M1-2#23	0	270	270	Q8N1M1-2	398	668	+	270	Q8N1M1-2	106	668	Q8N1M1-6	0	562	+	71	Q8N1M1-2#23	0	270	Q8N1M1-6	292	562	+	270	0	0	1132
Q8N1M1-2#23	0	270	270	Q8N1M1-2	398	668	+	270	Q8N1M1-2	162	668	Q8N1M1-5	0	455	+	70	Q8N1M1-2#23	0	270	Q8N1M1-5	185	455	+	270	0	0	1133
Q8N1M1-2#23	0	270	270	Q8N1M1-2	398	668	+	270	Q8N1M1-2	0	668	Q8N1M1-2	0	668	+	68	Q8N1M1-2#23	0	270	Q8N1M1-2	398	668	+	270	0	0	1134
Q8N1M1-2#24	0	1	1	Q8N1M1-2	42	43	+	1	Q8N1M1-2	0	668	Q8N1M1-2	0	668	+	68	Q8N1M1-2#24	0	1	Q8N1M1-2	42	43	+	1	0	0	1135
Q8N1M1-2#24	0	1	1	Q8N1M1-2	42	43	+	1	Q8N1M1-2	0	367	Q8N1M1-1	0	367	+	67	Q8N1M1-2#24	0	1	Q8N1M1-1	42	43	+	1	0	0	1136
Q8N1M1-2#25	0	1	1	Q8N1M1-2	621	622	+	1	Q8N1M1-2	106	668	Q8N1M1-6	0	562	+	71	Q8N1M1-2#25	0	1	Q8N1M1-6	515	516	+	1	0	0	1137
Q8N1M1-2#25	0	1	1	Q8N1M1-2	621	622	+	1	Q8N1M1-2	162	668	Q8N1M1-5	0	455	+	70	Q8N1M1-2#25	0	1	Q8N1M1-5	408	409	+	1	0	0	1138
Q8N1M1-2#25	0	1	1	Q8N1M1-2	621	622	+	1	Q8N1M1-2	0	668	Q8N1M1-2	0	668	+	68	Q8N1M1-2#25	0	1	Q8N1M1-2	621	622	+	1	0	0	1139
Q9UI95#0	0	211	211	Q9UI95	0	211	+	211	Q9UI95	0	211	Q9UI95	0	211	+	101	Q9UI95#0	0	211	Q9UI95	0	211	+	211	0	0	1140
Q9UI95#1	0	191	191	Q9UI95	12	203	+	191	Q9UI95	0	211	Q9UI95	0	211	+	101	Q9UI95#1	0	191	Q9UI95	12	203	+	191	0	0	1141
Q9UI95#2	0	135	135	Q9UI95	20	155	+	135	Q9UI95	0	211	Q9UI95	0	211	+	101	Q9UI95#2	0	135	Q9UI95	20	155	+	135	0	0	1142
Q9UI95#3	0	62	62	Q9UI95	149	211	+	62	Q9UI95	0	211	Q9UI95	0	211	+	101	Q9UI95#3	0	62	Q9UI95	149	211	+	62	0	0	1143
Q9UI95#4	0	1	1	Q9UI95	84	85	+	1	Q9UI95	0	211	Q9UI95	0	211	+	101	Q9UI95#4	0	1	Q9UI95	84	85	+	1	0	0	1144
Q9UI95#5	0	1	1	Q9UI95	62	63	+	1	Q9UI95	0	211	Q9UI95	0	211	+	101	Q9UI95#5	0	1	Q9UI95	62	63	+	1	0	0	1145
Q9UI95#6	0	1	1	Q9UI95	123	124	+	1	Q9UI95	0	211	Q9UI95	0	211	+	101	Q9UI95#6	0	1	Q9UI95	123	124	+	1	0	0	1146
Q9UI95#7	0	1	1	Q9UI95	170	171	+	1	Q9UI95	0	211	Q9UI95	0	211	+	101	Q9UI95#7	0	1	Q9UI95	170	171	+	1	0	0	1147
Q9UI95#8	0	1	1	Q9UI95	185	186	+	1	Q9UI95	0	211	Q9UI95	0	211	+	101	Q9UI95#8	0	1	Q9UI95	185	186	+	1	0	0	1148
Q9UI95#9	0	1	1	Q9UI95	199	200	+	1	Q9UI95	0	211	Q9UI95	0	211	+	101	Q9UI95#9	0	1	Q9UI95	199	200	+	1	0	0	1149
Q9UI95#10	0	1	1	Q9UI95	201	202	+	1	Q9UI95	0	211	Q9UI95	0	211	+	101	Q9UI95#10	0	1	Q9UI95	201	202	+	1	0	0	1150
Q9UI95#11	0	1	1	Q9UI95	16	17	+	1	Q9UI95	0	211	Q9UI95	0	211	+	101	Q9UI95#11	0	1	Q9UI95	16	17	+	1	0	0	1151
Q9UI95#12	0	1	1	Q9UI95	95	96	+	1	Q9UI95	0	211	Q9UI95	0	211	+	101	Q9UI95#12	0	1	Q9UI95	95	96	+	1	0	0	1152
Q9UI95#13	0	1	1	Q9UI95	198	199	+	1	Q9UI95	0	211	Q9UI95	0	211	+	101	Q9UI95#13	0	1	Q9UI95	198	199	+	1	0	0	1153
Q9UI95#14	0	3	3	Q9UI95	5	8	+	3	Q9UI95	0	211	Q9UI95	0	211	+	101	Q9UI95#14	0	3	Q9UI95	5	8	+	3	0	0	1154
Q9UI95#15	0	3	3	Q9UI95	9	12	+	3	Q9UI95	0	211	Q9UI95	0	211	+	101	Q9UI95#15	0	3	Q9UI95	9	12	+	3	0	0	1155
Q9UI95#16	0	21	21	Q9UI95	12	33	+	21	Q9UI95	0	211	Q9UI95	0	211	+	101	Q9UI95#16	0	21	Q9UI95	12	33	+	21	0	0	1156
Q9UI95#17	0	3	3	Q9UI95	38	41	+	3	Q9UI95	0	211	Q9UI95	0	211	+	101	Q9UI95#17	0	3	Q9UI95	38	41	+	3	0	0	1157
Q9UI95#18	0	6	6	Q9UI95	41	47	+	6	Q9UI95	0	211	Q9UI95	0	211	+	101	Q9UI95#18	0	6	Q9UI95	41	47	+	6	0	0	1158
Q9UI95#19	0	6	6	Q9UI95	49	55	+	6	Q9UI95	0	211	Q9UI95	0	211	+	101	Q9UI95#19	0	6	Q9UI95	49	55	+	6	0	0	1159
Q9UI95#20	0	19	19	Q9UI95	57	76	+	19	Q9UI95	0	211	Q9UI95	0	211	+	101	Q9UI95#20	0	19	Q9UI95	57	76	+	19	0	0	1160
Q9UI95#21	0	9	9	Q9UI95	79	88	+	9	Q9UI95	0	211	Q9UI95	0	211	+	101	Q9UI95#21	0	9	Q9UI95	79	88	+	9	0	0	1161
Q9UI95#22	0	3	3	Q9UI95	89	92	+	3	Q9UI95	0	211	Q9UI95	0	211	+	101	Q9UI95#22	0	3	Q9UI95	89	92	+	3	0	0	1162
Q9UI95#23	0	10	10	Q9UI95	93	103	+	10	Q9UI95	0	211	Q9UI95	0	211	+	101	Q9UI95#23	0	10	Q9UI95	93	103	+	10	0	0	1163
Q9UI95#24	0	6	6	Q9UI95	105	111	+	6	Q9UI95	0	211	Q9UI95	0	211	+	101	Q9UI95#24	0	6	Q9UI95	105	111	+	6	0	0	1164
Q9UI95#25	0	3	3	Q9UI95	111	114	+	3	Q9UI95	0	211	Q9UI95	0	211	+	101	Q9UI95#25	0	3	Q9UI95	111	114	+	3	0	0	1165
Q9UI95#26	0	4	4	Q9UI95	114	118	+	4	Q9UI95	0	211	Q9UI95	0	211	+	101	Q9UI95#26	0	4	Q9UI95	114	118	+	4	0	0	1166
Q9UI95#27	0	13	13	Q9UI95	118	131	+	13	Q9UI95	0	211	Q9UI95	0	211	+	101	Q9UI95#27	0	13	Q9UI95	118	131	+	13	0	0	1167
Q9UI95#28	0	3	3	Q9UI95	132	135	+	3	Q9UI95	0	211	Q9UI95	0	211	+	101	Q9UI95#28	0	3	Q9UI95	132	135	+	3	0	0	1168
Q9UI95#29	0	11	11	Q9UI95	144	155	+	11	Q9UI95	0	211	Q9UI95	0	211	+	101	Q9UI95#29	0	11	Q9UI95	144	155	+	11	0	0	1169
Q9UI95#30	0	4	4	Q9UI95	155	159	+	4	Q9UI95	0	211	Q9UI95	0	211	+	101	Q9UI95#30	0	4	Q9UI95	155	159	+	4	0	0	1170
Q9UI95#31	0	5	5	Q9UI95	161	166	+	5	Q9UI95	0	211	Q9UI95	0	211	+	101	Q9UI95#31	0	5	Q9UI95	161	166	+	5	0	0	1171
Q9UI95#32	0	5	5	Q9UI95	168	173	+	5	Q9UI95	0	211	Q9UI95	0	211	+	101	Q9UI95#32	0	5	Q9UI95	168	173	+	5	0	0	1172
Q9UI95#33	0	4	4	Q9UI95	175	179	+	4	Q9UI95	0	211	Q9UI95	0	211	+	101	Q9UI95#33	0	4	Q9UI95	175	179	+	4	0	0	1173
Q9UI95#34	0	12	12	Q9UI95	184	196	+	12	Q9UI95	0	211	Q9UI95	0	211	+	101	Q9UI95#34	0	12	Q9UI95	184	196	+	12	0	0	1174
Q9UI95#35	0	8	8	Q9UI95	197	205	+	8	Q9UI95	0	211	Q9UI95	0	211	+	101	Q9UI95#35	0	8	Q9UI95	197	205	+	8	0	0	1175
Q9BS31#0	0	505	505	Q9BS31	0	505	+	505	Q9BS31	0	505	Q9BS31	0	505	+	88	Q9BS31#0	0	505	Q9BS31	0	505	+	505	0	0	1176
Q9BS31#1	0	72	72	Q9BS31	7	79	+	72	Q9BS31	0	505	Q9BS31	0	505	+	88	Q9BS31#1	0	72	Q9BS31	7	79	+	72	0	0	1177
Q9BS31#2	0	23	23	Q9BS31	177	200	+	23	Q9BS31	0	505	Q9BS31	0	505	+	88	Q9BS31#2	0	23	Q9BS31	177	200	+	23	0	0	1178
Q9BS31#3	0	23	23	Q9BS31	205	228	+	23	Q9BS31	0	505	Q9BS31	0	505	+	88	Q9BS31#3	0	23	Q9BS31	205	228	+	23	0	0	1179
Q9BS31#4	0	23	23	Q9BS31	233	256	+	23	Q9BS31	0	505	Q9BS31	0	505	+	88	Q9BS31#4	0	23	Q9BS31	233	256	+	23	0	0	1180
Q9BS31#5	0	23	23	Q9BS31	261	284	+	23	Q9BS31	0	505	Q9BS31	0	505	+	88	Q9BS31#5	0	23	Q9BS31	261	284	+	23	0	0	1181
Q9BS31#6	0	23	23	Q9BS31	289	312	+	23	Q9BS31	0	505	Q9BS31	0	505	+	88	Q9BS31#6	0	23	Q9BS31	289	312	+	23	0	0	1182
Q9BS31#7	0	23	23	Q9BS31	317	340	+	23	Q9BS31	0	505	Q9BS31	0	505	+	88	Q9BS31#7	0	23	Q9BS31	317	340	+	23	0	0	1183
Q9BS31#8	0	23	23	Q9BS31	345	368	+	23	Q9BS31	0	505	Q9BS31	0	505	+	88	Q9BS31#8	0	23	Q9BS31	345	368	+	23	0	0	1184
Q9BS31#9	0	23	23	Q9BS31	373	396	+	23	Q9BS31	0	505	Q9BS31	0	505	+	88	Q9BS31#9	0	23	Q9BS31	373	396	+	23	0	0	1185
Q9BS31#10	0	23	23	Q9BS31	401	424	+	23	Q9BS31	0	505	Q9BS31	0	505	+	88	Q9BS31#10	0	23	Q9BS31	401	424	+	23	0	0	1186
Q9BS31#11	0	23	23	Q9BS31	429	452	+	23	Q9BS31	0	505	Q9BS31	0	505	+	88	Q9BS31#11	0	23	Q9BS31	429	452	+	23	0	0	1187
Q9BS31#12	0	27	27	Q9BS31	454	481	+	27	Q9BS31	0	505	Q9BS31	0	505	+	88	Q9BS31#12	0	27	Q9BS31	454	481	+	27	0	0	1188
Q9BS31#13	0	19	19	Q9BS31	462	481	+	19	Q9BS31	0	505	Q9BS31	0	505	+	88	Q9BS31#13	0	19	Q9BS31	462	481	+	19	0	0	1189
Q9BS31#14	0	1	1	Q9BS31	111	112	+	1	Q9BS31	0	505	Q9BS31	0	505	+	88	Q9BS31#14	0	1	Q9BS31	111	112	+	1	0	0	1190
Q9BS31#15	0	1	1	Q9BS31	351	352	+	1	Q9BS31	0	505	Q9BS31	0	505	+	88	Q9BS31#15	0	1	Q9BS31	351	352	+	1	0	0	1191
Q9BS31#16	0	1	1	Q9BS31	468	469	+	1	Q9BS31	0	505	Q9BS31	0	505	+	88	Q9BS31#16	0	1	Q9BS31	468	469	+	1	0	0	1192
Q9BS31#17	0	1	1	Q9BS31	7	8	+	1	Q9BS31	0	505	Q9BS31	0	505	+	88	Q9BS31#17	0	1	Q9BS31	7	8	+	1	0	0	1193
Q9BS31#18	0	1	1	Q9BS31	313	314	+	1	Q9BS31	0	505	Q9BS31	0	505	+	88	Q9BS31#18	0	1	Q9BS31	313	314	+	1	0	0	1194
P14060#0	0	1	1	P14060	0	1	+	1	P14060	0	373	P14060	0	373	+	23	P14060#0	0	1	P14060	0	1	+	1	0	0	1195
P14060#1	0	372	372	P14060	1	373	+	372	P14060	0	373	P14060	0	373	+	23	P14060#1	0	372	P14060	1	373	+	372	0	0	1196
P14060#2	0	21	21	P14060	287	308	+	21	P14060	0	373	P14060	0	373	+	23	P14060#2	0	21	P14060	287	308	+	21	0	0	1197
P14060#3	0	1	1	P14060	158	159	+	1	P14060	0	373	P14060	0	373	+	23	P14060#3	0	1	P14060	158	159	+	1	0	0	1198
P14060#4	0	6	6	P14060	9	15	+	6	P14060	0	373	P14060	0	373	+	23	P14060#4	0	6	P14060	9	15	+	6	0	0	1199
P14060#5	0	1	1	P14060	154	155	+	1	P14060	0	373	P14060	0	373	+	23	P14060#5	0	1	P14060	154	155	+	1	0	0	1200
P14060#6	0	1	1	P14060	158	159	+	1	P14060	0	373	P14060	0	373	+	23	P14060#6	0	1	P14060	158	159	+	1	0	0	1201
P14060#7	0	1	1	P14060	53	54	+	1	P14060	0	373	P14060	0	373	+	23	P14060#7	0	1	P14060	53	54	+	1	0	0	1202
P14060#8	0	1	1	P14060	70	71	+	1	P14060	0	373	P14060	0	373	+	23	P14060#8	0	1	P14060	70	71	+	1	0	0	1203
P14060#9	0	1	1	P14060	78	79	+	1	P14060	0	373	P14060	0	373	+	23	P14060#9	0	1	P14060	78	79	+	1	0	0	1204
P14060#10	0	1	1	P14060	89	90	+	1	P14060	0	373	P14060	0	373	+	23	P14060#10	0	1	P14060	89	90	+	1	0	0	1205
P14060#11	0	1	1	P14060	285	286	+	1	P14060	0	373	P14060	0	373	+	23	P14060#11	0	1	P14060	285	286	+	1	0	0	1206
P14060#12	0	1	1	P14060	366	367	+	1	P14060	0	373	P14060	0	373	+	23	P14060#12	0	1	P14060	366	367	+	1	0	0	1207
P26439-1#0	0	372	372	P26439-1	0	372	+	372	P26439-1	0	102	P26439-2	0	102	+	26	P26439-1#0	0	102	P26439-2	0	102	+	102	0	270	1208
P26439-1#0	0	372	372	P26439-1	0	372	+	372	P26439-1	0	372	P26439-1	0	372	+	25	P26439-1#0	0	372	P26439-1	0	372	+	372	0	0	1209
P26439-1#1	0	21	21	P26439-1	286	307	+	21	P26439-1	0	372	P26439-1	0	372	+	25	P26439-1#1	0	21	P26439-1	286	307	+	21	0	0	1210
P26439-1#2	0	1	1	P26439-1	153	154	+	1	P26439-1	0	372	P26439-1	0	372	+	25	P26439-1#2	0	1	P26439-1	153	154	+	1	0	0	1211
P26439-1#3	0	1	1	P26439-1	157	158	+	1	P26439-1	0	372	P26439-1	0	372	+	25	P26439-1#3	0	1	P26439-1	157	158	+	1	0	0	1212
P26439-1#4	0	120	120	P26439-1	102	222	+	120	P26439-1	0	372	P26439-1	0	372	+	25	P26439-1#4	0	120	P26439-1	102	222	+	120	0	0	1213
P26439-1#5	0	150	150	P26439-1	222	372	+	150	P26439-1	0	372	P26439-1	0	372	+	25	P26439-1#5	0	150	P26439-1	222	372	+	150	0	0	1214
P26439-1#6	0	1	1	P26439-1	9	10	+	1	P26439-1	0	102	P26439-2	0	102	+	26	P26439-1#6	0	1	P26439-2	9	10	+	1	0	0	1215
P26439-1#6	0	1	1	P26439-1	9	10	+	1	P26439-1	0	372	P26439-1	0	372	+	25	P26439-1#6	0	1	P26439-1	9	10	+	1	0	0	1216
P26439-1#7	0	1	1	P26439-1	9	10	+	1	P26439-1	0	102	P26439-2	0	102	+	26	P26439-1#7	0	1	P26439-2	9	10	+	1	0	0	1217
P26439-1#7	0	1	1	P26439-1	9	10	+	1	P26439-1	0	372	P26439-1	0	372	+	25	P26439-1#7	0	1	P26439-1	9	10	+	1	0	0	1218
P26439-1#8	0	1	1	P26439-1	14	15	+	1	P26439-1	0	102	P26439-2	0	102	+	26	P26439-1#8	0	1	P26439-2	14	15	+	1	0	0	1219
P26439-1#8	0	1	1	P26439-1	14	15	+	1	P26439-1	0	372	P26439-1	0	372	+	25	P26439-1#8	0	1	P26439-1	14	15	+	1	0	0	1220
P26439-1#9	0	1	1	P26439-1	73	74	+	1	P26439-1	0	102	P26439-2	0	102	+	26	P26439-1#9	0	1	P26439-2	73	74	+	1	0	0	1221
P26439-1#9	0	1	1	P26439-1	73	74	+	1	P26439-1	0	372	P26439-1	0	372	+	25	P26439-1#9	0	1	P26439-1	73	74	+	1	0	0	1222
P26439-1#10	0	1	1	P26439-1	81	82	+	1	P26439-1	0	102	P26439-2	0	102	+	26	P26439-1#10	0	1	P26439-2	81	82	+	1	0	0	1223
P26439-1#10	0	1	1	P26439-1	81	82	+	1	P26439-1	0	372	P26439-1	0	372	+	25	P26439-1#10	0	1	P26439-1	81	82	+	1	0	0	1224
P26439-1#11	0	1	1	P26439-1	81	82	+	1	P26439-1	0	102	P26439-2	0	102	+	26	P26439-1#11	0	1	P26439-2	81	82	+	1	0	0	1225
P26439-1#11	0	1	1	P26439-1	81	82	+	1	P26439-1	0	372	P26439-1	0	372	+	25	P26439-1#11	0	1	P26439-1	81	82	+	1	0	0	1226
P26439-1#12	0	1	1	P26439-1	93	94	+	1	P26439-1	0	102	P26439-2	0	102	+	26	P26439-1#12	0	1	P26439-2	93	94	+	1	0	0	1227
P26439-1#12	0	1	1	P26439-1	93	94	+	1	P26439-1	0	372	P26439-1	0	372	+	25	P26439-1#12	0	1	P26439-1	93	94	+	1	0	0	1228
P26439-1#13	0	1	1	P26439-1	99	100	+	1	P26439-1	0	102	P26439-2	0	102	+	26	P26439-1#13	0	1	P26439-2	99	100	+	1	0	0	1229
P26439-1#13	0	1	1	P26439-1	99	100	+	1	P26439-1	0	372	P26439-1	0	372	+	25	P26439-1#13	0	1	P26439-1	99	100	+	1	0	0	1230
P26439-1#14	0	1	1	P26439-1	107	108	+	1	P26439-1	0	372	P26439-1	0	372	+	25	P26439-1#14	0	1	P26439-1	107	108	+	1	0	0	1231
P26439-1#15	0	1	1	P26439-1	128	129	+	1	P26439-1	0	372	P26439-1	0	372	+	25	P26439-1#15	0	1	P26439-1	128	129	+	1	0	0	1232
P26439-1#16	0	1	1	P26439-1	141	142	+	1	P26439-1	0	372	P26439-1	0	372	+	25	P26439-1#16	0	1	P26439-1	141	142	+	1	0	0	1233
P26439-1#17	0	1	1	P26439-1	154	155	+	1	P26439-1	0	372	P26439-1	0	372	+	25	P26439-1#17	0	1	P26439-1	154	155	+	1	0	0	1234
P26439-1#18	0	1	1	P26439-1	166	167	+	1	P26439-1	0	372	P26439-1	0	372	+	25	P26439-1#18	0	1	P26439-1	166	167	+	1	0	0	1235
P26439-1#19	0	1	1	P26439-1	172	173	+	1	P26439-1	0	372	P26439-1	0	372	+	25	P26439-1#19	0	1	P26439-1	172	173	+	1	0	0	1236
P26439-1#20	0	1	1	P26439-1	185	186	+	1	P26439-1	0	372	P26439-1	0	372	+	25	P26439-1#20	0	1	P26439-1	185	186	+	1	0	0	1237
P26439-1#21	0	1	1	P26439-1	204	205	+	1	P26439-1	0	372	P26439-1	0	372	+	25	P26439-1#21	0	1	P26439-1	204	205	+	1	0	0	1238
P26439-1#22	0	1	1	P26439-1	212	213	+	1	P26439-1	0	372	P26439-1	0	372	+	25	P26439-1#22	0	1	P26439-1	212	213	+	1	0	0	1239
P26439-1#23	0	1	1	P26439-1	215	216	+	1	P26439-1	0	372	P26439-1	0	372	+	25	P26439-1#23	0	1	P26439-1	215	216	+	1	0	0	1240
P26439-1#24	0	1	1	P26439-1	221	222	+	1	P26439-1	0	372	P26439-1	0	372	+	25	P26439-1#24	0	1	P26439-1	221	222	+	1	0	0	1241
P26439-1#25	0	1	1	P26439-1	221	222	+	1	P26439-1	0	372	P26439-1	0	372	+	25	P26439-1#25	0	1	P26439-1	221	222	+	1	0	0	1242
P26439-1#26	0	1	1	P26439-1	221	222	+	1	P26439-1	0	372	P26439-1	0	372	+	25	P26439-1#26	0	1	P26439-1	221	222	+	1	0	0	1243
P26439-1#27	0	8	8	P26439-1	230	238	+	8	P26439-1	0	372	P26439-1	0	372	+	25	P26439-1#27	0	8	P26439-1	230	238	+	8	0	0	1244
P26439-1#28	0	1	1	P26439-1	235	236	+	1	P26439-1	0	372	P26439-1	0	372	+	25	P26439-1#28	0	1	P26439-1	235	236	+	1	0	0	1245
P26439-1#29	0	1	1	P26439-1	244	245	+	1	P26439-1	0	372	P26439-1	0	372	+	25	P26439-1#29	0	1	P26439-1	244	245	+	1	0	0	1246
P26439-1#30	0	1	1	P26439-1	249	250	+	1	P26439-1	0	372	P26439-1	0	372	+	25	P26439-1#30	0	1	P26439-1	249	250	+	1	0	0	1247
P26439-1#31	0	1	1	P26439-1	252	253	+	1	P26439-1	0	372	P26439-1	0	372	+	25	P26439-1#31	0	1	P26439-1	252	253	+	1	0	0	1248
P26439-1#32	0	1	1	P26439-1	253	254	+	1	P26439-1	0	372	P26439-1	0	372	+	25	P26439-1#32	0	1	P26439-1	253	254	+	1	0	0	1249
P26439-1#33	0	1	1	P26439-1	258	259	+	1	P26439-1	0	372	P26439-1	0	372	+	25	P26439-1#33	0	1	P26439-1	258	259	+	1	0	0	1250
P26439-1#34	0	1	1	P26439-1	258	259	+	1	P26439-1	0	372	P26439-1	0	372	+	25	P26439-1#34	0	1	P26439-1	258	259	+	1	0	0	1251
P26439-1#35	0	1	1	P26439-1	293	294	+	1	P26439-1	0	372	P26439-1	0	372	+	25	P26439-1#35	0	1	P26439-1	293	294	+	1	0	0	1252
P26439-1#36	0	1	1	P26439-1	340	341	+	1	P26439-1	0	372	P26439-1	0	372	+	25	P26439-1#36	0	1	P26439-1	340	341	+	1	0	0	1253
P26439-1#37	0	2	2	P26439-1	51	53	+	2	P26439-1	0	102	P26439-2	0	102	+	26	P26439-1#37	0	2	P26439-2	51	53	+	2	0	0	1254
P26439-1#37	0	2	2	P26439-1	51	53	+	2	P26439-1	0	372	P26439-1	0	372	+	25	P26439-1#37	0	2	P26439-1	51	53	+	2	0	0	1255
P26439-1#38	0	3	3	P26439-1	91	94	+	3	P26439-1	0	102	P26439-2	0	102	+	26	P26439-1#38	0	3	P26439-2	91	94	+	3	0	0	1256
P26439-1#38	0	3	3	P26439-1	91	94	+	3	P26439-1	0	372	P26439-1	0	372	+	25	P26439-1#38	0	3	P26439-1	91	94	+	3	0	0	1257
P26439-1#39	0	1	1	P26439-1	231	232	+	1	P26439-1	0	372	P26439-1	0	372	+	25	P26439-1#39	0	1	P26439-1	231	232	+	1	0	0	1258
Q9GZX5#0	0	532	532	Q9GZX5	0	532	+	532	Q9GZX5	0	532	Q9GZX5	0	532	+	90	Q9GZX5#0	0	532	Q9GZX5	0	532	+	532	0	0	1259
Q9GZX5#1	0	72	72	Q9GZX5	7	79	+	72	Q9GZX5	0	532	Q9GZX5	0	532	+	90	Q9GZX5#1	0	72	Q9GZX5	7	79	+	72	0	0	1260
Q9GZX5#2	0	23	23	Q9GZX5	205	228	+	23	Q9GZX5	0	532	Q9GZX5	0	532	+	90	Q9GZX5#2	0	23	Q9GZX5	205	228	+	23	0	0	1261
Q9GZX5#3	0	23	23	Q9GZX5	233	256	+	23	Q9GZX5	0	532	Q9GZX5	0	532	+	90	Q9GZX5#3	0	23	Q9GZX5	233	256	+	23	0	0	1262
Q9GZX5#4	0	23	23	Q9GZX5	261	284	+	23	Q9GZX5	0	532	Q9GZX5	0	532	+	90	Q9GZX5#4	0	23	Q9GZX5	261	284	+	23	0	0	1263
Q9GZX5#5	0	23	23	Q9GZX5	289	312	+	23	Q9GZX5	0	532	Q9GZX5	0	532	+	90	Q9GZX5#5	0	23	Q9GZX5	289	312	+	23	0	0	1264
Q9GZX5#6	0	23	23	Q9GZX5	317	340	+	23	Q9GZX5	0	532	Q9GZX5	0	532	+	90	Q9GZX5#6	0	23	Q9GZX5	317	340	+	23	0	0	1265
Q9GZX5#7	0	23	23	Q9GZX5	345	368	+	23	Q9GZX5	0	532	Q9GZX5	0	532	+	90	Q9GZX5#7	0	23	Q9GZX5	345	368	+	23	0	0	1266
Q9GZX5#8	0	23	23	Q9GZX5	373	396	+	23	Q9GZX5	0	532	Q9GZX5	0	532	+	90	Q9GZX5#8	0	23	Q9GZX5	373	396	+	23	0	0	1267
Q9GZX5#9	0	23	23	Q9GZX5	401	424	+	23	Q9GZX5	0	532	Q9GZX5	0	532	+	90	Q9GZX5#9	0	23	Q9GZX5	401	424	+	23	0	0	1268
Q9GZX5#10	0	39	39	Q9GZX5	426	465	+	39	Q9GZX5	0	532	Q9GZX5	0	532	+	90	Q9GZX5#10	0	39	Q9GZX5	426	465	+	39	0	0	1269
Q9GZX5#11	0	22	22	Q9GZX5	426	448	+	22	Q9GZX5	0	532	Q9GZX5	0	532	+	90	Q9GZX5#11	0	22	Q9GZX5	426	448	+	22	0	0	1270
Q9GZX5#12	0	17	17	Q9GZX5	448	465	+	17	Q9GZX5	0	532	Q9GZX5	0	532	+	90	Q9GZX5#12	0	17	Q9GZX5	448	465	+	17	0	0	1271
Q9GZX5#13	0	1	1	Q9GZX5	36	37	+	1	Q9GZX5	0	532	Q9GZX5	0	532	+	90	Q9GZX5#13	0	1	Q9GZX5	36	37	+	1	0	0	1272
Q9GZX5#14	0	1	1	Q9GZX5	65	66	+	1	Q9GZX5	0	532	Q9GZX5	0	532	+	90	Q9GZX5#14	0	1	Q9GZX5	65	66	+	1	0	0	1273
Q9GZX5#15	0	1	1	Q9GZX5	68	69	+	1	Q9GZX5	0	532	Q9GZX5	0	532	+	90	Q9GZX5#15	0	1	Q9GZX5	68	69	+	1	0	0	1274
Q9GZX5#16	0	1	1	Q9GZX5	131	132	+	1	Q9GZX5	0	532	Q9GZX5	0	532	+	90	Q9GZX5#16	0	1	Q9GZX5	131	132	+	1	0	0	1275
Q9GZX5#17	0	1	1	Q9GZX5	405	406	+	1	Q9GZX5	0	532	Q9GZX5	0	532	+	90	Q9GZX5#17	0	1	Q9GZX5	405	406	+	1	0	0	1276
Q9GZX5#18	0	1	1	Q9GZX5	471	472	+	1	Q9GZX5	0	532	Q9GZX5	0	532	+	90	Q9GZX5#18	0	1	Q9GZX5	471	472	+	1	0	0	1277
Q9GZX5#19	0	1	1	Q9GZX5	500	501	+	1	Q9GZX5	0	532	Q9GZX5	0	532	+	90	Q9GZX5#19	0	1	Q9GZX5	500	501	+	1	0	0	1278
Q9GZX5#20	0	1	1	Q9GZX5	523	524	+	1	Q9GZX5	0	532	Q9GZX5	0	532	+	90	Q9GZX5#20	0	1	Q9GZX5	523	524	+	1	0	0	1279
Q8N139-1#0	0	1617	1617	Q8N139-1	0	1617	+	1617	Q8N139-1	0	153	Q8N139-3	0	153	+	66	Q8N139-1#0	0	153	Q8N139-3	0	153	+	153	0	1464	1280
Q8N139-1#0	0	1617	1617	Q8N139-1	0	1617	+	1617	Q8N139-1	0	635	Q8N139-2	0	635	+	65	Q8N139-1#0	0	635	Q8N139-2	0	635	+	635	0	982	1281
Q8N139-1#0	0	1617	1617	Q8N139-1	0	1617	+	1617	Q8N139-1	0	1617	Q8N139-1	0	1617	+	64	Q8N139-1#0	0	1617	Q8N139-1	0	1617	+	1617	0	0	1282
Q8N139-1#1	0	21	21	Q8N139-1	30	51	+	21	Q8N139-1	0	153	Q8N139-3	0	153	+	66	Q8N139-1#1	0	21	Q8N139-3	30	51	+	21	0	0	1283
Q8N139-1#1	0	21	21	Q8N139-1	30	51	+	21	Q8N139-1	0	635	Q8N139-2	0	635	+	65	Q8N139-1#1	0	21	Q8N139-2	30	51	+	21	0	0	1284
Q8N139-1#1	0	21	21	Q8N139-1	30	51	+	21	Q8N139-1	0	1617	Q8N139-1	0	1617	+	64	Q8N139-1#1	0	21	Q8N139-1	30	51	+	21	0	0	1285
Q8N139-1#2	0	21	21	Q8N139-1	221	242	+	21	Q8N139-1	0	635	Q8N139-2	0	635	+	65	Q8N139-1#2	0	21	Q8N139-2	221	242	+	21	0	0	1286
Q8N139-1#2	0	21	21	Q8N139-1	221	242	+	21	Q8N139-1	0	1617	Q8N139-1	0	1617	+	64	Q8N139-1#2	0	21	Q8N139-1	221	242	+	21	0	0	1287
Q8N139-1#3	0	21	21	Q8N139-1	267	288	+	21	Q8N139-1	0	635	Q8N139-2	0	635	+	65	Q8N139-1#3	0	21	Q8N139-2	267	288	+	21	0	0	1288
Q8N139-1#3	0	21	21	Q8N139-1	267	288	+	21	Q8N139-1	0	1617	Q8N139-1	0	1617	+	64	Q8N139-1#3	0	21	Q8N139-1	267	288	+	21	0	0	1289
Q8N139-1#4	0	21	21	Q8N139-1	296	317	+	21	Q8N139-1	0	635	Q8N139-2	0	635	+	65	Q8N139-1#4	0	21	Q8N139-2	296	317	+	21	0	0	1290
Q8N139-1#4	0	21	21	Q8N139-1	296	317	+	21	Q8N139-1	0	1617	Q8N139-1	0	1617	+	64	Q8N139-1#4	0	21	Q8N139-1	296	317	+	21	0	0	1291
Q8N139-1#5	0	21	21	Q8N139-1	326	347	+	21	Q8N139-1	0	635	Q8N139-2	0	635	+	65	Q8N139-1#5	0	21	Q8N139-2	326	347	+	21	0	0	1292
Q8N139-1#5	0	21	21	Q8N139-1	326	347	+	21	Q8N139-1	0	1617	Q8N139-1	0	1617	+	64	Q8N139-1#5	0	21	Q8N139-1	326	347	+	21	0	0	1293
Q8N139-1#6	0	21	21	Q8N139-1	354	375	+	21	Q8N139-1	0	635	Q8N139-2	0	635	+	65	Q8N139-1#6	0	21	Q8N139-2	354	375	+	21	0	0	1294
Q8N139-1#6	0	21	21	Q8N139-1	354	375	+	21	Q8N139-1	0	1617	Q8N139-1	0	1617	+	64	Q8N139-1#6	0	21	Q8N139-1	354	375	+	21	0	0	1295
Q8N139-1#7	0	21	21	Q8N139-1	396	417	+	21	Q8N139-1	0	635	Q8N139-2	0	635	+	65	Q8N139-1#7	0	21	Q8N139-2	396	417	+	21	0	0	1296
Q8N139-1#7	0	21	21	Q8N139-1	396	417	+	21	Q8N139-1	0	1617	Q8N139-1	0	1617	+	64	Q8N139-1#7	0	21	Q8N139-1	396	417	+	21	0	0	1297
Q8N139-1#8	0	21	21	Q8N139-1	853	874	+	21	Q8N139-1	0	1617	Q8N139-1	0	1617	+	64	Q8N139-1#8	0	21	Q8N139-1	853	874	+	21	0	0	1298
Q8N139-1#9	0	21	21	Q8N139-1	1006	1027	+	21	Q8N139-1	0	1617	Q8N139-1	0	1617	+	64	Q8N139-1#9	0	21	Q8N139-1	1006	1027	+	21	0	0	1299
Q8N139-1#10	0	21	21	Q8N139-1	1061	1082	+	21	Q8N139-1	0	1617	Q8N139-1	0	1617	+	64	Q8N139-1#10	0	21	Q8N139-1	1061	1082	+	21	0	0	1300
Q8N139-1#11	0	21	21	Q8N139-1	1093	1114	+	21	Q8N139-1	0	1617	Q8N139-1	0	1617	+	64	Q8N139-1#11	0	21	Q8N139-1	1093	1114	+	21	0	0	1301
Q8N139-1#12	0	21	21	Q8N139-1	1126	1147	+	21	Q8N139-1	0	1617	Q8N139-1	0	1617	+	64	Q8N139-1#12	0	21	Q8N139-1	1126	1147	+	21	0	0	1302
Q8N139-1#13	0	21	21	Q8N139-1	1149	1170	+	21	Q8N139-1	0	1617	Q8N139-1	0	1617	+	64	Q8N139-1#13	0	21	Q8N139-1	1149	1170	+	21	0	0	1303
Q8N139-1#14	0	21	21	Q8N139-1	1193	1214	+	21	Q8N139-1	0	1617	Q8N139-1	0	1617	+	64	Q8N139-1#14	0	21	Q8N139-1	1193	1214	+	21	0	0	1304
Q8N139-1#15	0	236	236	Q8N139-1	477	713	+	236	Q8N139-1	0	635	Q8N139-2	0	635	+	65	Q8N139-1#15	0	158	Q8N139-2	477	635	+	158	0	78	1305
Q8N139-1#15	0	236	236	Q8N139-1	477	713	+	236	Q8N139-1	0	1617	Q8N139-1	0	1617	+	64	Q8N139-1#15	0	236	Q8N139-1	477	713	+	236	0	0	1306
Q8N139-1#16	0	226	226	Q8N139-1	1287	1513	+	226	Q8N139-1	0	1617	Q8N139-1	0	1617	+	64	Q8N139-1#16	0	226	Q8N139-1	1287	1513	+	226	0	0	1307
Q8N139-1#17	0	8	8	Q8N139-1	513	521	+	8	Q8N139-1	0	635	Q8N139-2	0	635	+	65	Q8N139-1#17	0	8	Q8N139-2	513	521	+	8	0	0	1308
Q8N139-1#17	0	8	8	Q8N139-1	513	521	+	8	Q8N139-1	0	1617	Q8N139-1	0	1617	+	64	Q8N139-1#17	0	8	Q8N139-1	513	521	+	8	0	0	1309
Q8N139-1#18	0	8	8	Q8N139-1	1319	1327	+	8	Q8N139-1	0	1617	Q8N139-1	0	1617	+	64	Q8N139-1#18	0	8	Q8N139-1	1319	1327	+	8	0	0	1310
Q8N139-1#19	0	1	1	Q8N139-1	83	84	+	1	Q8N139-1	0	153	Q8N139-3	0	153	+	66	Q8N139-1#19	0	1	Q8N139-3	83	84	+	1	0	0	1311
Q8N139-1#19	0	1	1	Q8N139-1	83	84	+	1	Q8N139-1	0	635	Q8N139-2	0	635	+	65	Q8N139-1#19	0	1	Q8N139-2	83	84	+	1	0	0	1312
Q8N139-1#19	0	1	1	Q8N139-1	83	84	+	1	Q8N139-1	0	1617	Q8N139-1	0	1617	+	64	Q8N139-1#19	0	1	Q8N139-1	83	84	+	1	0	0	1313
Q8N139-1#20	0	1	1	Q8N139-1	108	109	+	1	Q8N139-1	0	153	Q8N139-3	0	153	+	66	Q8N139-1#20	0	1	Q8N139-3	108	109	+	1	0	0	1314
Q8N139-1#20	0	1	1	Q8N139-1	108	109	+	1	Q8N139-1	0	635	Q8N139-2	0	635	+	65	Q8N139-1#20	0	1	Q8N139-2	108	109	+	1	0	0	1315
Q8N139-1#20	0	1	1	Q8N139-1	108	109	+	1	Q8N139-1	0	1617	Q8N139-1	0	1617	+	64	Q8N139-1#20	0	1	Q8N139-1	108	109	+	1	0	0	1316
Q8N139-1#21	0	1	1	Q8N139-1	939	940	+	1	Q8N139-1	0	1617	Q8N139-1	0	1617	+	64	Q8N139-1#21	0	1	Q8N139-1	939	940	+	1	0	0	1317
Q8N139-1#22	0	32	32	Q8N139-1	153	185	+	32	Q8N139-1	0	635	Q8N139-2	0	635	+	65	Q8N139-1#22	0	32	Q8N139-2	153	185	+	32	0	0	1318
Q8N139-1#22	0	32	32	Q8N139-1	153	185	+	32	Q8N139-1	0	1617	Q8N139-1	0	1617	+	64	Q8N139-1#22	0	32	Q8N139-1	153	185	+	32	0	0	1319
Q8N139-1#23	0	1432	1432	Q8N139-1	185	1617	+	1432	Q8N139-1	0	635	Q8N139-2	0	635	+	65	Q8N139-1#23	0	450	Q8N139-2	185	635	+	450	0	982	1320
Q8N139-1#23	0	1432	1432	Q8N139-1	185	1617	+	1432	Q8N139-1	0	1617	Q8N139-1	0	1617	+	64	Q8N139-1#23	0	1432	Q8N139-1	185	1617	+	1432	0	0	1321
Q8N139-1#24	0	2	2	Q8N139-1	635	637	+	2	Q8N139-1	0	1617	Q8N139-1	0	1617	+	64	Q8N139-1#24	0	2	Q8N139-1	635	637	+	2	0	0	1322
Q8N139-1#25	0	980	980	Q8N139-1	637	1617	+	980	Q8N139-1	0	1617	Q8N139-1	0	1617	+	64	Q8N139-1#25	0	980	Q8N139-1	637	1617	+	980	0	0	1323
Q8N139-1#26	0	1	1	Q8N139-1	281	282	+	1	Q8N139-1	0	635	Q8N139-2	0	635	+	65	Q8N139-1#26	0	1	Q8N139-2	281	282	+	1	0	0	1324
Q8N139-1#26	0	1	1	Q8N139-1	281	282	+	1	Q8N139-1	0	1617	Q8N139-1	0	1617	+	64	Q8N139-1#26	0	1	Q8N139-1	281	282	+	1	0	0	1325
Q8N139-1#27	0	1	1	Q8N139-1	609	610	+	1	Q8N139-1	0	635	Q8N139-2	0	635	+	65	Q8N139-1#27	0	1	Q8N139-2	609	610	+	1	0	0	1326
Q8N139-1#27	0	1	1	Q8N139-1	609	610	+	1	Q8N139-1	0	1617	Q8N139-1	0	1617	+	64	Q8N139-1#27	0	1	Q8N139-1	609	610	+	1	0	0	1327
Q8N139-1#28	0	1	1	Q8N139-1	697	698	+	1	Q8N139-1	0	1617	Q8N139-1	0	1617	+	64	Q8N139-1#28	0	1	Q8N139-1	697	698	+	1	0	0	1328
Q8N139-1#29	0	1	1	Q8N139-1	874	875	+	1	Q8N139-1	0	1617	Q8N139-1	0	1617	+	64	Q8N139-1#29	0	1	Q8N139-1	874	875	+	1	0	0	1329
Q8N139-1#30	0	1	1	Q8N139-1	1321	1322	+	1	Q8N139-1	0	1617	Q8N139-1	0	1617	+	64	Q8N139-1#30	0	1	Q8N139-1	1321	1322	+	1	0	0	1330
Q8N139-1#31	0	1	1	Q8N139-1	50	51	+	1	Q8N139-1	0	153	Q8N139-3	0	153	+	66	Q8N139-1#31	0	1	Q8N139-3	50	51	+	1	0	0	1331
Q8N139-1#31	0	1	1	Q8N139-1	50	51	+	1	Q8N139-1	0	635	Q8N139-2	0	635	+	65	Q8N139-1#31	0	1	Q8N139-2	50	51	+	1	0	0	1332
Q8N139-1#31	0	1	1	Q8N139-1	50	51	+	1	Q8N139-1	0	1617	Q8N139-1	0	1617	+	64	Q8N139-1#31	0	1	Q8N139-1	50	51	+	1	0	0	1333
Q8N139-1#32	0	1	1	Q8N139-1	146	147	+	1	Q8N139-1	0	153	Q8N139-3	0	153	+	66	Q8N139-1#32	0	1	Q8N139-3	146	147	+	1	0	0	1334
Q8N139-1#32	0	1	1	Q8N139-1	146	147	+	1	Q8N139-1	0	635	Q8N139-2	0	635	+	65	Q8N139-1#32	0	1	Q8N139-2	146	147	+	1	0	0	1335
Q8N139-1#32	0	1	1	Q8N139-1	146	147	+	1	Q8N139-1	0	1617	Q8N139-1	0	1617	+	64	Q8N139-1#32	0	1	Q8N139-1	146	147	+	1	0	0	1336
Q8N139-1#33	0	1	1	Q8N139-1	811	812	+	1	Q8N139-1	0	1617	Q8N139-1	0	1617	+	64	Q8N139-1#33	0	1	Q8N139-1	811	812	+	1	0	0	1337
Q8N139-1#34	0	2	2	Q8N139-1	874	876	+	2	Q8N139-1	0	1617	Q8N139-1	0	1617	+	64	Q8N139-1#34	0	2	Q8N139-1	874	876	+	2	0	0	1338
Q8IZY2-1#0	0	2146	2146	Q8IZY2-1	0	2146	+	2146	Q8IZY2-1	166	2146	Q8IZY2-2	28	2008	+	63	Q8IZY2-1#0	166	2146	Q8IZY2-2	28	2008	+	1980	166	0	1339
Q8IZY2-1#0	0	2146	2146	Q8IZY2-1	0	2146	+	2146	Q8IZY2-1	0	2146	Q8IZY2-1	0	2146	+	62	Q8IZY2-1#0	0	2146	Q8IZY2-1	0	2146	+	2146	0	0	1340
Q8IZY2-1#1	0	21	21	Q8IZY2-1	21	42	+	21	Q8IZY2-1	0	2146	Q8IZY2-1	0	2146	+	62	Q8IZY2-1#1	0	21	Q8IZY2-1	21	42	+	21	0	0	1341
Q8IZY2-1#2	0	507	507	Q8IZY2-1	42	549	+	507	Q8IZY2-1	166	2146	Q8IZY2-2	28	2008	+	63	Q8IZY2-1#2	124	507	Q8IZY2-2	28	411	+	383	124	0	1342
Q8IZY2-1#2	0	507	507	Q8IZY2-1	42	549	+	507	Q8IZY2-1	0	2146	Q8IZY2-1	0	2146	+	62	Q8IZY2-1#2	0	507	Q8IZY2-1	42	549	+	507	0	0	1343
Q8IZY2-1#3	0	21	21	Q8IZY2-1	549	570	+	21	Q8IZY2-1	166	2146	Q8IZY2-2	28	2008	+	63	Q8IZY2-1#3	0	21	Q8IZY2-2	411	432	+	21	0	0	1344
Q8IZY2-1#3	0	21	21	Q8IZY2-1	549	570	+	21	Q8IZY2-1	0	2146	Q8IZY2-1	0	2146	+	62	Q8IZY2-1#3	0	21	Q8IZY2-1	549	570	+	21	0	0	1345
Q8IZY2-1#4	0	21	21	Q8IZY2-1	592	613	+	21	Q8IZY2-1	166	2146	Q8IZY2-2	28	2008	+	63	Q8IZY2-1#4	0	21	Q8IZY2-2	454	475	+	21	0	0	1346
Q8IZY2-1#4	0	21	21	Q8IZY2-1	592	613	+	21	Q8IZY2-1	0	2146	Q8IZY2-1	0	2146	+	62	Q8IZY2-1#4	0	21	Q8IZY2-1	592	613	+	21	0	0	1347
Q8IZY2-1#5	0	21	21	Q8IZY2-1	625	646	+	21	Q8IZY2-1	166	2146	Q8IZY2-2	28	2008	+	63	Q8IZY2-1#5	0	21	Q8IZY2-2	487	508	+	21	0	0	1348
Q8IZY2-1#5	0	21	21	Q8IZY2-1	625	646	+	21	Q8IZY2-1	0	2146	Q8IZY2-1	0	2146	+	62	Q8IZY2-1#5	0	21	Q8IZY2-1	625	646	+	21	0	0	1349
Q8IZY2-1#6	0	21	21	Q8IZY2-1	654	675	+	21	Q8IZY2-1	166	2146	Q8IZY2-2	28	2008	+	63	Q8IZY2-1#6	0	21	Q8IZY2-2	516	537	+	21	0	0	1350
Q8IZY2-1#6	0	21	21	Q8IZY2-1	654	675	+	21	Q8IZY2-1	0	2146	Q8IZY2-1	0	2146	+	62	Q8IZY2-1#6	0	21	Q8IZY2-1	654	675	+	21	0	0	1351
Q8IZY2-1#7	0	21	21	Q8IZY2-1	686	707	+	21	Q8IZY2-1	166	2146	Q8IZY2-2	28	2008	+	63	Q8IZY2-1#7	0	21	Q8IZY2-2	548	569	+	21	0	0	1352
Q8IZY2-1#7	0	21	21	Q8IZY2-1	686	707	+	21	Q8IZY2-1	0	2146	Q8IZY2-1	0	2146	+	62	Q8IZY2-1#7	0	21	Q8IZY2-1	686	707	+	21	0	0	1353
Q8IZY2-1#8	0	21	21	Q8IZY2-1	726	747	+	21	Q8IZY2-1	166	2146	Q8IZY2-2	28	2008	+	63	Q8IZY2-1#8	0	21	Q8IZY2-2	588	609	+	21	0	0	1354
Q8IZY2-1#8	0	21	21	Q8IZY2-1	726	747	+	21	Q8IZY2-1	0	2146	Q8IZY2-1	0	2146	+	62	Q8IZY2-1#8	0	21	Q8IZY2-1	726	747	+	21	0	0	1355
Q8IZY2-1#9	0	21	21	Q8IZY2-1	848	869	+	21	Q8IZY2-1	166	2146	Q8IZY2-2	28	2008	+	63	Q8IZY2-1#9	0	21	Q8IZY2-2	710	731	+	21	0	0	1356
Q8IZY2-1#9	0	21	21	Q8IZY2-1	848	869	+	21	Q8IZY2-1	0	2146	Q8IZY2-1	0	2146	+	62	Q8IZY2-1#9	0	21	Q8IZY2-1	848	869	+	21	0	0	1357
Q8IZY2-1#10	0	21	21	Q8IZY2-1	1242	1263	+	21	Q8IZY2-1	166	2146	Q8IZY2-2	28	2008	+	63	Q8IZY2-1#10	0	21	Q8IZY2-2	1104	1125	+	21	0	0	1358
Q8IZY2-1#10	0	21	21	Q8IZY2-1	1242	1263	+	21	Q8IZY2-1	0	2146	Q8IZY2-1	0	2146	+	62	Q8IZY2-1#10	0	21	Q8IZY2-1	1242	1263	+	21	0	0	1359
Q8IZY2-1#11	0	274	274	Q8IZY2-1	1263	1537	+	274	Q8IZY2-1	166	2146	Q8IZY2-2	28	2008	+	63	Q8IZY2-1#11	0	274	Q8IZY2-2	1125	1399	+	274	0	0	1360
Q8IZY2-1#11	0	274	274	Q8IZY2-1	1263	1537	+	274	Q8IZY2-1	0	2146	Q8IZY2-1	0	2146	+	62	Q8IZY2-1#11	0	274	Q8IZY2-1	1263	1537	+	274	0	0	1361
Q8IZY2-1#12	0	21	21	Q8IZY2-1	1537	1558	+	21	Q8IZY2-1	166	2146	Q8IZY2-2	28	2008	+	63	Q8IZY2-1#12	0	21	Q8IZY2-2	1399	1420	+	21	0	0	1362
Q8IZY2-1#12	0	21	21	Q8IZY2-1	1537	1558	+	21	Q8IZY2-1	0	2146	Q8IZY2-1	0	2146	+	62	Q8IZY2-1#12	0	21	Q8IZY2-1	1537	1558	+	21	0	0	1363
Q8IZY2-1#13	0	21	21	Q8IZY2-1	1583	1604	+	21	Q8IZY2-1	166	2146	Q8IZY2-2	28	2008	+	63	Q8IZY2-1#13	0	21	Q8IZY2-2	1445	1466	+	21	0	0	1364
Q8IZY2-1#13	0	21	21	Q8IZY2-1	1583	1604	+	21	Q8IZY2-1	0	2146	Q8IZY2-1	0	2146	+	62	Q8IZY2-1#13	0	21	Q8IZY2-1	1583	1604	+	21	0	0	1365
Q8IZY2-1#14	0	21	21	Q8IZY2-1	1620	1641	+	21	Q8IZY2-1	166	2146	Q8IZY2-2	28	2008	+	63	Q8IZY2-1#14	0	21	Q8IZY2-2	1482	1503	+	21	0	0	1366
Q8IZY2-1#14	0	21	21	Q8IZY2-1	1620	1641	+	21	Q8IZY2-1	0	2146	Q8IZY2-1	0	2146	+	62	Q8IZY2-1#14	0	21	Q8IZY2-1	1620	1641	+	21	0	0	1367
Q8IZY2-1#15	0	21	21	Q8IZY2-1	1648	1669	+	21	Q8IZY2-1	166	2146	Q8IZY2-2	28	2008	+	63	Q8IZY2-1#15	0	21	Q8IZY2-2	1510	1531	+	21	0	0	1368
Q8IZY2-1#15	0	21	21	Q8IZY2-1	1648	1669	+	21	Q8IZY2-1	0	2146	Q8IZY2-1	0	2146	+	62	Q8IZY2-1#15	0	21	Q8IZY2-1	1648	1669	+	21	0	0	1369
Q8IZY2-1#16	0	21	21	Q8IZY2-1	1682	1703	+	21	Q8IZY2-1	166	2146	Q8IZY2-2	28	2008	+	63	Q8IZY2-1#16	0	21	Q8IZY2-2	1544	1565	+	21	0	0	1370
Q8IZY2-1#16	0	21	21	Q8IZY2-1	1682	1703	+	21	Q8IZY2-1	0	2146	Q8IZY2-1	0	2146	+	62	Q8IZY2-1#16	0	21	Q8IZY2-1	1682	1703	+	21	0	0	1371
Q8IZY2-1#17	0	21	21	Q8IZY2-1	1728	1749	+	21	Q8IZY2-1	166	2146	Q8IZY2-2	28	2008	+	63	Q8IZY2-1#17	0	21	Q8IZY2-2	1590	1611	+	21	0	0	1372
Q8IZY2-1#17	0	21	21	Q8IZY2-1	1728	1749	+	21	Q8IZY2-1	0	2146	Q8IZY2-1	0	2146	+	62	Q8IZY2-1#17	0	21	Q8IZY2-1	1728	1749	+	21	0	0	1373
Q8IZY2-1#18	0	232	232	Q8IZY2-1	806	1038	+	232	Q8IZY2-1	166	2146	Q8IZY2-2	28	2008	+	63	Q8IZY2-1#18	0	232	Q8IZY2-2	668	900	+	232	0	0	1374
Q8IZY2-1#18	0	232	232	Q8IZY2-1	806	1038	+	232	Q8IZY2-1	0	2146	Q8IZY2-1	0	2146	+	62	Q8IZY2-1#18	0	232	Q8IZY2-1	806	1038	+	232	0	0	1375
Q8IZY2-1#19	0	233	233	Q8IZY2-1	1792	2025	+	233	Q8IZY2-1	166	2146	Q8IZY2-2	28	2008	+	63	Q8IZY2-1#19	0	233	Q8IZY2-2	1654	1887	+	233	0	0	1376
Q8IZY2-1#19	0	233	233	Q8IZY2-1	1792	2025	+	233	Q8IZY2-1	0	2146	Q8IZY2-1	0	2146	+	62	Q8IZY2-1#19	0	233	Q8IZY2-1	1792	2025	+	233	0	0	1377
Q8IZY2-1#20	0	25	25	Q8IZY2-1	1047	1072	+	25	Q8IZY2-1	166	2146	Q8IZY2-2	28	2008	+	63	Q8IZY2-1#20	0	25	Q8IZY2-2	909	934	+	25	0	0	1378
Q8IZY2-1#20	0	25	25	Q8IZY2-1	1047	1072	+	25	Q8IZY2-1	0	2146	Q8IZY2-1	0	2146	+	62	Q8IZY2-1#20	0	25	Q8IZY2-1	1047	1072	+	25	0	0	1379
Q8IZY2-1#21	0	25	25	Q8IZY2-1	1184	1209	+	25	Q8IZY2-1	166	2146	Q8IZY2-2	28	2008	+	63	Q8IZY2-1#21	0	25	Q8IZY2-2	1046	1071	+	25	0	0	1380
Q8IZY2-1#21	0	25	25	Q8IZY2-1	1184	1209	+	25	Q8IZY2-1	0	2146	Q8IZY2-1	0	2146	+	62	Q8IZY2-1#21	0	25	Q8IZY2-1	1184	1209	+	25	0	0	1381
Q8IZY2-1#22	0	43	43	Q8IZY2-1	2103	2146	+	43	Q8IZY2-1	166	2146	Q8IZY2-2	28	2008	+	63	Q8IZY2-1#22	0	43	Q8IZY2-2	1965	2008	+	43	0	0	1382
Q8IZY2-1#22	0	43	43	Q8IZY2-1	2103	2146	+	43	Q8IZY2-1	0	2146	Q8IZY2-1	0	2146	+	62	Q8IZY2-1#22	0	43	Q8IZY2-1	2103	2146	+	43	0	0	1383
Q8IZY2-1#23	0	19	19	Q8IZY2-1	1047	1066	+	19	Q8IZY2-1	166	2146	Q8IZY2-2	28	2008	+	63	Q8IZY2-1#23	0	19	Q8IZY2-2	909	928	+	19	0	0	1384
Q8IZY2-1#23	0	19	19	Q8IZY2-1	1047	1066	+	19	Q8IZY2-1	0	2146	Q8IZY2-1	0	2146	+	62	Q8IZY2-1#23	0	19	Q8IZY2-1	1047	1066	+	19	0	0	1385
Q8IZY2-1#24	0	8	8	Q8IZY2-1	840	848	+	8	Q8IZY2-1	166	2146	Q8IZY2-2	28	2008	+	63	Q8IZY2-1#24	0	8	Q8IZY2-2	702	710	+	8	0	0	1386
Q8IZY2-1#24	0	8	8	Q8IZY2-1	840	848	+	8	Q8IZY2-1	0	2146	Q8IZY2-1	0	2146	+	62	Q8IZY2-1#24	0	8	Q8IZY2-1	840	848	+	8	0	0	1387
Q8IZY2-1#25	0	8	8	Q8IZY2-1	1826	1834	+	8	Q8IZY2-1	166	2146	Q8IZY2-2	28	2008	+	63	Q8IZY2-1#25	0	8	Q8IZY2-2	1688	1696	+	8	0	0	1388
Q8IZY2-1#25	0	8	8	Q8IZY2-1	1826	1834	+	8	Q8IZY2-1	0	2146	Q8IZY2-1	0	2146	+	62	Q8IZY2-1#25	0	8	Q8IZY2-1	1826	1834	+	8	0	0	1389
Q8IZY2-1#26	0	1	1	Q8IZY2-1	311	312	+	1	Q8IZY2-1	166	2146	Q8IZY2-2	28	2008	+	63	Q8IZY2-1#26	0	1	Q8IZY2-2	173	174	+	1	0	0	1390
Q8IZY2-1#26	0	1	1	Q8IZY2-1	311	312	+	1	Q8IZY2-1	0	2146	Q8IZY2-1	0	2146	+	62	Q8IZY2-1#26	0	1	Q8IZY2-1	311	312	+	1	0	0	1391
Q8IZY2-1#27	0	151	151	Q8IZY2-1	74	225	+	151	Q8IZY2-1	166	2146	Q8IZY2-2	28	2008	+	63	Q8IZY2-1#27	92	151	Q8IZY2-2	28	87	+	59	92	0	1392
Q8IZY2-1#27	0	151	151	Q8IZY2-1	74	225	+	151	Q8IZY2-1	0	2146	Q8IZY2-1	0	2146	+	62	Q8IZY2-1#27	0	151	Q8IZY2-1	74	225	+	151	0	0	1393
Q8IZY2-1#28	0	15	15	Q8IZY2-1	1344	1359	+	15	Q8IZY2-1	166	2146	Q8IZY2-2	28	2008	+	63	Q8IZY2-1#28	0	15	Q8IZY2-2	1206	1221	+	15	0	0	1394
Q8IZY2-1#28	0	15	15	Q8IZY2-1	1344	1359	+	15	Q8IZY2-1	0	2146	Q8IZY2-1	0	2146	+	62	Q8IZY2-1#28	0	15	Q8IZY2-1	1344	1359	+	15	0	0	1395
Q8IZY2-1#29	0	138	138	Q8IZY2-1	0	138	+	138	Q8IZY2-1	0	2146	Q8IZY2-1	0	2146	+	62	Q8IZY2-1#29	0	138	Q8IZY2-1	0	138	+	138	0	0	1396
Q8IZY2-1#30	0	28	28	Q8IZY2-1	138	166	+	28	Q8IZY2-1	0	2146	Q8IZY2-1	0	2146	+	62	Q8IZY2-1#30	0	28	Q8IZY2-1	138	166	+	28	0	0	1397
Q8IZY2-1#31	0	1	1	Q8IZY2-1	187	188	+	1	Q8IZY2-1	166	2146	Q8IZY2-2	28	2008	+	63	Q8IZY2-1#31	0	1	Q8IZY2-2	49	50	+	1	0	0	1398
Q8IZY2-1#31	0	1	1	Q8IZY2-1	187	188	+	1	Q8IZY2-1	0	2146	Q8IZY2-1	0	2146	+	62	Q8IZY2-1#31	0	1	Q8IZY2-1	187	188	+	1	0	0	1399
Q8IZY2-1#32	0	1	1	Q8IZY2-1	318	319	+	1	Q8IZY2-1	166	2146	Q8IZY2-2	28	2008	+	63	Q8IZY2-1#32	0	1	Q8IZY2-2	180	181	+	1	0	0	1400
Q8IZY2-1#32	0	1	1	Q8IZY2-1	318	319	+	1	Q8IZY2-1	0	2146	Q8IZY2-1	0	2146	+	62	Q8IZY2-1#32	0	1	Q8IZY2-1	318	319	+	1	0	0	1401
Q8IZY2-1#33	0	1	1	Q8IZY2-1	394	395	+	1	Q8IZY2-1	166	2146	Q8IZY2-2	28	2008	+	63	Q8IZY2-1#33	0	1	Q8IZY2-2	256	257	+	1	0	0	1402
Q8IZY2-1#33	0	1	1	Q8IZY2-1	394	395	+	1	Q8IZY2-1	0	2146	Q8IZY2-1	0	2146	+	62	Q8IZY2-1#33	0	1	Q8IZY2-1	394	395	+	1	0	0	1403
Q8IZY2-1#34	0	1	1	Q8IZY2-1	462	463	+	1	Q8IZY2-1	166	2146	Q8IZY2-2	28	2008	+	63	Q8IZY2-1#34	0	1	Q8IZY2-2	324	325	+	1	0	0	1404
Q8IZY2-1#34	0	1	1	Q8IZY2-1	462	463	+	1	Q8IZY2-1	0	2146	Q8IZY2-1	0	2146	+	62	Q8IZY2-1#34	0	1	Q8IZY2-1	462	463	+	1	0	0	1405
Q8IZY2-1#35	0	1	1	Q8IZY2-1	675	676	+	1	Q8IZY2-1	166	2146	Q8IZY2-2	28	2008	+	63	Q8IZY2-1#35	0	1	Q8IZY2-2	537	538	+	1	0	0	1406
Q8IZY2-1#35	0	1	1	Q8IZY2-1	675	676	+	1	Q8IZY2-1	0	2146	Q8IZY2-1	0	2146	+	62	Q8IZY2-1#35	0	1	Q8IZY2-1	675	676	+	1	0	0	1407
Q8IZY2-1#36	0	1	1	Q8IZY2-1	717	718	+	1	Q8IZY2-1	166	2146	Q8IZY2-2	28	2008	+	63	Q8IZY2-1#36	0	1	Q8IZY2-2	579	580	+	1	0	0	1408
Q8IZY2-1#36	0	1	1	Q8IZY2-1	717	718	+	1	Q8IZY2-1	0	2146	Q8IZY2-1	0	2146	+	62	Q8IZY2-1#36	0	1	Q8IZY2-1	717	718	+	1	0	0	1409
Q8IZY2-1#37	0	1	1	Q8IZY2-1	879	880	+	1	Q8IZY2-1	166	2146	Q8IZY2-2	28	2008	+	63	Q8IZY2-1#37	0	1	Q8IZY2-2	741	742	+	1	0	0	1410
Q8IZY2-1#37	0	1	1	Q8IZY2-1	879	880	+	1	Q8IZY2-1	0	2146	Q8IZY2-1	0	2146	+	62	Q8IZY2-1#37	0	1	Q8IZY2-1	879	880	+	1	0	0	1411
Q8IZY2-1#38	0	1	1	Q8IZY2-1	1348	1349	+	1	Q8IZY2-1	166	2146	Q8IZY2-2	28	2008	+	63	Q8IZY2-1#38	0	1	Q8IZY2-2	1210	1211	+	1	0	0	1412
Q8IZY2-1#38	0	1	1	Q8IZY2-1	1348	1349	+	1	Q8IZY2-1	0	2146	Q8IZY2-1	0	2146	+	62	Q8IZY2-1#38	0	1	Q8IZY2-1	1348	1349	+	1	0	0	1413
Q8IZY2-1#39	0	1	1	Q8IZY2-1	1526	1527	+	1	Q8IZY2-1	166	2146	Q8IZY2-2	28	2008	+	63	Q8IZY2-1#39	0	1	Q8IZY2-2	1388	1389	+	1	0	0	1414
Q8IZY2-1#39	0	1	1	Q8IZY2-1	1526	1527	+	1	Q8IZY2-1	0	2146	Q8IZY2-1	0	2146	+	62	Q8IZY2-1#39	0	1	Q8IZY2-1	1526	1527	+	1	0	0	1415
Q8IZY2-1#40	0	1	1	Q8IZY2-1	1685	1686	+	1	Q8IZY2-1	166	2146	Q8IZY2-2	28	2008	+	63	Q8IZY2-1#40	0	1	Q8IZY2-2	1547	1548	+	1	0	0	1416
Q8IZY2-1#40	0	1	1	Q8IZY2-1	1685	1686	+	1	Q8IZY2-1	0	2146	Q8IZY2-1	0	2146	+	62	Q8IZY2-1#40	0	1	Q8IZY2-1	1685	1686	+	1	0	0	1417
Q8IZY2-1#41	0	1	1	Q8IZY2-1	2044	2045	+	1	Q8IZY2-1	166	2146	Q8IZY2-2	28	2008	+	63	Q8IZY2-1#41	0	1	Q8IZY2-2	1906	1907	+	1	0	0	1418
Q8IZY2-1#41	0	1	1	Q8IZY2-1	2044	2045	+	1	Q8IZY2-1	0	2146	Q8IZY2-1	0	2146	+	62	Q8IZY2-1#41	0	1	Q8IZY2-1	2044	2045	+	1	0	0	1419
Q8IZY2-1#42	0	1	1	Q8IZY2-1	1502	1503	+	1	Q8IZY2-1	166	2146	Q8IZY2-2	28	2008	+	63	Q8IZY2-1#42	0	1	Q8IZY2-2	1364	1365	+	1	0	0	1420
Q8IZY2-1#42	0	1	1	Q8IZY2-1	1502	1503	+	1	Q8IZY2-1	0	2146	Q8IZY2-1	0	2146	+	62	Q8IZY2-1#42	0	1	Q8IZY2-1	1502	1503	+	1	0	0	1421
Q8IZY2-1#43	0	1	1	Q8IZY2-1	1524	1525	+	1	Q8IZY2-1	166	2146	Q8IZY2-2	28	2008	+	63	Q8IZY2-1#43	0	1	Q8IZY2-2	1386	1387	+	1	0	0	1422
Q8IZY2-1#43	0	1	1	Q8IZY2-1	1524	1525	+	1	Q8IZY2-1	0	2146	Q8IZY2-1	0	2146	+	62	Q8IZY2-1#43	0	1	Q8IZY2-1	1524	1525	+	1	0	0	1423
O94911-3#0	0	1621	1621	O94911-3	0	1621	+	1621	O94911-3	0	1621	O94911-3	0	1621	+	6	O94911-3#0	0	1621	O94911-3	0	1621	+	1621	0	0	1424
O94911-3#0	0	1621	1621	O94911-3	0	1621	+	1621	O94911-3	0	266	O94911-2	0	266	+	5	O94911-3#0	0	266	O94911-2	0	266	+	266	0	1355	1425
O94911-3#0	0	1621	1621	O94911-3	0	1621	+	1621	O94911-3	0	1621	O94911-1	0	1581	+	4	O94911-3#0	0	1621	O94911-1	0	1581	+	1581	0	0	1426
O94911-3#1	0	21	21	O94911-3	29	50	+	21	O94911-3	0	1621	O94911-3	0	1621	+	6	O94911-3#1	0	21	O94911-3	29	50	+	21	0	0	1427
O94911-3#1	0	21	21	O94911-3	29	50	+	21	O94911-3	0	266	O94911-2	0	266	+	5	O94911-3#1	0	21	O94911-2	29	50	+	21	0	0	1428
O94911-3#1	0	21	21	O94911-3	29	50	+	21	O94911-3	0	1621	O94911-1	0	1581	+	4	O94911-3#1	0	21	O94911-1	29	50	+	21	0	0	1429
O94911-3#2	0	21	21	O94911-3	219	240	+	21	O94911-3	0	1621	O94911-3	0	1621	+	6	O94911-3#2	0	21	O94911-3	219	240	+	21	0	0	1430
O94911-3#2	0	21	21	O94911-3	219	240	+	21	O94911-3	0	266	O94911-2	0	266	+	5	O94911-3#2	0	21	O94911-2	219	240	+	21	0	0	1431
O94911-3#2	0	21	21	O94911-3	219	240	+	21	O94911-3	0	1621	O94911-1	0	1581	+	4	O94911-3#2	0	21	O94911-1	219	240	+	21	0	0	1432
O94911-3#3	0	21	21	O94911-3	267	288	+	21	O94911-3	0	1621	O94911-3	0	1621	+	6	O94911-3#3	0	21	O94911-3	267	288	+	21	0	0	1433
O94911-3#3	0	21	21	O94911-3	267	288	+	21	O94911-3	0	1621	O94911-1	0	1581	+	4	O94911-3#3	0	21	O94911-1	267	288	+	21	0	0	1434
O94911-3#4	0	21	21	O94911-3	298	319	+	21	O94911-3	0	1621	O94911-3	0	1621	+	6	O94911-3#4	0	21	O94911-3	298	319	+	21	0	0	1435
O94911-3#4	0	21	21	O94911-3	298	319	+	21	O94911-3	0	1621	O94911-1	0	1581	+	4	O94911-3#4	0	21	O94911-1	298	319	+	21	0	0	1436
O94911-3#5	0	21	21	O94911-3	326	347	+	21	O94911-3	0	1621	O94911-3	0	1621	+	6	O94911-3#5	0	21	O94911-3	326	347	+	21	0	0	1437
O94911-3#5	0	21	21	O94911-3	326	347	+	21	O94911-3	0	1621	O94911-1	0	1581	+	4	O94911-3#5	0	21	O94911-1	326	347	+	21	0	0	1438
O94911-3#6	0	21	21	O94911-3	358	379	+	21	O94911-3	0	1621	O94911-3	0	1621	+	6	O94911-3#6	0	21	O94911-3	358	379	+	21	0	0	1439
O94911-3#6	0	21	21	O94911-3	358	379	+	21	O94911-3	0	1621	O94911-1	0	1581	+	4	O94911-3#6	0	21	O94911-1	358	379	+	21	0	0	1440
O94911-3#7	0	21	21	O94911-3	396	417	+	21	O94911-3	0	1621	O94911-3	0	1621	+	6	O94911-3#7	0	21	O94911-3	396	417	+	21	0	0	1441
O94911-3#7	0	21	21	O94911-3	396	417	+	21	O94911-3	0	1621	O94911-1	0	1581	+	4	O94911-3#7	0	21	O94911-1	396	417	+	21	0	0	1442
O94911-3#8	0	21	21	O94911-3	863	884	+	21	O94911-3	0	1621	O94911-3	0	1621	+	6	O94911-3#8	0	21	O94911-3	863	884	+	21	0	0	1443
O94911-3#8	0	21	21	O94911-3	863	884	+	21	O94911-3	0	1621	O94911-1	0	1581	+	4	O94911-3#8	0	21	O94911-1	823	844	+	21	0	0	1444
O94911-3#9	0	21	21	O94911-3	1018	1039	+	21	O94911-3	0	1621	O94911-3	0	1621	+	6	O94911-3#9	0	21	O94911-3	1018	1039	+	21	0	0	1445
O94911-3#9	0	21	21	O94911-3	1018	1039	+	21	O94911-3	0	1621	O94911-1	0	1581	+	4	O94911-3#9	0	21	O94911-1	978	999	+	21	0	0	1446
O94911-3#10	0	21	21	O94911-3	1069	1090	+	21	O94911-3	0	1621	O94911-3	0	1621	+	6	O94911-3#10	0	21	O94911-3	1069	1090	+	21	0	0	1447
O94911-3#10	0	21	21	O94911-3	1069	1090	+	21	O94911-3	0	1621	O94911-1	0	1581	+	4	O94911-3#10	0	21	O94911-1	1029	1050	+	21	0	0	1448
O94911-3#11	0	21	21	O94911-3	1105	1126	+	21	O94911-3	0	1621	O94911-3	0	1621	+	6	O94911-3#11	0	21	O94911-3	1105	1126	+	21	0	0	1449
O94911-3#11	0	21	21	O94911-3	1105	1126	+	21	O94911-3	0	1621	O94911-1	0	1581	+	4	O94911-3#11	0	21	O94911-1	1065	1086	+	21	0	0	1450
O94911-3#12	0	21	21	O94911-3	1135	1156	+	21	O94911-3	0	1621	O94911-3	0	1621	+	6	O94911-3#12	0	21	O94911-3	1135	1156	+	21	0	0	1451
O94911-3#12	0	21	21	O94911-3	1135	1156	+	21	O94911-3	0	1621	O94911-1	0	1581	+	4	O94911-3#12	0	21	O94911-1	1095	1116	+	21	0	0	1452
O94911-3#13	0	21	21	O94911-3	1160	1181	+	21	O94911-3	0	1621	O94911-3	0	1621	+	6	O94911-3#13	0	21	O94911-3	1160	1181	+	21	0	0	1453
O94911-3#13	0	21	21	O94911-3	1160	1181	+	21	O94911-3	0	1621	O94911-1	0	1581	+	4	O94911-3#13	0	21	O94911-1	1120	1141	+	21	0	0	1454
O94911-3#14	0	21	21	O94911-3	1196	1217	+	21	O94911-3	0	1621	O94911-3	0	1621	+	6	O94911-3#14	0	21	O94911-3	1196	1217	+	21	0	0	1455
O94911-3#14	0	21	21	O94911-3	1196	1217	+	21	O94911-3	0	1621	O94911-1	0	1581	+	4	O94911-3#14	0	21	O94911-1	1156	1177	+	21	0	0	1456
O94911-3#15	0	236	236	O94911-3	479	715	+	236	O94911-3	0	1621	O94911-3	0	1621	+	6	O94911-3#15	0	236	O94911-3	479	715	+	236	0	0	1457
O94911-3#15	0	236	236	O94911-3	479	715	+	236	O94911-3	0	1621	O94911-1	0	1581	+	4	O94911-3#15	0	236	O94911-1	479	675	+	196	0	0	1458
O94911-3#16	0	234	234	O94911-3	1284	1518	+	234	O94911-3	0	1621	O94911-3	0	1621	+	6	O94911-3#16	0	234	O94911-3	1284	1518	+	234	0	0	1459
O94911-3#16	0	234	234	O94911-3	1284	1518	+	234	O94911-3	0	1621	O94911-1	0	1581	+	4	O94911-3#16	0	234	O94911-1	1244	1478	+	234	0	0	1460
O94911-3#17	0	8	8	O94911-3	515	523	+	8	O94911-3	0	1621	O94911-3	0	1621	+	6	O94911-3#17	0	8	O94911-3	515	523	+	8	0	0	1461
O94911-3#17	0	8	8	O94911-3	515	523	+	8	O94911-3	0	1621	O94911-1	0	1581	+	4	O94911-3#17	0	8	O94911-1	515	523	+	8	0	0	1462
O94911-3#18	0	8	8	O94911-3	1322	1330	+	8	O94911-3	0	1621	O94911-3	0	1621	+	6	O94911-3#18	0	8	O94911-3	1322	1330	+	8	0	0	1463
O94911-3#18	0	8	8	O94911-3	1322	1330	+	8	O94911-3	0	1621	O94911-1	0	1581	+	4	O94911-3#18	0	8	O94911-1	1282	1290	+	8	0	0	1464
O94911-3#19	0	1	1	O94911-3	70	71	+	1	O94911-3	0	1621	O94911-3	0	1621	+	6	O94911-3#19	0	1	O94911-3	70	71	+	1	0	0	1465
O94911-3#19	0	1	1	O94911-3	70	71	+	1	O94911-3	0	266	O94911-2	0	266	+	5	O94911-3#19	0	1	O94911-2	70	71	+	1	0	0	1466
O94911-3#19	0	1	1	O94911-3	70	71	+	1	O94911-3	0	1621	O94911-1	0	1581	+	4	O94911-3#19	0	1	O94911-1	70	71	+	1	0	0	1467
O94911-3#20	0	1	1	O94911-3	83	84	+	1	O94911-3	0	1621	O94911-3	0	1621	+	6	O94911-3#20	0	1	O94911-3	83	84	+	1	0	0	1468
O94911-3#20	0	1	1	O94911-3	83	84	+	1	O94911-3	0	266	O94911-2	0	266	+	5	O94911-3#20	0	1	O94911-2	83	84	+	1	0	0	1469
O94911-3#20	0	1	1	O94911-3	83	84	+	1	O94911-3	0	1621	O94911-1	0	1581	+	4	O94911-3#20	0	1	O94911-1	83	84	+	1	0	0	1470
O94911-3#21	0	1	1	O94911-3	193	194	+	1	O94911-3	0	1621	O94911-3	0	1621	+	6	O94911-3#21	0	1	O94911-3	193	194	+	1	0	0	1471
O94911-3#21	0	1	1	O94911-3	193	194	+	1	O94911-3	0	266	O94911-2	0	266	+	5	O94911-3#21	0	1	O94911-2	193	194	+	1	0	0	1472
O94911-3#21	0	1	1	O94911-3	193	194	+	1	O94911-3	0	1621	O94911-1	0	1581	+	4	O94911-3#21	0	1	O94911-1	193	194	+	1	0	0	1473
O94911-3#22	0	1	1	O94911-3	242	243	+	1	O94911-3	0	1621	O94911-3	0	1621	+	6	O94911-3#22	0	1	O94911-3	242	243	+	1	0	0	1474
O94911-3#22	0	1	1	O94911-3	242	243	+	1	O94911-3	0	266	O94911-2	0	266	+	5	O94911-3#22	0	1	O94911-2	242	243	+	1	0	0	1475
O94911-3#22	0	1	1	O94911-3	242	243	+	1	O94911-3	0	1621	O94911-1	0	1581	+	4	O94911-3#22	0	1	O94911-1	242	243	+	1	0	0	1476
O94911-3#23	0	1	1	O94911-3	483	484	+	1	O94911-3	0	1621	O94911-3	0	1621	+	6	O94911-3#23	0	1	O94911-3	483	484	+	1	0	0	1477
O94911-3#23	0	1	1	O94911-3	483	484	+	1	O94911-3	0	1621	O94911-1	0	1581	+	4	O94911-3#23	0	1	O94911-1	483	484	+	1	0	0	1478
O94911-3#24	0	1	1	O94911-3	554	555	+	1	O94911-3	0	1621	O94911-3	0	1621	+	6	O94911-3#24	0	1	O94911-3	554	555	+	1	0	0	1479
O94911-3#24	0	1	1	O94911-3	554	555	+	1	O94911-3	0	1621	O94911-1	0	1581	+	4	O94911-3#24	0	1	O94911-1	554	555	+	1	0	0	1480
O94911-3#25	0	1	1	O94911-3	615	616	+	1	O94911-3	0	1621	O94911-3	0	1621	+	6	O94911-3#25	0	1	O94911-3	615	616	+	1	0	0	1481
O94911-3#26	0	1	1	O94911-3	723	724	+	1	O94911-3	0	1621	O94911-3	0	1621	+	6	O94911-3#26	0	1	O94911-3	723	724	+	1	0	0	1482
O94911-3#26	0	1	1	O94911-3	723	724	+	1	O94911-3	0	1621	O94911-1	0	1581	+	4	O94911-3#26	0	1	O94911-1	683	684	+	1	0	0	1483
O94911-3#27	0	1	1	O94911-3	796	797	+	1	O94911-3	0	1621	O94911-3	0	1621	+	6	O94911-3#27	0	1	O94911-3	796	797	+	1	0	0	1484
O94911-3#27	0	1	1	O94911-3	796	797	+	1	O94911-3	0	1621	O94911-1	0	1581	+	4	O94911-3#27	0	1	O94911-1	756	757	+	1	0	0	1485
O94911-3#28	0	1	1	O94911-3	918	919	+	1	O94911-3	0	1621	O94911-3	0	1621	+	6	O94911-3#28	0	1	O94911-3	918	919	+	1	0	0	1486
O94911-3#28	0	1	1	O94911-3	918	919	+	1	O94911-3	0	1621	O94911-1	0	1581	+	4	O94911-3#28	0	1	O94911-1	878	879	+	1	0	0	1487
O94911-3#29	0	1	1	O94911-3	947	948	+	1	O94911-3	0	1621	O94911-3	0	1621	+	6	O94911-3#29	0	1	O94911-3	947	948	+	1	0	0	1488
O94911-3#29	0	1	1	O94911-3	947	948	+	1	O94911-3	0	1621	O94911-1	0	1581	+	4	O94911-3#29	0	1	O94911-1	907	908	+	1	0	0	1489
O94911-3#30	0	1	1	O94911-3	966	967	+	1	O94911-3	0	1621	O94911-3	0	1621	+	6	O94911-3#30	0	1	O94911-3	966	967	+	1	0	0	1490
O94911-3#30	0	1	1	O94911-3	966	967	+	1	O94911-3	0	1621	O94911-1	0	1581	+	4	O94911-3#30	0	1	O94911-1	926	927	+	1	0	0	1491
O94911-3#31	0	1	1	O94911-3	1269	1270	+	1	O94911-3	0	1621	O94911-3	0	1621	+	6	O94911-3#31	0	1	O94911-3	1269	1270	+	1	0	0	1492
O94911-3#31	0	1	1	O94911-3	1269	1270	+	1	O94911-3	0	1621	O94911-1	0	1581	+	4	O94911-3#31	0	1	O94911-1	1229	1230	+	1	0	0	1493
O94911-3#32	0	1	1	O94911-3	1307	1308	+	1	O94911-3	0	1621	O94911-3	0	1621	+	6	O94911-3#32	0	1	O94911-3	1307	1308	+	1	0	0	1494
O94911-3#32	0	1	1	O94911-3	1307	1308	+	1	O94911-3	0	1621	O94911-1	0	1581	+	4	O94911-3#32	0	1	O94911-1	1267	1268	+	1	0	0	1495
O94911-3#33	0	1	1	O94911-3	1372	1373	+	1	O94911-3	0	1621	O94911-3	0	1621	+	6	O94911-3#33	0	1	O94911-3	1372	1373	+	1	0	0	1496
O94911-3#33	0	1	1	O94911-3	1372	1373	+	1	O94911-3	0	1621	O94911-1	0	1581	+	4	O94911-3#33	0	1	O94911-1	1332	1333	+	1	0	0	1497
O94911-3#34	0	1	1	O94911-3	1434	1435	+	1	O94911-3	0	1621	O94911-3	0	1621	+	6	O94911-3#34	0	1	O94911-3	1434	1435	+	1	0	0	1498
O94911-3#34	0	1	1	O94911-3	1434	1435	+	1	O94911-3	0	1621	O94911-1	0	1581	+	4	O94911-3#34	0	1	O94911-1	1394	1395	+	1	0	0	1499
O94911-3#35	0	1355	1355	O94911-3	266	1621	+	1355	O94911-3	0	1621	O94911-3	0	1621	+	6	O94911-3#35	0	1355	O94911-3	266	1621	+	1355	0	0	1500
O94911-3#35	0	1355	1355	O94911-3	266	1621	+	1355	O94911-3	0	1621	O94911-1	0	1581	+	4	O94911-3#35	0	1355	O94911-1	266	1581	+	1315	0	0	1501
O94911-3#36	0	40	40	O94911-3	597	637	+	40	O94911-3	0	1621	O94911-3	0	1621	+	6	O94911-3#36	0	40	O94911-3	597	637	+	40	0	0	1502
O94911-3#36	0	40	40	O94911-3	597	637	+	40	O94911-3	0	1621	O94911-1	0	1581	+	4	O94911-3#36	39	40	O94911-1	596	597	+	1	39	0	1503
O94911-3#37	0	1	1	O94911-3	255	256	+	1	O94911-3	0	1621	O94911-3	0	1621	+	6	O94911-3#37	0	1	O94911-3	255	256	+	1	0	0	1504
O94911-3#37	0	1	1	O94911-3	255	256	+	1	O94911-3	0	266	O94911-2	0	266	+	5	O94911-3#37	0	1	O94911-2	255	256	+	1	0	0	1505
O94911-3#37	0	1	1	O94911-3	255	256	+	1	O94911-3	0	1621	O94911-1	0	1581	+	4	O94911-3#37	0	1	O94911-1	255	256	+	1	0	0	1506
O94911-3#38	0	1	1	O94911-3	330	331	+	1	O94911-3	0	1621	O94911-3	0	1621	+	6	O94911-3#38	0	1	O94911-3	330	331	+	1	0	0	1507
O94911-3#38	0	1	1	O94911-3	330	331	+	1	O94911-3	0	1621	O94911-1	0	1581	+	4	O94911-3#38	0	1	O94911-1	330	331	+	1	0	0	1508
O94911-3#39	0	1	1	O94911-3	415	416	+	1	O94911-3	0	1621	O94911-3	0	1621	+	6	O94911-3#39	0	1	O94911-3	415	416	+	1	0	0	1509
O94911-3#39	0	1	1	O94911-3	415	416	+	1	O94911-3	0	1621	O94911-1	0	1581	+	4	O94911-3#39	0	1	O94911-1	415	416	+	1	0	0	1510
O94911-3#40	0	1	1	O94911-3	488	489	+	1	O94911-3	0	1621	O94911-3	0	1621	+	6	O94911-3#40	0	1	O94911-3	488	489	+	1	0	0	1511
O94911-3#40	0	1	1	O94911-3	488	489	+	1	O94911-3	0	1621	O94911-1	0	1581	+	4	O94911-3#40	0	1	O94911-1	488	489	+	1	0	0	1512
O94911-3#41	0	1	1	O94911-3	648	649	+	1	O94911-3	0	1621	O94911-3	0	1621	+	6	O94911-3#41	0	1	O94911-3	648	649	+	1	0	0	1513
O94911-3#41	0	1	1	O94911-3	648	649	+	1	O94911-3	0	1621	O94911-1	0	1581	+	4	O94911-3#41	0	1	O94911-1	608	609	+	1	0	0	1514
O94911-3#42	0	1	1	O94911-3	658	659	+	1	O94911-3	0	1621	O94911-3	0	1621	+	6	O94911-3#42	0	1	O94911-3	658	659	+	1	0	0	1515
O94911-3#42	0	1	1	O94911-3	658	659	+	1	O94911-3	0	1621	O94911-1	0	1581	+	4	O94911-3#42	0	1	O94911-1	618	619	+	1	0	0	1516
O94911-3#43	0	1	1	O94911-3	719	720	+	1	O94911-3	0	1621	O94911-3	0	1621	+	6	O94911-3#43	0	1	O94911-3	719	720	+	1	0	0	1517
O94911-3#43	0	1	1	O94911-3	719	720	+	1	O94911-3	0	1621	O94911-1	0	1581	+	4	O94911-3#43	0	1	O94911-1	679	680	+	1	0	0	1518
O94911-3#44	0	841	841	O94911-3	780	1621	+	841	O94911-3	0	1621	O94911-3	0	1621	+	6	O94911-3#44	0	841	O94911-3	780	1621	+	841	0	0	1519
O94911-3#44	0	841	841	O94911-3	780	1621	+	841	O94911-3	0	1621	O94911-1	0	1581	+	4	O94911-3#44	0	841	O94911-1	740	1581	+	841	0	0	1520
O94911-3#45	0	1	1	O94911-3	1469	1470	+	1	O94911-3	0	1621	O94911-3	0	1621	+	6	O94911-3#45	0	1	O94911-3	1469	1470	+	1	0	0	1521
O94911-3#45	0	1	1	O94911-3	1469	1470	+	1	O94911-3	0	1621	O94911-1	0	1581	+	4	O94911-3#45	0	1	O94911-1	1429	1430	+	1	0	0	1522
Q8IUA7-1#0	0	1624	1624	Q8IUA7-1	0	1624	+	1624	Q8IUA7-1	0	267	Q8IUA7-5	0	267	+	61	Q8IUA7-1#0	0	267	Q8IUA7-5	0	267	+	267	0	1357	1523
Q8IUA7-1#0	0	1624	1624	Q8IUA7-1	0	1624	+	1624	Q8IUA7-1	0	1428	Q8IUA7-4	0	1428	+	60	Q8IUA7-1#0	0	1428	Q8IUA7-4	0	1428	+	1428	0	196	1524
Q8IUA7-1#0	0	1624	1624	Q8IUA7-1	0	1624	+	1624	Q8IUA7-1	0	1428	Q8IUA7-3	0	1428	+	59	Q8IUA7-1#0	0	1428	Q8IUA7-3	0	1428	+	1428	0	196	1525
Q8IUA7-1#0	0	1624	1624	Q8IUA7-1	0	1624	+	1624	Q8IUA7-1	0	266	Q8IUA7-2	0	266	+	58	Q8IUA7-1#0	0	266	Q8IUA7-2	0	266	+	266	0	1358	1526
Q8IUA7-1#0	0	1624	1624	Q8IUA7-1	0	1624	+	1624	Q8IUA7-1	0	1624	Q8IUA7-1	0	1624	+	57	Q8IUA7-1#0	0	1624	Q8IUA7-1	0	1624	+	1624	0	0	1527
Q8IUA7-1#1	0	21	21	Q8IUA7-1	30	51	+	21	Q8IUA7-1	0	267	Q8IUA7-5	0	267	+	61	Q8IUA7-1#1	0	21	Q8IUA7-5	30	51	+	21	0	0	1528
Q8IUA7-1#1	0	21	21	Q8IUA7-1	30	51	+	21	Q8IUA7-1	0	1428	Q8IUA7-4	0	1428	+	60	Q8IUA7-1#1	0	21	Q8IUA7-4	30	51	+	21	0	0	1529
Q8IUA7-1#1	0	21	21	Q8IUA7-1	30	51	+	21	Q8IUA7-1	0	1428	Q8IUA7-3	0	1428	+	59	Q8IUA7-1#1	0	21	Q8IUA7-3	30	51	+	21	0	0	1530
Q8IUA7-1#1	0	21	21	Q8IUA7-1	30	51	+	21	Q8IUA7-1	0	266	Q8IUA7-2	0	266	+	58	Q8IUA7-1#1	0	21	Q8IUA7-2	30	51	+	21	0	0	1531
Q8IUA7-1#1	0	21	21	Q8IUA7-1	30	51	+	21	Q8IUA7-1	0	1624	Q8IUA7-1	0	1624	+	57	Q8IUA7-1#1	0	21	Q8IUA7-1	30	51	+	21	0	0	1532
Q8IUA7-1#2	0	23	23	Q8IUA7-1	220	243	+	23	Q8IUA7-1	0	267	Q8IUA7-5	0	267	+	61	Q8IUA7-1#2	0	23	Q8IUA7-5	220	243	+	23	0	0	1533
Q8IUA7-1#2	0	23	23	Q8IUA7-1	220	243	+	23	Q8IUA7-1	0	1428	Q8IUA7-4	0	1428	+	60	Q8IUA7-1#2	0	23	Q8IUA7-4	220	243	+	23	0	0	1534
Q8IUA7-1#2	0	23	23	Q8IUA7-1	220	243	+	23	Q8IUA7-1	0	1428	Q8IUA7-3	0	1428	+	59	Q8IUA7-1#2	0	23	Q8IUA7-3	220	243	+	23	0	0	1535
Q8IUA7-1#2	0	23	23	Q8IUA7-1	220	243	+	23	Q8IUA7-1	0	266	Q8IUA7-2	0	266	+	58	Q8IUA7-1#2	0	23	Q8IUA7-2	220	243	+	23	0	0	1536
Q8IUA7-1#2	0	23	23	Q8IUA7-1	220	243	+	23	Q8IUA7-1	0	1624	Q8IUA7-1	0	1624	+	57	Q8IUA7-1#2	0	23	Q8IUA7-1	220	243	+	23	0	0	1537
Q8IUA7-1#3	0	21	21	Q8IUA7-1	268	289	+	21	Q8IUA7-1	0	1428	Q8IUA7-4	0	1428	+	60	Q8IUA7-1#3	0	21	Q8IUA7-4	268	289	+	21	0	0	1538
Q8IUA7-1#3	0	21	21	Q8IUA7-1	268	289	+	21	Q8IUA7-1	0	1428	Q8IUA7-3	0	1428	+	59	Q8IUA7-1#3	0	21	Q8IUA7-3	268	289	+	21	0	0	1539
Q8IUA7-1#3	0	21	21	Q8IUA7-1	268	289	+	21	Q8IUA7-1	0	1624	Q8IUA7-1	0	1624	+	57	Q8IUA7-1#3	0	21	Q8IUA7-1	268	289	+	21	0	0	1540
Q8IUA7-1#4	0	21	21	Q8IUA7-1	299	320	+	21	Q8IUA7-1	0	1428	Q8IUA7-4	0	1428	+	60	Q8IUA7-1#4	0	21	Q8IUA7-4	299	320	+	21	0	0	1541
Q8IUA7-1#4	0	21	21	Q8IUA7-1	299	320	+	21	Q8IUA7-1	0	1428	Q8IUA7-3	0	1428	+	59	Q8IUA7-1#4	0	21	Q8IUA7-3	299	320	+	21	0	0	1542
Q8IUA7-1#4	0	21	21	Q8IUA7-1	299	320	+	21	Q8IUA7-1	0	1624	Q8IUA7-1	0	1624	+	57	Q8IUA7-1#4	0	21	Q8IUA7-1	299	320	+	21	0	0	1543
Q8IUA7-1#5	0	21	21	Q8IUA7-1	328	349	+	21	Q8IUA7-1	0	1428	Q8IUA7-4	0	1428	+	60	Q8IUA7-1#5	0	21	Q8IUA7-4	328	349	+	21	0	0	1544
Q8IUA7-1#5	0	21	21	Q8IUA7-1	328	349	+	21	Q8IUA7-1	0	1428	Q8IUA7-3	0	1428	+	59	Q8IUA7-1#5	0	21	Q8IUA7-3	328	349	+	21	0	0	1545
Q8IUA7-1#5	0	21	21	Q8IUA7-1	328	349	+	21	Q8IUA7-1	0	1624	Q8IUA7-1	0	1624	+	57	Q8IUA7-1#5	0	21	Q8IUA7-1	328	349	+	21	0	0	1546
Q8IUA7-1#6	0	21	21	Q8IUA7-1	353	374	+	21	Q8IUA7-1	0	1428	Q8IUA7-4	0	1428	+	60	Q8IUA7-1#6	0	21	Q8IUA7-4	353	374	+	21	0	0	1547
Q8IUA7-1#6	0	21	21	Q8IUA7-1	353	374	+	21	Q8IUA7-1	0	1428	Q8IUA7-3	0	1428	+	59	Q8IUA7-1#6	0	21	Q8IUA7-3	353	374	+	21	0	0	1548
Q8IUA7-1#6	0	21	21	Q8IUA7-1	353	374	+	21	Q8IUA7-1	0	1624	Q8IUA7-1	0	1624	+	57	Q8IUA7-1#6	0	21	Q8IUA7-1	353	374	+	21	0	0	1549
Q8IUA7-1#7	0	21	21	Q8IUA7-1	397	418	+	21	Q8IUA7-1	0	1428	Q8IUA7-4	0	1428	+	60	Q8IUA7-1#7	0	21	Q8IUA7-4	397	418	+	21	0	0	1550
Q8IUA7-1#7	0	21	21	Q8IUA7-1	397	418	+	21	Q8IUA7-1	0	1428	Q8IUA7-3	0	1428	+	59	Q8IUA7-1#7	0	21	Q8IUA7-3	397	418	+	21	0	0	1551
Q8IUA7-1#7	0	21	21	Q8IUA7-1	397	418	+	21	Q8IUA7-1	0	1624	Q8IUA7-1	0	1624	+	57	Q8IUA7-1#7	0	21	Q8IUA7-1	397	418	+	21	0	0	1552
Q8IUA7-1#8	0	21	21	Q8IUA7-1	863	884	+	21	Q8IUA7-1	0	1428	Q8IUA7-4	0	1428	+	60	Q8IUA7-1#8	0	21	Q8IUA7-4	863	884	+	21	0	0	1553
Q8IUA7-1#8	0	21	21	Q8IUA7-1	863	884	+	21	Q8IUA7-1	0	1428	Q8IUA7-3	0	1428	+	59	Q8IUA7-1#8	0	21	Q8IUA7-3	863	884	+	21	0	0	1554
Q8IUA7-1#8	0	21	21	Q8IUA7-1	863	884	+	21	Q8IUA7-1	0	1624	Q8IUA7-1	0	1624	+	57	Q8IUA7-1#8	0	21	Q8IUA7-1	863	884	+	21	0	0	1555
Q8IUA7-1#9	0	21	21	Q8IUA7-1	1025	1046	+	21	Q8IUA7-1	0	1428	Q8IUA7-4	0	1428	+	60	Q8IUA7-1#9	0	21	Q8IUA7-4	1025	1046	+	21	0	0	1556
Q8IUA7-1#9	0	21	21	Q8IUA7-1	1025	1046	+	21	Q8IUA7-1	0	1428	Q8IUA7-3	0	1428	+	59	Q8IUA7-1#9	0	21	Q8IUA7-3	1025	1046	+	21	0	0	1557
Q8IUA7-1#9	0	21	21	Q8IUA7-1	1025	1046	+	21	Q8IUA7-1	0	1624	Q8IUA7-1	0	1624	+	57	Q8IUA7-1#9	0	21	Q8IUA7-1	1025	1046	+	21	0	0	1558
Q8IUA7-1#10	0	21	21	Q8IUA7-1	1064	1085	+	21	Q8IUA7-1	0	1428	Q8IUA7-4	0	1428	+	60	Q8IUA7-1#10	0	21	Q8IUA7-4	1064	1085	+	21	0	0	1559
Q8IUA7-1#10	0	21	21	Q8IUA7-1	1064	1085	+	21	Q8IUA7-1	0	1428	Q8IUA7-3	0	1428	+	59	Q8IUA7-1#10	0	21	Q8IUA7-3	1064	1085	+	21	0	0	1560
Q8IUA7-1#10	0	21	21	Q8IUA7-1	1064	1085	+	21	Q8IUA7-1	0	1624	Q8IUA7-1	0	1624	+	57	Q8IUA7-1#10	0	21	Q8IUA7-1	1064	1085	+	21	0	0	1561
Q8IUA7-1#11	0	21	21	Q8IUA7-1	1107	1128	+	21	Q8IUA7-1	0	1428	Q8IUA7-4	0	1428	+	60	Q8IUA7-1#11	0	21	Q8IUA7-4	1107	1128	+	21	0	0	1562
Q8IUA7-1#11	0	21	21	Q8IUA7-1	1107	1128	+	21	Q8IUA7-1	0	1428	Q8IUA7-3	0	1428	+	59	Q8IUA7-1#11	0	21	Q8IUA7-3	1107	1128	+	21	0	0	1563
Q8IUA7-1#11	0	21	21	Q8IUA7-1	1107	1128	+	21	Q8IUA7-1	0	1624	Q8IUA7-1	0	1624	+	57	Q8IUA7-1#11	0	21	Q8IUA7-1	1107	1128	+	21	0	0	1564
Q8IUA7-1#12	0	21	21	Q8IUA7-1	1135	1156	+	21	Q8IUA7-1	0	1428	Q8IUA7-4	0	1428	+	60	Q8IUA7-1#12	0	21	Q8IUA7-4	1135	1156	+	21	0	0	1565
Q8IUA7-1#12	0	21	21	Q8IUA7-1	1135	1156	+	21	Q8IUA7-1	0	1428	Q8IUA7-3	0	1428	+	59	Q8IUA7-1#12	0	21	Q8IUA7-3	1135	1156	+	21	0	0	1566
Q8IUA7-1#12	0	21	21	Q8IUA7-1	1135	1156	+	21	Q8IUA7-1	0	1624	Q8IUA7-1	0	1624	+	57	Q8IUA7-1#12	0	21	Q8IUA7-1	1135	1156	+	21	0	0	1567
Q8IUA7-1#13	0	21	21	Q8IUA7-1	1162	1183	+	21	Q8IUA7-1	0	1428	Q8IUA7-4	0	1428	+	60	Q8IUA7-1#13	0	21	Q8IUA7-4	1162	1183	+	21	0	0	1568
Q8IUA7-1#13	0	21	21	Q8IUA7-1	1162	1183	+	21	Q8IUA7-1	0	1428	Q8IUA7-3	0	1428	+	59	Q8IUA7-1#13	0	21	Q8IUA7-3	1162	1183	+	21	0	0	1569
Q8IUA7-1#13	0	21	21	Q8IUA7-1	1162	1183	+	21	Q8IUA7-1	0	1624	Q8IUA7-1	0	1624	+	57	Q8IUA7-1#13	0	21	Q8IUA7-1	1162	1183	+	21	0	0	1570
Q8IUA7-1#14	0	21	21	Q8IUA7-1	1199	1220	+	21	Q8IUA7-1	0	1428	Q8IUA7-4	0	1428	+	60	Q8IUA7-1#14	0	21	Q8IUA7-4	1199	1220	+	21	0	0	1571
Q8IUA7-1#14	0	21	21	Q8IUA7-1	1199	1220	+	21	Q8IUA7-1	0	1428	Q8IUA7-3	0	1428	+	59	Q8IUA7-1#14	0	21	Q8IUA7-3	1199	1220	+	21	0	0	1572
Q8IUA7-1#14	0	21	21	Q8IUA7-1	1199	1220	+	21	Q8IUA7-1	0	1624	Q8IUA7-1	0	1624	+	57	Q8IUA7-1#14	0	21	Q8IUA7-1	1199	1220	+	21	0	0	1573
Q8IUA7-1#15	0	236	236	Q8IUA7-1	480	716	+	236	Q8IUA7-1	0	1428	Q8IUA7-4	0	1428	+	60	Q8IUA7-1#15	0	236	Q8IUA7-4	480	716	+	236	0	0	1574
Q8IUA7-1#15	0	236	236	Q8IUA7-1	480	716	+	236	Q8IUA7-1	0	1428	Q8IUA7-3	0	1428	+	59	Q8IUA7-1#15	0	236	Q8IUA7-3	480	716	+	236	0	0	1575
Q8IUA7-1#15	0	236	236	Q8IUA7-1	480	716	+	236	Q8IUA7-1	0	1624	Q8IUA7-1	0	1624	+	57	Q8IUA7-1#15	0	236	Q8IUA7-1	480	716	+	236	0	0	1576
Q8IUA7-1#16	0	234	234	Q8IUA7-1	1287	1521	+	234	Q8IUA7-1	0	1428	Q8IUA7-4	0	1428	+	60	Q8IUA7-1#16	0	141	Q8IUA7-4	1287	1428	+	141	0	93	1577
Q8IUA7-1#16	0	234	234	Q8IUA7-1	1287	1521	+	234	Q8IUA7-1	0	1428	Q8IUA7-3	0	1428	+	59	Q8IUA7-1#16	0	141	Q8IUA7-3	1287	1428	+	141	0	93	1578
Q8IUA7-1#16	0	234	234	Q8IUA7-1	1287	1521	+	234	Q8IUA7-1	0	1624	Q8IUA7-1	0	1624	+	57	Q8IUA7-1#16	0	234	Q8IUA7-1	1287	1521	+	234	0	0	1579
Q8IUA7-1#17	0	8	8	Q8IUA7-1	516	524	+	8	Q8IUA7-1	0	1428	Q8IUA7-4	0	1428	+	60	Q8IUA7-1#17	0	8	Q8IUA7-4	516	524	+	8	0	0	1580
Q8IUA7-1#17	0	8	8	Q8IUA7-1	516	524	+	8	Q8IUA7-1	0	1428	Q8IUA7-3	0	1428	+	59	Q8IUA7-1#17	0	8	Q8IUA7-3	516	524	+	8	0	0	1581
Q8IUA7-1#17	0	8	8	Q8IUA7-1	516	524	+	8	Q8IUA7-1	0	1624	Q8IUA7-1	0	1624	+	57	Q8IUA7-1#17	0	8	Q8IUA7-1	516	524	+	8	0	0	1582
Q8IUA7-1#18	0	8	8	Q8IUA7-1	1325	1333	+	8	Q8IUA7-1	0	1428	Q8IUA7-4	0	1428	+	60	Q8IUA7-1#18	0	8	Q8IUA7-4	1325	1333	+	8	0	0	1583
Q8IUA7-1#18	0	8	8	Q8IUA7-1	1325	1333	+	8	Q8IUA7-1	0	1428	Q8IUA7-3	0	1428	+	59	Q8IUA7-1#18	0	8	Q8IUA7-3	1325	1333	+	8	0	0	1584
Q8IUA7-1#18	0	8	8	Q8IUA7-1	1325	1333	+	8	Q8IUA7-1	0	1624	Q8IUA7-1	0	1624	+	57	Q8IUA7-1#18	0	8	Q8IUA7-1	1325	1333	+	8	0	0	1585
Q8IUA7-1#19	0	1	1	Q8IUA7-1	119	120	+	1	Q8IUA7-1	0	267	Q8IUA7-5	0	267	+	61	Q8IUA7-1#19	0	1	Q8IUA7-5	119	120	+	1	0	0	1586
Q8IUA7-1#19	0	1	1	Q8IUA7-1	119	120	+	1	Q8IUA7-1	0	1428	Q8IUA7-4	0	1428	+	60	Q8IUA7-1#19	0	1	Q8IUA7-4	119	120	+	1	0	0	1587
Q8IUA7-1#19	0	1	1	Q8IUA7-1	119	120	+	1	Q8IUA7-1	0	1428	Q8IUA7-3	0	1428	+	59	Q8IUA7-1#19	0	1	Q8IUA7-3	119	120	+	1	0	0	1588
Q8IUA7-1#19	0	1	1	Q8IUA7-1	119	120	+	1	Q8IUA7-1	0	266	Q8IUA7-2	0	266	+	58	Q8IUA7-1#19	0	1	Q8IUA7-2	119	120	+	1	0	0	1589
Q8IUA7-1#19	0	1	1	Q8IUA7-1	119	120	+	1	Q8IUA7-1	0	1624	Q8IUA7-1	0	1624	+	57	Q8IUA7-1#19	0	1	Q8IUA7-1	119	120	+	1	0	0	1590
Q8IUA7-1#20	0	1	1	Q8IUA7-1	194	195	+	1	Q8IUA7-1	0	267	Q8IUA7-5	0	267	+	61	Q8IUA7-1#20	0	1	Q8IUA7-5	194	195	+	1	0	0	1591
Q8IUA7-1#20	0	1	1	Q8IUA7-1	194	195	+	1	Q8IUA7-1	0	1428	Q8IUA7-4	0	1428	+	60	Q8IUA7-1#20	0	1	Q8IUA7-4	194	195	+	1	0	0	1592
Q8IUA7-1#20	0	1	1	Q8IUA7-1	194	195	+	1	Q8IUA7-1	0	1428	Q8IUA7-3	0	1428	+	59	Q8IUA7-1#20	0	1	Q8IUA7-3	194	195	+	1	0	0	1593
Q8IUA7-1#20	0	1	1	Q8IUA7-1	194	195	+	1	Q8IUA7-1	0	266	Q8IUA7-2	0	266	+	58	Q8IUA7-1#20	0	1	Q8IUA7-2	194	195	+	1	0	0	1594
Q8IUA7-1#20	0	1	1	Q8IUA7-1	194	195	+	1	Q8IUA7-1	0	1624	Q8IUA7-1	0	1624	+	57	Q8IUA7-1#20	0	1	Q8IUA7-1	194	195	+	1	0	0	1595
Q8IUA7-1#21	0	1	1	Q8IUA7-1	948	949	+	1	Q8IUA7-1	0	1428	Q8IUA7-4	0	1428	+	60	Q8IUA7-1#21	0	1	Q8IUA7-4	948	949	+	1	0	0	1596
Q8IUA7-1#21	0	1	1	Q8IUA7-1	948	949	+	1	Q8IUA7-1	0	1428	Q8IUA7-3	0	1428	+	59	Q8IUA7-1#21	0	1	Q8IUA7-3	948	949	+	1	0	0	1597
Q8IUA7-1#21	0	1	1	Q8IUA7-1	948	949	+	1	Q8IUA7-1	0	1624	Q8IUA7-1	0	1624	+	57	Q8IUA7-1#21	0	1	Q8IUA7-1	948	949	+	1	0	0	1598
Q8IUA7-1#22	0	1358	1358	Q8IUA7-1	266	1624	+	1358	Q8IUA7-1	0	267	Q8IUA7-5	0	267	+	61	Q8IUA7-1#22	0	1	Q8IUA7-5	266	267	+	1	0	1357	1599
Q8IUA7-1#22	0	1358	1358	Q8IUA7-1	266	1624	+	1358	Q8IUA7-1	0	1428	Q8IUA7-4	0	1428	+	60	Q8IUA7-1#22	0	1162	Q8IUA7-4	266	1428	+	1162	0	196	1600
Q8IUA7-1#22	0	1358	1358	Q8IUA7-1	266	1624	+	1358	Q8IUA7-1	0	1428	Q8IUA7-3	0	1428	+	59	Q8IUA7-1#22	0	1162	Q8IUA7-3	266	1428	+	1162	0	196	1601
Q8IUA7-1#22	0	1358	1358	Q8IUA7-1	266	1624	+	1358	Q8IUA7-1	0	1624	Q8IUA7-1	0	1624	+	57	Q8IUA7-1#22	0	1358	Q8IUA7-1	266	1624	+	1358	0	0	1602
Q8IUA7-1#23	0	1357	1357	Q8IUA7-1	267	1624	+	1357	Q8IUA7-1	0	1428	Q8IUA7-4	0	1428	+	60	Q8IUA7-1#23	0	1161	Q8IUA7-4	267	1428	+	1161	0	196	1603
Q8IUA7-1#23	0	1357	1357	Q8IUA7-1	267	1624	+	1357	Q8IUA7-1	0	1428	Q8IUA7-3	0	1428	+	59	Q8IUA7-1#23	0	1161	Q8IUA7-3	267	1428	+	1161	0	196	1604
Q8IUA7-1#23	0	1357	1357	Q8IUA7-1	267	1624	+	1357	Q8IUA7-1	0	1624	Q8IUA7-1	0	1624	+	57	Q8IUA7-1#23	0	1357	Q8IUA7-1	267	1624	+	1357	0	0	1605
Q8IUA7-1#24	0	1	1	Q8IUA7-1	1428	1429	+	1	Q8IUA7-1	0	1624	Q8IUA7-1	0	1624	+	57	Q8IUA7-1#24	0	1	Q8IUA7-1	1428	1429	+	1	0	0	1606
Q8IUA7-1#25	0	1	1	Q8IUA7-1	1428	1429	+	1	Q8IUA7-1	0	1624	Q8IUA7-1	0	1624	+	57	Q8IUA7-1#25	0	1	Q8IUA7-1	1428	1429	+	1	0	0	1607
Q8IUA7-1#26	0	195	195	Q8IUA7-1	1429	1624	+	195	Q8IUA7-1	0	1624	Q8IUA7-1	0	1624	+	57	Q8IUA7-1#26	0	195	Q8IUA7-1	1429	1624	+	195	0	0	1608
Q8IUA7-1#27	0	1	1	Q8IUA7-1	352	353	+	1	Q8IUA7-1	0	1428	Q8IUA7-4	0	1428	+	60	Q8IUA7-1#27	0	1	Q8IUA7-4	352	353	+	1	0	0	1609
Q8IUA7-1#27	0	1	1	Q8IUA7-1	352	353	+	1	Q8IUA7-1	0	1428	Q8IUA7-3	0	1428	+	59	Q8IUA7-1#27	0	1	Q8IUA7-3	352	353	+	1	0	0	1610
Q8IUA7-1#27	0	1	1	Q8IUA7-1	352	353	+	1	Q8IUA7-1	0	1624	Q8IUA7-1	0	1624	+	57	Q8IUA7-1#27	0	1	Q8IUA7-1	352	353	+	1	0	0	1611
Q8IUA7-1#28	0	1	1	Q8IUA7-1	784	785	+	1	Q8IUA7-1	0	1428	Q8IUA7-4	0	1428	+	60	Q8IUA7-1#28	0	1	Q8IUA7-4	784	785	+	1	0	0	1612
Q8IUA7-1#28	0	1	1	Q8IUA7-1	784	785	+	1	Q8IUA7-1	0	1428	Q8IUA7-3	0	1428	+	59	Q8IUA7-1#28	0	1	Q8IUA7-3	784	785	+	1	0	0	1613
Q8IUA7-1#28	0	1	1	Q8IUA7-1	784	785	+	1	Q8IUA7-1	0	1624	Q8IUA7-1	0	1624	+	57	Q8IUA7-1#28	0	1	Q8IUA7-1	784	785	+	1	0	0	1614
Q8IUA7-1#29	0	1	1	Q8IUA7-1	1305	1306	+	1	Q8IUA7-1	0	1428	Q8IUA7-4	0	1428	+	60	Q8IUA7-1#29	0	1	Q8IUA7-4	1305	1306	+	1	0	0	1615
Q8IUA7-1#29	0	1	1	Q8IUA7-1	1305	1306	+	1	Q8IUA7-1	0	1428	Q8IUA7-3	0	1428	+	59	Q8IUA7-1#29	0	1	Q8IUA7-3	1305	1306	+	1	0	0	1616
Q8IUA7-1#29	0	1	1	Q8IUA7-1	1305	1306	+	1	Q8IUA7-1	0	1624	Q8IUA7-1	0	1624	+	57	Q8IUA7-1#29	0	1	Q8IUA7-1	1305	1306	+	1	0	0	1617
Q8IUA7-1#30	0	1	1	Q8IUA7-1	1355	1356	+	1	Q8IUA7-1	0	1428	Q8IUA7-4	0	1428	+	60	Q8IUA7-1#30	0	1	Q8IUA7-4	1355	1356	+	1	0	0	1618
Q8IUA7-1#30	0	1	1	Q8IUA7-1	1355	1356	+	1	Q8IUA7-1	0	1428	Q8IUA7-3	0	1428	+	59	Q8IUA7-1#30	0	1	Q8IUA7-3	1355	1356	+	1	0	0	1619
Q8IUA7-1#30	0	1	1	Q8IUA7-1	1355	1356	+	1	Q8IUA7-1	0	1624	Q8IUA7-1	0	1624	+	57	Q8IUA7-1#30	0	1	Q8IUA7-1	1355	1356	+	1	0	0	1620
Q8IUA7-1#31	0	1	1	Q8IUA7-1	1429	1430	+	1	Q8IUA7-1	0	1624	Q8IUA7-1	0	1624	+	57	Q8IUA7-1#31	0	1	Q8IUA7-1	1429	1430	+	1	0	0	1621
Q8WWZ4-1#0	0	1543	1543	Q8WWZ4-1	0	1543	+	1543	Q8WWZ4-1	0	412	Q8WWZ4-5	0	412	+	76	Q8WWZ4-1#0	0	412	Q8WWZ4-5	0	412	+	412	0	1131	1622
Q8WWZ4-1#0	0	1543	1543	Q8WWZ4-1	0	1543	+	1543	Q8WWZ4-1	0	449	Q8WWZ4-4	0	449	+	75	Q8WWZ4-1#0	0	449	Q8WWZ4-4	0	449	+	449	0	1094	1623
Q8WWZ4-1#0	0	1543	1543	Q8WWZ4-1	0	1543	+	1543	Q8WWZ4-1	0	68	Q8WWZ4-3	0	68	+	74	Q8WWZ4-1#0	0	68	Q8WWZ4-3	0	68	+	68	0	1475	1624
Q8WWZ4-1#0	0	1543	1543	Q8WWZ4-1	0	1543	+	1543	Q8WWZ4-1	23	1543	Q8WWZ4-2	0	1520	+	73	Q8WWZ4-1#0	23	1543	Q8WWZ4-2	0	1520	+	1520	23	0	1625
Q8WWZ4-1#0	0	1543	1543	Q8WWZ4-1	0	1543	+	1543	Q8WWZ4-1	0	1543	Q8WWZ4-1	0	1543	+	72	Q8WWZ4-1#0	0	1543	Q8WWZ4-1	0	1543	+	1543	0	0	1626
Q8WWZ4-1#1	0	21	21	Q8WWZ4-1	82	103	+	21	Q8WWZ4-1	0	412	Q8WWZ4-5	0	412	+	76	Q8WWZ4-1#1	0	21	Q8WWZ4-5	82	103	+	21	0	0	1627
Q8WWZ4-1#1	0	21	21	Q8WWZ4-1	82	103	+	21	Q8WWZ4-1	0	449	Q8WWZ4-4	0	449	+	75	Q8WWZ4-1#1	0	21	Q8WWZ4-4	82	103	+	21	0	0	1628
Q8WWZ4-1#1	0	21	21	Q8WWZ4-1	82	103	+	21	Q8WWZ4-1	23	1543	Q8WWZ4-2	0	1520	+	73	Q8WWZ4-1#1	0	21	Q8WWZ4-2	59	80	+	21	0	0	1629
Q8WWZ4-1#1	0	21	21	Q8WWZ4-1	82	103	+	21	Q8WWZ4-1	0	1543	Q8WWZ4-1	0	1543	+	72	Q8WWZ4-1#1	0	21	Q8WWZ4-1	82	103	+	21	0	0	1630
Q8WWZ4-1#2	0	21	21	Q8WWZ4-1	134	155	+	21	Q8WWZ4-1	0	412	Q8WWZ4-5	0	412	+	76	Q8WWZ4-1#2	0	21	Q8WWZ4-5	134	155	+	21	0	0	1631
Q8WWZ4-1#2	0	21	21	Q8WWZ4-1	134	155	+	21	Q8WWZ4-1	0	449	Q8WWZ4-4	0	449	+	75	Q8WWZ4-1#2	0	21	Q8WWZ4-4	134	155	+	21	0	0	1632
Q8WWZ4-1#2	0	21	21	Q8WWZ4-1	134	155	+	21	Q8WWZ4-1	23	1543	Q8WWZ4-2	0	1520	+	73	Q8WWZ4-1#2	0	21	Q8WWZ4-2	111	132	+	21	0	0	1633
Q8WWZ4-1#2	0	21	21	Q8WWZ4-1	134	155	+	21	Q8WWZ4-1	0	1543	Q8WWZ4-1	0	1543	+	72	Q8WWZ4-1#2	0	21	Q8WWZ4-1	134	155	+	21	0	0	1634
Q8WWZ4-1#3	0	21	21	Q8WWZ4-1	184	205	+	21	Q8WWZ4-1	0	412	Q8WWZ4-5	0	412	+	76	Q8WWZ4-1#3	0	21	Q8WWZ4-5	184	205	+	21	0	0	1635
Q8WWZ4-1#3	0	21	21	Q8WWZ4-1	184	205	+	21	Q8WWZ4-1	0	449	Q8WWZ4-4	0	449	+	75	Q8WWZ4-1#3	0	21	Q8WWZ4-4	184	205	+	21	0	0	1636
Q8WWZ4-1#3	0	21	21	Q8WWZ4-1	184	205	+	21	Q8WWZ4-1	23	1543	Q8WWZ4-2	0	1520	+	73	Q8WWZ4-1#3	0	21	Q8WWZ4-2	161	182	+	21	0	0	1637
Q8WWZ4-1#3	0	21	21	Q8WWZ4-1	184	205	+	21	Q8WWZ4-1	0	1543	Q8WWZ4-1	0	1543	+	72	Q8WWZ4-1#3	0	21	Q8WWZ4-1	184	205	+	21	0	0	1638
Q8WWZ4-1#4	0	21	21	Q8WWZ4-1	209	230	+	21	Q8WWZ4-1	0	412	Q8WWZ4-5	0	412	+	76	Q8WWZ4-1#4	0	21	Q8WWZ4-5	209	230	+	21	0	0	1639
Q8WWZ4-1#4	0	21	21	Q8WWZ4-1	209	230	+	21	Q8WWZ4-1	0	449	Q8WWZ4-4	0	449	+	75	Q8WWZ4-1#4	0	21	Q8WWZ4-4	209	230	+	21	0	0	1640
Q8WWZ4-1#4	0	21	21	Q8WWZ4-1	209	230	+	21	Q8WWZ4-1	23	1543	Q8WWZ4-2	0	1520	+	73	Q8WWZ4-1#4	0	21	Q8WWZ4-2	186	207	+	21	0	0	1641
Q8WWZ4-1#4	0	21	21	Q8WWZ4-1	209	230	+	21	Q8WWZ4-1	0	1543	Q8WWZ4-1	0	1543	+	72	Q8WWZ4-1#4	0	21	Q8WWZ4-1	209	230	+	21	0	0	1642
Q8WWZ4-1#5	0	21	21	Q8WWZ4-1	239	260	+	21	Q8WWZ4-1	0	412	Q8WWZ4-5	0	412	+	76	Q8WWZ4-1#5	0	21	Q8WWZ4-5	239	260	+	21	0	0	1643
Q8WWZ4-1#5	0	21	21	Q8WWZ4-1	239	260	+	21	Q8WWZ4-1	0	449	Q8WWZ4-4	0	449	+	75	Q8WWZ4-1#5	0	21	Q8WWZ4-4	239	260	+	21	0	0	1644
Q8WWZ4-1#5	0	21	21	Q8WWZ4-1	239	260	+	21	Q8WWZ4-1	23	1543	Q8WWZ4-2	0	1520	+	73	Q8WWZ4-1#5	0	21	Q8WWZ4-2	216	237	+	21	0	0	1645
Q8WWZ4-1#5	0	21	21	Q8WWZ4-1	239	260	+	21	Q8WWZ4-1	0	1543	Q8WWZ4-1	0	1543	+	72	Q8WWZ4-1#5	0	21	Q8WWZ4-1	239	260	+	21	0	0	1646
Q8WWZ4-1#6	0	21	21	Q8WWZ4-1	263	284	+	21	Q8WWZ4-1	0	412	Q8WWZ4-5	0	412	+	76	Q8WWZ4-1#6	0	21	Q8WWZ4-5	263	284	+	21	0	0	1647
Q8WWZ4-1#6	0	21	21	Q8WWZ4-1	263	284	+	21	Q8WWZ4-1	0	449	Q8WWZ4-4	0	449	+	75	Q8WWZ4-1#6	0	21	Q8WWZ4-4	263	284	+	21	0	0	1648
Q8WWZ4-1#6	0	21	21	Q8WWZ4-1	263	284	+	21	Q8WWZ4-1	23	1543	Q8WWZ4-2	0	1520	+	73	Q8WWZ4-1#6	0	21	Q8WWZ4-2	240	261	+	21	0	0	1649
Q8WWZ4-1#6	0	21	21	Q8WWZ4-1	263	284	+	21	Q8WWZ4-1	0	1543	Q8WWZ4-1	0	1543	+	72	Q8WWZ4-1#6	0	21	Q8WWZ4-1	263	284	+	21	0	0	1650
Q8WWZ4-1#7	0	21	21	Q8WWZ4-1	309	330	+	21	Q8WWZ4-1	0	412	Q8WWZ4-5	0	412	+	76	Q8WWZ4-1#7	0	21	Q8WWZ4-5	309	330	+	21	0	0	1651
Q8WWZ4-1#7	0	21	21	Q8WWZ4-1	309	330	+	21	Q8WWZ4-1	0	449	Q8WWZ4-4	0	449	+	75	Q8WWZ4-1#7	0	21	Q8WWZ4-4	309	330	+	21	0	0	1652
Q8WWZ4-1#7	0	21	21	Q8WWZ4-1	309	330	+	21	Q8WWZ4-1	23	1543	Q8WWZ4-2	0	1520	+	73	Q8WWZ4-1#7	0	21	Q8WWZ4-2	286	307	+	21	0	0	1653
Q8WWZ4-1#7	0	21	21	Q8WWZ4-1	309	330	+	21	Q8WWZ4-1	0	1543	Q8WWZ4-1	0	1543	+	72	Q8WWZ4-1#7	0	21	Q8WWZ4-1	309	330	+	21	0	0	1654
Q8WWZ4-1#8	0	21	21	Q8WWZ4-1	773	794	+	21	Q8WWZ4-1	23	1543	Q8WWZ4-2	0	1520	+	73	Q8WWZ4-1#8	0	21	Q8WWZ4-2	750	771	+	21	0	0	1655
Q8WWZ4-1#8	0	21	21	Q8WWZ4-1	773	794	+	21	Q8WWZ4-1	0	1543	Q8WWZ4-1	0	1543	+	72	Q8WWZ4-1#8	0	21	Q8WWZ4-1	773	794	+	21	0	0	1656
Q8WWZ4-1#9	0	21	21	Q8WWZ4-1	889	910	+	21	Q8WWZ4-1	23	1543	Q8WWZ4-2	0	1520	+	73	Q8WWZ4-1#9	0	21	Q8WWZ4-2	866	887	+	21	0	0	1657
Q8WWZ4-1#9	0	21	21	Q8WWZ4-1	889	910	+	21	Q8WWZ4-1	0	1543	Q8WWZ4-1	0	1543	+	72	Q8WWZ4-1#9	0	21	Q8WWZ4-1	889	910	+	21	0	0	1658
Q8WWZ4-1#10	0	21	21	Q8WWZ4-1	925	946	+	21	Q8WWZ4-1	23	1543	Q8WWZ4-2	0	1520	+	73	Q8WWZ4-1#10	0	21	Q8WWZ4-2	902	923	+	21	0	0	1659
Q8WWZ4-1#10	0	21	21	Q8WWZ4-1	925	946	+	21	Q8WWZ4-1	0	1543	Q8WWZ4-1	0	1543	+	72	Q8WWZ4-1#10	0	21	Q8WWZ4-1	925	946	+	21	0	0	1660
Q8WWZ4-1#11	0	21	21	Q8WWZ4-1	984	1005	+	21	Q8WWZ4-1	23	1543	Q8WWZ4-2	0	1520	+	73	Q8WWZ4-1#11	0	21	Q8WWZ4-2	961	982	+	21	0	0	1661
Q8WWZ4-1#11	0	21	21	Q8WWZ4-1	984	1005	+	21	Q8WWZ4-1	0	1543	Q8WWZ4-1	0	1543	+	72	Q8WWZ4-1#11	0	21	Q8WWZ4-1	984	1005	+	21	0	0	1662
Q8WWZ4-1#12	0	21	21	Q8WWZ4-1	1013	1034	+	21	Q8WWZ4-1	23	1543	Q8WWZ4-2	0	1520	+	73	Q8WWZ4-1#12	0	21	Q8WWZ4-2	990	1011	+	21	0	0	1663
Q8WWZ4-1#12	0	21	21	Q8WWZ4-1	1013	1034	+	21	Q8WWZ4-1	0	1543	Q8WWZ4-1	0	1543	+	72	Q8WWZ4-1#12	0	21	Q8WWZ4-1	1013	1034	+	21	0	0	1664
Q8WWZ4-1#13	0	21	21	Q8WWZ4-1	1045	1066	+	21	Q8WWZ4-1	23	1543	Q8WWZ4-2	0	1520	+	73	Q8WWZ4-1#13	0	21	Q8WWZ4-2	1022	1043	+	21	0	0	1665
Q8WWZ4-1#13	0	21	21	Q8WWZ4-1	1045	1066	+	21	Q8WWZ4-1	0	1543	Q8WWZ4-1	0	1543	+	72	Q8WWZ4-1#13	0	21	Q8WWZ4-1	1045	1066	+	21	0	0	1666
Q8WWZ4-1#14	0	21	21	Q8WWZ4-1	1072	1093	+	21	Q8WWZ4-1	23	1543	Q8WWZ4-2	0	1520	+	73	Q8WWZ4-1#14	0	21	Q8WWZ4-2	1049	1070	+	21	0	0	1667
Q8WWZ4-1#14	0	21	21	Q8WWZ4-1	1072	1093	+	21	Q8WWZ4-1	0	1543	Q8WWZ4-1	0	1543	+	72	Q8WWZ4-1#14	0	21	Q8WWZ4-1	1072	1093	+	21	0	0	1668
Q8WWZ4-1#15	0	21	21	Q8WWZ4-1	1112	1133	+	21	Q8WWZ4-1	23	1543	Q8WWZ4-2	0	1520	+	73	Q8WWZ4-1#15	0	21	Q8WWZ4-2	1089	1110	+	21	0	0	1669
Q8WWZ4-1#15	0	21	21	Q8WWZ4-1	1112	1133	+	21	Q8WWZ4-1	0	1543	Q8WWZ4-1	0	1543	+	72	Q8WWZ4-1#15	0	21	Q8WWZ4-1	1112	1133	+	21	0	0	1670
Q8WWZ4-1#16	0	236	236	Q8WWZ4-1	390	626	+	236	Q8WWZ4-1	0	412	Q8WWZ4-5	0	412	+	76	Q8WWZ4-1#16	0	22	Q8WWZ4-5	390	412	+	22	0	214	1671
Q8WWZ4-1#16	0	236	236	Q8WWZ4-1	390	626	+	236	Q8WWZ4-1	0	449	Q8WWZ4-4	0	449	+	75	Q8WWZ4-1#16	0	59	Q8WWZ4-4	390	449	+	59	0	177	1672
Q8WWZ4-1#16	0	236	236	Q8WWZ4-1	390	626	+	236	Q8WWZ4-1	23	1543	Q8WWZ4-2	0	1520	+	73	Q8WWZ4-1#16	0	236	Q8WWZ4-2	367	603	+	236	0	0	1673
Q8WWZ4-1#16	0	236	236	Q8WWZ4-1	390	626	+	236	Q8WWZ4-1	0	1543	Q8WWZ4-1	0	1543	+	72	Q8WWZ4-1#16	0	236	Q8WWZ4-1	390	626	+	236	0	0	1674
Q8WWZ4-1#17	0	235	235	Q8WWZ4-1	1205	1440	+	235	Q8WWZ4-1	23	1543	Q8WWZ4-2	0	1520	+	73	Q8WWZ4-1#17	0	235	Q8WWZ4-2	1182	1417	+	235	0	0	1675
Q8WWZ4-1#17	0	235	235	Q8WWZ4-1	1205	1440	+	235	Q8WWZ4-1	0	1543	Q8WWZ4-1	0	1543	+	72	Q8WWZ4-1#17	0	235	Q8WWZ4-1	1205	1440	+	235	0	0	1676
Q8WWZ4-1#18	0	25	25	Q8WWZ4-1	1152	1177	+	25	Q8WWZ4-1	23	1543	Q8WWZ4-2	0	1520	+	73	Q8WWZ4-1#18	0	25	Q8WWZ4-2	1129	1154	+	25	0	0	1677
Q8WWZ4-1#18	0	25	25	Q8WWZ4-1	1152	1177	+	25	Q8WWZ4-1	0	1543	Q8WWZ4-1	0	1543	+	72	Q8WWZ4-1#18	0	25	Q8WWZ4-1	1152	1177	+	25	0	0	1678
Q8WWZ4-1#19	0	8	8	Q8WWZ4-1	426	434	+	8	Q8WWZ4-1	0	449	Q8WWZ4-4	0	449	+	75	Q8WWZ4-1#19	0	8	Q8WWZ4-4	426	434	+	8	0	0	1679
Q8WWZ4-1#19	0	8	8	Q8WWZ4-1	426	434	+	8	Q8WWZ4-1	23	1543	Q8WWZ4-2	0	1520	+	73	Q8WWZ4-1#19	0	8	Q8WWZ4-2	403	411	+	8	0	0	1680
Q8WWZ4-1#19	0	8	8	Q8WWZ4-1	426	434	+	8	Q8WWZ4-1	0	1543	Q8WWZ4-1	0	1543	+	72	Q8WWZ4-1#19	0	8	Q8WWZ4-1	426	434	+	8	0	0	1681
Q8WWZ4-1#20	0	8	8	Q8WWZ4-1	1238	1246	+	8	Q8WWZ4-1	23	1543	Q8WWZ4-2	0	1520	+	73	Q8WWZ4-1#20	0	8	Q8WWZ4-2	1215	1223	+	8	0	0	1682
Q8WWZ4-1#20	0	8	8	Q8WWZ4-1	1238	1246	+	8	Q8WWZ4-1	0	1543	Q8WWZ4-1	0	1543	+	72	Q8WWZ4-1#20	0	8	Q8WWZ4-1	1238	1246	+	8	0	0	1683
Q8WWZ4-1#21	0	23	23	Q8WWZ4-1	0	23	+	23	Q8WWZ4-1	0	412	Q8WWZ4-5	0	412	+	76	Q8WWZ4-1#21	0	23	Q8WWZ4-5	0	23	+	23	0	0	1684
Q8WWZ4-1#21	0	23	23	Q8WWZ4-1	0	23	+	23	Q8WWZ4-1	0	449	Q8WWZ4-4	0	449	+	75	Q8WWZ4-1#21	0	23	Q8WWZ4-4	0	23	+	23	0	0	1685
Q8WWZ4-1#21	0	23	23	Q8WWZ4-1	0	23	+	23	Q8WWZ4-1	0	68	Q8WWZ4-3	0	68	+	74	Q8WWZ4-1#21	0	23	Q8WWZ4-3	0	23	+	23	0	0	1686
Q8WWZ4-1#21	0	23	23	Q8WWZ4-1	0	23	+	23	Q8WWZ4-1	0	1543	Q8WWZ4-1	0	1543	+	72	Q8WWZ4-1#21	0	23	Q8WWZ4-1	0	23	+	23	0	0	1687
Q8WWZ4-1#22	0	1	1	Q8WWZ4-1	66	67	+	1	Q8WWZ4-1	0	412	Q8WWZ4-5	0	412	+	76	Q8WWZ4-1#22	0	1	Q8WWZ4-5	66	67	+	1	0	0	1688
Q8WWZ4-1#22	0	1	1	Q8WWZ4-1	66	67	+	1	Q8WWZ4-1	0	449	Q8WWZ4-4	0	449	+	75	Q8WWZ4-1#22	0	1	Q8WWZ4-4	66	67	+	1	0	0	1689
Q8WWZ4-1#22	0	1	1	Q8WWZ4-1	66	67	+	1	Q8WWZ4-1	0	68	Q8WWZ4-3	0	68	+	74	Q8WWZ4-1#22	0	1	Q8WWZ4-3	66	67	+	1	0	0	1690
Q8WWZ4-1#22	0	1	1	Q8WWZ4-1	66	67	+	1	Q8WWZ4-1	23	1543	Q8WWZ4-2	0	1520	+	73	Q8WWZ4-1#22	0	1	Q8WWZ4-2	43	44	+	1	0	0	1691
Q8WWZ4-1#22	0	1	1	Q8WWZ4-1	66	67	+	1	Q8WWZ4-1	0	1543	Q8WWZ4-1	0	1543	+	72	Q8WWZ4-1#22	0	1	Q8WWZ4-1	66	67	+	1	0	0	1692
Q8WWZ4-1#23	0	1476	1476	Q8WWZ4-1	67	1543	+	1476	Q8WWZ4-1	0	412	Q8WWZ4-5	0	412	+	76	Q8WWZ4-1#23	0	345	Q8WWZ4-5	67	412	+	345	0	1131	1693
Q8WWZ4-1#23	0	1476	1476	Q8WWZ4-1	67	1543	+	1476	Q8WWZ4-1	0	449	Q8WWZ4-4	0	449	+	75	Q8WWZ4-1#23	0	382	Q8WWZ4-4	67	449	+	382	0	1094	1694
Q8WWZ4-1#23	0	1476	1476	Q8WWZ4-1	67	1543	+	1476	Q8WWZ4-1	0	68	Q8WWZ4-3	0	68	+	74	Q8WWZ4-1#23	0	1	Q8WWZ4-3	67	68	+	1	0	1475	1695
Q8WWZ4-1#23	0	1476	1476	Q8WWZ4-1	67	1543	+	1476	Q8WWZ4-1	23	1543	Q8WWZ4-2	0	1520	+	73	Q8WWZ4-1#23	0	1476	Q8WWZ4-2	44	1520	+	1476	0	0	1696
Q8WWZ4-1#23	0	1476	1476	Q8WWZ4-1	67	1543	+	1476	Q8WWZ4-1	0	1543	Q8WWZ4-1	0	1543	+	72	Q8WWZ4-1#23	0	1476	Q8WWZ4-1	67	1543	+	1476	0	0	1697
Q8WWZ4-1#24	0	40	40	Q8WWZ4-1	412	452	+	40	Q8WWZ4-1	0	449	Q8WWZ4-4	0	449	+	75	Q8WWZ4-1#24	0	37	Q8WWZ4-4	412	449	+	37	0	3	1698
Q8WWZ4-1#24	0	40	40	Q8WWZ4-1	412	452	+	40	Q8WWZ4-1	23	1543	Q8WWZ4-2	0	1520	+	73	Q8WWZ4-1#24	0	40	Q8WWZ4-2	389	429	+	40	0	0	1699
Q8WWZ4-1#24	0	40	40	Q8WWZ4-1	412	452	+	40	Q8WWZ4-1	0	1543	Q8WWZ4-1	0	1543	+	72	Q8WWZ4-1#24	0	40	Q8WWZ4-1	412	452	+	40	0	0	1700
Q8WWZ4-1#25	0	1	1	Q8WWZ4-1	449	450	+	1	Q8WWZ4-1	23	1543	Q8WWZ4-2	0	1520	+	73	Q8WWZ4-1#25	0	1	Q8WWZ4-2	426	427	+	1	0	0	1701
Q8WWZ4-1#25	0	1	1	Q8WWZ4-1	449	450	+	1	Q8WWZ4-1	0	1543	Q8WWZ4-1	0	1543	+	72	Q8WWZ4-1#25	0	1	Q8WWZ4-1	449	450	+	1	0	0	1702
Q8WWZ4-1#26	0	1093	1093	Q8WWZ4-1	450	1543	+	1093	Q8WWZ4-1	23	1543	Q8WWZ4-2	0	1520	+	73	Q8WWZ4-1#26	0	1093	Q8WWZ4-2	427	1520	+	1093	0	0	1703
Q8WWZ4-1#26	0	1093	1093	Q8WWZ4-1	450	1543	+	1093	Q8WWZ4-1	0	1543	Q8WWZ4-1	0	1543	+	72	Q8WWZ4-1#26	0	1093	Q8WWZ4-1	450	1543	+	1093	0	0	1704
Q8WWZ4-1#27	0	1091	1091	Q8WWZ4-1	452	1543	+	1091	Q8WWZ4-1	23	1543	Q8WWZ4-2	0	1520	+	73	Q8WWZ4-1#27	0	1091	Q8WWZ4-2	429	1520	+	1091	0	0	1705
Q8WWZ4-1#27	0	1091	1091	Q8WWZ4-1	452	1543	+	1091	Q8WWZ4-1	0	1543	Q8WWZ4-1	0	1543	+	72	Q8WWZ4-1#27	0	1091	Q8WWZ4-1	452	1543	+	1091	0	0	1706
Q8WWZ4-1#28	0	1	1	Q8WWZ4-1	202	203	+	1	Q8WWZ4-1	0	412	Q8WWZ4-5	0	412	+	76	Q8WWZ4-1#28	0	1	Q8WWZ4-5	202	203	+	1	0	0	1707
Q8WWZ4-1#28	0	1	1	Q8WWZ4-1	202	203	+	1	Q8WWZ4-1	0	449	Q8WWZ4-4	0	449	+	75	Q8WWZ4-1#28	0	1	Q8WWZ4-4	202	203	+	1	0	0	1708
Q8WWZ4-1#28	0	1	1	Q8WWZ4-1	202	203	+	1	Q8WWZ4-1	23	1543	Q8WWZ4-2	0	1520	+	73	Q8WWZ4-1#28	0	1	Q8WWZ4-2	179	180	+	1	0	0	1709
Q8WWZ4-1#28	0	1	1	Q8WWZ4-1	202	203	+	1	Q8WWZ4-1	0	1543	Q8WWZ4-1	0	1543	+	72	Q8WWZ4-1#28	0	1	Q8WWZ4-1	202	203	+	1	0	0	1710
Q8WWZ4-1#29	0	1	1	Q8WWZ4-1	286	287	+	1	Q8WWZ4-1	0	412	Q8WWZ4-5	0	412	+	76	Q8WWZ4-1#29	0	1	Q8WWZ4-5	286	287	+	1	0	0	1711
Q8WWZ4-1#29	0	1	1	Q8WWZ4-1	286	287	+	1	Q8WWZ4-1	0	449	Q8WWZ4-4	0	449	+	75	Q8WWZ4-1#29	0	1	Q8WWZ4-4	286	287	+	1	0	0	1712
Q8WWZ4-1#29	0	1	1	Q8WWZ4-1	286	287	+	1	Q8WWZ4-1	23	1543	Q8WWZ4-2	0	1520	+	73	Q8WWZ4-1#29	0	1	Q8WWZ4-2	263	264	+	1	0	0	1713
Q8WWZ4-1#29	0	1	1	Q8WWZ4-1	286	287	+	1	Q8WWZ4-1	0	1543	Q8WWZ4-1	0	1543	+	72	Q8WWZ4-1#29	0	1	Q8WWZ4-1	286	287	+	1	0	0	1714
Q8WWZ4-1#30	0	1	1	Q8WWZ4-1	915	916	+	1	Q8WWZ4-1	23	1543	Q8WWZ4-2	0	1520	+	73	Q8WWZ4-1#30	0	1	Q8WWZ4-2	892	893	+	1	0	0	1715
Q8WWZ4-1#30	0	1	1	Q8WWZ4-1	915	916	+	1	Q8WWZ4-1	0	1543	Q8WWZ4-1	0	1543	+	72	Q8WWZ4-1#30	0	1	Q8WWZ4-1	915	916	+	1	0	0	1716
Q8WWZ4-1#31	0	1	1	Q8WWZ4-1	1321	1322	+	1	Q8WWZ4-1	23	1543	Q8WWZ4-2	0	1520	+	73	Q8WWZ4-1#31	0	1	Q8WWZ4-2	1298	1299	+	1	0	0	1717
Q8WWZ4-1#31	0	1	1	Q8WWZ4-1	1321	1322	+	1	Q8WWZ4-1	0	1543	Q8WWZ4-1	0	1543	+	72	Q8WWZ4-1#31	0	1	Q8WWZ4-1	1321	1322	+	1	0	0	1718
Q8WWZ4-1#32	0	1	1	Q8WWZ4-1	139	140	+	1	Q8WWZ4-1	0	412	Q8WWZ4-5	0	412	+	76	Q8WWZ4-1#32	0	1	Q8WWZ4-5	139	140	+	1	0	0	1719
Q8WWZ4-1#32	0	1	1	Q8WWZ4-1	139	140	+	1	Q8WWZ4-1	0	449	Q8WWZ4-4	0	449	+	75	Q8WWZ4-1#32	0	1	Q8WWZ4-4	139	140	+	1	0	0	1720
Q8WWZ4-1#32	0	1	1	Q8WWZ4-1	139	140	+	1	Q8WWZ4-1	23	1543	Q8WWZ4-2	0	1520	+	73	Q8WWZ4-1#32	0	1	Q8WWZ4-2	116	117	+	1	0	0	1721
Q8WWZ4-1#32	0	1	1	Q8WWZ4-1	139	140	+	1	Q8WWZ4-1	0	1543	Q8WWZ4-1	0	1543	+	72	Q8WWZ4-1#32	0	1	Q8WWZ4-1	139	140	+	1	0	0	1722
Q8WWZ4-1#33	0	1	1	Q8WWZ4-1	158	159	+	1	Q8WWZ4-1	0	412	Q8WWZ4-5	0	412	+	76	Q8WWZ4-1#33	0	1	Q8WWZ4-5	158	159	+	1	0	0	1723
Q8WWZ4-1#33	0	1	1	Q8WWZ4-1	158	159	+	1	Q8WWZ4-1	0	449	Q8WWZ4-4	0	449	+	75	Q8WWZ4-1#33	0	1	Q8WWZ4-4	158	159	+	1	0	0	1724
Q8WWZ4-1#33	0	1	1	Q8WWZ4-1	158	159	+	1	Q8WWZ4-1	23	1543	Q8WWZ4-2	0	1520	+	73	Q8WWZ4-1#33	0	1	Q8WWZ4-2	135	136	+	1	0	0	1725
Q8WWZ4-1#33	0	1	1	Q8WWZ4-1	158	159	+	1	Q8WWZ4-1	0	1543	Q8WWZ4-1	0	1543	+	72	Q8WWZ4-1#33	0	1	Q8WWZ4-1	158	159	+	1	0	0	1726
Q8WWZ4-1#34	0	1	1	Q8WWZ4-1	186	187	+	1	Q8WWZ4-1	0	412	Q8WWZ4-5	0	412	+	76	Q8WWZ4-1#34	0	1	Q8WWZ4-5	186	187	+	1	0	0	1727
Q8WWZ4-1#34	0	1	1	Q8WWZ4-1	186	187	+	1	Q8WWZ4-1	0	449	Q8WWZ4-4	0	449	+	75	Q8WWZ4-1#34	0	1	Q8WWZ4-4	186	187	+	1	0	0	1728
Q8WWZ4-1#34	0	1	1	Q8WWZ4-1	186	187	+	1	Q8WWZ4-1	23	1543	Q8WWZ4-2	0	1520	+	73	Q8WWZ4-1#34	0	1	Q8WWZ4-2	163	164	+	1	0	0	1729
Q8WWZ4-1#34	0	1	1	Q8WWZ4-1	186	187	+	1	Q8WWZ4-1	0	1543	Q8WWZ4-1	0	1543	+	72	Q8WWZ4-1#34	0	1	Q8WWZ4-1	186	187	+	1	0	0	1730
Q8WWZ4-1#35	0	1	1	Q8WWZ4-1	323	324	+	1	Q8WWZ4-1	0	412	Q8WWZ4-5	0	412	+	76	Q8WWZ4-1#35	0	1	Q8WWZ4-5	323	324	+	1	0	0	1731
Q8WWZ4-1#35	0	1	1	Q8WWZ4-1	323	324	+	1	Q8WWZ4-1	0	449	Q8WWZ4-4	0	449	+	75	Q8WWZ4-1#35	0	1	Q8WWZ4-4	323	324	+	1	0	0	1732
Q8WWZ4-1#35	0	1	1	Q8WWZ4-1	323	324	+	1	Q8WWZ4-1	23	1543	Q8WWZ4-2	0	1520	+	73	Q8WWZ4-1#35	0	1	Q8WWZ4-2	300	301	+	1	0	0	1733
Q8WWZ4-1#35	0	1	1	Q8WWZ4-1	323	324	+	1	Q8WWZ4-1	0	1543	Q8WWZ4-1	0	1543	+	72	Q8WWZ4-1#35	0	1	Q8WWZ4-1	323	324	+	1	0	0	1734
Q8WWZ4-1#36	0	1	1	Q8WWZ4-1	363	364	+	1	Q8WWZ4-1	0	412	Q8WWZ4-5	0	412	+	76	Q8WWZ4-1#36	0	1	Q8WWZ4-5	363	364	+	1	0	0	1735
Q8WWZ4-1#36	0	1	1	Q8WWZ4-1	363	364	+	1	Q8WWZ4-1	0	449	Q8WWZ4-4	0	449	+	75	Q8WWZ4-1#36	0	1	Q8WWZ4-4	363	364	+	1	0	0	1736
Q8WWZ4-1#36	0	1	1	Q8WWZ4-1	363	364	+	1	Q8WWZ4-1	23	1543	Q8WWZ4-2	0	1520	+	73	Q8WWZ4-1#36	0	1	Q8WWZ4-2	340	341	+	1	0	0	1737
Q8WWZ4-1#36	0	1	1	Q8WWZ4-1	363	364	+	1	Q8WWZ4-1	0	1543	Q8WWZ4-1	0	1543	+	72	Q8WWZ4-1#36	0	1	Q8WWZ4-1	363	364	+	1	0	0	1738
Q8WWZ4-1#37	0	1	1	Q8WWZ4-1	1215	1216	+	1	Q8WWZ4-1	23	1543	Q8WWZ4-2	0	1520	+	73	Q8WWZ4-1#37	0	1	Q8WWZ4-2	1192	1193	+	1	0	0	1739
Q8WWZ4-1#37	0	1	1	Q8WWZ4-1	1215	1216	+	1	Q8WWZ4-1	0	1543	Q8WWZ4-1	0	1543	+	72	Q8WWZ4-1#37	0	1	Q8WWZ4-1	1215	1216	+	1	0	0	1740
Q86UK0-1#0	0	2595	2595	Q86UK0-1	0	2595	+	2595	Q86UK0-1	328	2595	Q86UK0-2	10	2277	+	49	Q86UK0-1#0	328	2595	Q86UK0-2	10	2277	+	2267	328	0	1741
Q86UK0-1#0	0	2595	2595	Q86UK0-1	0	2595	+	2595	Q86UK0-1	0	2595	Q86UK0-1	0	2595	+	48	Q86UK0-1#0	0	2595	Q86UK0-1	0	2595	+	2595	0	0	1742
Q86UK0-1#1	0	21	21	Q86UK0-1	22	43	+	21	Q86UK0-1	0	2595	Q86UK0-1	0	2595	+	48	Q86UK0-1#1	0	21	Q86UK0-1	22	43	+	21	0	0	1743
Q86UK0-1#2	0	21	21	Q86UK0-1	1064	1085	+	21	Q86UK0-1	328	2595	Q86UK0-2	10	2277	+	49	Q86UK0-1#2	0	21	Q86UK0-2	746	767	+	21	0	0	1744
Q86UK0-1#2	0	21	21	Q86UK0-1	1064	1085	+	21	Q86UK0-1	0	2595	Q86UK0-1	0	2595	+	48	Q86UK0-1#2	0	21	Q86UK0-1	1064	1085	+	21	0	0	1745
Q86UK0-1#3	0	21	21	Q86UK0-1	1111	1132	+	21	Q86UK0-1	328	2595	Q86UK0-2	10	2277	+	49	Q86UK0-1#3	0	21	Q86UK0-2	793	814	+	21	0	0	1746
Q86UK0-1#3	0	21	21	Q86UK0-1	1111	1132	+	21	Q86UK0-1	0	2595	Q86UK0-1	0	2595	+	48	Q86UK0-1#3	0	21	Q86UK0-1	1111	1132	+	21	0	0	1747
Q86UK0-1#4	0	21	21	Q86UK0-1	1144	1165	+	21	Q86UK0-1	328	2595	Q86UK0-2	10	2277	+	49	Q86UK0-1#4	0	21	Q86UK0-2	826	847	+	21	0	0	1748
Q86UK0-1#4	0	21	21	Q86UK0-1	1144	1165	+	21	Q86UK0-1	0	2595	Q86UK0-1	0	2595	+	48	Q86UK0-1#4	0	21	Q86UK0-1	1144	1165	+	21	0	0	1749
Q86UK0-1#5	0	21	21	Q86UK0-1	1173	1194	+	21	Q86UK0-1	328	2595	Q86UK0-2	10	2277	+	49	Q86UK0-1#5	0	21	Q86UK0-2	855	876	+	21	0	0	1750
Q86UK0-1#5	0	21	21	Q86UK0-1	1173	1194	+	21	Q86UK0-1	0	2595	Q86UK0-1	0	2595	+	48	Q86UK0-1#5	0	21	Q86UK0-1	1173	1194	+	21	0	0	1751
Q86UK0-1#6	0	21	21	Q86UK0-1	1199	1220	+	21	Q86UK0-1	328	2595	Q86UK0-2	10	2277	+	49	Q86UK0-1#6	0	21	Q86UK0-2	881	902	+	21	0	0	1752
Q86UK0-1#6	0	21	21	Q86UK0-1	1199	1220	+	21	Q86UK0-1	0	2595	Q86UK0-1	0	2595	+	48	Q86UK0-1#6	0	21	Q86UK0-1	1199	1220	+	21	0	0	1753
Q86UK0-1#7	0	21	21	Q86UK0-1	1249	1270	+	21	Q86UK0-1	328	2595	Q86UK0-2	10	2277	+	49	Q86UK0-1#7	0	21	Q86UK0-2	931	952	+	21	0	0	1754
Q86UK0-1#7	0	21	21	Q86UK0-1	1249	1270	+	21	Q86UK0-1	0	2595	Q86UK0-1	0	2595	+	48	Q86UK0-1#7	0	21	Q86UK0-1	1249	1270	+	21	0	0	1755
Q86UK0-1#8	0	21	21	Q86UK0-1	1746	1767	+	21	Q86UK0-1	328	2595	Q86UK0-2	10	2277	+	49	Q86UK0-1#8	0	21	Q86UK0-2	1428	1449	+	21	0	0	1756
Q86UK0-1#8	0	21	21	Q86UK0-1	1746	1767	+	21	Q86UK0-1	0	2595	Q86UK0-1	0	2595	+	48	Q86UK0-1#8	0	21	Q86UK0-1	1746	1767	+	21	0	0	1757
Q86UK0-1#9	0	21	21	Q86UK0-1	1978	1999	+	21	Q86UK0-1	328	2595	Q86UK0-2	10	2277	+	49	Q86UK0-1#9	0	21	Q86UK0-2	1660	1681	+	21	0	0	1758
Q86UK0-1#9	0	21	21	Q86UK0-1	1978	1999	+	21	Q86UK0-1	0	2595	Q86UK0-1	0	2595	+	48	Q86UK0-1#9	0	21	Q86UK0-1	1978	1999	+	21	0	0	1759
Q86UK0-1#10	0	21	21	Q86UK0-1	2034	2055	+	21	Q86UK0-1	328	2595	Q86UK0-2	10	2277	+	49	Q86UK0-1#10	0	21	Q86UK0-2	1716	1737	+	21	0	0	1760
Q86UK0-1#10	0	21	21	Q86UK0-1	2034	2055	+	21	Q86UK0-1	0	2595	Q86UK0-1	0	2595	+	48	Q86UK0-1#10	0	21	Q86UK0-1	2034	2055	+	21	0	0	1761
Q86UK0-1#11	0	21	21	Q86UK0-1	2071	2092	+	21	Q86UK0-1	328	2595	Q86UK0-2	10	2277	+	49	Q86UK0-1#11	0	21	Q86UK0-2	1753	1774	+	21	0	0	1762
Q86UK0-1#11	0	21	21	Q86UK0-1	2071	2092	+	21	Q86UK0-1	0	2595	Q86UK0-1	0	2595	+	48	Q86UK0-1#11	0	21	Q86UK0-1	2071	2092	+	21	0	0	1763
Q86UK0-1#12	0	21	21	Q86UK0-1	2102	2123	+	21	Q86UK0-1	328	2595	Q86UK0-2	10	2277	+	49	Q86UK0-1#12	0	21	Q86UK0-2	1784	1805	+	21	0	0	1764
Q86UK0-1#12	0	21	21	Q86UK0-1	2102	2123	+	21	Q86UK0-1	0	2595	Q86UK0-1	0	2595	+	48	Q86UK0-1#12	0	21	Q86UK0-1	2102	2123	+	21	0	0	1765
Q86UK0-1#13	0	21	21	Q86UK0-1	2186	2207	+	21	Q86UK0-1	328	2595	Q86UK0-2	10	2277	+	49	Q86UK0-1#13	0	21	Q86UK0-2	1868	1889	+	21	0	0	1766
Q86UK0-1#13	0	21	21	Q86UK0-1	2186	2207	+	21	Q86UK0-1	0	2595	Q86UK0-1	0	2595	+	48	Q86UK0-1#13	0	21	Q86UK0-1	2186	2207	+	21	0	0	1767
Q86UK0-1#14	0	21	21	Q86UK0-1	2269	2290	+	21	Q86UK0-1	328	2595	Q86UK0-2	10	2277	+	49	Q86UK0-1#14	0	21	Q86UK0-2	1951	1972	+	21	0	0	1768
Q86UK0-1#14	0	21	21	Q86UK0-1	2269	2290	+	21	Q86UK0-1	0	2595	Q86UK0-1	0	2595	+	48	Q86UK0-1#14	0	21	Q86UK0-1	2269	2290	+	21	0	0	1769
Q86UK0-1#15	0	232	232	Q86UK0-1	1345	1577	+	232	Q86UK0-1	328	2595	Q86UK0-2	10	2277	+	49	Q86UK0-1#15	0	232	Q86UK0-2	1027	1259	+	232	0	0	1770
Q86UK0-1#15	0	232	232	Q86UK0-1	1345	1577	+	232	Q86UK0-1	0	2595	Q86UK0-1	0	2595	+	48	Q86UK0-1#15	0	232	Q86UK0-1	1345	1577	+	232	0	0	1771
Q86UK0-1#16	0	236	236	Q86UK0-1	2253	2489	+	236	Q86UK0-1	328	2595	Q86UK0-2	10	2277	+	49	Q86UK0-1#16	0	236	Q86UK0-2	1935	2171	+	236	0	0	1772
Q86UK0-1#16	0	236	236	Q86UK0-1	2253	2489	+	236	Q86UK0-1	0	2595	Q86UK0-1	0	2595	+	48	Q86UK0-1#16	0	236	Q86UK0-1	2253	2489	+	236	0	0	1773
Q86UK0-1#17	0	25	25	Q86UK0-1	2570	2595	+	25	Q86UK0-1	328	2595	Q86UK0-2	10	2277	+	49	Q86UK0-1#17	0	25	Q86UK0-2	2252	2277	+	25	0	0	1774
Q86UK0-1#17	0	25	25	Q86UK0-1	2570	2595	+	25	Q86UK0-1	0	2595	Q86UK0-1	0	2595	+	48	Q86UK0-1#17	0	25	Q86UK0-1	2570	2595	+	25	0	0	1775
Q86UK0-1#18	0	8	8	Q86UK0-1	1377	1385	+	8	Q86UK0-1	328	2595	Q86UK0-2	10	2277	+	49	Q86UK0-1#18	0	8	Q86UK0-2	1059	1067	+	8	0	0	1776
Q86UK0-1#18	0	8	8	Q86UK0-1	1377	1385	+	8	Q86UK0-1	0	2595	Q86UK0-1	0	2595	+	48	Q86UK0-1#18	0	8	Q86UK0-1	1377	1385	+	8	0	0	1777
Q86UK0-1#19	0	8	8	Q86UK0-1	2289	2297	+	8	Q86UK0-1	328	2595	Q86UK0-2	10	2277	+	49	Q86UK0-1#19	0	8	Q86UK0-2	1971	1979	+	8	0	0	1778
Q86UK0-1#19	0	8	8	Q86UK0-1	2289	2297	+	8	Q86UK0-1	0	2595	Q86UK0-1	0	2595	+	48	Q86UK0-1#19	0	8	Q86UK0-1	2289	2297	+	8	0	0	1779
Q86UK0-1#20	0	1	1	Q86UK0-1	155	156	+	1	Q86UK0-1	0	2595	Q86UK0-1	0	2595	+	48	Q86UK0-1#20	0	1	Q86UK0-1	155	156	+	1	0	0	1780
Q86UK0-1#21	0	1	1	Q86UK0-1	173	174	+	1	Q86UK0-1	0	2595	Q86UK0-1	0	2595	+	48	Q86UK0-1#21	0	1	Q86UK0-1	173	174	+	1	0	0	1781
Q86UK0-1#22	0	1	1	Q86UK0-1	213	214	+	1	Q86UK0-1	0	2595	Q86UK0-1	0	2595	+	48	Q86UK0-1#22	0	1	Q86UK0-1	213	214	+	1	0	0	1782
Q86UK0-1#23	0	1	1	Q86UK0-1	274	275	+	1	Q86UK0-1	0	2595	Q86UK0-1	0	2595	+	48	Q86UK0-1#23	0	1	Q86UK0-1	274	275	+	1	0	0	1783
Q86UK0-1#24	0	1	1	Q86UK0-1	332	333	+	1	Q86UK0-1	328	2595	Q86UK0-2	10	2277	+	49	Q86UK0-1#24	0	1	Q86UK0-2	14	15	+	1	0	0	1784
Q86UK0-1#24	0	1	1	Q86UK0-1	332	333	+	1	Q86UK0-1	0	2595	Q86UK0-1	0	2595	+	48	Q86UK0-1#24	0	1	Q86UK0-1	332	333	+	1	0	0	1785
Q86UK0-1#25	0	1	1	Q86UK0-1	366	367	+	1	Q86UK0-1	328	2595	Q86UK0-2	10	2277	+	49	Q86UK0-1#25	0	1	Q86UK0-2	48	49	+	1	0	0	1786
Q86UK0-1#25	0	1	1	Q86UK0-1	366	367	+	1	Q86UK0-1	0	2595	Q86UK0-1	0	2595	+	48	Q86UK0-1#25	0	1	Q86UK0-1	366	367	+	1	0	0	1787
Q86UK0-1#26	0	1	1	Q86UK0-1	382	383	+	1	Q86UK0-1	328	2595	Q86UK0-2	10	2277	+	49	Q86UK0-1#26	0	1	Q86UK0-2	64	65	+	1	0	0	1788
Q86UK0-1#26	0	1	1	Q86UK0-1	382	383	+	1	Q86UK0-1	0	2595	Q86UK0-1	0	2595	+	48	Q86UK0-1#26	0	1	Q86UK0-1	382	383	+	1	0	0	1789
Q86UK0-1#27	0	1	1	Q86UK0-1	411	412	+	1	Q86UK0-1	328	2595	Q86UK0-2	10	2277	+	49	Q86UK0-1#27	0	1	Q86UK0-2	93	94	+	1	0	0	1790
Q86UK0-1#27	0	1	1	Q86UK0-1	411	412	+	1	Q86UK0-1	0	2595	Q86UK0-1	0	2595	+	48	Q86UK0-1#27	0	1	Q86UK0-1	411	412	+	1	0	0	1791
Q86UK0-1#28	0	1	1	Q86UK0-1	434	435	+	1	Q86UK0-1	328	2595	Q86UK0-2	10	2277	+	49	Q86UK0-1#28	0	1	Q86UK0-2	116	117	+	1	0	0	1792
Q86UK0-1#28	0	1	1	Q86UK0-1	434	435	+	1	Q86UK0-1	0	2595	Q86UK0-1	0	2595	+	48	Q86UK0-1#28	0	1	Q86UK0-1	434	435	+	1	0	0	1793
Q86UK0-1#29	0	1	1	Q86UK0-1	527	528	+	1	Q86UK0-1	328	2595	Q86UK0-2	10	2277	+	49	Q86UK0-1#29	0	1	Q86UK0-2	209	210	+	1	0	0	1794
Q86UK0-1#29	0	1	1	Q86UK0-1	527	528	+	1	Q86UK0-1	0	2595	Q86UK0-1	0	2595	+	48	Q86UK0-1#29	0	1	Q86UK0-1	527	528	+	1	0	0	1795
Q86UK0-1#30	0	1	1	Q86UK0-1	542	543	+	1	Q86UK0-1	328	2595	Q86UK0-2	10	2277	+	49	Q86UK0-1#30	0	1	Q86UK0-2	224	225	+	1	0	0	1796
Q86UK0-1#30	0	1	1	Q86UK0-1	542	543	+	1	Q86UK0-1	0	2595	Q86UK0-1	0	2595	+	48	Q86UK0-1#30	0	1	Q86UK0-1	542	543	+	1	0	0	1797
Q86UK0-1#31	0	1	1	Q86UK0-1	576	577	+	1	Q86UK0-1	328	2595	Q86UK0-2	10	2277	+	49	Q86UK0-1#31	0	1	Q86UK0-2	258	259	+	1	0	0	1798
Q86UK0-1#31	0	1	1	Q86UK0-1	576	577	+	1	Q86UK0-1	0	2595	Q86UK0-1	0	2595	+	48	Q86UK0-1#31	0	1	Q86UK0-1	576	577	+	1	0	0	1799
Q86UK0-1#32	0	1	1	Q86UK0-1	607	608	+	1	Q86UK0-1	328	2595	Q86UK0-2	10	2277	+	49	Q86UK0-1#32	0	1	Q86UK0-2	289	290	+	1	0	0	1800
Q86UK0-1#32	0	1	1	Q86UK0-1	607	608	+	1	Q86UK0-1	0	2595	Q86UK0-1	0	2595	+	48	Q86UK0-1#32	0	1	Q86UK0-1	607	608	+	1	0	0	1801
Q86UK0-1#33	0	1	1	Q86UK0-1	622	623	+	1	Q86UK0-1	328	2595	Q86UK0-2	10	2277	+	49	Q86UK0-1#33	0	1	Q86UK0-2	304	305	+	1	0	0	1802
Q86UK0-1#33	0	1	1	Q86UK0-1	622	623	+	1	Q86UK0-1	0	2595	Q86UK0-1	0	2595	+	48	Q86UK0-1#33	0	1	Q86UK0-1	622	623	+	1	0	0	1803
Q86UK0-1#34	0	1	1	Q86UK0-1	647	648	+	1	Q86UK0-1	328	2595	Q86UK0-2	10	2277	+	49	Q86UK0-1#34	0	1	Q86UK0-2	329	330	+	1	0	0	1804
Q86UK0-1#34	0	1	1	Q86UK0-1	647	648	+	1	Q86UK0-1	0	2595	Q86UK0-1	0	2595	+	48	Q86UK0-1#34	0	1	Q86UK0-1	647	648	+	1	0	0	1805
Q86UK0-1#35	0	1	1	Q86UK0-1	751	752	+	1	Q86UK0-1	328	2595	Q86UK0-2	10	2277	+	49	Q86UK0-1#35	0	1	Q86UK0-2	433	434	+	1	0	0	1806
Q86UK0-1#35	0	1	1	Q86UK0-1	751	752	+	1	Q86UK0-1	0	2595	Q86UK0-1	0	2595	+	48	Q86UK0-1#35	0	1	Q86UK0-1	751	752	+	1	0	0	1807
Q86UK0-1#36	0	1	1	Q86UK0-1	825	826	+	1	Q86UK0-1	328	2595	Q86UK0-2	10	2277	+	49	Q86UK0-1#36	0	1	Q86UK0-2	507	508	+	1	0	0	1808
Q86UK0-1#36	0	1	1	Q86UK0-1	825	826	+	1	Q86UK0-1	0	2595	Q86UK0-1	0	2595	+	48	Q86UK0-1#36	0	1	Q86UK0-1	825	826	+	1	0	0	1809
Q86UK0-1#37	0	1	1	Q86UK0-1	919	920	+	1	Q86UK0-1	328	2595	Q86UK0-2	10	2277	+	49	Q86UK0-1#37	0	1	Q86UK0-2	601	602	+	1	0	0	1810
Q86UK0-1#37	0	1	1	Q86UK0-1	919	920	+	1	Q86UK0-1	0	2595	Q86UK0-1	0	2595	+	48	Q86UK0-1#37	0	1	Q86UK0-1	919	920	+	1	0	0	1811
Q86UK0-1#38	0	1	1	Q86UK0-1	962	963	+	1	Q86UK0-1	328	2595	Q86UK0-2	10	2277	+	49	Q86UK0-1#38	0	1	Q86UK0-2	644	645	+	1	0	0	1812
Q86UK0-1#38	0	1	1	Q86UK0-1	962	963	+	1	Q86UK0-1	0	2595	Q86UK0-1	0	2595	+	48	Q86UK0-1#38	0	1	Q86UK0-1	962	963	+	1	0	0	1813
Q86UK0-1#39	0	1	1	Q86UK0-1	1169	1170	+	1	Q86UK0-1	328	2595	Q86UK0-2	10	2277	+	49	Q86UK0-1#39	0	1	Q86UK0-2	851	852	+	1	0	0	1814
Q86UK0-1#39	0	1	1	Q86UK0-1	1169	1170	+	1	Q86UK0-1	0	2595	Q86UK0-1	0	2595	+	48	Q86UK0-1#39	0	1	Q86UK0-1	1169	1170	+	1	0	0	1815
Q86UK0-1#40	0	1	1	Q86UK0-1	1523	1524	+	1	Q86UK0-1	328	2595	Q86UK0-2	10	2277	+	49	Q86UK0-1#40	0	1	Q86UK0-2	1205	1206	+	1	0	0	1816
Q86UK0-1#40	0	1	1	Q86UK0-1	1523	1524	+	1	Q86UK0-1	0	2595	Q86UK0-1	0	2595	+	48	Q86UK0-1#40	0	1	Q86UK0-1	1523	1524	+	1	0	0	1817
Q86UK0-1#41	0	1	1	Q86UK0-1	1662	1663	+	1	Q86UK0-1	328	2595	Q86UK0-2	10	2277	+	49	Q86UK0-1#41	0	1	Q86UK0-2	1344	1345	+	1	0	0	1818
Q86UK0-1#41	0	1	1	Q86UK0-1	1662	1663	+	1	Q86UK0-1	0	2595	Q86UK0-1	0	2595	+	48	Q86UK0-1#41	0	1	Q86UK0-1	1662	1663	+	1	0	0	1819
Q86UK0-1#42	0	1	1	Q86UK0-1	1703	1704	+	1	Q86UK0-1	328	2595	Q86UK0-2	10	2277	+	49	Q86UK0-1#42	0	1	Q86UK0-2	1385	1386	+	1	0	0	1820
Q86UK0-1#42	0	1	1	Q86UK0-1	1703	1704	+	1	Q86UK0-1	0	2595	Q86UK0-1	0	2595	+	48	Q86UK0-1#42	0	1	Q86UK0-1	1703	1704	+	1	0	0	1821
Q86UK0-1#43	0	1	1	Q86UK0-1	1768	1769	+	1	Q86UK0-1	328	2595	Q86UK0-2	10	2277	+	49	Q86UK0-1#43	0	1	Q86UK0-2	1450	1451	+	1	0	0	1822
Q86UK0-1#43	0	1	1	Q86UK0-1	1768	1769	+	1	Q86UK0-1	0	2595	Q86UK0-1	0	2595	+	48	Q86UK0-1#43	0	1	Q86UK0-1	1768	1769	+	1	0	0	1823
Q86UK0-1#44	0	1	1	Q86UK0-1	1818	1819	+	1	Q86UK0-1	328	2595	Q86UK0-2	10	2277	+	49	Q86UK0-1#44	0	1	Q86UK0-2	1500	1501	+	1	0	0	1824
Q86UK0-1#44	0	1	1	Q86UK0-1	1818	1819	+	1	Q86UK0-1	0	2595	Q86UK0-1	0	2595	+	48	Q86UK0-1#44	0	1	Q86UK0-1	1818	1819	+	1	0	0	1825
Q86UK0-1#45	0	1	1	Q86UK0-1	1834	1835	+	1	Q86UK0-1	328	2595	Q86UK0-2	10	2277	+	49	Q86UK0-1#45	0	1	Q86UK0-2	1516	1517	+	1	0	0	1826
Q86UK0-1#45	0	1	1	Q86UK0-1	1834	1835	+	1	Q86UK0-1	0	2595	Q86UK0-1	0	2595	+	48	Q86UK0-1#45	0	1	Q86UK0-1	1834	1835	+	1	0	0	1827
Q86UK0-1#46	0	1	1	Q86UK0-1	1875	1876	+	1	Q86UK0-1	328	2595	Q86UK0-2	10	2277	+	49	Q86UK0-1#46	0	1	Q86UK0-2	1557	1558	+	1	0	0	1828
Q86UK0-1#46	0	1	1	Q86UK0-1	1875	1876	+	1	Q86UK0-1	0	2595	Q86UK0-1	0	2595	+	48	Q86UK0-1#46	0	1	Q86UK0-1	1875	1876	+	1	0	0	1829
Q86UK0-1#47	0	1	1	Q86UK0-1	1920	1921	+	1	Q86UK0-1	328	2595	Q86UK0-2	10	2277	+	49	Q86UK0-1#47	0	1	Q86UK0-2	1602	1603	+	1	0	0	1830
Q86UK0-1#47	0	1	1	Q86UK0-1	1920	1921	+	1	Q86UK0-1	0	2595	Q86UK0-1	0	2595	+	48	Q86UK0-1#47	0	1	Q86UK0-1	1920	1921	+	1	0	0	1831
Q86UK0-1#48	0	1	1	Q86UK0-1	1951	1952	+	1	Q86UK0-1	328	2595	Q86UK0-2	10	2277	+	49	Q86UK0-1#48	0	1	Q86UK0-2	1633	1634	+	1	0	0	1832
Q86UK0-1#48	0	1	1	Q86UK0-1	1951	1952	+	1	Q86UK0-1	0	2595	Q86UK0-1	0	2595	+	48	Q86UK0-1#48	0	1	Q86UK0-1	1951	1952	+	1	0	0	1833
Q86UK0-1#49	0	1	1	Q86UK0-1	2177	2178	+	1	Q86UK0-1	328	2595	Q86UK0-2	10	2277	+	49	Q86UK0-1#49	0	1	Q86UK0-2	1859	1860	+	1	0	0	1834
Q86UK0-1#49	0	1	1	Q86UK0-1	2177	2178	+	1	Q86UK0-1	0	2595	Q86UK0-1	0	2595	+	48	Q86UK0-1#49	0	1	Q86UK0-1	2177	2178	+	1	0	0	1835
Q86UK0-1#50	0	1	1	Q86UK0-1	2207	2208	+	1	Q86UK0-1	328	2595	Q86UK0-2	10	2277	+	49	Q86UK0-1#50	0	1	Q86UK0-2	1889	1890	+	1	0	0	1836
Q86UK0-1#50	0	1	1	Q86UK0-1	2207	2208	+	1	Q86UK0-1	0	2595	Q86UK0-1	0	2595	+	48	Q86UK0-1#50	0	1	Q86UK0-1	2207	2208	+	1	0	0	1837
Q86UK0-1#51	0	1	1	Q86UK0-1	2222	2223	+	1	Q86UK0-1	328	2595	Q86UK0-2	10	2277	+	49	Q86UK0-1#51	0	1	Q86UK0-2	1904	1905	+	1	0	0	1838
Q86UK0-1#51	0	1	1	Q86UK0-1	2222	2223	+	1	Q86UK0-1	0	2595	Q86UK0-1	0	2595	+	48	Q86UK0-1#51	0	1	Q86UK0-1	2222	2223	+	1	0	0	1839
Q86UK0-1#52	0	1	1	Q86UK0-1	2317	2318	+	1	Q86UK0-1	328	2595	Q86UK0-2	10	2277	+	49	Q86UK0-1#52	0	1	Q86UK0-2	1999	2000	+	1	0	0	1840
Q86UK0-1#52	0	1	1	Q86UK0-1	2317	2318	+	1	Q86UK0-1	0	2595	Q86UK0-1	0	2595	+	48	Q86UK0-1#52	0	1	Q86UK0-1	2317	2318	+	1	0	0	1841
Q86UK0-1#53	0	1	1	Q86UK0-1	2541	2542	+	1	Q86UK0-1	328	2595	Q86UK0-2	10	2277	+	49	Q86UK0-1#53	0	1	Q86UK0-2	2223	2224	+	1	0	0	1842
Q86UK0-1#53	0	1	1	Q86UK0-1	2541	2542	+	1	Q86UK0-1	0	2595	Q86UK0-1	0	2595	+	48	Q86UK0-1#53	0	1	Q86UK0-1	2541	2542	+	1	0	0	1843
Q86UK0-1#54	0	1	1	Q86UK0-1	2546	2547	+	1	Q86UK0-1	328	2595	Q86UK0-2	10	2277	+	49	Q86UK0-1#54	0	1	Q86UK0-2	2228	2229	+	1	0	0	1844
Q86UK0-1#54	0	1	1	Q86UK0-1	2546	2547	+	1	Q86UK0-1	0	2595	Q86UK0-1	0	2595	+	48	Q86UK0-1#54	0	1	Q86UK0-1	2546	2547	+	1	0	0	1845
Q86UK0-1#55	0	318	318	Q86UK0-1	0	318	+	318	Q86UK0-1	0	2595	Q86UK0-1	0	2595	+	48	Q86UK0-1#55	0	318	Q86UK0-1	0	318	+	318	0	0	1846
Q86UK0-1#56	0	10	10	Q86UK0-1	318	328	+	10	Q86UK0-1	0	2595	Q86UK0-1	0	2595	+	48	Q86UK0-1#56	0	10	Q86UK0-1	318	328	+	10	0	0	1847
Q86UK0-1#57	0	1	1	Q86UK0-1	198	199	+	1	Q86UK0-1	0	2595	Q86UK0-1	0	2595	+	48	Q86UK0-1#57	0	1	Q86UK0-1	198	199	+	1	0	0	1848
Q86UK0-1#58	0	1	1	Q86UK0-1	236	237	+	1	Q86UK0-1	0	2595	Q86UK0-1	0	2595	+	48	Q86UK0-1#58	0	1	Q86UK0-1	236	237	+	1	0	0	1849
Q86UK0-1#59	0	1	1	Q86UK0-1	273	274	+	1	Q86UK0-1	0	2595	Q86UK0-1	0	2595	+	48	Q86UK0-1#59	0	1	Q86UK0-1	273	274	+	1	0	0	1850
Q86UK0-1#60	0	1	1	Q86UK0-1	286	287	+	1	Q86UK0-1	0	2595	Q86UK0-1	0	2595	+	48	Q86UK0-1#60	0	1	Q86UK0-1	286	287	+	1	0	0	1851
Q86UK0-1#61	0	1	1	Q86UK0-1	344	345	+	1	Q86UK0-1	328	2595	Q86UK0-2	10	2277	+	49	Q86UK0-1#61	0	1	Q86UK0-2	26	27	+	1	0	0	1852
Q86UK0-1#61	0	1	1	Q86UK0-1	344	345	+	1	Q86UK0-1	0	2595	Q86UK0-1	0	2595	+	48	Q86UK0-1#61	0	1	Q86UK0-1	344	345	+	1	0	0	1853
Q86UK0-1#62	0	1	1	Q86UK0-1	386	387	+	1	Q86UK0-1	328	2595	Q86UK0-2	10	2277	+	49	Q86UK0-1#62	0	1	Q86UK0-2	68	69	+	1	0	0	1854
Q86UK0-1#62	0	1	1	Q86UK0-1	386	387	+	1	Q86UK0-1	0	2595	Q86UK0-1	0	2595	+	48	Q86UK0-1#62	0	1	Q86UK0-1	386	387	+	1	0	0	1855
Q86UK0-1#63	0	2162	2162	Q86UK0-1	433	2595	+	2162	Q86UK0-1	328	2595	Q86UK0-2	10	2277	+	49	Q86UK0-1#63	0	2162	Q86UK0-2	115	2277	+	2162	0	0	1856
Q86UK0-1#63	0	2162	2162	Q86UK0-1	433	2595	+	2162	Q86UK0-1	0	2595	Q86UK0-1	0	2595	+	48	Q86UK0-1#63	0	2162	Q86UK0-1	433	2595	+	2162	0	0	1857
Q86UK0-1#64	0	1	1	Q86UK0-1	458	459	+	1	Q86UK0-1	328	2595	Q86UK0-2	10	2277	+	49	Q86UK0-1#64	0	1	Q86UK0-2	140	141	+	1	0	0	1858
Q86UK0-1#64	0	1	1	Q86UK0-1	458	459	+	1	Q86UK0-1	0	2595	Q86UK0-1	0	2595	+	48	Q86UK0-1#64	0	1	Q86UK0-1	458	459	+	1	0	0	1859
Q86UK0-1#65	0	1	1	Q86UK0-1	475	476	+	1	Q86UK0-1	328	2595	Q86UK0-2	10	2277	+	49	Q86UK0-1#65	0	1	Q86UK0-2	157	158	+	1	0	0	1860
Q86UK0-1#65	0	1	1	Q86UK0-1	475	476	+	1	Q86UK0-1	0	2595	Q86UK0-1	0	2595	+	48	Q86UK0-1#65	0	1	Q86UK0-1	475	476	+	1	0	0	1861
Q86UK0-1#66	0	1	1	Q86UK0-1	549	550	+	1	Q86UK0-1	328	2595	Q86UK0-2	10	2277	+	49	Q86UK0-1#66	0	1	Q86UK0-2	231	232	+	1	0	0	1862
Q86UK0-1#66	0	1	1	Q86UK0-1	549	550	+	1	Q86UK0-1	0	2595	Q86UK0-1	0	2595	+	48	Q86UK0-1#66	0	1	Q86UK0-1	549	550	+	1	0	0	1863
Q86UK0-1#67	0	1	1	Q86UK0-1	776	777	+	1	Q86UK0-1	328	2595	Q86UK0-2	10	2277	+	49	Q86UK0-1#67	0	1	Q86UK0-2	458	459	+	1	0	0	1864
Q86UK0-1#67	0	1	1	Q86UK0-1	776	777	+	1	Q86UK0-1	0	2595	Q86UK0-1	0	2595	+	48	Q86UK0-1#67	0	1	Q86UK0-1	776	777	+	1	0	0	1865
Q86UK0-1#68	0	1	1	Q86UK0-1	1135	1136	+	1	Q86UK0-1	328	2595	Q86UK0-2	10	2277	+	49	Q86UK0-1#68	0	1	Q86UK0-2	817	818	+	1	0	0	1866
Q86UK0-1#68	0	1	1	Q86UK0-1	1135	1136	+	1	Q86UK0-1	0	2595	Q86UK0-1	0	2595	+	48	Q86UK0-1#68	0	1	Q86UK0-1	1135	1136	+	1	0	0	1867
Q86UK0-1#69	0	1	1	Q86UK0-1	1178	1179	+	1	Q86UK0-1	328	2595	Q86UK0-2	10	2277	+	49	Q86UK0-1#69	0	1	Q86UK0-2	860	861	+	1	0	0	1868
Q86UK0-1#69	0	1	1	Q86UK0-1	1178	1179	+	1	Q86UK0-1	0	2595	Q86UK0-1	0	2595	+	48	Q86UK0-1#69	0	1	Q86UK0-1	1178	1179	+	1	0	0	1869
Q86UK0-1#70	0	1	1	Q86UK0-1	1234	1235	+	1	Q86UK0-1	328	2595	Q86UK0-2	10	2277	+	49	Q86UK0-1#70	0	1	Q86UK0-2	916	917	+	1	0	0	1870
Q86UK0-1#70	0	1	1	Q86UK0-1	1234	1235	+	1	Q86UK0-1	0	2595	Q86UK0-1	0	2595	+	48	Q86UK0-1#70	0	1	Q86UK0-1	1234	1235	+	1	0	0	1871
Q86UK0-1#71	0	1	1	Q86UK0-1	1250	1251	+	1	Q86UK0-1	328	2595	Q86UK0-2	10	2277	+	49	Q86UK0-1#71	0	1	Q86UK0-2	932	933	+	1	0	0	1872
Q86UK0-1#71	0	1	1	Q86UK0-1	1250	1251	+	1	Q86UK0-1	0	2595	Q86UK0-1	0	2595	+	48	Q86UK0-1#71	0	1	Q86UK0-1	1250	1251	+	1	0	0	1873
Q86UK0-1#72	0	1	1	Q86UK0-1	1379	1380	+	1	Q86UK0-1	328	2595	Q86UK0-2	10	2277	+	49	Q86UK0-1#72	0	1	Q86UK0-2	1061	1062	+	1	0	0	1874
Q86UK0-1#72	0	1	1	Q86UK0-1	1379	1380	+	1	Q86UK0-1	0	2595	Q86UK0-1	0	2595	+	48	Q86UK0-1#72	0	1	Q86UK0-1	1379	1380	+	1	0	0	1875
Q86UK0-1#73	0	1	1	Q86UK0-1	1380	1381	+	1	Q86UK0-1	328	2595	Q86UK0-2	10	2277	+	49	Q86UK0-1#73	0	1	Q86UK0-2	1062	1063	+	1	0	0	1876
Q86UK0-1#73	0	1	1	Q86UK0-1	1380	1381	+	1	Q86UK0-1	0	2595	Q86UK0-1	0	2595	+	48	Q86UK0-1#73	0	1	Q86UK0-1	1380	1381	+	1	0	0	1877
Q86UK0-1#74	0	1	1	Q86UK0-1	1384	1385	+	1	Q86UK0-1	328	2595	Q86UK0-2	10	2277	+	49	Q86UK0-1#74	0	1	Q86UK0-2	1066	1067	+	1	0	0	1878
Q86UK0-1#74	0	1	1	Q86UK0-1	1384	1385	+	1	Q86UK0-1	0	2595	Q86UK0-1	0	2595	+	48	Q86UK0-1#74	0	1	Q86UK0-1	1384	1385	+	1	0	0	1879
Q86UK0-1#75	0	1	1	Q86UK0-1	1493	1494	+	1	Q86UK0-1	328	2595	Q86UK0-2	10	2277	+	49	Q86UK0-1#75	0	1	Q86UK0-2	1175	1176	+	1	0	0	1880
Q86UK0-1#75	0	1	1	Q86UK0-1	1493	1494	+	1	Q86UK0-1	0	2595	Q86UK0-1	0	2595	+	48	Q86UK0-1#75	0	1	Q86UK0-1	1493	1494	+	1	0	0	1881
Q86UK0-1#76	0	1	1	Q86UK0-1	1513	1514	+	1	Q86UK0-1	328	2595	Q86UK0-2	10	2277	+	49	Q86UK0-1#76	0	1	Q86UK0-2	1195	1196	+	1	0	0	1882
Q86UK0-1#76	0	1	1	Q86UK0-1	1513	1514	+	1	Q86UK0-1	0	2595	Q86UK0-1	0	2595	+	48	Q86UK0-1#76	0	1	Q86UK0-1	1513	1514	+	1	0	0	1883
Q86UK0-1#77	0	1	1	Q86UK0-1	1538	1539	+	1	Q86UK0-1	328	2595	Q86UK0-2	10	2277	+	49	Q86UK0-1#77	0	1	Q86UK0-2	1220	1221	+	1	0	0	1884
Q86UK0-1#77	0	1	1	Q86UK0-1	1538	1539	+	1	Q86UK0-1	0	2595	Q86UK0-1	0	2595	+	48	Q86UK0-1#77	0	1	Q86UK0-1	1538	1539	+	1	0	0	1885
Q86UK0-1#78	0	1	1	Q86UK0-1	1545	1546	+	1	Q86UK0-1	328	2595	Q86UK0-2	10	2277	+	49	Q86UK0-1#78	0	1	Q86UK0-2	1227	1228	+	1	0	0	1886
Q86UK0-1#78	0	1	1	Q86UK0-1	1545	1546	+	1	Q86UK0-1	0	2595	Q86UK0-1	0	2595	+	48	Q86UK0-1#78	0	1	Q86UK0-1	1545	1546	+	1	0	0	1887
Q86UK0-1#79	0	1	1	Q86UK0-1	1558	1559	+	1	Q86UK0-1	328	2595	Q86UK0-2	10	2277	+	49	Q86UK0-1#79	0	1	Q86UK0-2	1240	1241	+	1	0	0	1888
Q86UK0-1#79	0	1	1	Q86UK0-1	1558	1559	+	1	Q86UK0-1	0	2595	Q86UK0-1	0	2595	+	48	Q86UK0-1#79	0	1	Q86UK0-1	1558	1559	+	1	0	0	1889
Q86UK0-1#80	0	1	1	Q86UK0-1	1650	1651	+	1	Q86UK0-1	328	2595	Q86UK0-2	10	2277	+	49	Q86UK0-1#80	0	1	Q86UK0-2	1332	1333	+	1	0	0	1890
Q86UK0-1#80	0	1	1	Q86UK0-1	1650	1651	+	1	Q86UK0-1	0	2595	Q86UK0-1	0	2595	+	48	Q86UK0-1#80	0	1	Q86UK0-1	1650	1651	+	1	0	0	1891
Q86UK0-1#81	0	1	1	Q86UK0-1	1797	1798	+	1	Q86UK0-1	328	2595	Q86UK0-2	10	2277	+	49	Q86UK0-1#81	0	1	Q86UK0-2	1479	1480	+	1	0	0	1892
Q86UK0-1#81	0	1	1	Q86UK0-1	1797	1798	+	1	Q86UK0-1	0	2595	Q86UK0-1	0	2595	+	48	Q86UK0-1#81	0	1	Q86UK0-1	1797	1798	+	1	0	0	1893
Q86UK0-1#82	0	646	646	Q86UK0-1	1949	2595	+	646	Q86UK0-1	328	2595	Q86UK0-2	10	2277	+	49	Q86UK0-1#82	0	646	Q86UK0-2	1631	2277	+	646	0	0	1894
Q86UK0-1#82	0	646	646	Q86UK0-1	1949	2595	+	646	Q86UK0-1	0	2595	Q86UK0-1	0	2595	+	48	Q86UK0-1#82	0	646	Q86UK0-1	1949	2595	+	646	0	0	1895
Q86UK0-1#83	0	1	1	Q86UK0-1	1979	1980	+	1	Q86UK0-1	328	2595	Q86UK0-2	10	2277	+	49	Q86UK0-1#83	0	1	Q86UK0-2	1661	1662	+	1	0	0	1896
Q86UK0-1#83	0	1	1	Q86UK0-1	1979	1980	+	1	Q86UK0-1	0	2595	Q86UK0-1	0	2595	+	48	Q86UK0-1#83	0	1	Q86UK0-1	1979	1980	+	1	0	0	1897
Q86UK0-1#84	0	1	1	Q86UK0-1	2063	2064	+	1	Q86UK0-1	328	2595	Q86UK0-2	10	2277	+	49	Q86UK0-1#84	0	1	Q86UK0-2	1745	1746	+	1	0	0	1898
Q86UK0-1#84	0	1	1	Q86UK0-1	2063	2064	+	1	Q86UK0-1	0	2595	Q86UK0-1	0	2595	+	48	Q86UK0-1#84	0	1	Q86UK0-1	2063	2064	+	1	0	0	1899
Q86UK0-1#85	0	1	1	Q86UK0-1	2364	2365	+	1	Q86UK0-1	328	2595	Q86UK0-2	10	2277	+	49	Q86UK0-1#85	0	1	Q86UK0-2	2046	2047	+	1	0	0	1900
Q86UK0-1#85	0	1	1	Q86UK0-1	2364	2365	+	1	Q86UK0-1	0	2595	Q86UK0-1	0	2595	+	48	Q86UK0-1#85	0	1	Q86UK0-1	2364	2365	+	1	0	0	1901
Q86UK0-1#86	0	1	1	Q86UK0-1	650	651	+	1	Q86UK0-1	328	2595	Q86UK0-2	10	2277	+	49	Q86UK0-1#86	0	1	Q86UK0-2	332	333	+	1	0	0	1902
Q86UK0-1#86	0	1	1	Q86UK0-1	650	651	+	1	Q86UK0-1	0	2595	Q86UK0-1	0	2595	+	48	Q86UK0-1#86	0	1	Q86UK0-1	650	651	+	1	0	0	1903
Q86UK0-1#87	0	1	1	Q86UK0-1	810	811	+	1	Q86UK0-1	328	2595	Q86UK0-2	10	2277	+	49	Q86UK0-1#87	0	1	Q86UK0-2	492	493	+	1	0	0	1904
Q86UK0-1#87	0	1	1	Q86UK0-1	810	811	+	1	Q86UK0-1	0	2595	Q86UK0-1	0	2595	+	48	Q86UK0-1#87	0	1	Q86UK0-1	810	811	+	1	0	0	1905
Q86UK0-1#88	0	1	1	Q86UK0-1	825	826	+	1	Q86UK0-1	328	2595	Q86UK0-2	10	2277	+	49	Q86UK0-1#88	0	1	Q86UK0-2	507	508	+	1	0	0	1906
Q86UK0-1#88	0	1	1	Q86UK0-1	825	826	+	1	Q86UK0-1	0	2595	Q86UK0-1	0	2595	+	48	Q86UK0-1#88	0	1	Q86UK0-1	825	826	+	1	0	0	1907
Q86UK0-1#89	0	1	1	Q86UK0-1	2078	2079	+	1	Q86UK0-1	328	2595	Q86UK0-2	10	2277	+	49	Q86UK0-1#89	0	1	Q86UK0-2	1760	1761	+	1	0	0	1908
Q86UK0-1#89	0	1	1	Q86UK0-1	2078	2079	+	1	Q86UK0-1	0	2595	Q86UK0-1	0	2595	+	48	Q86UK0-1#89	0	1	Q86UK0-1	2078	2079	+	1	0	0	1909
Q86UQ4-1#0	0	5058	5058	Q86UQ4-1	0	5058	+	5058	Q86UQ4-1	2736	5058	Q86UQ4-7	0	2292	+	56	Q86UQ4-1#0	2736	5058	Q86UQ4-7	0	2292	+	2291	2736	0	1910
Q86UQ4-1#0	0	5058	5058	Q86UQ4-1	0	5058	+	5058	Q86UQ4-1	2736	4946	Q86UQ4-6	0	2211	+	55	Q86UQ4-1#0	2736	4946	Q86UQ4-6	0	2211	+	2210	2736	112	1911
Q86UQ4-1#0	0	5058	5058	Q86UQ4-1	0	5058	+	5058	Q86UQ4-1	2736	5058	Q86UQ4-5	0	2323	+	54	Q86UQ4-1#0	2736	5058	Q86UQ4-5	0	2323	+	2322	2736	0	1912
Q86UQ4-1#0	0	5058	5058	Q86UQ4-1	0	5058	+	5058	Q86UQ4-1	0	5058	Q86UQ4-4	0	5059	+	53	Q86UQ4-1#0	0	5058	Q86UQ4-4	0	5059	+	5058	0	0	1913
Q86UQ4-1#0	0	5058	5058	Q86UQ4-1	0	5058	+	5058	Q86UQ4-1	2298	5058	Q86UQ4-3	0	2760	+	52	Q86UQ4-1#0	2298	5058	Q86UQ4-3	0	2760	+	2760	2298	0	1914
Q86UQ4-1#0	0	5058	5058	Q86UQ4-1	0	5058	+	5058	Q86UQ4-1	0	299	Q86UQ4-2	0	299	+	51	Q86UQ4-1#0	0	299	Q86UQ4-2	0	299	+	299	0	4759	1915
Q86UQ4-1#0	0	5058	5058	Q86UQ4-1	0	5058	+	5058	Q86UQ4-1	0	5058	Q86UQ4-1	0	5058	+	50	Q86UQ4-1#0	0	5058	Q86UQ4-1	0	5058	+	5058	0	0	1916
Q86UQ4-1#1	0	21	21	Q86UQ4-1	22	43	+	21	Q86UQ4-1	0	5058	Q86UQ4-4	0	5059	+	53	Q86UQ4-1#1	0	21	Q86UQ4-4	22	43	+	21	0	0	1917
Q86UQ4-1#1	0	21	21	Q86UQ4-1	22	43	+	21	Q86UQ4-1	0	299	Q86UQ4-2	0	299	+	51	Q86UQ4-1#1	0	21	Q86UQ4-2	22	43	+	21	0	0	1918
Q86UQ4-1#1	0	21	21	Q86UQ4-1	22	43	+	21	Q86UQ4-1	0	5058	Q86UQ4-1	0	5058	+	50	Q86UQ4-1#1	0	21	Q86UQ4-1	22	43	+	21	0	0	1919
Q86UQ4-1#2	0	21	21	Q86UQ4-1	3567	3588	+	21	Q86UQ4-1	2736	5058	Q86UQ4-7	0	2292	+	56	Q86UQ4-1#2	0	21	Q86UQ4-7	831	852	+	21	0	0	1920
Q86UQ4-1#2	0	21	21	Q86UQ4-1	3567	3588	+	21	Q86UQ4-1	2736	4946	Q86UQ4-6	0	2211	+	55	Q86UQ4-1#2	0	21	Q86UQ4-6	831	852	+	21	0	0	1921
Q86UQ4-1#2	0	21	21	Q86UQ4-1	3567	3588	+	21	Q86UQ4-1	2736	5058	Q86UQ4-5	0	2323	+	54	Q86UQ4-1#2	0	21	Q86UQ4-5	831	852	+	21	0	0	1922
Q86UQ4-1#2	0	21	21	Q86UQ4-1	3567	3588	+	21	Q86UQ4-1	0	5058	Q86UQ4-4	0	5059	+	53	Q86UQ4-1#2	0	21	Q86UQ4-4	3567	3588	+	21	0	0	1923
Q86UQ4-1#2	0	21	21	Q86UQ4-1	3567	3588	+	21	Q86UQ4-1	2298	5058	Q86UQ4-3	0	2760	+	52	Q86UQ4-1#2	0	21	Q86UQ4-3	1269	1290	+	21	0	0	1924
Q86UQ4-1#2	0	21	21	Q86UQ4-1	3567	3588	+	21	Q86UQ4-1	0	5058	Q86UQ4-1	0	5058	+	50	Q86UQ4-1#2	0	21	Q86UQ4-1	3567	3588	+	21	0	0	1925
Q86UQ4-1#3	0	21	21	Q86UQ4-1	3606	3627	+	21	Q86UQ4-1	2736	5058	Q86UQ4-7	0	2292	+	56	Q86UQ4-1#3	0	21	Q86UQ4-7	870	891	+	21	0	0	1926
Q86UQ4-1#3	0	21	21	Q86UQ4-1	3606	3627	+	21	Q86UQ4-1	2736	4946	Q86UQ4-6	0	2211	+	55	Q86UQ4-1#3	0	21	Q86UQ4-6	870	891	+	21	0	0	1927
Q86UQ4-1#3	0	21	21	Q86UQ4-1	3606	3627	+	21	Q86UQ4-1	2736	5058	Q86UQ4-5	0	2323	+	54	Q86UQ4-1#3	0	21	Q86UQ4-5	870	891	+	21	0	0	1928
Q86UQ4-1#3	0	21	21	Q86UQ4-1	3606	3627	+	21	Q86UQ4-1	0	5058	Q86UQ4-4	0	5059	+	53	Q86UQ4-1#3	0	21	Q86UQ4-4	3606	3627	+	21	0	0	1929
Q86UQ4-1#3	0	21	21	Q86UQ4-1	3606	3627	+	21	Q86UQ4-1	2298	5058	Q86UQ4-3	0	2760	+	52	Q86UQ4-1#3	0	21	Q86UQ4-3	1308	1329	+	21	0	0	1930
Q86UQ4-1#3	0	21	21	Q86UQ4-1	3606	3627	+	21	Q86UQ4-1	0	5058	Q86UQ4-1	0	5058	+	50	Q86UQ4-1#3	0	21	Q86UQ4-1	3606	3627	+	21	0	0	1931
Q86UQ4-1#4	0	21	21	Q86UQ4-1	3647	3668	+	21	Q86UQ4-1	2736	5058	Q86UQ4-7	0	2292	+	56	Q86UQ4-1#4	0	21	Q86UQ4-7	911	932	+	21	0	0	1932
Q86UQ4-1#4	0	21	21	Q86UQ4-1	3647	3668	+	21	Q86UQ4-1	2736	4946	Q86UQ4-6	0	2211	+	55	Q86UQ4-1#4	0	21	Q86UQ4-6	911	932	+	21	0	0	1933
Q86UQ4-1#4	0	21	21	Q86UQ4-1	3647	3668	+	21	Q86UQ4-1	2736	5058	Q86UQ4-5	0	2323	+	54	Q86UQ4-1#4	0	21	Q86UQ4-5	911	932	+	21	0	0	1934
Q86UQ4-1#4	0	21	21	Q86UQ4-1	3647	3668	+	21	Q86UQ4-1	0	5058	Q86UQ4-4	0	5059	+	53	Q86UQ4-1#4	0	21	Q86UQ4-4	3647	3668	+	21	0	0	1935
Q86UQ4-1#4	0	21	21	Q86UQ4-1	3647	3668	+	21	Q86UQ4-1	2298	5058	Q86UQ4-3	0	2760	+	52	Q86UQ4-1#4	0	21	Q86UQ4-3	1349	1370	+	21	0	0	1936
Q86UQ4-1#4	0	21	21	Q86UQ4-1	3647	3668	+	21	Q86UQ4-1	0	5058	Q86UQ4-1	0	5058	+	50	Q86UQ4-1#4	0	21	Q86UQ4-1	3647	3668	+	21	0	0	1937
Q86UQ4-1#5	0	21	21	Q86UQ4-1	3678	3699	+	21	Q86UQ4-1	2736	5058	Q86UQ4-7	0	2292	+	56	Q86UQ4-1#5	0	21	Q86UQ4-7	942	963	+	21	0	0	1938
Q86UQ4-1#5	0	21	21	Q86UQ4-1	3678	3699	+	21	Q86UQ4-1	2736	4946	Q86UQ4-6	0	2211	+	55	Q86UQ4-1#5	0	21	Q86UQ4-6	942	963	+	21	0	0	1939
Q86UQ4-1#5	0	21	21	Q86UQ4-1	3678	3699	+	21	Q86UQ4-1	2736	5058	Q86UQ4-5	0	2323	+	54	Q86UQ4-1#5	0	21	Q86UQ4-5	942	963	+	21	0	0	1940
Q86UQ4-1#5	0	21	21	Q86UQ4-1	3678	3699	+	21	Q86UQ4-1	0	5058	Q86UQ4-4	0	5059	+	53	Q86UQ4-1#5	0	21	Q86UQ4-4	3678	3699	+	21	0	0	1941
Q86UQ4-1#5	0	21	21	Q86UQ4-1	3678	3699	+	21	Q86UQ4-1	2298	5058	Q86UQ4-3	0	2760	+	52	Q86UQ4-1#5	0	21	Q86UQ4-3	1380	1401	+	21	0	0	1942
Q86UQ4-1#5	0	21	21	Q86UQ4-1	3678	3699	+	21	Q86UQ4-1	0	5058	Q86UQ4-1	0	5058	+	50	Q86UQ4-1#5	0	21	Q86UQ4-1	3678	3699	+	21	0	0	1943
Q86UQ4-1#6	0	21	21	Q86UQ4-1	3708	3729	+	21	Q86UQ4-1	2736	5058	Q86UQ4-7	0	2292	+	56	Q86UQ4-1#6	0	21	Q86UQ4-7	972	993	+	21	0	0	1944
Q86UQ4-1#6	0	21	21	Q86UQ4-1	3708	3729	+	21	Q86UQ4-1	2736	4946	Q86UQ4-6	0	2211	+	55	Q86UQ4-1#6	0	21	Q86UQ4-6	972	993	+	21	0	0	1945
Q86UQ4-1#6	0	21	21	Q86UQ4-1	3708	3729	+	21	Q86UQ4-1	2736	5058	Q86UQ4-5	0	2323	+	54	Q86UQ4-1#6	0	21	Q86UQ4-5	972	993	+	21	0	0	1946
Q86UQ4-1#6	0	21	21	Q86UQ4-1	3708	3729	+	21	Q86UQ4-1	0	5058	Q86UQ4-4	0	5059	+	53	Q86UQ4-1#6	0	21	Q86UQ4-4	3708	3729	+	21	0	0	1947
Q86UQ4-1#6	0	21	21	Q86UQ4-1	3708	3729	+	21	Q86UQ4-1	2298	5058	Q86UQ4-3	0	2760	+	52	Q86UQ4-1#6	0	21	Q86UQ4-3	1410	1431	+	21	0	0	1948
Q86UQ4-1#6	0	21	21	Q86UQ4-1	3708	3729	+	21	Q86UQ4-1	0	5058	Q86UQ4-1	0	5058	+	50	Q86UQ4-1#6	0	21	Q86UQ4-1	3708	3729	+	21	0	0	1949
Q86UQ4-1#7	0	21	21	Q86UQ4-1	3751	3772	+	21	Q86UQ4-1	2736	5058	Q86UQ4-7	0	2292	+	56	Q86UQ4-1#7	0	21	Q86UQ4-7	1015	1036	+	21	0	0	1950
Q86UQ4-1#7	0	21	21	Q86UQ4-1	3751	3772	+	21	Q86UQ4-1	2736	4946	Q86UQ4-6	0	2211	+	55	Q86UQ4-1#7	0	21	Q86UQ4-6	1015	1036	+	21	0	0	1951
Q86UQ4-1#7	0	21	21	Q86UQ4-1	3751	3772	+	21	Q86UQ4-1	2736	5058	Q86UQ4-5	0	2323	+	54	Q86UQ4-1#7	0	21	Q86UQ4-5	1015	1036	+	21	0	0	1952
Q86UQ4-1#7	0	21	21	Q86UQ4-1	3751	3772	+	21	Q86UQ4-1	0	5058	Q86UQ4-4	0	5059	+	53	Q86UQ4-1#7	0	21	Q86UQ4-4	3751	3772	+	21	0	0	1953
Q86UQ4-1#7	0	21	21	Q86UQ4-1	3751	3772	+	21	Q86UQ4-1	2298	5058	Q86UQ4-3	0	2760	+	52	Q86UQ4-1#7	0	21	Q86UQ4-3	1453	1474	+	21	0	0	1954
Q86UQ4-1#7	0	21	21	Q86UQ4-1	3751	3772	+	21	Q86UQ4-1	0	5058	Q86UQ4-1	0	5058	+	50	Q86UQ4-1#7	0	21	Q86UQ4-1	3751	3772	+	21	0	0	1955
Q86UQ4-1#8	0	21	21	Q86UQ4-1	4225	4246	+	21	Q86UQ4-1	2736	5058	Q86UQ4-7	0	2292	+	56	Q86UQ4-1#8	0	21	Q86UQ4-7	1489	1510	+	21	0	0	1956
Q86UQ4-1#8	0	21	21	Q86UQ4-1	4225	4246	+	21	Q86UQ4-1	2736	4946	Q86UQ4-6	0	2211	+	55	Q86UQ4-1#8	0	21	Q86UQ4-6	1489	1510	+	21	0	0	1957
Q86UQ4-1#8	0	21	21	Q86UQ4-1	4225	4246	+	21	Q86UQ4-1	2736	5058	Q86UQ4-5	0	2323	+	54	Q86UQ4-1#8	0	21	Q86UQ4-5	1489	1510	+	21	0	0	1958
Q86UQ4-1#8	0	21	21	Q86UQ4-1	4225	4246	+	21	Q86UQ4-1	0	5058	Q86UQ4-4	0	5059	+	53	Q86UQ4-1#8	0	21	Q86UQ4-4	4225	4246	+	21	0	0	1959
Q86UQ4-1#8	0	21	21	Q86UQ4-1	4225	4246	+	21	Q86UQ4-1	2298	5058	Q86UQ4-3	0	2760	+	52	Q86UQ4-1#8	0	21	Q86UQ4-3	1927	1948	+	21	0	0	1960
Q86UQ4-1#8	0	21	21	Q86UQ4-1	4225	4246	+	21	Q86UQ4-1	0	5058	Q86UQ4-1	0	5058	+	50	Q86UQ4-1#8	0	21	Q86UQ4-1	4225	4246	+	21	0	0	1961
Q86UQ4-1#9	0	21	21	Q86UQ4-1	4457	4478	+	21	Q86UQ4-1	2736	5058	Q86UQ4-7	0	2292	+	56	Q86UQ4-1#9	0	20	Q86UQ4-7	1722	1742	+	20	0	1	1962
Q86UQ4-1#9	0	21	21	Q86UQ4-1	4457	4478	+	21	Q86UQ4-1	2736	4946	Q86UQ4-6	0	2211	+	55	Q86UQ4-1#9	0	21	Q86UQ4-6	1722	1743	+	21	0	0	1963
Q86UQ4-1#9	0	21	21	Q86UQ4-1	4457	4478	+	21	Q86UQ4-1	2736	5058	Q86UQ4-5	0	2323	+	54	Q86UQ4-1#9	0	21	Q86UQ4-5	1722	1743	+	21	0	0	1964
Q86UQ4-1#9	0	21	21	Q86UQ4-1	4457	4478	+	21	Q86UQ4-1	0	5058	Q86UQ4-4	0	5059	+	53	Q86UQ4-1#9	0	21	Q86UQ4-4	4458	4479	+	21	0	0	1965
Q86UQ4-1#9	0	21	21	Q86UQ4-1	4457	4478	+	21	Q86UQ4-1	2298	5058	Q86UQ4-3	0	2760	+	52	Q86UQ4-1#9	0	21	Q86UQ4-3	2159	2180	+	21	0	0	1966
Q86UQ4-1#9	0	21	21	Q86UQ4-1	4457	4478	+	21	Q86UQ4-1	0	5058	Q86UQ4-1	0	5058	+	50	Q86UQ4-1#9	0	21	Q86UQ4-1	4457	4478	+	21	0	0	1967
Q86UQ4-1#10	0	21	21	Q86UQ4-1	4503	4524	+	21	Q86UQ4-1	2736	5058	Q86UQ4-7	0	2292	+	56	Q86UQ4-1#10	5	21	Q86UQ4-7	1742	1758	+	16	5	0	1968
Q86UQ4-1#10	0	21	21	Q86UQ4-1	4503	4524	+	21	Q86UQ4-1	2736	4946	Q86UQ4-6	0	2211	+	55	Q86UQ4-1#10	0	21	Q86UQ4-6	1768	1789	+	21	0	0	1969
Q86UQ4-1#10	0	21	21	Q86UQ4-1	4503	4524	+	21	Q86UQ4-1	2736	5058	Q86UQ4-5	0	2323	+	54	Q86UQ4-1#10	0	21	Q86UQ4-5	1768	1789	+	21	0	0	1970
Q86UQ4-1#10	0	21	21	Q86UQ4-1	4503	4524	+	21	Q86UQ4-1	0	5058	Q86UQ4-4	0	5059	+	53	Q86UQ4-1#10	0	21	Q86UQ4-4	4504	4525	+	21	0	0	1971
Q86UQ4-1#10	0	21	21	Q86UQ4-1	4503	4524	+	21	Q86UQ4-1	2298	5058	Q86UQ4-3	0	2760	+	52	Q86UQ4-1#10	0	21	Q86UQ4-3	2205	2226	+	21	0	0	1972
Q86UQ4-1#10	0	21	21	Q86UQ4-1	4503	4524	+	21	Q86UQ4-1	0	5058	Q86UQ4-1	0	5058	+	50	Q86UQ4-1#10	0	21	Q86UQ4-1	4503	4524	+	21	0	0	1973
Q86UQ4-1#11	0	21	21	Q86UQ4-1	4535	4556	+	21	Q86UQ4-1	2736	5058	Q86UQ4-7	0	2292	+	56	Q86UQ4-1#11	0	21	Q86UQ4-7	1769	1790	+	21	0	0	1974
Q86UQ4-1#11	0	21	21	Q86UQ4-1	4535	4556	+	21	Q86UQ4-1	2736	4946	Q86UQ4-6	0	2211	+	55	Q86UQ4-1#11	0	21	Q86UQ4-6	1800	1821	+	21	0	0	1975
Q86UQ4-1#11	0	21	21	Q86UQ4-1	4535	4556	+	21	Q86UQ4-1	2736	5058	Q86UQ4-5	0	2323	+	54	Q86UQ4-1#11	0	21	Q86UQ4-5	1800	1821	+	21	0	0	1976
Q86UQ4-1#11	0	21	21	Q86UQ4-1	4535	4556	+	21	Q86UQ4-1	0	5058	Q86UQ4-4	0	5059	+	53	Q86UQ4-1#11	0	21	Q86UQ4-4	4536	4557	+	21	0	0	1977
Q86UQ4-1#11	0	21	21	Q86UQ4-1	4535	4556	+	21	Q86UQ4-1	2298	5058	Q86UQ4-3	0	2760	+	52	Q86UQ4-1#11	0	21	Q86UQ4-3	2237	2258	+	21	0	0	1978
Q86UQ4-1#11	0	21	21	Q86UQ4-1	4535	4556	+	21	Q86UQ4-1	0	5058	Q86UQ4-1	0	5058	+	50	Q86UQ4-1#11	0	21	Q86UQ4-1	4535	4556	+	21	0	0	1979
Q86UQ4-1#12	0	21	21	Q86UQ4-1	4567	4588	+	21	Q86UQ4-1	2736	5058	Q86UQ4-7	0	2292	+	56	Q86UQ4-1#12	0	21	Q86UQ4-7	1801	1822	+	21	0	0	1980
Q86UQ4-1#12	0	21	21	Q86UQ4-1	4567	4588	+	21	Q86UQ4-1	2736	4946	Q86UQ4-6	0	2211	+	55	Q86UQ4-1#12	0	21	Q86UQ4-6	1832	1853	+	21	0	0	1981
Q86UQ4-1#12	0	21	21	Q86UQ4-1	4567	4588	+	21	Q86UQ4-1	2736	5058	Q86UQ4-5	0	2323	+	54	Q86UQ4-1#12	0	21	Q86UQ4-5	1832	1853	+	21	0	0	1982
Q86UQ4-1#12	0	21	21	Q86UQ4-1	4567	4588	+	21	Q86UQ4-1	0	5058	Q86UQ4-4	0	5059	+	53	Q86UQ4-1#12	0	21	Q86UQ4-4	4568	4589	+	21	0	0	1983
Q86UQ4-1#12	0	21	21	Q86UQ4-1	4567	4588	+	21	Q86UQ4-1	2298	5058	Q86UQ4-3	0	2760	+	52	Q86UQ4-1#12	0	21	Q86UQ4-3	2269	2290	+	21	0	0	1984
Q86UQ4-1#12	0	21	21	Q86UQ4-1	4567	4588	+	21	Q86UQ4-1	0	5058	Q86UQ4-1	0	5058	+	50	Q86UQ4-1#12	0	21	Q86UQ4-1	4567	4588	+	21	0	0	1985
Q86UQ4-1#13	0	21	21	Q86UQ4-1	4606	4627	+	21	Q86UQ4-1	2736	5058	Q86UQ4-7	0	2292	+	56	Q86UQ4-1#13	0	21	Q86UQ4-7	1840	1861	+	21	0	0	1986
Q86UQ4-1#13	0	21	21	Q86UQ4-1	4606	4627	+	21	Q86UQ4-1	2736	4946	Q86UQ4-6	0	2211	+	55	Q86UQ4-1#13	0	21	Q86UQ4-6	1871	1892	+	21	0	0	1987
Q86UQ4-1#13	0	21	21	Q86UQ4-1	4606	4627	+	21	Q86UQ4-1	2736	5058	Q86UQ4-5	0	2323	+	54	Q86UQ4-1#13	0	21	Q86UQ4-5	1871	1892	+	21	0	0	1988
Q86UQ4-1#13	0	21	21	Q86UQ4-1	4606	4627	+	21	Q86UQ4-1	0	5058	Q86UQ4-4	0	5059	+	53	Q86UQ4-1#13	0	21	Q86UQ4-4	4607	4628	+	21	0	0	1989
Q86UQ4-1#13	0	21	21	Q86UQ4-1	4606	4627	+	21	Q86UQ4-1	2298	5058	Q86UQ4-3	0	2760	+	52	Q86UQ4-1#13	0	21	Q86UQ4-3	2308	2329	+	21	0	0	1990
Q86UQ4-1#13	0	21	21	Q86UQ4-1	4606	4627	+	21	Q86UQ4-1	0	5058	Q86UQ4-1	0	5058	+	50	Q86UQ4-1#13	0	21	Q86UQ4-1	4606	4627	+	21	0	0	1991
Q86UQ4-1#14	0	21	21	Q86UQ4-1	4650	4671	+	21	Q86UQ4-1	2736	5058	Q86UQ4-7	0	2292	+	56	Q86UQ4-1#14	0	21	Q86UQ4-7	1884	1905	+	21	0	0	1992
Q86UQ4-1#14	0	21	21	Q86UQ4-1	4650	4671	+	21	Q86UQ4-1	2736	4946	Q86UQ4-6	0	2211	+	55	Q86UQ4-1#14	0	21	Q86UQ4-6	1915	1936	+	21	0	0	1993
Q86UQ4-1#14	0	21	21	Q86UQ4-1	4650	4671	+	21	Q86UQ4-1	2736	5058	Q86UQ4-5	0	2323	+	54	Q86UQ4-1#14	0	21	Q86UQ4-5	1915	1936	+	21	0	0	1994
Q86UQ4-1#14	0	21	21	Q86UQ4-1	4650	4671	+	21	Q86UQ4-1	0	5058	Q86UQ4-4	0	5059	+	53	Q86UQ4-1#14	0	21	Q86UQ4-4	4651	4672	+	21	0	0	1995
Q86UQ4-1#14	0	21	21	Q86UQ4-1	4650	4671	+	21	Q86UQ4-1	2298	5058	Q86UQ4-3	0	2760	+	52	Q86UQ4-1#14	0	21	Q86UQ4-3	2352	2373	+	21	0	0	1996
Q86UQ4-1#14	0	21	21	Q86UQ4-1	4650	4671	+	21	Q86UQ4-1	0	5058	Q86UQ4-1	0	5058	+	50	Q86UQ4-1#14	0	21	Q86UQ4-1	4650	4671	+	21	0	0	1997
Q86UQ4-1#15	0	233	233	Q86UQ4-1	3841	4074	+	233	Q86UQ4-1	2736	5058	Q86UQ4-7	0	2292	+	56	Q86UQ4-1#15	0	233	Q86UQ4-7	1105	1338	+	233	0	0	1998
Q86UQ4-1#15	0	233	233	Q86UQ4-1	3841	4074	+	233	Q86UQ4-1	2736	4946	Q86UQ4-6	0	2211	+	55	Q86UQ4-1#15	0	233	Q86UQ4-6	1105	1338	+	233	0	0	1999
Q86UQ4-1#15	0	233	233	Q86UQ4-1	3841	4074	+	233	Q86UQ4-1	2736	5058	Q86UQ4-5	0	2323	+	54	Q86UQ4-1#15	0	233	Q86UQ4-5	1105	1338	+	233	0	0	2000
Q86UQ4-1#15	0	233	233	Q86UQ4-1	3841	4074	+	233	Q86UQ4-1	0	5058	Q86UQ4-4	0	5059	+	53	Q86UQ4-1#15	0	233	Q86UQ4-4	3841	4074	+	233	0	0	2001
Q86UQ4-1#15	0	233	233	Q86UQ4-1	3841	4074	+	233	Q86UQ4-1	2298	5058	Q86UQ4-3	0	2760	+	52	Q86UQ4-1#15	0	233	Q86UQ4-3	1543	1776	+	233	0	0	2002
Q86UQ4-1#15	0	233	233	Q86UQ4-1	3841	4074	+	233	Q86UQ4-1	0	5058	Q86UQ4-1	0	5058	+	50	Q86UQ4-1#15	0	233	Q86UQ4-1	3841	4074	+	233	0	0	2003
Q86UQ4-1#16	0	239	239	Q86UQ4-1	4717	4956	+	239	Q86UQ4-1	2736	5058	Q86UQ4-7	0	2292	+	56	Q86UQ4-1#16	0	239	Q86UQ4-7	1951	2190	+	239	0	0	2004
Q86UQ4-1#16	0	239	239	Q86UQ4-1	4717	4956	+	239	Q86UQ4-1	2736	4946	Q86UQ4-6	0	2211	+	55	Q86UQ4-1#16	0	229	Q86UQ4-6	1982	2211	+	229	0	10	2005
Q86UQ4-1#16	0	239	239	Q86UQ4-1	4717	4956	+	239	Q86UQ4-1	2736	5058	Q86UQ4-5	0	2323	+	54	Q86UQ4-1#16	0	239	Q86UQ4-5	1982	2221	+	239	0	0	2006
Q86UQ4-1#16	0	239	239	Q86UQ4-1	4717	4956	+	239	Q86UQ4-1	0	5058	Q86UQ4-4	0	5059	+	53	Q86UQ4-1#16	0	239	Q86UQ4-4	4718	4957	+	239	0	0	2007
Q86UQ4-1#16	0	239	239	Q86UQ4-1	4717	4956	+	239	Q86UQ4-1	2298	5058	Q86UQ4-3	0	2760	+	52	Q86UQ4-1#16	0	239	Q86UQ4-3	2419	2658	+	239	0	0	2008
Q86UQ4-1#16	0	239	239	Q86UQ4-1	4717	4956	+	239	Q86UQ4-1	0	5058	Q86UQ4-1	0	5058	+	50	Q86UQ4-1#16	0	239	Q86UQ4-1	4717	4956	+	239	0	0	2009
Q86UQ4-1#17	0	8	8	Q86UQ4-1	3874	3882	+	8	Q86UQ4-1	2736	5058	Q86UQ4-7	0	2292	+	56	Q86UQ4-1#17	0	8	Q86UQ4-7	1138	1146	+	8	0	0	2010
Q86UQ4-1#17	0	8	8	Q86UQ4-1	3874	3882	+	8	Q86UQ4-1	2736	4946	Q86UQ4-6	0	2211	+	55	Q86UQ4-1#17	0	8	Q86UQ4-6	1138	1146	+	8	0	0	2011
Q86UQ4-1#17	0	8	8	Q86UQ4-1	3874	3882	+	8	Q86UQ4-1	2736	5058	Q86UQ4-5	0	2323	+	54	Q86UQ4-1#17	0	8	Q86UQ4-5	1138	1146	+	8	0	0	2012
Q86UQ4-1#17	0	8	8	Q86UQ4-1	3874	3882	+	8	Q86UQ4-1	0	5058	Q86UQ4-4	0	5059	+	53	Q86UQ4-1#17	0	8	Q86UQ4-4	3874	3882	+	8	0	0	2013
Q86UQ4-1#17	0	8	8	Q86UQ4-1	3874	3882	+	8	Q86UQ4-1	2298	5058	Q86UQ4-3	0	2760	+	52	Q86UQ4-1#17	0	8	Q86UQ4-3	1576	1584	+	8	0	0	2014
Q86UQ4-1#17	0	8	8	Q86UQ4-1	3874	3882	+	8	Q86UQ4-1	0	5058	Q86UQ4-1	0	5058	+	50	Q86UQ4-1#17	0	8	Q86UQ4-1	3874	3882	+	8	0	0	2015
Q86UQ4-1#18	0	8	8	Q86UQ4-1	4753	4761	+	8	Q86UQ4-1	2736	5058	Q86UQ4-7	0	2292	+	56	Q86UQ4-1#18	0	8	Q86UQ4-7	1987	1995	+	8	0	0	2016
Q86UQ4-1#18	0	8	8	Q86UQ4-1	4753	4761	+	8	Q86UQ4-1	2736	4946	Q86UQ4-6	0	2211	+	55	Q86UQ4-1#18	0	8	Q86UQ4-6	2018	2026	+	8	0	0	2017
Q86UQ4-1#18	0	8	8	Q86UQ4-1	4753	4761	+	8	Q86UQ4-1	2736	5058	Q86UQ4-5	0	2323	+	54	Q86UQ4-1#18	0	8	Q86UQ4-5	2018	2026	+	8	0	0	2018
Q86UQ4-1#18	0	8	8	Q86UQ4-1	4753	4761	+	8	Q86UQ4-1	0	5058	Q86UQ4-4	0	5059	+	53	Q86UQ4-1#18	0	8	Q86UQ4-4	4754	4762	+	8	0	0	2019
Q86UQ4-1#18	0	8	8	Q86UQ4-1	4753	4761	+	8	Q86UQ4-1	2298	5058	Q86UQ4-3	0	2760	+	52	Q86UQ4-1#18	0	8	Q86UQ4-3	2455	2463	+	8	0	0	2020
Q86UQ4-1#18	0	8	8	Q86UQ4-1	4753	4761	+	8	Q86UQ4-1	0	5058	Q86UQ4-1	0	5058	+	50	Q86UQ4-1#18	0	8	Q86UQ4-1	4753	4761	+	8	0	0	2021
Q86UQ4-1#19	0	2736	2736	Q86UQ4-1	0	2736	+	2736	Q86UQ4-1	0	5058	Q86UQ4-4	0	5059	+	53	Q86UQ4-1#19	0	2736	Q86UQ4-4	0	2736	+	2736	0	0	2022
Q86UQ4-1#19	0	2736	2736	Q86UQ4-1	0	2736	+	2736	Q86UQ4-1	2298	5058	Q86UQ4-3	0	2760	+	52	Q86UQ4-1#19	2298	2736	Q86UQ4-3	0	438	+	438	2298	0	2023
Q86UQ4-1#19	0	2736	2736	Q86UQ4-1	0	2736	+	2736	Q86UQ4-1	0	299	Q86UQ4-2	0	299	+	51	Q86UQ4-1#19	0	299	Q86UQ4-2	0	299	+	299	0	2437	2024
Q86UQ4-1#19	0	2736	2736	Q86UQ4-1	0	2736	+	2736	Q86UQ4-1	0	5058	Q86UQ4-1	0	5058	+	50	Q86UQ4-1#19	0	2736	Q86UQ4-1	0	2736	+	2736	0	0	2025
Q86UQ4-1#20	0	2298	2298	Q86UQ4-1	0	2298	+	2298	Q86UQ4-1	0	5058	Q86UQ4-4	0	5059	+	53	Q86UQ4-1#20	0	2298	Q86UQ4-4	0	2298	+	2298	0	0	2026
Q86UQ4-1#20	0	2298	2298	Q86UQ4-1	0	2298	+	2298	Q86UQ4-1	0	299	Q86UQ4-2	0	299	+	51	Q86UQ4-1#20	0	299	Q86UQ4-2	0	299	+	299	0	1999	2027
Q86UQ4-1#20	0	2298	2298	Q86UQ4-1	0	2298	+	2298	Q86UQ4-1	0	5058	Q86UQ4-1	0	5058	+	50	Q86UQ4-1#20	0	2298	Q86UQ4-1	0	2298	+	2298	0	0	2028
Q86UQ4-1#21	0	18	18	Q86UQ4-1	299	317	+	18	Q86UQ4-1	0	5058	Q86UQ4-4	0	5059	+	53	Q86UQ4-1#21	0	18	Q86UQ4-4	299	317	+	18	0	0	2029
Q86UQ4-1#21	0	18	18	Q86UQ4-1	299	317	+	18	Q86UQ4-1	0	5058	Q86UQ4-1	0	5058	+	50	Q86UQ4-1#21	0	18	Q86UQ4-1	299	317	+	18	0	0	2030
Q86UQ4-1#22	0	4741	4741	Q86UQ4-1	317	5058	+	4741	Q86UQ4-1	2736	5058	Q86UQ4-7	0	2292	+	56	Q86UQ4-1#22	2419	4741	Q86UQ4-7	0	2292	+	2291	2419	0	2031
Q86UQ4-1#22	0	4741	4741	Q86UQ4-1	317	5058	+	4741	Q86UQ4-1	2736	4946	Q86UQ4-6	0	2211	+	55	Q86UQ4-1#22	2419	4629	Q86UQ4-6	0	2211	+	2210	2419	112	2032
Q86UQ4-1#22	0	4741	4741	Q86UQ4-1	317	5058	+	4741	Q86UQ4-1	2736	5058	Q86UQ4-5	0	2323	+	54	Q86UQ4-1#22	2419	4741	Q86UQ4-5	0	2323	+	2322	2419	0	2033
Q86UQ4-1#22	0	4741	4741	Q86UQ4-1	317	5058	+	4741	Q86UQ4-1	0	5058	Q86UQ4-4	0	5059	+	53	Q86UQ4-1#22	0	4741	Q86UQ4-4	317	5059	+	4741	0	0	2034
Q86UQ4-1#22	0	4741	4741	Q86UQ4-1	317	5058	+	4741	Q86UQ4-1	2298	5058	Q86UQ4-3	0	2760	+	52	Q86UQ4-1#22	1981	4741	Q86UQ4-3	0	2760	+	2760	1981	0	2035
Q86UQ4-1#22	0	4741	4741	Q86UQ4-1	317	5058	+	4741	Q86UQ4-1	0	5058	Q86UQ4-1	0	5058	+	50	Q86UQ4-1#22	0	4741	Q86UQ4-1	317	5058	+	4741	0	0	2036
Q86UQ4-1#23	0	1	1	Q86UQ4-1	4270	4271	+	1	Q86UQ4-1	2736	5058	Q86UQ4-7	0	2292	+	56	Q86UQ4-1#23	0	1	Q86UQ4-7	1534	1535	+	1	0	0	2037
Q86UQ4-1#23	0	1	1	Q86UQ4-1	4270	4271	+	1	Q86UQ4-1	2736	4946	Q86UQ4-6	0	2211	+	55	Q86UQ4-1#23	0	1	Q86UQ4-6	1534	1535	+	1	0	0	2038
Q86UQ4-1#23	0	1	1	Q86UQ4-1	4270	4271	+	1	Q86UQ4-1	2736	5058	Q86UQ4-5	0	2323	+	54	Q86UQ4-1#23	0	1	Q86UQ4-5	1534	1535	+	1	0	0	2039
Q86UQ4-1#23	0	1	1	Q86UQ4-1	4270	4271	+	1	Q86UQ4-1	0	5058	Q86UQ4-4	0	5059	+	53	Q86UQ4-1#23	0	1	Q86UQ4-4	4271	4272	+	1	0	0	2040
Q86UQ4-1#23	0	1	1	Q86UQ4-1	4270	4271	+	1	Q86UQ4-1	2298	5058	Q86UQ4-3	0	2760	+	52	Q86UQ4-1#23	0	1	Q86UQ4-3	1972	1973	+	1	0	0	2041
Q86UQ4-1#23	0	1	1	Q86UQ4-1	4270	4271	+	1	Q86UQ4-1	0	5058	Q86UQ4-1	0	5058	+	50	Q86UQ4-1#23	0	1	Q86UQ4-1	4270	4271	+	1	0	0	2042
Q86UQ4-1#24	0	31	31	Q86UQ4-1	4477	4508	+	31	Q86UQ4-1	2736	4946	Q86UQ4-6	0	2211	+	55	Q86UQ4-1#24	0	31	Q86UQ4-6	1742	1773	+	31	0	0	2043
Q86UQ4-1#24	0	31	31	Q86UQ4-1	4477	4508	+	31	Q86UQ4-1	2736	5058	Q86UQ4-5	0	2323	+	54	Q86UQ4-1#24	0	31	Q86UQ4-5	1742	1773	+	31	0	0	2044
Q86UQ4-1#24	0	31	31	Q86UQ4-1	4477	4508	+	31	Q86UQ4-1	0	5058	Q86UQ4-4	0	5059	+	53	Q86UQ4-1#24	0	31	Q86UQ4-4	4478	4509	+	31	0	0	2045
Q86UQ4-1#24	0	31	31	Q86UQ4-1	4477	4508	+	31	Q86UQ4-1	2298	5058	Q86UQ4-3	0	2760	+	52	Q86UQ4-1#24	0	31	Q86UQ4-3	2179	2210	+	31	0	0	2046
Q86UQ4-1#24	0	31	31	Q86UQ4-1	4477	4508	+	31	Q86UQ4-1	0	5058	Q86UQ4-1	0	5058	+	50	Q86UQ4-1#24	0	31	Q86UQ4-1	4477	4508	+	31	0	0	2047
Q86UQ4-1#25	0	112	112	Q86UQ4-1	4946	5058	+	112	Q86UQ4-1	2736	5058	Q86UQ4-7	0	2292	+	56	Q86UQ4-1#25	0	112	Q86UQ4-7	2180	2292	+	112	0	0	2048
Q86UQ4-1#25	0	112	112	Q86UQ4-1	4946	5058	+	112	Q86UQ4-1	2736	5058	Q86UQ4-5	0	2323	+	54	Q86UQ4-1#25	0	112	Q86UQ4-5	2211	2323	+	112	0	0	2049
Q86UQ4-1#25	0	112	112	Q86UQ4-1	4946	5058	+	112	Q86UQ4-1	0	5058	Q86UQ4-4	0	5059	+	53	Q86UQ4-1#25	0	112	Q86UQ4-4	4947	5059	+	112	0	0	2050
Q86UQ4-1#25	0	112	112	Q86UQ4-1	4946	5058	+	112	Q86UQ4-1	2298	5058	Q86UQ4-3	0	2760	+	52	Q86UQ4-1#25	0	112	Q86UQ4-3	2648	2760	+	112	0	0	2051
Q86UQ4-1#25	0	112	112	Q86UQ4-1	4946	5058	+	112	Q86UQ4-1	0	5058	Q86UQ4-1	0	5058	+	50	Q86UQ4-1#25	0	112	Q86UQ4-1	4946	5058	+	112	0	0	2052
Q86UQ4-1#26	0	1	1	Q86UQ4-1	505	506	+	1	Q86UQ4-1	0	5058	Q86UQ4-4	0	5059	+	53	Q86UQ4-1#26	0	1	Q86UQ4-4	505	506	+	1	0	0	2053
Q86UQ4-1#26	0	1	1	Q86UQ4-1	505	506	+	1	Q86UQ4-1	0	5058	Q86UQ4-1	0	5058	+	50	Q86UQ4-1#26	0	1	Q86UQ4-1	505	506	+	1	0	0	2054
Q86UQ4-1#27	0	1	1	Q86UQ4-1	554	555	+	1	Q86UQ4-1	0	5058	Q86UQ4-4	0	5059	+	53	Q86UQ4-1#27	0	1	Q86UQ4-4	554	555	+	1	0	0	2055
Q86UQ4-1#27	0	1	1	Q86UQ4-1	554	555	+	1	Q86UQ4-1	0	5058	Q86UQ4-1	0	5058	+	50	Q86UQ4-1#27	0	1	Q86UQ4-1	554	555	+	1	0	0	2056
Q86UQ4-1#28	0	1	1	Q86UQ4-1	766	767	+	1	Q86UQ4-1	0	5058	Q86UQ4-4	0	5059	+	53	Q86UQ4-1#28	0	1	Q86UQ4-4	766	767	+	1	0	0	2057
Q86UQ4-1#28	0	1	1	Q86UQ4-1	766	767	+	1	Q86UQ4-1	0	5058	Q86UQ4-1	0	5058	+	50	Q86UQ4-1#28	0	1	Q86UQ4-1	766	767	+	1	0	0	2058
Q86UQ4-1#29	0	1	1	Q86UQ4-1	798	799	+	1	Q86UQ4-1	0	5058	Q86UQ4-4	0	5059	+	53	Q86UQ4-1#29	0	1	Q86UQ4-4	798	799	+	1	0	0	2059
Q86UQ4-1#29	0	1	1	Q86UQ4-1	798	799	+	1	Q86UQ4-1	0	5058	Q86UQ4-1	0	5058	+	50	Q86UQ4-1#29	0	1	Q86UQ4-1	798	799	+	1	0	0	2060
Q86UQ4-1#30	0	1	1	Q86UQ4-1	1433	1434	+	1	Q86UQ4-1	0	5058	Q86UQ4-4	0	5059	+	53	Q86UQ4-1#30	0	1	Q86UQ4-4	1433	1434	+	1	0	0	2061
Q86UQ4-1#30	0	1	1	Q86UQ4-1	1433	1434	+	1	Q86UQ4-1	0	5058	Q86UQ4-1	0	5058	+	50	Q86UQ4-1#30	0	1	Q86UQ4-1	1433	1434	+	1	0	0	2062
Q86UQ4-1#31	0	1	1	Q86UQ4-1	1507	1508	+	1	Q86UQ4-1	0	5058	Q86UQ4-4	0	5059	+	53	Q86UQ4-1#31	0	1	Q86UQ4-4	1507	1508	+	1	0	0	2063
Q86UQ4-1#31	0	1	1	Q86UQ4-1	1507	1508	+	1	Q86UQ4-1	0	5058	Q86UQ4-1	0	5058	+	50	Q86UQ4-1#31	0	1	Q86UQ4-1	1507	1508	+	1	0	0	2064
Q86UQ4-1#32	0	1	1	Q86UQ4-1	1539	1540	+	1	Q86UQ4-1	0	5058	Q86UQ4-4	0	5059	+	53	Q86UQ4-1#32	0	1	Q86UQ4-4	1539	1540	+	1	0	0	2065
Q86UQ4-1#32	0	1	1	Q86UQ4-1	1539	1540	+	1	Q86UQ4-1	0	5058	Q86UQ4-1	0	5058	+	50	Q86UQ4-1#32	0	1	Q86UQ4-1	1539	1540	+	1	0	0	2066
Q86UQ4-1#33	0	1	1	Q86UQ4-1	1888	1889	+	1	Q86UQ4-1	0	5058	Q86UQ4-4	0	5059	+	53	Q86UQ4-1#33	0	1	Q86UQ4-4	1888	1889	+	1	0	0	2067
Q86UQ4-1#33	0	1	1	Q86UQ4-1	1888	1889	+	1	Q86UQ4-1	0	5058	Q86UQ4-1	0	5058	+	50	Q86UQ4-1#33	0	1	Q86UQ4-1	1888	1889	+	1	0	0	2068
Q86UQ4-1#34	0	1	1	Q86UQ4-1	2032	2033	+	1	Q86UQ4-1	0	5058	Q86UQ4-4	0	5059	+	53	Q86UQ4-1#34	0	1	Q86UQ4-4	2032	2033	+	1	0	0	2069
Q86UQ4-1#34	0	1	1	Q86UQ4-1	2032	2033	+	1	Q86UQ4-1	0	5058	Q86UQ4-1	0	5058	+	50	Q86UQ4-1#34	0	1	Q86UQ4-1	2032	2033	+	1	0	0	2070
Q86UQ4-1#35	0	1	1	Q86UQ4-1	2153	2154	+	1	Q86UQ4-1	0	5058	Q86UQ4-4	0	5059	+	53	Q86UQ4-1#35	0	1	Q86UQ4-4	2153	2154	+	1	0	0	2071
Q86UQ4-1#35	0	1	1	Q86UQ4-1	2153	2154	+	1	Q86UQ4-1	0	5058	Q86UQ4-1	0	5058	+	50	Q86UQ4-1#35	0	1	Q86UQ4-1	2153	2154	+	1	0	0	2072
Q86UQ4-1#36	0	1	1	Q86UQ4-1	2177	2178	+	1	Q86UQ4-1	0	5058	Q86UQ4-4	0	5059	+	53	Q86UQ4-1#36	0	1	Q86UQ4-4	2177	2178	+	1	0	0	2073
Q86UQ4-1#36	0	1	1	Q86UQ4-1	2177	2178	+	1	Q86UQ4-1	0	5058	Q86UQ4-1	0	5058	+	50	Q86UQ4-1#36	0	1	Q86UQ4-1	2177	2178	+	1	0	0	2074
Q86UQ4-1#37	0	1	1	Q86UQ4-1	2211	2212	+	1	Q86UQ4-1	0	5058	Q86UQ4-4	0	5059	+	53	Q86UQ4-1#37	0	1	Q86UQ4-4	2211	2212	+	1	0	0	2075
Q86UQ4-1#37	0	1	1	Q86UQ4-1	2211	2212	+	1	Q86UQ4-1	0	5058	Q86UQ4-1	0	5058	+	50	Q86UQ4-1#37	0	1	Q86UQ4-1	2211	2212	+	1	0	0	2076
Q86UQ4-1#38	0	1	1	Q86UQ4-1	2435	2436	+	1	Q86UQ4-1	0	5058	Q86UQ4-4	0	5059	+	53	Q86UQ4-1#38	0	1	Q86UQ4-4	2435	2436	+	1	0	0	2077
Q86UQ4-1#38	0	1	1	Q86UQ4-1	2435	2436	+	1	Q86UQ4-1	2298	5058	Q86UQ4-3	0	2760	+	52	Q86UQ4-1#38	0	1	Q86UQ4-3	137	138	+	1	0	0	2078
Q86UQ4-1#38	0	1	1	Q86UQ4-1	2435	2436	+	1	Q86UQ4-1	0	5058	Q86UQ4-1	0	5058	+	50	Q86UQ4-1#38	0	1	Q86UQ4-1	2435	2436	+	1	0	0	2079
Q86UQ4-1#39	0	1	1	Q86UQ4-1	2536	2537	+	1	Q86UQ4-1	0	5058	Q86UQ4-4	0	5059	+	53	Q86UQ4-1#39	0	1	Q86UQ4-4	2536	2537	+	1	0	0	2080
Q86UQ4-1#39	0	1	1	Q86UQ4-1	2536	2537	+	1	Q86UQ4-1	2298	5058	Q86UQ4-3	0	2760	+	52	Q86UQ4-1#39	0	1	Q86UQ4-3	238	239	+	1	0	0	2081
Q86UQ4-1#39	0	1	1	Q86UQ4-1	2536	2537	+	1	Q86UQ4-1	0	5058	Q86UQ4-1	0	5058	+	50	Q86UQ4-1#39	0	1	Q86UQ4-1	2536	2537	+	1	0	0	2082
Q86UQ4-1#40	0	1	1	Q86UQ4-1	2673	2674	+	1	Q86UQ4-1	0	5058	Q86UQ4-4	0	5059	+	53	Q86UQ4-1#40	0	1	Q86UQ4-4	2673	2674	+	1	0	0	2083
Q86UQ4-1#40	0	1	1	Q86UQ4-1	2673	2674	+	1	Q86UQ4-1	2298	5058	Q86UQ4-3	0	2760	+	52	Q86UQ4-1#40	0	1	Q86UQ4-3	375	376	+	1	0	0	2084
Q86UQ4-1#40	0	1	1	Q86UQ4-1	2673	2674	+	1	Q86UQ4-1	0	5058	Q86UQ4-1	0	5058	+	50	Q86UQ4-1#40	0	1	Q86UQ4-1	2673	2674	+	1	0	0	2085
Q86UQ4-1#41	0	1	1	Q86UQ4-1	3141	3142	+	1	Q86UQ4-1	2736	5058	Q86UQ4-7	0	2292	+	56	Q86UQ4-1#41	0	1	Q86UQ4-7	405	406	+	1	0	0	2086
Q86UQ4-1#41	0	1	1	Q86UQ4-1	3141	3142	+	1	Q86UQ4-1	2736	4946	Q86UQ4-6	0	2211	+	55	Q86UQ4-1#41	0	1	Q86UQ4-6	405	406	+	1	0	0	2087
Q86UQ4-1#41	0	1	1	Q86UQ4-1	3141	3142	+	1	Q86UQ4-1	2736	5058	Q86UQ4-5	0	2323	+	54	Q86UQ4-1#41	0	1	Q86UQ4-5	405	406	+	1	0	0	2088
Q86UQ4-1#41	0	1	1	Q86UQ4-1	3141	3142	+	1	Q86UQ4-1	0	5058	Q86UQ4-4	0	5059	+	53	Q86UQ4-1#41	0	1	Q86UQ4-4	3141	3142	+	1	0	0	2089
Q86UQ4-1#41	0	1	1	Q86UQ4-1	3141	3142	+	1	Q86UQ4-1	2298	5058	Q86UQ4-3	0	2760	+	52	Q86UQ4-1#41	0	1	Q86UQ4-3	843	844	+	1	0	0	2090
Q86UQ4-1#41	0	1	1	Q86UQ4-1	3141	3142	+	1	Q86UQ4-1	0	5058	Q86UQ4-1	0	5058	+	50	Q86UQ4-1#41	0	1	Q86UQ4-1	3141	3142	+	1	0	0	2091
Q86UQ4-1#42	0	1	1	Q86UQ4-1	3850	3851	+	1	Q86UQ4-1	2736	5058	Q86UQ4-7	0	2292	+	56	Q86UQ4-1#42	0	1	Q86UQ4-7	1114	1115	+	1	0	0	2092
Q86UQ4-1#42	0	1	1	Q86UQ4-1	3850	3851	+	1	Q86UQ4-1	2736	4946	Q86UQ4-6	0	2211	+	55	Q86UQ4-1#42	0	1	Q86UQ4-6	1114	1115	+	1	0	0	2093
Q86UQ4-1#42	0	1	1	Q86UQ4-1	3850	3851	+	1	Q86UQ4-1	2736	5058	Q86UQ4-5	0	2323	+	54	Q86UQ4-1#42	0	1	Q86UQ4-5	1114	1115	+	1	0	0	2094
Q86UQ4-1#42	0	1	1	Q86UQ4-1	3850	3851	+	1	Q86UQ4-1	0	5058	Q86UQ4-4	0	5059	+	53	Q86UQ4-1#42	0	1	Q86UQ4-4	3850	3851	+	1	0	0	2095
Q86UQ4-1#42	0	1	1	Q86UQ4-1	3850	3851	+	1	Q86UQ4-1	2298	5058	Q86UQ4-3	0	2760	+	52	Q86UQ4-1#42	0	1	Q86UQ4-3	1552	1553	+	1	0	0	2096
Q86UQ4-1#42	0	1	1	Q86UQ4-1	3850	3851	+	1	Q86UQ4-1	0	5058	Q86UQ4-1	0	5058	+	50	Q86UQ4-1#42	0	1	Q86UQ4-1	3850	3851	+	1	0	0	2097
Q86UQ4-1#43	0	1	1	Q86UQ4-1	4276	4277	+	1	Q86UQ4-1	2736	5058	Q86UQ4-7	0	2292	+	56	Q86UQ4-1#43	0	1	Q86UQ4-7	1541	1542	+	1	0	0	2098
Q86UQ4-1#43	0	1	1	Q86UQ4-1	4276	4277	+	1	Q86UQ4-1	2736	4946	Q86UQ4-6	0	2211	+	55	Q86UQ4-1#43	0	1	Q86UQ4-6	1541	1542	+	1	0	0	2099
Q86UQ4-1#43	0	1	1	Q86UQ4-1	4276	4277	+	1	Q86UQ4-1	2736	5058	Q86UQ4-5	0	2323	+	54	Q86UQ4-1#43	0	1	Q86UQ4-5	1541	1542	+	1	0	0	2100
Q86UQ4-1#43	0	1	1	Q86UQ4-1	4276	4277	+	1	Q86UQ4-1	0	5058	Q86UQ4-4	0	5059	+	53	Q86UQ4-1#43	0	1	Q86UQ4-4	4277	4278	+	1	0	0	2101
Q86UQ4-1#43	0	1	1	Q86UQ4-1	4276	4277	+	1	Q86UQ4-1	2298	5058	Q86UQ4-3	0	2760	+	52	Q86UQ4-1#43	0	1	Q86UQ4-3	1978	1979	+	1	0	0	2102
Q86UQ4-1#43	0	1	1	Q86UQ4-1	4276	4277	+	1	Q86UQ4-1	0	5058	Q86UQ4-1	0	5058	+	50	Q86UQ4-1#43	0	1	Q86UQ4-1	4276	4277	+	1	0	0	2103
Q86UQ4-1#44	0	1	1	Q86UQ4-1	4301	4302	+	1	Q86UQ4-1	2736	5058	Q86UQ4-7	0	2292	+	56	Q86UQ4-1#44	0	1	Q86UQ4-7	1566	1567	+	1	0	0	2104
Q86UQ4-1#44	0	1	1	Q86UQ4-1	4301	4302	+	1	Q86UQ4-1	2736	4946	Q86UQ4-6	0	2211	+	55	Q86UQ4-1#44	0	1	Q86UQ4-6	1566	1567	+	1	0	0	2105
Q86UQ4-1#44	0	1	1	Q86UQ4-1	4301	4302	+	1	Q86UQ4-1	2736	5058	Q86UQ4-5	0	2323	+	54	Q86UQ4-1#44	0	1	Q86UQ4-5	1566	1567	+	1	0	0	2106
Q86UQ4-1#44	0	1	1	Q86UQ4-1	4301	4302	+	1	Q86UQ4-1	0	5058	Q86UQ4-4	0	5059	+	53	Q86UQ4-1#44	0	1	Q86UQ4-4	4302	4303	+	1	0	0	2107
Q86UQ4-1#44	0	1	1	Q86UQ4-1	4301	4302	+	1	Q86UQ4-1	2298	5058	Q86UQ4-3	0	2760	+	52	Q86UQ4-1#44	0	1	Q86UQ4-3	2003	2004	+	1	0	0	2108
Q86UQ4-1#44	0	1	1	Q86UQ4-1	4301	4302	+	1	Q86UQ4-1	0	5058	Q86UQ4-1	0	5058	+	50	Q86UQ4-1#44	0	1	Q86UQ4-1	4301	4302	+	1	0	0	2109
Q86UQ4-1#45	0	1	1	Q86UQ4-1	4334	4335	+	1	Q86UQ4-1	2736	5058	Q86UQ4-7	0	2292	+	56	Q86UQ4-1#45	0	1	Q86UQ4-7	1599	1600	+	1	0	0	2110
Q86UQ4-1#45	0	1	1	Q86UQ4-1	4334	4335	+	1	Q86UQ4-1	2736	4946	Q86UQ4-6	0	2211	+	55	Q86UQ4-1#45	0	1	Q86UQ4-6	1599	1600	+	1	0	0	2111
Q86UQ4-1#45	0	1	1	Q86UQ4-1	4334	4335	+	1	Q86UQ4-1	2736	5058	Q86UQ4-5	0	2323	+	54	Q86UQ4-1#45	0	1	Q86UQ4-5	1599	1600	+	1	0	0	2112
Q86UQ4-1#45	0	1	1	Q86UQ4-1	4334	4335	+	1	Q86UQ4-1	0	5058	Q86UQ4-4	0	5059	+	53	Q86UQ4-1#45	0	1	Q86UQ4-4	4335	4336	+	1	0	0	2113
Q86UQ4-1#45	0	1	1	Q86UQ4-1	4334	4335	+	1	Q86UQ4-1	2298	5058	Q86UQ4-3	0	2760	+	52	Q86UQ4-1#45	0	1	Q86UQ4-3	2036	2037	+	1	0	0	2114
Q86UQ4-1#45	0	1	1	Q86UQ4-1	4334	4335	+	1	Q86UQ4-1	0	5058	Q86UQ4-1	0	5058	+	50	Q86UQ4-1#45	0	1	Q86UQ4-1	4334	4335	+	1	0	0	2115
Q86UQ4-1#46	0	1	1	Q86UQ4-1	1415	1416	+	1	Q86UQ4-1	0	5058	Q86UQ4-4	0	5059	+	53	Q86UQ4-1#46	0	1	Q86UQ4-4	1415	1416	+	1	0	0	2116
Q86UQ4-1#46	0	1	1	Q86UQ4-1	1415	1416	+	1	Q86UQ4-1	0	5058	Q86UQ4-1	0	5058	+	50	Q86UQ4-1#46	0	1	Q86UQ4-1	1415	1416	+	1	0	0	2117
Q86UQ4-1#47	0	1	1	Q86UQ4-1	2717	2718	+	1	Q86UQ4-1	0	5058	Q86UQ4-4	0	5059	+	53	Q86UQ4-1#47	0	1	Q86UQ4-4	2717	2718	+	1	0	0	2118
Q86UQ4-1#47	0	1	1	Q86UQ4-1	2717	2718	+	1	Q86UQ4-1	2298	5058	Q86UQ4-3	0	2760	+	52	Q86UQ4-1#47	0	1	Q86UQ4-3	419	420	+	1	0	0	2119
Q86UQ4-1#47	0	1	1	Q86UQ4-1	2717	2718	+	1	Q86UQ4-1	0	5058	Q86UQ4-1	0	5058	+	50	Q86UQ4-1#47	0	1	Q86UQ4-1	2717	2718	+	1	0	0	2120
Q86UQ4-1#48	0	1	1	Q86UQ4-1	2830	2831	+	1	Q86UQ4-1	2736	5058	Q86UQ4-7	0	2292	+	56	Q86UQ4-1#48	0	1	Q86UQ4-7	94	95	+	1	0	0	2121
Q86UQ4-1#48	0	1	1	Q86UQ4-1	2830	2831	+	1	Q86UQ4-1	2736	4946	Q86UQ4-6	0	2211	+	55	Q86UQ4-1#48	0	1	Q86UQ4-6	94	95	+	1	0	0	2122
Q86UQ4-1#48	0	1	1	Q86UQ4-1	2830	2831	+	1	Q86UQ4-1	2736	5058	Q86UQ4-5	0	2323	+	54	Q86UQ4-1#48	0	1	Q86UQ4-5	94	95	+	1	0	0	2123
Q86UQ4-1#48	0	1	1	Q86UQ4-1	2830	2831	+	1	Q86UQ4-1	0	5058	Q86UQ4-4	0	5059	+	53	Q86UQ4-1#48	0	1	Q86UQ4-4	2830	2831	+	1	0	0	2124
Q86UQ4-1#48	0	1	1	Q86UQ4-1	2830	2831	+	1	Q86UQ4-1	2298	5058	Q86UQ4-3	0	2760	+	52	Q86UQ4-1#48	0	1	Q86UQ4-3	532	533	+	1	0	0	2125
Q86UQ4-1#48	0	1	1	Q86UQ4-1	2830	2831	+	1	Q86UQ4-1	0	5058	Q86UQ4-1	0	5058	+	50	Q86UQ4-1#48	0	1	Q86UQ4-1	2830	2831	+	1	0	0	2126
Q86UQ4-1#49	0	1	1	Q86UQ4-1	2869	2870	+	1	Q86UQ4-1	2736	5058	Q86UQ4-7	0	2292	+	56	Q86UQ4-1#49	0	1	Q86UQ4-7	133	134	+	1	0	0	2127
Q86UQ4-1#49	0	1	1	Q86UQ4-1	2869	2870	+	1	Q86UQ4-1	2736	4946	Q86UQ4-6	0	2211	+	55	Q86UQ4-1#49	0	1	Q86UQ4-6	133	134	+	1	0	0	2128
Q86UQ4-1#49	0	1	1	Q86UQ4-1	2869	2870	+	1	Q86UQ4-1	2736	5058	Q86UQ4-5	0	2323	+	54	Q86UQ4-1#49	0	1	Q86UQ4-5	133	134	+	1	0	0	2129
Q86UQ4-1#49	0	1	1	Q86UQ4-1	2869	2870	+	1	Q86UQ4-1	0	5058	Q86UQ4-4	0	5059	+	53	Q86UQ4-1#49	0	1	Q86UQ4-4	2869	2870	+	1	0	0	2130
Q86UQ4-1#49	0	1	1	Q86UQ4-1	2869	2870	+	1	Q86UQ4-1	2298	5058	Q86UQ4-3	0	2760	+	52	Q86UQ4-1#49	0	1	Q86UQ4-3	571	572	+	1	0	0	2131
Q86UQ4-1#49	0	1	1	Q86UQ4-1	2869	2870	+	1	Q86UQ4-1	0	5058	Q86UQ4-1	0	5058	+	50	Q86UQ4-1#49	0	1	Q86UQ4-1	2869	2870	+	1	0	0	2132
Q86UQ4-1#50	0	1	1	Q86UQ4-1	3056	3057	+	1	Q86UQ4-1	2736	5058	Q86UQ4-7	0	2292	+	56	Q86UQ4-1#50	0	1	Q86UQ4-7	320	321	+	1	0	0	2133
Q86UQ4-1#50	0	1	1	Q86UQ4-1	3056	3057	+	1	Q86UQ4-1	2736	4946	Q86UQ4-6	0	2211	+	55	Q86UQ4-1#50	0	1	Q86UQ4-6	320	321	+	1	0	0	2134
Q86UQ4-1#50	0	1	1	Q86UQ4-1	3056	3057	+	1	Q86UQ4-1	2736	5058	Q86UQ4-5	0	2323	+	54	Q86UQ4-1#50	0	1	Q86UQ4-5	320	321	+	1	0	0	2135
Q86UQ4-1#50	0	1	1	Q86UQ4-1	3056	3057	+	1	Q86UQ4-1	0	5058	Q86UQ4-4	0	5059	+	53	Q86UQ4-1#50	0	1	Q86UQ4-4	3056	3057	+	1	0	0	2136
Q86UQ4-1#50	0	1	1	Q86UQ4-1	3056	3057	+	1	Q86UQ4-1	2298	5058	Q86UQ4-3	0	2760	+	52	Q86UQ4-1#50	0	1	Q86UQ4-3	758	759	+	1	0	0	2137
Q86UQ4-1#50	0	1	1	Q86UQ4-1	3056	3057	+	1	Q86UQ4-1	0	5058	Q86UQ4-1	0	5058	+	50	Q86UQ4-1#50	0	1	Q86UQ4-1	3056	3057	+	1	0	0	2138
Q86UQ4-1#51	0	1	1	Q86UQ4-1	4445	4446	+	1	Q86UQ4-1	2736	5058	Q86UQ4-7	0	2292	+	56	Q86UQ4-1#51	0	1	Q86UQ4-7	1710	1711	+	1	0	0	2139
Q86UQ4-1#51	0	1	1	Q86UQ4-1	4445	4446	+	1	Q86UQ4-1	2736	4946	Q86UQ4-6	0	2211	+	55	Q86UQ4-1#51	0	1	Q86UQ4-6	1710	1711	+	1	0	0	2140
Q86UQ4-1#51	0	1	1	Q86UQ4-1	4445	4446	+	1	Q86UQ4-1	2736	5058	Q86UQ4-5	0	2323	+	54	Q86UQ4-1#51	0	1	Q86UQ4-5	1710	1711	+	1	0	0	2141
Q86UQ4-1#51	0	1	1	Q86UQ4-1	4445	4446	+	1	Q86UQ4-1	0	5058	Q86UQ4-4	0	5059	+	53	Q86UQ4-1#51	0	1	Q86UQ4-4	4446	4447	+	1	0	0	2142
Q86UQ4-1#51	0	1	1	Q86UQ4-1	4445	4446	+	1	Q86UQ4-1	2298	5058	Q86UQ4-3	0	2760	+	52	Q86UQ4-1#51	0	1	Q86UQ4-3	2147	2148	+	1	0	0	2143
Q86UQ4-1#51	0	1	1	Q86UQ4-1	4445	4446	+	1	Q86UQ4-1	0	5058	Q86UQ4-1	0	5058	+	50	Q86UQ4-1#51	0	1	Q86UQ4-1	4445	4446	+	1	0	0	2144
Q86UQ4-1#52	0	1	1	Q86UQ4-1	4583	4584	+	1	Q86UQ4-1	2736	5058	Q86UQ4-7	0	2292	+	56	Q86UQ4-1#52	0	1	Q86UQ4-7	1817	1818	+	1	0	0	2145
Q86UQ4-1#52	0	1	1	Q86UQ4-1	4583	4584	+	1	Q86UQ4-1	2736	4946	Q86UQ4-6	0	2211	+	55	Q86UQ4-1#52	0	1	Q86UQ4-6	1848	1849	+	1	0	0	2146
Q86UQ4-1#52	0	1	1	Q86UQ4-1	4583	4584	+	1	Q86UQ4-1	2736	5058	Q86UQ4-5	0	2323	+	54	Q86UQ4-1#52	0	1	Q86UQ4-5	1848	1849	+	1	0	0	2147
Q86UQ4-1#52	0	1	1	Q86UQ4-1	4583	4584	+	1	Q86UQ4-1	0	5058	Q86UQ4-4	0	5059	+	53	Q86UQ4-1#52	0	1	Q86UQ4-4	4584	4585	+	1	0	0	2148
Q86UQ4-1#52	0	1	1	Q86UQ4-1	4583	4584	+	1	Q86UQ4-1	2298	5058	Q86UQ4-3	0	2760	+	52	Q86UQ4-1#52	0	1	Q86UQ4-3	2285	2286	+	1	0	0	2149
Q86UQ4-1#52	0	1	1	Q86UQ4-1	4583	4584	+	1	Q86UQ4-1	0	5058	Q86UQ4-1	0	5058	+	50	Q86UQ4-1#52	0	1	Q86UQ4-1	4583	4584	+	1	0	0	2150
A8K2U0-1#0	0	17	17	A8K2U0-1	0	17	+	17	A8K2U0-1	0	1454	A8K2U0-1	0	1454	+	2	A8K2U0-1#0	0	17	A8K2U0-1	0	17	+	17	0	0	2151
A8K2U0-1#1	0	1437	1437	A8K2U0-1	17	1454	+	1437	A8K2U0-1	492	1454	A8K2U0-2	1	963	+	3	A8K2U0-1#1	475	1437	A8K2U0-2	1	963	+	962	475	0	2152
A8K2U0-1#1	0	1437	1437	A8K2U0-1	17	1454	+	1437	A8K2U0-1	0	1454	A8K2U0-1	0	1454	+	2	A8K2U0-1#1	0	1437	A8K2U0-1	17	1454	+	1437	0	0	2153
A8K2U0-1#2	0	32	32	A8K2U0-1	694	726	+	32	A8K2U0-1	492	1454	A8K2U0-2	1	963	+	3	A8K2U0-1#2	0	32	A8K2U0-2	203	235	+	32	0	0	2154
A8K2U0-1#2	0	32	32	A8K2U0-1	694	726	+	32	A8K2U0-1	0	1454	A8K2U0-1	0	1454	+	2	A8K2U0-1#2	0	32	A8K2U0-1	694	726	+	32	0	0	2155
A8K2U0-1#3	0	1	1	A8K2U0-1	119	120	+	1	A8K2U0-1	0	1454	A8K2U0-1	0	1454	+	2	A8K2U0-1#3	0	1	A8K2U0-1	119	120	+	1	0	0	2156
A8K2U0-1#4	0	1	1	A8K2U0-1	280	281	+	1	A8K2U0-1	0	1454	A8K2U0-1	0	1454	+	2	A8K2U0-1#4	0	1	A8K2U0-1	280	281	+	1	0	0	2157
A8K2U0-1#5	0	1	1	A8K2U0-1	408	409	+	1	A8K2U0-1	0	1454	A8K2U0-1	0	1454	+	2	A8K2U0-1#5	0	1	A8K2U0-1	408	409	+	1	0	0	2158
A8K2U0-1#6	0	1	1	A8K2U0-1	856	857	+	1	A8K2U0-1	492	1454	A8K2U0-2	1	963	+	3	A8K2U0-1#6	0	1	A8K2U0-2	365	366	+	1	0	0	2159
A8K2U0-1#6	0	1	1	A8K2U0-1	856	857	+	1	A8K2U0-1	0	1454	A8K2U0-1	0	1454	+	2	A8K2U0-1#6	0	1	A8K2U0-1	856	857	+	1	0	0	2160
A8K2U0-1#7	0	1	1	A8K2U0-1	1019	1020	+	1	A8K2U0-1	492	1454	A8K2U0-2	1	963	+	3	A8K2U0-1#7	0	1	A8K2U0-2	528	529	+	1	0	0	2161
A8K2U0-1#7	0	1	1	A8K2U0-1	1019	1020	+	1	A8K2U0-1	0	1454	A8K2U0-1	0	1454	+	2	A8K2U0-1#7	0	1	A8K2U0-1	1019	1020	+	1	0	0	2162
A8K2U0-1#8	0	39	39	A8K2U0-1	39	78	+	39	A8K2U0-1	0	1454	A8K2U0-1	0	1454	+	2	A8K2U0-1#8	0	39	A8K2U0-1	39	78	+	39	0	0	2163
A8K2U0-1#9	0	51	51	A8K2U0-1	240	291	+	51	A8K2U0-1	0	1454	A8K2U0-1	0	1454	+	2	A8K2U0-1#9	0	51	A8K2U0-1	240	291	+	51	0	0	2164
A8K2U0-1#10	0	21	21	A8K2U0-1	258	279	+	21	A8K2U0-1	0	1454	A8K2U0-1	0	1454	+	2	A8K2U0-1#10	0	21	A8K2U0-1	258	279	+	21	0	0	2165
A8K2U0-1#11	0	94	94	A8K2U0-1	463	557	+	94	A8K2U0-1	492	1454	A8K2U0-2	1	963	+	3	A8K2U0-1#11	29	94	A8K2U0-2	1	66	+	65	29	0	2166
A8K2U0-1#11	0	94	94	A8K2U0-1	463	557	+	94	A8K2U0-1	0	1454	A8K2U0-1	0	1454	+	2	A8K2U0-1#11	0	94	A8K2U0-1	463	557	+	94	0	0	2167
A8K2U0-1#12	0	181	181	A8K2U0-1	588	769	+	181	A8K2U0-1	492	1454	A8K2U0-2	1	963	+	3	A8K2U0-1#12	0	181	A8K2U0-2	97	278	+	181	0	0	2168
A8K2U0-1#12	0	181	181	A8K2U0-1	588	769	+	181	A8K2U0-1	0	1454	A8K2U0-1	0	1454	+	2	A8K2U0-1#12	0	181	A8K2U0-1	588	769	+	181	0	0	2169
A8K2U0-1#13	0	29	29	A8K2U0-1	818	847	+	29	A8K2U0-1	492	1454	A8K2U0-2	1	963	+	3	A8K2U0-1#13	0	29	A8K2U0-2	327	356	+	29	0	0	2170
A8K2U0-1#13	0	29	29	A8K2U0-1	818	847	+	29	A8K2U0-1	0	1454	A8K2U0-1	0	1454	+	2	A8K2U0-1#13	0	29	A8K2U0-1	818	847	+	29	0	0	2171
A8K2U0-1#14	0	37	37	A8K2U0-1	844	881	+	37	A8K2U0-1	492	1454	A8K2U0-2	1	963	+	3	A8K2U0-1#14	0	37	A8K2U0-2	353	390	+	37	0	0	2172
A8K2U0-1#14	0	37	37	A8K2U0-1	844	881	+	37	A8K2U0-1	0	1454	A8K2U0-1	0	1454	+	2	A8K2U0-1#14	0	37	A8K2U0-1	844	881	+	37	0	0	2173
A8K2U0-1#15	0	389	389	A8K2U0-1	918	1307	+	389	A8K2U0-1	492	1454	A8K2U0-2	1	963	+	3	A8K2U0-1#15	0	389	A8K2U0-2	427	816	+	389	0	0	2174
A8K2U0-1#15	0	389	389	A8K2U0-1	918	1307	+	389	A8K2U0-1	0	1454	A8K2U0-1	0	1454	+	2	A8K2U0-1#15	0	389	A8K2U0-1	918	1307	+	389	0	0	2175
A8K2U0-1#16	0	49	49	A8K2U0-1	1074	1123	+	49	A8K2U0-1	492	1454	A8K2U0-2	1	963	+	3	A8K2U0-1#16	0	49	A8K2U0-2	583	632	+	49	0	0	2176
A8K2U0-1#16	0	49	49	A8K2U0-1	1074	1123	+	49	A8K2U0-1	0	1454	A8K2U0-1	0	1454	+	2	A8K2U0-1#16	0	49	A8K2U0-1	1074	1123	+	49	0	0	2177
A8K2U0-1#17	0	116	116	A8K2U0-1	1337	1453	+	116	A8K2U0-1	492	1454	A8K2U0-2	1	963	+	3	A8K2U0-1#17	0	116	A8K2U0-2	846	962	+	116	0	0	2178
A8K2U0-1#17	0	116	116	A8K2U0-1	1337	1453	+	116	A8K2U0-1	0	1454	A8K2U0-1	0	1454	+	2	A8K2U0-1#17	0	116	A8K2U0-1	1337	1453	+	116	0	0	2179
A8K2U0-1#18	0	4	4	A8K2U0-1	969	973	+	4	A8K2U0-1	492	1454	A8K2U0-2	1	963	+	3	A8K2U0-1#18	0	4	A8K2U0-2	478	482	+	4	0	0	2180
A8K2U0-1#18	0	4	4	A8K2U0-1	969	973	+	4	A8K2U0-1	0	1454	A8K2U0-1	0	1454	+	2	A8K2U0-1#18	0	4	A8K2U0-1	969	973	+	4	0	0	2181
A8K2U0-1#19	0	491	491	A8K2U0-1	1	492	+	491	A8K2U0-1	0	1454	A8K2U0-1	0	1454	+	2	A8K2U0-1#19	0	491	A8K2U0-1	1	492	+	491	0	0	2182
A8K2U0-1#20	0	1	1	A8K2U0-1	206	207	+	1	A8K2U0-1	0	1454	A8K2U0-1	0	1454	+	2	A8K2U0-1#20	0	1	A8K2U0-1	206	207	+	1	0	0	2183
A8K2U0-1#21	0	1200	1200	A8K2U0-1	254	1454	+	1200	A8K2U0-1	492	1454	A8K2U0-2	1	963	+	3	A8K2U0-1#21	238	1200	A8K2U0-2	1	963	+	962	238	0	2184
A8K2U0-1#21	0	1200	1200	A8K2U0-1	254	1454	+	1200	A8K2U0-1	0	1454	A8K2U0-1	0	1454	+	2	A8K2U0-1#21	0	1200	A8K2U0-1	254	1454	+	1200	0	0	2185
A8K2U0-1#22	0	1	1	A8K2U0-1	295	296	+	1	A8K2U0-1	0	1454	A8K2U0-1	0	1454	+	2	A8K2U0-1#22	0	1	A8K2U0-1	295	296	+	1	0	0	2186
A8K2U0-1#23	0	1	1	A8K2U0-1	355	356	+	1	A8K2U0-1	0	1454	A8K2U0-1	0	1454	+	2	A8K2U0-1#23	0	1	A8K2U0-1	355	356	+	1	0	0	2187
A8K2U0-1#24	0	1	1	A8K2U0-1	849	850	+	1	A8K2U0-1	492	1454	A8K2U0-2	1	963	+	3	A8K2U0-1#24	0	1	A8K2U0-2	358	359	+	1	0	0	2188
A8K2U0-1#24	0	1	1	A8K2U0-1	849	850	+	1	A8K2U0-1	0	1454	A8K2U0-1	0	1454	+	2	A8K2U0-1#24	0	1	A8K2U0-1	849	850	+	1	0	0	2189
A8K2U0-1#25	0	562	562	A8K2U0-1	892	1454	+	562	A8K2U0-1	492	1454	A8K2U0-2	1	963	+	3	A8K2U0-1#25	0	562	A8K2U0-2	401	963	+	562	0	0	2190
A8K2U0-1#25	0	562	562	A8K2U0-1	892	1454	+	562	A8K2U0-1	0	1454	A8K2U0-1	0	1454	+	2	A8K2U0-1#25	0	562	A8K2U0-1	892	1454	+	562	0	0	2191
A8K2U0-1#26	0	1	1	A8K2U0-1	969	970	+	1	A8K2U0-1	492	1454	A8K2U0-2	1	963	+	3	A8K2U0-1#26	0	1	A8K2U0-2	478	479	+	1	0	0	2192
A8K2U0-1#26	0	1	1	A8K2U0-1	969	970	+	1	A8K2U0-1	0	1454	A8K2U0-1	0	1454	+	2	A8K2U0-1#26	0	1	A8K2U0-1	969	970	+	1	0	0	2193
A8K2U0-1#27	0	483	483	A8K2U0-1	971	1454	+	483	A8K2U0-1	492	1454	A8K2U0-2	1	963	+	3	A8K2U0-1#27	0	483	A8K2U0-2	480	963	+	483	0	0	2194
A8K2U0-1#27	0	483	483	A8K2U0-1	971	1454	+	483	A8K2U0-1	0	1454	A8K2U0-1	0	1454	+	2	A8K2U0-1#27	0	483	A8K2U0-1	971	1454	+	483	0	0	2195
A8K2U0-1#28	0	1	1	A8K2U0-1	1000	1001	+	1	A8K2U0-1	492	1454	A8K2U0-2	1	963	+	3	A8K2U0-1#28	0	1	A8K2U0-2	509	510	+	1	0	0	2196
A8K2U0-1#28	0	1	1	A8K2U0-1	1000	1001	+	1	A8K2U0-1	0	1454	A8K2U0-1	0	1454	+	2	A8K2U0-1#28	0	1	A8K2U0-1	1000	1001	+	1	0	0	2197
A8K2U0-1#29	0	1	1	A8K2U0-1	1121	1122	+	1	A8K2U0-1	492	1454	A8K2U0-2	1	963	+	3	A8K2U0-1#29	0	1	A8K2U0-2	630	631	+	1	0	0	2198
A8K2U0-1#29	0	1	1	A8K2U0-1	1121	1122	+	1	A8K2U0-1	0	1454	A8K2U0-1	0	1454	+	2	A8K2U0-1#29	0	1	A8K2U0-1	1121	1122	+	1	0	0	2199
A8K2U0-1#30	0	1	1	A8K2U0-1	1130	1131	+	1	A8K2U0-1	492	1454	A8K2U0-2	1	963	+	3	A8K2U0-1#30	0	1	A8K2U0-2	639	640	+	1	0	0	2200
A8K2U0-1#30	0	1	1	A8K2U0-1	1130	1131	+	1	A8K2U0-1	0	1454	A8K2U0-1	0	1454	+	2	A8K2U0-1#30	0	1	A8K2U0-1	1130	1131	+	1	0	0	2201
A8K2U0-1#31	0	1	1	A8K2U0-1	1228	1229	+	1	A8K2U0-1	492	1454	A8K2U0-2	1	963	+	3	A8K2U0-1#31	0	1	A8K2U0-2	737	738	+	1	0	0	2202
A8K2U0-1#31	0	1	1	A8K2U0-1	1228	1229	+	1	A8K2U0-1	0	1454	A8K2U0-1	0	1454	+	2	A8K2U0-1#31	0	1	A8K2U0-1	1228	1229	+	1	0	0	2203
A8K2U0-1#32	0	1	1	A8K2U0-1	1256	1257	+	1	A8K2U0-1	492	1454	A8K2U0-2	1	963	+	3	A8K2U0-1#32	0	1	A8K2U0-2	765	766	+	1	0	0	2204
A8K2U0-1#32	0	1	1	A8K2U0-1	1256	1257	+	1	A8K2U0-1	0	1454	A8K2U0-1	0	1454	+	2	A8K2U0-1#32	0	1	A8K2U0-1	1256	1257	+	1	0	0	2205
A8K2U0-1#33	0	1	1	A8K2U0-1	1311	1312	+	1	A8K2U0-1	492	1454	A8K2U0-2	1	963	+	3	A8K2U0-1#33	0	1	A8K2U0-2	820	821	+	1	0	0	2206
A8K2U0-1#33	0	1	1	A8K2U0-1	1311	1312	+	1	A8K2U0-1	0	1454	A8K2U0-1	0	1454	+	2	A8K2U0-1#33	0	1	A8K2U0-1	1311	1312	+	1	0	0	2207
A8K2U0-1#34	0	1	1	A8K2U0-1	1411	1412	+	1	A8K2U0-1	492	1454	A8K2U0-2	1	963	+	3	A8K2U0-1#34	0	1	A8K2U0-2	920	921	+	1	0	0	2208
A8K2U0-1#34	0	1	1	A8K2U0-1	1411	1412	+	1	A8K2U0-1	0	1454	A8K2U0-1	0	1454	+	2	A8K2U0-1#34	0	1	A8K2U0-1	1411	1412	+	1	0	0	2209
A8K2U0-1#35	0	1	1	A8K2U0-1	1430	1431	+	1	A8K2U0-1	492	1454	A8K2U0-2	1	963	+	3	A8K2U0-1#35	0	1	A8K2U0-2	939	940	+	1	0	0	2210
A8K2U0-1#35	0	1	1	A8K2U0-1	1430	1431	+	1	A8K2U0-1	0	1454	A8K2U0-1	0	1454	+	2	A8K2U0-1#35	0	1	A8K2U0-1	1430	1431	+	1	0	0	2211
A8K2U0-1#36	0	1	1	A8K2U0-1	732	733	+	1	A8K2U0-1	492	1454	A8K2U0-2	1	963	+	3	A8K2U0-1#36	0	1	A8K2U0-2	241	242	+	1	0	0	2212
A8K2U0-1#36	0	1	1	A8K2U0-1	732	733	+	1	A8K2U0-1	0	1454	A8K2U0-1	0	1454	+	2	A8K2U0-1#36	0	1	A8K2U0-1	732	733	+	1	0	0	2213
A8K2U0-1#37	0	1	1	A8K2U0-1	747	748	+	1	A8K2U0-1	492	1454	A8K2U0-2	1	963	+	3	A8K2U0-1#37	0	1	A8K2U0-2	256	257	+	1	0	0	2214
A8K2U0-1#37	0	1	1	A8K2U0-1	747	748	+	1	A8K2U0-1	0	1454	A8K2U0-1	0	1454	+	2	A8K2U0-1#37	0	1	A8K2U0-1	747	748	+	1	0	0	2215
A8K2U0-1#38	0	1	1	A8K2U0-1	1149	1150	+	1	A8K2U0-1	492	1454	A8K2U0-2	1	963	+	3	A8K2U0-1#38	0	1	A8K2U0-2	658	659	+	1	0	0	2216
A8K2U0-1#38	0	1	1	A8K2U0-1	1149	1150	+	1	A8K2U0-1	0	1454	A8K2U0-1	0	1454	+	2	A8K2U0-1#38	0	1	A8K2U0-1	1149	1150	+	1	0	0	2217
A8K2U0-1#39	0	1	1	A8K2U0-1	1247	1248	+	1	A8K2U0-1	492	1454	A8K2U0-2	1	963	+	3	A8K2U0-1#39	0	1	A8K2U0-2	756	757	+	1	0	0	2218
A8K2U0-1#39	0	1	1	A8K2U0-1	1247	1248	+	1	A8K2U0-1	0	1454	A8K2U0-1	0	1454	+	2	A8K2U0-1#39	0	1	A8K2U0-1	1247	1248	+	1	0	0	2219
A8K2U0-1#40	0	1	1	A8K2U0-1	1451	1452	+	1	A8K2U0-1	492	1454	A8K2U0-2	1	963	+	3	A8K2U0-1#40	0	1	A8K2U0-2	960	961	+	1	0	0	2220
A8K2U0-1#40	0	1	1	A8K2U0-1	1451	1452	+	1	A8K2U0-1	0	1454	A8K2U0-1	0	1454	+	2	A8K2U0-1#40	0	1	A8K2U0-1	1451	1452	+	1	0	0	2221
A7E2S9-1#0	0	258	258	A7E2S9-1	0	258	+	258	A7E2S9-1	0	205	A7E2S9-2	0	205	+	1	A7E2S9-1#0	0	205	A7E2S9-2	0	205	+	205	0	53	2222
A7E2S9-1#0	0	258	258	A7E2S9-1	0	258	+	258	A7E2S9-1	0	258	A7E2S9-1	0	258	+	0	A7E2S9-1#0	0	258	A7E2S9-1	0	258	+	258	0	0	2223
A7E2S9-1#1	0	30	30	A7E2S9-1	70	100	+	30	A7E2S9-1	0	205	A7E2S9-2	0	205	+	1	A7E2S9-1#1	0	30	A7E2S9-2	70	100	+	30	0	0	2224
A7E2S9-1#1	0	30	30	A7E2S9-1	70	100	+	30	A7E2S9-1	0	258	A7E2S9-1	0	258	+	0	A7E2S9-1#1	0	30	A7E2S9-1	70	100	+	30	0	0	2225
A7E2S9-1#2	0	30	30	A7E2S9-1	103	133	+	30	A7E2S9-1	0	205	A7E2S9-2	0	205	+	1	A7E2S9-1#2	0	30	A7E2S9-2	103	133	+	30	0	0	2226
A7E2S9-1#2	0	30	30	A7E2S9-1	103	133	+	30	A7E2S9-1	0	258	A7E2S9-1	0	258	+	0	A7E2S9-1#2	0	30	A7E2S9-1	103	133	+	30	0	0	2227
A7E2S9-1#3	0	30	30	A7E2S9-1	136	166	+	30	A7E2S9-1	0	205	A7E2S9-2	0	205	+	1	A7E2S9-1#3	0	30	A7E2S9-2	136	166	+	30	0	0	2228
A7E2S9-1#3	0	30	30	A7E2S9-1	136	166	+	30	A7E2S9-1	0	258	A7E2S9-1	0	258	+	0	A7E2S9-1#3	0	30	A7E2S9-1	136	166	+	30	0	0	2229
A7E2S9-1#4	0	30	30	A7E2S9-1	169	199	+	30	A7E2S9-1	0	205	A7E2S9-2	0	205	+	1	A7E2S9-1#4	0	30	A7E2S9-2	169	199	+	30	0	0	2230
A7E2S9-1#4	0	30	30	A7E2S9-1	169	199	+	30	A7E2S9-1	0	258	A7E2S9-1	0	258	+	0	A7E2S9-1#4	0	30	A7E2S9-1	169	199	+	30	0	0	2231
A7E2S9-1#5	0	21	21	A7E2S9-1	0	21	+	21	A7E2S9-1	0	205	A7E2S9-2	0	205	+	1	A7E2S9-1#5	0	21	A7E2S9-2	0	21	+	21	0	0	2232
A7E2S9-1#5	0	21	21	A7E2S9-1	0	21	+	21	A7E2S9-1	0	258	A7E2S9-1	0	258	+	0	A7E2S9-1#5	0	21	A7E2S9-1	0	21	+	21	0	0	2233
A7E2S9-1#6	0	43	43	A7E2S9-1	215	258	+	43	A7E2S9-1	0	258	A7E2S9-1	0	258	+	0	A7E2S9-1#6	0	43	A7E2S9-1	215	258	+	43	0	0	2234
A7E2S9-1#7	0	16	16	A7E2S9-1	215	231	+	16	A7E2S9-1	0	258	A7E2S9-1	0	258	+	0	A7E2S9-1#7	0	16	A7E2S9-1	215	231	+	16	0	0	2235
A7E2S9-1#8	0	53	53	A7E2S9-1	205	258	+	53	A7E2S9-1	0	258	A7E2S9-1	0	258	+	0	A7E2S9-1#8	0	53	A7E2S9-1	205	258	+	53	0	0	2236
P29275#0	0	332	332	P29275	0	332	+	332	P29275	0	332	P29275	0	332	+	28	P29275#0	0	332	P29275	0	332	+	332	0	0	2237
P29275#1	0	8	8	P29275	0	8	+	8	P29275	0	332	P29275	0	332	+	28	P29275#1	0	8	P29275	0	8	+	8	0	0	2238
P29275#2	0	25	25	P29275	8	33	+	25	P29275	0	332	P29275	0	332	+	28	P29275#2	0	25	P29275	8	33	+	25	0	0	2239
P29275#3	0	10	10	P29275	33	43	+	10	P29275	0	332	P29275	0	332	+	28	P29275#3	0	10	P29275	33	43	+	10	0	0	2240
P29275#4	0	24	24	P29275	43	67	+	24	P29275	0	332	P29275	0	332	+	28	P29275#4	0	24	P29275	43	67	+	24	0	0	2241
P29275#5	0	11	11	P29275	67	78	+	11	P29275	0	332	P29275	0	332	+	28	P29275#5	0	11	P29275	67	78	+	11	0	0	2242
P29275#6	0	23	23	P29275	78	101	+	23	P29275	0	332	P29275	0	332	+	28	P29275#6	0	23	P29275	78	101	+	23	0	0	2243
P29275#7	0	20	20	P29275	101	121	+	20	P29275	0	332	P29275	0	332	+	28	P29275#7	0	20	P29275	101	121	+	20	0	0	2244
P29275#8	0	23	23	P29275	121	144	+	23	P29275	0	332	P29275	0	332	+	28	P29275#8	0	23	P29275	121	144	+	23	0	0	2245
P29275#9	0	34	34	P29275	144	178	+	34	P29275	0	332	P29275	0	332	+	28	P29275#9	0	34	P29275	144	178	+	34	0	0	2246
P29275#10	0	25	25	P29275	178	203	+	25	P29275	0	332	P29275	0	332	+	28	P29275#10	0	25	P29275	178	203	+	25	0	0	2247
P29275#11	0	32	32	P29275	203	235	+	32	P29275	0	332	P29275	0	332	+	28	P29275#11	0	32	P29275	203	235	+	32	0	0	2248
P29275#12	0	24	24	P29275	235	259	+	24	P29275	0	332	P29275	0	332	+	28	P29275#12	0	24	P29275	235	259	+	24	0	0	2249
P29275#13	0	8	8	P29275	259	267	+	8	P29275	0	332	P29275	0	332	+	28	P29275#13	0	8	P29275	259	267	+	8	0	0	2250
P29275#14	0	24	24	P29275	267	291	+	24	P29275	0	332	P29275	0	332	+	28	P29275#14	0	24	P29275	267	291	+	24	0	0	2251
P29275#15	0	41	41	P29275	291	332	+	41	P29275	0	332	P29275	0	332	+	28	P29275#15	0	41	P29275	291	332	+	41	0	0	2252
P29275#16	0	1	1	P29275	173	174	+	1	P29275	0	332	P29275	0	332	+	28	P29275#16	0	1	P29275	173	174	+	1	0	0	2253
P29275#17	0	1	1	P29275	253	254	+	1	P29275	0	332	P29275	0	332	+	28	P29275#17	0	1	P29275	253	254	+	1	0	0	2254
P29275#18	0	1	1	P29275	278	279	+	1	P29275	0	332	P29275	0	332	+	28	P29275#18	0	1	P29275	278	279	+	1	0	0	2255
P29275#19	0	1	1	P29275	279	280	+	1	P29275	0	332	P29275	0	332	+	28	P29275#19	0	1	P29275	279	280	+	1	0	0	2256
P29275#20	0	1	1	P29275	310	311	+	1	P29275	0	332	P29275	0	332	+	28	P29275#20	0	1	P29275	310	311	+	1	0	0	2257
P29275#21	0	1	1	P29275	152	153	+	1	P29275	0	332	P29275	0	332	+	28	P29275#21	0	1	P29275	152	153	+	1	0	0	2258
P29275#22	0	1	1	P29275	162	163	+	1	P29275	0	332	P29275	0	332	+	28	P29275#22	0	1	P29275	162	163	+	1	0	0	2259
P29275#23	0	94	94	P29275	77	171	+	94	P29275	0	332	P29275	0	332	+	28	P29275#23	0	94	P29275	77	171	+	94	0	0	2260
P0DMS8-1#0	0	318	318	P0DMS8-1	0	318	+	318	P0DMS8-1	0	318	P0DMS8-1	0	318	+	19	P0DMS8-1#0	0	318	P0DMS8-1	0	318	+	318	0	0	2261
P0DMS8-1#1	0	14	14	P0DMS8-1	0	14	+	14	P0DMS8-1	0	318	P0DMS8-1	0	318	+	19	P0DMS8-1#1	0	14	P0DMS8-1	0	14	+	14	0	0	2262
P0DMS8-1#2	0	23	23	P0DMS8-1	14	37	+	23	P0DMS8-1	0	318	P0DMS8-1	0	318	+	19	P0DMS8-1#2	0	23	P0DMS8-1	14	37	+	23	0	0	2263
P0DMS8-1#3	0	11	11	P0DMS8-1	37	48	+	11	P0DMS8-1	0	318	P0DMS8-1	0	318	+	19	P0DMS8-1#3	0	11	P0DMS8-1	37	48	+	11	0	0	2264
P0DMS8-1#4	0	24	24	P0DMS8-1	48	72	+	24	P0DMS8-1	0	318	P0DMS8-1	0	318	+	19	P0DMS8-1#4	0	24	P0DMS8-1	48	72	+	24	0	0	2265
P0DMS8-1#5	0	12	12	P0DMS8-1	72	84	+	12	P0DMS8-1	0	318	P0DMS8-1	0	318	+	19	P0DMS8-1#5	0	12	P0DMS8-1	72	84	+	12	0	0	2266
P0DMS8-1#6	0	22	22	P0DMS8-1	84	106	+	22	P0DMS8-1	0	318	P0DMS8-1	0	318	+	19	P0DMS8-1#6	0	22	P0DMS8-1	84	106	+	22	0	0	2267
P0DMS8-1#7	0	20	20	P0DMS8-1	106	126	+	20	P0DMS8-1	0	318	P0DMS8-1	0	318	+	19	P0DMS8-1#7	0	20	P0DMS8-1	106	126	+	20	0	0	2268
P0DMS8-1#8	0	22	22	P0DMS8-1	126	148	+	22	P0DMS8-1	0	318	P0DMS8-1	0	318	+	19	P0DMS8-1#8	0	22	P0DMS8-1	126	148	+	22	0	0	2269
P0DMS8-1#9	0	29	29	P0DMS8-1	148	177	+	29	P0DMS8-1	0	318	P0DMS8-1	0	318	+	19	P0DMS8-1#9	0	29	P0DMS8-1	148	177	+	29	0	0	2270
P0DMS8-1#10	0	21	21	P0DMS8-1	177	198	+	21	P0DMS8-1	0	318	P0DMS8-1	0	318	+	19	P0DMS8-1#10	0	21	P0DMS8-1	177	198	+	21	0	0	2271
P0DMS8-1#11	0	33	33	P0DMS8-1	198	231	+	33	P0DMS8-1	0	318	P0DMS8-1	0	318	+	19	P0DMS8-1#11	0	33	P0DMS8-1	198	231	+	33	0	0	2272
P0DMS8-1#12	0	24	24	P0DMS8-1	231	255	+	24	P0DMS8-1	0	318	P0DMS8-1	0	318	+	19	P0DMS8-1#12	0	24	P0DMS8-1	231	255	+	24	0	0	2273
P0DMS8-1#13	0	6	6	P0DMS8-1	255	261	+	6	P0DMS8-1	0	318	P0DMS8-1	0	318	+	19	P0DMS8-1#13	0	6	P0DMS8-1	255	261	+	6	0	0	2274
P0DMS8-1#14	0	23	23	P0DMS8-1	261	284	+	23	P0DMS8-1	0	318	P0DMS8-1	0	318	+	19	P0DMS8-1#14	0	23	P0DMS8-1	261	284	+	23	0	0	2275
P0DMS8-1#15	0	34	34	P0DMS8-1	284	318	+	34	P0DMS8-1	0	318	P0DMS8-1	0	318	+	19	P0DMS8-1#15	0	34	P0DMS8-1	284	318	+	34	0	0	2276
P0DMS8-1#16	0	1	1	P0DMS8-1	302	303	+	1	P0DMS8-1	0	318	P0DMS8-1	0	318	+	19	P0DMS8-1#16	0	1	P0DMS8-1	302	303	+	1	0	0	2277
P0DMS8-1#17	0	1	1	P0DMS8-1	2	3	+	1	P0DMS8-1	0	318	P0DMS8-1	0	318	+	19	P0DMS8-1#17	0	1	P0DMS8-1	2	3	+	1	0	0	2278
P0DMS8-1#18	0	1	1	P0DMS8-1	3	4	+	1	P0DMS8-1	0	318	P0DMS8-1	0	318	+	19	P0DMS8-1#18	0	1	P0DMS8-1	3	4	+	1	0	0	2279
P0DMS8-1#19	0	1	1	P0DMS8-1	11	12	+	1	P0DMS8-1	0	318	P0DMS8-1	0	318	+	19	P0DMS8-1#19	0	1	P0DMS8-1	11	12	+	1	0	0	2280
P0DMS8-1#20	0	84	84	P0DMS8-1	82	166	+	84	P0DMS8-1	0	318	P0DMS8-1	0	318	+	19	P0DMS8-1#20	0	84	P0DMS8-1	82	166	+	84	0	0	2281
P0DMS8-1#21	0	1	1	P0DMS8-1	104	105	+	1	P0DMS8-1	0	318	P0DMS8-1	0	318	+	19	P0DMS8-1#21	0	1	P0DMS8-1	104	105	+	1	0	0	2282
P0DMS8-1#22	0	1	1	P0DMS8-1	247	248	+	1	P0DMS8-1	0	318	P0DMS8-1	0	318	+	19	P0DMS8-1#22	0	1	P0DMS8-1	247	248	+	1	0	0	2283
P0DMS8-1#23	0	1	1	P0DMS8-1	265	266	+	1	P0DMS8-1	0	318	P0DMS8-1	0	318	+	19	P0DMS8-1#23	0	1	P0DMS8-1	265	266	+	1	0	0	2284
P0DMS8-1#24	0	1	1	P0DMS8-1	6	7	+	1	P0DMS8-1	0	318	P0DMS8-1	0	318	+	19	P0DMS8-1#24	0	1	P0DMS8-1	6	7	+	1	0	0	2285
P0DMS8-1#25	0	1	1	P0DMS8-1	174	175	+	1	P0DMS8-1	0	318	P0DMS8-1	0	318	+	19	P0DMS8-1#25	0	1	P0DMS8-1	174	175	+	1	0	0	2286
Q9NTW7-1#0	0	645	645	Q9NTW7-1	0	645	+	645	Q9NTW7-1	0	254	Q9NTW7-6	0	200	+	100	Q9NTW7-1#0	0	254	Q9NTW7-6	0	200	+	200	0	391	2287
Q9NTW7-1#0	0	645	645	Q9NTW7-1	0	645	+	645	Q9NTW7-1	0	254	Q9NTW7-5	0	254	+	99	Q9NTW7-1#0	0	254	Q9NTW7-5	0	254	+	254	0	391	2288
Q9NTW7-1#0	0	645	645	Q9NTW7-1	0	645	+	645	Q9NTW7-1	0	254	Q9NTW7-4	0	252	+	98	Q9NTW7-1#0	0	254	Q9NTW7-4	0	252	+	251	0	391	2289
Q9NTW7-1#0	0	645	645	Q9NTW7-1	0	645	+	645	Q9NTW7-1	0	410	Q9NTW7-3	0	410	+	97	Q9NTW7-1#0	0	410	Q9NTW7-3	0	410	+	410	0	235	2290
Q9NTW7-1#0	0	645	645	Q9NTW7-1	0	645	+	645	Q9NTW7-1	254	645	Q9NTW7-2	35	426	+	96	Q9NTW7-1#0	254	645	Q9NTW7-2	35	426	+	391	254	0	2291
Q9NTW7-1#0	0	645	645	Q9NTW7-1	0	645	+	645	Q9NTW7-1	0	645	Q9NTW7-1	0	645	+	95	Q9NTW7-1#0	0	645	Q9NTW7-1	0	645	+	645	0	0	2292
Q9NTW7-1#1	0	23	23	Q9NTW7-1	174	197	+	23	Q9NTW7-1	0	254	Q9NTW7-6	0	200	+	100	Q9NTW7-1#1	0	23	Q9NTW7-6	120	143	+	23	0	0	2293
Q9NTW7-1#1	0	23	23	Q9NTW7-1	174	197	+	23	Q9NTW7-1	0	254	Q9NTW7-5	0	254	+	99	Q9NTW7-1#1	0	23	Q9NTW7-5	174	197	+	23	0	0	2294
Q9NTW7-1#1	0	23	23	Q9NTW7-1	174	197	+	23	Q9NTW7-1	0	254	Q9NTW7-4	0	252	+	98	Q9NTW7-1#1	0	23	Q9NTW7-4	172	195	+	23	0	0	2295
Q9NTW7-1#1	0	23	23	Q9NTW7-1	174	197	+	23	Q9NTW7-1	0	410	Q9NTW7-3	0	410	+	97	Q9NTW7-1#1	0	23	Q9NTW7-3	174	197	+	23	0	0	2296
Q9NTW7-1#1	0	23	23	Q9NTW7-1	174	197	+	23	Q9NTW7-1	0	645	Q9NTW7-1	0	645	+	95	Q9NTW7-1#1	0	23	Q9NTW7-1	174	197	+	23	0	0	2297
Q9NTW7-1#2	0	23	23	Q9NTW7-1	202	225	+	23	Q9NTW7-1	0	254	Q9NTW7-6	0	200	+	100	Q9NTW7-1#2	0	23	Q9NTW7-6	148	171	+	23	0	0	2298
Q9NTW7-1#2	0	23	23	Q9NTW7-1	202	225	+	23	Q9NTW7-1	0	254	Q9NTW7-5	0	254	+	99	Q9NTW7-1#2	0	23	Q9NTW7-5	202	225	+	23	0	0	2299
Q9NTW7-1#2	0	23	23	Q9NTW7-1	202	225	+	23	Q9NTW7-1	0	254	Q9NTW7-4	0	252	+	98	Q9NTW7-1#2	0	23	Q9NTW7-4	200	223	+	23	0	0	2300
Q9NTW7-1#2	0	23	23	Q9NTW7-1	202	225	+	23	Q9NTW7-1	0	410	Q9NTW7-3	0	410	+	97	Q9NTW7-1#2	0	23	Q9NTW7-3	202	225	+	23	0	0	2301
Q9NTW7-1#2	0	23	23	Q9NTW7-1	202	225	+	23	Q9NTW7-1	0	645	Q9NTW7-1	0	645	+	95	Q9NTW7-1#2	0	23	Q9NTW7-1	202	225	+	23	0	0	2302
Q9NTW7-1#3	0	23	23	Q9NTW7-1	230	253	+	23	Q9NTW7-1	0	254	Q9NTW7-6	0	200	+	100	Q9NTW7-1#3	0	23	Q9NTW7-6	176	199	+	23	0	0	2303
Q9NTW7-1#3	0	23	23	Q9NTW7-1	230	253	+	23	Q9NTW7-1	0	254	Q9NTW7-5	0	254	+	99	Q9NTW7-1#3	0	23	Q9NTW7-5	230	253	+	23	0	0	2304
Q9NTW7-1#3	0	23	23	Q9NTW7-1	230	253	+	23	Q9NTW7-1	0	254	Q9NTW7-4	0	252	+	98	Q9NTW7-1#3	0	23	Q9NTW7-4	228	251	+	23	0	0	2305
Q9NTW7-1#3	0	23	23	Q9NTW7-1	230	253	+	23	Q9NTW7-1	0	410	Q9NTW7-3	0	410	+	97	Q9NTW7-1#3	0	23	Q9NTW7-3	230	253	+	23	0	0	2306
Q9NTW7-1#3	0	23	23	Q9NTW7-1	230	253	+	23	Q9NTW7-1	0	645	Q9NTW7-1	0	645	+	95	Q9NTW7-1#3	0	23	Q9NTW7-1	230	253	+	23	0	0	2307
Q9NTW7-1#4	0	26	26	Q9NTW7-1	298	324	+	26	Q9NTW7-1	0	410	Q9NTW7-3	0	410	+	97	Q9NTW7-1#4	0	26	Q9NTW7-3	298	324	+	26	0	0	2308
Q9NTW7-1#4	0	26	26	Q9NTW7-1	298	324	+	26	Q9NTW7-1	254	645	Q9NTW7-2	35	426	+	96	Q9NTW7-1#4	0	26	Q9NTW7-2	79	105	+	26	0	0	2309
Q9NTW7-1#4	0	26	26	Q9NTW7-1	298	324	+	26	Q9NTW7-1	0	645	Q9NTW7-1	0	645	+	95	Q9NTW7-1#4	0	26	Q9NTW7-1	298	324	+	26	0	0	2310
Q9NTW7-1#5	0	23	23	Q9NTW7-1	329	352	+	23	Q9NTW7-1	0	410	Q9NTW7-3	0	410	+	97	Q9NTW7-1#5	0	23	Q9NTW7-3	329	352	+	23	0	0	2311
Q9NTW7-1#5	0	23	23	Q9NTW7-1	329	352	+	23	Q9NTW7-1	254	645	Q9NTW7-2	35	426	+	96	Q9NTW7-1#5	0	23	Q9NTW7-2	110	133	+	23	0	0	2312
Q9NTW7-1#5	0	23	23	Q9NTW7-1	329	352	+	23	Q9NTW7-1	0	645	Q9NTW7-1	0	645	+	95	Q9NTW7-1#5	0	23	Q9NTW7-1	329	352	+	23	0	0	2313
Q9NTW7-1#6	0	23	23	Q9NTW7-1	357	380	+	23	Q9NTW7-1	0	410	Q9NTW7-3	0	410	+	97	Q9NTW7-1#6	0	23	Q9NTW7-3	357	380	+	23	0	0	2314
Q9NTW7-1#6	0	23	23	Q9NTW7-1	357	380	+	23	Q9NTW7-1	254	645	Q9NTW7-2	35	426	+	96	Q9NTW7-1#6	0	23	Q9NTW7-2	138	161	+	23	0	0	2315
Q9NTW7-1#6	0	23	23	Q9NTW7-1	357	380	+	23	Q9NTW7-1	0	645	Q9NTW7-1	0	645	+	95	Q9NTW7-1#6	0	23	Q9NTW7-1	357	380	+	23	0	0	2316
Q9NTW7-1#7	0	23	23	Q9NTW7-1	385	408	+	23	Q9NTW7-1	0	410	Q9NTW7-3	0	410	+	97	Q9NTW7-1#7	0	23	Q9NTW7-3	385	408	+	23	0	0	2317
Q9NTW7-1#7	0	23	23	Q9NTW7-1	385	408	+	23	Q9NTW7-1	254	645	Q9NTW7-2	35	426	+	96	Q9NTW7-1#7	0	23	Q9NTW7-2	166	189	+	23	0	0	2318
Q9NTW7-1#7	0	23	23	Q9NTW7-1	385	408	+	23	Q9NTW7-1	0	645	Q9NTW7-1	0	645	+	95	Q9NTW7-1#7	0	23	Q9NTW7-1	385	408	+	23	0	0	2319
Q9NTW7-1#8	0	23	23	Q9NTW7-1	413	436	+	23	Q9NTW7-1	254	645	Q9NTW7-2	35	426	+	96	Q9NTW7-1#8	0	23	Q9NTW7-2	194	217	+	23	0	0	2320
Q9NTW7-1#8	0	23	23	Q9NTW7-1	413	436	+	23	Q9NTW7-1	0	645	Q9NTW7-1	0	645	+	95	Q9NTW7-1#8	0	23	Q9NTW7-1	413	436	+	23	0	0	2321
Q9NTW7-1#9	0	24	24	Q9NTW7-1	441	465	+	24	Q9NTW7-1	254	645	Q9NTW7-2	35	426	+	96	Q9NTW7-1#9	0	24	Q9NTW7-2	222	246	+	24	0	0	2322
Q9NTW7-1#9	0	24	24	Q9NTW7-1	441	465	+	24	Q9NTW7-1	0	645	Q9NTW7-1	0	645	+	95	Q9NTW7-1#9	0	24	Q9NTW7-1	441	465	+	24	0	0	2323
Q9NTW7-1#10	0	23	23	Q9NTW7-1	466	489	+	23	Q9NTW7-1	254	645	Q9NTW7-2	35	426	+	96	Q9NTW7-1#10	0	23	Q9NTW7-2	247	270	+	23	0	0	2324
Q9NTW7-1#10	0	23	23	Q9NTW7-1	466	489	+	23	Q9NTW7-1	0	645	Q9NTW7-1	0	645	+	95	Q9NTW7-1#10	0	23	Q9NTW7-1	466	489	+	23	0	0	2325
Q9NTW7-1#11	0	23	23	Q9NTW7-1	494	517	+	23	Q9NTW7-1	254	645	Q9NTW7-2	35	426	+	96	Q9NTW7-1#11	0	23	Q9NTW7-2	275	298	+	23	0	0	2326
Q9NTW7-1#11	0	23	23	Q9NTW7-1	494	517	+	23	Q9NTW7-1	0	645	Q9NTW7-1	0	645	+	95	Q9NTW7-1#11	0	23	Q9NTW7-1	494	517	+	23	0	0	2327
Q9NTW7-1#12	0	24	24	Q9NTW7-1	522	546	+	24	Q9NTW7-1	254	645	Q9NTW7-2	35	426	+	96	Q9NTW7-1#12	0	24	Q9NTW7-2	303	327	+	24	0	0	2328
Q9NTW7-1#12	0	24	24	Q9NTW7-1	522	546	+	24	Q9NTW7-1	0	645	Q9NTW7-1	0	645	+	95	Q9NTW7-1#12	0	24	Q9NTW7-1	522	546	+	24	0	0	2329
Q9NTW7-1#13	0	23	23	Q9NTW7-1	579	602	+	23	Q9NTW7-1	254	645	Q9NTW7-2	35	426	+	96	Q9NTW7-1#13	0	23	Q9NTW7-2	360	383	+	23	0	0	2330
Q9NTW7-1#13	0	23	23	Q9NTW7-1	579	602	+	23	Q9NTW7-1	0	645	Q9NTW7-1	0	645	+	95	Q9NTW7-1#13	0	23	Q9NTW7-1	579	602	+	23	0	0	2331
Q9NTW7-1#14	0	25	25	Q9NTW7-1	542	567	+	25	Q9NTW7-1	254	645	Q9NTW7-2	35	426	+	96	Q9NTW7-1#14	0	25	Q9NTW7-2	323	348	+	25	0	0	2332
Q9NTW7-1#14	0	25	25	Q9NTW7-1	542	567	+	25	Q9NTW7-1	0	645	Q9NTW7-1	0	645	+	95	Q9NTW7-1#14	0	25	Q9NTW7-1	542	567	+	25	0	0	2333
Q9NTW7-1#15	0	46	46	Q9NTW7-1	599	645	+	46	Q9NTW7-1	254	645	Q9NTW7-2	35	426	+	96	Q9NTW7-1#15	0	46	Q9NTW7-2	380	426	+	46	0	0	2334
Q9NTW7-1#15	0	46	46	Q9NTW7-1	599	645	+	46	Q9NTW7-1	0	645	Q9NTW7-1	0	645	+	95	Q9NTW7-1#15	0	46	Q9NTW7-1	599	645	+	46	0	0	2335
Q9NTW7-1#16	0	18	18	Q9NTW7-1	542	560	+	18	Q9NTW7-1	254	645	Q9NTW7-2	35	426	+	96	Q9NTW7-1#16	0	18	Q9NTW7-2	323	341	+	18	0	0	2336
Q9NTW7-1#16	0	18	18	Q9NTW7-1	542	560	+	18	Q9NTW7-1	0	645	Q9NTW7-1	0	645	+	95	Q9NTW7-1#16	0	18	Q9NTW7-1	542	560	+	18	0	0	2337
Q9NTW7-1#17	0	25	25	Q9NTW7-1	607	632	+	25	Q9NTW7-1	254	645	Q9NTW7-2	35	426	+	96	Q9NTW7-1#17	0	25	Q9NTW7-2	388	413	+	25	0	0	2338
Q9NTW7-1#17	0	25	25	Q9NTW7-1	607	632	+	25	Q9NTW7-1	0	645	Q9NTW7-1	0	645	+	95	Q9NTW7-1#17	0	25	Q9NTW7-1	607	632	+	25	0	0	2339
Q9NTW7-1#18	0	219	219	Q9NTW7-1	0	219	+	219	Q9NTW7-1	0	254	Q9NTW7-6	0	200	+	100	Q9NTW7-1#18	0	219	Q9NTW7-6	0	165	+	165	0	0	2340
Q9NTW7-1#18	0	219	219	Q9NTW7-1	0	219	+	219	Q9NTW7-1	0	254	Q9NTW7-5	0	254	+	99	Q9NTW7-1#18	0	219	Q9NTW7-5	0	219	+	219	0	0	2341
Q9NTW7-1#18	0	219	219	Q9NTW7-1	0	219	+	219	Q9NTW7-1	0	254	Q9NTW7-4	0	252	+	98	Q9NTW7-1#18	0	219	Q9NTW7-4	0	217	+	216	0	0	2342
Q9NTW7-1#18	0	219	219	Q9NTW7-1	0	219	+	219	Q9NTW7-1	0	410	Q9NTW7-3	0	410	+	97	Q9NTW7-1#18	0	219	Q9NTW7-3	0	219	+	219	0	0	2343
Q9NTW7-1#18	0	219	219	Q9NTW7-1	0	219	+	219	Q9NTW7-1	0	645	Q9NTW7-1	0	645	+	95	Q9NTW7-1#18	0	219	Q9NTW7-1	0	219	+	219	0	0	2344
Q9NTW7-1#19	0	3	3	Q9NTW7-1	15	18	+	3	Q9NTW7-1	0	254	Q9NTW7-6	0	200	+	100	Q9NTW7-1#19	0	3	Q9NTW7-6	15	18	+	3	0	0	2345
Q9NTW7-1#19	0	3	3	Q9NTW7-1	15	18	+	3	Q9NTW7-1	0	254	Q9NTW7-5	0	254	+	99	Q9NTW7-1#19	0	3	Q9NTW7-5	15	18	+	3	0	0	2346
Q9NTW7-1#19	0	3	3	Q9NTW7-1	15	18	+	3	Q9NTW7-1	0	410	Q9NTW7-3	0	410	+	97	Q9NTW7-1#19	0	3	Q9NTW7-3	15	18	+	3	0	0	2347
Q9NTW7-1#19	0	3	3	Q9NTW7-1	15	18	+	3	Q9NTW7-1	0	645	Q9NTW7-1	0	645	+	95	Q9NTW7-1#19	0	3	Q9NTW7-1	15	18	+	3	0	0	2348
Q9NTW7-1#20	0	54	54	Q9NTW7-1	95	149	+	54	Q9NTW7-1	0	254	Q9NTW7-5	0	254	+	99	Q9NTW7-1#20	0	54	Q9NTW7-5	95	149	+	54	0	0	2349
Q9NTW7-1#20	0	54	54	Q9NTW7-1	95	149	+	54	Q9NTW7-1	0	254	Q9NTW7-4	0	252	+	98	Q9NTW7-1#20	0	54	Q9NTW7-4	93	147	+	54	0	0	2350
Q9NTW7-1#20	0	54	54	Q9NTW7-1	95	149	+	54	Q9NTW7-1	0	410	Q9NTW7-3	0	410	+	97	Q9NTW7-1#20	0	54	Q9NTW7-3	95	149	+	54	0	0	2351
Q9NTW7-1#20	0	54	54	Q9NTW7-1	95	149	+	54	Q9NTW7-1	0	645	Q9NTW7-1	0	645	+	95	Q9NTW7-1#20	0	54	Q9NTW7-1	95	149	+	54	0	0	2352
Q9NTW7-1#21	0	35	35	Q9NTW7-1	219	254	+	35	Q9NTW7-1	0	254	Q9NTW7-6	0	200	+	100	Q9NTW7-1#21	0	35	Q9NTW7-6	165	200	+	35	0	0	2353
Q9NTW7-1#21	0	35	35	Q9NTW7-1	219	254	+	35	Q9NTW7-1	0	254	Q9NTW7-5	0	254	+	99	Q9NTW7-1#21	0	35	Q9NTW7-5	219	254	+	35	0	0	2354
Q9NTW7-1#21	0	35	35	Q9NTW7-1	219	254	+	35	Q9NTW7-1	0	254	Q9NTW7-4	0	252	+	98	Q9NTW7-1#21	0	35	Q9NTW7-4	217	252	+	35	0	0	2355
Q9NTW7-1#21	0	35	35	Q9NTW7-1	219	254	+	35	Q9NTW7-1	0	410	Q9NTW7-3	0	410	+	97	Q9NTW7-1#21	0	35	Q9NTW7-3	219	254	+	35	0	0	2356
Q9NTW7-1#21	0	35	35	Q9NTW7-1	219	254	+	35	Q9NTW7-1	0	645	Q9NTW7-1	0	645	+	95	Q9NTW7-1#21	0	35	Q9NTW7-1	219	254	+	35	0	0	2357
Q9NTW7-1#22	0	155	155	Q9NTW7-1	235	390	+	155	Q9NTW7-1	0	254	Q9NTW7-6	0	200	+	100	Q9NTW7-1#22	0	19	Q9NTW7-6	181	200	+	19	0	136	2358
Q9NTW7-1#22	0	155	155	Q9NTW7-1	235	390	+	155	Q9NTW7-1	0	254	Q9NTW7-5	0	254	+	99	Q9NTW7-1#22	0	19	Q9NTW7-5	235	254	+	19	0	136	2359
Q9NTW7-1#22	0	155	155	Q9NTW7-1	235	390	+	155	Q9NTW7-1	0	254	Q9NTW7-4	0	252	+	98	Q9NTW7-1#22	0	19	Q9NTW7-4	233	252	+	19	0	136	2360
Q9NTW7-1#22	0	155	155	Q9NTW7-1	235	390	+	155	Q9NTW7-1	0	410	Q9NTW7-3	0	410	+	97	Q9NTW7-1#22	0	155	Q9NTW7-3	235	390	+	155	0	0	2361
Q9NTW7-1#22	0	155	155	Q9NTW7-1	235	390	+	155	Q9NTW7-1	254	645	Q9NTW7-2	35	426	+	96	Q9NTW7-1#22	19	155	Q9NTW7-2	35	171	+	136	19	0	2362
Q9NTW7-1#22	0	155	155	Q9NTW7-1	235	390	+	155	Q9NTW7-1	0	645	Q9NTW7-1	0	645	+	95	Q9NTW7-1#22	0	155	Q9NTW7-1	235	390	+	155	0	0	2363
Q9NTW7-1#23	0	5	5	Q9NTW7-1	410	415	+	5	Q9NTW7-1	254	645	Q9NTW7-2	35	426	+	96	Q9NTW7-1#23	0	5	Q9NTW7-2	191	196	+	5	0	0	2364
Q9NTW7-1#23	0	5	5	Q9NTW7-1	410	415	+	5	Q9NTW7-1	0	645	Q9NTW7-1	0	645	+	95	Q9NTW7-1#23	0	5	Q9NTW7-1	410	415	+	5	0	0	2365
Q9NTW7-1#24	0	234	234	Q9NTW7-1	411	645	+	234	Q9NTW7-1	254	645	Q9NTW7-2	35	426	+	96	Q9NTW7-1#24	0	234	Q9NTW7-2	192	426	+	234	0	0	2366
Q9NTW7-1#24	0	234	234	Q9NTW7-1	411	645	+	234	Q9NTW7-1	0	645	Q9NTW7-1	0	645	+	95	Q9NTW7-1#24	0	234	Q9NTW7-1	411	645	+	234	0	0	2367
Q9NTW7-1#25	0	230	230	Q9NTW7-1	415	645	+	230	Q9NTW7-1	254	645	Q9NTW7-2	35	426	+	96	Q9NTW7-1#25	0	230	Q9NTW7-2	196	426	+	230	0	0	2368
Q9NTW7-1#25	0	230	230	Q9NTW7-1	415	645	+	230	Q9NTW7-1	0	645	Q9NTW7-1	0	645	+	95	Q9NTW7-1#25	0	230	Q9NTW7-1	415	645	+	230	0	0	2369
Q9NTW7-1#26	0	1	1	Q9NTW7-1	67	68	+	1	Q9NTW7-1	0	254	Q9NTW7-6	0	200	+	100	Q9NTW7-1#26	0	1	Q9NTW7-6	67	68	+	1	0	0	2370
Q9NTW7-1#26	0	1	1	Q9NTW7-1	67	68	+	1	Q9NTW7-1	0	254	Q9NTW7-5	0	254	+	99	Q9NTW7-1#26	0	1	Q9NTW7-5	67	68	+	1	0	0	2371
Q9NTW7-1#26	0	1	1	Q9NTW7-1	67	68	+	1	Q9NTW7-1	0	254	Q9NTW7-4	0	252	+	98	Q9NTW7-1#26	0	1	Q9NTW7-4	65	66	+	1	0	0	2372
Q9NTW7-1#26	0	1	1	Q9NTW7-1	67	68	+	1	Q9NTW7-1	0	410	Q9NTW7-3	0	410	+	97	Q9NTW7-1#26	0	1	Q9NTW7-3	67	68	+	1	0	0	2373
Q9NTW7-1#26	0	1	1	Q9NTW7-1	67	68	+	1	Q9NTW7-1	0	645	Q9NTW7-1	0	645	+	95	Q9NTW7-1#26	0	1	Q9NTW7-1	67	68	+	1	0	0	2374
Q9NTW7-1#27	0	1	1	Q9NTW7-1	138	139	+	1	Q9NTW7-1	0	254	Q9NTW7-5	0	254	+	99	Q9NTW7-1#27	0	1	Q9NTW7-5	138	139	+	1	0	0	2375
Q9NTW7-1#27	0	1	1	Q9NTW7-1	138	139	+	1	Q9NTW7-1	0	254	Q9NTW7-4	0	252	+	98	Q9NTW7-1#27	0	1	Q9NTW7-4	136	137	+	1	0	0	2376
Q9NTW7-1#27	0	1	1	Q9NTW7-1	138	139	+	1	Q9NTW7-1	0	410	Q9NTW7-3	0	410	+	97	Q9NTW7-1#27	0	1	Q9NTW7-3	138	139	+	1	0	0	2377
Q9NTW7-1#27	0	1	1	Q9NTW7-1	138	139	+	1	Q9NTW7-1	0	645	Q9NTW7-1	0	645	+	95	Q9NTW7-1#27	0	1	Q9NTW7-1	138	139	+	1	0	0	2378
Q9NTW7-1#28	0	1	1	Q9NTW7-1	592	593	+	1	Q9NTW7-1	254	645	Q9NTW7-2	35	426	+	96	Q9NTW7-1#28	0	1	Q9NTW7-2	373	374	+	1	0	0	2379
Q9NTW7-1#28	0	1	1	Q9NTW7-1	592	593	+	1	Q9NTW7-1	0	645	Q9NTW7-1	0	645	+	95	Q9NTW7-1#28	0	1	Q9NTW7-1	592	593	+	1	0	0	2380
Q9NTW7-1#29	0	1	1	Q9NTW7-1	608	609	+	1	Q9NTW7-1	254	645	Q9NTW7-2	35	426	+	96	Q9NTW7-1#29	0	1	Q9NTW7-2	389	390	+	1	0	0	2381
Q9NTW7-1#29	0	1	1	Q9NTW7-1	608	609	+	1	Q9NTW7-1	0	645	Q9NTW7-1	0	645	+	95	Q9NTW7-1#29	0	1	Q9NTW7-1	608	609	+	1	0	0	2382
Q9NTW7-1#30	0	1	1	Q9NTW7-1	239	240	+	1	Q9NTW7-1	0	254	Q9NTW7-6	0	200	+	100	Q9NTW7-1#30	0	1	Q9NTW7-6	185	186	+	1	0	0	2383
Q9NTW7-1#30	0	1	1	Q9NTW7-1	239	240	+	1	Q9NTW7-1	0	254	Q9NTW7-5	0	254	+	99	Q9NTW7-1#30	0	1	Q9NTW7-5	239	240	+	1	0	0	2384
Q9NTW7-1#30	0	1	1	Q9NTW7-1	239	240	+	1	Q9NTW7-1	0	254	Q9NTW7-4	0	252	+	98	Q9NTW7-1#30	0	1	Q9NTW7-4	237	238	+	1	0	0	2385
Q9NTW7-1#30	0	1	1	Q9NTW7-1	239	240	+	1	Q9NTW7-1	0	410	Q9NTW7-3	0	410	+	97	Q9NTW7-1#30	0	1	Q9NTW7-3	239	240	+	1	0	0	2386
Q9NTW7-1#30	0	1	1	Q9NTW7-1	239	240	+	1	Q9NTW7-1	0	645	Q9NTW7-1	0	645	+	95	Q9NTW7-1#30	0	1	Q9NTW7-1	239	240	+	1	0	0	2387
Q9NTW7-1#31	0	1	1	Q9NTW7-1	520	521	+	1	Q9NTW7-1	254	645	Q9NTW7-2	35	426	+	96	Q9NTW7-1#31	0	1	Q9NTW7-2	301	302	+	1	0	0	2388
Q9NTW7-1#31	0	1	1	Q9NTW7-1	520	521	+	1	Q9NTW7-1	0	645	Q9NTW7-1	0	645	+	95	Q9NTW7-1#31	0	1	Q9NTW7-1	520	521	+	1	0	0	2389
Q9NTW7-1#32	0	3	3	Q9NTW7-1	177	180	+	3	Q9NTW7-1	0	254	Q9NTW7-6	0	200	+	100	Q9NTW7-1#32	0	3	Q9NTW7-6	123	126	+	3	0	0	2390
Q9NTW7-1#32	0	3	3	Q9NTW7-1	177	180	+	3	Q9NTW7-1	0	254	Q9NTW7-5	0	254	+	99	Q9NTW7-1#32	0	3	Q9NTW7-5	177	180	+	3	0	0	2391
Q9NTW7-1#32	0	3	3	Q9NTW7-1	177	180	+	3	Q9NTW7-1	0	254	Q9NTW7-4	0	252	+	98	Q9NTW7-1#32	0	3	Q9NTW7-4	175	178	+	3	0	0	2392
Q9NTW7-1#32	0	3	3	Q9NTW7-1	177	180	+	3	Q9NTW7-1	0	410	Q9NTW7-3	0	410	+	97	Q9NTW7-1#32	0	3	Q9NTW7-3	177	180	+	3	0	0	2393
Q9NTW7-1#32	0	3	3	Q9NTW7-1	177	180	+	3	Q9NTW7-1	0	645	Q9NTW7-1	0	645	+	95	Q9NTW7-1#32	0	3	Q9NTW7-1	177	180	+	3	0	0	2394
Q9NTW7-1#33	0	7	7	Q9NTW7-1	186	193	+	7	Q9NTW7-1	0	254	Q9NTW7-6	0	200	+	100	Q9NTW7-1#33	0	7	Q9NTW7-6	132	139	+	7	0	0	2395
Q9NTW7-1#33	0	7	7	Q9NTW7-1	186	193	+	7	Q9NTW7-1	0	254	Q9NTW7-5	0	254	+	99	Q9NTW7-1#33	0	7	Q9NTW7-5	186	193	+	7	0	0	2396
Q9NTW7-1#33	0	7	7	Q9NTW7-1	186	193	+	7	Q9NTW7-1	0	254	Q9NTW7-4	0	252	+	98	Q9NTW7-1#33	0	7	Q9NTW7-4	184	191	+	7	0	0	2397
Q9NTW7-1#33	0	7	7	Q9NTW7-1	186	193	+	7	Q9NTW7-1	0	410	Q9NTW7-3	0	410	+	97	Q9NTW7-1#33	0	7	Q9NTW7-3	186	193	+	7	0	0	2398
Q9NTW7-1#33	0	7	7	Q9NTW7-1	186	193	+	7	Q9NTW7-1	0	645	Q9NTW7-1	0	645	+	95	Q9NTW7-1#33	0	7	Q9NTW7-1	186	193	+	7	0	0	2399
Q9NTW7-1#34	0	3	3	Q9NTW7-1	193	196	+	3	Q9NTW7-1	0	254	Q9NTW7-6	0	200	+	100	Q9NTW7-1#34	0	3	Q9NTW7-6	139	142	+	3	0	0	2400
Q9NTW7-1#34	0	3	3	Q9NTW7-1	193	196	+	3	Q9NTW7-1	0	254	Q9NTW7-5	0	254	+	99	Q9NTW7-1#34	0	3	Q9NTW7-5	193	196	+	3	0	0	2401
Q9NTW7-1#34	0	3	3	Q9NTW7-1	193	196	+	3	Q9NTW7-1	0	254	Q9NTW7-4	0	252	+	98	Q9NTW7-1#34	0	3	Q9NTW7-4	191	194	+	3	0	0	2402
Q9NTW7-1#34	0	3	3	Q9NTW7-1	193	196	+	3	Q9NTW7-1	0	410	Q9NTW7-3	0	410	+	97	Q9NTW7-1#34	0	3	Q9NTW7-3	193	196	+	3	0	0	2403
Q9NTW7-1#34	0	3	3	Q9NTW7-1	193	196	+	3	Q9NTW7-1	0	645	Q9NTW7-1	0	645	+	95	Q9NTW7-1#34	0	3	Q9NTW7-1	193	196	+	3	0	0	2404
Q9NTW7-1#35	0	3	3	Q9NTW7-1	201	204	+	3	Q9NTW7-1	0	254	Q9NTW7-6	0	200	+	100	Q9NTW7-1#35	0	3	Q9NTW7-6	147	150	+	3	0	0	2405
Q9NTW7-1#35	0	3	3	Q9NTW7-1	201	204	+	3	Q9NTW7-1	0	254	Q9NTW7-5	0	254	+	99	Q9NTW7-1#35	0	3	Q9NTW7-5	201	204	+	3	0	0	2406
Q9NTW7-1#35	0	3	3	Q9NTW7-1	201	204	+	3	Q9NTW7-1	0	254	Q9NTW7-4	0	252	+	98	Q9NTW7-1#35	0	3	Q9NTW7-4	199	202	+	3	0	0	2407
Q9NTW7-1#35	0	3	3	Q9NTW7-1	201	204	+	3	Q9NTW7-1	0	410	Q9NTW7-3	0	410	+	97	Q9NTW7-1#35	0	3	Q9NTW7-3	201	204	+	3	0	0	2408
Q9NTW7-1#35	0	3	3	Q9NTW7-1	201	204	+	3	Q9NTW7-1	0	645	Q9NTW7-1	0	645	+	95	Q9NTW7-1#35	0	3	Q9NTW7-1	201	204	+	3	0	0	2409
Q9NTW7-1#36	0	3	3	Q9NTW7-1	205	208	+	3	Q9NTW7-1	0	254	Q9NTW7-6	0	200	+	100	Q9NTW7-1#36	0	3	Q9NTW7-6	151	154	+	3	0	0	2410
Q9NTW7-1#36	0	3	3	Q9NTW7-1	205	208	+	3	Q9NTW7-1	0	254	Q9NTW7-5	0	254	+	99	Q9NTW7-1#36	0	3	Q9NTW7-5	205	208	+	3	0	0	2411
Q9NTW7-1#36	0	3	3	Q9NTW7-1	205	208	+	3	Q9NTW7-1	0	254	Q9NTW7-4	0	252	+	98	Q9NTW7-1#36	0	3	Q9NTW7-4	203	206	+	3	0	0	2412
Q9NTW7-1#36	0	3	3	Q9NTW7-1	205	208	+	3	Q9NTW7-1	0	410	Q9NTW7-3	0	410	+	97	Q9NTW7-1#36	0	3	Q9NTW7-3	205	208	+	3	0	0	2413
Q9NTW7-1#36	0	3	3	Q9NTW7-1	205	208	+	3	Q9NTW7-1	0	645	Q9NTW7-1	0	645	+	95	Q9NTW7-1#36	0	3	Q9NTW7-1	205	208	+	3	0	0	2414
Q9NTW7-1#37	0	4	4	Q9NTW7-1	210	214	+	4	Q9NTW7-1	0	254	Q9NTW7-6	0	200	+	100	Q9NTW7-1#37	0	4	Q9NTW7-6	156	160	+	4	0	0	2415
Q9NTW7-1#37	0	4	4	Q9NTW7-1	210	214	+	4	Q9NTW7-1	0	254	Q9NTW7-5	0	254	+	99	Q9NTW7-1#37	0	4	Q9NTW7-5	210	214	+	4	0	0	2416
Q9NTW7-1#37	0	4	4	Q9NTW7-1	210	214	+	4	Q9NTW7-1	0	254	Q9NTW7-4	0	252	+	98	Q9NTW7-1#37	0	4	Q9NTW7-4	208	212	+	4	0	0	2417
Q9NTW7-1#37	0	4	4	Q9NTW7-1	210	214	+	4	Q9NTW7-1	0	410	Q9NTW7-3	0	410	+	97	Q9NTW7-1#37	0	4	Q9NTW7-3	210	214	+	4	0	0	2418
Q9NTW7-1#37	0	4	4	Q9NTW7-1	210	214	+	4	Q9NTW7-1	0	645	Q9NTW7-1	0	645	+	95	Q9NTW7-1#37	0	4	Q9NTW7-1	210	214	+	4	0	0	2419
Q9NTW7-1#38	0	10	10	Q9NTW7-1	214	224	+	10	Q9NTW7-1	0	254	Q9NTW7-6	0	200	+	100	Q9NTW7-1#38	0	10	Q9NTW7-6	160	170	+	10	0	0	2420
Q9NTW7-1#38	0	10	10	Q9NTW7-1	214	224	+	10	Q9NTW7-1	0	254	Q9NTW7-5	0	254	+	99	Q9NTW7-1#38	0	10	Q9NTW7-5	214	224	+	10	0	0	2421
Q9NTW7-1#38	0	10	10	Q9NTW7-1	214	224	+	10	Q9NTW7-1	0	254	Q9NTW7-4	0	252	+	98	Q9NTW7-1#38	0	10	Q9NTW7-4	212	222	+	10	0	0	2422
Q9NTW7-1#38	0	10	10	Q9NTW7-1	214	224	+	10	Q9NTW7-1	0	410	Q9NTW7-3	0	410	+	97	Q9NTW7-1#38	0	10	Q9NTW7-3	214	224	+	10	0	0	2423
Q9NTW7-1#38	0	10	10	Q9NTW7-1	214	224	+	10	Q9NTW7-1	0	645	Q9NTW7-1	0	645	+	95	Q9NTW7-1#38	0	10	Q9NTW7-1	214	224	+	10	0	0	2424
Q9NTW7-1#39	0	4	4	Q9NTW7-1	233	237	+	4	Q9NTW7-1	0	254	Q9NTW7-6	0	200	+	100	Q9NTW7-1#39	0	4	Q9NTW7-6	179	183	+	4	0	0	2425
Q9NTW7-1#39	0	4	4	Q9NTW7-1	233	237	+	4	Q9NTW7-1	0	254	Q9NTW7-5	0	254	+	99	Q9NTW7-1#39	0	4	Q9NTW7-5	233	237	+	4	0	0	2426
Q9NTW7-1#39	0	4	4	Q9NTW7-1	233	237	+	4	Q9NTW7-1	0	254	Q9NTW7-4	0	252	+	98	Q9NTW7-1#39	0	4	Q9NTW7-4	231	235	+	4	0	0	2427
Q9NTW7-1#39	0	4	4	Q9NTW7-1	233	237	+	4	Q9NTW7-1	0	410	Q9NTW7-3	0	410	+	97	Q9NTW7-1#39	0	4	Q9NTW7-3	233	237	+	4	0	0	2428
Q9NTW7-1#39	0	4	4	Q9NTW7-1	233	237	+	4	Q9NTW7-1	0	645	Q9NTW7-1	0	645	+	95	Q9NTW7-1#39	0	4	Q9NTW7-1	233	237	+	4	0	0	2429
Q9NTW7-1#40	0	4	4	Q9NTW7-1	238	242	+	4	Q9NTW7-1	0	254	Q9NTW7-6	0	200	+	100	Q9NTW7-1#40	0	4	Q9NTW7-6	184	188	+	4	0	0	2430
Q9NTW7-1#40	0	4	4	Q9NTW7-1	238	242	+	4	Q9NTW7-1	0	254	Q9NTW7-5	0	254	+	99	Q9NTW7-1#40	0	4	Q9NTW7-5	238	242	+	4	0	0	2431
Q9NTW7-1#40	0	4	4	Q9NTW7-1	238	242	+	4	Q9NTW7-1	0	254	Q9NTW7-4	0	252	+	98	Q9NTW7-1#40	0	4	Q9NTW7-4	236	240	+	4	0	0	2432
Q9NTW7-1#40	0	4	4	Q9NTW7-1	238	242	+	4	Q9NTW7-1	0	410	Q9NTW7-3	0	410	+	97	Q9NTW7-1#40	0	4	Q9NTW7-3	238	242	+	4	0	0	2433
Q9NTW7-1#40	0	4	4	Q9NTW7-1	238	242	+	4	Q9NTW7-1	0	645	Q9NTW7-1	0	645	+	95	Q9NTW7-1#40	0	4	Q9NTW7-1	238	242	+	4	0	0	2434
Q9NTW7-1#41	0	8	8	Q9NTW7-1	242	250	+	8	Q9NTW7-1	0	254	Q9NTW7-6	0	200	+	100	Q9NTW7-1#41	0	8	Q9NTW7-6	188	196	+	8	0	0	2435
Q9NTW7-1#41	0	8	8	Q9NTW7-1	242	250	+	8	Q9NTW7-1	0	254	Q9NTW7-5	0	254	+	99	Q9NTW7-1#41	0	8	Q9NTW7-5	242	250	+	8	0	0	2436
Q9NTW7-1#41	0	8	8	Q9NTW7-1	242	250	+	8	Q9NTW7-1	0	254	Q9NTW7-4	0	252	+	98	Q9NTW7-1#41	0	8	Q9NTW7-4	240	248	+	8	0	0	2437
Q9NTW7-1#41	0	8	8	Q9NTW7-1	242	250	+	8	Q9NTW7-1	0	410	Q9NTW7-3	0	410	+	97	Q9NTW7-1#41	0	8	Q9NTW7-3	242	250	+	8	0	0	2438
Q9NTW7-1#41	0	8	8	Q9NTW7-1	242	250	+	8	Q9NTW7-1	0	645	Q9NTW7-1	0	645	+	95	Q9NTW7-1#41	0	8	Q9NTW7-1	242	250	+	8	0	0	2439
Q9NTW7-1#42	0	3	3	Q9NTW7-1	493	496	+	3	Q9NTW7-1	254	645	Q9NTW7-2	35	426	+	96	Q9NTW7-1#42	0	3	Q9NTW7-2	274	277	+	3	0	0	2440
Q9NTW7-1#42	0	3	3	Q9NTW7-1	493	496	+	3	Q9NTW7-1	0	645	Q9NTW7-1	0	645	+	95	Q9NTW7-1#42	0	3	Q9NTW7-1	493	496	+	3	0	0	2441
Q9NTW7-1#43	0	4	4	Q9NTW7-1	497	501	+	4	Q9NTW7-1	254	645	Q9NTW7-2	35	426	+	96	Q9NTW7-1#43	0	4	Q9NTW7-2	278	282	+	4	0	0	2442
Q9NTW7-1#43	0	4	4	Q9NTW7-1	497	501	+	4	Q9NTW7-1	0	645	Q9NTW7-1	0	645	+	95	Q9NTW7-1#43	0	4	Q9NTW7-1	497	501	+	4	0	0	2443
Q9NTW7-1#44	0	4	4	Q9NTW7-1	502	506	+	4	Q9NTW7-1	254	645	Q9NTW7-2	35	426	+	96	Q9NTW7-1#44	0	4	Q9NTW7-2	283	287	+	4	0	0	2444
Q9NTW7-1#44	0	4	4	Q9NTW7-1	502	506	+	4	Q9NTW7-1	0	645	Q9NTW7-1	0	645	+	95	Q9NTW7-1#44	0	4	Q9NTW7-1	502	506	+	4	0	0	2445
Q9NTW7-1#45	0	8	8	Q9NTW7-1	506	514	+	8	Q9NTW7-1	254	645	Q9NTW7-2	35	426	+	96	Q9NTW7-1#45	0	8	Q9NTW7-2	287	295	+	8	0	0	2446
Q9NTW7-1#45	0	8	8	Q9NTW7-1	506	514	+	8	Q9NTW7-1	0	645	Q9NTW7-1	0	645	+	95	Q9NTW7-1#45	0	8	Q9NTW7-1	506	514	+	8	0	0	2447
Q9NTW7-1#46	0	3	3	Q9NTW7-1	514	517	+	3	Q9NTW7-1	254	645	Q9NTW7-2	35	426	+	96	Q9NTW7-1#46	0	3	Q9NTW7-2	295	298	+	3	0	0	2448
Q9NTW7-1#46	0	3	3	Q9NTW7-1	514	517	+	3	Q9NTW7-1	0	645	Q9NTW7-1	0	645	+	95	Q9NTW7-1#46	0	3	Q9NTW7-1	514	517	+	3	0	0	2449
Q9NTW7-1#47	0	3	3	Q9NTW7-1	521	524	+	3	Q9NTW7-1	254	645	Q9NTW7-2	35	426	+	96	Q9NTW7-1#47	0	3	Q9NTW7-2	302	305	+	3	0	0	2450
Q9NTW7-1#47	0	3	3	Q9NTW7-1	521	524	+	3	Q9NTW7-1	0	645	Q9NTW7-1	0	645	+	95	Q9NTW7-1#47	0	3	Q9NTW7-1	521	524	+	3	0	0	2451
Q9NTW7-1#48	0	4	4	Q9NTW7-1	525	529	+	4	Q9NTW7-1	254	645	Q9NTW7-2	35	426	+	96	Q9NTW7-1#48	0	4	Q9NTW7-2	306	310	+	4	0	0	2452
Q9NTW7-1#48	0	4	4	Q9NTW7-1	525	529	+	4	Q9NTW7-1	0	645	Q9NTW7-1	0	645	+	95	Q9NTW7-1#48	0	4	Q9NTW7-1	525	529	+	4	0	0	2453
Q9NTW7-1#49	0	4	4	Q9NTW7-1	530	534	+	4	Q9NTW7-1	254	645	Q9NTW7-2	35	426	+	96	Q9NTW7-1#49	0	4	Q9NTW7-2	311	315	+	4	0	0	2454
Q9NTW7-1#49	0	4	4	Q9NTW7-1	530	534	+	4	Q9NTW7-1	0	645	Q9NTW7-1	0	645	+	95	Q9NTW7-1#49	0	4	Q9NTW7-1	530	534	+	4	0	0	2455
Q9NTW7-1#50	0	12	12	Q9NTW7-1	534	546	+	12	Q9NTW7-1	254	645	Q9NTW7-2	35	426	+	96	Q9NTW7-1#50	0	12	Q9NTW7-2	315	327	+	12	0	0	2456
Q9NTW7-1#50	0	12	12	Q9NTW7-1	534	546	+	12	Q9NTW7-1	0	645	Q9NTW7-1	0	645	+	95	Q9NTW7-1#50	0	12	Q9NTW7-1	534	546	+	12	0	0	2457
Q9NTW7-1#51	0	1	1	Q9NTW7-1	544	545	+	1	Q9NTW7-1	254	645	Q9NTW7-2	35	426	+	96	Q9NTW7-1#51	0	1	Q9NTW7-2	325	326	+	1	0	0	2458
Q9NTW7-1#51	0	1	1	Q9NTW7-1	544	545	+	1	Q9NTW7-1	0	645	Q9NTW7-1	0	645	+	95	Q9NTW7-1#51	0	1	Q9NTW7-1	544	545	+	1	0	0	2459
Q9NTW7-1#52	0	1	1	Q9NTW7-1	285	286	+	1	Q9NTW7-1	0	410	Q9NTW7-3	0	410	+	97	Q9NTW7-1#52	0	1	Q9NTW7-3	285	286	+	1	0	0	2460
Q9NTW7-1#52	0	1	1	Q9NTW7-1	285	286	+	1	Q9NTW7-1	254	645	Q9NTW7-2	35	426	+	96	Q9NTW7-1#52	0	1	Q9NTW7-2	66	67	+	1	0	0	2461
Q9NTW7-1#52	0	1	1	Q9NTW7-1	285	286	+	1	Q9NTW7-1	0	645	Q9NTW7-1	0	645	+	95	Q9NTW7-1#52	0	1	Q9NTW7-1	285	286	+	1	0	0	2462
Q9NTW7-1#53	0	1	1	Q9NTW7-1	396	397	+	1	Q9NTW7-1	0	410	Q9NTW7-3	0	410	+	97	Q9NTW7-1#53	0	1	Q9NTW7-3	396	397	+	1	0	0	2463
Q9NTW7-1#53	0	1	1	Q9NTW7-1	396	397	+	1	Q9NTW7-1	254	645	Q9NTW7-2	35	426	+	96	Q9NTW7-1#53	0	1	Q9NTW7-2	177	178	+	1	0	0	2464
Q9NTW7-1#53	0	1	1	Q9NTW7-1	396	397	+	1	Q9NTW7-1	0	645	Q9NTW7-1	0	645	+	95	Q9NTW7-1#53	0	1	Q9NTW7-1	396	397	+	1	0	0	2465
Q9NTW7-1#54	0	1	1	Q9NTW7-1	424	425	+	1	Q9NTW7-1	254	645	Q9NTW7-2	35	426	+	96	Q9NTW7-1#54	0	1	Q9NTW7-2	205	206	+	1	0	0	2466
Q9NTW7-1#54	0	1	1	Q9NTW7-1	424	425	+	1	Q9NTW7-1	0	645	Q9NTW7-1	0	645	+	95	Q9NTW7-1#54	0	1	Q9NTW7-1	424	425	+	1	0	0	2467
Q9NTW7-1#55	0	1	1	Q9NTW7-1	450	451	+	1	Q9NTW7-1	254	645	Q9NTW7-2	35	426	+	96	Q9NTW7-1#55	0	1	Q9NTW7-2	231	232	+	1	0	0	2468
Q9NTW7-1#55	0	1	1	Q9NTW7-1	450	451	+	1	Q9NTW7-1	0	645	Q9NTW7-1	0	645	+	95	Q9NTW7-1#55	0	1	Q9NTW7-1	450	451	+	1	0	0	2469
Q96D53-1#0	0	544	544	Q96D53-1	0	544	+	544	Q96D53-1	0	544	Q96D53-2	0	503	+	80	Q96D53-1#0	0	544	Q96D53-2	0	503	+	503	0	0	2470
Q96D53-1#0	0	544	544	Q96D53-1	0	544	+	544	Q96D53-1	0	544	Q96D53-1	0	544	+	79	Q96D53-1#0	0	544	Q96D53-1	0	544	+	544	0	0	2471
Q96D53-1#1	0	17	17	Q96D53-1	91	108	+	17	Q96D53-1	0	544	Q96D53-2	0	503	+	80	Q96D53-1#1	0	17	Q96D53-2	91	108	+	17	0	0	2472
Q96D53-1#1	0	17	17	Q96D53-1	91	108	+	17	Q96D53-1	0	544	Q96D53-1	0	544	+	79	Q96D53-1#1	0	17	Q96D53-1	91	108	+	17	0	0	2473
Q96D53-1#2	0	233	233	Q96D53-1	190	423	+	233	Q96D53-1	0	544	Q96D53-2	0	503	+	80	Q96D53-1#2	0	233	Q96D53-2	149	382	+	233	0	0	2474
Q96D53-1#2	0	233	233	Q96D53-1	190	423	+	233	Q96D53-1	0	544	Q96D53-1	0	544	+	79	Q96D53-1#2	0	233	Q96D53-1	190	423	+	233	0	0	2475
Q96D53-1#3	0	42	42	Q96D53-1	44	86	+	42	Q96D53-1	0	544	Q96D53-2	0	503	+	80	Q96D53-1#3	0	42	Q96D53-2	44	86	+	42	0	0	2476
Q96D53-1#3	0	42	42	Q96D53-1	44	86	+	42	Q96D53-1	0	544	Q96D53-1	0	544	+	79	Q96D53-1#3	0	42	Q96D53-1	44	86	+	42	0	0	2477
Q96D53-1#4	0	4	4	Q96D53-1	154	158	+	4	Q96D53-1	0	544	Q96D53-1	0	544	+	79	Q96D53-1#4	0	4	Q96D53-1	154	158	+	4	0	0	2478
Q96D53-1#5	0	4	4	Q96D53-1	215	219	+	4	Q96D53-1	0	544	Q96D53-2	0	503	+	80	Q96D53-1#5	0	4	Q96D53-2	174	178	+	4	0	0	2479
Q96D53-1#5	0	4	4	Q96D53-1	215	219	+	4	Q96D53-1	0	544	Q96D53-1	0	544	+	79	Q96D53-1#5	0	4	Q96D53-1	215	219	+	4	0	0	2480
Q96D53-1#6	0	36	36	Q96D53-1	50	86	+	36	Q96D53-1	0	544	Q96D53-2	0	503	+	80	Q96D53-1#6	0	36	Q96D53-2	50	86	+	36	0	0	2481
Q96D53-1#6	0	36	36	Q96D53-1	50	86	+	36	Q96D53-1	0	544	Q96D53-1	0	544	+	79	Q96D53-1#6	0	36	Q96D53-1	50	86	+	36	0	0	2482
Q96D53-1#7	0	1	1	Q96D53-1	366	367	+	1	Q96D53-1	0	544	Q96D53-2	0	503	+	80	Q96D53-1#7	0	1	Q96D53-2	325	326	+	1	0	0	2483
Q96D53-1#7	0	1	1	Q96D53-1	366	367	+	1	Q96D53-1	0	544	Q96D53-1	0	544	+	79	Q96D53-1#7	0	1	Q96D53-1	366	367	+	1	0	0	2484
Q96D53-1#8	0	1	1	Q96D53-1	218	219	+	1	Q96D53-1	0	544	Q96D53-2	0	503	+	80	Q96D53-1#8	0	1	Q96D53-2	177	178	+	1	0	0	2485
Q96D53-1#8	0	1	1	Q96D53-1	218	219	+	1	Q96D53-1	0	544	Q96D53-1	0	544	+	79	Q96D53-1#8	0	1	Q96D53-1	218	219	+	1	0	0	2486
Q96D53-1#9	0	1	1	Q96D53-1	236	237	+	1	Q96D53-1	0	544	Q96D53-2	0	503	+	80	Q96D53-1#9	0	1	Q96D53-2	195	196	+	1	0	0	2487
Q96D53-1#9	0	1	1	Q96D53-1	236	237	+	1	Q96D53-1	0	544	Q96D53-1	0	544	+	79	Q96D53-1#9	0	1	Q96D53-1	236	237	+	1	0	0	2488
Q96D53-1#10	0	4	4	Q96D53-1	323	327	+	4	Q96D53-1	0	544	Q96D53-2	0	503	+	80	Q96D53-1#10	0	4	Q96D53-2	282	286	+	4	0	0	2489
Q96D53-1#10	0	4	4	Q96D53-1	323	327	+	4	Q96D53-1	0	544	Q96D53-1	0	544	+	79	Q96D53-1#10	0	4	Q96D53-1	323	327	+	4	0	0	2490
Q96D53-1#11	0	1	1	Q96D53-1	371	372	+	1	Q96D53-1	0	544	Q96D53-2	0	503	+	80	Q96D53-1#11	0	1	Q96D53-2	330	331	+	1	0	0	2491
Q96D53-1#11	0	1	1	Q96D53-1	371	372	+	1	Q96D53-1	0	544	Q96D53-1	0	544	+	79	Q96D53-1#11	0	1	Q96D53-1	371	372	+	1	0	0	2492
Q96D53-1#12	0	1	1	Q96D53-1	385	386	+	1	Q96D53-1	0	544	Q96D53-2	0	503	+	80	Q96D53-1#12	0	1	Q96D53-2	344	345	+	1	0	0	2493
Q96D53-1#12	0	1	1	Q96D53-1	385	386	+	1	Q96D53-1	0	544	Q96D53-1	0	544	+	79	Q96D53-1#12	0	1	Q96D53-1	385	386	+	1	0	0	2494
Q96D53-1#13	0	41	41	Q96D53-1	122	163	+	41	Q96D53-1	0	544	Q96D53-1	0	544	+	79	Q96D53-1#13	0	41	Q96D53-1	122	163	+	41	0	0	2495
Q96D53-1#14	0	1	1	Q96D53-1	77	78	+	1	Q96D53-1	0	544	Q96D53-2	0	503	+	80	Q96D53-1#14	0	1	Q96D53-2	77	78	+	1	0	0	2496
Q96D53-1#14	0	1	1	Q96D53-1	77	78	+	1	Q96D53-1	0	544	Q96D53-1	0	544	+	79	Q96D53-1#14	0	1	Q96D53-1	77	78	+	1	0	0	2497
Q96D53-1#15	0	1	1	Q96D53-1	97	98	+	1	Q96D53-1	0	544	Q96D53-2	0	503	+	80	Q96D53-1#15	0	1	Q96D53-2	97	98	+	1	0	0	2498
Q96D53-1#15	0	1	1	Q96D53-1	97	98	+	1	Q96D53-1	0	544	Q96D53-1	0	544	+	79	Q96D53-1#15	0	1	Q96D53-1	97	98	+	1	0	0	2499
Q96D53-1#16	0	1	1	Q96D53-1	173	174	+	1	Q96D53-1	0	544	Q96D53-2	0	503	+	80	Q96D53-1#16	0	1	Q96D53-2	132	133	+	1	0	0	2500
Q96D53-1#16	0	1	1	Q96D53-1	173	174	+	1	Q96D53-1	0	544	Q96D53-1	0	544	+	79	Q96D53-1#16	0	1	Q96D53-1	173	174	+	1	0	0	2501
Q96D53-1#17	0	1	1	Q96D53-1	177	178	+	1	Q96D53-1	0	544	Q96D53-2	0	503	+	80	Q96D53-1#17	0	1	Q96D53-2	136	137	+	1	0	0	2502
Q96D53-1#17	0	1	1	Q96D53-1	177	178	+	1	Q96D53-1	0	544	Q96D53-1	0	544	+	79	Q96D53-1#17	0	1	Q96D53-1	177	178	+	1	0	0	2503
Q96D53-1#18	0	1	1	Q96D53-1	285	286	+	1	Q96D53-1	0	544	Q96D53-2	0	503	+	80	Q96D53-1#18	0	1	Q96D53-2	244	245	+	1	0	0	2504
Q96D53-1#18	0	1	1	Q96D53-1	285	286	+	1	Q96D53-1	0	544	Q96D53-1	0	544	+	79	Q96D53-1#18	0	1	Q96D53-1	285	286	+	1	0	0	2505
Q96D53-1#19	0	1	1	Q96D53-1	309	310	+	1	Q96D53-1	0	544	Q96D53-2	0	503	+	80	Q96D53-1#19	0	1	Q96D53-2	268	269	+	1	0	0	2506
Q96D53-1#19	0	1	1	Q96D53-1	309	310	+	1	Q96D53-1	0	544	Q96D53-1	0	544	+	79	Q96D53-1#19	0	1	Q96D53-1	309	310	+	1	0	0	2507
Q96D53-1#20	0	1	1	Q96D53-1	317	318	+	1	Q96D53-1	0	544	Q96D53-2	0	503	+	80	Q96D53-1#20	0	1	Q96D53-2	276	277	+	1	0	0	2508
Q96D53-1#20	0	1	1	Q96D53-1	317	318	+	1	Q96D53-1	0	544	Q96D53-1	0	544	+	79	Q96D53-1#20	0	1	Q96D53-1	317	318	+	1	0	0	2509
Q96D53-1#21	0	1	1	Q96D53-1	319	320	+	1	Q96D53-1	0	544	Q96D53-2	0	503	+	80	Q96D53-1#21	0	1	Q96D53-2	278	279	+	1	0	0	2510
Q96D53-1#21	0	1	1	Q96D53-1	319	320	+	1	Q96D53-1	0	544	Q96D53-1	0	544	+	79	Q96D53-1#21	0	1	Q96D53-1	319	320	+	1	0	0	2511
Q96D53-1#22	0	1	1	Q96D53-1	342	343	+	1	Q96D53-1	0	544	Q96D53-2	0	503	+	80	Q96D53-1#22	0	1	Q96D53-2	301	302	+	1	0	0	2512
Q96D53-1#22	0	1	1	Q96D53-1	342	343	+	1	Q96D53-1	0	544	Q96D53-1	0	544	+	79	Q96D53-1#22	0	1	Q96D53-1	342	343	+	1	0	0	2513
Q96D53-1#23	0	1	1	Q96D53-1	351	352	+	1	Q96D53-1	0	544	Q96D53-2	0	503	+	80	Q96D53-1#23	0	1	Q96D53-2	310	311	+	1	0	0	2514
Q96D53-1#23	0	1	1	Q96D53-1	351	352	+	1	Q96D53-1	0	544	Q96D53-1	0	544	+	79	Q96D53-1#23	0	1	Q96D53-1	351	352	+	1	0	0	2515
Q96D53-1#24	0	1	1	Q96D53-1	461	462	+	1	Q96D53-1	0	544	Q96D53-2	0	503	+	80	Q96D53-1#24	0	1	Q96D53-2	420	421	+	1	0	0	2516
Q96D53-1#24	0	1	1	Q96D53-1	461	462	+	1	Q96D53-1	0	544	Q96D53-1	0	544	+	79	Q96D53-1#24	0	1	Q96D53-1	461	462	+	1	0	0	2517
Q96D53-1#25	0	1	1	Q96D53-1	476	477	+	1	Q96D53-1	0	544	Q96D53-2	0	503	+	80	Q96D53-1#25	0	1	Q96D53-2	435	436	+	1	0	0	2518
Q96D53-1#25	0	1	1	Q96D53-1	476	477	+	1	Q96D53-1	0	544	Q96D53-1	0	544	+	79	Q96D53-1#25	0	1	Q96D53-1	476	477	+	1	0	0	2519
Q96D53-1#26	0	1	1	Q96D53-1	497	498	+	1	Q96D53-1	0	544	Q96D53-2	0	503	+	80	Q96D53-1#26	0	1	Q96D53-2	456	457	+	1	0	0	2520
Q96D53-1#26	0	1	1	Q96D53-1	497	498	+	1	Q96D53-1	0	544	Q96D53-1	0	544	+	79	Q96D53-1#26	0	1	Q96D53-1	497	498	+	1	0	0	2521
Q96D53-1#27	0	3	3	Q96D53-1	163	166	+	3	Q96D53-1	0	544	Q96D53-2	0	503	+	80	Q96D53-1#27	0	3	Q96D53-2	122	125	+	3	0	0	2522
Q96D53-1#27	0	3	3	Q96D53-1	163	166	+	3	Q96D53-1	0	544	Q96D53-1	0	544	+	79	Q96D53-1#27	0	3	Q96D53-1	163	166	+	3	0	0	2523
P00519-1#0	0	1130	1130	P00519-1	0	1130	+	1130	P00519-1	26	1130	P00519-2	45	1149	+	15	P00519-1#0	26	1130	P00519-2	45	1149	+	1104	26	0	2524
P00519-1#0	0	1130	1130	P00519-1	0	1130	+	1130	P00519-1	0	1130	P00519-1	0	1130	+	14	P00519-1#0	0	1130	P00519-1	0	1130	+	1130	0	0	2525
P00519-1#1	0	61	61	P00519-1	60	121	+	61	P00519-1	26	1130	P00519-2	45	1149	+	15	P00519-1#1	0	61	P00519-2	79	140	+	61	0	0	2526
P00519-1#1	0	61	61	P00519-1	60	121	+	61	P00519-1	0	1130	P00519-1	0	1130	+	14	P00519-1#1	0	61	P00519-1	60	121	+	61	0	0	2527
P00519-1#2	0	91	91	P00519-1	126	217	+	91	P00519-1	26	1130	P00519-2	45	1149	+	15	P00519-1#2	0	91	P00519-2	145	236	+	91	0	0	2528
P00519-1#2	0	91	91	P00519-1	126	217	+	91	P00519-1	0	1130	P00519-1	0	1130	+	14	P00519-1#2	0	91	P00519-1	126	217	+	91	0	0	2529
P00519-1#3	0	252	252	P00519-1	241	493	+	252	P00519-1	26	1130	P00519-2	45	1149	+	15	P00519-1#3	0	252	P00519-2	260	512	+	252	0	0	2530
P00519-1#3	0	252	252	P00519-1	241	493	+	252	P00519-1	0	1130	P00519-1	0	1130	+	14	P00519-1#3	0	252	P00519-1	241	493	+	252	0	0	2531
P00519-1#4	0	60	60	P00519-1	0	60	+	60	P00519-1	26	1130	P00519-2	45	1149	+	15	P00519-1#4	26	60	P00519-2	45	79	+	34	26	0	2532
P00519-1#4	0	60	60	P00519-1	0	60	+	60	P00519-1	0	1130	P00519-1	0	1130	+	14	P00519-1#4	0	60	P00519-1	0	60	+	60	0	0	2533
P00519-1#5	0	479	479	P00519-1	517	996	+	479	P00519-1	26	1130	P00519-2	45	1149	+	15	P00519-1#5	0	479	P00519-2	536	1015	+	479	0	0	2534
P00519-1#5	0	479	479	P00519-1	517	996	+	479	P00519-1	0	1130	P00519-1	0	1130	+	14	P00519-1#5	0	479	P00519-1	517	996	+	479	0	0	2535
P00519-1#6	0	100	100	P00519-1	868	968	+	100	P00519-1	26	1130	P00519-2	45	1149	+	15	P00519-1#6	0	100	P00519-2	887	987	+	100	0	0	2536
P00519-1#6	0	100	100	P00519-1	868	968	+	100	P00519-1	0	1130	P00519-1	0	1130	+	14	P00519-1#6	0	100	P00519-1	868	968	+	100	0	0	2537
P00519-1#7	0	178	178	P00519-1	952	1130	+	178	P00519-1	26	1130	P00519-2	45	1149	+	15	P00519-1#7	0	178	P00519-2	971	1149	+	178	0	0	2538
P00519-1#7	0	178	178	P00519-1	952	1130	+	178	P00519-1	0	1130	P00519-1	0	1130	+	14	P00519-1#7	0	178	P00519-1	952	1130	+	178	0	0	2539
P00519-1#8	0	25	25	P00519-1	380	405	+	25	P00519-1	26	1130	P00519-2	45	1149	+	15	P00519-1#8	0	25	P00519-2	399	424	+	25	0	0	2540
P00519-1#8	0	25	25	P00519-1	380	405	+	25	P00519-1	0	1130	P00519-1	0	1130	+	14	P00519-1#8	0	25	P00519-1	380	405	+	25	0	0	2541
P00519-1#9	0	5	5	P00519-1	604	609	+	5	P00519-1	26	1130	P00519-2	45	1149	+	15	P00519-1#9	0	5	P00519-2	623	628	+	5	0	0	2542
P00519-1#9	0	5	5	P00519-1	604	609	+	5	P00519-1	0	1130	P00519-1	0	1130	+	14	P00519-1#9	0	5	P00519-1	604	609	+	5	0	0	2543
P00519-1#10	0	7	7	P00519-1	708	715	+	7	P00519-1	26	1130	P00519-2	45	1149	+	15	P00519-1#10	0	7	P00519-2	727	734	+	7	0	0	2544
P00519-1#10	0	7	7	P00519-1	708	715	+	7	P00519-1	0	1130	P00519-1	0	1130	+	14	P00519-1#10	0	7	P00519-1	708	715	+	7	0	0	2545
P00519-1#11	0	8	8	P00519-1	761	769	+	8	P00519-1	26	1130	P00519-2	45	1149	+	15	P00519-1#11	0	8	P00519-2	780	788	+	8	0	0	2546
P00519-1#11	0	8	8	P00519-1	761	769	+	8	P00519-1	0	1130	P00519-1	0	1130	+	14	P00519-1#11	0	8	P00519-1	761	769	+	8	0	0	2547
P00519-1#12	0	11	11	P00519-1	1089	1100	+	11	P00519-1	26	1130	P00519-2	45	1149	+	15	P00519-1#12	0	11	P00519-2	1108	1119	+	11	0	0	2548
P00519-1#12	0	11	11	P00519-1	1089	1100	+	11	P00519-1	0	1130	P00519-1	0	1130	+	14	P00519-1#12	0	11	P00519-1	1089	1100	+	11	0	0	2549
P00519-1#13	0	17	17	P00519-1	532	549	+	17	P00519-1	26	1130	P00519-2	45	1149	+	15	P00519-1#13	0	17	P00519-2	551	568	+	17	0	0	2550
P00519-1#13	0	17	17	P00519-1	532	549	+	17	P00519-1	0	1130	P00519-1	0	1130	+	14	P00519-1#13	0	17	P00519-1	532	549	+	17	0	0	2551
P00519-1#14	0	23	23	P00519-1	578	601	+	23	P00519-1	26	1130	P00519-2	45	1149	+	15	P00519-1#14	0	23	P00519-2	597	620	+	23	0	0	2552
P00519-1#14	0	23	23	P00519-1	578	601	+	23	P00519-1	0	1130	P00519-1	0	1130	+	14	P00519-1#14	0	23	P00519-1	578	601	+	23	0	0	2553
P00519-1#15	0	17	17	P00519-1	621	638	+	17	P00519-1	26	1130	P00519-2	45	1149	+	15	P00519-1#15	0	17	P00519-2	640	657	+	17	0	0	2554
P00519-1#15	0	17	17	P00519-1	621	638	+	17	P00519-1	0	1130	P00519-1	0	1130	+	14	P00519-1#15	0	17	P00519-1	621	638	+	17	0	0	2555
P00519-1#16	0	19	19	P00519-1	684	703	+	19	P00519-1	26	1130	P00519-2	45	1149	+	15	P00519-1#16	0	19	P00519-2	703	722	+	19	0	0	2556
P00519-1#16	0	19	19	P00519-1	684	703	+	19	P00519-1	0	1130	P00519-1	0	1130	+	14	P00519-1#16	0	19	P00519-1	684	703	+	19	0	0	2557
P00519-1#17	0	19	19	P00519-1	734	753	+	19	P00519-1	26	1130	P00519-2	45	1149	+	15	P00519-1#17	0	19	P00519-2	753	772	+	19	0	0	2558
P00519-1#17	0	19	19	P00519-1	734	753	+	19	P00519-1	0	1130	P00519-1	0	1130	+	14	P00519-1#17	0	19	P00519-1	734	753	+	19	0	0	2559
P00519-1#18	0	15	15	P00519-1	757	772	+	15	P00519-1	26	1130	P00519-2	45	1149	+	15	P00519-1#18	0	15	P00519-2	776	791	+	15	0	0	2560
P00519-1#18	0	15	15	P00519-1	757	772	+	15	P00519-1	0	1130	P00519-1	0	1130	+	14	P00519-1#18	0	15	P00519-1	757	772	+	15	0	0	2561
P00519-1#19	0	25	25	P00519-1	869	894	+	25	P00519-1	26	1130	P00519-2	45	1149	+	15	P00519-1#19	0	25	P00519-2	888	913	+	25	0	0	2562
P00519-1#19	0	25	25	P00519-1	869	894	+	25	P00519-1	0	1130	P00519-1	0	1130	+	14	P00519-1#19	0	25	P00519-1	869	894	+	25	0	0	2563
P00519-1#20	0	1	1	P00519-1	362	363	+	1	P00519-1	26	1130	P00519-2	45	1149	+	15	P00519-1#20	0	1	P00519-2	381	382	+	1	0	0	2564
P00519-1#20	0	1	1	P00519-1	362	363	+	1	P00519-1	0	1130	P00519-1	0	1130	+	14	P00519-1#20	0	1	P00519-1	362	363	+	1	0	0	2565
P00519-1#21	0	9	9	P00519-1	247	256	+	9	P00519-1	26	1130	P00519-2	45	1149	+	15	P00519-1#21	0	9	P00519-2	266	275	+	9	0	0	2566
P00519-1#21	0	9	9	P00519-1	247	256	+	9	P00519-1	0	1130	P00519-1	0	1130	+	14	P00519-1#21	0	9	P00519-1	247	256	+	9	0	0	2567
P00519-1#22	0	1	1	P00519-1	270	271	+	1	P00519-1	26	1130	P00519-2	45	1149	+	15	P00519-1#22	0	1	P00519-2	289	290	+	1	0	0	2568
P00519-1#22	0	1	1	P00519-1	270	271	+	1	P00519-1	0	1130	P00519-1	0	1130	+	14	P00519-1#22	0	1	P00519-1	270	271	+	1	0	0	2569
P00519-1#23	0	7	7	P00519-1	315	322	+	7	P00519-1	26	1130	P00519-2	45	1149	+	15	P00519-1#23	0	7	P00519-2	334	341	+	7	0	0	2570
P00519-1#23	0	7	7	P00519-1	315	322	+	7	P00519-1	0	1130	P00519-1	0	1130	+	14	P00519-1#23	0	7	P00519-1	315	322	+	7	0	0	2571
P00519-1#24	0	2	2	P00519-1	25	27	+	2	P00519-1	26	1130	P00519-2	45	1149	+	15	P00519-1#24	1	2	P00519-2	45	46	+	1	1	0	2572
P00519-1#24	0	2	2	P00519-1	25	27	+	2	P00519-1	0	1130	P00519-1	0	1130	+	14	P00519-1#24	0	2	P00519-1	25	27	+	2	0	0	2573
P00519-1#25	0	1	1	P00519-1	49	50	+	1	P00519-1	26	1130	P00519-2	45	1149	+	15	P00519-1#25	0	1	P00519-2	68	69	+	1	0	0	2574
P00519-1#25	0	1	1	P00519-1	49	50	+	1	P00519-1	0	1130	P00519-1	0	1130	+	14	P00519-1#25	0	1	P00519-1	49	50	+	1	0	0	2575
P00519-1#26	0	1	1	P00519-1	69	70	+	1	P00519-1	26	1130	P00519-2	45	1149	+	15	P00519-1#26	0	1	P00519-2	88	89	+	1	0	0	2576
P00519-1#26	0	1	1	P00519-1	69	70	+	1	P00519-1	0	1130	P00519-1	0	1130	+	14	P00519-1#26	0	1	P00519-1	69	70	+	1	0	0	2577
P00519-1#27	0	1	1	P00519-1	114	115	+	1	P00519-1	26	1130	P00519-2	45	1149	+	15	P00519-1#27	0	1	P00519-2	133	134	+	1	0	0	2578
P00519-1#27	0	1	1	P00519-1	114	115	+	1	P00519-1	0	1130	P00519-1	0	1130	+	14	P00519-1#27	0	1	P00519-1	114	115	+	1	0	0	2579
P00519-1#28	0	1	1	P00519-1	127	128	+	1	P00519-1	26	1130	P00519-2	45	1149	+	15	P00519-1#28	0	1	P00519-2	146	147	+	1	0	0	2580
P00519-1#28	0	1	1	P00519-1	127	128	+	1	P00519-1	0	1130	P00519-1	0	1130	+	14	P00519-1#28	0	1	P00519-1	127	128	+	1	0	0	2581
P00519-1#29	0	1	1	P00519-1	138	139	+	1	P00519-1	26	1130	P00519-2	45	1149	+	15	P00519-1#29	0	1	P00519-2	157	158	+	1	0	0	2582
P00519-1#29	0	1	1	P00519-1	138	139	+	1	P00519-1	0	1130	P00519-1	0	1130	+	14	P00519-1#29	0	1	P00519-1	138	139	+	1	0	0	2583
P00519-1#30	0	1	1	P00519-1	171	172	+	1	P00519-1	26	1130	P00519-2	45	1149	+	15	P00519-1#30	0	1	P00519-2	190	191	+	1	0	0	2584
P00519-1#30	0	1	1	P00519-1	171	172	+	1	P00519-1	0	1130	P00519-1	0	1130	+	14	P00519-1#30	0	1	P00519-1	171	172	+	1	0	0	2585
P00519-1#31	0	1	1	P00519-1	184	185	+	1	P00519-1	26	1130	P00519-2	45	1149	+	15	P00519-1#31	0	1	P00519-2	203	204	+	1	0	0	2586
P00519-1#31	0	1	1	P00519-1	184	185	+	1	P00519-1	0	1130	P00519-1	0	1130	+	14	P00519-1#31	0	1	P00519-1	184	185	+	1	0	0	2587
P00519-1#32	0	1	1	P00519-1	214	215	+	1	P00519-1	26	1130	P00519-2	45	1149	+	15	P00519-1#32	0	1	P00519-2	233	234	+	1	0	0	2588
P00519-1#32	0	1	1	P00519-1	214	215	+	1	P00519-1	0	1130	P00519-1	0	1130	+	14	P00519-1#32	0	1	P00519-1	214	215	+	1	0	0	2589
P00519-1#33	0	1	1	P00519-1	225	226	+	1	P00519-1	26	1130	P00519-2	45	1149	+	15	P00519-1#33	0	1	P00519-2	244	245	+	1	0	0	2590
P00519-1#33	0	1	1	P00519-1	225	226	+	1	P00519-1	0	1130	P00519-1	0	1130	+	14	P00519-1#33	0	1	P00519-1	225	226	+	1	0	0	2591
P00519-1#34	0	1	1	P00519-1	228	229	+	1	P00519-1	26	1130	P00519-2	45	1149	+	15	P00519-1#34	0	1	P00519-2	247	248	+	1	0	0	2592
P00519-1#34	0	1	1	P00519-1	228	229	+	1	P00519-1	0	1130	P00519-1	0	1130	+	14	P00519-1#34	0	1	P00519-1	228	229	+	1	0	0	2593
P00519-1#35	0	1	1	P00519-1	252	253	+	1	P00519-1	26	1130	P00519-2	45	1149	+	15	P00519-1#35	0	1	P00519-2	271	272	+	1	0	0	2594
P00519-1#35	0	1	1	P00519-1	252	253	+	1	P00519-1	0	1130	P00519-1	0	1130	+	14	P00519-1#35	0	1	P00519-1	252	253	+	1	0	0	2595
P00519-1#36	0	1	1	P00519-1	256	257	+	1	P00519-1	26	1130	P00519-2	45	1149	+	15	P00519-1#36	0	1	P00519-2	275	276	+	1	0	0	2596
P00519-1#36	0	1	1	P00519-1	256	257	+	1	P00519-1	0	1130	P00519-1	0	1130	+	14	P00519-1#36	0	1	P00519-1	256	257	+	1	0	0	2597
P00519-1#37	0	1	1	P00519-1	392	393	+	1	P00519-1	26	1130	P00519-2	45	1149	+	15	P00519-1#37	0	1	P00519-2	411	412	+	1	0	0	2598
P00519-1#37	0	1	1	P00519-1	392	393	+	1	P00519-1	0	1130	P00519-1	0	1130	+	14	P00519-1#37	0	1	P00519-1	392	393	+	1	0	0	2599
P00519-1#38	0	1	1	P00519-1	412	413	+	1	P00519-1	26	1130	P00519-2	45	1149	+	15	P00519-1#38	0	1	P00519-2	431	432	+	1	0	0	2600
P00519-1#38	0	1	1	P00519-1	412	413	+	1	P00519-1	0	1130	P00519-1	0	1130	+	14	P00519-1#38	0	1	P00519-1	412	413	+	1	0	0	2601
P00519-1#39	0	1	1	P00519-1	445	446	+	1	P00519-1	26	1130	P00519-2	45	1149	+	15	P00519-1#39	0	1	P00519-2	464	465	+	1	0	0	2602
P00519-1#39	0	1	1	P00519-1	445	446	+	1	P00519-1	0	1130	P00519-1	0	1130	+	14	P00519-1#39	0	1	P00519-1	445	446	+	1	0	0	2603
P00519-1#40	0	1	1	P00519-1	558	559	+	1	P00519-1	26	1130	P00519-2	45	1149	+	15	P00519-1#40	0	1	P00519-2	577	578	+	1	0	0	2604
P00519-1#40	0	1	1	P00519-1	558	559	+	1	P00519-1	0	1130	P00519-1	0	1130	+	14	P00519-1#40	0	1	P00519-1	558	559	+	1	0	0	2605
P00519-1#41	0	1	1	P00519-1	568	569	+	1	P00519-1	26	1130	P00519-2	45	1149	+	15	P00519-1#41	0	1	P00519-2	587	588	+	1	0	0	2606
P00519-1#41	0	1	1	P00519-1	568	569	+	1	P00519-1	0	1130	P00519-1	0	1130	+	14	P00519-1#41	0	1	P00519-1	568	569	+	1	0	0	2607
P00519-1#42	0	1	1	P00519-1	617	618	+	1	P00519-1	26	1130	P00519-2	45	1149	+	15	P00519-1#42	0	1	P00519-2	636	637	+	1	0	0	2608
P00519-1#42	0	1	1	P00519-1	617	618	+	1	P00519-1	0	1130	P00519-1	0	1130	+	14	P00519-1#42	0	1	P00519-1	617	618	+	1	0	0	2609
P00519-1#43	0	1	1	P00519-1	618	619	+	1	P00519-1	26	1130	P00519-2	45	1149	+	15	P00519-1#43	0	1	P00519-2	637	638	+	1	0	0	2610
P00519-1#43	0	1	1	P00519-1	618	619	+	1	P00519-1	0	1130	P00519-1	0	1130	+	14	P00519-1#43	0	1	P00519-1	618	619	+	1	0	0	2611
P00519-1#44	0	1	1	P00519-1	619	620	+	1	P00519-1	26	1130	P00519-2	45	1149	+	15	P00519-1#44	0	1	P00519-2	638	639	+	1	0	0	2612
P00519-1#44	0	1	1	P00519-1	619	620	+	1	P00519-1	0	1130	P00519-1	0	1130	+	14	P00519-1#44	0	1	P00519-1	619	620	+	1	0	0	2613
P00519-1#45	0	1	1	P00519-1	658	659	+	1	P00519-1	26	1130	P00519-2	45	1149	+	15	P00519-1#45	0	1	P00519-2	677	678	+	1	0	0	2614
P00519-1#45	0	1	1	P00519-1	658	659	+	1	P00519-1	0	1130	P00519-1	0	1130	+	14	P00519-1#45	0	1	P00519-1	658	659	+	1	0	0	2615
P00519-1#46	0	1	1	P00519-1	682	683	+	1	P00519-1	26	1130	P00519-2	45	1149	+	15	P00519-1#46	0	1	P00519-2	701	702	+	1	0	0	2616
P00519-1#46	0	1	1	P00519-1	682	683	+	1	P00519-1	0	1130	P00519-1	0	1130	+	14	P00519-1#46	0	1	P00519-1	682	683	+	1	0	0	2617
P00519-1#47	0	1	1	P00519-1	710	711	+	1	P00519-1	26	1130	P00519-2	45	1149	+	15	P00519-1#47	0	1	P00519-2	729	730	+	1	0	0	2618
P00519-1#47	0	1	1	P00519-1	710	711	+	1	P00519-1	0	1130	P00519-1	0	1130	+	14	P00519-1#47	0	1	P00519-1	710	711	+	1	0	0	2619
P00519-1#48	0	1	1	P00519-1	717	718	+	1	P00519-1	26	1130	P00519-2	45	1149	+	15	P00519-1#48	0	1	P00519-2	736	737	+	1	0	0	2620
P00519-1#48	0	1	1	P00519-1	717	718	+	1	P00519-1	0	1130	P00519-1	0	1130	+	14	P00519-1#48	0	1	P00519-1	717	718	+	1	0	0	2621
P00519-1#49	0	1	1	P00519-1	734	735	+	1	P00519-1	26	1130	P00519-2	45	1149	+	15	P00519-1#49	0	1	P00519-2	753	754	+	1	0	0	2622
P00519-1#49	0	1	1	P00519-1	734	735	+	1	P00519-1	0	1130	P00519-1	0	1130	+	14	P00519-1#49	0	1	P00519-1	734	735	+	1	0	0	2623
P00519-1#50	0	1	1	P00519-1	750	751	+	1	P00519-1	26	1130	P00519-2	45	1149	+	15	P00519-1#50	0	1	P00519-2	769	770	+	1	0	0	2624
P00519-1#50	0	1	1	P00519-1	750	751	+	1	P00519-1	0	1130	P00519-1	0	1130	+	14	P00519-1#50	0	1	P00519-1	750	751	+	1	0	0	2625
P00519-1#51	0	1	1	P00519-1	780	781	+	1	P00519-1	26	1130	P00519-2	45	1149	+	15	P00519-1#51	0	1	P00519-2	799	800	+	1	0	0	2626
P00519-1#51	0	1	1	P00519-1	780	781	+	1	P00519-1	0	1130	P00519-1	0	1130	+	14	P00519-1#51	0	1	P00519-1	780	781	+	1	0	0	2627
P00519-1#52	0	1	1	P00519-1	813	814	+	1	P00519-1	26	1130	P00519-2	45	1149	+	15	P00519-1#52	0	1	P00519-2	832	833	+	1	0	0	2628
P00519-1#52	0	1	1	P00519-1	813	814	+	1	P00519-1	0	1130	P00519-1	0	1130	+	14	P00519-1#52	0	1	P00519-1	813	814	+	1	0	0	2629
P00519-1#53	0	1	1	P00519-1	822	823	+	1	P00519-1	26	1130	P00519-2	45	1149	+	15	P00519-1#53	0	1	P00519-2	841	842	+	1	0	0	2630
P00519-1#53	0	1	1	P00519-1	822	823	+	1	P00519-1	0	1130	P00519-1	0	1130	+	14	P00519-1#53	0	1	P00519-1	822	823	+	1	0	0	2631
P00519-1#54	0	1	1	P00519-1	843	844	+	1	P00519-1	26	1130	P00519-2	45	1149	+	15	P00519-1#54	0	1	P00519-2	862	863	+	1	0	0	2632
P00519-1#54	0	1	1	P00519-1	843	844	+	1	P00519-1	0	1130	P00519-1	0	1130	+	14	P00519-1#54	0	1	P00519-1	843	844	+	1	0	0	2633
P00519-1#55	0	1	1	P00519-1	851	852	+	1	P00519-1	26	1130	P00519-2	45	1149	+	15	P00519-1#55	0	1	P00519-2	870	871	+	1	0	0	2634
P00519-1#55	0	1	1	P00519-1	851	852	+	1	P00519-1	0	1130	P00519-1	0	1130	+	14	P00519-1#55	0	1	P00519-1	851	852	+	1	0	0	2635
P00519-1#56	0	1	1	P00519-1	854	855	+	1	P00519-1	26	1130	P00519-2	45	1149	+	15	P00519-1#56	0	1	P00519-2	873	874	+	1	0	0	2636
P00519-1#56	0	1	1	P00519-1	854	855	+	1	P00519-1	0	1130	P00519-1	0	1130	+	14	P00519-1#56	0	1	P00519-1	854	855	+	1	0	0	2637
P00519-1#57	0	1	1	P00519-1	916	917	+	1	P00519-1	26	1130	P00519-2	45	1149	+	15	P00519-1#57	0	1	P00519-2	935	936	+	1	0	0	2638
P00519-1#57	0	1	1	P00519-1	916	917	+	1	P00519-1	0	1130	P00519-1	0	1130	+	14	P00519-1#57	0	1	P00519-1	916	917	+	1	0	0	2639
P00519-1#58	0	1	1	P00519-1	976	977	+	1	P00519-1	26	1130	P00519-2	45	1149	+	15	P00519-1#58	0	1	P00519-2	995	996	+	1	0	0	2640
P00519-1#58	0	1	1	P00519-1	976	977	+	1	P00519-1	0	1130	P00519-1	0	1130	+	14	P00519-1#58	0	1	P00519-1	976	977	+	1	0	0	2641
P00519-1#59	0	26	26	P00519-1	0	26	+	26	P00519-1	0	1130	P00519-1	0	1130	+	14	P00519-1#59	0	26	P00519-1	0	26	+	26	0	0	2642
P00519-1#60	0	1	1	P00519-1	46	47	+	1	P00519-1	26	1130	P00519-2	45	1149	+	15	P00519-1#60	0	1	P00519-2	65	66	+	1	0	0	2643
P00519-1#60	0	1	1	P00519-1	46	47	+	1	P00519-1	0	1130	P00519-1	0	1130	+	14	P00519-1#60	0	1	P00519-1	46	47	+	1	0	0	2644
P00519-1#61	0	1	1	P00519-1	139	140	+	1	P00519-1	26	1130	P00519-2	45	1149	+	15	P00519-1#61	0	1	P00519-2	158	159	+	1	0	0	2645
P00519-1#61	0	1	1	P00519-1	139	140	+	1	P00519-1	0	1130	P00519-1	0	1130	+	14	P00519-1#61	0	1	P00519-1	139	140	+	1	0	0	2646
P00519-1#62	0	1	1	P00519-1	165	166	+	1	P00519-1	26	1130	P00519-2	45	1149	+	15	P00519-1#62	0	1	P00519-2	184	185	+	1	0	0	2647
P00519-1#62	0	1	1	P00519-1	165	166	+	1	P00519-1	0	1130	P00519-1	0	1130	+	14	P00519-1#62	0	1	P00519-1	165	166	+	1	0	0	2648
P00519-1#63	0	1	1	P00519-1	225	226	+	1	P00519-1	26	1130	P00519-2	45	1149	+	15	P00519-1#63	0	1	P00519-2	244	245	+	1	0	0	2649
P00519-1#63	0	1	1	P00519-1	225	226	+	1	P00519-1	0	1130	P00519-1	0	1130	+	14	P00519-1#63	0	1	P00519-1	225	226	+	1	0	0	2650
P00519-1#64	0	1	1	P00519-1	246	247	+	1	P00519-1	26	1130	P00519-2	45	1149	+	15	P00519-1#64	0	1	P00519-2	265	266	+	1	0	0	2651
P00519-1#64	0	1	1	P00519-1	246	247	+	1	P00519-1	0	1130	P00519-1	0	1130	+	14	P00519-1#64	0	1	P00519-1	246	247	+	1	0	0	2652
P00519-1#65	0	1	1	P00519-1	336	337	+	1	P00519-1	26	1130	P00519-2	45	1149	+	15	P00519-1#65	0	1	P00519-2	355	356	+	1	0	0	2653
P00519-1#65	0	1	1	P00519-1	336	337	+	1	P00519-1	0	1130	P00519-1	0	1130	+	14	P00519-1#65	0	1	P00519-1	336	337	+	1	0	0	2654
P00519-1#66	0	1	1	P00519-1	705	706	+	1	P00519-1	26	1130	P00519-2	45	1149	+	15	P00519-1#66	0	1	P00519-2	724	725	+	1	0	0	2655
P00519-1#66	0	1	1	P00519-1	705	706	+	1	P00519-1	0	1130	P00519-1	0	1130	+	14	P00519-1#66	0	1	P00519-1	705	706	+	1	0	0	2656
P00519-1#67	0	1	1	P00519-1	809	810	+	1	P00519-1	26	1130	P00519-2	45	1149	+	15	P00519-1#67	0	1	P00519-2	828	829	+	1	0	0	2657
P00519-1#67	0	1	1	P00519-1	809	810	+	1	P00519-1	0	1130	P00519-1	0	1130	+	14	P00519-1#67	0	1	P00519-1	809	810	+	1	0	0	2658
P00519-1#68	0	1	1	P00519-1	851	852	+	1	P00519-1	26	1130	P00519-2	45	1149	+	15	P00519-1#68	0	1	P00519-2	870	871	+	1	0	0	2659
P00519-1#68	0	1	1	P00519-1	851	852	+	1	P00519-1	0	1130	P00519-1	0	1130	+	14	P00519-1#68	0	1	P00519-1	851	852	+	1	0	0	2660
P00519-1#69	0	1	1	P00519-1	899	900	+	1	P00519-1	26	1130	P00519-2	45	1149	+	15	P00519-1#69	0	1	P00519-2	918	919	+	1	0	0	2661
P00519-1#69	0	1	1	P00519-1	899	900	+	1	P00519-1	0	1130	P00519-1	0	1130	+	14	P00519-1#69	0	1	P00519-1	899	900	+	1	0	0	2662
P00519-1#70	0	1	1	P00519-1	967	968	+	1	P00519-1	26	1130	P00519-2	45	1149	+	15	P00519-1#70	0	1	P00519-2	986	987	+	1	0	0	2663
P00519-1#70	0	1	1	P00519-1	967	968	+	1	P00519-1	0	1130	P00519-1	0	1130	+	14	P00519-1#70	0	1	P00519-1	967	968	+	1	0	0	2664
P00519-1#71	0	1	1	P00519-1	971	972	+	1	P00519-1	26	1130	P00519-2	45	1149	+	15	P00519-1#71	0	1	P00519-2	990	991	+	1	0	0	2665
P00519-1#71	0	1	1	P00519-1	971	972	+	1	P00519-1	0	1130	P00519-1	0	1130	+	14	P00519-1#71	0	1	P00519-1	971	972	+	1	0	0	2666
P00519-1#72	0	1	1	P00519-1	734	735	+	1	P00519-1	26	1130	P00519-2	45	1149	+	15	P00519-1#72	0	1	P00519-2	753	754	+	1	0	0	2667
P00519-1#72	0	1	1	P00519-1	734	735	+	1	P00519-1	0	1130	P00519-1	0	1130	+	14	P00519-1#72	0	1	P00519-1	734	735	+	1	0	0	2668
P00519-1#73	0	1	1	P00519-1	158	159	+	1	P00519-1	26	1130	P00519-2	45	1149	+	15	P00519-1#73	0	1	P00519-2	177	178	+	1	0	0	2669
P00519-1#73	0	1	1	P00519-1	158	159	+	1	P00519-1	0	1130	P00519-1	0	1130	+	14	P00519-1#73	0	1	P00519-1	158	159	+	1	0	0	2670
P00519-1#74	0	2	2	P00519-1	423	425	+	2	P00519-1	26	1130	P00519-2	45	1149	+	15	P00519-1#74	0	2	P00519-2	442	444	+	2	0	0	2671
P00519-1#74	0	2	2	P00519-1	423	425	+	2	P00519-1	0	1130	P00519-1	0	1130	+	14	P00519-1#74	0	2	P00519-1	423	425	+	2	0	0	2672
P00519-1#75	0	1	1	P00519-1	444	445	+	1	P00519-1	26	1130	P00519-2	45	1149	+	15	P00519-1#75	0	1	P00519-2	463	464	+	1	0	0	2673
P00519-1#75	0	1	1	P00519-1	444	445	+	1	P00519-1	0	1130	P00519-1	0	1130	+	14	P00519-1#75	0	1	P00519-1	444	445	+	1	0	0	2674
P00519-1#76	0	1	1	P00519-1	458	459	+	1	P00519-1	26	1130	P00519-2	45	1149	+	15	P00519-1#76	0	1	P00519-2	477	478	+	1	0	0	2675
P00519-1#76	0	1	1	P00519-1	458	459	+	1	P00519-1	0	1130	P00519-1	0	1130	+	14	P00519-1#76	0	1	P00519-1	458	459	+	1	0	0	2676
P00519-1#77	0	1	1	P00519-1	519	520	+	1	P00519-1	26	1130	P00519-2	45	1149	+	15	P00519-1#77	0	1	P00519-2	538	539	+	1	0	0	2677
P00519-1#77	0	1	1	P00519-1	519	520	+	1	P00519-1	0	1130	P00519-1	0	1130	+	14	P00519-1#77	0	1	P00519-1	519	520	+	1	0	0	2678
P00519-1#78	0	1	1	P00519-1	718	719	+	1	P00519-1	26	1130	P00519-2	45	1149	+	15	P00519-1#78	0	1	P00519-2	737	738	+	1	0	0	2679
P00519-1#78	0	1	1	P00519-1	718	719	+	1	P00519-1	0	1130	P00519-1	0	1130	+	14	P00519-1#78	0	1	P00519-1	718	719	+	1	0	0	2680
P00519-1#79	0	1	1	P00519-1	836	837	+	1	P00519-1	26	1130	P00519-2	45	1149	+	15	P00519-1#79	0	1	P00519-2	855	856	+	1	0	0	2681
P00519-1#79	0	1	1	P00519-1	836	837	+	1	P00519-1	0	1130	P00519-1	0	1130	+	14	P00519-1#79	0	1	P00519-1	836	837	+	1	0	0	2682
P00519-1#80	0	1	1	P00519-1	836	837	+	1	P00519-1	26	1130	P00519-2	45	1149	+	15	P00519-1#80	0	1	P00519-2	855	856	+	1	0	0	2683
P00519-1#80	0	1	1	P00519-1	836	837	+	1	P00519-1	0	1130	P00519-1	0	1130	+	14	P00519-1#80	0	1	P00519-1	836	837	+	1	0	0	2684
P00519-1#81	0	1	1	P00519-1	862	863	+	1	P00519-1	26	1130	P00519-2	45	1149	+	15	P00519-1#81	0	1	P00519-2	881	882	+	1	0	0	2685
P00519-1#81	0	1	1	P00519-1	862	863	+	1	P00519-1	0	1130	P00519-1	0	1130	+	14	P00519-1#81	0	1	P00519-1	862	863	+	1	0	0	2686
P00519-1#82	0	1	1	P00519-1	893	894	+	1	P00519-1	26	1130	P00519-2	45	1149	+	15	P00519-1#82	0	1	P00519-2	912	913	+	1	0	0	2687
P00519-1#82	0	1	1	P00519-1	893	894	+	1	P00519-1	0	1130	P00519-1	0	1130	+	14	P00519-1#82	0	1	P00519-1	893	894	+	1	0	0	2688
P00519-1#83	0	3	3	P00519-1	916	919	+	3	P00519-1	26	1130	P00519-2	45	1149	+	15	P00519-1#83	0	3	P00519-2	935	938	+	3	0	0	2689
P00519-1#83	0	3	3	P00519-1	916	919	+	3	P00519-1	0	1130	P00519-1	0	1130	+	14	P00519-1#83	0	3	P00519-1	916	919	+	3	0	0	2690
P00519-1#84	0	1	1	P00519-1	951	952	+	1	P00519-1	26	1130	P00519-2	45	1149	+	15	P00519-1#84	0	1	P00519-2	970	971	+	1	0	0	2691
P00519-1#84	0	1	1	P00519-1	951	952	+	1	P00519-1	0	1130	P00519-1	0	1130	+	14	P00519-1#84	0	1	P00519-1	951	952	+	1	0	0	2692
P00519-1#85	0	2	2	P00519-1	966	968	+	2	P00519-1	26	1130	P00519-2	45	1149	+	15	P00519-1#85	0	2	P00519-2	985	987	+	2	0	0	2693
P00519-1#85	0	2	2	P00519-1	966	968	+	2	P00519-1	0	1130	P00519-1	0	1130	+	14	P00519-1#85	0	2	P00519-1	966	968	+	2	0	0	2694
P00519-1#86	0	1	1	P00519-1	981	982	+	1	P00519-1	26	1130	P00519-2	45	1149	+	15	P00519-1#86	0	1	P00519-2	1000	1001	+	1	0	0	2695
P00519-1#86	0	1	1	P00519-1	981	982	+	1	P00519-1	0	1130	P00519-1	0	1130	+	14	P00519-1#86	0	1	P00519-1	981	982	+	1	0	0	2696
P00519-1#87	0	1	1	P00519-1	1021	1022	+	1	P00519-1	26	1130	P00519-2	45	1149	+	15	P00519-1#87	0	1	P00519-2	1040	1041	+	1	0	0	2697
P00519-1#87	0	1	1	P00519-1	1021	1022	+	1	P00519-1	0	1130	P00519-1	0	1130	+	14	P00519-1#87	0	1	P00519-1	1021	1022	+	1	0	0	2698
P00519-1#88	0	1	1	P00519-1	1044	1045	+	1	P00519-1	26	1130	P00519-2	45	1149	+	15	P00519-1#88	0	1	P00519-2	1063	1064	+	1	0	0	2699
P00519-1#88	0	1	1	P00519-1	1044	1045	+	1	P00519-1	0	1130	P00519-1	0	1130	+	14	P00519-1#88	0	1	P00519-1	1044	1045	+	1	0	0	2700
P00519-1#89	0	1	1	P00519-1	1102	1103	+	1	P00519-1	26	1130	P00519-2	45	1149	+	15	P00519-1#89	0	1	P00519-2	1121	1122	+	1	0	0	2701
P00519-1#89	0	1	1	P00519-1	1102	1103	+	1	P00519-1	0	1130	P00519-1	0	1130	+	14	P00519-1#89	0	1	P00519-1	1102	1103	+	1	0	0	2702
P00519-1#90	0	7	7	P00519-1	25	32	+	7	P00519-1	26	1130	P00519-2	45	1149	+	15	P00519-1#90	1	7	P00519-2	45	51	+	6	1	0	2703
P00519-1#90	0	7	7	P00519-1	25	32	+	7	P00519-1	0	1130	P00519-1	0	1130	+	14	P00519-1#90	0	7	P00519-1	25	32	+	7	0	0	2704
P00519-1#91	0	6	6	P00519-1	38	44	+	6	P00519-1	26	1130	P00519-2	45	1149	+	15	P00519-1#91	0	6	P00519-2	57	63	+	6	0	0	2705
P00519-1#91	0	6	6	P00519-1	38	44	+	6	P00519-1	0	1130	P00519-1	0	1130	+	14	P00519-1#91	0	6	P00519-1	38	44	+	6	0	0	2706
P00519-1#92	0	3	3	P00519-1	44	47	+	3	P00519-1	26	1130	P00519-2	45	1149	+	15	P00519-1#92	0	3	P00519-2	63	66	+	3	0	0	2707
P00519-1#92	0	3	3	P00519-1	44	47	+	3	P00519-1	0	1130	P00519-1	0	1130	+	14	P00519-1#92	0	3	P00519-1	44	47	+	3	0	0	2708
P00519-1#93	0	5	5	P00519-1	48	53	+	5	P00519-1	26	1130	P00519-2	45	1149	+	15	P00519-1#93	0	5	P00519-2	67	72	+	5	0	0	2709
P00519-1#93	0	5	5	P00519-1	48	53	+	5	P00519-1	0	1130	P00519-1	0	1130	+	14	P00519-1#93	0	5	P00519-1	48	53	+	5	0	0	2710
P00519-1#94	0	3	3	P00519-1	57	60	+	3	P00519-1	26	1130	P00519-2	45	1149	+	15	P00519-1#94	0	3	P00519-2	76	79	+	3	0	0	2711
P00519-1#94	0	3	3	P00519-1	57	60	+	3	P00519-1	0	1130	P00519-1	0	1130	+	14	P00519-1#94	0	3	P00519-1	57	60	+	3	0	0	2712
P00519-1#95	0	6	6	P00519-1	64	70	+	6	P00519-1	26	1130	P00519-2	45	1149	+	15	P00519-1#95	0	6	P00519-2	83	89	+	6	0	0	2713
P00519-1#95	0	6	6	P00519-1	64	70	+	6	P00519-1	0	1130	P00519-1	0	1130	+	14	P00519-1#95	0	6	P00519-1	64	70	+	6	0	0	2714
P00519-1#96	0	4	4	P00519-1	75	79	+	4	P00519-1	26	1130	P00519-2	45	1149	+	15	P00519-1#96	0	4	P00519-2	94	98	+	4	0	0	2715
P00519-1#96	0	4	4	P00519-1	75	79	+	4	P00519-1	0	1130	P00519-1	0	1130	+	14	P00519-1#96	0	4	P00519-1	75	79	+	4	0	0	2716
P00519-1#97	0	7	7	P00519-1	86	93	+	7	P00519-1	26	1130	P00519-2	45	1149	+	15	P00519-1#97	0	7	P00519-2	105	112	+	7	0	0	2717
P00519-1#97	0	7	7	P00519-1	86	93	+	7	P00519-1	0	1130	P00519-1	0	1130	+	14	P00519-1#97	0	7	P00519-1	86	93	+	7	0	0	2718
P00519-1#98	0	8	8	P00519-1	96	104	+	8	P00519-1	26	1130	P00519-2	45	1149	+	15	P00519-1#98	0	8	P00519-2	115	123	+	8	0	0	2719
P00519-1#98	0	8	8	P00519-1	96	104	+	8	P00519-1	0	1130	P00519-1	0	1130	+	14	P00519-1#98	0	8	P00519-1	96	104	+	8	0	0	2720
P00519-1#99	0	6	6	P00519-1	106	112	+	6	P00519-1	26	1130	P00519-2	45	1149	+	15	P00519-1#99	0	6	P00519-2	125	131	+	6	0	0	2721
P00519-1#99	0	6	6	P00519-1	106	112	+	6	P00519-1	0	1130	P00519-1	0	1130	+	14	P00519-1#99	0	6	P00519-1	106	112	+	6	0	0	2722
P00519-1#100	0	3	3	P00519-1	112	115	+	3	P00519-1	26	1130	P00519-2	45	1149	+	15	P00519-1#100	0	3	P00519-2	131	134	+	3	0	0	2723
P00519-1#100	0	3	3	P00519-1	112	115	+	3	P00519-1	0	1130	P00519-1	0	1130	+	14	P00519-1#100	0	3	P00519-1	112	115	+	3	0	0	2724
P00519-1#101	0	3	3	P00519-1	115	118	+	3	P00519-1	26	1130	P00519-2	45	1149	+	15	P00519-1#101	0	3	P00519-2	134	137	+	3	0	0	2725
P00519-1#101	0	3	3	P00519-1	115	118	+	3	P00519-1	0	1130	P00519-1	0	1130	+	14	P00519-1#101	0	3	P00519-1	115	118	+	3	0	0	2726
P00519-1#102	0	3	3	P00519-1	121	124	+	3	P00519-1	26	1130	P00519-2	45	1149	+	15	P00519-1#102	0	3	P00519-2	140	143	+	3	0	0	2727
P00519-1#102	0	3	3	P00519-1	121	124	+	3	P00519-1	0	1130	P00519-1	0	1130	+	14	P00519-1#102	0	3	P00519-1	121	124	+	3	0	0	2728
P00519-1#103	0	4	4	P00519-1	127	131	+	4	P00519-1	26	1130	P00519-2	45	1149	+	15	P00519-1#103	0	4	P00519-2	146	150	+	4	0	0	2729
P00519-1#103	0	4	4	P00519-1	127	131	+	4	P00519-1	0	1130	P00519-1	0	1130	+	14	P00519-1#103	0	4	P00519-1	127	131	+	4	0	0	2730
P00519-1#104	0	7	7	P00519-1	133	140	+	7	P00519-1	26	1130	P00519-2	45	1149	+	15	P00519-1#104	0	7	P00519-2	152	159	+	7	0	0	2731
P00519-1#104	0	7	7	P00519-1	133	140	+	7	P00519-1	0	1130	P00519-1	0	1130	+	14	P00519-1#104	0	7	P00519-1	133	140	+	7	0	0	2732
P00519-1#105	0	3	3	P00519-1	140	143	+	3	P00519-1	26	1130	P00519-2	45	1149	+	15	P00519-1#105	0	3	P00519-2	159	162	+	3	0	0	2733
P00519-1#105	0	3	3	P00519-1	140	143	+	3	P00519-1	0	1130	P00519-1	0	1130	+	14	P00519-1#105	0	3	P00519-1	140	143	+	3	0	0	2734
P00519-1#106	0	6	6	P00519-1	147	153	+	6	P00519-1	26	1130	P00519-2	45	1149	+	15	P00519-1#106	0	6	P00519-2	166	172	+	6	0	0	2735
P00519-1#106	0	6	6	P00519-1	147	153	+	6	P00519-1	0	1130	P00519-1	0	1130	+	14	P00519-1#106	0	6	P00519-1	147	153	+	6	0	0	2736
P00519-1#107	0	3	3	P00519-1	154	157	+	3	P00519-1	26	1130	P00519-2	45	1149	+	15	P00519-1#107	0	3	P00519-2	173	176	+	3	0	0	2737
P00519-1#107	0	3	3	P00519-1	154	157	+	3	P00519-1	0	1130	P00519-1	0	1130	+	14	P00519-1#107	0	3	P00519-1	154	157	+	3	0	0	2738
P00519-1#108	0	7	7	P00519-1	160	167	+	7	P00519-1	26	1130	P00519-2	45	1149	+	15	P00519-1#108	0	7	P00519-2	179	186	+	7	0	0	2739
P00519-1#108	0	7	7	P00519-1	160	167	+	7	P00519-1	0	1130	P00519-1	0	1130	+	14	P00519-1#108	0	7	P00519-1	160	167	+	7	0	0	2740
P00519-1#109	0	6	6	P00519-1	169	175	+	6	P00519-1	26	1130	P00519-2	45	1149	+	15	P00519-1#109	0	6	P00519-2	188	194	+	6	0	0	2741
P00519-1#109	0	6	6	P00519-1	169	175	+	6	P00519-1	0	1130	P00519-1	0	1130	+	14	P00519-1#109	0	6	P00519-1	169	175	+	6	0	0	2742
P00519-1#110	0	3	3	P00519-1	176	179	+	3	P00519-1	26	1130	P00519-2	45	1149	+	15	P00519-1#110	0	3	P00519-2	195	198	+	3	0	0	2743
P00519-1#110	0	3	3	P00519-1	176	179	+	3	P00519-1	0	1130	P00519-1	0	1130	+	14	P00519-1#110	0	3	P00519-1	176	179	+	3	0	0	2744
P00519-1#111	0	3	3	P00519-1	179	182	+	3	P00519-1	26	1130	P00519-2	45	1149	+	15	P00519-1#111	0	3	P00519-2	198	201	+	3	0	0	2745
P00519-1#111	0	3	3	P00519-1	179	182	+	3	P00519-1	0	1130	P00519-1	0	1130	+	14	P00519-1#111	0	3	P00519-1	179	182	+	3	0	0	2746
P00519-1#112	0	4	4	P00519-1	183	187	+	4	P00519-1	26	1130	P00519-2	45	1149	+	15	P00519-1#112	0	4	P00519-2	202	206	+	4	0	0	2747
P00519-1#112	0	4	4	P00519-1	183	187	+	4	P00519-1	0	1130	P00519-1	0	1130	+	14	P00519-1#112	0	4	P00519-1	183	187	+	4	0	0	2748
P00519-1#113	0	5	5	P00519-1	189	194	+	5	P00519-1	26	1130	P00519-2	45	1149	+	15	P00519-1#113	0	5	P00519-2	208	213	+	5	0	0	2749
P00519-1#113	0	5	5	P00519-1	189	194	+	5	P00519-1	0	1130	P00519-1	0	1130	+	14	P00519-1#113	0	5	P00519-1	189	194	+	5	0	0	2750
P00519-1#114	0	8	8	P00519-1	194	202	+	8	P00519-1	26	1130	P00519-2	45	1149	+	15	P00519-1#114	0	8	P00519-2	213	221	+	8	0	0	2751
P00519-1#114	0	8	8	P00519-1	194	202	+	8	P00519-1	0	1130	P00519-1	0	1130	+	14	P00519-1#114	0	8	P00519-1	194	202	+	8	0	0	2752
P00519-1#115	0	3	3	P00519-1	208	211	+	3	P00519-1	26	1130	P00519-2	45	1149	+	15	P00519-1#115	0	3	P00519-2	227	230	+	3	0	0	2753
P00519-1#115	0	3	3	P00519-1	208	211	+	3	P00519-1	0	1130	P00519-1	0	1130	+	14	P00519-1#115	0	3	P00519-1	208	211	+	3	0	0	2754
P00519-1#116	0	3	3	P00519-1	225	228	+	3	P00519-1	26	1130	P00519-2	45	1149	+	15	P00519-1#116	0	3	P00519-2	244	247	+	3	0	0	2755
P00519-1#116	0	3	3	P00519-1	225	228	+	3	P00519-1	0	1130	P00519-1	0	1130	+	14	P00519-1#116	0	3	P00519-1	225	228	+	3	0	0	2756
P00519-1#117	0	3	3	P00519-1	228	231	+	3	P00519-1	26	1130	P00519-2	45	1149	+	15	P00519-1#117	0	3	P00519-2	247	250	+	3	0	0	2757
P00519-1#117	0	3	3	P00519-1	228	231	+	3	P00519-1	0	1130	P00519-1	0	1130	+	14	P00519-1#117	0	3	P00519-1	228	231	+	3	0	0	2758
P00519-1#118	0	3	3	P00519-1	232	235	+	3	P00519-1	26	1130	P00519-2	45	1149	+	15	P00519-1#118	0	3	P00519-2	251	254	+	3	0	0	2759
P00519-1#118	0	3	3	P00519-1	232	235	+	3	P00519-1	0	1130	P00519-1	0	1130	+	14	P00519-1#118	0	3	P00519-1	232	235	+	3	0	0	2760
P00519-1#119	0	3	3	P00519-1	238	241	+	3	P00519-1	26	1130	P00519-2	45	1149	+	15	P00519-1#119	0	3	P00519-2	257	260	+	3	0	0	2761
P00519-1#119	0	3	3	P00519-1	238	241	+	3	P00519-1	0	1130	P00519-1	0	1130	+	14	P00519-1#119	0	3	P00519-1	238	241	+	3	0	0	2762
P00519-1#120	0	6	6	P00519-1	241	247	+	6	P00519-1	26	1130	P00519-2	45	1149	+	15	P00519-1#120	0	6	P00519-2	260	266	+	6	0	0	2763
P00519-1#120	0	6	6	P00519-1	241	247	+	6	P00519-1	0	1130	P00519-1	0	1130	+	14	P00519-1#120	0	6	P00519-1	241	247	+	6	0	0	2764
P00519-1#121	0	4	4	P00519-1	247	251	+	4	P00519-1	26	1130	P00519-2	45	1149	+	15	P00519-1#121	0	4	P00519-2	266	270	+	4	0	0	2765
P00519-1#121	0	4	4	P00519-1	247	251	+	4	P00519-1	0	1130	P00519-1	0	1130	+	14	P00519-1#121	0	4	P00519-1	247	251	+	4	0	0	2766
P00519-1#122	0	8	8	P00519-1	253	261	+	8	P00519-1	26	1130	P00519-2	45	1149	+	15	P00519-1#122	0	8	P00519-2	272	280	+	8	0	0	2767
P00519-1#122	0	8	8	P00519-1	253	261	+	8	P00519-1	0	1130	P00519-1	0	1130	+	14	P00519-1#122	0	8	P00519-1	253	261	+	8	0	0	2768
P00519-1#123	0	3	3	P00519-1	261	264	+	3	P00519-1	26	1130	P00519-2	45	1149	+	15	P00519-1#123	0	3	P00519-2	280	283	+	3	0	0	2769
P00519-1#123	0	3	3	P00519-1	261	264	+	3	P00519-1	0	1130	P00519-1	0	1130	+	14	P00519-1#123	0	3	P00519-1	261	264	+	3	0	0	2770
P00519-1#124	0	6	6	P00519-1	265	271	+	6	P00519-1	26	1130	P00519-2	45	1149	+	15	P00519-1#124	0	6	P00519-2	284	290	+	6	0	0	2771
P00519-1#124	0	6	6	P00519-1	265	271	+	6	P00519-1	0	1130	P00519-1	0	1130	+	14	P00519-1#124	0	6	P00519-1	265	271	+	6	0	0	2772
P00519-1#125	0	3	3	P00519-1	274	277	+	3	P00519-1	26	1130	P00519-2	45	1149	+	15	P00519-1#125	0	3	P00519-2	293	296	+	3	0	0	2773
P00519-1#125	0	3	3	P00519-1	274	277	+	3	P00519-1	0	1130	P00519-1	0	1130	+	14	P00519-1#125	0	3	P00519-1	274	277	+	3	0	0	2774
P00519-1#126	0	11	11	P00519-1	279	290	+	11	P00519-1	26	1130	P00519-2	45	1149	+	15	P00519-1#126	0	11	P00519-2	298	309	+	11	0	0	2775
P00519-1#126	0	11	11	P00519-1	279	290	+	11	P00519-1	0	1130	P00519-1	0	1130	+	14	P00519-1#126	0	11	P00519-1	279	290	+	11	0	0	2776
P00519-1#127	0	5	5	P00519-1	300	305	+	5	P00519-1	26	1130	P00519-2	45	1149	+	15	P00519-1#127	0	5	P00519-2	319	324	+	5	0	0	2777
P00519-1#127	0	5	5	P00519-1	300	305	+	5	P00519-1	0	1130	P00519-1	0	1130	+	14	P00519-1#127	0	5	P00519-1	300	305	+	5	0	0	2778
P00519-1#128	0	4	4	P00519-1	306	310	+	4	P00519-1	26	1130	P00519-2	45	1149	+	15	P00519-1#128	0	4	P00519-2	325	329	+	4	0	0	2779
P00519-1#128	0	4	4	P00519-1	306	310	+	4	P00519-1	0	1130	P00519-1	0	1130	+	14	P00519-1#128	0	4	P00519-1	306	310	+	4	0	0	2780
P00519-1#129	0	5	5	P00519-1	311	316	+	5	P00519-1	26	1130	P00519-2	45	1149	+	15	P00519-1#129	0	5	P00519-2	330	335	+	5	0	0	2781
P00519-1#129	0	5	5	P00519-1	311	316	+	5	P00519-1	0	1130	P00519-1	0	1130	+	14	P00519-1#129	0	5	P00519-1	311	316	+	5	0	0	2782
P00519-1#130	0	4	4	P00519-1	318	322	+	4	P00519-1	26	1130	P00519-2	45	1149	+	15	P00519-1#130	0	4	P00519-2	337	341	+	4	0	0	2783
P00519-1#130	0	4	4	P00519-1	318	322	+	4	P00519-1	0	1130	P00519-1	0	1130	+	14	P00519-1#130	0	4	P00519-1	318	322	+	4	0	0	2784
P00519-1#131	0	7	7	P00519-1	322	329	+	7	P00519-1	26	1130	P00519-2	45	1149	+	15	P00519-1#131	0	7	P00519-2	341	348	+	7	0	0	2785
P00519-1#131	0	7	7	P00519-1	322	329	+	7	P00519-1	0	1130	P00519-1	0	1130	+	14	P00519-1#131	0	7	P00519-1	322	329	+	7	0	0	2786
P00519-1#132	0	3	3	P00519-1	331	334	+	3	P00519-1	26	1130	P00519-2	45	1149	+	15	P00519-1#132	0	3	P00519-2	350	353	+	3	0	0	2787
P00519-1#132	0	3	3	P00519-1	331	334	+	3	P00519-1	0	1130	P00519-1	0	1130	+	14	P00519-1#132	0	3	P00519-1	331	334	+	3	0	0	2788
P00519-1#133	0	20	20	P00519-1	336	356	+	20	P00519-1	26	1130	P00519-2	45	1149	+	15	P00519-1#133	0	20	P00519-2	355	375	+	20	0	0	2789
P00519-1#133	0	20	20	P00519-1	336	356	+	20	P00519-1	0	1130	P00519-1	0	1130	+	14	P00519-1#133	0	20	P00519-1	336	356	+	20	0	0	2790
P00519-1#134	0	3	3	P00519-1	358	361	+	3	P00519-1	26	1130	P00519-2	45	1149	+	15	P00519-1#134	0	3	P00519-2	377	380	+	3	0	0	2791
P00519-1#134	0	3	3	P00519-1	358	361	+	3	P00519-1	0	1130	P00519-1	0	1130	+	14	P00519-1#134	0	3	P00519-1	358	361	+	3	0	0	2792
P00519-1#135	0	3	3	P00519-1	365	368	+	3	P00519-1	26	1130	P00519-2	45	1149	+	15	P00519-1#135	0	3	P00519-2	384	387	+	3	0	0	2793
P00519-1#135	0	3	3	P00519-1	365	368	+	3	P00519-1	0	1130	P00519-1	0	1130	+	14	P00519-1#135	0	3	P00519-1	365	368	+	3	0	0	2794
P00519-1#136	0	3	3	P00519-1	368	371	+	3	P00519-1	26	1130	P00519-2	45	1149	+	15	P00519-1#136	0	3	P00519-2	387	390	+	3	0	0	2795
P00519-1#136	0	3	3	P00519-1	368	371	+	3	P00519-1	0	1130	P00519-1	0	1130	+	14	P00519-1#136	0	3	P00519-1	368	371	+	3	0	0	2796
P00519-1#137	0	3	3	P00519-1	372	375	+	3	P00519-1	26	1130	P00519-2	45	1149	+	15	P00519-1#137	0	3	P00519-2	391	394	+	3	0	0	2797
P00519-1#137	0	3	3	P00519-1	372	375	+	3	P00519-1	0	1130	P00519-1	0	1130	+	14	P00519-1#137	0	3	P00519-1	372	375	+	3	0	0	2798
P00519-1#138	0	3	3	P00519-1	376	379	+	3	P00519-1	26	1130	P00519-2	45	1149	+	15	P00519-1#138	0	3	P00519-2	395	398	+	3	0	0	2799
P00519-1#138	0	3	3	P00519-1	376	379	+	3	P00519-1	0	1130	P00519-1	0	1130	+	14	P00519-1#138	0	3	P00519-1	376	379	+	3	0	0	2800
P00519-1#139	0	3	3	P00519-1	380	383	+	3	P00519-1	26	1130	P00519-2	45	1149	+	15	P00519-1#139	0	3	P00519-2	399	402	+	3	0	0	2801
P00519-1#139	0	3	3	P00519-1	380	383	+	3	P00519-1	0	1130	P00519-1	0	1130	+	14	P00519-1#139	0	3	P00519-1	380	383	+	3	0	0	2802
P00519-1#140	0	4	4	P00519-1	383	387	+	4	P00519-1	26	1130	P00519-2	45	1149	+	15	P00519-1#140	0	4	P00519-2	402	406	+	4	0	0	2803
P00519-1#140	0	4	4	P00519-1	383	387	+	4	P00519-1	0	1130	P00519-1	0	1130	+	14	P00519-1#140	0	4	P00519-1	383	387	+	4	0	0	2804
P00519-1#141	0	3	3	P00519-1	389	392	+	3	P00519-1	26	1130	P00519-2	45	1149	+	15	P00519-1#141	0	3	P00519-2	408	411	+	3	0	0	2805
P00519-1#141	0	3	3	P00519-1	389	392	+	3	P00519-1	0	1130	P00519-1	0	1130	+	14	P00519-1#141	0	3	P00519-1	389	392	+	3	0	0	2806
P00519-1#142	0	4	4	P00519-1	392	396	+	4	P00519-1	26	1130	P00519-2	45	1149	+	15	P00519-1#142	0	4	P00519-2	411	415	+	4	0	0	2807
P00519-1#142	0	4	4	P00519-1	392	396	+	4	P00519-1	0	1130	P00519-1	0	1130	+	14	P00519-1#142	0	4	P00519-1	392	396	+	4	0	0	2808
P00519-1#143	0	3	3	P00519-1	398	401	+	3	P00519-1	26	1130	P00519-2	45	1149	+	15	P00519-1#143	0	3	P00519-2	417	420	+	3	0	0	2809
P00519-1#143	0	3	3	P00519-1	398	401	+	3	P00519-1	0	1130	P00519-1	0	1130	+	14	P00519-1#143	0	3	P00519-1	398	401	+	3	0	0	2810
P00519-1#144	0	3	3	P00519-1	402	405	+	3	P00519-1	26	1130	P00519-2	45	1149	+	15	P00519-1#144	0	3	P00519-2	421	424	+	3	0	0	2811
P00519-1#144	0	3	3	P00519-1	402	405	+	3	P00519-1	0	1130	P00519-1	0	1130	+	14	P00519-1#144	0	3	P00519-1	402	405	+	3	0	0	2812
P00519-1#145	0	6	6	P00519-1	407	413	+	6	P00519-1	26	1130	P00519-2	45	1149	+	15	P00519-1#145	0	6	P00519-2	426	432	+	6	0	0	2813
P00519-1#145	0	6	6	P00519-1	407	413	+	6	P00519-1	0	1130	P00519-1	0	1130	+	14	P00519-1#145	0	6	P00519-1	407	413	+	6	0	0	2814
P00519-1#146	0	16	16	P00519-1	417	433	+	16	P00519-1	26	1130	P00519-2	45	1149	+	15	P00519-1#146	0	16	P00519-2	436	452	+	16	0	0	2815
P00519-1#146	0	16	16	P00519-1	417	433	+	16	P00519-1	0	1130	P00519-1	0	1130	+	14	P00519-1#146	0	16	P00519-1	417	433	+	16	0	0	2816
P00519-1#147	0	3	3	P00519-1	444	447	+	3	P00519-1	26	1130	P00519-2	45	1149	+	15	P00519-1#147	0	3	P00519-2	463	466	+	3	0	0	2817
P00519-1#147	0	3	3	P00519-1	444	447	+	3	P00519-1	0	1130	P00519-1	0	1130	+	14	P00519-1#147	0	3	P00519-1	444	447	+	3	0	0	2818
P00519-1#148	0	6	6	P00519-1	447	453	+	6	P00519-1	26	1130	P00519-2	45	1149	+	15	P00519-1#148	0	6	P00519-2	466	472	+	6	0	0	2819
P00519-1#148	0	6	6	P00519-1	447	453	+	6	P00519-1	0	1130	P00519-1	0	1130	+	14	P00519-1#148	0	6	P00519-1	447	453	+	6	0	0	2820
P00519-1#149	0	10	10	P00519-1	465	475	+	10	P00519-1	26	1130	P00519-2	45	1149	+	15	P00519-1#149	0	10	P00519-2	484	494	+	10	0	0	2821
P00519-1#149	0	10	10	P00519-1	465	475	+	10	P00519-1	0	1130	P00519-1	0	1130	+	14	P00519-1#149	0	10	P00519-1	465	475	+	10	0	0	2822
P00519-1#150	0	3	3	P00519-1	479	482	+	3	P00519-1	26	1130	P00519-2	45	1149	+	15	P00519-1#150	0	3	P00519-2	498	501	+	3	0	0	2823
P00519-1#150	0	3	3	P00519-1	479	482	+	3	P00519-1	0	1130	P00519-1	0	1130	+	14	P00519-1#150	0	3	P00519-1	479	482	+	3	0	0	2824
P00519-1#151	0	11	11	P00519-1	485	496	+	11	P00519-1	26	1130	P00519-2	45	1149	+	15	P00519-1#151	0	11	P00519-2	504	515	+	11	0	0	2825
P00519-1#151	0	11	11	P00519-1	485	496	+	11	P00519-1	0	1130	P00519-1	0	1130	+	14	P00519-1#151	0	11	P00519-1	485	496	+	11	0	0	2826
P00519-1#152	0	3	3	P00519-1	497	500	+	3	P00519-1	26	1130	P00519-2	45	1149	+	15	P00519-1#152	0	3	P00519-2	516	519	+	3	0	0	2827
P00519-1#152	0	3	3	P00519-1	497	500	+	3	P00519-1	0	1130	P00519-1	0	1130	+	14	P00519-1#152	0	3	P00519-1	497	500	+	3	0	0	2828
P00519-1#153	0	4	4	P00519-1	502	506	+	4	P00519-1	26	1130	P00519-2	45	1149	+	15	P00519-1#153	0	4	P00519-2	521	525	+	4	0	0	2829
P00519-1#153	0	4	4	P00519-1	502	506	+	4	P00519-1	0	1130	P00519-1	0	1130	+	14	P00519-1#153	0	4	P00519-1	502	506	+	4	0	0	2830
P00519-1#154	0	3	3	P00519-1	509	512	+	3	P00519-1	26	1130	P00519-2	45	1149	+	15	P00519-1#154	0	3	P00519-2	528	531	+	3	0	0	2831
P00519-1#154	0	3	3	P00519-1	509	512	+	3	P00519-1	0	1130	P00519-1	0	1130	+	14	P00519-1#154	0	3	P00519-1	509	512	+	3	0	0	2832
P00519-1#155	0	17	17	P00519-1	1028	1045	+	17	P00519-1	26	1130	P00519-2	45	1149	+	15	P00519-1#155	0	17	P00519-2	1047	1064	+	17	0	0	2833
P00519-1#155	0	17	17	P00519-1	1028	1045	+	17	P00519-1	0	1130	P00519-1	0	1130	+	14	P00519-1#155	0	17	P00519-1	1028	1045	+	17	0	0	2834
P00519-1#156	0	3	3	P00519-1	1045	1048	+	3	P00519-1	26	1130	P00519-2	45	1149	+	15	P00519-1#156	0	3	P00519-2	1064	1067	+	3	0	0	2835
P00519-1#156	0	3	3	P00519-1	1045	1048	+	3	P00519-1	0	1130	P00519-1	0	1130	+	14	P00519-1#156	0	3	P00519-1	1045	1048	+	3	0	0	2836
P00519-1#157	0	18	18	P00519-1	1052	1070	+	18	P00519-1	26	1130	P00519-2	45	1149	+	15	P00519-1#157	0	18	P00519-2	1071	1089	+	18	0	0	2837
P00519-1#157	0	18	18	P00519-1	1052	1070	+	18	P00519-1	0	1130	P00519-1	0	1130	+	14	P00519-1#157	0	18	P00519-1	1052	1070	+	18	0	0	2838
P00519-1#158	0	3	3	P00519-1	1070	1073	+	3	P00519-1	26	1130	P00519-2	45	1149	+	15	P00519-1#158	0	3	P00519-2	1089	1092	+	3	0	0	2839
P00519-1#158	0	3	3	P00519-1	1070	1073	+	3	P00519-1	0	1130	P00519-1	0	1130	+	14	P00519-1#158	0	3	P00519-1	1070	1073	+	3	0	0	2840
P00519-1#159	0	18	18	P00519-1	1079	1097	+	18	P00519-1	26	1130	P00519-2	45	1149	+	15	P00519-1#159	0	18	P00519-2	1098	1116	+	18	0	0	2841
P00519-1#159	0	18	18	P00519-1	1079	1097	+	18	P00519-1	0	1130	P00519-1	0	1130	+	14	P00519-1#159	0	18	P00519-1	1079	1097	+	18	0	0	2842
P00519-1#160	0	4	4	P00519-1	1100	1104	+	4	P00519-1	26	1130	P00519-2	45	1149	+	15	P00519-1#160	0	4	P00519-2	1119	1123	+	4	0	0	2843
P00519-1#160	0	4	4	P00519-1	1100	1104	+	4	P00519-1	0	1130	P00519-1	0	1130	+	14	P00519-1#160	0	4	P00519-1	1100	1104	+	4	0	0	2844
P00519-1#161	0	3	3	P00519-1	1105	1108	+	3	P00519-1	26	1130	P00519-2	45	1149	+	15	P00519-1#161	0	3	P00519-2	1124	1127	+	3	0	0	2845
P00519-1#161	0	3	3	P00519-1	1105	1108	+	3	P00519-1	0	1130	P00519-1	0	1130	+	14	P00519-1#161	0	3	P00519-1	1105	1108	+	3	0	0	2846
P00519-1#162	0	14	14	P00519-1	1114	1128	+	14	P00519-1	26	1130	P00519-2	45	1149	+	15	P00519-1#162	0	14	P00519-2	1133	1147	+	14	0	0	2847
P00519-1#162	0	14	14	P00519-1	1114	1128	+	14	P00519-1	0	1130	P00519-1	0	1130	+	14	P00519-1#162	0	14	P00519-1	1114	1128	+	14	0	0	2848
P00519-1#163	0	1	1	P00519-1	1	2	+	1	P00519-1	0	1130	P00519-1	0	1130	+	14	P00519-1#163	0	1	P00519-1	1	2	+	1	0	0	2849
P42684-1#0	0	1	1	P42684-1	0	1	+	1	P42684-1	0	550	P42684-8	0	529	+	40	P42684-1#0	0	1	P42684-8	0	1	+	1	0	0	2850
P42684-1#0	0	1	1	P42684-1	0	1	+	1	P42684-1	0	1182	P42684-7	0	1058	+	39	P42684-1#0	0	1	P42684-7	0	1	+	1	0	0	2851
P42684-1#0	0	1	1	P42684-1	0	1	+	1	P42684-1	0	1182	P42684-6	0	1161	+	38	P42684-1#0	0	1	P42684-6	0	1	+	1	0	0	2852
P42684-1#0	0	1	1	P42684-1	0	1	+	1	P42684-1	0	1182	P42684-5	0	1079	+	37	P42684-1#0	0	1	P42684-5	0	1	+	1	0	0	2853
P42684-1#0	0	1	1	P42684-1	0	1	+	1	P42684-1	0	1182	P42684-1	0	1182	+	32	P42684-1#0	0	1	P42684-1	0	1	+	1	0	0	2854
P42684-1#1	0	1181	1181	P42684-1	1	1182	+	1181	P42684-1	0	550	P42684-8	0	529	+	40	P42684-1#1	0	549	P42684-8	1	529	+	528	0	632	2855
P42684-1#1	0	1181	1181	P42684-1	1	1182	+	1181	P42684-1	0	1182	P42684-7	0	1058	+	39	P42684-1#1	0	1181	P42684-7	1	1058	+	1057	0	0	2856
P42684-1#1	0	1181	1181	P42684-1	1	1182	+	1181	P42684-1	0	1182	P42684-6	0	1161	+	38	P42684-1#1	0	1181	P42684-6	1	1161	+	1160	0	0	2857
P42684-1#1	0	1181	1181	P42684-1	1	1182	+	1181	P42684-1	0	1182	P42684-5	0	1079	+	37	P42684-1#1	0	1181	P42684-5	1	1079	+	1078	0	0	2858
P42684-1#1	0	1181	1181	P42684-1	1	1182	+	1181	P42684-1	73	1182	P42684-4	37	1043	+	36	P42684-1#1	72	1181	P42684-4	37	1043	+	1006	72	0	2859
P42684-1#1	0	1181	1181	P42684-1	1	1182	+	1181	P42684-1	52	1182	P42684-3	37	1167	+	35	P42684-1#1	51	1181	P42684-3	37	1167	+	1130	51	0	2860
P42684-1#1	0	1181	1181	P42684-1	1	1182	+	1181	P42684-1	73	1182	P42684-2	37	1146	+	34	P42684-1#1	72	1181	P42684-2	37	1146	+	1109	72	0	2861
P42684-1#1	0	1181	1181	P42684-1	1	1182	+	1181	P42684-1	52	1182	P42684-10	37	1064	+	33	P42684-1#1	51	1181	P42684-10	37	1064	+	1027	51	0	2862
P42684-1#1	0	1181	1181	P42684-1	1	1182	+	1181	P42684-1	0	1182	P42684-1	0	1182	+	32	P42684-1#1	0	1181	P42684-1	1	1182	+	1181	0	0	2863
P42684-1#2	0	61	61	P42684-1	106	167	+	61	P42684-1	0	550	P42684-8	0	529	+	40	P42684-1#2	0	61	P42684-8	85	146	+	61	0	0	2864
P42684-1#2	0	61	61	P42684-1	106	167	+	61	P42684-1	0	1182	P42684-7	0	1058	+	39	P42684-1#2	0	61	P42684-7	85	146	+	61	0	0	2865
P42684-1#2	0	61	61	P42684-1	106	167	+	61	P42684-1	0	1182	P42684-6	0	1161	+	38	P42684-1#2	0	61	P42684-6	85	146	+	61	0	0	2866
P42684-1#2	0	61	61	P42684-1	106	167	+	61	P42684-1	0	1182	P42684-5	0	1079	+	37	P42684-1#2	0	61	P42684-5	106	167	+	61	0	0	2867
P42684-1#2	0	61	61	P42684-1	106	167	+	61	P42684-1	73	1182	P42684-4	37	1043	+	36	P42684-1#2	0	61	P42684-4	70	131	+	61	0	0	2868
P42684-1#2	0	61	61	P42684-1	106	167	+	61	P42684-1	52	1182	P42684-3	37	1167	+	35	P42684-1#2	0	61	P42684-3	91	152	+	61	0	0	2869
P42684-1#2	0	61	61	P42684-1	106	167	+	61	P42684-1	73	1182	P42684-2	37	1146	+	34	P42684-1#2	0	61	P42684-2	70	131	+	61	0	0	2870
P42684-1#2	0	61	61	P42684-1	106	167	+	61	P42684-1	52	1182	P42684-10	37	1064	+	33	P42684-1#2	0	61	P42684-10	91	152	+	61	0	0	2871
P42684-1#2	0	61	61	P42684-1	106	167	+	61	P42684-1	0	1182	P42684-1	0	1182	+	32	P42684-1#2	0	61	P42684-1	106	167	+	61	0	0	2872
P42684-1#3	0	91	91	P42684-1	172	263	+	91	P42684-1	0	550	P42684-8	0	529	+	40	P42684-1#3	0	91	P42684-8	151	242	+	91	0	0	2873
P42684-1#3	0	91	91	P42684-1	172	263	+	91	P42684-1	0	1182	P42684-7	0	1058	+	39	P42684-1#3	0	91	P42684-7	151	242	+	91	0	0	2874
P42684-1#3	0	91	91	P42684-1	172	263	+	91	P42684-1	0	1182	P42684-6	0	1161	+	38	P42684-1#3	0	91	P42684-6	151	242	+	91	0	0	2875
P42684-1#3	0	91	91	P42684-1	172	263	+	91	P42684-1	0	1182	P42684-5	0	1079	+	37	P42684-1#3	0	91	P42684-5	172	263	+	91	0	0	2876
P42684-1#3	0	91	91	P42684-1	172	263	+	91	P42684-1	73	1182	P42684-4	37	1043	+	36	P42684-1#3	0	91	P42684-4	136	227	+	91	0	0	2877
P42684-1#3	0	91	91	P42684-1	172	263	+	91	P42684-1	52	1182	P42684-3	37	1167	+	35	P42684-1#3	0	91	P42684-3	157	248	+	91	0	0	2878
P42684-1#3	0	91	91	P42684-1	172	263	+	91	P42684-1	73	1182	P42684-2	37	1146	+	34	P42684-1#3	0	91	P42684-2	136	227	+	91	0	0	2879
P42684-1#3	0	91	91	P42684-1	172	263	+	91	P42684-1	52	1182	P42684-10	37	1064	+	33	P42684-1#3	0	91	P42684-10	157	248	+	91	0	0	2880
P42684-1#3	0	91	91	P42684-1	172	263	+	91	P42684-1	0	1182	P42684-1	0	1182	+	32	P42684-1#3	0	91	P42684-1	172	263	+	91	0	0	2881
P42684-1#4	0	252	252	P42684-1	287	539	+	252	P42684-1	0	550	P42684-8	0	529	+	40	P42684-1#4	0	252	P42684-8	266	518	+	252	0	0	2882
P42684-1#4	0	252	252	P42684-1	287	539	+	252	P42684-1	0	1182	P42684-7	0	1058	+	39	P42684-1#4	0	252	P42684-7	266	518	+	252	0	0	2883
P42684-1#4	0	252	252	P42684-1	287	539	+	252	P42684-1	0	1182	P42684-6	0	1161	+	38	P42684-1#4	0	252	P42684-6	266	518	+	252	0	0	2884
P42684-1#4	0	252	252	P42684-1	287	539	+	252	P42684-1	0	1182	P42684-5	0	1079	+	37	P42684-1#4	0	252	P42684-5	287	539	+	252	0	0	2885
P42684-1#4	0	252	252	P42684-1	287	539	+	252	P42684-1	73	1182	P42684-4	37	1043	+	36	P42684-1#4	0	252	P42684-4	251	503	+	252	0	0	2886
P42684-1#4	0	252	252	P42684-1	287	539	+	252	P42684-1	52	1182	P42684-3	37	1167	+	35	P42684-1#4	0	252	P42684-3	272	524	+	252	0	0	2887
P42684-1#4	0	252	252	P42684-1	287	539	+	252	P42684-1	73	1182	P42684-2	37	1146	+	34	P42684-1#4	0	252	P42684-2	251	503	+	252	0	0	2888
P42684-1#4	0	252	252	P42684-1	287	539	+	252	P42684-1	52	1182	P42684-10	37	1064	+	33	P42684-1#4	0	252	P42684-10	272	524	+	252	0	0	2889
P42684-1#4	0	252	252	P42684-1	287	539	+	252	P42684-1	0	1182	P42684-1	0	1182	+	32	P42684-1#4	0	252	P42684-1	287	539	+	252	0	0	2890
P42684-1#5	0	47	47	P42684-1	0	47	+	47	P42684-1	0	550	P42684-8	0	529	+	40	P42684-1#5	0	47	P42684-8	0	47	+	47	0	0	2891
P42684-1#5	0	47	47	P42684-1	0	47	+	47	P42684-1	0	1182	P42684-7	0	1058	+	39	P42684-1#5	0	47	P42684-7	0	47	+	47	0	0	2892
P42684-1#5	0	47	47	P42684-1	0	47	+	47	P42684-1	0	1182	P42684-6	0	1161	+	38	P42684-1#5	0	47	P42684-6	0	47	+	47	0	0	2893
P42684-1#5	0	47	47	P42684-1	0	47	+	47	P42684-1	0	1182	P42684-5	0	1079	+	37	P42684-1#5	0	47	P42684-5	0	47	+	47	0	0	2894
P42684-1#5	0	47	47	P42684-1	0	47	+	47	P42684-1	0	1182	P42684-1	0	1182	+	32	P42684-1#5	0	47	P42684-1	0	47	+	47	0	0	2895
P42684-1#6	0	105	105	P42684-1	1	106	+	105	P42684-1	0	550	P42684-8	0	529	+	40	P42684-1#6	0	105	P42684-8	1	85	+	84	0	0	2896
P42684-1#6	0	105	105	P42684-1	1	106	+	105	P42684-1	0	1182	P42684-7	0	1058	+	39	P42684-1#6	0	105	P42684-7	1	85	+	84	0	0	2897
P42684-1#6	0	105	105	P42684-1	1	106	+	105	P42684-1	0	1182	P42684-6	0	1161	+	38	P42684-1#6	0	105	P42684-6	1	85	+	84	0	0	2898
P42684-1#6	0	105	105	P42684-1	1	106	+	105	P42684-1	0	1182	P42684-5	0	1079	+	37	P42684-1#6	0	105	P42684-5	1	106	+	105	0	0	2899
P42684-1#6	0	105	105	P42684-1	1	106	+	105	P42684-1	73	1182	P42684-4	37	1043	+	36	P42684-1#6	72	105	P42684-4	37	70	+	33	72	0	2900
P42684-1#6	0	105	105	P42684-1	1	106	+	105	P42684-1	52	1182	P42684-3	37	1167	+	35	P42684-1#6	51	105	P42684-3	37	91	+	54	51	0	2901
P42684-1#6	0	105	105	P42684-1	1	106	+	105	P42684-1	73	1182	P42684-2	37	1146	+	34	P42684-1#6	72	105	P42684-2	37	70	+	33	72	0	2902
P42684-1#6	0	105	105	P42684-1	1	106	+	105	P42684-1	52	1182	P42684-10	37	1064	+	33	P42684-1#6	51	105	P42684-10	37	91	+	54	51	0	2903
P42684-1#6	0	105	105	P42684-1	1	106	+	105	P42684-1	0	1182	P42684-1	0	1182	+	32	P42684-1#6	0	105	P42684-1	1	106	+	105	0	0	2904
P42684-1#7	0	21	21	P42684-1	59	80	+	21	P42684-1	0	550	P42684-8	0	529	+	40	P42684-1#7	14	21	P42684-8	52	59	+	7	14	0	2905
P42684-1#7	0	21	21	P42684-1	59	80	+	21	P42684-1	0	1182	P42684-7	0	1058	+	39	P42684-1#7	14	21	P42684-7	52	59	+	7	14	0	2906
P42684-1#7	0	21	21	P42684-1	59	80	+	21	P42684-1	0	1182	P42684-6	0	1161	+	38	P42684-1#7	14	21	P42684-6	52	59	+	7	14	0	2907
P42684-1#7	0	21	21	P42684-1	59	80	+	21	P42684-1	0	1182	P42684-5	0	1079	+	37	P42684-1#7	0	21	P42684-5	59	80	+	21	0	0	2908
P42684-1#7	0	21	21	P42684-1	59	80	+	21	P42684-1	73	1182	P42684-4	37	1043	+	36	P42684-1#7	14	21	P42684-4	37	44	+	7	14	0	2909
P42684-1#7	0	21	21	P42684-1	59	80	+	21	P42684-1	52	1182	P42684-3	37	1167	+	35	P42684-1#7	0	21	P42684-3	44	65	+	21	0	0	2910
P42684-1#7	0	21	21	P42684-1	59	80	+	21	P42684-1	73	1182	P42684-2	37	1146	+	34	P42684-1#7	14	21	P42684-2	37	44	+	7	14	0	2911
P42684-1#7	0	21	21	P42684-1	59	80	+	21	P42684-1	52	1182	P42684-10	37	1064	+	33	P42684-1#7	0	21	P42684-10	44	65	+	21	0	0	2912
P42684-1#7	0	21	21	P42684-1	59	80	+	21	P42684-1	0	1182	P42684-1	0	1182	+	32	P42684-1#7	0	21	P42684-1	59	80	+	21	0	0	2913
P42684-1#8	0	31	31	P42684-1	610	641	+	31	P42684-1	0	1182	P42684-7	0	1058	+	39	P42684-1#8	0	31	P42684-7	589	620	+	31	0	0	2914
P42684-1#8	0	31	31	P42684-1	610	641	+	31	P42684-1	0	1182	P42684-6	0	1161	+	38	P42684-1#8	0	31	P42684-6	589	620	+	31	0	0	2915
P42684-1#8	0	31	31	P42684-1	610	641	+	31	P42684-1	0	1182	P42684-5	0	1079	+	37	P42684-1#8	0	31	P42684-5	610	641	+	31	0	0	2916
P42684-1#8	0	31	31	P42684-1	610	641	+	31	P42684-1	73	1182	P42684-4	37	1043	+	36	P42684-1#8	0	31	P42684-4	574	605	+	31	0	0	2917
P42684-1#8	0	31	31	P42684-1	610	641	+	31	P42684-1	52	1182	P42684-3	37	1167	+	35	P42684-1#8	0	31	P42684-3	595	626	+	31	0	0	2918
P42684-1#8	0	31	31	P42684-1	610	641	+	31	P42684-1	73	1182	P42684-2	37	1146	+	34	P42684-1#8	0	31	P42684-2	574	605	+	31	0	0	2919
P42684-1#8	0	31	31	P42684-1	610	641	+	31	P42684-1	52	1182	P42684-10	37	1064	+	33	P42684-1#8	0	31	P42684-10	595	626	+	31	0	0	2920
P42684-1#8	0	31	31	P42684-1	610	641	+	31	P42684-1	0	1182	P42684-1	0	1182	+	32	P42684-1#8	0	31	P42684-1	610	641	+	31	0	0	2921
P42684-1#9	0	21	21	P42684-1	653	674	+	21	P42684-1	0	1182	P42684-7	0	1058	+	39	P42684-1#9	0	21	P42684-7	632	653	+	21	0	0	2922
P42684-1#9	0	21	21	P42684-1	653	674	+	21	P42684-1	0	1182	P42684-6	0	1161	+	38	P42684-1#9	0	21	P42684-6	632	653	+	21	0	0	2923
P42684-1#9	0	21	21	P42684-1	653	674	+	21	P42684-1	0	1182	P42684-5	0	1079	+	37	P42684-1#9	0	21	P42684-5	653	674	+	21	0	0	2924
P42684-1#9	0	21	21	P42684-1	653	674	+	21	P42684-1	73	1182	P42684-4	37	1043	+	36	P42684-1#9	0	21	P42684-4	617	638	+	21	0	0	2925
P42684-1#9	0	21	21	P42684-1	653	674	+	21	P42684-1	52	1182	P42684-3	37	1167	+	35	P42684-1#9	0	21	P42684-3	638	659	+	21	0	0	2926
P42684-1#9	0	21	21	P42684-1	653	674	+	21	P42684-1	73	1182	P42684-2	37	1146	+	34	P42684-1#9	0	21	P42684-2	617	638	+	21	0	0	2927
P42684-1#9	0	21	21	P42684-1	653	674	+	21	P42684-1	52	1182	P42684-10	37	1064	+	33	P42684-1#9	0	21	P42684-10	638	659	+	21	0	0	2928
P42684-1#9	0	21	21	P42684-1	653	674	+	21	P42684-1	0	1182	P42684-1	0	1182	+	32	P42684-1#9	0	21	P42684-1	653	674	+	21	0	0	2929
P42684-1#10	0	237	237	P42684-1	693	930	+	237	P42684-1	0	1182	P42684-7	0	1058	+	39	P42684-1#10	96	237	P42684-7	665	806	+	141	96	0	2930
P42684-1#10	0	237	237	P42684-1	693	930	+	237	P42684-1	0	1182	P42684-6	0	1161	+	38	P42684-1#10	0	237	P42684-6	672	909	+	237	0	0	2931
P42684-1#10	0	237	237	P42684-1	693	930	+	237	P42684-1	0	1182	P42684-5	0	1079	+	37	P42684-1#10	96	237	P42684-5	686	827	+	141	96	0	2932
P42684-1#10	0	237	237	P42684-1	693	930	+	237	P42684-1	73	1182	P42684-4	37	1043	+	36	P42684-1#10	96	237	P42684-4	650	791	+	141	96	0	2933
P42684-1#10	0	237	237	P42684-1	693	930	+	237	P42684-1	52	1182	P42684-3	37	1167	+	35	P42684-1#10	0	237	P42684-3	678	915	+	237	0	0	2934
P42684-1#10	0	237	237	P42684-1	693	930	+	237	P42684-1	73	1182	P42684-2	37	1146	+	34	P42684-1#10	0	237	P42684-2	657	894	+	237	0	0	2935
P42684-1#10	0	237	237	P42684-1	693	930	+	237	P42684-1	52	1182	P42684-10	37	1064	+	33	P42684-1#10	96	237	P42684-10	671	812	+	141	96	0	2936
P42684-1#10	0	237	237	P42684-1	693	930	+	237	P42684-1	0	1182	P42684-1	0	1182	+	32	P42684-1#10	0	237	P42684-1	693	930	+	237	0	0	2937
P42684-1#11	0	32	32	P42684-1	762	794	+	32	P42684-1	0	1182	P42684-7	0	1058	+	39	P42684-1#11	27	32	P42684-7	665	670	+	5	27	0	2938
P42684-1#11	0	32	32	P42684-1	762	794	+	32	P42684-1	0	1182	P42684-6	0	1161	+	38	P42684-1#11	0	32	P42684-6	741	773	+	32	0	0	2939
P42684-1#11	0	32	32	P42684-1	762	794	+	32	P42684-1	0	1182	P42684-5	0	1079	+	37	P42684-1#11	27	32	P42684-5	686	691	+	5	27	0	2940
P42684-1#11	0	32	32	P42684-1	762	794	+	32	P42684-1	73	1182	P42684-4	37	1043	+	36	P42684-1#11	27	32	P42684-4	650	655	+	5	27	0	2941
P42684-1#11	0	32	32	P42684-1	762	794	+	32	P42684-1	52	1182	P42684-3	37	1167	+	35	P42684-1#11	0	32	P42684-3	747	779	+	32	0	0	2942
P42684-1#11	0	32	32	P42684-1	762	794	+	32	P42684-1	73	1182	P42684-2	37	1146	+	34	P42684-1#11	0	32	P42684-2	726	758	+	32	0	0	2943
P42684-1#11	0	32	32	P42684-1	762	794	+	32	P42684-1	52	1182	P42684-10	37	1064	+	33	P42684-1#11	27	32	P42684-10	671	676	+	5	27	0	2944
P42684-1#11	0	32	32	P42684-1	762	794	+	32	P42684-1	0	1182	P42684-1	0	1182	+	32	P42684-1#11	0	32	P42684-1	762	794	+	32	0	0	2945
P42684-1#12	0	45	45	P42684-1	806	851	+	45	P42684-1	0	1182	P42684-7	0	1058	+	39	P42684-1#12	0	45	P42684-7	682	727	+	45	0	0	2946
P42684-1#12	0	45	45	P42684-1	806	851	+	45	P42684-1	0	1182	P42684-6	0	1161	+	38	P42684-1#12	0	45	P42684-6	785	830	+	45	0	0	2947
P42684-1#12	0	45	45	P42684-1	806	851	+	45	P42684-1	0	1182	P42684-5	0	1079	+	37	P42684-1#12	0	45	P42684-5	703	748	+	45	0	0	2948
P42684-1#12	0	45	45	P42684-1	806	851	+	45	P42684-1	73	1182	P42684-4	37	1043	+	36	P42684-1#12	0	45	P42684-4	667	712	+	45	0	0	2949
P42684-1#12	0	45	45	P42684-1	806	851	+	45	P42684-1	52	1182	P42684-3	37	1167	+	35	P42684-1#12	0	45	P42684-3	791	836	+	45	0	0	2950
P42684-1#12	0	45	45	P42684-1	806	851	+	45	P42684-1	73	1182	P42684-2	37	1146	+	34	P42684-1#12	0	45	P42684-2	770	815	+	45	0	0	2951
P42684-1#12	0	45	45	P42684-1	806	851	+	45	P42684-1	52	1182	P42684-10	37	1064	+	33	P42684-1#12	0	45	P42684-10	688	733	+	45	0	0	2952
P42684-1#12	0	45	45	P42684-1	806	851	+	45	P42684-1	0	1182	P42684-1	0	1182	+	32	P42684-1#12	0	45	P42684-1	806	851	+	45	0	0	2953
P42684-1#13	0	61	61	P42684-1	963	1024	+	61	P42684-1	0	1182	P42684-7	0	1058	+	39	P42684-1#13	0	61	P42684-7	839	900	+	61	0	0	2954
P42684-1#13	0	61	61	P42684-1	963	1024	+	61	P42684-1	0	1182	P42684-6	0	1161	+	38	P42684-1#13	0	61	P42684-6	942	1003	+	61	0	0	2955
P42684-1#13	0	61	61	P42684-1	963	1024	+	61	P42684-1	0	1182	P42684-5	0	1079	+	37	P42684-1#13	0	61	P42684-5	860	921	+	61	0	0	2956
P42684-1#13	0	61	61	P42684-1	963	1024	+	61	P42684-1	73	1182	P42684-4	37	1043	+	36	P42684-1#13	0	61	P42684-4	824	885	+	61	0	0	2957
P42684-1#13	0	61	61	P42684-1	963	1024	+	61	P42684-1	52	1182	P42684-3	37	1167	+	35	P42684-1#13	0	61	P42684-3	948	1009	+	61	0	0	2958
P42684-1#13	0	61	61	P42684-1	963	1024	+	61	P42684-1	73	1182	P42684-2	37	1146	+	34	P42684-1#13	0	61	P42684-2	927	988	+	61	0	0	2959
P42684-1#13	0	61	61	P42684-1	963	1024	+	61	P42684-1	52	1182	P42684-10	37	1064	+	33	P42684-1#13	0	61	P42684-10	845	906	+	61	0	0	2960
P42684-1#13	0	61	61	P42684-1	963	1024	+	61	P42684-1	0	1182	P42684-1	0	1182	+	32	P42684-1#13	0	61	P42684-1	963	1024	+	61	0	0	2961
P42684-1#14	0	163	163	P42684-1	1019	1182	+	163	P42684-1	0	1182	P42684-7	0	1058	+	39	P42684-1#14	0	163	P42684-7	895	1058	+	163	0	0	2962
P42684-1#14	0	163	163	P42684-1	1019	1182	+	163	P42684-1	0	1182	P42684-6	0	1161	+	38	P42684-1#14	0	163	P42684-6	998	1161	+	163	0	0	2963
P42684-1#14	0	163	163	P42684-1	1019	1182	+	163	P42684-1	0	1182	P42684-5	0	1079	+	37	P42684-1#14	0	163	P42684-5	916	1079	+	163	0	0	2964
P42684-1#14	0	163	163	P42684-1	1019	1182	+	163	P42684-1	73	1182	P42684-4	37	1043	+	36	P42684-1#14	0	163	P42684-4	880	1043	+	163	0	0	2965
P42684-1#14	0	163	163	P42684-1	1019	1182	+	163	P42684-1	52	1182	P42684-3	37	1167	+	35	P42684-1#14	0	163	P42684-3	1004	1167	+	163	0	0	2966
P42684-1#14	0	163	163	P42684-1	1019	1182	+	163	P42684-1	73	1182	P42684-2	37	1146	+	34	P42684-1#14	0	163	P42684-2	983	1146	+	163	0	0	2967
P42684-1#14	0	163	163	P42684-1	1019	1182	+	163	P42684-1	52	1182	P42684-10	37	1064	+	33	P42684-1#14	0	163	P42684-10	901	1064	+	163	0	0	2968
P42684-1#14	0	163	163	P42684-1	1019	1182	+	163	P42684-1	0	1182	P42684-1	0	1182	+	32	P42684-1#14	0	163	P42684-1	1019	1182	+	163	0	0	2969
P42684-1#15	0	25	25	P42684-1	426	451	+	25	P42684-1	0	550	P42684-8	0	529	+	40	P42684-1#15	0	25	P42684-8	405	430	+	25	0	0	2970
P42684-1#15	0	25	25	P42684-1	426	451	+	25	P42684-1	0	1182	P42684-7	0	1058	+	39	P42684-1#15	0	25	P42684-7	405	430	+	25	0	0	2971
P42684-1#15	0	25	25	P42684-1	426	451	+	25	P42684-1	0	1182	P42684-6	0	1161	+	38	P42684-1#15	0	25	P42684-6	405	430	+	25	0	0	2972
P42684-1#15	0	25	25	P42684-1	426	451	+	25	P42684-1	0	1182	P42684-5	0	1079	+	37	P42684-1#15	0	25	P42684-5	426	451	+	25	0	0	2973
P42684-1#15	0	25	25	P42684-1	426	451	+	25	P42684-1	73	1182	P42684-4	37	1043	+	36	P42684-1#15	0	25	P42684-4	390	415	+	25	0	0	2974
P42684-1#15	0	25	25	P42684-1	426	451	+	25	P42684-1	52	1182	P42684-3	37	1167	+	35	P42684-1#15	0	25	P42684-3	411	436	+	25	0	0	2975
P42684-1#15	0	25	25	P42684-1	426	451	+	25	P42684-1	73	1182	P42684-2	37	1146	+	34	P42684-1#15	0	25	P42684-2	390	415	+	25	0	0	2976
P42684-1#15	0	25	25	P42684-1	426	451	+	25	P42684-1	52	1182	P42684-10	37	1064	+	33	P42684-1#15	0	25	P42684-10	411	436	+	25	0	0	2977
P42684-1#15	0	25	25	P42684-1	426	451	+	25	P42684-1	0	1182	P42684-1	0	1182	+	32	P42684-1#15	0	25	P42684-1	426	451	+	25	0	0	2978
P42684-1#16	0	3	3	P42684-1	657	660	+	3	P42684-1	0	1182	P42684-7	0	1058	+	39	P42684-1#16	0	3	P42684-7	636	639	+	3	0	0	2979
P42684-1#16	0	3	3	P42684-1	657	660	+	3	P42684-1	0	1182	P42684-6	0	1161	+	38	P42684-1#16	0	3	P42684-6	636	639	+	3	0	0	2980
P42684-1#16	0	3	3	P42684-1	657	660	+	3	P42684-1	0	1182	P42684-5	0	1079	+	37	P42684-1#16	0	3	P42684-5	657	660	+	3	0	0	2981
P42684-1#16	0	3	3	P42684-1	657	660	+	3	P42684-1	73	1182	P42684-4	37	1043	+	36	P42684-1#16	0	3	P42684-4	621	624	+	3	0	0	2982
P42684-1#16	0	3	3	P42684-1	657	660	+	3	P42684-1	52	1182	P42684-3	37	1167	+	35	P42684-1#16	0	3	P42684-3	642	645	+	3	0	0	2983
P42684-1#16	0	3	3	P42684-1	657	660	+	3	P42684-1	73	1182	P42684-2	37	1146	+	34	P42684-1#16	0	3	P42684-2	621	624	+	3	0	0	2984
P42684-1#16	0	3	3	P42684-1	657	660	+	3	P42684-1	52	1182	P42684-10	37	1064	+	33	P42684-1#16	0	3	P42684-10	642	645	+	3	0	0	2985
P42684-1#16	0	3	3	P42684-1	657	660	+	3	P42684-1	0	1182	P42684-1	0	1182	+	32	P42684-1#16	0	3	P42684-1	657	660	+	3	0	0	2986
P42684-1#17	0	20	20	P42684-1	773	793	+	20	P42684-1	0	1182	P42684-7	0	1058	+	39	P42684-1#17	16	20	P42684-7	665	669	+	4	16	0	2987
P42684-1#17	0	20	20	P42684-1	773	793	+	20	P42684-1	0	1182	P42684-6	0	1161	+	38	P42684-1#17	0	20	P42684-6	752	772	+	20	0	0	2988
P42684-1#17	0	20	20	P42684-1	773	793	+	20	P42684-1	0	1182	P42684-5	0	1079	+	37	P42684-1#17	16	20	P42684-5	686	690	+	4	16	0	2989
P42684-1#17	0	20	20	P42684-1	773	793	+	20	P42684-1	73	1182	P42684-4	37	1043	+	36	P42684-1#17	16	20	P42684-4	650	654	+	4	16	0	2990
P42684-1#17	0	20	20	P42684-1	773	793	+	20	P42684-1	52	1182	P42684-3	37	1167	+	35	P42684-1#17	0	20	P42684-3	758	778	+	20	0	0	2991
P42684-1#17	0	20	20	P42684-1	773	793	+	20	P42684-1	73	1182	P42684-2	37	1146	+	34	P42684-1#17	0	20	P42684-2	737	757	+	20	0	0	2992
P42684-1#17	0	20	20	P42684-1	773	793	+	20	P42684-1	52	1182	P42684-10	37	1064	+	33	P42684-1#17	16	20	P42684-10	671	675	+	4	16	0	2993
P42684-1#17	0	20	20	P42684-1	773	793	+	20	P42684-1	0	1182	P42684-1	0	1182	+	32	P42684-1#17	0	20	P42684-1	773	793	+	20	0	0	2994
P42684-1#18	0	20	20	P42684-1	806	826	+	20	P42684-1	0	1182	P42684-7	0	1058	+	39	P42684-1#18	0	20	P42684-7	682	702	+	20	0	0	2995
P42684-1#18	0	20	20	P42684-1	806	826	+	20	P42684-1	0	1182	P42684-6	0	1161	+	38	P42684-1#18	0	20	P42684-6	785	805	+	20	0	0	2996
P42684-1#18	0	20	20	P42684-1	806	826	+	20	P42684-1	0	1182	P42684-5	0	1079	+	37	P42684-1#18	0	20	P42684-5	703	723	+	20	0	0	2997
P42684-1#18	0	20	20	P42684-1	806	826	+	20	P42684-1	73	1182	P42684-4	37	1043	+	36	P42684-1#18	0	20	P42684-4	667	687	+	20	0	0	2998
P42684-1#18	0	20	20	P42684-1	806	826	+	20	P42684-1	52	1182	P42684-3	37	1167	+	35	P42684-1#18	0	20	P42684-3	791	811	+	20	0	0	2999
P42684-1#18	0	20	20	P42684-1	806	826	+	20	P42684-1	73	1182	P42684-2	37	1146	+	34	P42684-1#18	0	20	P42684-2	770	790	+	20	0	0	3000
P42684-1#18	0	20	20	P42684-1	806	826	+	20	P42684-1	52	1182	P42684-10	37	1064	+	33	P42684-1#18	0	20	P42684-10	688	708	+	20	0	0	3001
P42684-1#18	0	20	20	P42684-1	806	826	+	20	P42684-1	0	1182	P42684-1	0	1182	+	32	P42684-1#18	0	20	P42684-1	806	826	+	20	0	0	3002
P42684-1#19	0	24	24	P42684-1	827	851	+	24	P42684-1	0	1182	P42684-7	0	1058	+	39	P42684-1#19	0	24	P42684-7	703	727	+	24	0	0	3003
P42684-1#19	0	24	24	P42684-1	827	851	+	24	P42684-1	0	1182	P42684-6	0	1161	+	38	P42684-1#19	0	24	P42684-6	806	830	+	24	0	0	3004
P42684-1#19	0	24	24	P42684-1	827	851	+	24	P42684-1	0	1182	P42684-5	0	1079	+	37	P42684-1#19	0	24	P42684-5	724	748	+	24	0	0	3005
P42684-1#19	0	24	24	P42684-1	827	851	+	24	P42684-1	73	1182	P42684-4	37	1043	+	36	P42684-1#19	0	24	P42684-4	688	712	+	24	0	0	3006
P42684-1#19	0	24	24	P42684-1	827	851	+	24	P42684-1	52	1182	P42684-3	37	1167	+	35	P42684-1#19	0	24	P42684-3	812	836	+	24	0	0	3007
P42684-1#19	0	24	24	P42684-1	827	851	+	24	P42684-1	73	1182	P42684-2	37	1146	+	34	P42684-1#19	0	24	P42684-2	791	815	+	24	0	0	3008
P42684-1#19	0	24	24	P42684-1	827	851	+	24	P42684-1	52	1182	P42684-10	37	1064	+	33	P42684-1#19	0	24	P42684-10	709	733	+	24	0	0	3009
P42684-1#19	0	24	24	P42684-1	827	851	+	24	P42684-1	0	1182	P42684-1	0	1182	+	32	P42684-1#19	0	24	P42684-1	827	851	+	24	0	0	3010
P42684-1#20	0	15	15	P42684-1	965	980	+	15	P42684-1	0	1182	P42684-7	0	1058	+	39	P42684-1#20	0	15	P42684-7	841	856	+	15	0	0	3011
P42684-1#20	0	15	15	P42684-1	965	980	+	15	P42684-1	0	1182	P42684-6	0	1161	+	38	P42684-1#20	0	15	P42684-6	944	959	+	15	0	0	3012
P42684-1#20	0	15	15	P42684-1	965	980	+	15	P42684-1	0	1182	P42684-5	0	1079	+	37	P42684-1#20	0	15	P42684-5	862	877	+	15	0	0	3013
P42684-1#20	0	15	15	P42684-1	965	980	+	15	P42684-1	73	1182	P42684-4	37	1043	+	36	P42684-1#20	0	15	P42684-4	826	841	+	15	0	0	3014
P42684-1#20	0	15	15	P42684-1	965	980	+	15	P42684-1	52	1182	P42684-3	37	1167	+	35	P42684-1#20	0	15	P42684-3	950	965	+	15	0	0	3015
P42684-1#20	0	15	15	P42684-1	965	980	+	15	P42684-1	73	1182	P42684-2	37	1146	+	34	P42684-1#20	0	15	P42684-2	929	944	+	15	0	0	3016
P42684-1#20	0	15	15	P42684-1	965	980	+	15	P42684-1	52	1182	P42684-10	37	1064	+	33	P42684-1#20	0	15	P42684-10	847	862	+	15	0	0	3017
P42684-1#20	0	15	15	P42684-1	965	980	+	15	P42684-1	0	1182	P42684-1	0	1182	+	32	P42684-1#20	0	15	P42684-1	965	980	+	15	0	0	3018
P42684-1#21	0	22	22	P42684-1	999	1021	+	22	P42684-1	0	1182	P42684-7	0	1058	+	39	P42684-1#21	0	22	P42684-7	875	897	+	22	0	0	3019
P42684-1#21	0	22	22	P42684-1	999	1021	+	22	P42684-1	0	1182	P42684-6	0	1161	+	38	P42684-1#21	0	22	P42684-6	978	1000	+	22	0	0	3020
P42684-1#21	0	22	22	P42684-1	999	1021	+	22	P42684-1	0	1182	P42684-5	0	1079	+	37	P42684-1#21	0	22	P42684-5	896	918	+	22	0	0	3021
P42684-1#21	0	22	22	P42684-1	999	1021	+	22	P42684-1	73	1182	P42684-4	37	1043	+	36	P42684-1#21	0	22	P42684-4	860	882	+	22	0	0	3022
P42684-1#21	0	22	22	P42684-1	999	1021	+	22	P42684-1	52	1182	P42684-3	37	1167	+	35	P42684-1#21	0	22	P42684-3	984	1006	+	22	0	0	3023
P42684-1#21	0	22	22	P42684-1	999	1021	+	22	P42684-1	73	1182	P42684-2	37	1146	+	34	P42684-1#21	0	22	P42684-2	963	985	+	22	0	0	3024
P42684-1#21	0	22	22	P42684-1	999	1021	+	22	P42684-1	52	1182	P42684-10	37	1064	+	33	P42684-1#21	0	22	P42684-10	881	903	+	22	0	0	3025
P42684-1#21	0	22	22	P42684-1	999	1021	+	22	P42684-1	0	1182	P42684-1	0	1182	+	32	P42684-1#21	0	22	P42684-1	999	1021	+	22	0	0	3026
P42684-1#22	0	1	1	P42684-1	408	409	+	1	P42684-1	0	550	P42684-8	0	529	+	40	P42684-1#22	0	1	P42684-8	387	388	+	1	0	0	3027
P42684-1#22	0	1	1	P42684-1	408	409	+	1	P42684-1	0	1182	P42684-7	0	1058	+	39	P42684-1#22	0	1	P42684-7	387	388	+	1	0	0	3028
P42684-1#22	0	1	1	P42684-1	408	409	+	1	P42684-1	0	1182	P42684-6	0	1161	+	38	P42684-1#22	0	1	P42684-6	387	388	+	1	0	0	3029
P42684-1#22	0	1	1	P42684-1	408	409	+	1	P42684-1	0	1182	P42684-5	0	1079	+	37	P42684-1#22	0	1	P42684-5	408	409	+	1	0	0	3030
P42684-1#22	0	1	1	P42684-1	408	409	+	1	P42684-1	73	1182	P42684-4	37	1043	+	36	P42684-1#22	0	1	P42684-4	372	373	+	1	0	0	3031
P42684-1#22	0	1	1	P42684-1	408	409	+	1	P42684-1	52	1182	P42684-3	37	1167	+	35	P42684-1#22	0	1	P42684-3	393	394	+	1	0	0	3032
P42684-1#22	0	1	1	P42684-1	408	409	+	1	P42684-1	73	1182	P42684-2	37	1146	+	34	P42684-1#22	0	1	P42684-2	372	373	+	1	0	0	3033
P42684-1#22	0	1	1	P42684-1	408	409	+	1	P42684-1	52	1182	P42684-10	37	1064	+	33	P42684-1#22	0	1	P42684-10	393	394	+	1	0	0	3034
P42684-1#22	0	1	1	P42684-1	408	409	+	1	P42684-1	0	1182	P42684-1	0	1182	+	32	P42684-1#22	0	1	P42684-1	408	409	+	1	0	0	3035
P42684-1#23	0	9	9	P42684-1	293	302	+	9	P42684-1	0	550	P42684-8	0	529	+	40	P42684-1#23	0	9	P42684-8	272	281	+	9	0	0	3036
P42684-1#23	0	9	9	P42684-1	293	302	+	9	P42684-1	0	1182	P42684-7	0	1058	+	39	P42684-1#23	0	9	P42684-7	272	281	+	9	0	0	3037
P42684-1#23	0	9	9	P42684-1	293	302	+	9	P42684-1	0	1182	P42684-6	0	1161	+	38	P42684-1#23	0	9	P42684-6	272	281	+	9	0	0	3038
P42684-1#23	0	9	9	P42684-1	293	302	+	9	P42684-1	0	1182	P42684-5	0	1079	+	37	P42684-1#23	0	9	P42684-5	293	302	+	9	0	0	3039
P42684-1#23	0	9	9	P42684-1	293	302	+	9	P42684-1	73	1182	P42684-4	37	1043	+	36	P42684-1#23	0	9	P42684-4	257	266	+	9	0	0	3040
P42684-1#23	0	9	9	P42684-1	293	302	+	9	P42684-1	52	1182	P42684-3	37	1167	+	35	P42684-1#23	0	9	P42684-3	278	287	+	9	0	0	3041
P42684-1#23	0	9	9	P42684-1	293	302	+	9	P42684-1	73	1182	P42684-2	37	1146	+	34	P42684-1#23	0	9	P42684-2	257	266	+	9	0	0	3042
P42684-1#23	0	9	9	P42684-1	293	302	+	9	P42684-1	52	1182	P42684-10	37	1064	+	33	P42684-1#23	0	9	P42684-10	278	287	+	9	0	0	3043
P42684-1#23	0	9	9	P42684-1	293	302	+	9	P42684-1	0	1182	P42684-1	0	1182	+	32	P42684-1#23	0	9	P42684-1	293	302	+	9	0	0	3044
P42684-1#24	0	1	1	P42684-1	316	317	+	1	P42684-1	0	550	P42684-8	0	529	+	40	P42684-1#24	0	1	P42684-8	295	296	+	1	0	0	3045
P42684-1#24	0	1	1	P42684-1	316	317	+	1	P42684-1	0	1182	P42684-7	0	1058	+	39	P42684-1#24	0	1	P42684-7	295	296	+	1	0	0	3046
P42684-1#24	0	1	1	P42684-1	316	317	+	1	P42684-1	0	1182	P42684-6	0	1161	+	38	P42684-1#24	0	1	P42684-6	295	296	+	1	0	0	3047
P42684-1#24	0	1	1	P42684-1	316	317	+	1	P42684-1	0	1182	P42684-5	0	1079	+	37	P42684-1#24	0	1	P42684-5	316	317	+	1	0	0	3048
P42684-1#24	0	1	1	P42684-1	316	317	+	1	P42684-1	73	1182	P42684-4	37	1043	+	36	P42684-1#24	0	1	P42684-4	280	281	+	1	0	0	3049
P42684-1#24	0	1	1	P42684-1	316	317	+	1	P42684-1	52	1182	P42684-3	37	1167	+	35	P42684-1#24	0	1	P42684-3	301	302	+	1	0	0	3050
P42684-1#24	0	1	1	P42684-1	316	317	+	1	P42684-1	73	1182	P42684-2	37	1146	+	34	P42684-1#24	0	1	P42684-2	280	281	+	1	0	0	3051
P42684-1#24	0	1	1	P42684-1	316	317	+	1	P42684-1	52	1182	P42684-10	37	1064	+	33	P42684-1#24	0	1	P42684-10	301	302	+	1	0	0	3052
P42684-1#24	0	1	1	P42684-1	316	317	+	1	P42684-1	0	1182	P42684-1	0	1182	+	32	P42684-1#24	0	1	P42684-1	316	317	+	1	0	0	3053
P42684-1#25	0	7	7	P42684-1	361	368	+	7	P42684-1	0	550	P42684-8	0	529	+	40	P42684-1#25	0	7	P42684-8	340	347	+	7	0	0	3054
P42684-1#25	0	7	7	P42684-1	361	368	+	7	P42684-1	0	1182	P42684-7	0	1058	+	39	P42684-1#25	0	7	P42684-7	340	347	+	7	0	0	3055
P42684-1#25	0	7	7	P42684-1	361	368	+	7	P42684-1	0	1182	P42684-6	0	1161	+	38	P42684-1#25	0	7	P42684-6	340	347	+	7	0	0	3056
P42684-1#25	0	7	7	P42684-1	361	368	+	7	P42684-1	0	1182	P42684-5	0	1079	+	37	P42684-1#25	0	7	P42684-5	361	368	+	7	0	0	3057
P42684-1#25	0	7	7	P42684-1	361	368	+	7	P42684-1	73	1182	P42684-4	37	1043	+	36	P42684-1#25	0	7	P42684-4	325	332	+	7	0	0	3058
P42684-1#25	0	7	7	P42684-1	361	368	+	7	P42684-1	52	1182	P42684-3	37	1167	+	35	P42684-1#25	0	7	P42684-3	346	353	+	7	0	0	3059
P42684-1#25	0	7	7	P42684-1	361	368	+	7	P42684-1	73	1182	P42684-2	37	1146	+	34	P42684-1#25	0	7	P42684-2	325	332	+	7	0	0	3060
P42684-1#25	0	7	7	P42684-1	361	368	+	7	P42684-1	52	1182	P42684-10	37	1064	+	33	P42684-1#25	0	7	P42684-10	346	353	+	7	0	0	3061
P42684-1#25	0	7	7	P42684-1	361	368	+	7	P42684-1	0	1182	P42684-1	0	1182	+	32	P42684-1#25	0	7	P42684-1	361	368	+	7	0	0	3062
P42684-1#26	0	1	1	P42684-1	96	97	+	1	P42684-1	0	550	P42684-8	0	529	+	40	P42684-1#26	0	1	P42684-8	75	76	+	1	0	0	3063
P42684-1#26	0	1	1	P42684-1	96	97	+	1	P42684-1	0	1182	P42684-7	0	1058	+	39	P42684-1#26	0	1	P42684-7	75	76	+	1	0	0	3064
P42684-1#26	0	1	1	P42684-1	96	97	+	1	P42684-1	0	1182	P42684-6	0	1161	+	38	P42684-1#26	0	1	P42684-6	75	76	+	1	0	0	3065
P42684-1#26	0	1	1	P42684-1	96	97	+	1	P42684-1	0	1182	P42684-5	0	1079	+	37	P42684-1#26	0	1	P42684-5	96	97	+	1	0	0	3066
P42684-1#26	0	1	1	P42684-1	96	97	+	1	P42684-1	73	1182	P42684-4	37	1043	+	36	P42684-1#26	0	1	P42684-4	60	61	+	1	0	0	3067
P42684-1#26	0	1	1	P42684-1	96	97	+	1	P42684-1	52	1182	P42684-3	37	1167	+	35	P42684-1#26	0	1	P42684-3	81	82	+	1	0	0	3068
P42684-1#26	0	1	1	P42684-1	96	97	+	1	P42684-1	73	1182	P42684-2	37	1146	+	34	P42684-1#26	0	1	P42684-2	60	61	+	1	0	0	3069
P42684-1#26	0	1	1	P42684-1	96	97	+	1	P42684-1	52	1182	P42684-10	37	1064	+	33	P42684-1#26	0	1	P42684-10	81	82	+	1	0	0	3070
P42684-1#26	0	1	1	P42684-1	96	97	+	1	P42684-1	0	1182	P42684-1	0	1182	+	32	P42684-1#26	0	1	P42684-1	96	97	+	1	0	0	3071
P42684-1#27	0	1	1	P42684-1	115	116	+	1	P42684-1	0	550	P42684-8	0	529	+	40	P42684-1#27	0	1	P42684-8	94	95	+	1	0	0	3072
P42684-1#27	0	1	1	P42684-1	115	116	+	1	P42684-1	0	1182	P42684-7	0	1058	+	39	P42684-1#27	0	1	P42684-7	94	95	+	1	0	0	3073
P42684-1#27	0	1	1	P42684-1	115	116	+	1	P42684-1	0	1182	P42684-6	0	1161	+	38	P42684-1#27	0	1	P42684-6	94	95	+	1	0	0	3074
P42684-1#27	0	1	1	P42684-1	115	116	+	1	P42684-1	0	1182	P42684-5	0	1079	+	37	P42684-1#27	0	1	P42684-5	115	116	+	1	0	0	3075
P42684-1#27	0	1	1	P42684-1	115	116	+	1	P42684-1	73	1182	P42684-4	37	1043	+	36	P42684-1#27	0	1	P42684-4	79	80	+	1	0	0	3076
P42684-1#27	0	1	1	P42684-1	115	116	+	1	P42684-1	52	1182	P42684-3	37	1167	+	35	P42684-1#27	0	1	P42684-3	100	101	+	1	0	0	3077
P42684-1#27	0	1	1	P42684-1	115	116	+	1	P42684-1	73	1182	P42684-2	37	1146	+	34	P42684-1#27	0	1	P42684-2	79	80	+	1	0	0	3078
P42684-1#27	0	1	1	P42684-1	115	116	+	1	P42684-1	52	1182	P42684-10	37	1064	+	33	P42684-1#27	0	1	P42684-10	100	101	+	1	0	0	3079
P42684-1#27	0	1	1	P42684-1	115	116	+	1	P42684-1	0	1182	P42684-1	0	1182	+	32	P42684-1#27	0	1	P42684-1	115	116	+	1	0	0	3080
P42684-1#28	0	1	1	P42684-1	160	161	+	1	P42684-1	0	550	P42684-8	0	529	+	40	P42684-1#28	0	1	P42684-8	139	140	+	1	0	0	3081
P42684-1#28	0	1	1	P42684-1	160	161	+	1	P42684-1	0	1182	P42684-7	0	1058	+	39	P42684-1#28	0	1	P42684-7	139	140	+	1	0	0	3082
P42684-1#28	0	1	1	P42684-1	160	161	+	1	P42684-1	0	1182	P42684-6	0	1161	+	38	P42684-1#28	0	1	P42684-6	139	140	+	1	0	0	3083
P42684-1#28	0	1	1	P42684-1	160	161	+	1	P42684-1	0	1182	P42684-5	0	1079	+	37	P42684-1#28	0	1	P42684-5	160	161	+	1	0	0	3084
P42684-1#28	0	1	1	P42684-1	160	161	+	1	P42684-1	73	1182	P42684-4	37	1043	+	36	P42684-1#28	0	1	P42684-4	124	125	+	1	0	0	3085
P42684-1#28	0	1	1	P42684-1	160	161	+	1	P42684-1	52	1182	P42684-3	37	1167	+	35	P42684-1#28	0	1	P42684-3	145	146	+	1	0	0	3086
P42684-1#28	0	1	1	P42684-1	160	161	+	1	P42684-1	73	1182	P42684-2	37	1146	+	34	P42684-1#28	0	1	P42684-2	124	125	+	1	0	0	3087
P42684-1#28	0	1	1	P42684-1	160	161	+	1	P42684-1	52	1182	P42684-10	37	1064	+	33	P42684-1#28	0	1	P42684-10	145	146	+	1	0	0	3088
P42684-1#28	0	1	1	P42684-1	160	161	+	1	P42684-1	0	1182	P42684-1	0	1182	+	32	P42684-1#28	0	1	P42684-1	160	161	+	1	0	0	3089
P42684-1#29	0	1	1	P42684-1	173	174	+	1	P42684-1	0	550	P42684-8	0	529	+	40	P42684-1#29	0	1	P42684-8	152	153	+	1	0	0	3090
P42684-1#29	0	1	1	P42684-1	173	174	+	1	P42684-1	0	1182	P42684-7	0	1058	+	39	P42684-1#29	0	1	P42684-7	152	153	+	1	0	0	3091
P42684-1#29	0	1	1	P42684-1	173	174	+	1	P42684-1	0	1182	P42684-6	0	1161	+	38	P42684-1#29	0	1	P42684-6	152	153	+	1	0	0	3092
P42684-1#29	0	1	1	P42684-1	173	174	+	1	P42684-1	0	1182	P42684-5	0	1079	+	37	P42684-1#29	0	1	P42684-5	173	174	+	1	0	0	3093
P42684-1#29	0	1	1	P42684-1	173	174	+	1	P42684-1	73	1182	P42684-4	37	1043	+	36	P42684-1#29	0	1	P42684-4	137	138	+	1	0	0	3094
P42684-1#29	0	1	1	P42684-1	173	174	+	1	P42684-1	52	1182	P42684-3	37	1167	+	35	P42684-1#29	0	1	P42684-3	158	159	+	1	0	0	3095
P42684-1#29	0	1	1	P42684-1	173	174	+	1	P42684-1	73	1182	P42684-2	37	1146	+	34	P42684-1#29	0	1	P42684-2	137	138	+	1	0	0	3096
P42684-1#29	0	1	1	P42684-1	173	174	+	1	P42684-1	52	1182	P42684-10	37	1064	+	33	P42684-1#29	0	1	P42684-10	158	159	+	1	0	0	3097
P42684-1#29	0	1	1	P42684-1	173	174	+	1	P42684-1	0	1182	P42684-1	0	1182	+	32	P42684-1#29	0	1	P42684-1	173	174	+	1	0	0	3098
P42684-1#30	0	1	1	P42684-1	184	185	+	1	P42684-1	0	550	P42684-8	0	529	+	40	P42684-1#30	0	1	P42684-8	163	164	+	1	0	0	3099
P42684-1#30	0	1	1	P42684-1	184	185	+	1	P42684-1	0	1182	P42684-7	0	1058	+	39	P42684-1#30	0	1	P42684-7	163	164	+	1	0	0	3100
P42684-1#30	0	1	1	P42684-1	184	185	+	1	P42684-1	0	1182	P42684-6	0	1161	+	38	P42684-1#30	0	1	P42684-6	163	164	+	1	0	0	3101
P42684-1#30	0	1	1	P42684-1	184	185	+	1	P42684-1	0	1182	P42684-5	0	1079	+	37	P42684-1#30	0	1	P42684-5	184	185	+	1	0	0	3102
P42684-1#30	0	1	1	P42684-1	184	185	+	1	P42684-1	73	1182	P42684-4	37	1043	+	36	P42684-1#30	0	1	P42684-4	148	149	+	1	0	0	3103
P42684-1#30	0	1	1	P42684-1	184	185	+	1	P42684-1	52	1182	P42684-3	37	1167	+	35	P42684-1#30	0	1	P42684-3	169	170	+	1	0	0	3104
P42684-1#30	0	1	1	P42684-1	184	185	+	1	P42684-1	73	1182	P42684-2	37	1146	+	34	P42684-1#30	0	1	P42684-2	148	149	+	1	0	0	3105
P42684-1#30	0	1	1	P42684-1	184	185	+	1	P42684-1	52	1182	P42684-10	37	1064	+	33	P42684-1#30	0	1	P42684-10	169	170	+	1	0	0	3106
P42684-1#30	0	1	1	P42684-1	184	185	+	1	P42684-1	0	1182	P42684-1	0	1182	+	32	P42684-1#30	0	1	P42684-1	184	185	+	1	0	0	3107
P42684-1#31	0	1	1	P42684-1	217	218	+	1	P42684-1	0	550	P42684-8	0	529	+	40	P42684-1#31	0	1	P42684-8	196	197	+	1	0	0	3108
P42684-1#31	0	1	1	P42684-1	217	218	+	1	P42684-1	0	1182	P42684-7	0	1058	+	39	P42684-1#31	0	1	P42684-7	196	197	+	1	0	0	3109
P42684-1#31	0	1	1	P42684-1	217	218	+	1	P42684-1	0	1182	P42684-6	0	1161	+	38	P42684-1#31	0	1	P42684-6	196	197	+	1	0	0	3110
P42684-1#31	0	1	1	P42684-1	217	218	+	1	P42684-1	0	1182	P42684-5	0	1079	+	37	P42684-1#31	0	1	P42684-5	217	218	+	1	0	0	3111
P42684-1#31	0	1	1	P42684-1	217	218	+	1	P42684-1	73	1182	P42684-4	37	1043	+	36	P42684-1#31	0	1	P42684-4	181	182	+	1	0	0	3112
P42684-1#31	0	1	1	P42684-1	217	218	+	1	P42684-1	52	1182	P42684-3	37	1167	+	35	P42684-1#31	0	1	P42684-3	202	203	+	1	0	0	3113
P42684-1#31	0	1	1	P42684-1	217	218	+	1	P42684-1	73	1182	P42684-2	37	1146	+	34	P42684-1#31	0	1	P42684-2	181	182	+	1	0	0	3114
P42684-1#31	0	1	1	P42684-1	217	218	+	1	P42684-1	52	1182	P42684-10	37	1064	+	33	P42684-1#31	0	1	P42684-10	202	203	+	1	0	0	3115
P42684-1#31	0	1	1	P42684-1	217	218	+	1	P42684-1	0	1182	P42684-1	0	1182	+	32	P42684-1#31	0	1	P42684-1	217	218	+	1	0	0	3116
P42684-1#32	0	1	1	P42684-1	230	231	+	1	P42684-1	0	550	P42684-8	0	529	+	40	P42684-1#32	0	1	P42684-8	209	210	+	1	0	0	3117
P42684-1#32	0	1	1	P42684-1	230	231	+	1	P42684-1	0	1182	P42684-7	0	1058	+	39	P42684-1#32	0	1	P42684-7	209	210	+	1	0	0	3118
P42684-1#32	0	1	1	P42684-1	230	231	+	1	P42684-1	0	1182	P42684-6	0	1161	+	38	P42684-1#32	0	1	P42684-6	209	210	+	1	0	0	3119
P42684-1#32	0	1	1	P42684-1	230	231	+	1	P42684-1	0	1182	P42684-5	0	1079	+	37	P42684-1#32	0	1	P42684-5	230	231	+	1	0	0	3120
P42684-1#32	0	1	1	P42684-1	230	231	+	1	P42684-1	73	1182	P42684-4	37	1043	+	36	P42684-1#32	0	1	P42684-4	194	195	+	1	0	0	3121
P42684-1#32	0	1	1	P42684-1	230	231	+	1	P42684-1	52	1182	P42684-3	37	1167	+	35	P42684-1#32	0	1	P42684-3	215	216	+	1	0	0	3122
P42684-1#32	0	1	1	P42684-1	230	231	+	1	P42684-1	73	1182	P42684-2	37	1146	+	34	P42684-1#32	0	1	P42684-2	194	195	+	1	0	0	3123
P42684-1#32	0	1	1	P42684-1	230	231	+	1	P42684-1	52	1182	P42684-10	37	1064	+	33	P42684-1#32	0	1	P42684-10	215	216	+	1	0	0	3124
P42684-1#32	0	1	1	P42684-1	230	231	+	1	P42684-1	0	1182	P42684-1	0	1182	+	32	P42684-1#32	0	1	P42684-1	230	231	+	1	0	0	3125
P42684-1#33	0	1	1	P42684-1	260	261	+	1	P42684-1	0	550	P42684-8	0	529	+	40	P42684-1#33	0	1	P42684-8	239	240	+	1	0	0	3126
P42684-1#33	0	1	1	P42684-1	260	261	+	1	P42684-1	0	1182	P42684-7	0	1058	+	39	P42684-1#33	0	1	P42684-7	239	240	+	1	0	0	3127
P42684-1#33	0	1	1	P42684-1	260	261	+	1	P42684-1	0	1182	P42684-6	0	1161	+	38	P42684-1#33	0	1	P42684-6	239	240	+	1	0	0	3128
P42684-1#33	0	1	1	P42684-1	260	261	+	1	P42684-1	0	1182	P42684-5	0	1079	+	37	P42684-1#33	0	1	P42684-5	260	261	+	1	0	0	3129
P42684-1#33	0	1	1	P42684-1	260	261	+	1	P42684-1	73	1182	P42684-4	37	1043	+	36	P42684-1#33	0	1	P42684-4	224	225	+	1	0	0	3130
P42684-1#33	0	1	1	P42684-1	260	261	+	1	P42684-1	52	1182	P42684-3	37	1167	+	35	P42684-1#33	0	1	P42684-3	245	246	+	1	0	0	3131
P42684-1#33	0	1	1	P42684-1	260	261	+	1	P42684-1	73	1182	P42684-2	37	1146	+	34	P42684-1#33	0	1	P42684-2	224	225	+	1	0	0	3132
P42684-1#33	0	1	1	P42684-1	260	261	+	1	P42684-1	52	1182	P42684-10	37	1064	+	33	P42684-1#33	0	1	P42684-10	245	246	+	1	0	0	3133
P42684-1#33	0	1	1	P42684-1	260	261	+	1	P42684-1	0	1182	P42684-1	0	1182	+	32	P42684-1#33	0	1	P42684-1	260	261	+	1	0	0	3134
P42684-1#34	0	1	1	P42684-1	271	272	+	1	P42684-1	0	550	P42684-8	0	529	+	40	P42684-1#34	0	1	P42684-8	250	251	+	1	0	0	3135
P42684-1#34	0	1	1	P42684-1	271	272	+	1	P42684-1	0	1182	P42684-7	0	1058	+	39	P42684-1#34	0	1	P42684-7	250	251	+	1	0	0	3136
P42684-1#34	0	1	1	P42684-1	271	272	+	1	P42684-1	0	1182	P42684-6	0	1161	+	38	P42684-1#34	0	1	P42684-6	250	251	+	1	0	0	3137
P42684-1#34	0	1	1	P42684-1	271	272	+	1	P42684-1	0	1182	P42684-5	0	1079	+	37	P42684-1#34	0	1	P42684-5	271	272	+	1	0	0	3138
P42684-1#34	0	1	1	P42684-1	271	272	+	1	P42684-1	73	1182	P42684-4	37	1043	+	36	P42684-1#34	0	1	P42684-4	235	236	+	1	0	0	3139
P42684-1#34	0	1	1	P42684-1	271	272	+	1	P42684-1	52	1182	P42684-3	37	1167	+	35	P42684-1#34	0	1	P42684-3	256	257	+	1	0	0	3140
P42684-1#34	0	1	1	P42684-1	271	272	+	1	P42684-1	73	1182	P42684-2	37	1146	+	34	P42684-1#34	0	1	P42684-2	235	236	+	1	0	0	3141
P42684-1#34	0	1	1	P42684-1	271	272	+	1	P42684-1	52	1182	P42684-10	37	1064	+	33	P42684-1#34	0	1	P42684-10	256	257	+	1	0	0	3142
P42684-1#34	0	1	1	P42684-1	271	272	+	1	P42684-1	0	1182	P42684-1	0	1182	+	32	P42684-1#34	0	1	P42684-1	271	272	+	1	0	0	3143
P42684-1#35	0	1	1	P42684-1	274	275	+	1	P42684-1	0	550	P42684-8	0	529	+	40	P42684-1#35	0	1	P42684-8	253	254	+	1	0	0	3144
P42684-1#35	0	1	1	P42684-1	274	275	+	1	P42684-1	0	1182	P42684-7	0	1058	+	39	P42684-1#35	0	1	P42684-7	253	254	+	1	0	0	3145
P42684-1#35	0	1	1	P42684-1	274	275	+	1	P42684-1	0	1182	P42684-6	0	1161	+	38	P42684-1#35	0	1	P42684-6	253	254	+	1	0	0	3146
P42684-1#35	0	1	1	P42684-1	274	275	+	1	P42684-1	0	1182	P42684-5	0	1079	+	37	P42684-1#35	0	1	P42684-5	274	275	+	1	0	0	3147
P42684-1#35	0	1	1	P42684-1	274	275	+	1	P42684-1	73	1182	P42684-4	37	1043	+	36	P42684-1#35	0	1	P42684-4	238	239	+	1	0	0	3148
P42684-1#35	0	1	1	P42684-1	274	275	+	1	P42684-1	52	1182	P42684-3	37	1167	+	35	P42684-1#35	0	1	P42684-3	259	260	+	1	0	0	3149
P42684-1#35	0	1	1	P42684-1	274	275	+	1	P42684-1	73	1182	P42684-2	37	1146	+	34	P42684-1#35	0	1	P42684-2	238	239	+	1	0	0	3150
P42684-1#35	0	1	1	P42684-1	274	275	+	1	P42684-1	52	1182	P42684-10	37	1064	+	33	P42684-1#35	0	1	P42684-10	259	260	+	1	0	0	3151
P42684-1#35	0	1	1	P42684-1	274	275	+	1	P42684-1	0	1182	P42684-1	0	1182	+	32	P42684-1#35	0	1	P42684-1	274	275	+	1	0	0	3152
P42684-1#36	0	1	1	P42684-1	298	299	+	1	P42684-1	0	550	P42684-8	0	529	+	40	P42684-1#36	0	1	P42684-8	277	278	+	1	0	0	3153
P42684-1#36	0	1	1	P42684-1	298	299	+	1	P42684-1	0	1182	P42684-7	0	1058	+	39	P42684-1#36	0	1	P42684-7	277	278	+	1	0	0	3154
P42684-1#36	0	1	1	P42684-1	298	299	+	1	P42684-1	0	1182	P42684-6	0	1161	+	38	P42684-1#36	0	1	P42684-6	277	278	+	1	0	0	3155
P42684-1#36	0	1	1	P42684-1	298	299	+	1	P42684-1	0	1182	P42684-5	0	1079	+	37	P42684-1#36	0	1	P42684-5	298	299	+	1	0	0	3156
P42684-1#36	0	1	1	P42684-1	298	299	+	1	P42684-1	73	1182	P42684-4	37	1043	+	36	P42684-1#36	0	1	P42684-4	262	263	+	1	0	0	3157
P42684-1#36	0	1	1	P42684-1	298	299	+	1	P42684-1	52	1182	P42684-3	37	1167	+	35	P42684-1#36	0	1	P42684-3	283	284	+	1	0	0	3158
P42684-1#36	0	1	1	P42684-1	298	299	+	1	P42684-1	73	1182	P42684-2	37	1146	+	34	P42684-1#36	0	1	P42684-2	262	263	+	1	0	0	3159
P42684-1#36	0	1	1	P42684-1	298	299	+	1	P42684-1	52	1182	P42684-10	37	1064	+	33	P42684-1#36	0	1	P42684-10	283	284	+	1	0	0	3160
P42684-1#36	0	1	1	P42684-1	298	299	+	1	P42684-1	0	1182	P42684-1	0	1182	+	32	P42684-1#36	0	1	P42684-1	298	299	+	1	0	0	3161
P42684-1#37	0	1	1	P42684-1	302	303	+	1	P42684-1	0	550	P42684-8	0	529	+	40	P42684-1#37	0	1	P42684-8	281	282	+	1	0	0	3162
P42684-1#37	0	1	1	P42684-1	302	303	+	1	P42684-1	0	1182	P42684-7	0	1058	+	39	P42684-1#37	0	1	P42684-7	281	282	+	1	0	0	3163
P42684-1#37	0	1	1	P42684-1	302	303	+	1	P42684-1	0	1182	P42684-6	0	1161	+	38	P42684-1#37	0	1	P42684-6	281	282	+	1	0	0	3164
P42684-1#37	0	1	1	P42684-1	302	303	+	1	P42684-1	0	1182	P42684-5	0	1079	+	37	P42684-1#37	0	1	P42684-5	302	303	+	1	0	0	3165
P42684-1#37	0	1	1	P42684-1	302	303	+	1	P42684-1	73	1182	P42684-4	37	1043	+	36	P42684-1#37	0	1	P42684-4	266	267	+	1	0	0	3166
P42684-1#37	0	1	1	P42684-1	302	303	+	1	P42684-1	52	1182	P42684-3	37	1167	+	35	P42684-1#37	0	1	P42684-3	287	288	+	1	0	0	3167
P42684-1#37	0	1	1	P42684-1	302	303	+	1	P42684-1	73	1182	P42684-2	37	1146	+	34	P42684-1#37	0	1	P42684-2	266	267	+	1	0	0	3168
P42684-1#37	0	1	1	P42684-1	302	303	+	1	P42684-1	52	1182	P42684-10	37	1064	+	33	P42684-1#37	0	1	P42684-10	287	288	+	1	0	0	3169
P42684-1#37	0	1	1	P42684-1	302	303	+	1	P42684-1	0	1182	P42684-1	0	1182	+	32	P42684-1#37	0	1	P42684-1	302	303	+	1	0	0	3170
P42684-1#38	0	1	1	P42684-1	438	439	+	1	P42684-1	0	550	P42684-8	0	529	+	40	P42684-1#38	0	1	P42684-8	417	418	+	1	0	0	3171
P42684-1#38	0	1	1	P42684-1	438	439	+	1	P42684-1	0	1182	P42684-7	0	1058	+	39	P42684-1#38	0	1	P42684-7	417	418	+	1	0	0	3172
P42684-1#38	0	1	1	P42684-1	438	439	+	1	P42684-1	0	1182	P42684-6	0	1161	+	38	P42684-1#38	0	1	P42684-6	417	418	+	1	0	0	3173
P42684-1#38	0	1	1	P42684-1	438	439	+	1	P42684-1	0	1182	P42684-5	0	1079	+	37	P42684-1#38	0	1	P42684-5	438	439	+	1	0	0	3174
P42684-1#38	0	1	1	P42684-1	438	439	+	1	P42684-1	73	1182	P42684-4	37	1043	+	36	P42684-1#38	0	1	P42684-4	402	403	+	1	0	0	3175
P42684-1#38	0	1	1	P42684-1	438	439	+	1	P42684-1	52	1182	P42684-3	37	1167	+	35	P42684-1#38	0	1	P42684-3	423	424	+	1	0	0	3176
P42684-1#38	0	1	1	P42684-1	438	439	+	1	P42684-1	73	1182	P42684-2	37	1146	+	34	P42684-1#38	0	1	P42684-2	402	403	+	1	0	0	3177
P42684-1#38	0	1	1	P42684-1	438	439	+	1	P42684-1	52	1182	P42684-10	37	1064	+	33	P42684-1#38	0	1	P42684-10	423	424	+	1	0	0	3178
P42684-1#38	0	1	1	P42684-1	438	439	+	1	P42684-1	0	1182	P42684-1	0	1182	+	32	P42684-1#38	0	1	P42684-1	438	439	+	1	0	0	3179
P42684-1#39	0	1	1	P42684-1	458	459	+	1	P42684-1	0	550	P42684-8	0	529	+	40	P42684-1#39	0	1	P42684-8	437	438	+	1	0	0	3180
P42684-1#39	0	1	1	P42684-1	458	459	+	1	P42684-1	0	1182	P42684-7	0	1058	+	39	P42684-1#39	0	1	P42684-7	437	438	+	1	0	0	3181
P42684-1#39	0	1	1	P42684-1	458	459	+	1	P42684-1	0	1182	P42684-6	0	1161	+	38	P42684-1#39	0	1	P42684-6	437	438	+	1	0	0	3182
P42684-1#39	0	1	1	P42684-1	458	459	+	1	P42684-1	0	1182	P42684-5	0	1079	+	37	P42684-1#39	0	1	P42684-5	458	459	+	1	0	0	3183
P42684-1#39	0	1	1	P42684-1	458	459	+	1	P42684-1	73	1182	P42684-4	37	1043	+	36	P42684-1#39	0	1	P42684-4	422	423	+	1	0	0	3184
P42684-1#39	0	1	1	P42684-1	458	459	+	1	P42684-1	52	1182	P42684-3	37	1167	+	35	P42684-1#39	0	1	P42684-3	443	444	+	1	0	0	3185
P42684-1#39	0	1	1	P42684-1	458	459	+	1	P42684-1	73	1182	P42684-2	37	1146	+	34	P42684-1#39	0	1	P42684-2	422	423	+	1	0	0	3186
P42684-1#39	0	1	1	P42684-1	458	459	+	1	P42684-1	52	1182	P42684-10	37	1064	+	33	P42684-1#39	0	1	P42684-10	443	444	+	1	0	0	3187
P42684-1#39	0	1	1	P42684-1	458	459	+	1	P42684-1	0	1182	P42684-1	0	1182	+	32	P42684-1#39	0	1	P42684-1	458	459	+	1	0	0	3188
P42684-1#40	0	1	1	P42684-1	567	568	+	1	P42684-1	0	1182	P42684-7	0	1058	+	39	P42684-1#40	0	1	P42684-7	546	547	+	1	0	0	3189
P42684-1#40	0	1	1	P42684-1	567	568	+	1	P42684-1	0	1182	P42684-6	0	1161	+	38	P42684-1#40	0	1	P42684-6	546	547	+	1	0	0	3190
P42684-1#40	0	1	1	P42684-1	567	568	+	1	P42684-1	0	1182	P42684-5	0	1079	+	37	P42684-1#40	0	1	P42684-5	567	568	+	1	0	0	3191
P42684-1#40	0	1	1	P42684-1	567	568	+	1	P42684-1	73	1182	P42684-4	37	1043	+	36	P42684-1#40	0	1	P42684-4	531	532	+	1	0	0	3192
P42684-1#40	0	1	1	P42684-1	567	568	+	1	P42684-1	52	1182	P42684-3	37	1167	+	35	P42684-1#40	0	1	P42684-3	552	553	+	1	0	0	3193
P42684-1#40	0	1	1	P42684-1	567	568	+	1	P42684-1	73	1182	P42684-2	37	1146	+	34	P42684-1#40	0	1	P42684-2	531	532	+	1	0	0	3194
P42684-1#40	0	1	1	P42684-1	567	568	+	1	P42684-1	52	1182	P42684-10	37	1064	+	33	P42684-1#40	0	1	P42684-10	552	553	+	1	0	0	3195
P42684-1#40	0	1	1	P42684-1	567	568	+	1	P42684-1	0	1182	P42684-1	0	1182	+	32	P42684-1#40	0	1	P42684-1	567	568	+	1	0	0	3196
P42684-1#41	0	1	1	P42684-1	619	620	+	1	P42684-1	0	1182	P42684-7	0	1058	+	39	P42684-1#41	0	1	P42684-7	598	599	+	1	0	0	3197
P42684-1#41	0	1	1	P42684-1	619	620	+	1	P42684-1	0	1182	P42684-6	0	1161	+	38	P42684-1#41	0	1	P42684-6	598	599	+	1	0	0	3198
P42684-1#41	0	1	1	P42684-1	619	620	+	1	P42684-1	0	1182	P42684-5	0	1079	+	37	P42684-1#41	0	1	P42684-5	619	620	+	1	0	0	3199
P42684-1#41	0	1	1	P42684-1	619	620	+	1	P42684-1	73	1182	P42684-4	37	1043	+	36	P42684-1#41	0	1	P42684-4	583	584	+	1	0	0	3200
P42684-1#41	0	1	1	P42684-1	619	620	+	1	P42684-1	52	1182	P42684-3	37	1167	+	35	P42684-1#41	0	1	P42684-3	604	605	+	1	0	0	3201
P42684-1#41	0	1	1	P42684-1	619	620	+	1	P42684-1	73	1182	P42684-2	37	1146	+	34	P42684-1#41	0	1	P42684-2	583	584	+	1	0	0	3202
P42684-1#41	0	1	1	P42684-1	619	620	+	1	P42684-1	52	1182	P42684-10	37	1064	+	33	P42684-1#41	0	1	P42684-10	604	605	+	1	0	0	3203
P42684-1#41	0	1	1	P42684-1	619	620	+	1	P42684-1	0	1182	P42684-1	0	1182	+	32	P42684-1#41	0	1	P42684-1	619	620	+	1	0	0	3204
P42684-1#42	0	1	1	P42684-1	630	631	+	1	P42684-1	0	1182	P42684-7	0	1058	+	39	P42684-1#42	0	1	P42684-7	609	610	+	1	0	0	3205
P42684-1#42	0	1	1	P42684-1	630	631	+	1	P42684-1	0	1182	P42684-6	0	1161	+	38	P42684-1#42	0	1	P42684-6	609	610	+	1	0	0	3206
P42684-1#42	0	1	1	P42684-1	630	631	+	1	P42684-1	0	1182	P42684-5	0	1079	+	37	P42684-1#42	0	1	P42684-5	630	631	+	1	0	0	3207
P42684-1#42	0	1	1	P42684-1	630	631	+	1	P42684-1	73	1182	P42684-4	37	1043	+	36	P42684-1#42	0	1	P42684-4	594	595	+	1	0	0	3208
P42684-1#42	0	1	1	P42684-1	630	631	+	1	P42684-1	52	1182	P42684-3	37	1167	+	35	P42684-1#42	0	1	P42684-3	615	616	+	1	0	0	3209
P42684-1#42	0	1	1	P42684-1	630	631	+	1	P42684-1	73	1182	P42684-2	37	1146	+	34	P42684-1#42	0	1	P42684-2	594	595	+	1	0	0	3210
P42684-1#42	0	1	1	P42684-1	630	631	+	1	P42684-1	52	1182	P42684-10	37	1064	+	33	P42684-1#42	0	1	P42684-10	615	616	+	1	0	0	3211
P42684-1#42	0	1	1	P42684-1	630	631	+	1	P42684-1	0	1182	P42684-1	0	1182	+	32	P42684-1#42	0	1	P42684-1	630	631	+	1	0	0	3212
P42684-1#43	0	1	1	P42684-1	632	633	+	1	P42684-1	0	1182	P42684-7	0	1058	+	39	P42684-1#43	0	1	P42684-7	611	612	+	1	0	0	3213
P42684-1#43	0	1	1	P42684-1	632	633	+	1	P42684-1	0	1182	P42684-6	0	1161	+	38	P42684-1#43	0	1	P42684-6	611	612	+	1	0	0	3214
P42684-1#43	0	1	1	P42684-1	632	633	+	1	P42684-1	0	1182	P42684-5	0	1079	+	37	P42684-1#43	0	1	P42684-5	632	633	+	1	0	0	3215
P42684-1#43	0	1	1	P42684-1	632	633	+	1	P42684-1	73	1182	P42684-4	37	1043	+	36	P42684-1#43	0	1	P42684-4	596	597	+	1	0	0	3216
P42684-1#43	0	1	1	P42684-1	632	633	+	1	P42684-1	52	1182	P42684-3	37	1167	+	35	P42684-1#43	0	1	P42684-3	617	618	+	1	0	0	3217
P42684-1#43	0	1	1	P42684-1	632	633	+	1	P42684-1	73	1182	P42684-2	37	1146	+	34	P42684-1#43	0	1	P42684-2	596	597	+	1	0	0	3218
P42684-1#43	0	1	1	P42684-1	632	633	+	1	P42684-1	52	1182	P42684-10	37	1064	+	33	P42684-1#43	0	1	P42684-10	617	618	+	1	0	0	3219
P42684-1#43	0	1	1	P42684-1	632	633	+	1	P42684-1	0	1182	P42684-1	0	1182	+	32	P42684-1#43	0	1	P42684-1	632	633	+	1	0	0	3220
P42684-1#44	0	1	1	P42684-1	654	655	+	1	P42684-1	0	1182	P42684-7	0	1058	+	39	P42684-1#44	0	1	P42684-7	633	634	+	1	0	0	3221
P42684-1#44	0	1	1	P42684-1	654	655	+	1	P42684-1	0	1182	P42684-6	0	1161	+	38	P42684-1#44	0	1	P42684-6	633	634	+	1	0	0	3222
P42684-1#44	0	1	1	P42684-1	654	655	+	1	P42684-1	0	1182	P42684-5	0	1079	+	37	P42684-1#44	0	1	P42684-5	654	655	+	1	0	0	3223
P42684-1#44	0	1	1	P42684-1	654	655	+	1	P42684-1	73	1182	P42684-4	37	1043	+	36	P42684-1#44	0	1	P42684-4	618	619	+	1	0	0	3224
P42684-1#44	0	1	1	P42684-1	654	655	+	1	P42684-1	52	1182	P42684-3	37	1167	+	35	P42684-1#44	0	1	P42684-3	639	640	+	1	0	0	3225
P42684-1#44	0	1	1	P42684-1	654	655	+	1	P42684-1	73	1182	P42684-2	37	1146	+	34	P42684-1#44	0	1	P42684-2	618	619	+	1	0	0	3226
P42684-1#44	0	1	1	P42684-1	654	655	+	1	P42684-1	52	1182	P42684-10	37	1064	+	33	P42684-1#44	0	1	P42684-10	639	640	+	1	0	0	3227
P42684-1#44	0	1	1	P42684-1	654	655	+	1	P42684-1	0	1182	P42684-1	0	1182	+	32	P42684-1#44	0	1	P42684-1	654	655	+	1	0	0	3228
P42684-1#45	0	1	1	P42684-1	668	669	+	1	P42684-1	0	1182	P42684-7	0	1058	+	39	P42684-1#45	0	1	P42684-7	647	648	+	1	0	0	3229
P42684-1#45	0	1	1	P42684-1	668	669	+	1	P42684-1	0	1182	P42684-6	0	1161	+	38	P42684-1#45	0	1	P42684-6	647	648	+	1	0	0	3230
P42684-1#45	0	1	1	P42684-1	668	669	+	1	P42684-1	0	1182	P42684-5	0	1079	+	37	P42684-1#45	0	1	P42684-5	668	669	+	1	0	0	3231
P42684-1#45	0	1	1	P42684-1	668	669	+	1	P42684-1	73	1182	P42684-4	37	1043	+	36	P42684-1#45	0	1	P42684-4	632	633	+	1	0	0	3232
P42684-1#45	0	1	1	P42684-1	668	669	+	1	P42684-1	52	1182	P42684-3	37	1167	+	35	P42684-1#45	0	1	P42684-3	653	654	+	1	0	0	3233
P42684-1#45	0	1	1	P42684-1	668	669	+	1	P42684-1	73	1182	P42684-2	37	1146	+	34	P42684-1#45	0	1	P42684-2	632	633	+	1	0	0	3234
P42684-1#45	0	1	1	P42684-1	668	669	+	1	P42684-1	52	1182	P42684-10	37	1064	+	33	P42684-1#45	0	1	P42684-10	653	654	+	1	0	0	3235
P42684-1#45	0	1	1	P42684-1	668	669	+	1	P42684-1	0	1182	P42684-1	0	1182	+	32	P42684-1#45	0	1	P42684-1	668	669	+	1	0	0	3236
P42684-1#46	0	1	1	P42684-1	669	670	+	1	P42684-1	0	1182	P42684-7	0	1058	+	39	P42684-1#46	0	1	P42684-7	648	649	+	1	0	0	3237
P42684-1#46	0	1	1	P42684-1	669	670	+	1	P42684-1	0	1182	P42684-6	0	1161	+	38	P42684-1#46	0	1	P42684-6	648	649	+	1	0	0	3238
P42684-1#46	0	1	1	P42684-1	669	670	+	1	P42684-1	0	1182	P42684-5	0	1079	+	37	P42684-1#46	0	1	P42684-5	669	670	+	1	0	0	3239
P42684-1#46	0	1	1	P42684-1	669	670	+	1	P42684-1	73	1182	P42684-4	37	1043	+	36	P42684-1#46	0	1	P42684-4	633	634	+	1	0	0	3240
P42684-1#46	0	1	1	P42684-1	669	670	+	1	P42684-1	52	1182	P42684-3	37	1167	+	35	P42684-1#46	0	1	P42684-3	654	655	+	1	0	0	3241
P42684-1#46	0	1	1	P42684-1	669	670	+	1	P42684-1	73	1182	P42684-2	37	1146	+	34	P42684-1#46	0	1	P42684-2	633	634	+	1	0	0	3242
P42684-1#46	0	1	1	P42684-1	669	670	+	1	P42684-1	52	1182	P42684-10	37	1064	+	33	P42684-1#46	0	1	P42684-10	654	655	+	1	0	0	3243
P42684-1#46	0	1	1	P42684-1	669	670	+	1	P42684-1	0	1182	P42684-1	0	1182	+	32	P42684-1#46	0	1	P42684-1	669	670	+	1	0	0	3244
P42684-1#47	0	1	1	P42684-1	670	671	+	1	P42684-1	0	1182	P42684-7	0	1058	+	39	P42684-1#47	0	1	P42684-7	649	650	+	1	0	0	3245
P42684-1#47	0	1	1	P42684-1	670	671	+	1	P42684-1	0	1182	P42684-6	0	1161	+	38	P42684-1#47	0	1	P42684-6	649	650	+	1	0	0	3246
P42684-1#47	0	1	1	P42684-1	670	671	+	1	P42684-1	0	1182	P42684-5	0	1079	+	37	P42684-1#47	0	1	P42684-5	670	671	+	1	0	0	3247
P42684-1#47	0	1	1	P42684-1	670	671	+	1	P42684-1	73	1182	P42684-4	37	1043	+	36	P42684-1#47	0	1	P42684-4	634	635	+	1	0	0	3248
P42684-1#47	0	1	1	P42684-1	670	671	+	1	P42684-1	52	1182	P42684-3	37	1167	+	35	P42684-1#47	0	1	P42684-3	655	656	+	1	0	0	3249
P42684-1#47	0	1	1	P42684-1	670	671	+	1	P42684-1	73	1182	P42684-2	37	1146	+	34	P42684-1#47	0	1	P42684-2	634	635	+	1	0	0	3250
P42684-1#47	0	1	1	P42684-1	670	671	+	1	P42684-1	52	1182	P42684-10	37	1064	+	33	P42684-1#47	0	1	P42684-10	655	656	+	1	0	0	3251
P42684-1#47	0	1	1	P42684-1	670	671	+	1	P42684-1	0	1182	P42684-1	0	1182	+	32	P42684-1#47	0	1	P42684-1	670	671	+	1	0	0	3252
P42684-1#48	0	1	1	P42684-1	682	683	+	1	P42684-1	0	1182	P42684-7	0	1058	+	39	P42684-1#48	0	1	P42684-7	661	662	+	1	0	0	3253
P42684-1#48	0	1	1	P42684-1	682	683	+	1	P42684-1	0	1182	P42684-6	0	1161	+	38	P42684-1#48	0	1	P42684-6	661	662	+	1	0	0	3254
P42684-1#48	0	1	1	P42684-1	682	683	+	1	P42684-1	0	1182	P42684-5	0	1079	+	37	P42684-1#48	0	1	P42684-5	682	683	+	1	0	0	3255
P42684-1#48	0	1	1	P42684-1	682	683	+	1	P42684-1	73	1182	P42684-4	37	1043	+	36	P42684-1#48	0	1	P42684-4	646	647	+	1	0	0	3256
P42684-1#48	0	1	1	P42684-1	682	683	+	1	P42684-1	52	1182	P42684-3	37	1167	+	35	P42684-1#48	0	1	P42684-3	667	668	+	1	0	0	3257
P42684-1#48	0	1	1	P42684-1	682	683	+	1	P42684-1	73	1182	P42684-2	37	1146	+	34	P42684-1#48	0	1	P42684-2	646	647	+	1	0	0	3258
P42684-1#48	0	1	1	P42684-1	682	683	+	1	P42684-1	52	1182	P42684-10	37	1064	+	33	P42684-1#48	0	1	P42684-10	667	668	+	1	0	0	3259
P42684-1#48	0	1	1	P42684-1	682	683	+	1	P42684-1	0	1182	P42684-1	0	1182	+	32	P42684-1#48	0	1	P42684-1	682	683	+	1	0	0	3260
P42684-1#49	0	1	1	P42684-1	717	718	+	1	P42684-1	0	1182	P42684-6	0	1161	+	38	P42684-1#49	0	1	P42684-6	696	697	+	1	0	0	3261
P42684-1#49	0	1	1	P42684-1	717	718	+	1	P42684-1	52	1182	P42684-3	37	1167	+	35	P42684-1#49	0	1	P42684-3	702	703	+	1	0	0	3262
P42684-1#49	0	1	1	P42684-1	717	718	+	1	P42684-1	73	1182	P42684-2	37	1146	+	34	P42684-1#49	0	1	P42684-2	681	682	+	1	0	0	3263
P42684-1#49	0	1	1	P42684-1	717	718	+	1	P42684-1	0	1182	P42684-1	0	1182	+	32	P42684-1#49	0	1	P42684-1	717	718	+	1	0	0	3264
P42684-1#50	0	1	1	P42684-1	775	776	+	1	P42684-1	0	1182	P42684-6	0	1161	+	38	P42684-1#50	0	1	P42684-6	754	755	+	1	0	0	3265
P42684-1#50	0	1	1	P42684-1	775	776	+	1	P42684-1	52	1182	P42684-3	37	1167	+	35	P42684-1#50	0	1	P42684-3	760	761	+	1	0	0	3266
P42684-1#50	0	1	1	P42684-1	775	776	+	1	P42684-1	73	1182	P42684-2	37	1146	+	34	P42684-1#50	0	1	P42684-2	739	740	+	1	0	0	3267
P42684-1#50	0	1	1	P42684-1	775	776	+	1	P42684-1	0	1182	P42684-1	0	1182	+	32	P42684-1#50	0	1	P42684-1	775	776	+	1	0	0	3268
P42684-1#51	0	1	1	P42684-1	782	783	+	1	P42684-1	0	1182	P42684-6	0	1161	+	38	P42684-1#51	0	1	P42684-6	761	762	+	1	0	0	3269
P42684-1#51	0	1	1	P42684-1	782	783	+	1	P42684-1	52	1182	P42684-3	37	1167	+	35	P42684-1#51	0	1	P42684-3	767	768	+	1	0	0	3270
P42684-1#51	0	1	1	P42684-1	782	783	+	1	P42684-1	73	1182	P42684-2	37	1146	+	34	P42684-1#51	0	1	P42684-2	746	747	+	1	0	0	3271
P42684-1#51	0	1	1	P42684-1	782	783	+	1	P42684-1	0	1182	P42684-1	0	1182	+	32	P42684-1#51	0	1	P42684-1	782	783	+	1	0	0	3272
P42684-1#52	0	1	1	P42684-1	799	800	+	1	P42684-1	0	1182	P42684-7	0	1058	+	39	P42684-1#52	0	1	P42684-7	675	676	+	1	0	0	3273
P42684-1#52	0	1	1	P42684-1	799	800	+	1	P42684-1	0	1182	P42684-6	0	1161	+	38	P42684-1#52	0	1	P42684-6	778	779	+	1	0	0	3274
P42684-1#52	0	1	1	P42684-1	799	800	+	1	P42684-1	0	1182	P42684-5	0	1079	+	37	P42684-1#52	0	1	P42684-5	696	697	+	1	0	0	3275
P42684-1#52	0	1	1	P42684-1	799	800	+	1	P42684-1	73	1182	P42684-4	37	1043	+	36	P42684-1#52	0	1	P42684-4	660	661	+	1	0	0	3276
P42684-1#52	0	1	1	P42684-1	799	800	+	1	P42684-1	52	1182	P42684-3	37	1167	+	35	P42684-1#52	0	1	P42684-3	784	785	+	1	0	0	3277
P42684-1#52	0	1	1	P42684-1	799	800	+	1	P42684-1	73	1182	P42684-2	37	1146	+	34	P42684-1#52	0	1	P42684-2	763	764	+	1	0	0	3278
P42684-1#52	0	1	1	P42684-1	799	800	+	1	P42684-1	52	1182	P42684-10	37	1064	+	33	P42684-1#52	0	1	P42684-10	681	682	+	1	0	0	3279
P42684-1#52	0	1	1	P42684-1	799	800	+	1	P42684-1	0	1182	P42684-1	0	1182	+	32	P42684-1#52	0	1	P42684-1	799	800	+	1	0	0	3280
P42684-1#53	0	1	1	P42684-1	816	817	+	1	P42684-1	0	1182	P42684-7	0	1058	+	39	P42684-1#53	0	1	P42684-7	692	693	+	1	0	0	3281
P42684-1#53	0	1	1	P42684-1	816	817	+	1	P42684-1	0	1182	P42684-6	0	1161	+	38	P42684-1#53	0	1	P42684-6	795	796	+	1	0	0	3282
P42684-1#53	0	1	1	P42684-1	816	817	+	1	P42684-1	0	1182	P42684-5	0	1079	+	37	P42684-1#53	0	1	P42684-5	713	714	+	1	0	0	3283
P42684-1#53	0	1	1	P42684-1	816	817	+	1	P42684-1	73	1182	P42684-4	37	1043	+	36	P42684-1#53	0	1	P42684-4	677	678	+	1	0	0	3284
P42684-1#53	0	1	1	P42684-1	816	817	+	1	P42684-1	52	1182	P42684-3	37	1167	+	35	P42684-1#53	0	1	P42684-3	801	802	+	1	0	0	3285
P42684-1#53	0	1	1	P42684-1	816	817	+	1	P42684-1	73	1182	P42684-2	37	1146	+	34	P42684-1#53	0	1	P42684-2	780	781	+	1	0	0	3286
P42684-1#53	0	1	1	P42684-1	816	817	+	1	P42684-1	52	1182	P42684-10	37	1064	+	33	P42684-1#53	0	1	P42684-10	698	699	+	1	0	0	3287
P42684-1#53	0	1	1	P42684-1	816	817	+	1	P42684-1	0	1182	P42684-1	0	1182	+	32	P42684-1#53	0	1	P42684-1	816	817	+	1	0	0	3288
P42684-1#54	0	1	1	P42684-1	819	820	+	1	P42684-1	0	1182	P42684-7	0	1058	+	39	P42684-1#54	0	1	P42684-7	695	696	+	1	0	0	3289
P42684-1#54	0	1	1	P42684-1	819	820	+	1	P42684-1	0	1182	P42684-6	0	1161	+	38	P42684-1#54	0	1	P42684-6	798	799	+	1	0	0	3290
P42684-1#54	0	1	1	P42684-1	819	820	+	1	P42684-1	0	1182	P42684-5	0	1079	+	37	P42684-1#54	0	1	P42684-5	716	717	+	1	0	0	3291
P42684-1#54	0	1	1	P42684-1	819	820	+	1	P42684-1	73	1182	P42684-4	37	1043	+	36	P42684-1#54	0	1	P42684-4	680	681	+	1	0	0	3292
P42684-1#54	0	1	1	P42684-1	819	820	+	1	P42684-1	52	1182	P42684-3	37	1167	+	35	P42684-1#54	0	1	P42684-3	804	805	+	1	0	0	3293
P42684-1#54	0	1	1	P42684-1	819	820	+	1	P42684-1	73	1182	P42684-2	37	1146	+	34	P42684-1#54	0	1	P42684-2	783	784	+	1	0	0	3294
P42684-1#54	0	1	1	P42684-1	819	820	+	1	P42684-1	52	1182	P42684-10	37	1064	+	33	P42684-1#54	0	1	P42684-10	701	702	+	1	0	0	3295
P42684-1#54	0	1	1	P42684-1	819	820	+	1	P42684-1	0	1182	P42684-1	0	1182	+	32	P42684-1#54	0	1	P42684-1	819	820	+	1	0	0	3296
P42684-1#55	0	1	1	P42684-1	914	915	+	1	P42684-1	0	1182	P42684-7	0	1058	+	39	P42684-1#55	0	1	P42684-7	790	791	+	1	0	0	3297
P42684-1#55	0	1	1	P42684-1	914	915	+	1	P42684-1	0	1182	P42684-6	0	1161	+	38	P42684-1#55	0	1	P42684-6	893	894	+	1	0	0	3298
P42684-1#55	0	1	1	P42684-1	914	915	+	1	P42684-1	0	1182	P42684-5	0	1079	+	37	P42684-1#55	0	1	P42684-5	811	812	+	1	0	0	3299
P42684-1#55	0	1	1	P42684-1	914	915	+	1	P42684-1	73	1182	P42684-4	37	1043	+	36	P42684-1#55	0	1	P42684-4	775	776	+	1	0	0	3300
P42684-1#55	0	1	1	P42684-1	914	915	+	1	P42684-1	52	1182	P42684-3	37	1167	+	35	P42684-1#55	0	1	P42684-3	899	900	+	1	0	0	3301
P42684-1#55	0	1	1	P42684-1	914	915	+	1	P42684-1	73	1182	P42684-2	37	1146	+	34	P42684-1#55	0	1	P42684-2	878	879	+	1	0	0	3302
P42684-1#55	0	1	1	P42684-1	914	915	+	1	P42684-1	52	1182	P42684-10	37	1064	+	33	P42684-1#55	0	1	P42684-10	796	797	+	1	0	0	3303
P42684-1#55	0	1	1	P42684-1	914	915	+	1	P42684-1	0	1182	P42684-1	0	1182	+	32	P42684-1#55	0	1	P42684-1	914	915	+	1	0	0	3304
P42684-1#56	0	1	1	P42684-1	935	936	+	1	P42684-1	0	1182	P42684-7	0	1058	+	39	P42684-1#56	0	1	P42684-7	811	812	+	1	0	0	3305
P42684-1#56	0	1	1	P42684-1	935	936	+	1	P42684-1	0	1182	P42684-6	0	1161	+	38	P42684-1#56	0	1	P42684-6	914	915	+	1	0	0	3306
P42684-1#56	0	1	1	P42684-1	935	936	+	1	P42684-1	0	1182	P42684-5	0	1079	+	37	P42684-1#56	0	1	P42684-5	832	833	+	1	0	0	3307
P42684-1#56	0	1	1	P42684-1	935	936	+	1	P42684-1	73	1182	P42684-4	37	1043	+	36	P42684-1#56	0	1	P42684-4	796	797	+	1	0	0	3308
P42684-1#56	0	1	1	P42684-1	935	936	+	1	P42684-1	52	1182	P42684-3	37	1167	+	35	P42684-1#56	0	1	P42684-3	920	921	+	1	0	0	3309
P42684-1#56	0	1	1	P42684-1	935	936	+	1	P42684-1	73	1182	P42684-2	37	1146	+	34	P42684-1#56	0	1	P42684-2	899	900	+	1	0	0	3310
P42684-1#56	0	1	1	P42684-1	935	936	+	1	P42684-1	52	1182	P42684-10	37	1064	+	33	P42684-1#56	0	1	P42684-10	817	818	+	1	0	0	3311
P42684-1#56	0	1	1	P42684-1	935	936	+	1	P42684-1	0	1182	P42684-1	0	1182	+	32	P42684-1#56	0	1	P42684-1	935	936	+	1	0	0	3312
P42684-1#57	0	1	1	P42684-1	1	2	+	1	P42684-1	0	550	P42684-8	0	529	+	40	P42684-1#57	0	1	P42684-8	1	2	+	1	0	0	3313
P42684-1#57	0	1	1	P42684-1	1	2	+	1	P42684-1	0	1182	P42684-7	0	1058	+	39	P42684-1#57	0	1	P42684-7	1	2	+	1	0	0	3314
P42684-1#57	0	1	1	P42684-1	1	2	+	1	P42684-1	0	1182	P42684-6	0	1161	+	38	P42684-1#57	0	1	P42684-6	1	2	+	1	0	0	3315
P42684-1#57	0	1	1	P42684-1	1	2	+	1	P42684-1	0	1182	P42684-5	0	1079	+	37	P42684-1#57	0	1	P42684-5	1	2	+	1	0	0	3316
P42684-1#57	0	1	1	P42684-1	1	2	+	1	P42684-1	0	1182	P42684-1	0	1182	+	32	P42684-1#57	0	1	P42684-1	1	2	+	1	0	0	3317
P42684-1#58	0	73	73	P42684-1	0	73	+	73	P42684-1	0	550	P42684-8	0	529	+	40	P42684-1#58	0	52	P42684-8	0	52	+	52	0	21	3318
P42684-1#58	0	73	73	P42684-1	0	73	+	73	P42684-1	0	1182	P42684-7	0	1058	+	39	P42684-1#58	0	52	P42684-7	0	52	+	52	0	21	3319
P42684-1#58	0	73	73	P42684-1	0	73	+	73	P42684-1	0	1182	P42684-6	0	1161	+	38	P42684-1#58	0	52	P42684-6	0	52	+	52	0	21	3320
P42684-1#58	0	73	73	P42684-1	0	73	+	73	P42684-1	0	1182	P42684-5	0	1079	+	37	P42684-1#58	0	73	P42684-5	0	73	+	73	0	0	3321
P42684-1#58	0	73	73	P42684-1	0	73	+	73	P42684-1	52	1182	P42684-3	37	1167	+	35	P42684-1#58	52	73	P42684-3	37	58	+	21	52	0	3322
P42684-1#58	0	73	73	P42684-1	0	73	+	73	P42684-1	52	1182	P42684-10	37	1064	+	33	P42684-1#58	52	73	P42684-10	37	58	+	21	52	0	3323
P42684-1#58	0	73	73	P42684-1	0	73	+	73	P42684-1	0	1182	P42684-1	0	1182	+	32	P42684-1#58	0	73	P42684-1	0	73	+	73	0	0	3324
P42684-1#59	0	52	52	P42684-1	0	52	+	52	P42684-1	0	550	P42684-8	0	529	+	40	P42684-1#59	0	52	P42684-8	0	52	+	52	0	0	3325
P42684-1#59	0	52	52	P42684-1	0	52	+	52	P42684-1	0	1182	P42684-7	0	1058	+	39	P42684-1#59	0	52	P42684-7	0	52	+	52	0	0	3326
P42684-1#59	0	52	52	P42684-1	0	52	+	52	P42684-1	0	1182	P42684-6	0	1161	+	38	P42684-1#59	0	52	P42684-6	0	52	+	52	0	0	3327
P42684-1#59	0	52	52	P42684-1	0	52	+	52	P42684-1	0	1182	P42684-5	0	1079	+	37	P42684-1#59	0	52	P42684-5	0	52	+	52	0	0	3328
P42684-1#59	0	52	52	P42684-1	0	52	+	52	P42684-1	0	1182	P42684-1	0	1182	+	32	P42684-1#59	0	52	P42684-1	0	52	+	52	0	0	3329
P42684-1#60	0	21	21	P42684-1	52	73	+	21	P42684-1	0	1182	P42684-5	0	1079	+	37	P42684-1#60	0	21	P42684-5	52	73	+	21	0	0	3330
P42684-1#60	0	21	21	P42684-1	52	73	+	21	P42684-1	52	1182	P42684-3	37	1167	+	35	P42684-1#60	0	21	P42684-3	37	58	+	21	0	0	3331
P42684-1#60	0	21	21	P42684-1	52	73	+	21	P42684-1	52	1182	P42684-10	37	1064	+	33	P42684-1#60	0	21	P42684-10	37	58	+	21	0	0	3332
P42684-1#60	0	21	21	P42684-1	52	73	+	21	P42684-1	0	1182	P42684-1	0	1182	+	32	P42684-1#60	0	21	P42684-1	52	73	+	21	0	0	3333
P42684-1#61	0	15	15	P42684-1	549	564	+	15	P42684-1	0	550	P42684-8	0	529	+	40	P42684-1#61	0	1	P42684-8	528	529	+	1	0	14	3334
P42684-1#61	0	15	15	P42684-1	549	564	+	15	P42684-1	0	1182	P42684-7	0	1058	+	39	P42684-1#61	0	15	P42684-7	528	543	+	15	0	0	3335
P42684-1#61	0	15	15	P42684-1	549	564	+	15	P42684-1	0	1182	P42684-6	0	1161	+	38	P42684-1#61	0	15	P42684-6	528	543	+	15	0	0	3336
P42684-1#61	0	15	15	P42684-1	549	564	+	15	P42684-1	0	1182	P42684-5	0	1079	+	37	P42684-1#61	0	15	P42684-5	549	564	+	15	0	0	3337
P42684-1#61	0	15	15	P42684-1	549	564	+	15	P42684-1	73	1182	P42684-4	37	1043	+	36	P42684-1#61	0	15	P42684-4	513	528	+	15	0	0	3338
P42684-1#61	0	15	15	P42684-1	549	564	+	15	P42684-1	52	1182	P42684-3	37	1167	+	35	P42684-1#61	0	15	P42684-3	534	549	+	15	0	0	3339
P42684-1#61	0	15	15	P42684-1	549	564	+	15	P42684-1	73	1182	P42684-2	37	1146	+	34	P42684-1#61	0	15	P42684-2	513	528	+	15	0	0	3340
P42684-1#61	0	15	15	P42684-1	549	564	+	15	P42684-1	52	1182	P42684-10	37	1064	+	33	P42684-1#61	0	15	P42684-10	534	549	+	15	0	0	3341
P42684-1#61	0	15	15	P42684-1	549	564	+	15	P42684-1	0	1182	P42684-1	0	1182	+	32	P42684-1#61	0	15	P42684-1	549	564	+	15	0	0	3342
P42684-1#62	0	618	618	P42684-1	564	1182	+	618	P42684-1	0	1182	P42684-7	0	1058	+	39	P42684-1#62	0	618	P42684-7	543	1058	+	515	0	0	3343
P42684-1#62	0	618	618	P42684-1	564	1182	+	618	P42684-1	0	1182	P42684-6	0	1161	+	38	P42684-1#62	0	618	P42684-6	543	1161	+	618	0	0	3344
P42684-1#62	0	618	618	P42684-1	564	1182	+	618	P42684-1	0	1182	P42684-5	0	1079	+	37	P42684-1#62	0	618	P42684-5	564	1079	+	515	0	0	3345
P42684-1#62	0	618	618	P42684-1	564	1182	+	618	P42684-1	73	1182	P42684-4	37	1043	+	36	P42684-1#62	0	618	P42684-4	528	1043	+	515	0	0	3346
P42684-1#62	0	618	618	P42684-1	564	1182	+	618	P42684-1	52	1182	P42684-3	37	1167	+	35	P42684-1#62	0	618	P42684-3	549	1167	+	618	0	0	3347
P42684-1#62	0	618	618	P42684-1	564	1182	+	618	P42684-1	73	1182	P42684-2	37	1146	+	34	P42684-1#62	0	618	P42684-2	528	1146	+	618	0	0	3348
P42684-1#62	0	618	618	P42684-1	564	1182	+	618	P42684-1	52	1182	P42684-10	37	1064	+	33	P42684-1#62	0	618	P42684-10	549	1064	+	515	0	0	3349
P42684-1#62	0	618	618	P42684-1	564	1182	+	618	P42684-1	0	1182	P42684-1	0	1182	+	32	P42684-1#62	0	618	P42684-1	564	1182	+	618	0	0	3350
P42684-1#63	0	103	103	P42684-1	687	790	+	103	P42684-1	0	1182	P42684-7	0	1058	+	39	P42684-1#63	102	103	P42684-7	665	666	+	1	102	0	3351
P42684-1#63	0	103	103	P42684-1	687	790	+	103	P42684-1	0	1182	P42684-6	0	1161	+	38	P42684-1#63	0	103	P42684-6	666	769	+	103	0	0	3352
P42684-1#63	0	103	103	P42684-1	687	790	+	103	P42684-1	0	1182	P42684-5	0	1079	+	37	P42684-1#63	102	103	P42684-5	686	687	+	1	102	0	3353
P42684-1#63	0	103	103	P42684-1	687	790	+	103	P42684-1	73	1182	P42684-4	37	1043	+	36	P42684-1#63	102	103	P42684-4	650	651	+	1	102	0	3354
P42684-1#63	0	103	103	P42684-1	687	790	+	103	P42684-1	52	1182	P42684-3	37	1167	+	35	P42684-1#63	0	103	P42684-3	672	775	+	103	0	0	3355
P42684-1#63	0	103	103	P42684-1	687	790	+	103	P42684-1	73	1182	P42684-2	37	1146	+	34	P42684-1#63	0	103	P42684-2	651	754	+	103	0	0	3356
P42684-1#63	0	103	103	P42684-1	687	790	+	103	P42684-1	52	1182	P42684-10	37	1064	+	33	P42684-1#63	102	103	P42684-10	671	672	+	1	102	0	3357
P42684-1#63	0	103	103	P42684-1	687	790	+	103	P42684-1	0	1182	P42684-1	0	1182	+	32	P42684-1#63	0	103	P42684-1	687	790	+	103	0	0	3358
P42684-1#64	0	1	1	P42684-1	77	78	+	1	P42684-1	0	550	P42684-8	0	529	+	40	P42684-1#64	0	1	P42684-8	56	57	+	1	0	0	3359
P42684-1#64	0	1	1	P42684-1	77	78	+	1	P42684-1	0	1182	P42684-7	0	1058	+	39	P42684-1#64	0	1	P42684-7	56	57	+	1	0	0	3360
P42684-1#64	0	1	1	P42684-1	77	78	+	1	P42684-1	0	1182	P42684-6	0	1161	+	38	P42684-1#64	0	1	P42684-6	56	57	+	1	0	0	3361
P42684-1#64	0	1	1	P42684-1	77	78	+	1	P42684-1	0	1182	P42684-5	0	1079	+	37	P42684-1#64	0	1	P42684-5	77	78	+	1	0	0	3362
P42684-1#64	0	1	1	P42684-1	77	78	+	1	P42684-1	73	1182	P42684-4	37	1043	+	36	P42684-1#64	0	1	P42684-4	41	42	+	1	0	0	3363
P42684-1#64	0	1	1	P42684-1	77	78	+	1	P42684-1	52	1182	P42684-3	37	1167	+	35	P42684-1#64	0	1	P42684-3	62	63	+	1	0	0	3364
P42684-1#64	0	1	1	P42684-1	77	78	+	1	P42684-1	73	1182	P42684-2	37	1146	+	34	P42684-1#64	0	1	P42684-2	41	42	+	1	0	0	3365
P42684-1#64	0	1	1	P42684-1	77	78	+	1	P42684-1	52	1182	P42684-10	37	1064	+	33	P42684-1#64	0	1	P42684-10	62	63	+	1	0	0	3366
P42684-1#64	0	1	1	P42684-1	77	78	+	1	P42684-1	0	1182	P42684-1	0	1182	+	32	P42684-1#64	0	1	P42684-1	77	78	+	1	0	0	3367
P42684-1#65	0	1	1	P42684-1	98	99	+	1	P42684-1	0	550	P42684-8	0	529	+	40	P42684-1#65	0	1	P42684-8	77	78	+	1	0	0	3368
P42684-1#65	0	1	1	P42684-1	98	99	+	1	P42684-1	0	1182	P42684-7	0	1058	+	39	P42684-1#65	0	1	P42684-7	77	78	+	1	0	0	3369
P42684-1#65	0	1	1	P42684-1	98	99	+	1	P42684-1	0	1182	P42684-6	0	1161	+	38	P42684-1#65	0	1	P42684-6	77	78	+	1	0	0	3370
P42684-1#65	0	1	1	P42684-1	98	99	+	1	P42684-1	0	1182	P42684-5	0	1079	+	37	P42684-1#65	0	1	P42684-5	98	99	+	1	0	0	3371
P42684-1#65	0	1	1	P42684-1	98	99	+	1	P42684-1	73	1182	P42684-4	37	1043	+	36	P42684-1#65	0	1	P42684-4	62	63	+	1	0	0	3372
P42684-1#65	0	1	1	P42684-1	98	99	+	1	P42684-1	52	1182	P42684-3	37	1167	+	35	P42684-1#65	0	1	P42684-3	83	84	+	1	0	0	3373
P42684-1#65	0	1	1	P42684-1	98	99	+	1	P42684-1	73	1182	P42684-2	37	1146	+	34	P42684-1#65	0	1	P42684-2	62	63	+	1	0	0	3374
P42684-1#65	0	1	1	P42684-1	98	99	+	1	P42684-1	52	1182	P42684-10	37	1064	+	33	P42684-1#65	0	1	P42684-10	83	84	+	1	0	0	3375
P42684-1#65	0	1	1	P42684-1	98	99	+	1	P42684-1	0	1182	P42684-1	0	1182	+	32	P42684-1#65	0	1	P42684-1	98	99	+	1	0	0	3376
P42684-1#66	0	1	1	P42684-1	518	519	+	1	P42684-1	0	550	P42684-8	0	529	+	40	P42684-1#66	0	1	P42684-8	497	498	+	1	0	0	3377
P42684-1#66	0	1	1	P42684-1	518	519	+	1	P42684-1	0	1182	P42684-7	0	1058	+	39	P42684-1#66	0	1	P42684-7	497	498	+	1	0	0	3378
P42684-1#66	0	1	1	P42684-1	518	519	+	1	P42684-1	0	1182	P42684-6	0	1161	+	38	P42684-1#66	0	1	P42684-6	497	498	+	1	0	0	3379
P42684-1#66	0	1	1	P42684-1	518	519	+	1	P42684-1	0	1182	P42684-5	0	1079	+	37	P42684-1#66	0	1	P42684-5	518	519	+	1	0	0	3380
P42684-1#66	0	1	1	P42684-1	518	519	+	1	P42684-1	73	1182	P42684-4	37	1043	+	36	P42684-1#66	0	1	P42684-4	482	483	+	1	0	0	3381
P42684-1#66	0	1	1	P42684-1	518	519	+	1	P42684-1	52	1182	P42684-3	37	1167	+	35	P42684-1#66	0	1	P42684-3	503	504	+	1	0	0	3382
P42684-1#66	0	1	1	P42684-1	518	519	+	1	P42684-1	73	1182	P42684-2	37	1146	+	34	P42684-1#66	0	1	P42684-2	482	483	+	1	0	0	3383
P42684-1#66	0	1	1	P42684-1	518	519	+	1	P42684-1	52	1182	P42684-10	37	1064	+	33	P42684-1#66	0	1	P42684-10	503	504	+	1	0	0	3384
P42684-1#66	0	1	1	P42684-1	518	519	+	1	P42684-1	0	1182	P42684-1	0	1182	+	32	P42684-1#66	0	1	P42684-1	518	519	+	1	0	0	3385
P42684-1#67	0	1	1	P42684-1	768	769	+	1	P42684-1	0	1182	P42684-6	0	1161	+	38	P42684-1#67	0	1	P42684-6	747	748	+	1	0	0	3386
P42684-1#67	0	1	1	P42684-1	768	769	+	1	P42684-1	52	1182	P42684-3	37	1167	+	35	P42684-1#67	0	1	P42684-3	753	754	+	1	0	0	3387
P42684-1#67	0	1	1	P42684-1	768	769	+	1	P42684-1	73	1182	P42684-2	37	1146	+	34	P42684-1#67	0	1	P42684-2	732	733	+	1	0	0	3388
P42684-1#67	0	1	1	P42684-1	768	769	+	1	P42684-1	0	1182	P42684-1	0	1182	+	32	P42684-1#67	0	1	P42684-1	768	769	+	1	0	0	3389
P42684-1#68	0	1	1	P42684-1	929	930	+	1	P42684-1	0	1182	P42684-7	0	1058	+	39	P42684-1#68	0	1	P42684-7	805	806	+	1	0	0	3390
P42684-1#68	0	1	1	P42684-1	929	930	+	1	P42684-1	0	1182	P42684-6	0	1161	+	38	P42684-1#68	0	1	P42684-6	908	909	+	1	0	0	3391
P42684-1#68	0	1	1	P42684-1	929	930	+	1	P42684-1	0	1182	P42684-5	0	1079	+	37	P42684-1#68	0	1	P42684-5	826	827	+	1	0	0	3392
P42684-1#68	0	1	1	P42684-1	929	930	+	1	P42684-1	73	1182	P42684-4	37	1043	+	36	P42684-1#68	0	1	P42684-4	790	791	+	1	0	0	3393
P42684-1#68	0	1	1	P42684-1	929	930	+	1	P42684-1	52	1182	P42684-3	37	1167	+	35	P42684-1#68	0	1	P42684-3	914	915	+	1	0	0	3394
P42684-1#68	0	1	1	P42684-1	929	930	+	1	P42684-1	73	1182	P42684-2	37	1146	+	34	P42684-1#68	0	1	P42684-2	893	894	+	1	0	0	3395
P42684-1#68	0	1	1	P42684-1	929	930	+	1	P42684-1	52	1182	P42684-10	37	1064	+	33	P42684-1#68	0	1	P42684-10	811	812	+	1	0	0	3396
P42684-1#68	0	1	1	P42684-1	929	930	+	1	P42684-1	0	1182	P42684-1	0	1182	+	32	P42684-1#68	0	1	P42684-1	929	930	+	1	0	0	3397
P42684-1#69	0	1	1	P42684-1	945	946	+	1	P42684-1	0	1182	P42684-7	0	1058	+	39	P42684-1#69	0	1	P42684-7	821	822	+	1	0	0	3398
P42684-1#69	0	1	1	P42684-1	945	946	+	1	P42684-1	0	1182	P42684-6	0	1161	+	38	P42684-1#69	0	1	P42684-6	924	925	+	1	0	0	3399
P42684-1#69	0	1	1	P42684-1	945	946	+	1	P42684-1	0	1182	P42684-5	0	1079	+	37	P42684-1#69	0	1	P42684-5	842	843	+	1	0	0	3400
P42684-1#69	0	1	1	P42684-1	945	946	+	1	P42684-1	73	1182	P42684-4	37	1043	+	36	P42684-1#69	0	1	P42684-4	806	807	+	1	0	0	3401
P42684-1#69	0	1	1	P42684-1	945	946	+	1	P42684-1	52	1182	P42684-3	37	1167	+	35	P42684-1#69	0	1	P42684-3	930	931	+	1	0	0	3402
P42684-1#69	0	1	1	P42684-1	945	946	+	1	P42684-1	73	1182	P42684-2	37	1146	+	34	P42684-1#69	0	1	P42684-2	909	910	+	1	0	0	3403
P42684-1#69	0	1	1	P42684-1	945	946	+	1	P42684-1	52	1182	P42684-10	37	1064	+	33	P42684-1#69	0	1	P42684-10	827	828	+	1	0	0	3404
P42684-1#69	0	1	1	P42684-1	945	946	+	1	P42684-1	0	1182	P42684-1	0	1182	+	32	P42684-1#69	0	1	P42684-1	945	946	+	1	0	0	3405
P42684-1#70	0	1	1	P42684-1	995	996	+	1	P42684-1	0	1182	P42684-7	0	1058	+	39	P42684-1#70	0	1	P42684-7	871	872	+	1	0	0	3406
P42684-1#70	0	1	1	P42684-1	995	996	+	1	P42684-1	0	1182	P42684-6	0	1161	+	38	P42684-1#70	0	1	P42684-6	974	975	+	1	0	0	3407
P42684-1#70	0	1	1	P42684-1	995	996	+	1	P42684-1	0	1182	P42684-5	0	1079	+	37	P42684-1#70	0	1	P42684-5	892	893	+	1	0	0	3408
P42684-1#70	0	1	1	P42684-1	995	996	+	1	P42684-1	73	1182	P42684-4	37	1043	+	36	P42684-1#70	0	1	P42684-4	856	857	+	1	0	0	3409
P42684-1#70	0	1	1	P42684-1	995	996	+	1	P42684-1	52	1182	P42684-3	37	1167	+	35	P42684-1#70	0	1	P42684-3	980	981	+	1	0	0	3410
P42684-1#70	0	1	1	P42684-1	995	996	+	1	P42684-1	73	1182	P42684-2	37	1146	+	34	P42684-1#70	0	1	P42684-2	959	960	+	1	0	0	3411
P42684-1#70	0	1	1	P42684-1	995	996	+	1	P42684-1	52	1182	P42684-10	37	1064	+	33	P42684-1#70	0	1	P42684-10	877	878	+	1	0	0	3412
P42684-1#70	0	1	1	P42684-1	995	996	+	1	P42684-1	0	1182	P42684-1	0	1182	+	32	P42684-1#70	0	1	P42684-1	995	996	+	1	0	0	3413
P42684-1#71	0	1	1	P42684-1	1084	1085	+	1	P42684-1	0	1182	P42684-7	0	1058	+	39	P42684-1#71	0	1	P42684-7	960	961	+	1	0	0	3414
P42684-1#71	0	1	1	P42684-1	1084	1085	+	1	P42684-1	0	1182	P42684-6	0	1161	+	38	P42684-1#71	0	1	P42684-6	1063	1064	+	1	0	0	3415
P42684-1#71	0	1	1	P42684-1	1084	1085	+	1	P42684-1	0	1182	P42684-5	0	1079	+	37	P42684-1#71	0	1	P42684-5	981	982	+	1	0	0	3416
P42684-1#71	0	1	1	P42684-1	1084	1085	+	1	P42684-1	73	1182	P42684-4	37	1043	+	36	P42684-1#71	0	1	P42684-4	945	946	+	1	0	0	3417
P42684-1#71	0	1	1	P42684-1	1084	1085	+	1	P42684-1	52	1182	P42684-3	37	1167	+	35	P42684-1#71	0	1	P42684-3	1069	1070	+	1	0	0	3418
P42684-1#71	0	1	1	P42684-1	1084	1085	+	1	P42684-1	73	1182	P42684-2	37	1146	+	34	P42684-1#71	0	1	P42684-2	1048	1049	+	1	0	0	3419
P42684-1#71	0	1	1	P42684-1	1084	1085	+	1	P42684-1	52	1182	P42684-10	37	1064	+	33	P42684-1#71	0	1	P42684-10	966	967	+	1	0	0	3420
P42684-1#71	0	1	1	P42684-1	1084	1085	+	1	P42684-1	0	1182	P42684-1	0	1182	+	32	P42684-1#71	0	1	P42684-1	1084	1085	+	1	0	0	3421
P42684-1#72	0	1	1	P42684-1	1100	1101	+	1	P42684-1	0	1182	P42684-7	0	1058	+	39	P42684-1#72	0	1	P42684-7	976	977	+	1	0	0	3422
P42684-1#72	0	1	1	P42684-1	1100	1101	+	1	P42684-1	0	1182	P42684-6	0	1161	+	38	P42684-1#72	0	1	P42684-6	1079	1080	+	1	0	0	3423
P42684-1#72	0	1	1	P42684-1	1100	1101	+	1	P42684-1	0	1182	P42684-5	0	1079	+	37	P42684-1#72	0	1	P42684-5	997	998	+	1	0	0	3424
P42684-1#72	0	1	1	P42684-1	1100	1101	+	1	P42684-1	73	1182	P42684-4	37	1043	+	36	P42684-1#72	0	1	P42684-4	961	962	+	1	0	0	3425
P42684-1#72	0	1	1	P42684-1	1100	1101	+	1	P42684-1	52	1182	P42684-3	37	1167	+	35	P42684-1#72	0	1	P42684-3	1085	1086	+	1	0	0	3426
P42684-1#72	0	1	1	P42684-1	1100	1101	+	1	P42684-1	73	1182	P42684-2	37	1146	+	34	P42684-1#72	0	1	P42684-2	1064	1065	+	1	0	0	3427
P42684-1#72	0	1	1	P42684-1	1100	1101	+	1	P42684-1	52	1182	P42684-10	37	1064	+	33	P42684-1#72	0	1	P42684-10	982	983	+	1	0	0	3428
P42684-1#72	0	1	1	P42684-1	1100	1101	+	1	P42684-1	0	1182	P42684-1	0	1182	+	32	P42684-1#72	0	1	P42684-1	1100	1101	+	1	0	0	3429
P42684-1#73	0	2	2	P42684-1	342	344	+	2	P42684-1	0	550	P42684-8	0	529	+	40	P42684-1#73	0	2	P42684-8	321	323	+	2	0	0	3430
P42684-1#73	0	2	2	P42684-1	342	344	+	2	P42684-1	0	1182	P42684-7	0	1058	+	39	P42684-1#73	0	2	P42684-7	321	323	+	2	0	0	3431
P42684-1#73	0	2	2	P42684-1	342	344	+	2	P42684-1	0	1182	P42684-6	0	1161	+	38	P42684-1#73	0	2	P42684-6	321	323	+	2	0	0	3432
P42684-1#73	0	2	2	P42684-1	342	344	+	2	P42684-1	0	1182	P42684-5	0	1079	+	37	P42684-1#73	0	2	P42684-5	342	344	+	2	0	0	3433
P42684-1#73	0	2	2	P42684-1	342	344	+	2	P42684-1	73	1182	P42684-4	37	1043	+	36	P42684-1#73	0	2	P42684-4	306	308	+	2	0	0	3434
P42684-1#73	0	2	2	P42684-1	342	344	+	2	P42684-1	52	1182	P42684-3	37	1167	+	35	P42684-1#73	0	2	P42684-3	327	329	+	2	0	0	3435
P42684-1#73	0	2	2	P42684-1	342	344	+	2	P42684-1	73	1182	P42684-2	37	1146	+	34	P42684-1#73	0	2	P42684-2	306	308	+	2	0	0	3436
P42684-1#73	0	2	2	P42684-1	342	344	+	2	P42684-1	52	1182	P42684-10	37	1064	+	33	P42684-1#73	0	2	P42684-10	327	329	+	2	0	0	3437
P42684-1#73	0	2	2	P42684-1	342	344	+	2	P42684-1	0	1182	P42684-1	0	1182	+	32	P42684-1#73	0	2	P42684-1	342	344	+	2	0	0	3438
P42684-1#74	0	1	1	P42684-1	434	435	+	1	P42684-1	0	550	P42684-8	0	529	+	40	P42684-1#74	0	1	P42684-8	413	414	+	1	0	0	3439
P42684-1#74	0	1	1	P42684-1	434	435	+	1	P42684-1	0	1182	P42684-7	0	1058	+	39	P42684-1#74	0	1	P42684-7	413	414	+	1	0	0	3440
P42684-1#74	0	1	1	P42684-1	434	435	+	1	P42684-1	0	1182	P42684-6	0	1161	+	38	P42684-1#74	0	1	P42684-6	413	414	+	1	0	0	3441
P42684-1#74	0	1	1	P42684-1	434	435	+	1	P42684-1	0	1182	P42684-5	0	1079	+	37	P42684-1#74	0	1	P42684-5	434	435	+	1	0	0	3442
P42684-1#74	0	1	1	P42684-1	434	435	+	1	P42684-1	73	1182	P42684-4	37	1043	+	36	P42684-1#74	0	1	P42684-4	398	399	+	1	0	0	3443
P42684-1#74	0	1	1	P42684-1	434	435	+	1	P42684-1	52	1182	P42684-3	37	1167	+	35	P42684-1#74	0	1	P42684-3	419	420	+	1	0	0	3444
P42684-1#74	0	1	1	P42684-1	434	435	+	1	P42684-1	73	1182	P42684-2	37	1146	+	34	P42684-1#74	0	1	P42684-2	398	399	+	1	0	0	3445
P42684-1#74	0	1	1	P42684-1	434	435	+	1	P42684-1	52	1182	P42684-10	37	1064	+	33	P42684-1#74	0	1	P42684-10	419	420	+	1	0	0	3446
P42684-1#74	0	1	1	P42684-1	434	435	+	1	P42684-1	0	1182	P42684-1	0	1182	+	32	P42684-1#74	0	1	P42684-1	434	435	+	1	0	0	3447
P42684-1#75	0	1	1	P42684-1	980	981	+	1	P42684-1	0	1182	P42684-7	0	1058	+	39	P42684-1#75	0	1	P42684-7	856	857	+	1	0	0	3448
P42684-1#75	0	1	1	P42684-1	980	981	+	1	P42684-1	0	1182	P42684-6	0	1161	+	38	P42684-1#75	0	1	P42684-6	959	960	+	1	0	0	3449
P42684-1#75	0	1	1	P42684-1	980	981	+	1	P42684-1	0	1182	P42684-5	0	1079	+	37	P42684-1#75	0	1	P42684-5	877	878	+	1	0	0	3450
P42684-1#75	0	1	1	P42684-1	980	981	+	1	P42684-1	73	1182	P42684-4	37	1043	+	36	P42684-1#75	0	1	P42684-4	841	842	+	1	0	0	3451
P42684-1#75	0	1	1	P42684-1	980	981	+	1	P42684-1	52	1182	P42684-3	37	1167	+	35	P42684-1#75	0	1	P42684-3	965	966	+	1	0	0	3452
P42684-1#75	0	1	1	P42684-1	980	981	+	1	P42684-1	73	1182	P42684-2	37	1146	+	34	P42684-1#75	0	1	P42684-2	944	945	+	1	0	0	3453
P42684-1#75	0	1	1	P42684-1	980	981	+	1	P42684-1	52	1182	P42684-10	37	1064	+	33	P42684-1#75	0	1	P42684-10	862	863	+	1	0	0	3454
P42684-1#75	0	1	1	P42684-1	980	981	+	1	P42684-1	0	1182	P42684-1	0	1182	+	32	P42684-1#75	0	1	P42684-1	980	981	+	1	0	0	3455
P42684-1#76	0	6	6	P42684-1	110	116	+	6	P42684-1	0	550	P42684-8	0	529	+	40	P42684-1#76	0	6	P42684-8	89	95	+	6	0	0	3456
P42684-1#76	0	6	6	P42684-1	110	116	+	6	P42684-1	0	1182	P42684-7	0	1058	+	39	P42684-1#76	0	6	P42684-7	89	95	+	6	0	0	3457
P42684-1#76	0	6	6	P42684-1	110	116	+	6	P42684-1	0	1182	P42684-6	0	1161	+	38	P42684-1#76	0	6	P42684-6	89	95	+	6	0	0	3458
P42684-1#76	0	6	6	P42684-1	110	116	+	6	P42684-1	0	1182	P42684-5	0	1079	+	37	P42684-1#76	0	6	P42684-5	110	116	+	6	0	0	3459
P42684-1#76	0	6	6	P42684-1	110	116	+	6	P42684-1	73	1182	P42684-4	37	1043	+	36	P42684-1#76	0	6	P42684-4	74	80	+	6	0	0	3460
P42684-1#76	0	6	6	P42684-1	110	116	+	6	P42684-1	52	1182	P42684-3	37	1167	+	35	P42684-1#76	0	6	P42684-3	95	101	+	6	0	0	3461
P42684-1#76	0	6	6	P42684-1	110	116	+	6	P42684-1	73	1182	P42684-2	37	1146	+	34	P42684-1#76	0	6	P42684-2	74	80	+	6	0	0	3462
P42684-1#76	0	6	6	P42684-1	110	116	+	6	P42684-1	52	1182	P42684-10	37	1064	+	33	P42684-1#76	0	6	P42684-10	95	101	+	6	0	0	3463
P42684-1#76	0	6	6	P42684-1	110	116	+	6	P42684-1	0	1182	P42684-1	0	1182	+	32	P42684-1#76	0	6	P42684-1	110	116	+	6	0	0	3464
P42684-1#77	0	7	7	P42684-1	132	139	+	7	P42684-1	0	550	P42684-8	0	529	+	40	P42684-1#77	0	7	P42684-8	111	118	+	7	0	0	3465
P42684-1#77	0	7	7	P42684-1	132	139	+	7	P42684-1	0	1182	P42684-7	0	1058	+	39	P42684-1#77	0	7	P42684-7	111	118	+	7	0	0	3466
P42684-1#77	0	7	7	P42684-1	132	139	+	7	P42684-1	0	1182	P42684-6	0	1161	+	38	P42684-1#77	0	7	P42684-6	111	118	+	7	0	0	3467
P42684-1#77	0	7	7	P42684-1	132	139	+	7	P42684-1	0	1182	P42684-5	0	1079	+	37	P42684-1#77	0	7	P42684-5	132	139	+	7	0	0	3468
P42684-1#77	0	7	7	P42684-1	132	139	+	7	P42684-1	73	1182	P42684-4	37	1043	+	36	P42684-1#77	0	7	P42684-4	96	103	+	7	0	0	3469
P42684-1#77	0	7	7	P42684-1	132	139	+	7	P42684-1	52	1182	P42684-3	37	1167	+	35	P42684-1#77	0	7	P42684-3	117	124	+	7	0	0	3470
P42684-1#77	0	7	7	P42684-1	132	139	+	7	P42684-1	73	1182	P42684-2	37	1146	+	34	P42684-1#77	0	7	P42684-2	96	103	+	7	0	0	3471
P42684-1#77	0	7	7	P42684-1	132	139	+	7	P42684-1	52	1182	P42684-10	37	1064	+	33	P42684-1#77	0	7	P42684-10	117	124	+	7	0	0	3472
P42684-1#77	0	7	7	P42684-1	132	139	+	7	P42684-1	0	1182	P42684-1	0	1182	+	32	P42684-1#77	0	7	P42684-1	132	139	+	7	0	0	3473
P42684-1#78	0	10	10	P42684-1	140	150	+	10	P42684-1	0	550	P42684-8	0	529	+	40	P42684-1#78	0	10	P42684-8	119	129	+	10	0	0	3474
P42684-1#78	0	10	10	P42684-1	140	150	+	10	P42684-1	0	1182	P42684-7	0	1058	+	39	P42684-1#78	0	10	P42684-7	119	129	+	10	0	0	3475
P42684-1#78	0	10	10	P42684-1	140	150	+	10	P42684-1	0	1182	P42684-6	0	1161	+	38	P42684-1#78	0	10	P42684-6	119	129	+	10	0	0	3476
P42684-1#78	0	10	10	P42684-1	140	150	+	10	P42684-1	0	1182	P42684-5	0	1079	+	37	P42684-1#78	0	10	P42684-5	140	150	+	10	0	0	3477
P42684-1#78	0	10	10	P42684-1	140	150	+	10	P42684-1	73	1182	P42684-4	37	1043	+	36	P42684-1#78	0	10	P42684-4	104	114	+	10	0	0	3478
P42684-1#78	0	10	10	P42684-1	140	150	+	10	P42684-1	52	1182	P42684-3	37	1167	+	35	P42684-1#78	0	10	P42684-3	125	135	+	10	0	0	3479
P42684-1#78	0	10	10	P42684-1	140	150	+	10	P42684-1	73	1182	P42684-2	37	1146	+	34	P42684-1#78	0	10	P42684-2	104	114	+	10	0	0	3480
P42684-1#78	0	10	10	P42684-1	140	150	+	10	P42684-1	52	1182	P42684-10	37	1064	+	33	P42684-1#78	0	10	P42684-10	125	135	+	10	0	0	3481
P42684-1#78	0	10	10	P42684-1	140	150	+	10	P42684-1	0	1182	P42684-1	0	1182	+	32	P42684-1#78	0	10	P42684-1	140	150	+	10	0	0	3482
P42684-1#79	0	6	6	P42684-1	152	158	+	6	P42684-1	0	550	P42684-8	0	529	+	40	P42684-1#79	0	6	P42684-8	131	137	+	6	0	0	3483
P42684-1#79	0	6	6	P42684-1	152	158	+	6	P42684-1	0	1182	P42684-7	0	1058	+	39	P42684-1#79	0	6	P42684-7	131	137	+	6	0	0	3484
P42684-1#79	0	6	6	P42684-1	152	158	+	6	P42684-1	0	1182	P42684-6	0	1161	+	38	P42684-1#79	0	6	P42684-6	131	137	+	6	0	0	3485
P42684-1#79	0	6	6	P42684-1	152	158	+	6	P42684-1	0	1182	P42684-5	0	1079	+	37	P42684-1#79	0	6	P42684-5	152	158	+	6	0	0	3486
P42684-1#79	0	6	6	P42684-1	152	158	+	6	P42684-1	73	1182	P42684-4	37	1043	+	36	P42684-1#79	0	6	P42684-4	116	122	+	6	0	0	3487
P42684-1#79	0	6	6	P42684-1	152	158	+	6	P42684-1	52	1182	P42684-3	37	1167	+	35	P42684-1#79	0	6	P42684-3	137	143	+	6	0	0	3488
P42684-1#79	0	6	6	P42684-1	152	158	+	6	P42684-1	73	1182	P42684-2	37	1146	+	34	P42684-1#79	0	6	P42684-2	116	122	+	6	0	0	3489
P42684-1#79	0	6	6	P42684-1	152	158	+	6	P42684-1	52	1182	P42684-10	37	1064	+	33	P42684-1#79	0	6	P42684-10	137	143	+	6	0	0	3490
P42684-1#79	0	6	6	P42684-1	152	158	+	6	P42684-1	0	1182	P42684-1	0	1182	+	32	P42684-1#79	0	6	P42684-1	152	158	+	6	0	0	3491
P42684-1#80	0	3	3	P42684-1	158	161	+	3	P42684-1	0	550	P42684-8	0	529	+	40	P42684-1#80	0	3	P42684-8	137	140	+	3	0	0	3492
P42684-1#80	0	3	3	P42684-1	158	161	+	3	P42684-1	0	1182	P42684-7	0	1058	+	39	P42684-1#80	0	3	P42684-7	137	140	+	3	0	0	3493
P42684-1#80	0	3	3	P42684-1	158	161	+	3	P42684-1	0	1182	P42684-6	0	1161	+	38	P42684-1#80	0	3	P42684-6	137	140	+	3	0	0	3494
P42684-1#80	0	3	3	P42684-1	158	161	+	3	P42684-1	0	1182	P42684-5	0	1079	+	37	P42684-1#80	0	3	P42684-5	158	161	+	3	0	0	3495
P42684-1#80	0	3	3	P42684-1	158	161	+	3	P42684-1	73	1182	P42684-4	37	1043	+	36	P42684-1#80	0	3	P42684-4	122	125	+	3	0	0	3496
P42684-1#80	0	3	3	P42684-1	158	161	+	3	P42684-1	52	1182	P42684-3	37	1167	+	35	P42684-1#80	0	3	P42684-3	143	146	+	3	0	0	3497
P42684-1#80	0	3	3	P42684-1	158	161	+	3	P42684-1	73	1182	P42684-2	37	1146	+	34	P42684-1#80	0	3	P42684-2	122	125	+	3	0	0	3498
P42684-1#80	0	3	3	P42684-1	158	161	+	3	P42684-1	52	1182	P42684-10	37	1064	+	33	P42684-1#80	0	3	P42684-10	143	146	+	3	0	0	3499
P42684-1#80	0	3	3	P42684-1	158	161	+	3	P42684-1	0	1182	P42684-1	0	1182	+	32	P42684-1#80	0	3	P42684-1	158	161	+	3	0	0	3500
P42684-1#81	0	3	3	P42684-1	161	164	+	3	P42684-1	0	550	P42684-8	0	529	+	40	P42684-1#81	0	3	P42684-8	140	143	+	3	0	0	3501
P42684-1#81	0	3	3	P42684-1	161	164	+	3	P42684-1	0	1182	P42684-7	0	1058	+	39	P42684-1#81	0	3	P42684-7	140	143	+	3	0	0	3502
P42684-1#81	0	3	3	P42684-1	161	164	+	3	P42684-1	0	1182	P42684-6	0	1161	+	38	P42684-1#81	0	3	P42684-6	140	143	+	3	0	0	3503
P42684-1#81	0	3	3	P42684-1	161	164	+	3	P42684-1	0	1182	P42684-5	0	1079	+	37	P42684-1#81	0	3	P42684-5	161	164	+	3	0	0	3504
P42684-1#81	0	3	3	P42684-1	161	164	+	3	P42684-1	73	1182	P42684-4	37	1043	+	36	P42684-1#81	0	3	P42684-4	125	128	+	3	0	0	3505
P42684-1#81	0	3	3	P42684-1	161	164	+	3	P42684-1	52	1182	P42684-3	37	1167	+	35	P42684-1#81	0	3	P42684-3	146	149	+	3	0	0	3506
P42684-1#81	0	3	3	P42684-1	161	164	+	3	P42684-1	73	1182	P42684-2	37	1146	+	34	P42684-1#81	0	3	P42684-2	125	128	+	3	0	0	3507
P42684-1#81	0	3	3	P42684-1	161	164	+	3	P42684-1	52	1182	P42684-10	37	1064	+	33	P42684-1#81	0	3	P42684-10	146	149	+	3	0	0	3508
P42684-1#81	0	3	3	P42684-1	161	164	+	3	P42684-1	0	1182	P42684-1	0	1182	+	32	P42684-1#81	0	3	P42684-1	161	164	+	3	0	0	3509
P42684-1#82	0	3	3	P42684-1	167	170	+	3	P42684-1	0	550	P42684-8	0	529	+	40	P42684-1#82	0	3	P42684-8	146	149	+	3	0	0	3510
P42684-1#82	0	3	3	P42684-1	167	170	+	3	P42684-1	0	1182	P42684-7	0	1058	+	39	P42684-1#82	0	3	P42684-7	146	149	+	3	0	0	3511
P42684-1#82	0	3	3	P42684-1	167	170	+	3	P42684-1	0	1182	P42684-6	0	1161	+	38	P42684-1#82	0	3	P42684-6	146	149	+	3	0	0	3512
P42684-1#82	0	3	3	P42684-1	167	170	+	3	P42684-1	0	1182	P42684-5	0	1079	+	37	P42684-1#82	0	3	P42684-5	167	170	+	3	0	0	3513
P42684-1#82	0	3	3	P42684-1	167	170	+	3	P42684-1	73	1182	P42684-4	37	1043	+	36	P42684-1#82	0	3	P42684-4	131	134	+	3	0	0	3514
P42684-1#82	0	3	3	P42684-1	167	170	+	3	P42684-1	52	1182	P42684-3	37	1167	+	35	P42684-1#82	0	3	P42684-3	152	155	+	3	0	0	3515
P42684-1#82	0	3	3	P42684-1	167	170	+	3	P42684-1	73	1182	P42684-2	37	1146	+	34	P42684-1#82	0	3	P42684-2	131	134	+	3	0	0	3516
P42684-1#82	0	3	3	P42684-1	167	170	+	3	P42684-1	52	1182	P42684-10	37	1064	+	33	P42684-1#82	0	3	P42684-10	152	155	+	3	0	0	3517
P42684-1#82	0	3	3	P42684-1	167	170	+	3	P42684-1	0	1182	P42684-1	0	1182	+	32	P42684-1#82	0	3	P42684-1	167	170	+	3	0	0	3518
P42684-1#83	0	4	4	P42684-1	173	177	+	4	P42684-1	0	550	P42684-8	0	529	+	40	P42684-1#83	0	4	P42684-8	152	156	+	4	0	0	3519
P42684-1#83	0	4	4	P42684-1	173	177	+	4	P42684-1	0	1182	P42684-7	0	1058	+	39	P42684-1#83	0	4	P42684-7	152	156	+	4	0	0	3520
P42684-1#83	0	4	4	P42684-1	173	177	+	4	P42684-1	0	1182	P42684-6	0	1161	+	38	P42684-1#83	0	4	P42684-6	152	156	+	4	0	0	3521
P42684-1#83	0	4	4	P42684-1	173	177	+	4	P42684-1	0	1182	P42684-5	0	1079	+	37	P42684-1#83	0	4	P42684-5	173	177	+	4	0	0	3522
P42684-1#83	0	4	4	P42684-1	173	177	+	4	P42684-1	73	1182	P42684-4	37	1043	+	36	P42684-1#83	0	4	P42684-4	137	141	+	4	0	0	3523
P42684-1#83	0	4	4	P42684-1	173	177	+	4	P42684-1	52	1182	P42684-3	37	1167	+	35	P42684-1#83	0	4	P42684-3	158	162	+	4	0	0	3524
P42684-1#83	0	4	4	P42684-1	173	177	+	4	P42684-1	73	1182	P42684-2	37	1146	+	34	P42684-1#83	0	4	P42684-2	137	141	+	4	0	0	3525
P42684-1#83	0	4	4	P42684-1	173	177	+	4	P42684-1	52	1182	P42684-10	37	1064	+	33	P42684-1#83	0	4	P42684-10	158	162	+	4	0	0	3526
P42684-1#83	0	4	4	P42684-1	173	177	+	4	P42684-1	0	1182	P42684-1	0	1182	+	32	P42684-1#83	0	4	P42684-1	173	177	+	4	0	0	3527
P42684-1#84	0	8	8	P42684-1	179	187	+	8	P42684-1	0	550	P42684-8	0	529	+	40	P42684-1#84	0	8	P42684-8	158	166	+	8	0	0	3528
P42684-1#84	0	8	8	P42684-1	179	187	+	8	P42684-1	0	1182	P42684-7	0	1058	+	39	P42684-1#84	0	8	P42684-7	158	166	+	8	0	0	3529
P42684-1#84	0	8	8	P42684-1	179	187	+	8	P42684-1	0	1182	P42684-6	0	1161	+	38	P42684-1#84	0	8	P42684-6	158	166	+	8	0	0	3530
P42684-1#84	0	8	8	P42684-1	179	187	+	8	P42684-1	0	1182	P42684-5	0	1079	+	37	P42684-1#84	0	8	P42684-5	179	187	+	8	0	0	3531
P42684-1#84	0	8	8	P42684-1	179	187	+	8	P42684-1	73	1182	P42684-4	37	1043	+	36	P42684-1#84	0	8	P42684-4	143	151	+	8	0	0	3532
P42684-1#84	0	8	8	P42684-1	179	187	+	8	P42684-1	52	1182	P42684-3	37	1167	+	35	P42684-1#84	0	8	P42684-3	164	172	+	8	0	0	3533
P42684-1#84	0	8	8	P42684-1	179	187	+	8	P42684-1	73	1182	P42684-2	37	1146	+	34	P42684-1#84	0	8	P42684-2	143	151	+	8	0	0	3534
P42684-1#84	0	8	8	P42684-1	179	187	+	8	P42684-1	52	1182	P42684-10	37	1064	+	33	P42684-1#84	0	8	P42684-10	164	172	+	8	0	0	3535
P42684-1#84	0	8	8	P42684-1	179	187	+	8	P42684-1	0	1182	P42684-1	0	1182	+	32	P42684-1#84	0	8	P42684-1	179	187	+	8	0	0	3536
P42684-1#85	0	6	6	P42684-1	193	199	+	6	P42684-1	0	550	P42684-8	0	529	+	40	P42684-1#85	0	6	P42684-8	172	178	+	6	0	0	3537
P42684-1#85	0	6	6	P42684-1	193	199	+	6	P42684-1	0	1182	P42684-7	0	1058	+	39	P42684-1#85	0	6	P42684-7	172	178	+	6	0	0	3538
P42684-1#85	0	6	6	P42684-1	193	199	+	6	P42684-1	0	1182	P42684-6	0	1161	+	38	P42684-1#85	0	6	P42684-6	172	178	+	6	0	0	3539
P42684-1#85	0	6	6	P42684-1	193	199	+	6	P42684-1	0	1182	P42684-5	0	1079	+	37	P42684-1#85	0	6	P42684-5	193	199	+	6	0	0	3540
P42684-1#85	0	6	6	P42684-1	193	199	+	6	P42684-1	73	1182	P42684-4	37	1043	+	36	P42684-1#85	0	6	P42684-4	157	163	+	6	0	0	3541
P42684-1#85	0	6	6	P42684-1	193	199	+	6	P42684-1	52	1182	P42684-3	37	1167	+	35	P42684-1#85	0	6	P42684-3	178	184	+	6	0	0	3542
P42684-1#85	0	6	6	P42684-1	193	199	+	6	P42684-1	73	1182	P42684-2	37	1146	+	34	P42684-1#85	0	6	P42684-2	157	163	+	6	0	0	3543
P42684-1#85	0	6	6	P42684-1	193	199	+	6	P42684-1	52	1182	P42684-10	37	1064	+	33	P42684-1#85	0	6	P42684-10	178	184	+	6	0	0	3544
P42684-1#85	0	6	6	P42684-1	193	199	+	6	P42684-1	0	1182	P42684-1	0	1182	+	32	P42684-1#85	0	6	P42684-1	193	199	+	6	0	0	3545
P42684-1#86	0	7	7	P42684-1	206	213	+	7	P42684-1	0	550	P42684-8	0	529	+	40	P42684-1#86	0	7	P42684-8	185	192	+	7	0	0	3546
P42684-1#86	0	7	7	P42684-1	206	213	+	7	P42684-1	0	1182	P42684-7	0	1058	+	39	P42684-1#86	0	7	P42684-7	185	192	+	7	0	0	3547
P42684-1#86	0	7	7	P42684-1	206	213	+	7	P42684-1	0	1182	P42684-6	0	1161	+	38	P42684-1#86	0	7	P42684-6	185	192	+	7	0	0	3548
P42684-1#86	0	7	7	P42684-1	206	213	+	7	P42684-1	0	1182	P42684-5	0	1079	+	37	P42684-1#86	0	7	P42684-5	206	213	+	7	0	0	3549
P42684-1#86	0	7	7	P42684-1	206	213	+	7	P42684-1	73	1182	P42684-4	37	1043	+	36	P42684-1#86	0	7	P42684-4	170	177	+	7	0	0	3550
P42684-1#86	0	7	7	P42684-1	206	213	+	7	P42684-1	52	1182	P42684-3	37	1167	+	35	P42684-1#86	0	7	P42684-3	191	198	+	7	0	0	3551
P42684-1#86	0	7	7	P42684-1	206	213	+	7	P42684-1	73	1182	P42684-2	37	1146	+	34	P42684-1#86	0	7	P42684-2	170	177	+	7	0	0	3552
P42684-1#86	0	7	7	P42684-1	206	213	+	7	P42684-1	52	1182	P42684-10	37	1064	+	33	P42684-1#86	0	7	P42684-10	191	198	+	7	0	0	3553
P42684-1#86	0	7	7	P42684-1	206	213	+	7	P42684-1	0	1182	P42684-1	0	1182	+	32	P42684-1#86	0	7	P42684-1	206	213	+	7	0	0	3554
P42684-1#87	0	6	6	P42684-1	215	221	+	6	P42684-1	0	550	P42684-8	0	529	+	40	P42684-1#87	0	6	P42684-8	194	200	+	6	0	0	3555
P42684-1#87	0	6	6	P42684-1	215	221	+	6	P42684-1	0	1182	P42684-7	0	1058	+	39	P42684-1#87	0	6	P42684-7	194	200	+	6	0	0	3556
P42684-1#87	0	6	6	P42684-1	215	221	+	6	P42684-1	0	1182	P42684-6	0	1161	+	38	P42684-1#87	0	6	P42684-6	194	200	+	6	0	0	3557
P42684-1#87	0	6	6	P42684-1	215	221	+	6	P42684-1	0	1182	P42684-5	0	1079	+	37	P42684-1#87	0	6	P42684-5	215	221	+	6	0	0	3558
P42684-1#87	0	6	6	P42684-1	215	221	+	6	P42684-1	73	1182	P42684-4	37	1043	+	36	P42684-1#87	0	6	P42684-4	179	185	+	6	0	0	3559
P42684-1#87	0	6	6	P42684-1	215	221	+	6	P42684-1	52	1182	P42684-3	37	1167	+	35	P42684-1#87	0	6	P42684-3	200	206	+	6	0	0	3560
P42684-1#87	0	6	6	P42684-1	215	221	+	6	P42684-1	73	1182	P42684-2	37	1146	+	34	P42684-1#87	0	6	P42684-2	179	185	+	6	0	0	3561
P42684-1#87	0	6	6	P42684-1	215	221	+	6	P42684-1	52	1182	P42684-10	37	1064	+	33	P42684-1#87	0	6	P42684-10	200	206	+	6	0	0	3562
P42684-1#87	0	6	6	P42684-1	215	221	+	6	P42684-1	0	1182	P42684-1	0	1182	+	32	P42684-1#87	0	6	P42684-1	215	221	+	6	0	0	3563
P42684-1#88	0	3	3	P42684-1	225	228	+	3	P42684-1	0	550	P42684-8	0	529	+	40	P42684-1#88	0	3	P42684-8	204	207	+	3	0	0	3564
P42684-1#88	0	3	3	P42684-1	225	228	+	3	P42684-1	0	1182	P42684-7	0	1058	+	39	P42684-1#88	0	3	P42684-7	204	207	+	3	0	0	3565
P42684-1#88	0	3	3	P42684-1	225	228	+	3	P42684-1	0	1182	P42684-6	0	1161	+	38	P42684-1#88	0	3	P42684-6	204	207	+	3	0	0	3566
P42684-1#88	0	3	3	P42684-1	225	228	+	3	P42684-1	0	1182	P42684-5	0	1079	+	37	P42684-1#88	0	3	P42684-5	225	228	+	3	0	0	3567
P42684-1#88	0	3	3	P42684-1	225	228	+	3	P42684-1	73	1182	P42684-4	37	1043	+	36	P42684-1#88	0	3	P42684-4	189	192	+	3	0	0	3568
P42684-1#88	0	3	3	P42684-1	225	228	+	3	P42684-1	52	1182	P42684-3	37	1167	+	35	P42684-1#88	0	3	P42684-3	210	213	+	3	0	0	3569
P42684-1#88	0	3	3	P42684-1	225	228	+	3	P42684-1	73	1182	P42684-2	37	1146	+	34	P42684-1#88	0	3	P42684-2	189	192	+	3	0	0	3570
P42684-1#88	0	3	3	P42684-1	225	228	+	3	P42684-1	52	1182	P42684-10	37	1064	+	33	P42684-1#88	0	3	P42684-10	210	213	+	3	0	0	3571
P42684-1#88	0	3	3	P42684-1	225	228	+	3	P42684-1	0	1182	P42684-1	0	1182	+	32	P42684-1#88	0	3	P42684-1	225	228	+	3	0	0	3572
P42684-1#89	0	4	4	P42684-1	229	233	+	4	P42684-1	0	550	P42684-8	0	529	+	40	P42684-1#89	0	4	P42684-8	208	212	+	4	0	0	3573
P42684-1#89	0	4	4	P42684-1	229	233	+	4	P42684-1	0	1182	P42684-7	0	1058	+	39	P42684-1#89	0	4	P42684-7	208	212	+	4	0	0	3574
P42684-1#89	0	4	4	P42684-1	229	233	+	4	P42684-1	0	1182	P42684-6	0	1161	+	38	P42684-1#89	0	4	P42684-6	208	212	+	4	0	0	3575
P42684-1#89	0	4	4	P42684-1	229	233	+	4	P42684-1	0	1182	P42684-5	0	1079	+	37	P42684-1#89	0	4	P42684-5	229	233	+	4	0	0	3576
P42684-1#89	0	4	4	P42684-1	229	233	+	4	P42684-1	73	1182	P42684-4	37	1043	+	36	P42684-1#89	0	4	P42684-4	193	197	+	4	0	0	3577
P42684-1#89	0	4	4	P42684-1	229	233	+	4	P42684-1	52	1182	P42684-3	37	1167	+	35	P42684-1#89	0	4	P42684-3	214	218	+	4	0	0	3578
P42684-1#89	0	4	4	P42684-1	229	233	+	4	P42684-1	73	1182	P42684-2	37	1146	+	34	P42684-1#89	0	4	P42684-2	193	197	+	4	0	0	3579
P42684-1#89	0	4	4	P42684-1	229	233	+	4	P42684-1	52	1182	P42684-10	37	1064	+	33	P42684-1#89	0	4	P42684-10	214	218	+	4	0	0	3580
P42684-1#89	0	4	4	P42684-1	229	233	+	4	P42684-1	0	1182	P42684-1	0	1182	+	32	P42684-1#89	0	4	P42684-1	229	233	+	4	0	0	3581
P42684-1#90	0	5	5	P42684-1	235	240	+	5	P42684-1	0	550	P42684-8	0	529	+	40	P42684-1#90	0	5	P42684-8	214	219	+	5	0	0	3582
P42684-1#90	0	5	5	P42684-1	235	240	+	5	P42684-1	0	1182	P42684-7	0	1058	+	39	P42684-1#90	0	5	P42684-7	214	219	+	5	0	0	3583
P42684-1#90	0	5	5	P42684-1	235	240	+	5	P42684-1	0	1182	P42684-6	0	1161	+	38	P42684-1#90	0	5	P42684-6	214	219	+	5	0	0	3584
P42684-1#90	0	5	5	P42684-1	235	240	+	5	P42684-1	0	1182	P42684-5	0	1079	+	37	P42684-1#90	0	5	P42684-5	235	240	+	5	0	0	3585
P42684-1#90	0	5	5	P42684-1	235	240	+	5	P42684-1	73	1182	P42684-4	37	1043	+	36	P42684-1#90	0	5	P42684-4	199	204	+	5	0	0	3586
P42684-1#90	0	5	5	P42684-1	235	240	+	5	P42684-1	52	1182	P42684-3	37	1167	+	35	P42684-1#90	0	5	P42684-3	220	225	+	5	0	0	3587
P42684-1#90	0	5	5	P42684-1	235	240	+	5	P42684-1	73	1182	P42684-2	37	1146	+	34	P42684-1#90	0	5	P42684-2	199	204	+	5	0	0	3588
P42684-1#90	0	5	5	P42684-1	235	240	+	5	P42684-1	52	1182	P42684-10	37	1064	+	33	P42684-1#90	0	5	P42684-10	220	225	+	5	0	0	3589
P42684-1#90	0	5	5	P42684-1	235	240	+	5	P42684-1	0	1182	P42684-1	0	1182	+	32	P42684-1#90	0	5	P42684-1	235	240	+	5	0	0	3590
P42684-1#91	0	8	8	P42684-1	240	248	+	8	P42684-1	0	550	P42684-8	0	529	+	40	P42684-1#91	0	8	P42684-8	219	227	+	8	0	0	3591
P42684-1#91	0	8	8	P42684-1	240	248	+	8	P42684-1	0	1182	P42684-7	0	1058	+	39	P42684-1#91	0	8	P42684-7	219	227	+	8	0	0	3592
P42684-1#91	0	8	8	P42684-1	240	248	+	8	P42684-1	0	1182	P42684-6	0	1161	+	38	P42684-1#91	0	8	P42684-6	219	227	+	8	0	0	3593
P42684-1#91	0	8	8	P42684-1	240	248	+	8	P42684-1	0	1182	P42684-5	0	1079	+	37	P42684-1#91	0	8	P42684-5	240	248	+	8	0	0	3594
P42684-1#91	0	8	8	P42684-1	240	248	+	8	P42684-1	73	1182	P42684-4	37	1043	+	36	P42684-1#91	0	8	P42684-4	204	212	+	8	0	0	3595
P42684-1#91	0	8	8	P42684-1	240	248	+	8	P42684-1	52	1182	P42684-3	37	1167	+	35	P42684-1#91	0	8	P42684-3	225	233	+	8	0	0	3596
P42684-1#91	0	8	8	P42684-1	240	248	+	8	P42684-1	73	1182	P42684-2	37	1146	+	34	P42684-1#91	0	8	P42684-2	204	212	+	8	0	0	3597
P42684-1#91	0	8	8	P42684-1	240	248	+	8	P42684-1	52	1182	P42684-10	37	1064	+	33	P42684-1#91	0	8	P42684-10	225	233	+	8	0	0	3598
P42684-1#91	0	8	8	P42684-1	240	248	+	8	P42684-1	0	1182	P42684-1	0	1182	+	32	P42684-1#91	0	8	P42684-1	240	248	+	8	0	0	3599
P42684-1#92	0	3	3	P42684-1	254	257	+	3	P42684-1	0	550	P42684-8	0	529	+	40	P42684-1#92	0	3	P42684-8	233	236	+	3	0	0	3600
P42684-1#92	0	3	3	P42684-1	254	257	+	3	P42684-1	0	1182	P42684-7	0	1058	+	39	P42684-1#92	0	3	P42684-7	233	236	+	3	0	0	3601
P42684-1#92	0	3	3	P42684-1	254	257	+	3	P42684-1	0	1182	P42684-6	0	1161	+	38	P42684-1#92	0	3	P42684-6	233	236	+	3	0	0	3602
P42684-1#92	0	3	3	P42684-1	254	257	+	3	P42684-1	0	1182	P42684-5	0	1079	+	37	P42684-1#92	0	3	P42684-5	254	257	+	3	0	0	3603
P42684-1#92	0	3	3	P42684-1	254	257	+	3	P42684-1	73	1182	P42684-4	37	1043	+	36	P42684-1#92	0	3	P42684-4	218	221	+	3	0	0	3604
P42684-1#92	0	3	3	P42684-1	254	257	+	3	P42684-1	52	1182	P42684-3	37	1167	+	35	P42684-1#92	0	3	P42684-3	239	242	+	3	0	0	3605
P42684-1#92	0	3	3	P42684-1	254	257	+	3	P42684-1	73	1182	P42684-2	37	1146	+	34	P42684-1#92	0	3	P42684-2	218	221	+	3	0	0	3606
P42684-1#92	0	3	3	P42684-1	254	257	+	3	P42684-1	52	1182	P42684-10	37	1064	+	33	P42684-1#92	0	3	P42684-10	239	242	+	3	0	0	3607
P42684-1#92	0	3	3	P42684-1	254	257	+	3	P42684-1	0	1182	P42684-1	0	1182	+	32	P42684-1#92	0	3	P42684-1	254	257	+	3	0	0	3608
P42684-1#93	0	3	3	P42684-1	279	282	+	3	P42684-1	0	550	P42684-8	0	529	+	40	P42684-1#93	0	3	P42684-8	258	261	+	3	0	0	3609
P42684-1#93	0	3	3	P42684-1	279	282	+	3	P42684-1	0	1182	P42684-7	0	1058	+	39	P42684-1#93	0	3	P42684-7	258	261	+	3	0	0	3610
P42684-1#93	0	3	3	P42684-1	279	282	+	3	P42684-1	0	1182	P42684-6	0	1161	+	38	P42684-1#93	0	3	P42684-6	258	261	+	3	0	0	3611
P42684-1#93	0	3	3	P42684-1	279	282	+	3	P42684-1	0	1182	P42684-5	0	1079	+	37	P42684-1#93	0	3	P42684-5	279	282	+	3	0	0	3612
P42684-1#93	0	3	3	P42684-1	279	282	+	3	P42684-1	73	1182	P42684-4	37	1043	+	36	P42684-1#93	0	3	P42684-4	243	246	+	3	0	0	3613
P42684-1#93	0	3	3	P42684-1	279	282	+	3	P42684-1	52	1182	P42684-3	37	1167	+	35	P42684-1#93	0	3	P42684-3	264	267	+	3	0	0	3614
P42684-1#93	0	3	3	P42684-1	279	282	+	3	P42684-1	73	1182	P42684-2	37	1146	+	34	P42684-1#93	0	3	P42684-2	243	246	+	3	0	0	3615
P42684-1#93	0	3	3	P42684-1	279	282	+	3	P42684-1	52	1182	P42684-10	37	1064	+	33	P42684-1#93	0	3	P42684-10	264	267	+	3	0	0	3616
P42684-1#93	0	3	3	P42684-1	279	282	+	3	P42684-1	0	1182	P42684-1	0	1182	+	32	P42684-1#93	0	3	P42684-1	279	282	+	3	0	0	3617
P42684-1#94	0	3	3	P42684-1	284	287	+	3	P42684-1	0	550	P42684-8	0	529	+	40	P42684-1#94	0	3	P42684-8	263	266	+	3	0	0	3618
P42684-1#94	0	3	3	P42684-1	284	287	+	3	P42684-1	0	1182	P42684-7	0	1058	+	39	P42684-1#94	0	3	P42684-7	263	266	+	3	0	0	3619
P42684-1#94	0	3	3	P42684-1	284	287	+	3	P42684-1	0	1182	P42684-6	0	1161	+	38	P42684-1#94	0	3	P42684-6	263	266	+	3	0	0	3620
P42684-1#94	0	3	3	P42684-1	284	287	+	3	P42684-1	0	1182	P42684-5	0	1079	+	37	P42684-1#94	0	3	P42684-5	284	287	+	3	0	0	3621
P42684-1#94	0	3	3	P42684-1	284	287	+	3	P42684-1	73	1182	P42684-4	37	1043	+	36	P42684-1#94	0	3	P42684-4	248	251	+	3	0	0	3622
P42684-1#94	0	3	3	P42684-1	284	287	+	3	P42684-1	52	1182	P42684-3	37	1167	+	35	P42684-1#94	0	3	P42684-3	269	272	+	3	0	0	3623
P42684-1#94	0	3	3	P42684-1	284	287	+	3	P42684-1	73	1182	P42684-2	37	1146	+	34	P42684-1#94	0	3	P42684-2	248	251	+	3	0	0	3624
P42684-1#94	0	3	3	P42684-1	284	287	+	3	P42684-1	52	1182	P42684-10	37	1064	+	33	P42684-1#94	0	3	P42684-10	269	272	+	3	0	0	3625
P42684-1#94	0	3	3	P42684-1	284	287	+	3	P42684-1	0	1182	P42684-1	0	1182	+	32	P42684-1#94	0	3	P42684-1	284	287	+	3	0	0	3626
P42684-1#95	0	6	6	P42684-1	287	293	+	6	P42684-1	0	550	P42684-8	0	529	+	40	P42684-1#95	0	6	P42684-8	266	272	+	6	0	0	3627
P42684-1#95	0	6	6	P42684-1	287	293	+	6	P42684-1	0	1182	P42684-7	0	1058	+	39	P42684-1#95	0	6	P42684-7	266	272	+	6	0	0	3628
P42684-1#95	0	6	6	P42684-1	287	293	+	6	P42684-1	0	1182	P42684-6	0	1161	+	38	P42684-1#95	0	6	P42684-6	266	272	+	6	0	0	3629
P42684-1#95	0	6	6	P42684-1	287	293	+	6	P42684-1	0	1182	P42684-5	0	1079	+	37	P42684-1#95	0	6	P42684-5	287	293	+	6	0	0	3630
P42684-1#95	0	6	6	P42684-1	287	293	+	6	P42684-1	73	1182	P42684-4	37	1043	+	36	P42684-1#95	0	6	P42684-4	251	257	+	6	0	0	3631
P42684-1#95	0	6	6	P42684-1	287	293	+	6	P42684-1	52	1182	P42684-3	37	1167	+	35	P42684-1#95	0	6	P42684-3	272	278	+	6	0	0	3632
P42684-1#95	0	6	6	P42684-1	287	293	+	6	P42684-1	73	1182	P42684-2	37	1146	+	34	P42684-1#95	0	6	P42684-2	251	257	+	6	0	0	3633
P42684-1#95	0	6	6	P42684-1	287	293	+	6	P42684-1	52	1182	P42684-10	37	1064	+	33	P42684-1#95	0	6	P42684-10	272	278	+	6	0	0	3634
P42684-1#95	0	6	6	P42684-1	287	293	+	6	P42684-1	0	1182	P42684-1	0	1182	+	32	P42684-1#95	0	6	P42684-1	287	293	+	6	0	0	3635
P42684-1#96	0	4	4	P42684-1	293	297	+	4	P42684-1	0	550	P42684-8	0	529	+	40	P42684-1#96	0	4	P42684-8	272	276	+	4	0	0	3636
P42684-1#96	0	4	4	P42684-1	293	297	+	4	P42684-1	0	1182	P42684-7	0	1058	+	39	P42684-1#96	0	4	P42684-7	272	276	+	4	0	0	3637
P42684-1#96	0	4	4	P42684-1	293	297	+	4	P42684-1	0	1182	P42684-6	0	1161	+	38	P42684-1#96	0	4	P42684-6	272	276	+	4	0	0	3638
P42684-1#96	0	4	4	P42684-1	293	297	+	4	P42684-1	0	1182	P42684-5	0	1079	+	37	P42684-1#96	0	4	P42684-5	293	297	+	4	0	0	3639
P42684-1#96	0	4	4	P42684-1	293	297	+	4	P42684-1	73	1182	P42684-4	37	1043	+	36	P42684-1#96	0	4	P42684-4	257	261	+	4	0	0	3640
P42684-1#96	0	4	4	P42684-1	293	297	+	4	P42684-1	52	1182	P42684-3	37	1167	+	35	P42684-1#96	0	4	P42684-3	278	282	+	4	0	0	3641
P42684-1#96	0	4	4	P42684-1	293	297	+	4	P42684-1	73	1182	P42684-2	37	1146	+	34	P42684-1#96	0	4	P42684-2	257	261	+	4	0	0	3642
P42684-1#96	0	4	4	P42684-1	293	297	+	4	P42684-1	52	1182	P42684-10	37	1064	+	33	P42684-1#96	0	4	P42684-10	278	282	+	4	0	0	3643
P42684-1#96	0	4	4	P42684-1	293	297	+	4	P42684-1	0	1182	P42684-1	0	1182	+	32	P42684-1#96	0	4	P42684-1	293	297	+	4	0	0	3644
P42684-1#97	0	8	8	P42684-1	299	307	+	8	P42684-1	0	550	P42684-8	0	529	+	40	P42684-1#97	0	8	P42684-8	278	286	+	8	0	0	3645
P42684-1#97	0	8	8	P42684-1	299	307	+	8	P42684-1	0	1182	P42684-7	0	1058	+	39	P42684-1#97	0	8	P42684-7	278	286	+	8	0	0	3646
P42684-1#97	0	8	8	P42684-1	299	307	+	8	P42684-1	0	1182	P42684-6	0	1161	+	38	P42684-1#97	0	8	P42684-6	278	286	+	8	0	0	3647
P42684-1#97	0	8	8	P42684-1	299	307	+	8	P42684-1	0	1182	P42684-5	0	1079	+	37	P42684-1#97	0	8	P42684-5	299	307	+	8	0	0	3648
P42684-1#97	0	8	8	P42684-1	299	307	+	8	P42684-1	73	1182	P42684-4	37	1043	+	36	P42684-1#97	0	8	P42684-4	263	271	+	8	0	0	3649
P42684-1#97	0	8	8	P42684-1	299	307	+	8	P42684-1	52	1182	P42684-3	37	1167	+	35	P42684-1#97	0	8	P42684-3	284	292	+	8	0	0	3650
P42684-1#97	0	8	8	P42684-1	299	307	+	8	P42684-1	73	1182	P42684-2	37	1146	+	34	P42684-1#97	0	8	P42684-2	263	271	+	8	0	0	3651
P42684-1#97	0	8	8	P42684-1	299	307	+	8	P42684-1	52	1182	P42684-10	37	1064	+	33	P42684-1#97	0	8	P42684-10	284	292	+	8	0	0	3652
P42684-1#97	0	8	8	P42684-1	299	307	+	8	P42684-1	0	1182	P42684-1	0	1182	+	32	P42684-1#97	0	8	P42684-1	299	307	+	8	0	0	3653
P42684-1#98	0	3	3	P42684-1	307	310	+	3	P42684-1	0	550	P42684-8	0	529	+	40	P42684-1#98	0	3	P42684-8	286	289	+	3	0	0	3654
P42684-1#98	0	3	3	P42684-1	307	310	+	3	P42684-1	0	1182	P42684-7	0	1058	+	39	P42684-1#98	0	3	P42684-7	286	289	+	3	0	0	3655
P42684-1#98	0	3	3	P42684-1	307	310	+	3	P42684-1	0	1182	P42684-6	0	1161	+	38	P42684-1#98	0	3	P42684-6	286	289	+	3	0	0	3656
P42684-1#98	0	3	3	P42684-1	307	310	+	3	P42684-1	0	1182	P42684-5	0	1079	+	37	P42684-1#98	0	3	P42684-5	307	310	+	3	0	0	3657
P42684-1#98	0	3	3	P42684-1	307	310	+	3	P42684-1	73	1182	P42684-4	37	1043	+	36	P42684-1#98	0	3	P42684-4	271	274	+	3	0	0	3658
P42684-1#98	0	3	3	P42684-1	307	310	+	3	P42684-1	52	1182	P42684-3	37	1167	+	35	P42684-1#98	0	3	P42684-3	292	295	+	3	0	0	3659
P42684-1#98	0	3	3	P42684-1	307	310	+	3	P42684-1	73	1182	P42684-2	37	1146	+	34	P42684-1#98	0	3	P42684-2	271	274	+	3	0	0	3660
P42684-1#98	0	3	3	P42684-1	307	310	+	3	P42684-1	52	1182	P42684-10	37	1064	+	33	P42684-1#98	0	3	P42684-10	292	295	+	3	0	0	3661
P42684-1#98	0	3	3	P42684-1	307	310	+	3	P42684-1	0	1182	P42684-1	0	1182	+	32	P42684-1#98	0	3	P42684-1	307	310	+	3	0	0	3662
P42684-1#99	0	7	7	P42684-1	311	318	+	7	P42684-1	0	550	P42684-8	0	529	+	40	P42684-1#99	0	7	P42684-8	290	297	+	7	0	0	3663
P42684-1#99	0	7	7	P42684-1	311	318	+	7	P42684-1	0	1182	P42684-7	0	1058	+	39	P42684-1#99	0	7	P42684-7	290	297	+	7	0	0	3664
P42684-1#99	0	7	7	P42684-1	311	318	+	7	P42684-1	0	1182	P42684-6	0	1161	+	38	P42684-1#99	0	7	P42684-6	290	297	+	7	0	0	3665
P42684-1#99	0	7	7	P42684-1	311	318	+	7	P42684-1	0	1182	P42684-5	0	1079	+	37	P42684-1#99	0	7	P42684-5	311	318	+	7	0	0	3666
P42684-1#99	0	7	7	P42684-1	311	318	+	7	P42684-1	73	1182	P42684-4	37	1043	+	36	P42684-1#99	0	7	P42684-4	275	282	+	7	0	0	3667
P42684-1#99	0	7	7	P42684-1	311	318	+	7	P42684-1	52	1182	P42684-3	37	1167	+	35	P42684-1#99	0	7	P42684-3	296	303	+	7	0	0	3668
P42684-1#99	0	7	7	P42684-1	311	318	+	7	P42684-1	73	1182	P42684-2	37	1146	+	34	P42684-1#99	0	7	P42684-2	275	282	+	7	0	0	3669
P42684-1#99	0	7	7	P42684-1	311	318	+	7	P42684-1	52	1182	P42684-10	37	1064	+	33	P42684-1#99	0	7	P42684-10	296	303	+	7	0	0	3670
P42684-1#99	0	7	7	P42684-1	311	318	+	7	P42684-1	0	1182	P42684-1	0	1182	+	32	P42684-1#99	0	7	P42684-1	311	318	+	7	0	0	3671
P42684-1#100	0	12	12	P42684-1	325	337	+	12	P42684-1	0	550	P42684-8	0	529	+	40	P42684-1#100	0	12	P42684-8	304	316	+	12	0	0	3672
P42684-1#100	0	12	12	P42684-1	325	337	+	12	P42684-1	0	1182	P42684-7	0	1058	+	39	P42684-1#100	0	12	P42684-7	304	316	+	12	0	0	3673
P42684-1#100	0	12	12	P42684-1	325	337	+	12	P42684-1	0	1182	P42684-6	0	1161	+	38	P42684-1#100	0	12	P42684-6	304	316	+	12	0	0	3674
P42684-1#100	0	12	12	P42684-1	325	337	+	12	P42684-1	0	1182	P42684-5	0	1079	+	37	P42684-1#100	0	12	P42684-5	325	337	+	12	0	0	3675
P42684-1#100	0	12	12	P42684-1	325	337	+	12	P42684-1	73	1182	P42684-4	37	1043	+	36	P42684-1#100	0	12	P42684-4	289	301	+	12	0	0	3676
P42684-1#100	0	12	12	P42684-1	325	337	+	12	P42684-1	52	1182	P42684-3	37	1167	+	35	P42684-1#100	0	12	P42684-3	310	322	+	12	0	0	3677
P42684-1#100	0	12	12	P42684-1	325	337	+	12	P42684-1	73	1182	P42684-2	37	1146	+	34	P42684-1#100	0	12	P42684-2	289	301	+	12	0	0	3678
P42684-1#100	0	12	12	P42684-1	325	337	+	12	P42684-1	52	1182	P42684-10	37	1064	+	33	P42684-1#100	0	12	P42684-10	310	322	+	12	0	0	3679
P42684-1#100	0	12	12	P42684-1	325	337	+	12	P42684-1	0	1182	P42684-1	0	1182	+	32	P42684-1#100	0	12	P42684-1	325	337	+	12	0	0	3680
P42684-1#101	0	5	5	P42684-1	346	351	+	5	P42684-1	0	550	P42684-8	0	529	+	40	P42684-1#101	0	5	P42684-8	325	330	+	5	0	0	3681
P42684-1#101	0	5	5	P42684-1	346	351	+	5	P42684-1	0	1182	P42684-7	0	1058	+	39	P42684-1#101	0	5	P42684-7	325	330	+	5	0	0	3682
P42684-1#101	0	5	5	P42684-1	346	351	+	5	P42684-1	0	1182	P42684-6	0	1161	+	38	P42684-1#101	0	5	P42684-6	325	330	+	5	0	0	3683
P42684-1#101	0	5	5	P42684-1	346	351	+	5	P42684-1	0	1182	P42684-5	0	1079	+	37	P42684-1#101	0	5	P42684-5	346	351	+	5	0	0	3684
P42684-1#101	0	5	5	P42684-1	346	351	+	5	P42684-1	73	1182	P42684-4	37	1043	+	36	P42684-1#101	0	5	P42684-4	310	315	+	5	0	0	3685
P42684-1#101	0	5	5	P42684-1	346	351	+	5	P42684-1	52	1182	P42684-3	37	1167	+	35	P42684-1#101	0	5	P42684-3	331	336	+	5	0	0	3686
P42684-1#101	0	5	5	P42684-1	346	351	+	5	P42684-1	73	1182	P42684-2	37	1146	+	34	P42684-1#101	0	5	P42684-2	310	315	+	5	0	0	3687
P42684-1#101	0	5	5	P42684-1	346	351	+	5	P42684-1	52	1182	P42684-10	37	1064	+	33	P42684-1#101	0	5	P42684-10	331	336	+	5	0	0	3688
P42684-1#101	0	5	5	P42684-1	346	351	+	5	P42684-1	0	1182	P42684-1	0	1182	+	32	P42684-1#101	0	5	P42684-1	346	351	+	5	0	0	3689
P42684-1#102	0	4	4	P42684-1	352	356	+	4	P42684-1	0	550	P42684-8	0	529	+	40	P42684-1#102	0	4	P42684-8	331	335	+	4	0	0	3690
P42684-1#102	0	4	4	P42684-1	352	356	+	4	P42684-1	0	1182	P42684-7	0	1058	+	39	P42684-1#102	0	4	P42684-7	331	335	+	4	0	0	3691
P42684-1#102	0	4	4	P42684-1	352	356	+	4	P42684-1	0	1182	P42684-6	0	1161	+	38	P42684-1#102	0	4	P42684-6	331	335	+	4	0	0	3692
P42684-1#102	0	4	4	P42684-1	352	356	+	4	P42684-1	0	1182	P42684-5	0	1079	+	37	P42684-1#102	0	4	P42684-5	352	356	+	4	0	0	3693
P42684-1#102	0	4	4	P42684-1	352	356	+	4	P42684-1	73	1182	P42684-4	37	1043	+	36	P42684-1#102	0	4	P42684-4	316	320	+	4	0	0	3694
P42684-1#102	0	4	4	P42684-1	352	356	+	4	P42684-1	52	1182	P42684-3	37	1167	+	35	P42684-1#102	0	4	P42684-3	337	341	+	4	0	0	3695
P42684-1#102	0	4	4	P42684-1	352	356	+	4	P42684-1	73	1182	P42684-2	37	1146	+	34	P42684-1#102	0	4	P42684-2	316	320	+	4	0	0	3696
P42684-1#102	0	4	4	P42684-1	352	356	+	4	P42684-1	52	1182	P42684-10	37	1064	+	33	P42684-1#102	0	4	P42684-10	337	341	+	4	0	0	3697
P42684-1#102	0	4	4	P42684-1	352	356	+	4	P42684-1	0	1182	P42684-1	0	1182	+	32	P42684-1#102	0	4	P42684-1	352	356	+	4	0	0	3698
P42684-1#103	0	5	5	P42684-1	357	362	+	5	P42684-1	0	550	P42684-8	0	529	+	40	P42684-1#103	0	5	P42684-8	336	341	+	5	0	0	3699
P42684-1#103	0	5	5	P42684-1	357	362	+	5	P42684-1	0	1182	P42684-7	0	1058	+	39	P42684-1#103	0	5	P42684-7	336	341	+	5	0	0	3700
P42684-1#103	0	5	5	P42684-1	357	362	+	5	P42684-1	0	1182	P42684-6	0	1161	+	38	P42684-1#103	0	5	P42684-6	336	341	+	5	0	0	3701
P42684-1#103	0	5	5	P42684-1	357	362	+	5	P42684-1	0	1182	P42684-5	0	1079	+	37	P42684-1#103	0	5	P42684-5	357	362	+	5	0	0	3702
P42684-1#103	0	5	5	P42684-1	357	362	+	5	P42684-1	73	1182	P42684-4	37	1043	+	36	P42684-1#103	0	5	P42684-4	321	326	+	5	0	0	3703
P42684-1#103	0	5	5	P42684-1	357	362	+	5	P42684-1	52	1182	P42684-3	37	1167	+	35	P42684-1#103	0	5	P42684-3	342	347	+	5	0	0	3704
P42684-1#103	0	5	5	P42684-1	357	362	+	5	P42684-1	73	1182	P42684-2	37	1146	+	34	P42684-1#103	0	5	P42684-2	321	326	+	5	0	0	3705
P42684-1#103	0	5	5	P42684-1	357	362	+	5	P42684-1	52	1182	P42684-10	37	1064	+	33	P42684-1#103	0	5	P42684-10	342	347	+	5	0	0	3706
P42684-1#103	0	5	5	P42684-1	357	362	+	5	P42684-1	0	1182	P42684-1	0	1182	+	32	P42684-1#103	0	5	P42684-1	357	362	+	5	0	0	3707
P42684-1#104	0	7	7	P42684-1	368	375	+	7	P42684-1	0	550	P42684-8	0	529	+	40	P42684-1#104	0	7	P42684-8	347	354	+	7	0	0	3708
P42684-1#104	0	7	7	P42684-1	368	375	+	7	P42684-1	0	1182	P42684-7	0	1058	+	39	P42684-1#104	0	7	P42684-7	347	354	+	7	0	0	3709
P42684-1#104	0	7	7	P42684-1	368	375	+	7	P42684-1	0	1182	P42684-6	0	1161	+	38	P42684-1#104	0	7	P42684-6	347	354	+	7	0	0	3710
P42684-1#104	0	7	7	P42684-1	368	375	+	7	P42684-1	0	1182	P42684-5	0	1079	+	37	P42684-1#104	0	7	P42684-5	368	375	+	7	0	0	3711
P42684-1#104	0	7	7	P42684-1	368	375	+	7	P42684-1	73	1182	P42684-4	37	1043	+	36	P42684-1#104	0	7	P42684-4	332	339	+	7	0	0	3712
P42684-1#104	0	7	7	P42684-1	368	375	+	7	P42684-1	52	1182	P42684-3	37	1167	+	35	P42684-1#104	0	7	P42684-3	353	360	+	7	0	0	3713
P42684-1#104	0	7	7	P42684-1	368	375	+	7	P42684-1	73	1182	P42684-2	37	1146	+	34	P42684-1#104	0	7	P42684-2	332	339	+	7	0	0	3714
P42684-1#104	0	7	7	P42684-1	368	375	+	7	P42684-1	52	1182	P42684-10	37	1064	+	33	P42684-1#104	0	7	P42684-10	353	360	+	7	0	0	3715
P42684-1#104	0	7	7	P42684-1	368	375	+	7	P42684-1	0	1182	P42684-1	0	1182	+	32	P42684-1#104	0	7	P42684-1	368	375	+	7	0	0	3716
P42684-1#105	0	3	3	P42684-1	377	380	+	3	P42684-1	0	550	P42684-8	0	529	+	40	P42684-1#105	0	3	P42684-8	356	359	+	3	0	0	3717
P42684-1#105	0	3	3	P42684-1	377	380	+	3	P42684-1	0	1182	P42684-7	0	1058	+	39	P42684-1#105	0	3	P42684-7	356	359	+	3	0	0	3718
P42684-1#105	0	3	3	P42684-1	377	380	+	3	P42684-1	0	1182	P42684-6	0	1161	+	38	P42684-1#105	0	3	P42684-6	356	359	+	3	0	0	3719
P42684-1#105	0	3	3	P42684-1	377	380	+	3	P42684-1	0	1182	P42684-5	0	1079	+	37	P42684-1#105	0	3	P42684-5	377	380	+	3	0	0	3720
P42684-1#105	0	3	3	P42684-1	377	380	+	3	P42684-1	73	1182	P42684-4	37	1043	+	36	P42684-1#105	0	3	P42684-4	341	344	+	3	0	0	3721
P42684-1#105	0	3	3	P42684-1	377	380	+	3	P42684-1	52	1182	P42684-3	37	1167	+	35	P42684-1#105	0	3	P42684-3	362	365	+	3	0	0	3722
P42684-1#105	0	3	3	P42684-1	377	380	+	3	P42684-1	73	1182	P42684-2	37	1146	+	34	P42684-1#105	0	3	P42684-2	341	344	+	3	0	0	3723
P42684-1#105	0	3	3	P42684-1	377	380	+	3	P42684-1	52	1182	P42684-10	37	1064	+	33	P42684-1#105	0	3	P42684-10	362	365	+	3	0	0	3724
P42684-1#105	0	3	3	P42684-1	377	380	+	3	P42684-1	0	1182	P42684-1	0	1182	+	32	P42684-1#105	0	3	P42684-1	377	380	+	3	0	0	3725
P42684-1#106	0	20	20	P42684-1	382	402	+	20	P42684-1	0	550	P42684-8	0	529	+	40	P42684-1#106	0	20	P42684-8	361	381	+	20	0	0	3726
P42684-1#106	0	20	20	P42684-1	382	402	+	20	P42684-1	0	1182	P42684-7	0	1058	+	39	P42684-1#106	0	20	P42684-7	361	381	+	20	0	0	3727
P42684-1#106	0	20	20	P42684-1	382	402	+	20	P42684-1	0	1182	P42684-6	0	1161	+	38	P42684-1#106	0	20	P42684-6	361	381	+	20	0	0	3728
P42684-1#106	0	20	20	P42684-1	382	402	+	20	P42684-1	0	1182	P42684-5	0	1079	+	37	P42684-1#106	0	20	P42684-5	382	402	+	20	0	0	3729
P42684-1#106	0	20	20	P42684-1	382	402	+	20	P42684-1	73	1182	P42684-4	37	1043	+	36	P42684-1#106	0	20	P42684-4	346	366	+	20	0	0	3730
P42684-1#106	0	20	20	P42684-1	382	402	+	20	P42684-1	52	1182	P42684-3	37	1167	+	35	P42684-1#106	0	20	P42684-3	367	387	+	20	0	0	3731
P42684-1#106	0	20	20	P42684-1	382	402	+	20	P42684-1	73	1182	P42684-2	37	1146	+	34	P42684-1#106	0	20	P42684-2	346	366	+	20	0	0	3732
P42684-1#106	0	20	20	P42684-1	382	402	+	20	P42684-1	52	1182	P42684-10	37	1064	+	33	P42684-1#106	0	20	P42684-10	367	387	+	20	0	0	3733
P42684-1#106	0	20	20	P42684-1	382	402	+	20	P42684-1	0	1182	P42684-1	0	1182	+	32	P42684-1#106	0	20	P42684-1	382	402	+	20	0	0	3734
P42684-1#107	0	3	3	P42684-1	411	414	+	3	P42684-1	0	550	P42684-8	0	529	+	40	P42684-1#107	0	3	P42684-8	390	393	+	3	0	0	3735
P42684-1#107	0	3	3	P42684-1	411	414	+	3	P42684-1	0	1182	P42684-7	0	1058	+	39	P42684-1#107	0	3	P42684-7	390	393	+	3	0	0	3736
P42684-1#107	0	3	3	P42684-1	411	414	+	3	P42684-1	0	1182	P42684-6	0	1161	+	38	P42684-1#107	0	3	P42684-6	390	393	+	3	0	0	3737
P42684-1#107	0	3	3	P42684-1	411	414	+	3	P42684-1	0	1182	P42684-5	0	1079	+	37	P42684-1#107	0	3	P42684-5	411	414	+	3	0	0	3738
P42684-1#107	0	3	3	P42684-1	411	414	+	3	P42684-1	73	1182	P42684-4	37	1043	+	36	P42684-1#107	0	3	P42684-4	375	378	+	3	0	0	3739
P42684-1#107	0	3	3	P42684-1	411	414	+	3	P42684-1	52	1182	P42684-3	37	1167	+	35	P42684-1#107	0	3	P42684-3	396	399	+	3	0	0	3740
P42684-1#107	0	3	3	P42684-1	411	414	+	3	P42684-1	73	1182	P42684-2	37	1146	+	34	P42684-1#107	0	3	P42684-2	375	378	+	3	0	0	3741
P42684-1#107	0	3	3	P42684-1	411	414	+	3	P42684-1	52	1182	P42684-10	37	1064	+	33	P42684-1#107	0	3	P42684-10	396	399	+	3	0	0	3742
P42684-1#107	0	3	3	P42684-1	411	414	+	3	P42684-1	0	1182	P42684-1	0	1182	+	32	P42684-1#107	0	3	P42684-1	411	414	+	3	0	0	3743
P42684-1#108	0	3	3	P42684-1	414	417	+	3	P42684-1	0	550	P42684-8	0	529	+	40	P42684-1#108	0	3	P42684-8	393	396	+	3	0	0	3744
P42684-1#108	0	3	3	P42684-1	414	417	+	3	P42684-1	0	1182	P42684-7	0	1058	+	39	P42684-1#108	0	3	P42684-7	393	396	+	3	0	0	3745
P42684-1#108	0	3	3	P42684-1	414	417	+	3	P42684-1	0	1182	P42684-6	0	1161	+	38	P42684-1#108	0	3	P42684-6	393	396	+	3	0	0	3746
P42684-1#108	0	3	3	P42684-1	414	417	+	3	P42684-1	0	1182	P42684-5	0	1079	+	37	P42684-1#108	0	3	P42684-5	414	417	+	3	0	0	3747
P42684-1#108	0	3	3	P42684-1	414	417	+	3	P42684-1	73	1182	P42684-4	37	1043	+	36	P42684-1#108	0	3	P42684-4	378	381	+	3	0	0	3748
P42684-1#108	0	3	3	P42684-1	414	417	+	3	P42684-1	52	1182	P42684-3	37	1167	+	35	P42684-1#108	0	3	P42684-3	399	402	+	3	0	0	3749
P42684-1#108	0	3	3	P42684-1	414	417	+	3	P42684-1	73	1182	P42684-2	37	1146	+	34	P42684-1#108	0	3	P42684-2	378	381	+	3	0	0	3750
P42684-1#108	0	3	3	P42684-1	414	417	+	3	P42684-1	52	1182	P42684-10	37	1064	+	33	P42684-1#108	0	3	P42684-10	399	402	+	3	0	0	3751
P42684-1#108	0	3	3	P42684-1	414	417	+	3	P42684-1	0	1182	P42684-1	0	1182	+	32	P42684-1#108	0	3	P42684-1	414	417	+	3	0	0	3752
P42684-1#109	0	3	3	P42684-1	418	421	+	3	P42684-1	0	550	P42684-8	0	529	+	40	P42684-1#109	0	3	P42684-8	397	400	+	3	0	0	3753
P42684-1#109	0	3	3	P42684-1	418	421	+	3	P42684-1	0	1182	P42684-7	0	1058	+	39	P42684-1#109	0	3	P42684-7	397	400	+	3	0	0	3754
P42684-1#109	0	3	3	P42684-1	418	421	+	3	P42684-1	0	1182	P42684-6	0	1161	+	38	P42684-1#109	0	3	P42684-6	397	400	+	3	0	0	3755
P42684-1#109	0	3	3	P42684-1	418	421	+	3	P42684-1	0	1182	P42684-5	0	1079	+	37	P42684-1#109	0	3	P42684-5	418	421	+	3	0	0	3756
P42684-1#109	0	3	3	P42684-1	418	421	+	3	P42684-1	73	1182	P42684-4	37	1043	+	36	P42684-1#109	0	3	P42684-4	382	385	+	3	0	0	3757
P42684-1#109	0	3	3	P42684-1	418	421	+	3	P42684-1	52	1182	P42684-3	37	1167	+	35	P42684-1#109	0	3	P42684-3	403	406	+	3	0	0	3758
P42684-1#109	0	3	3	P42684-1	418	421	+	3	P42684-1	73	1182	P42684-2	37	1146	+	34	P42684-1#109	0	3	P42684-2	382	385	+	3	0	0	3759
P42684-1#109	0	3	3	P42684-1	418	421	+	3	P42684-1	52	1182	P42684-10	37	1064	+	33	P42684-1#109	0	3	P42684-10	403	406	+	3	0	0	3760
P42684-1#109	0	3	3	P42684-1	418	421	+	3	P42684-1	0	1182	P42684-1	0	1182	+	32	P42684-1#109	0	3	P42684-1	418	421	+	3	0	0	3761
P42684-1#110	0	3	3	P42684-1	422	425	+	3	P42684-1	0	550	P42684-8	0	529	+	40	P42684-1#110	0	3	P42684-8	401	404	+	3	0	0	3762
P42684-1#110	0	3	3	P42684-1	422	425	+	3	P42684-1	0	1182	P42684-7	0	1058	+	39	P42684-1#110	0	3	P42684-7	401	404	+	3	0	0	3763
P42684-1#110	0	3	3	P42684-1	422	425	+	3	P42684-1	0	1182	P42684-6	0	1161	+	38	P42684-1#110	0	3	P42684-6	401	404	+	3	0	0	3764
P42684-1#110	0	3	3	P42684-1	422	425	+	3	P42684-1	0	1182	P42684-5	0	1079	+	37	P42684-1#110	0	3	P42684-5	422	425	+	3	0	0	3765
P42684-1#110	0	3	3	P42684-1	422	425	+	3	P42684-1	73	1182	P42684-4	37	1043	+	36	P42684-1#110	0	3	P42684-4	386	389	+	3	0	0	3766
P42684-1#110	0	3	3	P42684-1	422	425	+	3	P42684-1	52	1182	P42684-3	37	1167	+	35	P42684-1#110	0	3	P42684-3	407	410	+	3	0	0	3767
P42684-1#110	0	3	3	P42684-1	422	425	+	3	P42684-1	73	1182	P42684-2	37	1146	+	34	P42684-1#110	0	3	P42684-2	386	389	+	3	0	0	3768
P42684-1#110	0	3	3	P42684-1	422	425	+	3	P42684-1	52	1182	P42684-10	37	1064	+	33	P42684-1#110	0	3	P42684-10	407	410	+	3	0	0	3769
P42684-1#110	0	3	3	P42684-1	422	425	+	3	P42684-1	0	1182	P42684-1	0	1182	+	32	P42684-1#110	0	3	P42684-1	422	425	+	3	0	0	3770
P42684-1#111	0	3	3	P42684-1	434	437	+	3	P42684-1	0	550	P42684-8	0	529	+	40	P42684-1#111	0	3	P42684-8	413	416	+	3	0	0	3771
P42684-1#111	0	3	3	P42684-1	434	437	+	3	P42684-1	0	1182	P42684-7	0	1058	+	39	P42684-1#111	0	3	P42684-7	413	416	+	3	0	0	3772
P42684-1#111	0	3	3	P42684-1	434	437	+	3	P42684-1	0	1182	P42684-6	0	1161	+	38	P42684-1#111	0	3	P42684-6	413	416	+	3	0	0	3773
P42684-1#111	0	3	3	P42684-1	434	437	+	3	P42684-1	0	1182	P42684-5	0	1079	+	37	P42684-1#111	0	3	P42684-5	434	437	+	3	0	0	3774
P42684-1#111	0	3	3	P42684-1	434	437	+	3	P42684-1	73	1182	P42684-4	37	1043	+	36	P42684-1#111	0	3	P42684-4	398	401	+	3	0	0	3775
P42684-1#111	0	3	3	P42684-1	434	437	+	3	P42684-1	52	1182	P42684-3	37	1167	+	35	P42684-1#111	0	3	P42684-3	419	422	+	3	0	0	3776
P42684-1#111	0	3	3	P42684-1	434	437	+	3	P42684-1	73	1182	P42684-2	37	1146	+	34	P42684-1#111	0	3	P42684-2	398	401	+	3	0	0	3777
P42684-1#111	0	3	3	P42684-1	434	437	+	3	P42684-1	52	1182	P42684-10	37	1064	+	33	P42684-1#111	0	3	P42684-10	419	422	+	3	0	0	3778
P42684-1#111	0	3	3	P42684-1	434	437	+	3	P42684-1	0	1182	P42684-1	0	1182	+	32	P42684-1#111	0	3	P42684-1	434	437	+	3	0	0	3779
P42684-1#112	0	3	3	P42684-1	437	440	+	3	P42684-1	0	550	P42684-8	0	529	+	40	P42684-1#112	0	3	P42684-8	416	419	+	3	0	0	3780
P42684-1#112	0	3	3	P42684-1	437	440	+	3	P42684-1	0	1182	P42684-7	0	1058	+	39	P42684-1#112	0	3	P42684-7	416	419	+	3	0	0	3781
P42684-1#112	0	3	3	P42684-1	437	440	+	3	P42684-1	0	1182	P42684-6	0	1161	+	38	P42684-1#112	0	3	P42684-6	416	419	+	3	0	0	3782
P42684-1#112	0	3	3	P42684-1	437	440	+	3	P42684-1	0	1182	P42684-5	0	1079	+	37	P42684-1#112	0	3	P42684-5	437	440	+	3	0	0	3783
P42684-1#112	0	3	3	P42684-1	437	440	+	3	P42684-1	73	1182	P42684-4	37	1043	+	36	P42684-1#112	0	3	P42684-4	401	404	+	3	0	0	3784
P42684-1#112	0	3	3	P42684-1	437	440	+	3	P42684-1	52	1182	P42684-3	37	1167	+	35	P42684-1#112	0	3	P42684-3	422	425	+	3	0	0	3785
P42684-1#112	0	3	3	P42684-1	437	440	+	3	P42684-1	73	1182	P42684-2	37	1146	+	34	P42684-1#112	0	3	P42684-2	401	404	+	3	0	0	3786
P42684-1#112	0	3	3	P42684-1	437	440	+	3	P42684-1	52	1182	P42684-10	37	1064	+	33	P42684-1#112	0	3	P42684-10	422	425	+	3	0	0	3787
P42684-1#112	0	3	3	P42684-1	437	440	+	3	P42684-1	0	1182	P42684-1	0	1182	+	32	P42684-1#112	0	3	P42684-1	437	440	+	3	0	0	3788
P42684-1#113	0	3	3	P42684-1	448	451	+	3	P42684-1	0	550	P42684-8	0	529	+	40	P42684-1#113	0	3	P42684-8	427	430	+	3	0	0	3789
P42684-1#113	0	3	3	P42684-1	448	451	+	3	P42684-1	0	1182	P42684-7	0	1058	+	39	P42684-1#113	0	3	P42684-7	427	430	+	3	0	0	3790
P42684-1#113	0	3	3	P42684-1	448	451	+	3	P42684-1	0	1182	P42684-6	0	1161	+	38	P42684-1#113	0	3	P42684-6	427	430	+	3	0	0	3791
P42684-1#113	0	3	3	P42684-1	448	451	+	3	P42684-1	0	1182	P42684-5	0	1079	+	37	P42684-1#113	0	3	P42684-5	448	451	+	3	0	0	3792
P42684-1#113	0	3	3	P42684-1	448	451	+	3	P42684-1	73	1182	P42684-4	37	1043	+	36	P42684-1#113	0	3	P42684-4	412	415	+	3	0	0	3793
P42684-1#113	0	3	3	P42684-1	448	451	+	3	P42684-1	52	1182	P42684-3	37	1167	+	35	P42684-1#113	0	3	P42684-3	433	436	+	3	0	0	3794
P42684-1#113	0	3	3	P42684-1	448	451	+	3	P42684-1	73	1182	P42684-2	37	1146	+	34	P42684-1#113	0	3	P42684-2	412	415	+	3	0	0	3795
P42684-1#113	0	3	3	P42684-1	448	451	+	3	P42684-1	52	1182	P42684-10	37	1064	+	33	P42684-1#113	0	3	P42684-10	433	436	+	3	0	0	3796
P42684-1#113	0	3	3	P42684-1	448	451	+	3	P42684-1	0	1182	P42684-1	0	1182	+	32	P42684-1#113	0	3	P42684-1	448	451	+	3	0	0	3797
P42684-1#114	0	6	6	P42684-1	453	459	+	6	P42684-1	0	550	P42684-8	0	529	+	40	P42684-1#114	0	6	P42684-8	432	438	+	6	0	0	3798
P42684-1#114	0	6	6	P42684-1	453	459	+	6	P42684-1	0	1182	P42684-7	0	1058	+	39	P42684-1#114	0	6	P42684-7	432	438	+	6	0	0	3799
P42684-1#114	0	6	6	P42684-1	453	459	+	6	P42684-1	0	1182	P42684-6	0	1161	+	38	P42684-1#114	0	6	P42684-6	432	438	+	6	0	0	3800
P42684-1#114	0	6	6	P42684-1	453	459	+	6	P42684-1	0	1182	P42684-5	0	1079	+	37	P42684-1#114	0	6	P42684-5	453	459	+	6	0	0	3801
P42684-1#114	0	6	6	P42684-1	453	459	+	6	P42684-1	73	1182	P42684-4	37	1043	+	36	P42684-1#114	0	6	P42684-4	417	423	+	6	0	0	3802
P42684-1#114	0	6	6	P42684-1	453	459	+	6	P42684-1	52	1182	P42684-3	37	1167	+	35	P42684-1#114	0	6	P42684-3	438	444	+	6	0	0	3803
P42684-1#114	0	6	6	P42684-1	453	459	+	6	P42684-1	73	1182	P42684-2	37	1146	+	34	P42684-1#114	0	6	P42684-2	417	423	+	6	0	0	3804
P42684-1#114	0	6	6	P42684-1	453	459	+	6	P42684-1	52	1182	P42684-10	37	1064	+	33	P42684-1#114	0	6	P42684-10	438	444	+	6	0	0	3805
P42684-1#114	0	6	6	P42684-1	453	459	+	6	P42684-1	0	1182	P42684-1	0	1182	+	32	P42684-1#114	0	6	P42684-1	453	459	+	6	0	0	3806
P42684-1#115	0	16	16	P42684-1	463	479	+	16	P42684-1	0	550	P42684-8	0	529	+	40	P42684-1#115	0	16	P42684-8	442	458	+	16	0	0	3807
P42684-1#115	0	16	16	P42684-1	463	479	+	16	P42684-1	0	1182	P42684-7	0	1058	+	39	P42684-1#115	0	16	P42684-7	442	458	+	16	0	0	3808
P42684-1#115	0	16	16	P42684-1	463	479	+	16	P42684-1	0	1182	P42684-6	0	1161	+	38	P42684-1#115	0	16	P42684-6	442	458	+	16	0	0	3809
P42684-1#115	0	16	16	P42684-1	463	479	+	16	P42684-1	0	1182	P42684-5	0	1079	+	37	P42684-1#115	0	16	P42684-5	463	479	+	16	0	0	3810
P42684-1#115	0	16	16	P42684-1	463	479	+	16	P42684-1	73	1182	P42684-4	37	1043	+	36	P42684-1#115	0	16	P42684-4	427	443	+	16	0	0	3811
P42684-1#115	0	16	16	P42684-1	463	479	+	16	P42684-1	52	1182	P42684-3	37	1167	+	35	P42684-1#115	0	16	P42684-3	448	464	+	16	0	0	3812
P42684-1#115	0	16	16	P42684-1	463	479	+	16	P42684-1	73	1182	P42684-2	37	1146	+	34	P42684-1#115	0	16	P42684-2	427	443	+	16	0	0	3813
P42684-1#115	0	16	16	P42684-1	463	479	+	16	P42684-1	52	1182	P42684-10	37	1064	+	33	P42684-1#115	0	16	P42684-10	448	464	+	16	0	0	3814
P42684-1#115	0	16	16	P42684-1	463	479	+	16	P42684-1	0	1182	P42684-1	0	1182	+	32	P42684-1#115	0	16	P42684-1	463	479	+	16	0	0	3815
P42684-1#116	0	3	3	P42684-1	490	493	+	3	P42684-1	0	550	P42684-8	0	529	+	40	P42684-1#116	0	3	P42684-8	469	472	+	3	0	0	3816
P42684-1#116	0	3	3	P42684-1	490	493	+	3	P42684-1	0	1182	P42684-7	0	1058	+	39	P42684-1#116	0	3	P42684-7	469	472	+	3	0	0	3817
P42684-1#116	0	3	3	P42684-1	490	493	+	3	P42684-1	0	1182	P42684-6	0	1161	+	38	P42684-1#116	0	3	P42684-6	469	472	+	3	0	0	3818
P42684-1#116	0	3	3	P42684-1	490	493	+	3	P42684-1	0	1182	P42684-5	0	1079	+	37	P42684-1#116	0	3	P42684-5	490	493	+	3	0	0	3819
P42684-1#116	0	3	3	P42684-1	490	493	+	3	P42684-1	73	1182	P42684-4	37	1043	+	36	P42684-1#116	0	3	P42684-4	454	457	+	3	0	0	3820
P42684-1#116	0	3	3	P42684-1	490	493	+	3	P42684-1	52	1182	P42684-3	37	1167	+	35	P42684-1#116	0	3	P42684-3	475	478	+	3	0	0	3821
P42684-1#116	0	3	3	P42684-1	490	493	+	3	P42684-1	73	1182	P42684-2	37	1146	+	34	P42684-1#116	0	3	P42684-2	454	457	+	3	0	0	3822
P42684-1#116	0	3	3	P42684-1	490	493	+	3	P42684-1	52	1182	P42684-10	37	1064	+	33	P42684-1#116	0	3	P42684-10	475	478	+	3	0	0	3823
P42684-1#116	0	3	3	P42684-1	490	493	+	3	P42684-1	0	1182	P42684-1	0	1182	+	32	P42684-1#116	0	3	P42684-1	490	493	+	3	0	0	3824
P42684-1#117	0	6	6	P42684-1	493	499	+	6	P42684-1	0	550	P42684-8	0	529	+	40	P42684-1#117	0	6	P42684-8	472	478	+	6	0	0	3825
P42684-1#117	0	6	6	P42684-1	493	499	+	6	P42684-1	0	1182	P42684-7	0	1058	+	39	P42684-1#117	0	6	P42684-7	472	478	+	6	0	0	3826
P42684-1#117	0	6	6	P42684-1	493	499	+	6	P42684-1	0	1182	P42684-6	0	1161	+	38	P42684-1#117	0	6	P42684-6	472	478	+	6	0	0	3827
P42684-1#117	0	6	6	P42684-1	493	499	+	6	P42684-1	0	1182	P42684-5	0	1079	+	37	P42684-1#117	0	6	P42684-5	493	499	+	6	0	0	3828
P42684-1#117	0	6	6	P42684-1	493	499	+	6	P42684-1	73	1182	P42684-4	37	1043	+	36	P42684-1#117	0	6	P42684-4	457	463	+	6	0	0	3829
P42684-1#117	0	6	6	P42684-1	493	499	+	6	P42684-1	52	1182	P42684-3	37	1167	+	35	P42684-1#117	0	6	P42684-3	478	484	+	6	0	0	3830
P42684-1#117	0	6	6	P42684-1	493	499	+	6	P42684-1	73	1182	P42684-2	37	1146	+	34	P42684-1#117	0	6	P42684-2	457	463	+	6	0	0	3831
P42684-1#117	0	6	6	P42684-1	493	499	+	6	P42684-1	52	1182	P42684-10	37	1064	+	33	P42684-1#117	0	6	P42684-10	478	484	+	6	0	0	3832
P42684-1#117	0	6	6	P42684-1	493	499	+	6	P42684-1	0	1182	P42684-1	0	1182	+	32	P42684-1#117	0	6	P42684-1	493	499	+	6	0	0	3833
P42684-1#118	0	10	10	P42684-1	511	521	+	10	P42684-1	0	550	P42684-8	0	529	+	40	P42684-1#118	0	10	P42684-8	490	500	+	10	0	0	3834
P42684-1#118	0	10	10	P42684-1	511	521	+	10	P42684-1	0	1182	P42684-7	0	1058	+	39	P42684-1#118	0	10	P42684-7	490	500	+	10	0	0	3835
P42684-1#118	0	10	10	P42684-1	511	521	+	10	P42684-1	0	1182	P42684-6	0	1161	+	38	P42684-1#118	0	10	P42684-6	490	500	+	10	0	0	3836
P42684-1#118	0	10	10	P42684-1	511	521	+	10	P42684-1	0	1182	P42684-5	0	1079	+	37	P42684-1#118	0	10	P42684-5	511	521	+	10	0	0	3837
P42684-1#118	0	10	10	P42684-1	511	521	+	10	P42684-1	73	1182	P42684-4	37	1043	+	36	P42684-1#118	0	10	P42684-4	475	485	+	10	0	0	3838
P42684-1#118	0	10	10	P42684-1	511	521	+	10	P42684-1	52	1182	P42684-3	37	1167	+	35	P42684-1#118	0	10	P42684-3	496	506	+	10	0	0	3839
P42684-1#118	0	10	10	P42684-1	511	521	+	10	P42684-1	73	1182	P42684-2	37	1146	+	34	P42684-1#118	0	10	P42684-2	475	485	+	10	0	0	3840
P42684-1#118	0	10	10	P42684-1	511	521	+	10	P42684-1	52	1182	P42684-10	37	1064	+	33	P42684-1#118	0	10	P42684-10	496	506	+	10	0	0	3841
P42684-1#118	0	10	10	P42684-1	511	521	+	10	P42684-1	0	1182	P42684-1	0	1182	+	32	P42684-1#118	0	10	P42684-1	511	521	+	10	0	0	3842
P42684-1#119	0	3	3	P42684-1	525	528	+	3	P42684-1	0	550	P42684-8	0	529	+	40	P42684-1#119	0	3	P42684-8	504	507	+	3	0	0	3843
P42684-1#119	0	3	3	P42684-1	525	528	+	3	P42684-1	0	1182	P42684-7	0	1058	+	39	P42684-1#119	0	3	P42684-7	504	507	+	3	0	0	3844
P42684-1#119	0	3	3	P42684-1	525	528	+	3	P42684-1	0	1182	P42684-6	0	1161	+	38	P42684-1#119	0	3	P42684-6	504	507	+	3	0	0	3845
P42684-1#119	0	3	3	P42684-1	525	528	+	3	P42684-1	0	1182	P42684-5	0	1079	+	37	P42684-1#119	0	3	P42684-5	525	528	+	3	0	0	3846
P42684-1#119	0	3	3	P42684-1	525	528	+	3	P42684-1	73	1182	P42684-4	37	1043	+	36	P42684-1#119	0	3	P42684-4	489	492	+	3	0	0	3847
P42684-1#119	0	3	3	P42684-1	525	528	+	3	P42684-1	52	1182	P42684-3	37	1167	+	35	P42684-1#119	0	3	P42684-3	510	513	+	3	0	0	3848
P42684-1#119	0	3	3	P42684-1	525	528	+	3	P42684-1	73	1182	P42684-2	37	1146	+	34	P42684-1#119	0	3	P42684-2	489	492	+	3	0	0	3849
P42684-1#119	0	3	3	P42684-1	525	528	+	3	P42684-1	52	1182	P42684-10	37	1064	+	33	P42684-1#119	0	3	P42684-10	510	513	+	3	0	0	3850
P42684-1#119	0	3	3	P42684-1	525	528	+	3	P42684-1	0	1182	P42684-1	0	1182	+	32	P42684-1#119	0	3	P42684-1	525	528	+	3	0	0	3851
P42684-1#120	0	14	14	P42684-1	531	545	+	14	P42684-1	0	550	P42684-8	0	529	+	40	P42684-1#120	0	14	P42684-8	510	524	+	14	0	0	3852
P42684-1#120	0	14	14	P42684-1	531	545	+	14	P42684-1	0	1182	P42684-7	0	1058	+	39	P42684-1#120	0	14	P42684-7	510	524	+	14	0	0	3853
P42684-1#120	0	14	14	P42684-1	531	545	+	14	P42684-1	0	1182	P42684-6	0	1161	+	38	P42684-1#120	0	14	P42684-6	510	524	+	14	0	0	3854
P42684-1#120	0	14	14	P42684-1	531	545	+	14	P42684-1	0	1182	P42684-5	0	1079	+	37	P42684-1#120	0	14	P42684-5	531	545	+	14	0	0	3855
P42684-1#120	0	14	14	P42684-1	531	545	+	14	P42684-1	73	1182	P42684-4	37	1043	+	36	P42684-1#120	0	14	P42684-4	495	509	+	14	0	0	3856
P42684-1#120	0	14	14	P42684-1	531	545	+	14	P42684-1	52	1182	P42684-3	37	1167	+	35	P42684-1#120	0	14	P42684-3	516	530	+	14	0	0	3857
P42684-1#120	0	14	14	P42684-1	531	545	+	14	P42684-1	73	1182	P42684-2	37	1146	+	34	P42684-1#120	0	14	P42684-2	495	509	+	14	0	0	3858
P42684-1#120	0	14	14	P42684-1	531	545	+	14	P42684-1	52	1182	P42684-10	37	1064	+	33	P42684-1#120	0	14	P42684-10	516	530	+	14	0	0	3859
P42684-1#120	0	14	14	P42684-1	531	545	+	14	P42684-1	0	1182	P42684-1	0	1182	+	32	P42684-1#120	0	14	P42684-1	531	545	+	14	0	0	3860
P42684-1#121	0	3	3	P42684-1	1068	1071	+	3	P42684-1	0	1182	P42684-7	0	1058	+	39	P42684-1#121	0	3	P42684-7	944	947	+	3	0	0	3861
P42684-1#121	0	3	3	P42684-1	1068	1071	+	3	P42684-1	0	1182	P42684-6	0	1161	+	38	P42684-1#121	0	3	P42684-6	1047	1050	+	3	0	0	3862
P42684-1#121	0	3	3	P42684-1	1068	1071	+	3	P42684-1	0	1182	P42684-5	0	1079	+	37	P42684-1#121	0	3	P42684-5	965	968	+	3	0	0	3863
P42684-1#121	0	3	3	P42684-1	1068	1071	+	3	P42684-1	73	1182	P42684-4	37	1043	+	36	P42684-1#121	0	3	P42684-4	929	932	+	3	0	0	3864
P42684-1#121	0	3	3	P42684-1	1068	1071	+	3	P42684-1	52	1182	P42684-3	37	1167	+	35	P42684-1#121	0	3	P42684-3	1053	1056	+	3	0	0	3865
P42684-1#121	0	3	3	P42684-1	1068	1071	+	3	P42684-1	73	1182	P42684-2	37	1146	+	34	P42684-1#121	0	3	P42684-2	1032	1035	+	3	0	0	3866
P42684-1#121	0	3	3	P42684-1	1068	1071	+	3	P42684-1	52	1182	P42684-10	37	1064	+	33	P42684-1#121	0	3	P42684-10	950	953	+	3	0	0	3867
P42684-1#121	0	3	3	P42684-1	1068	1071	+	3	P42684-1	0	1182	P42684-1	0	1182	+	32	P42684-1#121	0	3	P42684-1	1068	1071	+	3	0	0	3868
P42684-1#122	0	3	3	P42684-1	1075	1078	+	3	P42684-1	0	1182	P42684-7	0	1058	+	39	P42684-1#122	0	3	P42684-7	951	954	+	3	0	0	3869
P42684-1#122	0	3	3	P42684-1	1075	1078	+	3	P42684-1	0	1182	P42684-6	0	1161	+	38	P42684-1#122	0	3	P42684-6	1054	1057	+	3	0	0	3870
P42684-1#122	0	3	3	P42684-1	1075	1078	+	3	P42684-1	0	1182	P42684-5	0	1079	+	37	P42684-1#122	0	3	P42684-5	972	975	+	3	0	0	3871
P42684-1#122	0	3	3	P42684-1	1075	1078	+	3	P42684-1	73	1182	P42684-4	37	1043	+	36	P42684-1#122	0	3	P42684-4	936	939	+	3	0	0	3872
P42684-1#122	0	3	3	P42684-1	1075	1078	+	3	P42684-1	52	1182	P42684-3	37	1167	+	35	P42684-1#122	0	3	P42684-3	1060	1063	+	3	0	0	3873
P42684-1#122	0	3	3	P42684-1	1075	1078	+	3	P42684-1	73	1182	P42684-2	37	1146	+	34	P42684-1#122	0	3	P42684-2	1039	1042	+	3	0	0	3874
P42684-1#122	0	3	3	P42684-1	1075	1078	+	3	P42684-1	52	1182	P42684-10	37	1064	+	33	P42684-1#122	0	3	P42684-10	957	960	+	3	0	0	3875
P42684-1#122	0	3	3	P42684-1	1075	1078	+	3	P42684-1	0	1182	P42684-1	0	1182	+	32	P42684-1#122	0	3	P42684-1	1075	1078	+	3	0	0	3876
P42684-1#123	0	4	4	P42684-1	1079	1083	+	4	P42684-1	0	1182	P42684-7	0	1058	+	39	P42684-1#123	0	4	P42684-7	955	959	+	4	0	0	3877
P42684-1#123	0	4	4	P42684-1	1079	1083	+	4	P42684-1	0	1182	P42684-6	0	1161	+	38	P42684-1#123	0	4	P42684-6	1058	1062	+	4	0	0	3878
P42684-1#123	0	4	4	P42684-1	1079	1083	+	4	P42684-1	0	1182	P42684-5	0	1079	+	37	P42684-1#123	0	4	P42684-5	976	980	+	4	0	0	3879
P42684-1#123	0	4	4	P42684-1	1079	1083	+	4	P42684-1	73	1182	P42684-4	37	1043	+	36	P42684-1#123	0	4	P42684-4	940	944	+	4	0	0	3880
P42684-1#123	0	4	4	P42684-1	1079	1083	+	4	P42684-1	52	1182	P42684-3	37	1167	+	35	P42684-1#123	0	4	P42684-3	1064	1068	+	4	0	0	3881
P42684-1#123	0	4	4	P42684-1	1079	1083	+	4	P42684-1	73	1182	P42684-2	37	1146	+	34	P42684-1#123	0	4	P42684-2	1043	1047	+	4	0	0	3882
P42684-1#123	0	4	4	P42684-1	1079	1083	+	4	P42684-1	52	1182	P42684-10	37	1064	+	33	P42684-1#123	0	4	P42684-10	961	965	+	4	0	0	3883
P42684-1#123	0	4	4	P42684-1	1079	1083	+	4	P42684-1	0	1182	P42684-1	0	1182	+	32	P42684-1#123	0	4	P42684-1	1079	1083	+	4	0	0	3884
P42684-1#124	0	14	14	P42684-1	1085	1099	+	14	P42684-1	0	1182	P42684-7	0	1058	+	39	P42684-1#124	0	14	P42684-7	961	975	+	14	0	0	3885
P42684-1#124	0	14	14	P42684-1	1085	1099	+	14	P42684-1	0	1182	P42684-6	0	1161	+	38	P42684-1#124	0	14	P42684-6	1064	1078	+	14	0	0	3886
P42684-1#124	0	14	14	P42684-1	1085	1099	+	14	P42684-1	0	1182	P42684-5	0	1079	+	37	P42684-1#124	0	14	P42684-5	982	996	+	14	0	0	3887
P42684-1#124	0	14	14	P42684-1	1085	1099	+	14	P42684-1	73	1182	P42684-4	37	1043	+	36	P42684-1#124	0	14	P42684-4	946	960	+	14	0	0	3888
P42684-1#124	0	14	14	P42684-1	1085	1099	+	14	P42684-1	52	1182	P42684-3	37	1167	+	35	P42684-1#124	0	14	P42684-3	1070	1084	+	14	0	0	3889
P42684-1#124	0	14	14	P42684-1	1085	1099	+	14	P42684-1	73	1182	P42684-2	37	1146	+	34	P42684-1#124	0	14	P42684-2	1049	1063	+	14	0	0	3890
P42684-1#124	0	14	14	P42684-1	1085	1099	+	14	P42684-1	52	1182	P42684-10	37	1064	+	33	P42684-1#124	0	14	P42684-10	967	981	+	14	0	0	3891
P42684-1#124	0	14	14	P42684-1	1085	1099	+	14	P42684-1	0	1182	P42684-1	0	1182	+	32	P42684-1#124	0	14	P42684-1	1085	1099	+	14	0	0	3892
P42684-1#125	0	18	18	P42684-1	1105	1123	+	18	P42684-1	0	1182	P42684-7	0	1058	+	39	P42684-1#125	0	18	P42684-7	981	999	+	18	0	0	3893
P42684-1#125	0	18	18	P42684-1	1105	1123	+	18	P42684-1	0	1182	P42684-6	0	1161	+	38	P42684-1#125	0	18	P42684-6	1084	1102	+	18	0	0	3894
P42684-1#125	0	18	18	P42684-1	1105	1123	+	18	P42684-1	0	1182	P42684-5	0	1079	+	37	P42684-1#125	0	18	P42684-5	1002	1020	+	18	0	0	3895
P42684-1#125	0	18	18	P42684-1	1105	1123	+	18	P42684-1	73	1182	P42684-4	37	1043	+	36	P42684-1#125	0	18	P42684-4	966	984	+	18	0	0	3896
P42684-1#125	0	18	18	P42684-1	1105	1123	+	18	P42684-1	52	1182	P42684-3	37	1167	+	35	P42684-1#125	0	18	P42684-3	1090	1108	+	18	0	0	3897
P42684-1#125	0	18	18	P42684-1	1105	1123	+	18	P42684-1	73	1182	P42684-2	37	1146	+	34	P42684-1#125	0	18	P42684-2	1069	1087	+	18	0	0	3898
P42684-1#125	0	18	18	P42684-1	1105	1123	+	18	P42684-1	52	1182	P42684-10	37	1064	+	33	P42684-1#125	0	18	P42684-10	987	1005	+	18	0	0	3899
P42684-1#125	0	18	18	P42684-1	1105	1123	+	18	P42684-1	0	1182	P42684-1	0	1182	+	32	P42684-1#125	0	18	P42684-1	1105	1123	+	18	0	0	3900
P42684-1#126	0	3	3	P42684-1	1123	1126	+	3	P42684-1	0	1182	P42684-7	0	1058	+	39	P42684-1#126	0	3	P42684-7	999	1002	+	3	0	0	3901
P42684-1#126	0	3	3	P42684-1	1123	1126	+	3	P42684-1	0	1182	P42684-6	0	1161	+	38	P42684-1#126	0	3	P42684-6	1102	1105	+	3	0	0	3902
P42684-1#126	0	3	3	P42684-1	1123	1126	+	3	P42684-1	0	1182	P42684-5	0	1079	+	37	P42684-1#126	0	3	P42684-5	1020	1023	+	3	0	0	3903
P42684-1#126	0	3	3	P42684-1	1123	1126	+	3	P42684-1	73	1182	P42684-4	37	1043	+	36	P42684-1#126	0	3	P42684-4	984	987	+	3	0	0	3904
P42684-1#126	0	3	3	P42684-1	1123	1126	+	3	P42684-1	52	1182	P42684-3	37	1167	+	35	P42684-1#126	0	3	P42684-3	1108	1111	+	3	0	0	3905
P42684-1#126	0	3	3	P42684-1	1123	1126	+	3	P42684-1	73	1182	P42684-2	37	1146	+	34	P42684-1#126	0	3	P42684-2	1087	1090	+	3	0	0	3906
P42684-1#126	0	3	3	P42684-1	1123	1126	+	3	P42684-1	52	1182	P42684-10	37	1064	+	33	P42684-1#126	0	3	P42684-10	1005	1008	+	3	0	0	3907
P42684-1#126	0	3	3	P42684-1	1123	1126	+	3	P42684-1	0	1182	P42684-1	0	1182	+	32	P42684-1#126	0	3	P42684-1	1123	1126	+	3	0	0	3908
P42684-1#127	0	23	23	P42684-1	1129	1152	+	23	P42684-1	0	1182	P42684-7	0	1058	+	39	P42684-1#127	0	23	P42684-7	1005	1028	+	23	0	0	3909
P42684-1#127	0	23	23	P42684-1	1129	1152	+	23	P42684-1	0	1182	P42684-6	0	1161	+	38	P42684-1#127	0	23	P42684-6	1108	1131	+	23	0	0	3910
P42684-1#127	0	23	23	P42684-1	1129	1152	+	23	P42684-1	0	1182	P42684-5	0	1079	+	37	P42684-1#127	0	23	P42684-5	1026	1049	+	23	0	0	3911
P42684-1#127	0	23	23	P42684-1	1129	1152	+	23	P42684-1	73	1182	P42684-4	37	1043	+	36	P42684-1#127	0	23	P42684-4	990	1013	+	23	0	0	3912
P42684-1#127	0	23	23	P42684-1	1129	1152	+	23	P42684-1	52	1182	P42684-3	37	1167	+	35	P42684-1#127	0	23	P42684-3	1114	1137	+	23	0	0	3913
P42684-1#127	0	23	23	P42684-1	1129	1152	+	23	P42684-1	73	1182	P42684-2	37	1146	+	34	P42684-1#127	0	23	P42684-2	1093	1116	+	23	0	0	3914
P42684-1#127	0	23	23	P42684-1	1129	1152	+	23	P42684-1	52	1182	P42684-10	37	1064	+	33	P42684-1#127	0	23	P42684-10	1011	1034	+	23	0	0	3915
P42684-1#127	0	23	23	P42684-1	1129	1152	+	23	P42684-1	0	1182	P42684-1	0	1182	+	32	P42684-1#127	0	23	P42684-1	1129	1152	+	23	0	0	3916
P42684-1#128	0	4	4	P42684-1	1154	1158	+	4	P42684-1	0	1182	P42684-7	0	1058	+	39	P42684-1#128	0	4	P42684-7	1030	1034	+	4	0	0	3917
P42684-1#128	0	4	4	P42684-1	1154	1158	+	4	P42684-1	0	1182	P42684-6	0	1161	+	38	P42684-1#128	0	4	P42684-6	1133	1137	+	4	0	0	3918
P42684-1#128	0	4	4	P42684-1	1154	1158	+	4	P42684-1	0	1182	P42684-5	0	1079	+	37	P42684-1#128	0	4	P42684-5	1051	1055	+	4	0	0	3919
P42684-1#128	0	4	4	P42684-1	1154	1158	+	4	P42684-1	73	1182	P42684-4	37	1043	+	36	P42684-1#128	0	4	P42684-4	1015	1019	+	4	0	0	3920
P42684-1#128	0	4	4	P42684-1	1154	1158	+	4	P42684-1	52	1182	P42684-3	37	1167	+	35	P42684-1#128	0	4	P42684-3	1139	1143	+	4	0	0	3921
P42684-1#128	0	4	4	P42684-1	1154	1158	+	4	P42684-1	73	1182	P42684-2	37	1146	+	34	P42684-1#128	0	4	P42684-2	1118	1122	+	4	0	0	3922
P42684-1#128	0	4	4	P42684-1	1154	1158	+	4	P42684-1	52	1182	P42684-10	37	1064	+	33	P42684-1#128	0	4	P42684-10	1036	1040	+	4	0	0	3923
P42684-1#128	0	4	4	P42684-1	1154	1158	+	4	P42684-1	0	1182	P42684-1	0	1182	+	32	P42684-1#128	0	4	P42684-1	1154	1158	+	4	0	0	3924
P42684-1#129	0	17	17	P42684-1	1164	1181	+	17	P42684-1	0	1182	P42684-7	0	1058	+	39	P42684-1#129	0	17	P42684-7	1040	1057	+	17	0	0	3925
P42684-1#129	0	17	17	P42684-1	1164	1181	+	17	P42684-1	0	1182	P42684-6	0	1161	+	38	P42684-1#129	0	17	P42684-6	1143	1160	+	17	0	0	3926
P42684-1#129	0	17	17	P42684-1	1164	1181	+	17	P42684-1	0	1182	P42684-5	0	1079	+	37	P42684-1#129	0	17	P42684-5	1061	1078	+	17	0	0	3927
P42684-1#129	0	17	17	P42684-1	1164	1181	+	17	P42684-1	73	1182	P42684-4	37	1043	+	36	P42684-1#129	0	17	P42684-4	1025	1042	+	17	0	0	3928
P42684-1#129	0	17	17	P42684-1	1164	1181	+	17	P42684-1	52	1182	P42684-3	37	1167	+	35	P42684-1#129	0	17	P42684-3	1149	1166	+	17	0	0	3929
P42684-1#129	0	17	17	P42684-1	1164	1181	+	17	P42684-1	73	1182	P42684-2	37	1146	+	34	P42684-1#129	0	17	P42684-2	1128	1145	+	17	0	0	3930
P42684-1#129	0	17	17	P42684-1	1164	1181	+	17	P42684-1	52	1182	P42684-10	37	1064	+	33	P42684-1#129	0	17	P42684-10	1046	1063	+	17	0	0	3931
P42684-1#129	0	17	17	P42684-1	1164	1181	+	17	P42684-1	0	1182	P42684-1	0	1182	+	32	P42684-1#129	0	17	P42684-1	1164	1181	+	17	0	0	3932
P42684-1#130	0	1	1	P42684-1	646	647	+	1	P42684-1	0	1182	P42684-7	0	1058	+	39	P42684-1#130	0	1	P42684-7	625	626	+	1	0	0	3933
P42684-1#130	0	1	1	P42684-1	646	647	+	1	P42684-1	0	1182	P42684-6	0	1161	+	38	P42684-1#130	0	1	P42684-6	625	626	+	1	0	0	3934
P42684-1#130	0	1	1	P42684-1	646	647	+	1	P42684-1	0	1182	P42684-5	0	1079	+	37	P42684-1#130	0	1	P42684-5	646	647	+	1	0	0	3935
P42684-1#130	0	1	1	P42684-1	646	647	+	1	P42684-1	73	1182	P42684-4	37	1043	+	36	P42684-1#130	0	1	P42684-4	610	611	+	1	0	0	3936
P42684-1#130	0	1	1	P42684-1	646	647	+	1	P42684-1	52	1182	P42684-3	37	1167	+	35	P42684-1#130	0	1	P42684-3	631	632	+	1	0	0	3937
P42684-1#130	0	1	1	P42684-1	646	647	+	1	P42684-1	73	1182	P42684-2	37	1146	+	34	P42684-1#130	0	1	P42684-2	610	611	+	1	0	0	3938
P42684-1#130	0	1	1	P42684-1	646	647	+	1	P42684-1	52	1182	P42684-10	37	1064	+	33	P42684-1#130	0	1	P42684-10	631	632	+	1	0	0	3939
P42684-1#130	0	1	1	P42684-1	646	647	+	1	P42684-1	0	1182	P42684-1	0	1182	+	32	P42684-1#130	0	1	P42684-1	646	647	+	1	0	0	3940
P42684-1#131	0	1	1	P42684-1	11	12	+	1	P42684-1	0	550	P42684-8	0	529	+	40	P42684-1#131	0	1	P42684-8	11	12	+	1	0	0	3941
P42684-1#131	0	1	1	P42684-1	11	12	+	1	P42684-1	0	1182	P42684-7	0	1058	+	39	P42684-1#131	0	1	P42684-7	11	12	+	1	0	0	3942
P42684-1#131	0	1	1	P42684-1	11	12	+	1	P42684-1	0	1182	P42684-6	0	1161	+	38	P42684-1#131	0	1	P42684-6	11	12	+	1	0	0	3943
P42684-1#131	0	1	1	P42684-1	11	12	+	1	P42684-1	0	1182	P42684-5	0	1079	+	37	P42684-1#131	0	1	P42684-5	11	12	+	1	0	0	3944
P42684-1#131	0	1	1	P42684-1	11	12	+	1	P42684-1	0	1182	P42684-1	0	1182	+	32	P42684-1#131	0	1	P42684-1	11	12	+	1	0	0	3945
P42684-1#132	0	1	1	P42684-1	682	683	+	1	P42684-1	0	1182	P42684-7	0	1058	+	39	P42684-1#132	0	1	P42684-7	661	662	+	1	0	0	3946
P42684-1#132	0	1	1	P42684-1	682	683	+	1	P42684-1	0	1182	P42684-6	0	1161	+	38	P42684-1#132	0	1	P42684-6	661	662	+	1	0	0	3947
P42684-1#132	0	1	1	P42684-1	682	683	+	1	P42684-1	0	1182	P42684-5	0	1079	+	37	P42684-1#132	0	1	P42684-5	682	683	+	1	0	0	3948
P42684-1#132	0	1	1	P42684-1	682	683	+	1	P42684-1	73	1182	P42684-4	37	1043	+	36	P42684-1#132	0	1	P42684-4	646	647	+	1	0	0	3949
P42684-1#132	0	1	1	P42684-1	682	683	+	1	P42684-1	52	1182	P42684-3	37	1167	+	35	P42684-1#132	0	1	P42684-3	667	668	+	1	0	0	3950
P42684-1#132	0	1	1	P42684-1	682	683	+	1	P42684-1	73	1182	P42684-2	37	1146	+	34	P42684-1#132	0	1	P42684-2	646	647	+	1	0	0	3951
P42684-1#132	0	1	1	P42684-1	682	683	+	1	P42684-1	52	1182	P42684-10	37	1064	+	33	P42684-1#132	0	1	P42684-10	667	668	+	1	0	0	3952
P42684-1#132	0	1	1	P42684-1	682	683	+	1	P42684-1	0	1182	P42684-1	0	1182	+	32	P42684-1#132	0	1	P42684-1	682	683	+	1	0	0	3953
P42684-1#133	0	1	1	P42684-1	661	662	+	1	P42684-1	0	1182	P42684-7	0	1058	+	39	P42684-1#133	0	1	P42684-7	640	641	+	1	0	0	3954
P42684-1#133	0	1	1	P42684-1	661	662	+	1	P42684-1	0	1182	P42684-6	0	1161	+	38	P42684-1#133	0	1	P42684-6	640	641	+	1	0	0	3955
P42684-1#133	0	1	1	P42684-1	661	662	+	1	P42684-1	0	1182	P42684-5	0	1079	+	37	P42684-1#133	0	1	P42684-5	661	662	+	1	0	0	3956
P42684-1#133	0	1	1	P42684-1	661	662	+	1	P42684-1	73	1182	P42684-4	37	1043	+	36	P42684-1#133	0	1	P42684-4	625	626	+	1	0	0	3957
P42684-1#133	0	1	1	P42684-1	661	662	+	1	P42684-1	52	1182	P42684-3	37	1167	+	35	P42684-1#133	0	1	P42684-3	646	647	+	1	0	0	3958
P42684-1#133	0	1	1	P42684-1	661	662	+	1	P42684-1	73	1182	P42684-2	37	1146	+	34	P42684-1#133	0	1	P42684-2	625	626	+	1	0	0	3959
P42684-1#133	0	1	1	P42684-1	661	662	+	1	P42684-1	52	1182	P42684-10	37	1064	+	33	P42684-1#133	0	1	P42684-10	646	647	+	1	0	0	3960
P42684-1#133	0	1	1	P42684-1	661	662	+	1	P42684-1	0	1182	P42684-1	0	1182	+	32	P42684-1#133	0	1	P42684-1	661	662	+	1	0	0	3961
P42684-1#134	0	1	1	P42684-1	667	668	+	1	P42684-1	0	1182	P42684-7	0	1058	+	39	P42684-1#134	0	1	P42684-7	646	647	+	1	0	0	3962
P42684-1#134	0	1	1	P42684-1	667	668	+	1	P42684-1	0	1182	P42684-6	0	1161	+	38	P42684-1#134	0	1	P42684-6	646	647	+	1	0	0	3963
P42684-1#134	0	1	1	P42684-1	667	668	+	1	P42684-1	0	1182	P42684-5	0	1079	+	37	P42684-1#134	0	1	P42684-5	667	668	+	1	0	0	3964
P42684-1#134	0	1	1	P42684-1	667	668	+	1	P42684-1	73	1182	P42684-4	37	1043	+	36	P42684-1#134	0	1	P42684-4	631	632	+	1	0	0	3965
P42684-1#134	0	1	1	P42684-1	667	668	+	1	P42684-1	52	1182	P42684-3	37	1167	+	35	P42684-1#134	0	1	P42684-3	652	653	+	1	0	0	3966
P42684-1#134	0	1	1	P42684-1	667	668	+	1	P42684-1	73	1182	P42684-2	37	1146	+	34	P42684-1#134	0	1	P42684-2	631	632	+	1	0	0	3967
P42684-1#134	0	1	1	P42684-1	667	668	+	1	P42684-1	52	1182	P42684-10	37	1064	+	33	P42684-1#134	0	1	P42684-10	652	653	+	1	0	0	3968
P42684-1#134	0	1	1	P42684-1	667	668	+	1	P42684-1	0	1182	P42684-1	0	1182	+	32	P42684-1#134	0	1	P42684-1	667	668	+	1	0	0	3969
Q9Y215-1#0	0	22	22	Q9Y215-1	0	22	+	22	Q9Y215-1	0	272	Q9Y215-8	0	272	+	109	Q9Y215-1#0	0	22	Q9Y215-8	0	22	+	22	0	0	3970
Q9Y215-1#0	0	22	22	Q9Y215-1	0	22	+	22	Q9Y215-1	0	271	Q9Y215-7	0	271	+	108	Q9Y215-1#0	0	22	Q9Y215-7	0	22	+	22	0	0	3971
Q9Y215-1#0	0	22	22	Q9Y215-1	0	22	+	22	Q9Y215-1	0	239	Q9Y215-6	0	239	+	107	Q9Y215-1#0	0	22	Q9Y215-6	0	22	+	22	0	0	3972
Q9Y215-1#0	0	22	22	Q9Y215-1	0	22	+	22	Q9Y215-1	0	455	Q9Y215-5	0	446	+	106	Q9Y215-1#0	0	22	Q9Y215-5	0	22	+	22	0	0	3973
Q9Y215-1#0	0	22	22	Q9Y215-1	0	22	+	22	Q9Y215-1	0	455	Q9Y215-4	0	451	+	105	Q9Y215-1#0	0	22	Q9Y215-4	0	22	+	22	0	0	3974
Q9Y215-1#0	0	22	22	Q9Y215-1	0	22	+	22	Q9Y215-1	0	455	Q9Y215-3	0	421	+	104	Q9Y215-1#0	0	22	Q9Y215-3	0	22	+	22	0	0	3975
Q9Y215-1#0	0	22	22	Q9Y215-1	0	22	+	22	Q9Y215-1	0	455	Q9Y215-1	0	455	+	102	Q9Y215-1#0	0	22	Q9Y215-1	0	22	+	22	0	0	3976
Q9Y215-1#1	0	433	433	Q9Y215-1	22	455	+	433	Q9Y215-1	0	272	Q9Y215-8	0	272	+	109	Q9Y215-1#1	0	250	Q9Y215-8	22	272	+	250	0	183	3977
Q9Y215-1#1	0	433	433	Q9Y215-1	22	455	+	433	Q9Y215-1	0	271	Q9Y215-7	0	271	+	108	Q9Y215-1#1	0	249	Q9Y215-7	22	271	+	249	0	184	3978
Q9Y215-1#1	0	433	433	Q9Y215-1	22	455	+	433	Q9Y215-1	0	239	Q9Y215-6	0	239	+	107	Q9Y215-1#1	0	217	Q9Y215-6	22	239	+	217	0	216	3979
Q9Y215-1#1	0	433	433	Q9Y215-1	22	455	+	433	Q9Y215-1	0	455	Q9Y215-5	0	446	+	106	Q9Y215-1#1	0	433	Q9Y215-5	22	446	+	424	0	0	3980
Q9Y215-1#1	0	433	433	Q9Y215-1	22	455	+	433	Q9Y215-1	0	455	Q9Y215-4	0	451	+	105	Q9Y215-1#1	0	433	Q9Y215-4	22	451	+	429	0	0	3981
Q9Y215-1#1	0	433	433	Q9Y215-1	22	455	+	433	Q9Y215-1	0	455	Q9Y215-3	0	421	+	104	Q9Y215-1#1	0	433	Q9Y215-3	22	421	+	399	0	0	3982
Q9Y215-1#1	0	433	433	Q9Y215-1	22	455	+	433	Q9Y215-1	35	455	Q9Y215-2	25	445	+	103	Q9Y215-1#1	13	433	Q9Y215-2	25	445	+	420	13	0	3983
Q9Y215-1#1	0	433	433	Q9Y215-1	22	455	+	433	Q9Y215-1	0	455	Q9Y215-1	0	455	+	102	Q9Y215-1#1	0	433	Q9Y215-1	22	455	+	433	0	0	3984
Q9Y215-1#2	0	174	174	Q9Y215-1	95	269	+	174	Q9Y215-1	0	272	Q9Y215-8	0	272	+	109	Q9Y215-1#2	0	174	Q9Y215-8	95	269	+	174	0	0	3985
Q9Y215-1#2	0	174	174	Q9Y215-1	95	269	+	174	Q9Y215-1	0	271	Q9Y215-7	0	271	+	108	Q9Y215-1#2	0	174	Q9Y215-7	95	269	+	174	0	0	3986
Q9Y215-1#2	0	174	174	Q9Y215-1	95	269	+	174	Q9Y215-1	0	239	Q9Y215-6	0	239	+	107	Q9Y215-1#2	0	144	Q9Y215-6	95	239	+	144	0	30	3987
Q9Y215-1#2	0	174	174	Q9Y215-1	95	269	+	174	Q9Y215-1	0	455	Q9Y215-5	0	446	+	106	Q9Y215-1#2	0	174	Q9Y215-5	95	260	+	165	0	0	3988
Q9Y215-1#2	0	174	174	Q9Y215-1	95	269	+	174	Q9Y215-1	0	455	Q9Y215-4	0	451	+	105	Q9Y215-1#2	0	174	Q9Y215-4	91	265	+	174	0	0	3989
Q9Y215-1#2	0	174	174	Q9Y215-1	95	269	+	174	Q9Y215-1	0	455	Q9Y215-3	0	421	+	104	Q9Y215-1#2	4	174	Q9Y215-3	71	235	+	164	4	0	3990
Q9Y215-1#2	0	174	174	Q9Y215-1	95	269	+	174	Q9Y215-1	35	455	Q9Y215-2	25	445	+	103	Q9Y215-1#2	0	174	Q9Y215-2	85	259	+	174	0	0	3991
Q9Y215-1#2	0	174	174	Q9Y215-1	95	269	+	174	Q9Y215-1	0	455	Q9Y215-1	0	455	+	102	Q9Y215-1#2	0	174	Q9Y215-1	95	269	+	174	0	0	3992
Q9Y215-1#3	0	15	15	Q9Y215-1	276	291	+	15	Q9Y215-1	0	455	Q9Y215-5	0	446	+	106	Q9Y215-1#3	0	15	Q9Y215-5	267	282	+	15	0	0	3993
Q9Y215-1#3	0	15	15	Q9Y215-1	276	291	+	15	Q9Y215-1	0	455	Q9Y215-4	0	451	+	105	Q9Y215-1#3	0	15	Q9Y215-4	272	287	+	15	0	0	3994
Q9Y215-1#3	0	15	15	Q9Y215-1	276	291	+	15	Q9Y215-1	0	455	Q9Y215-3	0	421	+	104	Q9Y215-1#3	0	15	Q9Y215-3	242	257	+	15	0	0	3995
Q9Y215-1#3	0	15	15	Q9Y215-1	276	291	+	15	Q9Y215-1	35	455	Q9Y215-2	25	445	+	103	Q9Y215-1#3	0	15	Q9Y215-2	266	281	+	15	0	0	3996
Q9Y215-1#3	0	15	15	Q9Y215-1	276	291	+	15	Q9Y215-1	0	455	Q9Y215-1	0	455	+	102	Q9Y215-1#3	0	15	Q9Y215-1	276	291	+	15	0	0	3997
Q9Y215-1#4	0	17	17	Q9Y215-1	50	67	+	17	Q9Y215-1	0	272	Q9Y215-8	0	272	+	109	Q9Y215-1#4	0	17	Q9Y215-8	50	67	+	17	0	0	3998
Q9Y215-1#4	0	17	17	Q9Y215-1	50	67	+	17	Q9Y215-1	0	271	Q9Y215-7	0	271	+	108	Q9Y215-1#4	0	17	Q9Y215-7	50	67	+	17	0	0	3999
Q9Y215-1#4	0	17	17	Q9Y215-1	50	67	+	17	Q9Y215-1	0	239	Q9Y215-6	0	239	+	107	Q9Y215-1#4	0	17	Q9Y215-6	50	67	+	17	0	0	4000
Q9Y215-1#4	0	17	17	Q9Y215-1	50	67	+	17	Q9Y215-1	0	455	Q9Y215-5	0	446	+	106	Q9Y215-1#4	0	17	Q9Y215-5	50	67	+	17	0	0	4001
Q9Y215-1#4	0	17	17	Q9Y215-1	50	67	+	17	Q9Y215-1	0	455	Q9Y215-4	0	451	+	105	Q9Y215-1#4	0	17	Q9Y215-4	50	67	+	17	0	0	4002
Q9Y215-1#4	0	17	17	Q9Y215-1	50	67	+	17	Q9Y215-1	0	455	Q9Y215-3	0	421	+	104	Q9Y215-1#4	0	17	Q9Y215-3	50	67	+	17	0	0	4003
Q9Y215-1#4	0	17	17	Q9Y215-1	50	67	+	17	Q9Y215-1	35	455	Q9Y215-2	25	445	+	103	Q9Y215-1#4	0	17	Q9Y215-2	40	57	+	17	0	0	4004
Q9Y215-1#4	0	17	17	Q9Y215-1	50	67	+	17	Q9Y215-1	0	455	Q9Y215-1	0	455	+	102	Q9Y215-1#4	0	17	Q9Y215-1	50	67	+	17	0	0	4005
Q9Y215-1#5	0	193	193	Q9Y215-1	89	282	+	193	Q9Y215-1	0	272	Q9Y215-8	0	272	+	109	Q9Y215-1#5	0	183	Q9Y215-8	89	272	+	183	0	10	4006
Q9Y215-1#5	0	193	193	Q9Y215-1	89	282	+	193	Q9Y215-1	0	271	Q9Y215-7	0	271	+	108	Q9Y215-1#5	0	182	Q9Y215-7	89	271	+	182	0	11	4007
Q9Y215-1#5	0	193	193	Q9Y215-1	89	282	+	193	Q9Y215-1	0	239	Q9Y215-6	0	239	+	107	Q9Y215-1#5	0	150	Q9Y215-6	89	239	+	150	0	43	4008
Q9Y215-1#5	0	193	193	Q9Y215-1	89	282	+	193	Q9Y215-1	0	455	Q9Y215-5	0	446	+	106	Q9Y215-1#5	0	193	Q9Y215-5	89	273	+	184	0	0	4009
Q9Y215-1#5	0	193	193	Q9Y215-1	89	282	+	193	Q9Y215-1	0	455	Q9Y215-4	0	451	+	105	Q9Y215-1#5	0	193	Q9Y215-4	85	278	+	193	0	0	4010
Q9Y215-1#5	0	193	193	Q9Y215-1	89	282	+	193	Q9Y215-1	0	455	Q9Y215-3	0	421	+	104	Q9Y215-1#5	10	193	Q9Y215-3	71	248	+	177	10	0	4011
Q9Y215-1#5	0	193	193	Q9Y215-1	89	282	+	193	Q9Y215-1	35	455	Q9Y215-2	25	445	+	103	Q9Y215-1#5	0	193	Q9Y215-2	79	272	+	193	0	0	4012
Q9Y215-1#5	0	193	193	Q9Y215-1	89	282	+	193	Q9Y215-1	0	455	Q9Y215-1	0	455	+	102	Q9Y215-1#5	0	193	Q9Y215-1	89	282	+	193	0	0	4013
Q9Y215-1#6	0	4	4	Q9Y215-1	129	133	+	4	Q9Y215-1	0	272	Q9Y215-8	0	272	+	109	Q9Y215-1#6	0	4	Q9Y215-8	129	133	+	4	0	0	4014
Q9Y215-1#6	0	4	4	Q9Y215-1	129	133	+	4	Q9Y215-1	0	271	Q9Y215-7	0	271	+	108	Q9Y215-1#6	0	4	Q9Y215-7	129	133	+	4	0	0	4015
Q9Y215-1#6	0	4	4	Q9Y215-1	129	133	+	4	Q9Y215-1	0	239	Q9Y215-6	0	239	+	107	Q9Y215-1#6	0	4	Q9Y215-6	129	133	+	4	0	0	4016
Q9Y215-1#6	0	4	4	Q9Y215-1	129	133	+	4	Q9Y215-1	0	455	Q9Y215-5	0	446	+	106	Q9Y215-1#6	1	4	Q9Y215-5	121	124	+	3	1	0	4017
Q9Y215-1#6	0	4	4	Q9Y215-1	129	133	+	4	Q9Y215-1	0	455	Q9Y215-4	0	451	+	105	Q9Y215-1#6	0	4	Q9Y215-4	125	129	+	4	0	0	4018
Q9Y215-1#6	0	4	4	Q9Y215-1	129	133	+	4	Q9Y215-1	0	455	Q9Y215-3	0	421	+	104	Q9Y215-1#6	0	4	Q9Y215-3	95	99	+	4	0	0	4019
Q9Y215-1#6	0	4	4	Q9Y215-1	129	133	+	4	Q9Y215-1	35	455	Q9Y215-2	25	445	+	103	Q9Y215-1#6	0	4	Q9Y215-2	119	123	+	4	0	0	4020
Q9Y215-1#6	0	4	4	Q9Y215-1	129	133	+	4	Q9Y215-1	0	455	Q9Y215-1	0	455	+	102	Q9Y215-1#6	0	4	Q9Y215-1	129	133	+	4	0	0	4021
Q9Y215-1#7	0	4	4	Q9Y215-1	234	238	+	4	Q9Y215-1	0	272	Q9Y215-8	0	272	+	109	Q9Y215-1#7	0	4	Q9Y215-8	234	238	+	4	0	0	4022
Q9Y215-1#7	0	4	4	Q9Y215-1	234	238	+	4	Q9Y215-1	0	271	Q9Y215-7	0	271	+	108	Q9Y215-1#7	0	4	Q9Y215-7	234	238	+	4	0	0	4023
Q9Y215-1#7	0	4	4	Q9Y215-1	234	238	+	4	Q9Y215-1	0	239	Q9Y215-6	0	239	+	107	Q9Y215-1#7	0	4	Q9Y215-6	234	238	+	4	0	0	4024
Q9Y215-1#7	0	4	4	Q9Y215-1	234	238	+	4	Q9Y215-1	0	455	Q9Y215-5	0	446	+	106	Q9Y215-1#7	0	4	Q9Y215-5	225	229	+	4	0	0	4025
Q9Y215-1#7	0	4	4	Q9Y215-1	234	238	+	4	Q9Y215-1	0	455	Q9Y215-4	0	451	+	105	Q9Y215-1#7	0	4	Q9Y215-4	230	234	+	4	0	0	4026
Q9Y215-1#7	0	4	4	Q9Y215-1	234	238	+	4	Q9Y215-1	0	455	Q9Y215-3	0	421	+	104	Q9Y215-1#7	0	4	Q9Y215-3	200	204	+	4	0	0	4027
Q9Y215-1#7	0	4	4	Q9Y215-1	234	238	+	4	Q9Y215-1	35	455	Q9Y215-2	25	445	+	103	Q9Y215-1#7	0	4	Q9Y215-2	224	228	+	4	0	0	4028
Q9Y215-1#7	0	4	4	Q9Y215-1	234	238	+	4	Q9Y215-1	0	455	Q9Y215-1	0	455	+	102	Q9Y215-1#7	0	4	Q9Y215-1	234	238	+	4	0	0	4029
Q9Y215-1#8	0	18	18	Q9Y215-1	132	150	+	18	Q9Y215-1	0	272	Q9Y215-8	0	272	+	109	Q9Y215-1#8	0	18	Q9Y215-8	132	150	+	18	0	0	4030
Q9Y215-1#8	0	18	18	Q9Y215-1	132	150	+	18	Q9Y215-1	0	271	Q9Y215-7	0	271	+	108	Q9Y215-1#8	0	18	Q9Y215-7	132	150	+	18	0	0	4031
Q9Y215-1#8	0	18	18	Q9Y215-1	132	150	+	18	Q9Y215-1	0	239	Q9Y215-6	0	239	+	107	Q9Y215-1#8	0	18	Q9Y215-6	132	150	+	18	0	0	4032
Q9Y215-1#8	0	18	18	Q9Y215-1	132	150	+	18	Q9Y215-1	0	455	Q9Y215-5	0	446	+	106	Q9Y215-1#8	0	18	Q9Y215-5	123	141	+	18	0	0	4033
Q9Y215-1#8	0	18	18	Q9Y215-1	132	150	+	18	Q9Y215-1	0	455	Q9Y215-4	0	451	+	105	Q9Y215-1#8	0	18	Q9Y215-4	128	146	+	18	0	0	4034
Q9Y215-1#8	0	18	18	Q9Y215-1	132	150	+	18	Q9Y215-1	0	455	Q9Y215-3	0	421	+	104	Q9Y215-1#8	0	18	Q9Y215-3	98	116	+	18	0	0	4035
Q9Y215-1#8	0	18	18	Q9Y215-1	132	150	+	18	Q9Y215-1	35	455	Q9Y215-2	25	445	+	103	Q9Y215-1#8	0	18	Q9Y215-2	122	140	+	18	0	0	4036
Q9Y215-1#8	0	18	18	Q9Y215-1	132	150	+	18	Q9Y215-1	0	455	Q9Y215-1	0	455	+	102	Q9Y215-1#8	0	18	Q9Y215-1	132	150	+	18	0	0	4037
Q9Y215-1#9	0	15	15	Q9Y215-1	182	197	+	15	Q9Y215-1	0	272	Q9Y215-8	0	272	+	109	Q9Y215-1#9	0	15	Q9Y215-8	182	197	+	15	0	0	4038
Q9Y215-1#9	0	15	15	Q9Y215-1	182	197	+	15	Q9Y215-1	0	271	Q9Y215-7	0	271	+	108	Q9Y215-1#9	0	15	Q9Y215-7	182	197	+	15	0	0	4039
Q9Y215-1#9	0	15	15	Q9Y215-1	182	197	+	15	Q9Y215-1	0	239	Q9Y215-6	0	239	+	107	Q9Y215-1#9	0	15	Q9Y215-6	182	197	+	15	0	0	4040
Q9Y215-1#9	0	15	15	Q9Y215-1	182	197	+	15	Q9Y215-1	0	455	Q9Y215-5	0	446	+	106	Q9Y215-1#9	0	15	Q9Y215-5	173	188	+	15	0	0	4041
Q9Y215-1#9	0	15	15	Q9Y215-1	182	197	+	15	Q9Y215-1	0	455	Q9Y215-4	0	451	+	105	Q9Y215-1#9	0	15	Q9Y215-4	178	193	+	15	0	0	4042
Q9Y215-1#9	0	15	15	Q9Y215-1	182	197	+	15	Q9Y215-1	0	455	Q9Y215-3	0	421	+	104	Q9Y215-1#9	0	15	Q9Y215-3	148	163	+	15	0	0	4043
Q9Y215-1#9	0	15	15	Q9Y215-1	182	197	+	15	Q9Y215-1	35	455	Q9Y215-2	25	445	+	103	Q9Y215-1#9	0	15	Q9Y215-2	172	187	+	15	0	0	4044
Q9Y215-1#9	0	15	15	Q9Y215-1	182	197	+	15	Q9Y215-1	0	455	Q9Y215-1	0	455	+	102	Q9Y215-1#9	0	15	Q9Y215-1	182	197	+	15	0	0	4045
Q9Y215-1#10	0	21	21	Q9Y215-1	252	273	+	21	Q9Y215-1	0	272	Q9Y215-8	0	272	+	109	Q9Y215-1#10	0	20	Q9Y215-8	252	272	+	20	0	1	4046
Q9Y215-1#10	0	21	21	Q9Y215-1	252	273	+	21	Q9Y215-1	0	271	Q9Y215-7	0	271	+	108	Q9Y215-1#10	0	19	Q9Y215-7	252	271	+	19	0	2	4047
Q9Y215-1#10	0	21	21	Q9Y215-1	252	273	+	21	Q9Y215-1	0	455	Q9Y215-5	0	446	+	106	Q9Y215-1#10	0	21	Q9Y215-5	243	264	+	21	0	0	4048
Q9Y215-1#10	0	21	21	Q9Y215-1	252	273	+	21	Q9Y215-1	0	455	Q9Y215-4	0	451	+	105	Q9Y215-1#10	0	21	Q9Y215-4	248	269	+	21	0	0	4049
Q9Y215-1#10	0	21	21	Q9Y215-1	252	273	+	21	Q9Y215-1	0	455	Q9Y215-3	0	421	+	104	Q9Y215-1#10	0	21	Q9Y215-3	218	239	+	21	0	0	4050
Q9Y215-1#10	0	21	21	Q9Y215-1	252	273	+	21	Q9Y215-1	35	455	Q9Y215-2	25	445	+	103	Q9Y215-1#10	0	21	Q9Y215-2	242	263	+	21	0	0	4051
Q9Y215-1#10	0	21	21	Q9Y215-1	252	273	+	21	Q9Y215-1	0	455	Q9Y215-1	0	455	+	102	Q9Y215-1#10	0	21	Q9Y215-1	252	273	+	21	0	0	4052
Q9Y215-1#11	0	1	1	Q9Y215-1	50	51	+	1	Q9Y215-1	0	272	Q9Y215-8	0	272	+	109	Q9Y215-1#11	0	1	Q9Y215-8	50	51	+	1	0	0	4053
Q9Y215-1#11	0	1	1	Q9Y215-1	50	51	+	1	Q9Y215-1	0	271	Q9Y215-7	0	271	+	108	Q9Y215-1#11	0	1	Q9Y215-7	50	51	+	1	0	0	4054
Q9Y215-1#11	0	1	1	Q9Y215-1	50	51	+	1	Q9Y215-1	0	239	Q9Y215-6	0	239	+	107	Q9Y215-1#11	0	1	Q9Y215-6	50	51	+	1	0	0	4055
Q9Y215-1#11	0	1	1	Q9Y215-1	50	51	+	1	Q9Y215-1	0	455	Q9Y215-5	0	446	+	106	Q9Y215-1#11	0	1	Q9Y215-5	50	51	+	1	0	0	4056
Q9Y215-1#11	0	1	1	Q9Y215-1	50	51	+	1	Q9Y215-1	0	455	Q9Y215-4	0	451	+	105	Q9Y215-1#11	0	1	Q9Y215-4	50	51	+	1	0	0	4057
Q9Y215-1#11	0	1	1	Q9Y215-1	50	51	+	1	Q9Y215-1	0	455	Q9Y215-3	0	421	+	104	Q9Y215-1#11	0	1	Q9Y215-3	50	51	+	1	0	0	4058
Q9Y215-1#11	0	1	1	Q9Y215-1	50	51	+	1	Q9Y215-1	35	455	Q9Y215-2	25	445	+	103	Q9Y215-1#11	0	1	Q9Y215-2	40	41	+	1	0	0	4059
Q9Y215-1#11	0	1	1	Q9Y215-1	50	51	+	1	Q9Y215-1	0	455	Q9Y215-1	0	455	+	102	Q9Y215-1#11	0	1	Q9Y215-1	50	51	+	1	0	0	4060
Q9Y215-1#12	0	1	1	Q9Y215-1	51	52	+	1	Q9Y215-1	0	272	Q9Y215-8	0	272	+	109	Q9Y215-1#12	0	1	Q9Y215-8	51	52	+	1	0	0	4061
Q9Y215-1#12	0	1	1	Q9Y215-1	51	52	+	1	Q9Y215-1	0	271	Q9Y215-7	0	271	+	108	Q9Y215-1#12	0	1	Q9Y215-7	51	52	+	1	0	0	4062
Q9Y215-1#12	0	1	1	Q9Y215-1	51	52	+	1	Q9Y215-1	0	239	Q9Y215-6	0	239	+	107	Q9Y215-1#12	0	1	Q9Y215-6	51	52	+	1	0	0	4063
Q9Y215-1#12	0	1	1	Q9Y215-1	51	52	+	1	Q9Y215-1	0	455	Q9Y215-5	0	446	+	106	Q9Y215-1#12	0	1	Q9Y215-5	51	52	+	1	0	0	4064
Q9Y215-1#12	0	1	1	Q9Y215-1	51	52	+	1	Q9Y215-1	0	455	Q9Y215-4	0	451	+	105	Q9Y215-1#12	0	1	Q9Y215-4	51	52	+	1	0	0	4065
Q9Y215-1#12	0	1	1	Q9Y215-1	51	52	+	1	Q9Y215-1	0	455	Q9Y215-3	0	421	+	104	Q9Y215-1#12	0	1	Q9Y215-3	51	52	+	1	0	0	4066
Q9Y215-1#12	0	1	1	Q9Y215-1	51	52	+	1	Q9Y215-1	35	455	Q9Y215-2	25	445	+	103	Q9Y215-1#12	0	1	Q9Y215-2	41	42	+	1	0	0	4067
Q9Y215-1#12	0	1	1	Q9Y215-1	51	52	+	1	Q9Y215-1	0	455	Q9Y215-1	0	455	+	102	Q9Y215-1#12	0	1	Q9Y215-1	51	52	+	1	0	0	4068
Q9Y215-1#13	0	1	1	Q9Y215-1	92	93	+	1	Q9Y215-1	0	272	Q9Y215-8	0	272	+	109	Q9Y215-1#13	0	1	Q9Y215-8	92	93	+	1	0	0	4069
Q9Y215-1#13	0	1	1	Q9Y215-1	92	93	+	1	Q9Y215-1	0	271	Q9Y215-7	0	271	+	108	Q9Y215-1#13	0	1	Q9Y215-7	92	93	+	1	0	0	4070
Q9Y215-1#13	0	1	1	Q9Y215-1	92	93	+	1	Q9Y215-1	0	239	Q9Y215-6	0	239	+	107	Q9Y215-1#13	0	1	Q9Y215-6	92	93	+	1	0	0	4071
Q9Y215-1#13	0	1	1	Q9Y215-1	92	93	+	1	Q9Y215-1	0	455	Q9Y215-5	0	446	+	106	Q9Y215-1#13	0	1	Q9Y215-5	92	93	+	1	0	0	4072
Q9Y215-1#13	0	1	1	Q9Y215-1	92	93	+	1	Q9Y215-1	0	455	Q9Y215-4	0	451	+	105	Q9Y215-1#13	0	1	Q9Y215-4	88	89	+	1	0	0	4073
Q9Y215-1#13	0	1	1	Q9Y215-1	92	93	+	1	Q9Y215-1	35	455	Q9Y215-2	25	445	+	103	Q9Y215-1#13	0	1	Q9Y215-2	82	83	+	1	0	0	4074
Q9Y215-1#13	0	1	1	Q9Y215-1	92	93	+	1	Q9Y215-1	0	455	Q9Y215-1	0	455	+	102	Q9Y215-1#13	0	1	Q9Y215-1	92	93	+	1	0	0	4075
Q9Y215-1#14	0	1	1	Q9Y215-1	290	291	+	1	Q9Y215-1	0	455	Q9Y215-5	0	446	+	106	Q9Y215-1#14	0	1	Q9Y215-5	281	282	+	1	0	0	4076
Q9Y215-1#14	0	1	1	Q9Y215-1	290	291	+	1	Q9Y215-1	0	455	Q9Y215-4	0	451	+	105	Q9Y215-1#14	0	1	Q9Y215-4	286	287	+	1	0	0	4077
Q9Y215-1#14	0	1	1	Q9Y215-1	290	291	+	1	Q9Y215-1	0	455	Q9Y215-3	0	421	+	104	Q9Y215-1#14	0	1	Q9Y215-3	256	257	+	1	0	0	4078
Q9Y215-1#14	0	1	1	Q9Y215-1	290	291	+	1	Q9Y215-1	35	455	Q9Y215-2	25	445	+	103	Q9Y215-1#14	0	1	Q9Y215-2	280	281	+	1	0	0	4079
Q9Y215-1#14	0	1	1	Q9Y215-1	290	291	+	1	Q9Y215-1	0	455	Q9Y215-1	0	455	+	102	Q9Y215-1#14	0	1	Q9Y215-1	290	291	+	1	0	0	4080
Q9Y215-1#15	0	1	1	Q9Y215-1	292	293	+	1	Q9Y215-1	0	455	Q9Y215-5	0	446	+	106	Q9Y215-1#15	0	1	Q9Y215-5	283	284	+	1	0	0	4081
Q9Y215-1#15	0	1	1	Q9Y215-1	292	293	+	1	Q9Y215-1	0	455	Q9Y215-4	0	451	+	105	Q9Y215-1#15	0	1	Q9Y215-4	288	289	+	1	0	0	4082
Q9Y215-1#15	0	1	1	Q9Y215-1	292	293	+	1	Q9Y215-1	0	455	Q9Y215-3	0	421	+	104	Q9Y215-1#15	0	1	Q9Y215-3	258	259	+	1	0	0	4083
Q9Y215-1#15	0	1	1	Q9Y215-1	292	293	+	1	Q9Y215-1	35	455	Q9Y215-2	25	445	+	103	Q9Y215-1#15	0	1	Q9Y215-2	282	283	+	1	0	0	4084
Q9Y215-1#15	0	1	1	Q9Y215-1	292	293	+	1	Q9Y215-1	0	455	Q9Y215-1	0	455	+	102	Q9Y215-1#15	0	1	Q9Y215-1	292	293	+	1	0	0	4085
Q9Y215-1#16	0	35	35	Q9Y215-1	0	35	+	35	Q9Y215-1	0	272	Q9Y215-8	0	272	+	109	Q9Y215-1#16	0	35	Q9Y215-8	0	35	+	35	0	0	4086
Q9Y215-1#16	0	35	35	Q9Y215-1	0	35	+	35	Q9Y215-1	0	271	Q9Y215-7	0	271	+	108	Q9Y215-1#16	0	35	Q9Y215-7	0	35	+	35	0	0	4087
Q9Y215-1#16	0	35	35	Q9Y215-1	0	35	+	35	Q9Y215-1	0	239	Q9Y215-6	0	239	+	107	Q9Y215-1#16	0	35	Q9Y215-6	0	35	+	35	0	0	4088
Q9Y215-1#16	0	35	35	Q9Y215-1	0	35	+	35	Q9Y215-1	0	455	Q9Y215-5	0	446	+	106	Q9Y215-1#16	0	35	Q9Y215-5	0	35	+	35	0	0	4089
Q9Y215-1#16	0	35	35	Q9Y215-1	0	35	+	35	Q9Y215-1	0	455	Q9Y215-4	0	451	+	105	Q9Y215-1#16	0	35	Q9Y215-4	0	35	+	35	0	0	4090
Q9Y215-1#16	0	35	35	Q9Y215-1	0	35	+	35	Q9Y215-1	0	455	Q9Y215-3	0	421	+	104	Q9Y215-1#16	0	35	Q9Y215-3	0	35	+	35	0	0	4091
Q9Y215-1#16	0	35	35	Q9Y215-1	0	35	+	35	Q9Y215-1	0	455	Q9Y215-1	0	455	+	102	Q9Y215-1#16	0	35	Q9Y215-1	0	35	+	35	0	0	4092
Q9Y215-1#17	0	4	4	Q9Y215-1	72	76	+	4	Q9Y215-1	0	272	Q9Y215-8	0	272	+	109	Q9Y215-1#17	0	4	Q9Y215-8	72	76	+	4	0	0	4093
Q9Y215-1#17	0	4	4	Q9Y215-1	72	76	+	4	Q9Y215-1	0	271	Q9Y215-7	0	271	+	108	Q9Y215-1#17	0	4	Q9Y215-7	72	76	+	4	0	0	4094
Q9Y215-1#17	0	4	4	Q9Y215-1	72	76	+	4	Q9Y215-1	0	239	Q9Y215-6	0	239	+	107	Q9Y215-1#17	0	4	Q9Y215-6	72	76	+	4	0	0	4095
Q9Y215-1#17	0	4	4	Q9Y215-1	72	76	+	4	Q9Y215-1	0	455	Q9Y215-5	0	446	+	106	Q9Y215-1#17	0	4	Q9Y215-5	72	76	+	4	0	0	4096
Q9Y215-1#17	0	4	4	Q9Y215-1	72	76	+	4	Q9Y215-1	0	455	Q9Y215-4	0	451	+	105	Q9Y215-1#17	3	4	Q9Y215-4	71	72	+	1	3	0	4097
Q9Y215-1#17	0	4	4	Q9Y215-1	72	76	+	4	Q9Y215-1	35	455	Q9Y215-2	25	445	+	103	Q9Y215-1#17	0	4	Q9Y215-2	62	66	+	4	0	0	4098
Q9Y215-1#17	0	4	4	Q9Y215-1	72	76	+	4	Q9Y215-1	0	455	Q9Y215-1	0	455	+	102	Q9Y215-1#17	0	4	Q9Y215-1	72	76	+	4	0	0	4099
Q9Y215-1#18	0	34	34	Q9Y215-1	73	107	+	34	Q9Y215-1	0	272	Q9Y215-8	0	272	+	109	Q9Y215-1#18	0	34	Q9Y215-8	73	107	+	34	0	0	4100
Q9Y215-1#18	0	34	34	Q9Y215-1	73	107	+	34	Q9Y215-1	0	271	Q9Y215-7	0	271	+	108	Q9Y215-1#18	0	34	Q9Y215-7	73	107	+	34	0	0	4101
Q9Y215-1#18	0	34	34	Q9Y215-1	73	107	+	34	Q9Y215-1	0	239	Q9Y215-6	0	239	+	107	Q9Y215-1#18	0	34	Q9Y215-6	73	107	+	34	0	0	4102
Q9Y215-1#18	0	34	34	Q9Y215-1	73	107	+	34	Q9Y215-1	0	455	Q9Y215-5	0	446	+	106	Q9Y215-1#18	0	34	Q9Y215-5	73	107	+	34	0	0	4103
Q9Y215-1#18	0	34	34	Q9Y215-1	73	107	+	34	Q9Y215-1	0	455	Q9Y215-4	0	451	+	105	Q9Y215-1#18	2	34	Q9Y215-4	71	103	+	32	2	0	4104
Q9Y215-1#18	0	34	34	Q9Y215-1	73	107	+	34	Q9Y215-1	0	455	Q9Y215-3	0	421	+	104	Q9Y215-1#18	26	28	Q9Y215-3	71	73	+	2	26	6	4105
Q9Y215-1#18	0	34	34	Q9Y215-1	73	107	+	34	Q9Y215-1	35	455	Q9Y215-2	25	445	+	103	Q9Y215-1#18	0	34	Q9Y215-2	63	97	+	34	0	0	4106
Q9Y215-1#18	0	34	34	Q9Y215-1	73	107	+	34	Q9Y215-1	0	455	Q9Y215-1	0	455	+	102	Q9Y215-1#18	0	34	Q9Y215-1	73	107	+	34	0	0	4107
Q9Y215-1#19	0	9	9	Q9Y215-1	123	132	+	9	Q9Y215-1	0	272	Q9Y215-8	0	272	+	109	Q9Y215-1#19	0	9	Q9Y215-8	123	132	+	9	0	0	4108
Q9Y215-1#19	0	9	9	Q9Y215-1	123	132	+	9	Q9Y215-1	0	271	Q9Y215-7	0	271	+	108	Q9Y215-1#19	0	9	Q9Y215-7	123	132	+	9	0	0	4109
Q9Y215-1#19	0	9	9	Q9Y215-1	123	132	+	9	Q9Y215-1	0	239	Q9Y215-6	0	239	+	107	Q9Y215-1#19	0	9	Q9Y215-6	123	132	+	9	0	0	4110
Q9Y215-1#19	0	9	9	Q9Y215-1	123	132	+	9	Q9Y215-1	0	455	Q9Y215-5	0	446	+	106	Q9Y215-1#19	7	9	Q9Y215-5	121	123	+	2	7	0	4111
Q9Y215-1#19	0	9	9	Q9Y215-1	123	132	+	9	Q9Y215-1	0	455	Q9Y215-4	0	451	+	105	Q9Y215-1#19	0	9	Q9Y215-4	119	128	+	9	0	0	4112
Q9Y215-1#19	0	9	9	Q9Y215-1	123	132	+	9	Q9Y215-1	0	455	Q9Y215-3	0	421	+	104	Q9Y215-1#19	0	9	Q9Y215-3	89	98	+	9	0	0	4113
Q9Y215-1#19	0	9	9	Q9Y215-1	123	132	+	9	Q9Y215-1	35	455	Q9Y215-2	25	445	+	103	Q9Y215-1#19	0	9	Q9Y215-2	113	122	+	9	0	0	4114
Q9Y215-1#19	0	9	9	Q9Y215-1	123	132	+	9	Q9Y215-1	0	455	Q9Y215-1	0	455	+	102	Q9Y215-1#19	0	9	Q9Y215-1	123	132	+	9	0	0	4115
Q9Y215-1#20	0	52	52	Q9Y215-1	239	291	+	52	Q9Y215-1	0	272	Q9Y215-8	0	272	+	109	Q9Y215-1#20	0	33	Q9Y215-8	239	272	+	33	0	19	4116
Q9Y215-1#20	0	52	52	Q9Y215-1	239	291	+	52	Q9Y215-1	0	271	Q9Y215-7	0	271	+	108	Q9Y215-1#20	0	32	Q9Y215-7	239	271	+	32	0	20	4117
Q9Y215-1#20	0	52	52	Q9Y215-1	239	291	+	52	Q9Y215-1	0	455	Q9Y215-5	0	446	+	106	Q9Y215-1#20	0	52	Q9Y215-5	230	282	+	52	0	0	4118
Q9Y215-1#20	0	52	52	Q9Y215-1	239	291	+	52	Q9Y215-1	0	455	Q9Y215-4	0	451	+	105	Q9Y215-1#20	0	52	Q9Y215-4	235	287	+	52	0	0	4119
Q9Y215-1#20	0	52	52	Q9Y215-1	239	291	+	52	Q9Y215-1	0	455	Q9Y215-3	0	421	+	104	Q9Y215-1#20	0	52	Q9Y215-3	205	257	+	52	0	0	4120
Q9Y215-1#20	0	52	52	Q9Y215-1	239	291	+	52	Q9Y215-1	35	455	Q9Y215-2	25	445	+	103	Q9Y215-1#20	0	52	Q9Y215-2	229	281	+	52	0	0	4121
Q9Y215-1#20	0	52	52	Q9Y215-1	239	291	+	52	Q9Y215-1	0	455	Q9Y215-1	0	455	+	102	Q9Y215-1#20	0	52	Q9Y215-1	239	291	+	52	0	0	4122
Q9Y215-1#21	0	10	10	Q9Y215-1	271	281	+	10	Q9Y215-1	0	272	Q9Y215-8	0	272	+	109	Q9Y215-1#21	0	1	Q9Y215-8	271	272	+	1	0	9	4123
Q9Y215-1#21	0	10	10	Q9Y215-1	271	281	+	10	Q9Y215-1	0	455	Q9Y215-5	0	446	+	106	Q9Y215-1#21	0	10	Q9Y215-5	262	272	+	10	0	0	4124
Q9Y215-1#21	0	10	10	Q9Y215-1	271	281	+	10	Q9Y215-1	0	455	Q9Y215-4	0	451	+	105	Q9Y215-1#21	0	10	Q9Y215-4	267	277	+	10	0	0	4125
Q9Y215-1#21	0	10	10	Q9Y215-1	271	281	+	10	Q9Y215-1	0	455	Q9Y215-3	0	421	+	104	Q9Y215-1#21	0	10	Q9Y215-3	237	247	+	10	0	0	4126
Q9Y215-1#21	0	10	10	Q9Y215-1	271	281	+	10	Q9Y215-1	35	455	Q9Y215-2	25	445	+	103	Q9Y215-1#21	0	10	Q9Y215-2	261	271	+	10	0	0	4127
Q9Y215-1#21	0	10	10	Q9Y215-1	271	281	+	10	Q9Y215-1	0	455	Q9Y215-1	0	455	+	102	Q9Y215-1#21	0	10	Q9Y215-1	271	281	+	10	0	0	4128
Q9Y215-1#22	0	57	57	Q9Y215-1	272	329	+	57	Q9Y215-1	0	455	Q9Y215-5	0	446	+	106	Q9Y215-1#22	0	57	Q9Y215-5	263	320	+	57	0	0	4129
Q9Y215-1#22	0	57	57	Q9Y215-1	272	329	+	57	Q9Y215-1	0	455	Q9Y215-4	0	451	+	105	Q9Y215-1#22	0	57	Q9Y215-4	268	325	+	57	0	0	4130
Q9Y215-1#22	0	57	57	Q9Y215-1	272	329	+	57	Q9Y215-1	0	455	Q9Y215-3	0	421	+	104	Q9Y215-1#22	0	57	Q9Y215-3	238	295	+	57	0	0	4131
Q9Y215-1#22	0	57	57	Q9Y215-1	272	329	+	57	Q9Y215-1	35	455	Q9Y215-2	25	445	+	103	Q9Y215-1#22	0	57	Q9Y215-2	262	319	+	57	0	0	4132
Q9Y215-1#22	0	57	57	Q9Y215-1	272	329	+	57	Q9Y215-1	0	455	Q9Y215-1	0	455	+	102	Q9Y215-1#22	0	57	Q9Y215-1	272	329	+	57	0	0	4133
Q9Y215-1#23	0	174	174	Q9Y215-1	281	455	+	174	Q9Y215-1	0	455	Q9Y215-5	0	446	+	106	Q9Y215-1#23	0	174	Q9Y215-5	272	446	+	174	0	0	4134
Q9Y215-1#23	0	174	174	Q9Y215-1	281	455	+	174	Q9Y215-1	0	455	Q9Y215-4	0	451	+	105	Q9Y215-1#23	0	174	Q9Y215-4	277	451	+	174	0	0	4135
Q9Y215-1#23	0	174	174	Q9Y215-1	281	455	+	174	Q9Y215-1	0	455	Q9Y215-3	0	421	+	104	Q9Y215-1#23	0	174	Q9Y215-3	247	421	+	174	0	0	4136
Q9Y215-1#23	0	174	174	Q9Y215-1	281	455	+	174	Q9Y215-1	35	455	Q9Y215-2	25	445	+	103	Q9Y215-1#23	0	174	Q9Y215-2	271	445	+	174	0	0	4137
Q9Y215-1#23	0	174	174	Q9Y215-1	281	455	+	174	Q9Y215-1	0	455	Q9Y215-1	0	455	+	102	Q9Y215-1#23	0	174	Q9Y215-1	281	455	+	174	0	0	4138
Q9Y215-1#24	0	164	164	Q9Y215-1	291	455	+	164	Q9Y215-1	0	455	Q9Y215-5	0	446	+	106	Q9Y215-1#24	0	164	Q9Y215-5	282	446	+	164	0	0	4139
Q9Y215-1#24	0	164	164	Q9Y215-1	291	455	+	164	Q9Y215-1	0	455	Q9Y215-4	0	451	+	105	Q9Y215-1#24	0	164	Q9Y215-4	287	451	+	164	0	0	4140
Q9Y215-1#24	0	164	164	Q9Y215-1	291	455	+	164	Q9Y215-1	0	455	Q9Y215-3	0	421	+	104	Q9Y215-1#24	0	164	Q9Y215-3	257	421	+	164	0	0	4141
Q9Y215-1#24	0	164	164	Q9Y215-1	291	455	+	164	Q9Y215-1	35	455	Q9Y215-2	25	445	+	103	Q9Y215-1#24	0	164	Q9Y215-2	281	445	+	164	0	0	4142
Q9Y215-1#24	0	164	164	Q9Y215-1	291	455	+	164	Q9Y215-1	0	455	Q9Y215-1	0	455	+	102	Q9Y215-1#24	0	164	Q9Y215-1	291	455	+	164	0	0	4143
Q9Y215-1#25	0	126	126	Q9Y215-1	329	455	+	126	Q9Y215-1	0	455	Q9Y215-5	0	446	+	106	Q9Y215-1#25	0	126	Q9Y215-5	320	446	+	126	0	0	4144
Q9Y215-1#25	0	126	126	Q9Y215-1	329	455	+	126	Q9Y215-1	0	455	Q9Y215-4	0	451	+	105	Q9Y215-1#25	0	126	Q9Y215-4	325	451	+	126	0	0	4145
Q9Y215-1#25	0	126	126	Q9Y215-1	329	455	+	126	Q9Y215-1	0	455	Q9Y215-3	0	421	+	104	Q9Y215-1#25	0	126	Q9Y215-3	295	421	+	126	0	0	4146
Q9Y215-1#25	0	126	126	Q9Y215-1	329	455	+	126	Q9Y215-1	35	455	Q9Y215-2	25	445	+	103	Q9Y215-1#25	0	126	Q9Y215-2	319	445	+	126	0	0	4147
Q9Y215-1#25	0	126	126	Q9Y215-1	329	455	+	126	Q9Y215-1	0	455	Q9Y215-1	0	455	+	102	Q9Y215-1#25	0	126	Q9Y215-1	329	455	+	126	0	0	4148
Q9Y215-1#26	0	1	1	Q9Y215-1	58	59	+	1	Q9Y215-1	0	272	Q9Y215-8	0	272	+	109	Q9Y215-1#26	0	1	Q9Y215-8	58	59	+	1	0	0	4149
Q9Y215-1#26	0	1	1	Q9Y215-1	58	59	+	1	Q9Y215-1	0	271	Q9Y215-7	0	271	+	108	Q9Y215-1#26	0	1	Q9Y215-7	58	59	+	1	0	0	4150
Q9Y215-1#26	0	1	1	Q9Y215-1	58	59	+	1	Q9Y215-1	0	239	Q9Y215-6	0	239	+	107	Q9Y215-1#26	0	1	Q9Y215-6	58	59	+	1	0	0	4151
Q9Y215-1#26	0	1	1	Q9Y215-1	58	59	+	1	Q9Y215-1	0	455	Q9Y215-5	0	446	+	106	Q9Y215-1#26	0	1	Q9Y215-5	58	59	+	1	0	0	4152
Q9Y215-1#26	0	1	1	Q9Y215-1	58	59	+	1	Q9Y215-1	0	455	Q9Y215-4	0	451	+	105	Q9Y215-1#26	0	1	Q9Y215-4	58	59	+	1	0	0	4153
Q9Y215-1#26	0	1	1	Q9Y215-1	58	59	+	1	Q9Y215-1	0	455	Q9Y215-3	0	421	+	104	Q9Y215-1#26	0	1	Q9Y215-3	58	59	+	1	0	0	4154
Q9Y215-1#26	0	1	1	Q9Y215-1	58	59	+	1	Q9Y215-1	35	455	Q9Y215-2	25	445	+	103	Q9Y215-1#26	0	1	Q9Y215-2	48	49	+	1	0	0	4155
Q9Y215-1#26	0	1	1	Q9Y215-1	58	59	+	1	Q9Y215-1	0	455	Q9Y215-1	0	455	+	102	Q9Y215-1#26	0	1	Q9Y215-1	58	59	+	1	0	0	4156
Q9Y215-1#27	0	1	1	Q9Y215-1	311	312	+	1	Q9Y215-1	0	455	Q9Y215-5	0	446	+	106	Q9Y215-1#27	0	1	Q9Y215-5	302	303	+	1	0	0	4157
Q9Y215-1#27	0	1	1	Q9Y215-1	311	312	+	1	Q9Y215-1	0	455	Q9Y215-4	0	451	+	105	Q9Y215-1#27	0	1	Q9Y215-4	307	308	+	1	0	0	4158
Q9Y215-1#27	0	1	1	Q9Y215-1	311	312	+	1	Q9Y215-1	0	455	Q9Y215-3	0	421	+	104	Q9Y215-1#27	0	1	Q9Y215-3	277	278	+	1	0	0	4159
Q9Y215-1#27	0	1	1	Q9Y215-1	311	312	+	1	Q9Y215-1	35	455	Q9Y215-2	25	445	+	103	Q9Y215-1#27	0	1	Q9Y215-2	301	302	+	1	0	0	4160
Q9Y215-1#27	0	1	1	Q9Y215-1	311	312	+	1	Q9Y215-1	0	455	Q9Y215-1	0	455	+	102	Q9Y215-1#27	0	1	Q9Y215-1	311	312	+	1	0	0	4161
Q9Y215-1#28	0	1	1	Q9Y215-1	336	337	+	1	Q9Y215-1	0	455	Q9Y215-5	0	446	+	106	Q9Y215-1#28	0	1	Q9Y215-5	327	328	+	1	0	0	4162
Q9Y215-1#28	0	1	1	Q9Y215-1	336	337	+	1	Q9Y215-1	0	455	Q9Y215-4	0	451	+	105	Q9Y215-1#28	0	1	Q9Y215-4	332	333	+	1	0	0	4163
Q9Y215-1#28	0	1	1	Q9Y215-1	336	337	+	1	Q9Y215-1	0	455	Q9Y215-3	0	421	+	104	Q9Y215-1#28	0	1	Q9Y215-3	302	303	+	1	0	0	4164
Q9Y215-1#28	0	1	1	Q9Y215-1	336	337	+	1	Q9Y215-1	35	455	Q9Y215-2	25	445	+	103	Q9Y215-1#28	0	1	Q9Y215-2	326	327	+	1	0	0	4165
Q9Y215-1#28	0	1	1	Q9Y215-1	336	337	+	1	Q9Y215-1	0	455	Q9Y215-1	0	455	+	102	Q9Y215-1#28	0	1	Q9Y215-1	336	337	+	1	0	0	4166
Q9Y215-1#29	0	1	1	Q9Y215-1	341	342	+	1	Q9Y215-1	0	455	Q9Y215-5	0	446	+	106	Q9Y215-1#29	0	1	Q9Y215-5	332	333	+	1	0	0	4167
Q9Y215-1#29	0	1	1	Q9Y215-1	341	342	+	1	Q9Y215-1	0	455	Q9Y215-4	0	451	+	105	Q9Y215-1#29	0	1	Q9Y215-4	337	338	+	1	0	0	4168
Q9Y215-1#29	0	1	1	Q9Y215-1	341	342	+	1	Q9Y215-1	0	455	Q9Y215-3	0	421	+	104	Q9Y215-1#29	0	1	Q9Y215-3	307	308	+	1	0	0	4169
Q9Y215-1#29	0	1	1	Q9Y215-1	341	342	+	1	Q9Y215-1	35	455	Q9Y215-2	25	445	+	103	Q9Y215-1#29	0	1	Q9Y215-2	331	332	+	1	0	0	4170
Q9Y215-1#29	0	1	1	Q9Y215-1	341	342	+	1	Q9Y215-1	0	455	Q9Y215-1	0	455	+	102	Q9Y215-1#29	0	1	Q9Y215-1	341	342	+	1	0	0	4171
Q9Y215-1#30	0	1	1	Q9Y215-1	409	410	+	1	Q9Y215-1	0	455	Q9Y215-5	0	446	+	106	Q9Y215-1#30	0	1	Q9Y215-5	400	401	+	1	0	0	4172
Q9Y215-1#30	0	1	1	Q9Y215-1	409	410	+	1	Q9Y215-1	0	455	Q9Y215-4	0	451	+	105	Q9Y215-1#30	0	1	Q9Y215-4	405	406	+	1	0	0	4173
Q9Y215-1#30	0	1	1	Q9Y215-1	409	410	+	1	Q9Y215-1	0	455	Q9Y215-3	0	421	+	104	Q9Y215-1#30	0	1	Q9Y215-3	375	376	+	1	0	0	4174
Q9Y215-1#30	0	1	1	Q9Y215-1	409	410	+	1	Q9Y215-1	35	455	Q9Y215-2	25	445	+	103	Q9Y215-1#30	0	1	Q9Y215-2	399	400	+	1	0	0	4175
Q9Y215-1#30	0	1	1	Q9Y215-1	409	410	+	1	Q9Y215-1	0	455	Q9Y215-1	0	455	+	102	Q9Y215-1#30	0	1	Q9Y215-1	409	410	+	1	0	0	4176
Q9Y215-1#31	0	1	1	Q9Y215-1	429	430	+	1	Q9Y215-1	0	455	Q9Y215-5	0	446	+	106	Q9Y215-1#31	0	1	Q9Y215-5	420	421	+	1	0	0	4177
Q9Y215-1#31	0	1	1	Q9Y215-1	429	430	+	1	Q9Y215-1	0	455	Q9Y215-4	0	451	+	105	Q9Y215-1#31	0	1	Q9Y215-4	425	426	+	1	0	0	4178
Q9Y215-1#31	0	1	1	Q9Y215-1	429	430	+	1	Q9Y215-1	0	455	Q9Y215-3	0	421	+	104	Q9Y215-1#31	0	1	Q9Y215-3	395	396	+	1	0	0	4179
Q9Y215-1#31	0	1	1	Q9Y215-1	429	430	+	1	Q9Y215-1	35	455	Q9Y215-2	25	445	+	103	Q9Y215-1#31	0	1	Q9Y215-2	419	420	+	1	0	0	4180
Q9Y215-1#31	0	1	1	Q9Y215-1	429	430	+	1	Q9Y215-1	0	455	Q9Y215-1	0	455	+	102	Q9Y215-1#31	0	1	Q9Y215-1	429	430	+	1	0	0	4181
Q9Y215-1#32	0	1	1	Q9Y215-1	443	444	+	1	Q9Y215-1	0	455	Q9Y215-5	0	446	+	106	Q9Y215-1#32	0	1	Q9Y215-5	434	435	+	1	0	0	4182
Q9Y215-1#32	0	1	1	Q9Y215-1	443	444	+	1	Q9Y215-1	0	455	Q9Y215-4	0	451	+	105	Q9Y215-1#32	0	1	Q9Y215-4	439	440	+	1	0	0	4183
Q9Y215-1#32	0	1	1	Q9Y215-1	443	444	+	1	Q9Y215-1	0	455	Q9Y215-3	0	421	+	104	Q9Y215-1#32	0	1	Q9Y215-3	409	410	+	1	0	0	4184
Q9Y215-1#32	0	1	1	Q9Y215-1	443	444	+	1	Q9Y215-1	35	455	Q9Y215-2	25	445	+	103	Q9Y215-1#32	0	1	Q9Y215-2	433	434	+	1	0	0	4185
Q9Y215-1#32	0	1	1	Q9Y215-1	443	444	+	1	Q9Y215-1	0	455	Q9Y215-1	0	455	+	102	Q9Y215-1#32	0	1	Q9Y215-1	443	444	+	1	0	0	4186
Q9Y215-1#33	0	1	1	Q9Y215-1	369	370	+	1	Q9Y215-1	0	455	Q9Y215-5	0	446	+	106	Q9Y215-1#33	0	1	Q9Y215-5	360	361	+	1	0	0	4187
Q9Y215-1#33	0	1	1	Q9Y215-1	369	370	+	1	Q9Y215-1	0	455	Q9Y215-4	0	451	+	105	Q9Y215-1#33	0	1	Q9Y215-4	365	366	+	1	0	0	4188
Q9Y215-1#33	0	1	1	Q9Y215-1	369	370	+	1	Q9Y215-1	0	455	Q9Y215-3	0	421	+	104	Q9Y215-1#33	0	1	Q9Y215-3	335	336	+	1	0	0	4189
Q9Y215-1#33	0	1	1	Q9Y215-1	369	370	+	1	Q9Y215-1	35	455	Q9Y215-2	25	445	+	103	Q9Y215-1#33	0	1	Q9Y215-2	359	360	+	1	0	0	4190
Q9Y215-1#33	0	1	1	Q9Y215-1	369	370	+	1	Q9Y215-1	0	455	Q9Y215-1	0	455	+	102	Q9Y215-1#33	0	1	Q9Y215-1	369	370	+	1	0	0	4191
Q9Y215-1#34	0	1	1	Q9Y215-1	398	399	+	1	Q9Y215-1	0	455	Q9Y215-5	0	446	+	106	Q9Y215-1#34	0	1	Q9Y215-5	389	390	+	1	0	0	4192
Q9Y215-1#34	0	1	1	Q9Y215-1	398	399	+	1	Q9Y215-1	0	455	Q9Y215-4	0	451	+	105	Q9Y215-1#34	0	1	Q9Y215-4	394	395	+	1	0	0	4193
Q9Y215-1#34	0	1	1	Q9Y215-1	398	399	+	1	Q9Y215-1	0	455	Q9Y215-3	0	421	+	104	Q9Y215-1#34	0	1	Q9Y215-3	364	365	+	1	0	0	4194
Q9Y215-1#34	0	1	1	Q9Y215-1	398	399	+	1	Q9Y215-1	35	455	Q9Y215-2	25	445	+	103	Q9Y215-1#34	0	1	Q9Y215-2	388	389	+	1	0	0	4195
Q9Y215-1#34	0	1	1	Q9Y215-1	398	399	+	1	Q9Y215-1	0	455	Q9Y215-1	0	455	+	102	Q9Y215-1#34	0	1	Q9Y215-1	398	399	+	1	0	0	4196
Q9Y215-1#35	0	1	1	Q9Y215-1	399	400	+	1	Q9Y215-1	0	455	Q9Y215-5	0	446	+	106	Q9Y215-1#35	0	1	Q9Y215-5	390	391	+	1	0	0	4197
Q9Y215-1#35	0	1	1	Q9Y215-1	399	400	+	1	Q9Y215-1	0	455	Q9Y215-4	0	451	+	105	Q9Y215-1#35	0	1	Q9Y215-4	395	396	+	1	0	0	4198
Q9Y215-1#35	0	1	1	Q9Y215-1	399	400	+	1	Q9Y215-1	0	455	Q9Y215-3	0	421	+	104	Q9Y215-1#35	0	1	Q9Y215-3	365	366	+	1	0	0	4199
Q9Y215-1#35	0	1	1	Q9Y215-1	399	400	+	1	Q9Y215-1	35	455	Q9Y215-2	25	445	+	103	Q9Y215-1#35	0	1	Q9Y215-2	389	390	+	1	0	0	4200
Q9Y215-1#35	0	1	1	Q9Y215-1	399	400	+	1	Q9Y215-1	0	455	Q9Y215-1	0	455	+	102	Q9Y215-1#35	0	1	Q9Y215-1	399	400	+	1	0	0	4201
Q9Y215-1#36	0	1	1	Q9Y215-1	403	404	+	1	Q9Y215-1	0	455	Q9Y215-5	0	446	+	106	Q9Y215-1#36	0	1	Q9Y215-5	394	395	+	1	0	0	4202
Q9Y215-1#36	0	1	1	Q9Y215-1	403	404	+	1	Q9Y215-1	0	455	Q9Y215-4	0	451	+	105	Q9Y215-1#36	0	1	Q9Y215-4	399	400	+	1	0	0	4203
Q9Y215-1#36	0	1	1	Q9Y215-1	403	404	+	1	Q9Y215-1	0	455	Q9Y215-3	0	421	+	104	Q9Y215-1#36	0	1	Q9Y215-3	369	370	+	1	0	0	4204
Q9Y215-1#36	0	1	1	Q9Y215-1	403	404	+	1	Q9Y215-1	35	455	Q9Y215-2	25	445	+	103	Q9Y215-1#36	0	1	Q9Y215-2	393	394	+	1	0	0	4205
Q9Y215-1#36	0	1	1	Q9Y215-1	403	404	+	1	Q9Y215-1	0	455	Q9Y215-1	0	455	+	102	Q9Y215-1#36	0	1	Q9Y215-1	403	404	+	1	0	0	4206
Q9Y215-1#37	0	1	1	Q9Y215-1	422	423	+	1	Q9Y215-1	0	455	Q9Y215-5	0	446	+	106	Q9Y215-1#37	0	1	Q9Y215-5	413	414	+	1	0	0	4207
Q9Y215-1#37	0	1	1	Q9Y215-1	422	423	+	1	Q9Y215-1	0	455	Q9Y215-4	0	451	+	105	Q9Y215-1#37	0	1	Q9Y215-4	418	419	+	1	0	0	4208
Q9Y215-1#37	0	1	1	Q9Y215-1	422	423	+	1	Q9Y215-1	0	455	Q9Y215-3	0	421	+	104	Q9Y215-1#37	0	1	Q9Y215-3	388	389	+	1	0	0	4209
Q9Y215-1#37	0	1	1	Q9Y215-1	422	423	+	1	Q9Y215-1	35	455	Q9Y215-2	25	445	+	103	Q9Y215-1#37	0	1	Q9Y215-2	412	413	+	1	0	0	4210
Q9Y215-1#37	0	1	1	Q9Y215-1	422	423	+	1	Q9Y215-1	0	455	Q9Y215-1	0	455	+	102	Q9Y215-1#37	0	1	Q9Y215-1	422	423	+	1	0	0	4211
P11137-1#0	0	1827	1827	P11137-1	0	1827	+	1827	P11137-1	0	1827	P11137-3	0	1823	+	22	P11137-1#0	0	1827	P11137-3	0	1823	+	1823	0	0	4212
P11137-1#0	0	1827	1827	P11137-1	0	1827	+	1827	P11137-1	0	1827	P11137-2	0	471	+	21	P11137-1#0	0	1827	P11137-2	0	471	+	471	0	0	4213
P11137-1#0	0	1827	1827	P11137-1	0	1827	+	1827	P11137-1	0	1827	P11137-1	0	1827	+	20	P11137-1#0	0	1827	P11137-1	0	1827	+	1827	0	0	4214
P11137-1#1	0	31	31	P11137-1	1660	1691	+	31	P11137-1	0	1827	P11137-3	0	1823	+	22	P11137-1#1	0	31	P11137-3	1656	1687	+	31	0	0	4215
P11137-1#1	0	31	31	P11137-1	1660	1691	+	31	P11137-1	0	1827	P11137-2	0	471	+	21	P11137-1#1	0	31	P11137-2	304	335	+	31	0	0	4216
P11137-1#1	0	31	31	P11137-1	1660	1691	+	31	P11137-1	0	1827	P11137-1	0	1827	+	20	P11137-1#1	0	31	P11137-1	1660	1691	+	31	0	0	4217
P11137-1#2	0	31	31	P11137-1	1691	1722	+	31	P11137-1	0	1827	P11137-3	0	1823	+	22	P11137-1#2	0	31	P11137-3	1687	1718	+	31	0	0	4218
P11137-1#2	0	31	31	P11137-1	1691	1722	+	31	P11137-1	0	1827	P11137-2	0	471	+	21	P11137-1#2	0	31	P11137-2	335	366	+	31	0	0	4219
P11137-1#2	0	31	31	P11137-1	1691	1722	+	31	P11137-1	0	1827	P11137-1	0	1827	+	20	P11137-1#2	0	31	P11137-1	1691	1722	+	31	0	0	4220
P11137-1#3	0	32	32	P11137-1	1722	1754	+	32	P11137-1	0	1827	P11137-3	0	1823	+	22	P11137-1#3	0	32	P11137-3	1718	1750	+	32	0	0	4221
P11137-1#3	0	32	32	P11137-1	1722	1754	+	32	P11137-1	0	1827	P11137-2	0	471	+	21	P11137-1#3	0	32	P11137-2	366	398	+	32	0	0	4222
P11137-1#3	0	32	32	P11137-1	1722	1754	+	32	P11137-1	0	1827	P11137-1	0	1827	+	20	P11137-1#3	0	32	P11137-1	1722	1754	+	32	0	0	4223
P11137-1#4	0	88	88	P11137-1	0	88	+	88	P11137-1	0	1827	P11137-3	0	1823	+	22	P11137-1#4	0	88	P11137-3	0	88	+	88	0	0	4224
P11137-1#4	0	88	88	P11137-1	0	88	+	88	P11137-1	0	1827	P11137-2	0	471	+	21	P11137-1#4	0	88	P11137-2	0	88	+	88	0	0	4225
P11137-1#4	0	88	88	P11137-1	0	88	+	88	P11137-1	0	1827	P11137-1	0	1827	+	20	P11137-1#4	0	88	P11137-1	0	88	+	88	0	0	4226
P11137-1#5	0	113	113	P11137-1	108	221	+	113	P11137-1	0	1827	P11137-3	0	1823	+	22	P11137-1#5	0	113	P11137-3	108	217	+	109	0	0	4227
P11137-1#5	0	113	113	P11137-1	108	221	+	113	P11137-1	0	1827	P11137-2	0	471	+	21	P11137-1#5	0	43	P11137-2	108	151	+	43	0	70	4228
P11137-1#5	0	113	113	P11137-1	108	221	+	113	P11137-1	0	1827	P11137-1	0	1827	+	20	P11137-1#5	0	113	P11137-1	108	221	+	113	0	0	4229
P11137-1#6	0	158	158	P11137-1	339	497	+	158	P11137-1	0	1827	P11137-3	0	1823	+	22	P11137-1#6	0	158	P11137-3	335	493	+	158	0	0	4230
P11137-1#6	0	158	158	P11137-1	339	497	+	158	P11137-1	0	1827	P11137-1	0	1827	+	20	P11137-1#6	0	158	P11137-1	339	497	+	158	0	0	4231
P11137-1#7	0	82	82	P11137-1	578	660	+	82	P11137-1	0	1827	P11137-3	0	1823	+	22	P11137-1#7	0	82	P11137-3	574	656	+	82	0	0	4232
P11137-1#7	0	82	82	P11137-1	578	660	+	82	P11137-1	0	1827	P11137-1	0	1827	+	20	P11137-1#7	0	82	P11137-1	578	660	+	82	0	0	4233
P11137-1#8	0	44	44	P11137-1	700	744	+	44	P11137-1	0	1827	P11137-3	0	1823	+	22	P11137-1#8	0	44	P11137-3	696	740	+	44	0	0	4234
P11137-1#8	0	44	44	P11137-1	700	744	+	44	P11137-1	0	1827	P11137-1	0	1827	+	20	P11137-1#8	0	44	P11137-1	700	744	+	44	0	0	4235
P11137-1#9	0	58	58	P11137-1	930	988	+	58	P11137-1	0	1827	P11137-3	0	1823	+	22	P11137-1#9	0	58	P11137-3	926	984	+	58	0	0	4236
P11137-1#9	0	58	58	P11137-1	930	988	+	58	P11137-1	0	1827	P11137-1	0	1827	+	20	P11137-1#9	0	58	P11137-1	930	988	+	58	0	0	4237
P11137-1#10	0	88	88	P11137-1	1072	1160	+	88	P11137-1	0	1827	P11137-3	0	1823	+	22	P11137-1#10	0	88	P11137-3	1068	1156	+	88	0	0	4238
P11137-1#10	0	88	88	P11137-1	1072	1160	+	88	P11137-1	0	1827	P11137-1	0	1827	+	20	P11137-1#10	0	88	P11137-1	1072	1160	+	88	0	0	4239
P11137-1#11	0	20	20	P11137-1	1196	1216	+	20	P11137-1	0	1827	P11137-3	0	1823	+	22	P11137-1#11	0	20	P11137-3	1192	1212	+	20	0	0	4240
P11137-1#11	0	20	20	P11137-1	1196	1216	+	20	P11137-1	0	1827	P11137-1	0	1827	+	20	P11137-1#11	0	20	P11137-1	1196	1216	+	20	0	0	4241
P11137-1#12	0	82	82	P11137-1	1296	1378	+	82	P11137-1	0	1827	P11137-3	0	1823	+	22	P11137-1#12	0	82	P11137-3	1292	1374	+	82	0	0	4242
P11137-1#12	0	82	82	P11137-1	1296	1378	+	82	P11137-1	0	1827	P11137-1	0	1827	+	20	P11137-1#12	0	82	P11137-1	1296	1378	+	82	0	0	4243
P11137-1#13	0	58	58	P11137-1	1402	1460	+	58	P11137-1	0	1827	P11137-3	0	1823	+	22	P11137-1#13	0	58	P11137-3	1398	1456	+	58	0	0	4244
P11137-1#13	0	58	58	P11137-1	1402	1460	+	58	P11137-1	0	1827	P11137-1	0	1827	+	20	P11137-1#13	0	58	P11137-1	1402	1460	+	58	0	0	4245
P11137-1#14	0	21	21	P11137-1	1446	1467	+	21	P11137-1	0	1827	P11137-3	0	1823	+	22	P11137-1#14	0	21	P11137-3	1442	1463	+	21	0	0	4246
P11137-1#14	0	21	21	P11137-1	1446	1467	+	21	P11137-1	0	1827	P11137-1	0	1827	+	20	P11137-1#14	0	21	P11137-1	1446	1467	+	21	0	0	4247
P11137-1#15	0	20	20	P11137-1	1470	1490	+	20	P11137-1	0	1827	P11137-3	0	1823	+	22	P11137-1#15	0	20	P11137-3	1466	1486	+	20	0	0	4248
P11137-1#15	0	20	20	P11137-1	1470	1490	+	20	P11137-1	0	1827	P11137-1	0	1827	+	20	P11137-1#15	0	20	P11137-1	1470	1490	+	20	0	0	4249
P11137-1#16	0	133	133	P11137-1	1505	1638	+	133	P11137-1	0	1827	P11137-3	0	1823	+	22	P11137-1#16	0	133	P11137-3	1501	1634	+	133	0	0	4250
P11137-1#16	0	133	133	P11137-1	1505	1638	+	133	P11137-1	0	1827	P11137-2	0	471	+	21	P11137-1#16	2	133	P11137-2	151	282	+	131	2	0	4251
P11137-1#16	0	133	133	P11137-1	1505	1638	+	133	P11137-1	0	1827	P11137-1	0	1827	+	20	P11137-1#16	0	133	P11137-1	1505	1638	+	133	0	0	4252
P11137-1#17	0	23	23	P11137-1	1778	1801	+	23	P11137-1	0	1827	P11137-3	0	1823	+	22	P11137-1#17	0	23	P11137-3	1774	1797	+	23	0	0	4253
P11137-1#17	0	23	23	P11137-1	1778	1801	+	23	P11137-1	0	1827	P11137-2	0	471	+	21	P11137-1#17	0	23	P11137-2	422	445	+	23	0	0	4254
P11137-1#17	0	23	23	P11137-1	1778	1801	+	23	P11137-1	0	1827	P11137-1	0	1827	+	20	P11137-1#17	0	23	P11137-1	1778	1801	+	23	0	0	4255
P11137-1#18	0	19	19	P11137-1	61	80	+	19	P11137-1	0	1827	P11137-3	0	1823	+	22	P11137-1#18	0	19	P11137-3	61	80	+	19	0	0	4256
P11137-1#18	0	19	19	P11137-1	61	80	+	19	P11137-1	0	1827	P11137-2	0	471	+	21	P11137-1#18	0	19	P11137-2	61	80	+	19	0	0	4257
P11137-1#18	0	19	19	P11137-1	61	80	+	19	P11137-1	0	1827	P11137-1	0	1827	+	20	P11137-1#18	0	19	P11137-1	61	80	+	19	0	0	4258
P11137-1#19	0	19	19	P11137-1	172	191	+	19	P11137-1	0	1827	P11137-3	0	1823	+	22	P11137-1#19	0	19	P11137-3	168	187	+	19	0	0	4259
P11137-1#19	0	19	19	P11137-1	172	191	+	19	P11137-1	0	1827	P11137-1	0	1827	+	20	P11137-1#19	0	19	P11137-1	172	191	+	19	0	0	4260
P11137-1#20	0	16	16	P11137-1	364	380	+	16	P11137-1	0	1827	P11137-3	0	1823	+	22	P11137-1#20	0	16	P11137-3	360	376	+	16	0	0	4261
P11137-1#20	0	16	16	P11137-1	364	380	+	16	P11137-1	0	1827	P11137-1	0	1827	+	20	P11137-1#20	0	16	P11137-1	364	380	+	16	0	0	4262
P11137-1#21	0	24	24	P11137-1	394	418	+	24	P11137-1	0	1827	P11137-3	0	1823	+	22	P11137-1#21	0	24	P11137-3	390	414	+	24	0	0	4263
P11137-1#21	0	24	24	P11137-1	394	418	+	24	P11137-1	0	1827	P11137-1	0	1827	+	20	P11137-1#21	0	24	P11137-1	394	418	+	24	0	0	4264
P11137-1#22	0	16	16	P11137-1	418	434	+	16	P11137-1	0	1827	P11137-3	0	1823	+	22	P11137-1#22	0	16	P11137-3	414	430	+	16	0	0	4265
P11137-1#22	0	16	16	P11137-1	418	434	+	16	P11137-1	0	1827	P11137-1	0	1827	+	20	P11137-1#22	0	16	P11137-1	418	434	+	16	0	0	4266
P11137-1#23	0	31	31	P11137-1	435	466	+	31	P11137-1	0	1827	P11137-3	0	1823	+	22	P11137-1#23	0	31	P11137-3	431	462	+	31	0	0	4267
P11137-1#23	0	31	31	P11137-1	435	466	+	31	P11137-1	0	1827	P11137-1	0	1827	+	20	P11137-1#23	0	31	P11137-1	435	466	+	31	0	0	4268
P11137-1#24	0	43	43	P11137-1	578	621	+	43	P11137-1	0	1827	P11137-3	0	1823	+	22	P11137-1#24	0	43	P11137-3	574	617	+	43	0	0	4269
P11137-1#24	0	43	43	P11137-1	578	621	+	43	P11137-1	0	1827	P11137-1	0	1827	+	20	P11137-1#24	0	43	P11137-1	578	621	+	43	0	0	4270
P11137-1#25	0	29	29	P11137-1	621	650	+	29	P11137-1	0	1827	P11137-3	0	1823	+	22	P11137-1#25	0	29	P11137-3	617	646	+	29	0	0	4271
P11137-1#25	0	29	29	P11137-1	621	650	+	29	P11137-1	0	1827	P11137-1	0	1827	+	20	P11137-1#25	0	29	P11137-1	621	650	+	29	0	0	4272
P11137-1#26	0	56	56	P11137-1	930	986	+	56	P11137-1	0	1827	P11137-3	0	1823	+	22	P11137-1#26	0	56	P11137-3	926	982	+	56	0	0	4273
P11137-1#26	0	56	56	P11137-1	930	986	+	56	P11137-1	0	1827	P11137-1	0	1827	+	20	P11137-1#26	0	56	P11137-1	930	986	+	56	0	0	4274
P11137-1#27	0	59	59	P11137-1	1099	1158	+	59	P11137-1	0	1827	P11137-3	0	1823	+	22	P11137-1#27	0	59	P11137-3	1095	1154	+	59	0	0	4275
P11137-1#27	0	59	59	P11137-1	1099	1158	+	59	P11137-1	0	1827	P11137-1	0	1827	+	20	P11137-1#27	0	59	P11137-1	1099	1158	+	59	0	0	4276
P11137-1#28	0	16	16	P11137-1	1313	1329	+	16	P11137-1	0	1827	P11137-3	0	1823	+	22	P11137-1#28	0	16	P11137-3	1309	1325	+	16	0	0	4277
P11137-1#28	0	16	16	P11137-1	1313	1329	+	16	P11137-1	0	1827	P11137-1	0	1827	+	20	P11137-1#28	0	16	P11137-1	1313	1329	+	16	0	0	4278
P11137-1#29	0	30	30	P11137-1	1348	1378	+	30	P11137-1	0	1827	P11137-3	0	1823	+	22	P11137-1#29	0	30	P11137-3	1344	1374	+	30	0	0	4279
P11137-1#29	0	30	30	P11137-1	1348	1378	+	30	P11137-1	0	1827	P11137-1	0	1827	+	20	P11137-1#29	0	30	P11137-1	1348	1378	+	30	0	0	4280
P11137-1#30	0	18	18	P11137-1	1558	1576	+	18	P11137-1	0	1827	P11137-3	0	1823	+	22	P11137-1#30	0	18	P11137-3	1554	1572	+	18	0	0	4281
P11137-1#30	0	18	18	P11137-1	1558	1576	+	18	P11137-1	0	1827	P11137-2	0	471	+	21	P11137-1#30	0	18	P11137-2	202	220	+	18	0	0	4282
P11137-1#30	0	18	18	P11137-1	1558	1576	+	18	P11137-1	0	1827	P11137-1	0	1827	+	20	P11137-1#30	0	18	P11137-1	1558	1576	+	18	0	0	4283
P11137-1#31	0	36	36	P11137-1	1582	1618	+	36	P11137-1	0	1827	P11137-3	0	1823	+	22	P11137-1#31	0	36	P11137-3	1578	1614	+	36	0	0	4284
P11137-1#31	0	36	36	P11137-1	1582	1618	+	36	P11137-1	0	1827	P11137-2	0	471	+	21	P11137-1#31	0	36	P11137-2	226	262	+	36	0	0	4285
P11137-1#31	0	36	36	P11137-1	1582	1618	+	36	P11137-1	0	1827	P11137-1	0	1827	+	20	P11137-1#31	0	36	P11137-1	1582	1618	+	36	0	0	4286
P11137-1#32	0	22	22	P11137-1	1779	1801	+	22	P11137-1	0	1827	P11137-3	0	1823	+	22	P11137-1#32	0	22	P11137-3	1775	1797	+	22	0	0	4287
P11137-1#32	0	22	22	P11137-1	1779	1801	+	22	P11137-1	0	1827	P11137-2	0	471	+	21	P11137-1#32	0	22	P11137-2	423	445	+	22	0	0	4288
P11137-1#32	0	22	22	P11137-1	1779	1801	+	22	P11137-1	0	1827	P11137-1	0	1827	+	20	P11137-1#32	0	22	P11137-1	1779	1801	+	22	0	0	4289
P11137-1#33	0	1	1	P11137-1	135	136	+	1	P11137-1	0	1827	P11137-3	0	1823	+	22	P11137-1#33	0	1	P11137-3	135	136	+	1	0	0	4290
P11137-1#33	0	1	1	P11137-1	135	136	+	1	P11137-1	0	1827	P11137-2	0	471	+	21	P11137-1#33	0	1	P11137-2	135	136	+	1	0	0	4291
P11137-1#33	0	1	1	P11137-1	135	136	+	1	P11137-1	0	1827	P11137-1	0	1827	+	20	P11137-1#33	0	1	P11137-1	135	136	+	1	0	0	4292
P11137-1#34	0	1	1	P11137-1	139	140	+	1	P11137-1	0	1827	P11137-3	0	1823	+	22	P11137-1#34	0	1	P11137-3	139	140	+	1	0	0	4293
P11137-1#34	0	1	1	P11137-1	139	140	+	1	P11137-1	0	1827	P11137-2	0	471	+	21	P11137-1#34	0	1	P11137-2	139	140	+	1	0	0	4294
P11137-1#34	0	1	1	P11137-1	139	140	+	1	P11137-1	0	1827	P11137-1	0	1827	+	20	P11137-1#34	0	1	P11137-1	139	140	+	1	0	0	4295
P11137-1#35	0	1	1	P11137-1	142	143	+	1	P11137-1	0	1827	P11137-3	0	1823	+	22	P11137-1#35	0	1	P11137-3	142	143	+	1	0	0	4296
P11137-1#35	0	1	1	P11137-1	142	143	+	1	P11137-1	0	1827	P11137-2	0	471	+	21	P11137-1#35	0	1	P11137-2	142	143	+	1	0	0	4297
P11137-1#35	0	1	1	P11137-1	142	143	+	1	P11137-1	0	1827	P11137-1	0	1827	+	20	P11137-1#35	0	1	P11137-1	142	143	+	1	0	0	4298
P11137-1#36	0	1	1	P11137-1	284	285	+	1	P11137-1	0	1827	P11137-3	0	1823	+	22	P11137-1#36	0	1	P11137-3	280	281	+	1	0	0	4299
P11137-1#36	0	1	1	P11137-1	284	285	+	1	P11137-1	0	1827	P11137-1	0	1827	+	20	P11137-1#36	0	1	P11137-1	284	285	+	1	0	0	4300
P11137-1#37	0	1	1	P11137-1	497	498	+	1	P11137-1	0	1827	P11137-3	0	1823	+	22	P11137-1#37	0	1	P11137-3	493	494	+	1	0	0	4301
P11137-1#37	0	1	1	P11137-1	497	498	+	1	P11137-1	0	1827	P11137-1	0	1827	+	20	P11137-1#37	0	1	P11137-1	497	498	+	1	0	0	4302
P11137-1#38	0	1	1	P11137-1	600	601	+	1	P11137-1	0	1827	P11137-3	0	1823	+	22	P11137-1#38	0	1	P11137-3	596	597	+	1	0	0	4303
P11137-1#38	0	1	1	P11137-1	600	601	+	1	P11137-1	0	1827	P11137-1	0	1827	+	20	P11137-1#38	0	1	P11137-1	600	601	+	1	0	0	4304
P11137-1#39	0	1	1	P11137-1	604	605	+	1	P11137-1	0	1827	P11137-3	0	1823	+	22	P11137-1#39	0	1	P11137-3	600	601	+	1	0	0	4305
P11137-1#39	0	1	1	P11137-1	604	605	+	1	P11137-1	0	1827	P11137-1	0	1827	+	20	P11137-1#39	0	1	P11137-1	604	605	+	1	0	0	4306
P11137-1#40	0	1	1	P11137-1	609	610	+	1	P11137-1	0	1827	P11137-3	0	1823	+	22	P11137-1#40	0	1	P11137-3	605	606	+	1	0	0	4307
P11137-1#40	0	1	1	P11137-1	609	610	+	1	P11137-1	0	1827	P11137-1	0	1827	+	20	P11137-1#40	0	1	P11137-1	609	610	+	1	0	0	4308
P11137-1#41	0	1	1	P11137-1	628	629	+	1	P11137-1	0	1827	P11137-3	0	1823	+	22	P11137-1#41	0	1	P11137-3	624	625	+	1	0	0	4309
P11137-1#41	0	1	1	P11137-1	628	629	+	1	P11137-1	0	1827	P11137-1	0	1827	+	20	P11137-1#41	0	1	P11137-1	628	629	+	1	0	0	4310
P11137-1#42	0	1	1	P11137-1	724	725	+	1	P11137-1	0	1827	P11137-3	0	1823	+	22	P11137-1#42	0	1	P11137-3	720	721	+	1	0	0	4311
P11137-1#42	0	1	1	P11137-1	724	725	+	1	P11137-1	0	1827	P11137-1	0	1827	+	20	P11137-1#42	0	1	P11137-1	724	725	+	1	0	0	4312
P11137-1#43	0	1	1	P11137-1	728	729	+	1	P11137-1	0	1827	P11137-3	0	1823	+	22	P11137-1#43	0	1	P11137-3	724	725	+	1	0	0	4313
P11137-1#43	0	1	1	P11137-1	728	729	+	1	P11137-1	0	1827	P11137-1	0	1827	+	20	P11137-1#43	0	1	P11137-1	728	729	+	1	0	0	4314
P11137-1#44	0	1	1	P11137-1	732	733	+	1	P11137-1	0	1827	P11137-3	0	1823	+	22	P11137-1#44	0	1	P11137-3	728	729	+	1	0	0	4315
P11137-1#44	0	1	1	P11137-1	732	733	+	1	P11137-1	0	1827	P11137-1	0	1827	+	20	P11137-1#44	0	1	P11137-1	732	733	+	1	0	0	4316
P11137-1#45	0	1	1	P11137-1	735	736	+	1	P11137-1	0	1827	P11137-3	0	1823	+	22	P11137-1#45	0	1	P11137-3	731	732	+	1	0	0	4317
P11137-1#45	0	1	1	P11137-1	735	736	+	1	P11137-1	0	1827	P11137-1	0	1827	+	20	P11137-1#45	0	1	P11137-1	735	736	+	1	0	0	4318
P11137-1#46	0	1	1	P11137-1	737	738	+	1	P11137-1	0	1827	P11137-3	0	1823	+	22	P11137-1#46	0	1	P11137-3	733	734	+	1	0	0	4319
P11137-1#46	0	1	1	P11137-1	737	738	+	1	P11137-1	0	1827	P11137-1	0	1827	+	20	P11137-1#46	0	1	P11137-1	737	738	+	1	0	0	4320
P11137-1#47	0	1	1	P11137-1	744	745	+	1	P11137-1	0	1827	P11137-3	0	1823	+	22	P11137-1#47	0	1	P11137-3	740	741	+	1	0	0	4321
P11137-1#47	0	1	1	P11137-1	744	745	+	1	P11137-1	0	1827	P11137-1	0	1827	+	20	P11137-1#47	0	1	P11137-1	744	745	+	1	0	0	4322
P11137-1#48	0	1	1	P11137-1	820	821	+	1	P11137-1	0	1827	P11137-3	0	1823	+	22	P11137-1#48	0	1	P11137-3	816	817	+	1	0	0	4323
P11137-1#48	0	1	1	P11137-1	820	821	+	1	P11137-1	0	1827	P11137-1	0	1827	+	20	P11137-1#48	0	1	P11137-1	820	821	+	1	0	0	4324
P11137-1#49	0	1	1	P11137-1	880	881	+	1	P11137-1	0	1827	P11137-3	0	1823	+	22	P11137-1#49	0	1	P11137-3	876	877	+	1	0	0	4325
P11137-1#49	0	1	1	P11137-1	880	881	+	1	P11137-1	0	1827	P11137-1	0	1827	+	20	P11137-1#49	0	1	P11137-1	880	881	+	1	0	0	4326
P11137-1#50	0	1	1	P11137-1	889	890	+	1	P11137-1	0	1827	P11137-3	0	1823	+	22	P11137-1#50	0	1	P11137-3	885	886	+	1	0	0	4327
P11137-1#50	0	1	1	P11137-1	889	890	+	1	P11137-1	0	1827	P11137-1	0	1827	+	20	P11137-1#50	0	1	P11137-1	889	890	+	1	0	0	4328
P11137-1#51	0	1	1	P11137-1	935	936	+	1	P11137-1	0	1827	P11137-3	0	1823	+	22	P11137-1#51	0	1	P11137-3	931	932	+	1	0	0	4329
P11137-1#51	0	1	1	P11137-1	935	936	+	1	P11137-1	0	1827	P11137-1	0	1827	+	20	P11137-1#51	0	1	P11137-1	935	936	+	1	0	0	4330
P11137-1#52	0	1	1	P11137-1	1132	1133	+	1	P11137-1	0	1827	P11137-3	0	1823	+	22	P11137-1#52	0	1	P11137-3	1128	1129	+	1	0	0	4331
P11137-1#52	0	1	1	P11137-1	1132	1133	+	1	P11137-1	0	1827	P11137-1	0	1827	+	20	P11137-1#52	0	1	P11137-1	1132	1133	+	1	0	0	4332
P11137-1#53	0	1	1	P11137-1	1133	1134	+	1	P11137-1	0	1827	P11137-3	0	1823	+	22	P11137-1#53	0	1	P11137-3	1129	1130	+	1	0	0	4333
P11137-1#53	0	1	1	P11137-1	1133	1134	+	1	P11137-1	0	1827	P11137-1	0	1827	+	20	P11137-1#53	0	1	P11137-1	1133	1134	+	1	0	0	4334
P11137-1#54	0	1	1	P11137-1	1138	1139	+	1	P11137-1	0	1827	P11137-3	0	1823	+	22	P11137-1#54	0	1	P11137-3	1134	1135	+	1	0	0	4335
P11137-1#54	0	1	1	P11137-1	1138	1139	+	1	P11137-1	0	1827	P11137-1	0	1827	+	20	P11137-1#54	0	1	P11137-1	1138	1139	+	1	0	0	4336
P11137-1#55	0	1	1	P11137-1	1153	1154	+	1	P11137-1	0	1827	P11137-3	0	1823	+	22	P11137-1#55	0	1	P11137-3	1149	1150	+	1	0	0	4337
P11137-1#55	0	1	1	P11137-1	1153	1154	+	1	P11137-1	0	1827	P11137-1	0	1827	+	20	P11137-1#55	0	1	P11137-1	1153	1154	+	1	0	0	4338
P11137-1#56	0	1	1	P11137-1	1154	1155	+	1	P11137-1	0	1827	P11137-3	0	1823	+	22	P11137-1#56	0	1	P11137-3	1150	1151	+	1	0	0	4339
P11137-1#56	0	1	1	P11137-1	1154	1155	+	1	P11137-1	0	1827	P11137-1	0	1827	+	20	P11137-1#56	0	1	P11137-1	1154	1155	+	1	0	0	4340
P11137-1#57	0	1	1	P11137-1	1158	1159	+	1	P11137-1	0	1827	P11137-3	0	1823	+	22	P11137-1#57	0	1	P11137-3	1154	1155	+	1	0	0	4341
P11137-1#57	0	1	1	P11137-1	1158	1159	+	1	P11137-1	0	1827	P11137-1	0	1827	+	20	P11137-1#57	0	1	P11137-1	1158	1159	+	1	0	0	4342
P11137-1#58	0	1	1	P11137-1	1346	1347	+	1	P11137-1	0	1827	P11137-3	0	1823	+	22	P11137-1#58	0	1	P11137-3	1342	1343	+	1	0	0	4343
P11137-1#58	0	1	1	P11137-1	1346	1347	+	1	P11137-1	0	1827	P11137-1	0	1827	+	20	P11137-1#58	0	1	P11137-1	1346	1347	+	1	0	0	4344
P11137-1#59	0	1	1	P11137-1	1352	1353	+	1	P11137-1	0	1827	P11137-3	0	1823	+	22	P11137-1#59	0	1	P11137-3	1348	1349	+	1	0	0	4345
P11137-1#59	0	1	1	P11137-1	1352	1353	+	1	P11137-1	0	1827	P11137-1	0	1827	+	20	P11137-1#59	0	1	P11137-1	1352	1353	+	1	0	0	4346
P11137-1#60	0	1	1	P11137-1	1533	1534	+	1	P11137-1	0	1827	P11137-3	0	1823	+	22	P11137-1#60	0	1	P11137-3	1529	1530	+	1	0	0	4347
P11137-1#60	0	1	1	P11137-1	1533	1534	+	1	P11137-1	0	1827	P11137-2	0	471	+	21	P11137-1#60	0	1	P11137-2	177	178	+	1	0	0	4348
P11137-1#60	0	1	1	P11137-1	1533	1534	+	1	P11137-1	0	1827	P11137-1	0	1827	+	20	P11137-1#60	0	1	P11137-1	1533	1534	+	1	0	0	4349
P11137-1#61	0	1	1	P11137-1	1554	1555	+	1	P11137-1	0	1827	P11137-3	0	1823	+	22	P11137-1#61	0	1	P11137-3	1550	1551	+	1	0	0	4350
P11137-1#61	0	1	1	P11137-1	1554	1555	+	1	P11137-1	0	1827	P11137-2	0	471	+	21	P11137-1#61	0	1	P11137-2	198	199	+	1	0	0	4351
P11137-1#61	0	1	1	P11137-1	1554	1555	+	1	P11137-1	0	1827	P11137-1	0	1827	+	20	P11137-1#61	0	1	P11137-1	1554	1555	+	1	0	0	4352
P11137-1#62	0	1	1	P11137-1	1587	1588	+	1	P11137-1	0	1827	P11137-3	0	1823	+	22	P11137-1#62	0	1	P11137-3	1583	1584	+	1	0	0	4353
P11137-1#62	0	1	1	P11137-1	1587	1588	+	1	P11137-1	0	1827	P11137-2	0	471	+	21	P11137-1#62	0	1	P11137-2	231	232	+	1	0	0	4354
P11137-1#62	0	1	1	P11137-1	1587	1588	+	1	P11137-1	0	1827	P11137-1	0	1827	+	20	P11137-1#62	0	1	P11137-1	1587	1588	+	1	0	0	4355
P11137-1#63	0	1	1	P11137-1	1601	1602	+	1	P11137-1	0	1827	P11137-3	0	1823	+	22	P11137-1#63	0	1	P11137-3	1597	1598	+	1	0	0	4356
P11137-1#63	0	1	1	P11137-1	1601	1602	+	1	P11137-1	0	1827	P11137-2	0	471	+	21	P11137-1#63	0	1	P11137-2	245	246	+	1	0	0	4357
P11137-1#63	0	1	1	P11137-1	1601	1602	+	1	P11137-1	0	1827	P11137-1	0	1827	+	20	P11137-1#63	0	1	P11137-1	1601	1602	+	1	0	0	4358
P11137-1#64	0	1	1	P11137-1	1604	1605	+	1	P11137-1	0	1827	P11137-3	0	1823	+	22	P11137-1#64	0	1	P11137-3	1600	1601	+	1	0	0	4359
P11137-1#64	0	1	1	P11137-1	1604	1605	+	1	P11137-1	0	1827	P11137-2	0	471	+	21	P11137-1#64	0	1	P11137-2	248	249	+	1	0	0	4360
P11137-1#64	0	1	1	P11137-1	1604	1605	+	1	P11137-1	0	1827	P11137-1	0	1827	+	20	P11137-1#64	0	1	P11137-1	1604	1605	+	1	0	0	4361
P11137-1#65	0	1	1	P11137-1	1615	1616	+	1	P11137-1	0	1827	P11137-3	0	1823	+	22	P11137-1#65	0	1	P11137-3	1611	1612	+	1	0	0	4362
P11137-1#65	0	1	1	P11137-1	1615	1616	+	1	P11137-1	0	1827	P11137-2	0	471	+	21	P11137-1#65	0	1	P11137-2	259	260	+	1	0	0	4363
P11137-1#65	0	1	1	P11137-1	1615	1616	+	1	P11137-1	0	1827	P11137-1	0	1827	+	20	P11137-1#65	0	1	P11137-1	1615	1616	+	1	0	0	4364
P11137-1#66	0	1	1	P11137-1	1618	1619	+	1	P11137-1	0	1827	P11137-3	0	1823	+	22	P11137-1#66	0	1	P11137-3	1614	1615	+	1	0	0	4365
P11137-1#66	0	1	1	P11137-1	1618	1619	+	1	P11137-1	0	1827	P11137-2	0	471	+	21	P11137-1#66	0	1	P11137-2	262	263	+	1	0	0	4366
P11137-1#66	0	1	1	P11137-1	1618	1619	+	1	P11137-1	0	1827	P11137-1	0	1827	+	20	P11137-1#66	0	1	P11137-1	1618	1619	+	1	0	0	4367
P11137-1#67	0	1	1	P11137-1	1648	1649	+	1	P11137-1	0	1827	P11137-3	0	1823	+	22	P11137-1#67	0	1	P11137-3	1644	1645	+	1	0	0	4368
P11137-1#67	0	1	1	P11137-1	1648	1649	+	1	P11137-1	0	1827	P11137-2	0	471	+	21	P11137-1#67	0	1	P11137-2	292	293	+	1	0	0	4369
P11137-1#67	0	1	1	P11137-1	1648	1649	+	1	P11137-1	0	1827	P11137-1	0	1827	+	20	P11137-1#67	0	1	P11137-1	1648	1649	+	1	0	0	4370
P11137-1#68	0	1	1	P11137-1	1652	1653	+	1	P11137-1	0	1827	P11137-3	0	1823	+	22	P11137-1#68	0	1	P11137-3	1648	1649	+	1	0	0	4371
P11137-1#68	0	1	1	P11137-1	1652	1653	+	1	P11137-1	0	1827	P11137-2	0	471	+	21	P11137-1#68	0	1	P11137-2	296	297	+	1	0	0	4372
P11137-1#68	0	1	1	P11137-1	1652	1653	+	1	P11137-1	0	1827	P11137-1	0	1827	+	20	P11137-1#68	0	1	P11137-1	1652	1653	+	1	0	0	4373
P11137-1#69	0	1	1	P11137-1	1678	1679	+	1	P11137-1	0	1827	P11137-3	0	1823	+	22	P11137-1#69	0	1	P11137-3	1674	1675	+	1	0	0	4374
P11137-1#69	0	1	1	P11137-1	1678	1679	+	1	P11137-1	0	1827	P11137-2	0	471	+	21	P11137-1#69	0	1	P11137-2	322	323	+	1	0	0	4375
P11137-1#69	0	1	1	P11137-1	1678	1679	+	1	P11137-1	0	1827	P11137-1	0	1827	+	20	P11137-1#69	0	1	P11137-1	1678	1679	+	1	0	0	4376
P11137-1#70	0	1	1	P11137-1	1781	1782	+	1	P11137-1	0	1827	P11137-3	0	1823	+	22	P11137-1#70	0	1	P11137-3	1777	1778	+	1	0	0	4377
P11137-1#70	0	1	1	P11137-1	1781	1782	+	1	P11137-1	0	1827	P11137-2	0	471	+	21	P11137-1#70	0	1	P11137-2	425	426	+	1	0	0	4378
P11137-1#70	0	1	1	P11137-1	1781	1782	+	1	P11137-1	0	1827	P11137-1	0	1827	+	20	P11137-1#70	0	1	P11137-1	1781	1782	+	1	0	0	4379
P11137-1#71	0	1	1	P11137-1	1786	1787	+	1	P11137-1	0	1827	P11137-3	0	1823	+	22	P11137-1#71	0	1	P11137-3	1782	1783	+	1	0	0	4380
P11137-1#71	0	1	1	P11137-1	1786	1787	+	1	P11137-1	0	1827	P11137-2	0	471	+	21	P11137-1#71	0	1	P11137-2	430	431	+	1	0	0	4381
P11137-1#71	0	1	1	P11137-1	1786	1787	+	1	P11137-1	0	1827	P11137-1	0	1827	+	20	P11137-1#71	0	1	P11137-1	1786	1787	+	1	0	0	4382
P11137-1#72	0	1	1	P11137-1	1789	1790	+	1	P11137-1	0	1827	P11137-3	0	1823	+	22	P11137-1#72	0	1	P11137-3	1785	1786	+	1	0	0	4383
P11137-1#72	0	1	1	P11137-1	1789	1790	+	1	P11137-1	0	1827	P11137-2	0	471	+	21	P11137-1#72	0	1	P11137-2	433	434	+	1	0	0	4384
P11137-1#72	0	1	1	P11137-1	1789	1790	+	1	P11137-1	0	1827	P11137-1	0	1827	+	20	P11137-1#72	0	1	P11137-1	1789	1790	+	1	0	0	4385
P11137-1#73	0	1	1	P11137-1	1794	1795	+	1	P11137-1	0	1827	P11137-3	0	1823	+	22	P11137-1#73	0	1	P11137-3	1790	1791	+	1	0	0	4386
P11137-1#73	0	1	1	P11137-1	1794	1795	+	1	P11137-1	0	1827	P11137-2	0	471	+	21	P11137-1#73	0	1	P11137-2	438	439	+	1	0	0	4387
P11137-1#73	0	1	1	P11137-1	1794	1795	+	1	P11137-1	0	1827	P11137-1	0	1827	+	20	P11137-1#73	0	1	P11137-1	1794	1795	+	1	0	0	4388
P11137-1#74	0	1	1	P11137-1	1807	1808	+	1	P11137-1	0	1827	P11137-3	0	1823	+	22	P11137-1#74	0	1	P11137-3	1803	1804	+	1	0	0	4389
P11137-1#74	0	1	1	P11137-1	1807	1808	+	1	P11137-1	0	1827	P11137-2	0	471	+	21	P11137-1#74	0	1	P11137-2	451	452	+	1	0	0	4390
P11137-1#74	0	1	1	P11137-1	1807	1808	+	1	P11137-1	0	1827	P11137-1	0	1827	+	20	P11137-1#74	0	1	P11137-1	1807	1808	+	1	0	0	4391
P11137-1#75	0	1356	1356	P11137-1	151	1507	+	1356	P11137-1	0	1827	P11137-3	0	1823	+	22	P11137-1#75	4	1356	P11137-3	151	1503	+	1352	4	0	4392
P11137-1#75	0	1356	1356	P11137-1	151	1507	+	1356	P11137-1	0	1827	P11137-1	0	1827	+	20	P11137-1#75	0	1356	P11137-1	151	1507	+	1356	0	0	4393
P11137-1#76	0	78	78	P11137-1	151	229	+	78	P11137-1	0	1827	P11137-3	0	1823	+	22	P11137-1#76	4	78	P11137-3	151	225	+	74	4	0	4394
P11137-1#76	0	78	78	P11137-1	151	229	+	78	P11137-1	0	1827	P11137-1	0	1827	+	20	P11137-1#76	0	78	P11137-1	151	229	+	78	0	0	4395
P11137-1#77	0	4	4	P11137-1	151	155	+	4	P11137-1	0	1827	P11137-1	0	1827	+	20	P11137-1#77	0	4	P11137-1	151	155	+	4	0	0	4396
P11137-1#78	0	1299	1299	P11137-1	229	1528	+	1299	P11137-1	0	1827	P11137-3	0	1823	+	22	P11137-1#78	0	1299	P11137-3	225	1524	+	1299	0	0	4397
P11137-1#78	0	1299	1299	P11137-1	229	1528	+	1299	P11137-1	0	1827	P11137-2	0	471	+	21	P11137-1#78	1278	1299	P11137-2	151	172	+	21	1278	0	4398
P11137-1#78	0	1299	1299	P11137-1	229	1528	+	1299	P11137-1	0	1827	P11137-1	0	1827	+	20	P11137-1#78	0	1299	P11137-1	229	1528	+	1299	0	0	4399
P11137-1#79	0	1	1	P11137-1	1690	1691	+	1	P11137-1	0	1827	P11137-3	0	1823	+	22	P11137-1#79	0	1	P11137-3	1686	1687	+	1	0	0	4400
P11137-1#79	0	1	1	P11137-1	1690	1691	+	1	P11137-1	0	1827	P11137-2	0	471	+	21	P11137-1#79	0	1	P11137-2	334	335	+	1	0	0	4401
P11137-1#79	0	1	1	P11137-1	1690	1691	+	1	P11137-1	0	1827	P11137-1	0	1827	+	20	P11137-1#79	0	1	P11137-1	1690	1691	+	1	0	0	4402
P11137-1#80	0	1	1	P11137-1	81	82	+	1	P11137-1	0	1827	P11137-3	0	1823	+	22	P11137-1#80	0	1	P11137-3	81	82	+	1	0	0	4403
P11137-1#80	0	1	1	P11137-1	81	82	+	1	P11137-1	0	1827	P11137-2	0	471	+	21	P11137-1#80	0	1	P11137-2	81	82	+	1	0	0	4404
P11137-1#80	0	1	1	P11137-1	81	82	+	1	P11137-1	0	1827	P11137-1	0	1827	+	20	P11137-1#80	0	1	P11137-1	81	82	+	1	0	0	4405
P11137-1#81	0	1	1	P11137-1	178	179	+	1	P11137-1	0	1827	P11137-3	0	1823	+	22	P11137-1#81	0	1	P11137-3	174	175	+	1	0	0	4406
P11137-1#81	0	1	1	P11137-1	178	179	+	1	P11137-1	0	1827	P11137-1	0	1827	+	20	P11137-1#81	0	1	P11137-1	178	179	+	1	0	0	4407
P11137-1#82	0	1	1	P11137-1	276	277	+	1	P11137-1	0	1827	P11137-3	0	1823	+	22	P11137-1#82	0	1	P11137-3	272	273	+	1	0	0	4408
P11137-1#82	0	1	1	P11137-1	276	277	+	1	P11137-1	0	1827	P11137-1	0	1827	+	20	P11137-1#82	0	1	P11137-1	276	277	+	1	0	0	4409
P11137-1#83	0	1	1	P11137-1	422	423	+	1	P11137-1	0	1827	P11137-3	0	1823	+	22	P11137-1#83	0	1	P11137-3	418	419	+	1	0	0	4410
P11137-1#83	0	1	1	P11137-1	422	423	+	1	P11137-1	0	1827	P11137-1	0	1827	+	20	P11137-1#83	0	1	P11137-1	422	423	+	1	0	0	4411
P11137-1#84	0	1	1	P11137-1	704	705	+	1	P11137-1	0	1827	P11137-3	0	1823	+	22	P11137-1#84	0	1	P11137-3	700	701	+	1	0	0	4412
P11137-1#84	0	1	1	P11137-1	704	705	+	1	P11137-1	0	1827	P11137-1	0	1827	+	20	P11137-1#84	0	1	P11137-1	704	705	+	1	0	0	4413
P11137-1#85	0	1	1	P11137-1	975	976	+	1	P11137-1	0	1827	P11137-3	0	1823	+	22	P11137-1#85	0	1	P11137-3	971	972	+	1	0	0	4414
P11137-1#85	0	1	1	P11137-1	975	976	+	1	P11137-1	0	1827	P11137-1	0	1827	+	20	P11137-1#85	0	1	P11137-1	975	976	+	1	0	0	4415
P11137-1#86	0	1	1	P11137-1	990	991	+	1	P11137-1	0	1827	P11137-3	0	1823	+	22	P11137-1#86	0	1	P11137-3	986	987	+	1	0	0	4416
P11137-1#86	0	1	1	P11137-1	990	991	+	1	P11137-1	0	1827	P11137-1	0	1827	+	20	P11137-1#86	0	1	P11137-1	990	991	+	1	0	0	4417
P11137-1#87	0	1	1	P11137-1	1098	1099	+	1	P11137-1	0	1827	P11137-3	0	1823	+	22	P11137-1#87	0	1	P11137-3	1094	1095	+	1	0	0	4418
P11137-1#87	0	1	1	P11137-1	1098	1099	+	1	P11137-1	0	1827	P11137-1	0	1827	+	20	P11137-1#87	0	1	P11137-1	1098	1099	+	1	0	0	4419
P11137-1#88	0	1	1	P11137-1	8	9	+	1	P11137-1	0	1827	P11137-3	0	1823	+	22	P11137-1#88	0	1	P11137-3	8	9	+	1	0	0	4420
P11137-1#88	0	1	1	P11137-1	8	9	+	1	P11137-1	0	1827	P11137-2	0	471	+	21	P11137-1#88	0	1	P11137-2	8	9	+	1	0	0	4421
P11137-1#88	0	1	1	P11137-1	8	9	+	1	P11137-1	0	1827	P11137-1	0	1827	+	20	P11137-1#88	0	1	P11137-1	8	9	+	1	0	0	4422
P11137-1#89	0	1	1	P11137-1	36	37	+	1	P11137-1	0	1827	P11137-3	0	1823	+	22	P11137-1#89	0	1	P11137-3	36	37	+	1	0	0	4423
P11137-1#89	0	1	1	P11137-1	36	37	+	1	P11137-1	0	1827	P11137-2	0	471	+	21	P11137-1#89	0	1	P11137-2	36	37	+	1	0	0	4424
P11137-1#89	0	1	1	P11137-1	36	37	+	1	P11137-1	0	1827	P11137-1	0	1827	+	20	P11137-1#89	0	1	P11137-1	36	37	+	1	0	0	4425
P11137-1#90	0	1	1	P11137-1	107	108	+	1	P11137-1	0	1827	P11137-3	0	1823	+	22	P11137-1#90	0	1	P11137-3	107	108	+	1	0	0	4426
P11137-1#90	0	1	1	P11137-1	107	108	+	1	P11137-1	0	1827	P11137-2	0	471	+	21	P11137-1#90	0	1	P11137-2	107	108	+	1	0	0	4427
P11137-1#90	0	1	1	P11137-1	107	108	+	1	P11137-1	0	1827	P11137-1	0	1827	+	20	P11137-1#90	0	1	P11137-1	107	108	+	1	0	0	4428
P11137-1#91	0	1	1	P11137-1	186	187	+	1	P11137-1	0	1827	P11137-3	0	1823	+	22	P11137-1#91	0	1	P11137-3	182	183	+	1	0	0	4429
P11137-1#91	0	1	1	P11137-1	186	187	+	1	P11137-1	0	1827	P11137-1	0	1827	+	20	P11137-1#91	0	1	P11137-1	186	187	+	1	0	0	4430
P11137-1#92	0	1	1	P11137-1	1111	1112	+	1	P11137-1	0	1827	P11137-3	0	1823	+	22	P11137-1#92	0	1	P11137-3	1107	1108	+	1	0	0	4431
P11137-1#92	0	1	1	P11137-1	1111	1112	+	1	P11137-1	0	1827	P11137-1	0	1827	+	20	P11137-1#92	0	1	P11137-1	1111	1112	+	1	0	0	4432
P11137-1#93	0	1	1	P11137-1	1654	1655	+	1	P11137-1	0	1827	P11137-3	0	1823	+	22	P11137-1#93	0	1	P11137-3	1650	1651	+	1	0	0	4433
P11137-1#93	0	1	1	P11137-1	1654	1655	+	1	P11137-1	0	1827	P11137-2	0	471	+	21	P11137-1#93	0	1	P11137-2	298	299	+	1	0	0	4434
P11137-1#93	0	1	1	P11137-1	1654	1655	+	1	P11137-1	0	1827	P11137-1	0	1827	+	20	P11137-1#93	0	1	P11137-1	1654	1655	+	1	0	0	4435
P11137-1#94	0	2	2	P11137-1	1714	1716	+	2	P11137-1	0	1827	P11137-3	0	1823	+	22	P11137-1#94	0	2	P11137-3	1710	1712	+	2	0	0	4436
P11137-1#94	0	2	2	P11137-1	1714	1716	+	2	P11137-1	0	1827	P11137-2	0	471	+	21	P11137-1#94	0	2	P11137-2	358	360	+	2	0	0	4437
P11137-1#94	0	2	2	P11137-1	1714	1716	+	2	P11137-1	0	1827	P11137-1	0	1827	+	20	P11137-1#94	0	2	P11137-1	1714	1716	+	2	0	0	4438
P11137-1#95	0	1	1	P11137-1	1735	1736	+	1	P11137-1	0	1827	P11137-3	0	1823	+	22	P11137-1#95	0	1	P11137-3	1731	1732	+	1	0	0	4439
P11137-1#95	0	1	1	P11137-1	1735	1736	+	1	P11137-1	0	1827	P11137-2	0	471	+	21	P11137-1#95	0	1	P11137-2	379	380	+	1	0	0	4440
P11137-1#95	0	1	1	P11137-1	1735	1736	+	1	P11137-1	0	1827	P11137-1	0	1827	+	20	P11137-1#95	0	1	P11137-1	1735	1736	+	1	0	0	4441
P11137-1#96	0	1	1	P11137-1	66	67	+	1	P11137-1	0	1827	P11137-3	0	1823	+	22	P11137-1#96	0	1	P11137-3	66	67	+	1	0	0	4442
P11137-1#96	0	1	1	P11137-1	66	67	+	1	P11137-1	0	1827	P11137-2	0	471	+	21	P11137-1#96	0	1	P11137-2	66	67	+	1	0	0	4443
P11137-1#96	0	1	1	P11137-1	66	67	+	1	P11137-1	0	1827	P11137-1	0	1827	+	20	P11137-1#96	0	1	P11137-1	66	67	+	1	0	0	4444
P11137-1#97	0	1	1	P11137-1	322	323	+	1	P11137-1	0	1827	P11137-3	0	1823	+	22	P11137-1#97	0	1	P11137-3	318	319	+	1	0	0	4445
P11137-1#97	0	1	1	P11137-1	322	323	+	1	P11137-1	0	1827	P11137-1	0	1827	+	20	P11137-1#97	0	1	P11137-1	322	323	+	1	0	0	4446
P11137-1#98	0	1	1	P11137-1	353	354	+	1	P11137-1	0	1827	P11137-3	0	1823	+	22	P11137-1#98	0	1	P11137-3	349	350	+	1	0	0	4447
P11137-1#98	0	1	1	P11137-1	353	354	+	1	P11137-1	0	1827	P11137-1	0	1827	+	20	P11137-1#98	0	1	P11137-1	353	354	+	1	0	0	4448
P11137-1#99	0	1	1	P11137-1	385	386	+	1	P11137-1	0	1827	P11137-3	0	1823	+	22	P11137-1#99	0	1	P11137-3	381	382	+	1	0	0	4449
P11137-1#99	0	1	1	P11137-1	385	386	+	1	P11137-1	0	1827	P11137-1	0	1827	+	20	P11137-1#99	0	1	P11137-1	385	386	+	1	0	0	4450
O95831-1#0	0	54	54	O95831-1	0	54	+	54	O95831-1	0	36	O95831-6	0	36	+	13	O95831-1#0	0	36	O95831-6	0	36	+	36	0	18	4451
O95831-1#0	0	54	54	O95831-1	0	54	+	54	O95831-1	0	322	O95831-4	0	322	+	11	O95831-1#0	0	54	O95831-4	0	54	+	54	0	0	4452
O95831-1#0	0	54	54	O95831-1	0	54	+	54	O95831-1	0	613	O95831-3	0	609	+	10	O95831-1#0	0	35	O95831-3	0	35	+	35	0	19	4453
O95831-1#0	0	54	54	O95831-1	0	54	+	54	O95831-1	0	613	O95831-2	0	326	+	9	O95831-1#0	0	35	O95831-2	0	35	+	35	0	19	4454
O95831-1#0	0	54	54	O95831-1	0	54	+	54	O95831-1	0	613	O95831-1	0	613	+	8	O95831-1#0	0	54	O95831-1	0	54	+	54	0	0	4455
O95831-1#1	0	47	47	O95831-1	54	101	+	47	O95831-1	0	322	O95831-4	0	322	+	11	O95831-1#1	0	47	O95831-4	54	101	+	47	0	0	4456
O95831-1#1	0	47	47	O95831-1	54	101	+	47	O95831-1	0	613	O95831-3	0	609	+	10	O95831-1#1	28	47	O95831-3	78	97	+	19	28	0	4457
O95831-1#1	0	47	47	O95831-1	54	101	+	47	O95831-1	0	613	O95831-1	0	613	+	8	O95831-1#1	0	47	O95831-1	54	101	+	47	0	0	4458
O95831-1#2	0	512	512	O95831-1	101	613	+	512	O95831-1	352	613	O95831-5	0	261	+	12	O95831-1#2	251	512	O95831-5	0	261	+	261	251	0	4459
O95831-1#2	0	512	512	O95831-1	101	613	+	512	O95831-1	0	322	O95831-4	0	322	+	11	O95831-1#2	0	221	O95831-4	101	322	+	221	0	291	4460
O95831-1#2	0	512	512	O95831-1	101	613	+	512	O95831-1	0	613	O95831-3	0	609	+	10	O95831-1#2	0	512	O95831-3	97	609	+	512	0	0	4461
O95831-1#2	0	512	512	O95831-1	101	613	+	512	O95831-1	0	613	O95831-2	0	326	+	9	O95831-1#2	221	512	O95831-2	35	326	+	291	221	0	4462
O95831-1#2	0	512	512	O95831-1	101	613	+	512	O95831-1	0	613	O95831-1	0	613	+	8	O95831-1#2	0	512	O95831-1	101	613	+	512	0	0	4463
O95831-1#3	0	28	28	O95831-1	99	127	+	28	O95831-1	0	322	O95831-4	0	322	+	11	O95831-1#3	0	28	O95831-4	99	127	+	28	0	0	4464
O95831-1#3	0	28	28	O95831-1	99	127	+	28	O95831-1	0	613	O95831-3	0	609	+	10	O95831-1#3	0	28	O95831-3	95	123	+	28	0	0	4465
O95831-1#3	0	28	28	O95831-1	99	127	+	28	O95831-1	0	613	O95831-1	0	613	+	8	O95831-1#3	0	28	O95831-1	99	127	+	28	0	0	4466
O95831-1#4	0	350	350	O95831-1	133	483	+	350	O95831-1	352	613	O95831-5	0	261	+	12	O95831-1#4	219	350	O95831-5	0	131	+	131	219	0	4467
O95831-1#4	0	350	350	O95831-1	133	483	+	350	O95831-1	0	322	O95831-4	0	322	+	11	O95831-1#4	0	189	O95831-4	133	322	+	189	0	161	4468
O95831-1#4	0	350	350	O95831-1	133	483	+	350	O95831-1	0	613	O95831-3	0	609	+	10	O95831-1#4	0	350	O95831-3	129	479	+	350	0	0	4469
O95831-1#4	0	350	350	O95831-1	133	483	+	350	O95831-1	0	613	O95831-2	0	326	+	9	O95831-1#4	189	350	O95831-2	35	196	+	161	189	0	4470
O95831-1#4	0	350	350	O95831-1	133	483	+	350	O95831-1	0	613	O95831-1	0	613	+	8	O95831-1#4	0	350	O95831-1	133	483	+	350	0	0	4471
O95831-1#5	0	42	42	O95831-1	512	554	+	42	O95831-1	352	613	O95831-5	0	261	+	12	O95831-1#5	0	42	O95831-5	160	202	+	42	0	0	4472
O95831-1#5	0	42	42	O95831-1	512	554	+	42	O95831-1	0	613	O95831-3	0	609	+	10	O95831-1#5	0	42	O95831-3	508	550	+	42	0	0	4473
O95831-1#5	0	42	42	O95831-1	512	554	+	42	O95831-1	0	613	O95831-2	0	326	+	9	O95831-1#5	0	42	O95831-2	225	267	+	42	0	0	4474
O95831-1#5	0	42	42	O95831-1	512	554	+	42	O95831-1	0	613	O95831-1	0	613	+	8	O95831-1#5	0	42	O95831-1	512	554	+	42	0	0	4475
O95831-1#6	0	31	31	O95831-1	0	31	+	31	O95831-1	0	36	O95831-6	0	36	+	13	O95831-1#6	0	31	O95831-6	0	31	+	31	0	0	4476
O95831-1#6	0	31	31	O95831-1	0	31	+	31	O95831-1	0	322	O95831-4	0	322	+	11	O95831-1#6	0	31	O95831-4	0	31	+	31	0	0	4477
O95831-1#6	0	31	31	O95831-1	0	31	+	31	O95831-1	0	613	O95831-3	0	609	+	10	O95831-1#6	0	31	O95831-3	0	31	+	31	0	0	4478
O95831-1#6	0	31	31	O95831-1	0	31	+	31	O95831-1	0	613	O95831-2	0	326	+	9	O95831-1#6	0	31	O95831-2	0	31	+	31	0	0	4479
O95831-1#6	0	31	31	O95831-1	0	31	+	31	O95831-1	0	613	O95831-1	0	613	+	8	O95831-1#6	0	31	O95831-1	0	31	+	31	0	0	4480
O95831-1#7	0	27	27	O95831-1	62	89	+	27	O95831-1	0	322	O95831-4	0	322	+	11	O95831-1#7	0	27	O95831-4	62	89	+	27	0	0	4481
O95831-1#7	0	27	27	O95831-1	62	89	+	27	O95831-1	0	613	O95831-3	0	609	+	10	O95831-1#7	20	27	O95831-3	78	85	+	7	20	0	4482
O95831-1#7	0	27	27	O95831-1	62	89	+	27	O95831-1	0	613	O95831-1	0	613	+	8	O95831-1#7	0	27	O95831-1	62	89	+	27	0	0	4483
O95831-1#8	0	6	6	O95831-1	445	451	+	6	O95831-1	352	613	O95831-5	0	261	+	12	O95831-1#8	0	6	O95831-5	93	99	+	6	0	0	4484
O95831-1#8	0	6	6	O95831-1	445	451	+	6	O95831-1	0	613	O95831-3	0	609	+	10	O95831-1#8	0	6	O95831-3	441	447	+	6	0	0	4485
O95831-1#8	0	6	6	O95831-1	445	451	+	6	O95831-1	0	613	O95831-2	0	326	+	9	O95831-1#8	0	6	O95831-2	158	164	+	6	0	0	4486
O95831-1#8	0	6	6	O95831-1	445	451	+	6	O95831-1	0	613	O95831-1	0	613	+	8	O95831-1#8	0	6	O95831-1	445	451	+	6	0	0	4487
O95831-1#9	0	33	33	O95831-1	513	546	+	33	O95831-1	352	613	O95831-5	0	261	+	12	O95831-1#9	0	33	O95831-5	161	194	+	33	0	0	4488
O95831-1#9	0	33	33	O95831-1	513	546	+	33	O95831-1	0	613	O95831-3	0	609	+	10	O95831-1#9	0	33	O95831-3	509	542	+	33	0	0	4489
O95831-1#9	0	33	33	O95831-1	513	546	+	33	O95831-1	0	613	O95831-2	0	326	+	9	O95831-1#9	0	33	O95831-2	226	259	+	33	0	0	4490
O95831-1#9	0	33	33	O95831-1	513	546	+	33	O95831-1	0	613	O95831-1	0	613	+	8	O95831-1#9	0	33	O95831-1	513	546	+	33	0	0	4491
O95831-1#10	0	5	5	O95831-1	137	142	+	5	O95831-1	0	322	O95831-4	0	322	+	11	O95831-1#10	0	5	O95831-4	137	142	+	5	0	0	4492
O95831-1#10	0	5	5	O95831-1	137	142	+	5	O95831-1	0	613	O95831-3	0	609	+	10	O95831-1#10	0	5	O95831-3	133	138	+	5	0	0	4493
O95831-1#10	0	5	5	O95831-1	137	142	+	5	O95831-1	0	613	O95831-1	0	613	+	8	O95831-1#10	0	5	O95831-1	137	142	+	5	0	0	4494
O95831-1#11	0	2	2	O95831-1	163	165	+	2	O95831-1	0	322	O95831-4	0	322	+	11	O95831-1#11	0	2	O95831-4	163	165	+	2	0	0	4495
O95831-1#11	0	2	2	O95831-1	163	165	+	2	O95831-1	0	613	O95831-3	0	609	+	10	O95831-1#11	0	2	O95831-3	159	161	+	2	0	0	4496
O95831-1#11	0	2	2	O95831-1	163	165	+	2	O95831-1	0	613	O95831-1	0	613	+	8	O95831-1#11	0	2	O95831-1	163	165	+	2	0	0	4497
O95831-1#12	0	1	1	O95831-1	171	172	+	1	O95831-1	0	322	O95831-4	0	322	+	11	O95831-1#12	0	1	O95831-4	171	172	+	1	0	0	4498
O95831-1#12	0	1	1	O95831-1	171	172	+	1	O95831-1	0	613	O95831-3	0	609	+	10	O95831-1#12	0	1	O95831-3	167	168	+	1	0	0	4499
O95831-1#12	0	1	1	O95831-1	171	172	+	1	O95831-1	0	613	O95831-1	0	613	+	8	O95831-1#12	0	1	O95831-1	171	172	+	1	0	0	4500
O95831-1#13	0	1	1	O95831-1	176	177	+	1	O95831-1	0	322	O95831-4	0	322	+	11	O95831-1#13	0	1	O95831-4	176	177	+	1	0	0	4501
O95831-1#13	0	1	1	O95831-1	176	177	+	1	O95831-1	0	613	O95831-3	0	609	+	10	O95831-1#13	0	1	O95831-3	172	173	+	1	0	0	4502
O95831-1#13	0	1	1	O95831-1	176	177	+	1	O95831-1	0	613	O95831-1	0	613	+	8	O95831-1#13	0	1	O95831-1	176	177	+	1	0	0	4503
O95831-1#14	0	1	1	O95831-1	195	196	+	1	O95831-1	0	322	O95831-4	0	322	+	11	O95831-1#14	0	1	O95831-4	195	196	+	1	0	0	4504
O95831-1#14	0	1	1	O95831-1	195	196	+	1	O95831-1	0	613	O95831-3	0	609	+	10	O95831-1#14	0	1	O95831-3	191	192	+	1	0	0	4505
O95831-1#14	0	1	1	O95831-1	195	196	+	1	O95831-1	0	613	O95831-1	0	613	+	8	O95831-1#14	0	1	O95831-1	195	196	+	1	0	0	4506
O95831-1#15	0	1	1	O95831-1	232	233	+	1	O95831-1	0	322	O95831-4	0	322	+	11	O95831-1#15	0	1	O95831-4	232	233	+	1	0	0	4507
O95831-1#15	0	1	1	O95831-1	232	233	+	1	O95831-1	0	613	O95831-3	0	609	+	10	O95831-1#15	0	1	O95831-3	228	229	+	1	0	0	4508
O95831-1#15	0	1	1	O95831-1	232	233	+	1	O95831-1	0	613	O95831-1	0	613	+	8	O95831-1#15	0	1	O95831-1	232	233	+	1	0	0	4509
O95831-1#16	0	1	1	O95831-1	284	285	+	1	O95831-1	0	322	O95831-4	0	322	+	11	O95831-1#16	0	1	O95831-4	284	285	+	1	0	0	4510
O95831-1#16	0	1	1	O95831-1	284	285	+	1	O95831-1	0	613	O95831-3	0	609	+	10	O95831-1#16	0	1	O95831-3	280	281	+	1	0	0	4511
O95831-1#16	0	1	1	O95831-1	284	285	+	1	O95831-1	0	613	O95831-1	0	613	+	8	O95831-1#16	0	1	O95831-1	284	285	+	1	0	0	4512
O95831-1#17	0	4	4	O95831-1	307	311	+	4	O95831-1	0	322	O95831-4	0	322	+	11	O95831-1#17	0	4	O95831-4	307	311	+	4	0	0	4513
O95831-1#17	0	4	4	O95831-1	307	311	+	4	O95831-1	0	613	O95831-3	0	609	+	10	O95831-1#17	0	4	O95831-3	303	307	+	4	0	0	4514
O95831-1#17	0	4	4	O95831-1	307	311	+	4	O95831-1	0	613	O95831-1	0	613	+	8	O95831-1#17	0	4	O95831-1	307	311	+	4	0	0	4515
O95831-1#18	0	1	1	O95831-1	335	336	+	1	O95831-1	0	613	O95831-3	0	609	+	10	O95831-1#18	0	1	O95831-3	331	332	+	1	0	0	4516
O95831-1#18	0	1	1	O95831-1	335	336	+	1	O95831-1	0	613	O95831-2	0	326	+	9	O95831-1#18	0	1	O95831-2	48	49	+	1	0	0	4517
O95831-1#18	0	1	1	O95831-1	335	336	+	1	O95831-1	0	613	O95831-1	0	613	+	8	O95831-1#18	0	1	O95831-1	335	336	+	1	0	0	4518
O95831-1#19	0	1	1	O95831-1	341	342	+	1	O95831-1	0	613	O95831-3	0	609	+	10	O95831-1#19	0	1	O95831-3	337	338	+	1	0	0	4519
O95831-1#19	0	1	1	O95831-1	341	342	+	1	O95831-1	0	613	O95831-2	0	326	+	9	O95831-1#19	0	1	O95831-2	54	55	+	1	0	0	4520
O95831-1#19	0	1	1	O95831-1	341	342	+	1	O95831-1	0	613	O95831-1	0	613	+	8	O95831-1#19	0	1	O95831-1	341	342	+	1	0	0	4521
O95831-1#20	0	1	1	O95831-1	398	399	+	1	O95831-1	352	613	O95831-5	0	261	+	12	O95831-1#20	0	1	O95831-5	46	47	+	1	0	0	4522
O95831-1#20	0	1	1	O95831-1	398	399	+	1	O95831-1	0	613	O95831-3	0	609	+	10	O95831-1#20	0	1	O95831-3	394	395	+	1	0	0	4523
O95831-1#20	0	1	1	O95831-1	398	399	+	1	O95831-1	0	613	O95831-2	0	326	+	9	O95831-1#20	0	1	O95831-2	111	112	+	1	0	0	4524
O95831-1#20	0	1	1	O95831-1	398	399	+	1	O95831-1	0	613	O95831-1	0	613	+	8	O95831-1#20	0	1	O95831-1	398	399	+	1	0	0	4525
O95831-1#21	0	1	1	O95831-1	437	438	+	1	O95831-1	352	613	O95831-5	0	261	+	12	O95831-1#21	0	1	O95831-5	85	86	+	1	0	0	4526
O95831-1#21	0	1	1	O95831-1	437	438	+	1	O95831-1	0	613	O95831-3	0	609	+	10	O95831-1#21	0	1	O95831-3	433	434	+	1	0	0	4527
O95831-1#21	0	1	1	O95831-1	437	438	+	1	O95831-1	0	613	O95831-2	0	326	+	9	O95831-1#21	0	1	O95831-2	150	151	+	1	0	0	4528
O95831-1#21	0	1	1	O95831-1	437	438	+	1	O95831-1	0	613	O95831-1	0	613	+	8	O95831-1#21	0	1	O95831-1	437	438	+	1	0	0	4529
O95831-1#22	0	2	2	O95831-1	452	454	+	2	O95831-1	352	613	O95831-5	0	261	+	12	O95831-1#22	0	2	O95831-5	100	102	+	2	0	0	4530
O95831-1#22	0	2	2	O95831-1	452	454	+	2	O95831-1	0	613	O95831-3	0	609	+	10	O95831-1#22	0	2	O95831-3	448	450	+	2	0	0	4531
O95831-1#22	0	2	2	O95831-1	452	454	+	2	O95831-1	0	613	O95831-2	0	326	+	9	O95831-1#22	0	2	O95831-2	165	167	+	2	0	0	4532
O95831-1#22	0	2	2	O95831-1	452	454	+	2	O95831-1	0	613	O95831-1	0	613	+	8	O95831-1#22	0	2	O95831-1	452	454	+	2	0	0	4533
O95831-1#23	0	2	2	O95831-1	453	455	+	2	O95831-1	352	613	O95831-5	0	261	+	12	O95831-1#23	0	2	O95831-5	101	103	+	2	0	0	4534
O95831-1#23	0	2	2	O95831-1	453	455	+	2	O95831-1	0	613	O95831-3	0	609	+	10	O95831-1#23	0	2	O95831-3	449	451	+	2	0	0	4535
O95831-1#23	0	2	2	O95831-1	453	455	+	2	O95831-1	0	613	O95831-2	0	326	+	9	O95831-1#23	0	2	O95831-2	166	168	+	2	0	0	4536
O95831-1#23	0	2	2	O95831-1	453	455	+	2	O95831-1	0	613	O95831-1	0	613	+	8	O95831-1#23	0	2	O95831-1	453	455	+	2	0	0	4537
O95831-1#24	0	1	1	O95831-1	482	483	+	1	O95831-1	352	613	O95831-5	0	261	+	12	O95831-1#24	0	1	O95831-5	130	131	+	1	0	0	4538
O95831-1#24	0	1	1	O95831-1	482	483	+	1	O95831-1	0	613	O95831-3	0	609	+	10	O95831-1#24	0	1	O95831-3	478	479	+	1	0	0	4539
O95831-1#24	0	1	1	O95831-1	482	483	+	1	O95831-1	0	613	O95831-2	0	326	+	9	O95831-1#24	0	1	O95831-2	195	196	+	1	0	0	4540
O95831-1#24	0	1	1	O95831-1	482	483	+	1	O95831-1	0	613	O95831-1	0	613	+	8	O95831-1#24	0	1	O95831-1	482	483	+	1	0	0	4541
O95831-1#25	0	1	1	O95831-1	482	483	+	1	O95831-1	352	613	O95831-5	0	261	+	12	O95831-1#25	0	1	O95831-5	130	131	+	1	0	0	4542
O95831-1#25	0	1	1	O95831-1	482	483	+	1	O95831-1	0	613	O95831-3	0	609	+	10	O95831-1#25	0	1	O95831-3	478	479	+	1	0	0	4543
O95831-1#25	0	1	1	O95831-1	482	483	+	1	O95831-1	0	613	O95831-2	0	326	+	9	O95831-1#25	0	1	O95831-2	195	196	+	1	0	0	4544
O95831-1#25	0	1	1	O95831-1	482	483	+	1	O95831-1	0	613	O95831-1	0	613	+	8	O95831-1#25	0	1	O95831-1	482	483	+	1	0	0	4545
O95831-1#26	0	1	1	O95831-1	492	493	+	1	O95831-1	352	613	O95831-5	0	261	+	12	O95831-1#26	0	1	O95831-5	140	141	+	1	0	0	4546
O95831-1#26	0	1	1	O95831-1	492	493	+	1	O95831-1	0	613	O95831-3	0	609	+	10	O95831-1#26	0	1	O95831-3	488	489	+	1	0	0	4547
O95831-1#26	0	1	1	O95831-1	492	493	+	1	O95831-1	0	613	O95831-2	0	326	+	9	O95831-1#26	0	1	O95831-2	205	206	+	1	0	0	4548
O95831-1#26	0	1	1	O95831-1	492	493	+	1	O95831-1	0	613	O95831-1	0	613	+	8	O95831-1#26	0	1	O95831-1	492	493	+	1	0	0	4549
O95831-1#27	0	1	1	O95831-1	582	583	+	1	O95831-1	352	613	O95831-5	0	261	+	12	O95831-1#27	0	1	O95831-5	230	231	+	1	0	0	4550
O95831-1#27	0	1	1	O95831-1	582	583	+	1	O95831-1	0	613	O95831-3	0	609	+	10	O95831-1#27	0	1	O95831-3	578	579	+	1	0	0	4551
O95831-1#27	0	1	1	O95831-1	582	583	+	1	O95831-1	0	613	O95831-2	0	326	+	9	O95831-1#27	0	1	O95831-2	295	296	+	1	0	0	4552
O95831-1#27	0	1	1	O95831-1	582	583	+	1	O95831-1	0	613	O95831-1	0	613	+	8	O95831-1#27	0	1	O95831-1	582	583	+	1	0	0	4553
O95831-1#28	0	1	1	O95831-1	104	105	+	1	O95831-1	0	322	O95831-4	0	322	+	11	O95831-1#28	0	1	O95831-4	104	105	+	1	0	0	4554
O95831-1#28	0	1	1	O95831-1	104	105	+	1	O95831-1	0	613	O95831-3	0	609	+	10	O95831-1#28	0	1	O95831-3	100	101	+	1	0	0	4555
O95831-1#28	0	1	1	O95831-1	104	105	+	1	O95831-1	0	613	O95831-1	0	613	+	8	O95831-1#28	0	1	O95831-1	104	105	+	1	0	0	4556
O95831-1#29	0	1	1	O95831-1	108	109	+	1	O95831-1	0	322	O95831-4	0	322	+	11	O95831-1#29	0	1	O95831-4	108	109	+	1	0	0	4557
O95831-1#29	0	1	1	O95831-1	108	109	+	1	O95831-1	0	613	O95831-3	0	609	+	10	O95831-1#29	0	1	O95831-3	104	105	+	1	0	0	4558
O95831-1#29	0	1	1	O95831-1	108	109	+	1	O95831-1	0	613	O95831-1	0	613	+	8	O95831-1#29	0	1	O95831-1	108	109	+	1	0	0	4559
O95831-1#30	0	1	1	O95831-1	115	116	+	1	O95831-1	0	322	O95831-4	0	322	+	11	O95831-1#30	0	1	O95831-4	115	116	+	1	0	0	4560
O95831-1#30	0	1	1	O95831-1	115	116	+	1	O95831-1	0	613	O95831-3	0	609	+	10	O95831-1#30	0	1	O95831-3	111	112	+	1	0	0	4561
O95831-1#30	0	1	1	O95831-1	115	116	+	1	O95831-1	0	613	O95831-1	0	613	+	8	O95831-1#30	0	1	O95831-1	115	116	+	1	0	0	4562
O95831-1#31	0	1	1	O95831-1	117	118	+	1	O95831-1	0	322	O95831-4	0	322	+	11	O95831-1#31	0	1	O95831-4	117	118	+	1	0	0	4563
O95831-1#31	0	1	1	O95831-1	117	118	+	1	O95831-1	0	613	O95831-3	0	609	+	10	O95831-1#31	0	1	O95831-3	113	114	+	1	0	0	4564
O95831-1#31	0	1	1	O95831-1	117	118	+	1	O95831-1	0	613	O95831-1	0	613	+	8	O95831-1#31	0	1	O95831-1	117	118	+	1	0	0	4565
O95831-1#32	0	1	1	O95831-1	267	268	+	1	O95831-1	0	322	O95831-4	0	322	+	11	O95831-1#32	0	1	O95831-4	267	268	+	1	0	0	4566
O95831-1#32	0	1	1	O95831-1	267	268	+	1	O95831-1	0	613	O95831-3	0	609	+	10	O95831-1#32	0	1	O95831-3	263	264	+	1	0	0	4567
O95831-1#32	0	1	1	O95831-1	267	268	+	1	O95831-1	0	613	O95831-1	0	613	+	8	O95831-1#32	0	1	O95831-1	267	268	+	1	0	0	4568
O95831-1#33	0	1	1	O95831-1	291	292	+	1	O95831-1	0	322	O95831-4	0	322	+	11	O95831-1#33	0	1	O95831-4	291	292	+	1	0	0	4569
O95831-1#33	0	1	1	O95831-1	291	292	+	1	O95831-1	0	613	O95831-3	0	609	+	10	O95831-1#33	0	1	O95831-3	287	288	+	1	0	0	4570
O95831-1#33	0	1	1	O95831-1	291	292	+	1	O95831-1	0	613	O95831-1	0	613	+	8	O95831-1#33	0	1	O95831-1	291	292	+	1	0	0	4571
O95831-1#34	0	1	1	O95831-1	370	371	+	1	O95831-1	352	613	O95831-5	0	261	+	12	O95831-1#34	0	1	O95831-5	18	19	+	1	0	0	4572
O95831-1#34	0	1	1	O95831-1	370	371	+	1	O95831-1	0	613	O95831-3	0	609	+	10	O95831-1#34	0	1	O95831-3	366	367	+	1	0	0	4573
O95831-1#34	0	1	1	O95831-1	370	371	+	1	O95831-1	0	613	O95831-2	0	326	+	9	O95831-1#34	0	1	O95831-2	83	84	+	1	0	0	4574
O95831-1#34	0	1	1	O95831-1	370	371	+	1	O95831-1	0	613	O95831-1	0	613	+	8	O95831-1#34	0	1	O95831-1	370	371	+	1	0	0	4575
O95831-1#35	0	1	1	O95831-1	387	388	+	1	O95831-1	352	613	O95831-5	0	261	+	12	O95831-1#35	0	1	O95831-5	35	36	+	1	0	0	4576
O95831-1#35	0	1	1	O95831-1	387	388	+	1	O95831-1	0	613	O95831-3	0	609	+	10	O95831-1#35	0	1	O95831-3	383	384	+	1	0	0	4577
O95831-1#35	0	1	1	O95831-1	387	388	+	1	O95831-1	0	613	O95831-2	0	326	+	9	O95831-1#35	0	1	O95831-2	100	101	+	1	0	0	4578
O95831-1#35	0	1	1	O95831-1	387	388	+	1	O95831-1	0	613	O95831-1	0	613	+	8	O95831-1#35	0	1	O95831-1	387	388	+	1	0	0	4579
O95831-1#36	0	1	1	O95831-1	520	521	+	1	O95831-1	352	613	O95831-5	0	261	+	12	O95831-1#36	0	1	O95831-5	168	169	+	1	0	0	4580
O95831-1#36	0	1	1	O95831-1	520	521	+	1	O95831-1	0	613	O95831-3	0	609	+	10	O95831-1#36	0	1	O95831-3	516	517	+	1	0	0	4581
O95831-1#36	0	1	1	O95831-1	520	521	+	1	O95831-1	0	613	O95831-2	0	326	+	9	O95831-1#36	0	1	O95831-2	233	234	+	1	0	0	4582
O95831-1#36	0	1	1	O95831-1	520	521	+	1	O95831-1	0	613	O95831-1	0	613	+	8	O95831-1#36	0	1	O95831-1	520	521	+	1	0	0	4583
O95831-1#37	0	1	1	O95831-1	523	524	+	1	O95831-1	352	613	O95831-5	0	261	+	12	O95831-1#37	0	1	O95831-5	171	172	+	1	0	0	4584
O95831-1#37	0	1	1	O95831-1	523	524	+	1	O95831-1	0	613	O95831-3	0	609	+	10	O95831-1#37	0	1	O95831-3	519	520	+	1	0	0	4585
O95831-1#37	0	1	1	O95831-1	523	524	+	1	O95831-1	0	613	O95831-2	0	326	+	9	O95831-1#37	0	1	O95831-2	236	237	+	1	0	0	4586
O95831-1#37	0	1	1	O95831-1	523	524	+	1	O95831-1	0	613	O95831-1	0	613	+	8	O95831-1#37	0	1	O95831-1	523	524	+	1	0	0	4587
O95831-1#38	0	1	1	O95831-1	529	530	+	1	O95831-1	352	613	O95831-5	0	261	+	12	O95831-1#38	0	1	O95831-5	177	178	+	1	0	0	4588
O95831-1#38	0	1	1	O95831-1	529	530	+	1	O95831-1	0	613	O95831-3	0	609	+	10	O95831-1#38	0	1	O95831-3	525	526	+	1	0	0	4589
O95831-1#38	0	1	1	O95831-1	529	530	+	1	O95831-1	0	613	O95831-2	0	326	+	9	O95831-1#38	0	1	O95831-2	242	243	+	1	0	0	4590
O95831-1#38	0	1	1	O95831-1	529	530	+	1	O95831-1	0	613	O95831-1	0	613	+	8	O95831-1#38	0	1	O95831-1	529	530	+	1	0	0	4591
O95831-1#39	0	1	1	O95831-1	592	593	+	1	O95831-1	352	613	O95831-5	0	261	+	12	O95831-1#39	0	1	O95831-5	240	241	+	1	0	0	4592
O95831-1#39	0	1	1	O95831-1	592	593	+	1	O95831-1	0	613	O95831-3	0	609	+	10	O95831-1#39	0	1	O95831-3	588	589	+	1	0	0	4593
O95831-1#39	0	1	1	O95831-1	592	593	+	1	O95831-1	0	613	O95831-2	0	326	+	9	O95831-1#39	0	1	O95831-2	305	306	+	1	0	0	4594
O95831-1#39	0	1	1	O95831-1	592	593	+	1	O95831-1	0	613	O95831-1	0	613	+	8	O95831-1#39	0	1	O95831-1	592	593	+	1	0	0	4595
O95831-1#40	0	1	1	O95831-1	254	255	+	1	O95831-1	0	322	O95831-4	0	322	+	11	O95831-1#40	0	1	O95831-4	254	255	+	1	0	0	4596
O95831-1#40	0	1	1	O95831-1	254	255	+	1	O95831-1	0	613	O95831-3	0	609	+	10	O95831-1#40	0	1	O95831-3	250	251	+	1	0	0	4597
O95831-1#40	0	1	1	O95831-1	254	255	+	1	O95831-1	0	613	O95831-1	0	613	+	8	O95831-1#40	0	1	O95831-1	254	255	+	1	0	0	4598
O95831-1#41	0	352	352	O95831-1	0	352	+	352	O95831-1	0	36	O95831-6	0	36	+	13	O95831-1#41	0	36	O95831-6	0	36	+	36	0	316	4599
O95831-1#41	0	352	352	O95831-1	0	352	+	352	O95831-1	0	322	O95831-4	0	322	+	11	O95831-1#41	0	322	O95831-4	0	322	+	322	0	30	4600
O95831-1#41	0	352	352	O95831-1	0	352	+	352	O95831-1	0	613	O95831-3	0	609	+	10	O95831-1#41	0	352	O95831-3	0	348	+	305	0	0	4601
O95831-1#41	0	352	352	O95831-1	0	352	+	352	O95831-1	0	613	O95831-2	0	326	+	9	O95831-1#41	0	352	O95831-2	0	65	+	65	0	0	4602
O95831-1#41	0	352	352	O95831-1	0	352	+	352	O95831-1	0	613	O95831-1	0	613	+	8	O95831-1#41	0	352	O95831-1	0	352	+	352	0	0	4603
O95831-1#42	0	287	287	O95831-1	35	322	+	287	O95831-1	0	36	O95831-6	0	36	+	13	O95831-1#42	0	1	O95831-6	35	36	+	1	0	286	4604
O95831-1#42	0	287	287	O95831-1	35	322	+	287	O95831-1	0	322	O95831-4	0	322	+	11	O95831-1#42	0	287	O95831-4	35	322	+	287	0	0	4605
O95831-1#42	0	287	287	O95831-1	35	322	+	287	O95831-1	0	613	O95831-3	0	609	+	10	O95831-1#42	47	287	O95831-3	78	318	+	240	47	0	4606
O95831-1#42	0	287	287	O95831-1	35	322	+	287	O95831-1	0	613	O95831-1	0	613	+	8	O95831-1#42	0	287	O95831-1	35	322	+	287	0	0	4607
O95831-1#43	0	47	47	O95831-1	35	82	+	47	O95831-1	0	36	O95831-6	0	36	+	13	O95831-1#43	0	1	O95831-6	35	36	+	1	0	46	4608
O95831-1#43	0	47	47	O95831-1	35	82	+	47	O95831-1	0	322	O95831-4	0	322	+	11	O95831-1#43	0	47	O95831-4	35	82	+	47	0	0	4609
O95831-1#43	0	47	47	O95831-1	35	82	+	47	O95831-1	0	613	O95831-1	0	613	+	8	O95831-1#43	0	47	O95831-1	35	82	+	47	0	0	4610
O95831-1#44	0	7	7	O95831-1	36	43	+	7	O95831-1	0	322	O95831-4	0	322	+	11	O95831-1#44	0	7	O95831-4	36	43	+	7	0	0	4611
O95831-1#44	0	7	7	O95831-1	36	43	+	7	O95831-1	0	613	O95831-1	0	613	+	8	O95831-1#44	0	7	O95831-1	36	43	+	7	0	0	4612
O95831-1#45	0	570	570	O95831-1	43	613	+	570	O95831-1	352	613	O95831-5	0	261	+	12	O95831-1#45	309	570	O95831-5	0	261	+	261	309	0	4613
O95831-1#45	0	570	570	O95831-1	43	613	+	570	O95831-1	0	322	O95831-4	0	322	+	11	O95831-1#45	0	279	O95831-4	43	322	+	279	0	291	4614
O95831-1#45	0	570	570	O95831-1	43	613	+	570	O95831-1	0	613	O95831-3	0	609	+	10	O95831-1#45	39	570	O95831-3	78	609	+	531	39	0	4615
O95831-1#45	0	570	570	O95831-1	43	613	+	570	O95831-1	0	613	O95831-2	0	326	+	9	O95831-1#45	279	570	O95831-2	35	326	+	291	279	0	4616
O95831-1#45	0	570	570	O95831-1	43	613	+	570	O95831-1	0	613	O95831-1	0	613	+	8	O95831-1#45	0	570	O95831-1	43	613	+	570	0	0	4617
O95831-1#46	0	2	2	O95831-1	322	324	+	2	O95831-1	0	613	O95831-3	0	609	+	10	O95831-1#46	0	2	O95831-3	318	320	+	2	0	0	4618
O95831-1#46	0	2	2	O95831-1	322	324	+	2	O95831-1	0	613	O95831-2	0	326	+	9	O95831-1#46	0	2	O95831-2	35	37	+	2	0	0	4619
O95831-1#46	0	2	2	O95831-1	322	324	+	2	O95831-1	0	613	O95831-1	0	613	+	8	O95831-1#46	0	2	O95831-1	322	324	+	2	0	0	4620
O95831-1#47	0	289	289	O95831-1	324	613	+	289	O95831-1	352	613	O95831-5	0	261	+	12	O95831-1#47	28	289	O95831-5	0	261	+	261	28	0	4621
O95831-1#47	0	289	289	O95831-1	324	613	+	289	O95831-1	0	613	O95831-3	0	609	+	10	O95831-1#47	0	289	O95831-3	320	609	+	289	0	0	4622
O95831-1#47	0	289	289	O95831-1	324	613	+	289	O95831-1	0	613	O95831-2	0	326	+	9	O95831-1#47	0	289	O95831-2	37	326	+	289	0	0	4623
O95831-1#47	0	289	289	O95831-1	324	613	+	289	O95831-1	0	613	O95831-1	0	613	+	8	O95831-1#47	0	289	O95831-1	324	613	+	289	0	0	4624
O95831-1#48	0	1	1	O95831-1	200	201	+	1	O95831-1	0	322	O95831-4	0	322	+	11	O95831-1#48	0	1	O95831-4	200	201	+	1	0	0	4625
O95831-1#48	0	1	1	O95831-1	200	201	+	1	O95831-1	0	613	O95831-3	0	609	+	10	O95831-1#48	0	1	O95831-3	196	197	+	1	0	0	4626
O95831-1#48	0	1	1	O95831-1	200	201	+	1	O95831-1	0	613	O95831-1	0	613	+	8	O95831-1#48	0	1	O95831-1	200	201	+	1	0	0	4627
O95831-1#49	0	1	1	O95831-1	234	235	+	1	O95831-1	0	322	O95831-4	0	322	+	11	O95831-1#49	0	1	O95831-4	234	235	+	1	0	0	4628
O95831-1#49	0	1	1	O95831-1	234	235	+	1	O95831-1	0	613	O95831-3	0	609	+	10	O95831-1#49	0	1	O95831-3	230	231	+	1	0	0	4629
O95831-1#49	0	1	1	O95831-1	234	235	+	1	O95831-1	0	613	O95831-1	0	613	+	8	O95831-1#49	0	1	O95831-1	234	235	+	1	0	0	4630
O95831-1#50	0	1	1	O95831-1	236	237	+	1	O95831-1	0	322	O95831-4	0	322	+	11	O95831-1#50	0	1	O95831-4	236	237	+	1	0	0	4631
O95831-1#50	0	1	1	O95831-1	236	237	+	1	O95831-1	0	613	O95831-3	0	609	+	10	O95831-1#50	0	1	O95831-3	232	233	+	1	0	0	4632
O95831-1#50	0	1	1	O95831-1	236	237	+	1	O95831-1	0	613	O95831-1	0	613	+	8	O95831-1#50	0	1	O95831-1	236	237	+	1	0	0	4633
O95831-1#51	0	1	1	O95831-1	236	237	+	1	O95831-1	0	322	O95831-4	0	322	+	11	O95831-1#51	0	1	O95831-4	236	237	+	1	0	0	4634
O95831-1#51	0	1	1	O95831-1	236	237	+	1	O95831-1	0	613	O95831-3	0	609	+	10	O95831-1#51	0	1	O95831-3	232	233	+	1	0	0	4635
O95831-1#51	0	1	1	O95831-1	236	237	+	1	O95831-1	0	613	O95831-1	0	613	+	8	O95831-1#51	0	1	O95831-1	236	237	+	1	0	0	4636
O95831-1#52	0	1	1	O95831-1	242	243	+	1	O95831-1	0	322	O95831-4	0	322	+	11	O95831-1#52	0	1	O95831-4	242	243	+	1	0	0	4637
O95831-1#52	0	1	1	O95831-1	242	243	+	1	O95831-1	0	613	O95831-3	0	609	+	10	O95831-1#52	0	1	O95831-3	238	239	+	1	0	0	4638
O95831-1#52	0	1	1	O95831-1	242	243	+	1	O95831-1	0	613	O95831-1	0	613	+	8	O95831-1#52	0	1	O95831-1	242	243	+	1	0	0	4639
O95831-1#53	0	1	1	O95831-1	259	260	+	1	O95831-1	0	322	O95831-4	0	322	+	11	O95831-1#53	0	1	O95831-4	259	260	+	1	0	0	4640
O95831-1#53	0	1	1	O95831-1	259	260	+	1	O95831-1	0	613	O95831-3	0	609	+	10	O95831-1#53	0	1	O95831-3	255	256	+	1	0	0	4641
O95831-1#53	0	1	1	O95831-1	259	260	+	1	O95831-1	0	613	O95831-1	0	613	+	8	O95831-1#53	0	1	O95831-1	259	260	+	1	0	0	4642
O95831-1#54	0	1	1	O95831-1	261	262	+	1	O95831-1	0	322	O95831-4	0	322	+	11	O95831-1#54	0	1	O95831-4	261	262	+	1	0	0	4643
O95831-1#54	0	1	1	O95831-1	261	262	+	1	O95831-1	0	613	O95831-3	0	609	+	10	O95831-1#54	0	1	O95831-3	257	258	+	1	0	0	4644
O95831-1#54	0	1	1	O95831-1	261	262	+	1	O95831-1	0	613	O95831-1	0	613	+	8	O95831-1#54	0	1	O95831-1	261	262	+	1	0	0	4645
O95831-1#55	0	1	1	O95831-1	307	308	+	1	O95831-1	0	322	O95831-4	0	322	+	11	O95831-1#55	0	1	O95831-4	307	308	+	1	0	0	4646
O95831-1#55	0	1	1	O95831-1	307	308	+	1	O95831-1	0	613	O95831-3	0	609	+	10	O95831-1#55	0	1	O95831-3	303	304	+	1	0	0	4647
O95831-1#55	0	1	1	O95831-1	307	308	+	1	O95831-1	0	613	O95831-1	0	613	+	8	O95831-1#55	0	1	O95831-1	307	308	+	1	0	0	4648
O95831-1#56	0	1	1	O95831-1	337	338	+	1	O95831-1	0	613	O95831-3	0	609	+	10	O95831-1#56	0	1	O95831-3	333	334	+	1	0	0	4649
O95831-1#56	0	1	1	O95831-1	337	338	+	1	O95831-1	0	613	O95831-2	0	326	+	9	O95831-1#56	0	1	O95831-2	50	51	+	1	0	0	4650
O95831-1#56	0	1	1	O95831-1	337	338	+	1	O95831-1	0	613	O95831-1	0	613	+	8	O95831-1#56	0	1	O95831-1	337	338	+	1	0	0	4651
O95831-1#57	0	1	1	O95831-1	343	344	+	1	O95831-1	0	613	O95831-3	0	609	+	10	O95831-1#57	0	1	O95831-3	339	340	+	1	0	0	4652
O95831-1#57	0	1	1	O95831-1	343	344	+	1	O95831-1	0	613	O95831-2	0	326	+	9	O95831-1#57	0	1	O95831-2	56	57	+	1	0	0	4653
O95831-1#57	0	1	1	O95831-1	343	344	+	1	O95831-1	0	613	O95831-1	0	613	+	8	O95831-1#57	0	1	O95831-1	343	344	+	1	0	0	4654
O95831-1#58	0	1	1	O95831-1	359	360	+	1	O95831-1	352	613	O95831-5	0	261	+	12	O95831-1#58	0	1	O95831-5	7	8	+	1	0	0	4655
O95831-1#58	0	1	1	O95831-1	359	360	+	1	O95831-1	0	613	O95831-3	0	609	+	10	O95831-1#58	0	1	O95831-3	355	356	+	1	0	0	4656
O95831-1#58	0	1	1	O95831-1	359	360	+	1	O95831-1	0	613	O95831-2	0	326	+	9	O95831-1#58	0	1	O95831-2	72	73	+	1	0	0	4657
O95831-1#58	0	1	1	O95831-1	359	360	+	1	O95831-1	0	613	O95831-1	0	613	+	8	O95831-1#58	0	1	O95831-1	359	360	+	1	0	0	4658
O95831-1#59	0	1	1	O95831-1	421	422	+	1	O95831-1	352	613	O95831-5	0	261	+	12	O95831-1#59	0	1	O95831-5	69	70	+	1	0	0	4659
O95831-1#59	0	1	1	O95831-1	421	422	+	1	O95831-1	0	613	O95831-3	0	609	+	10	O95831-1#59	0	1	O95831-3	417	418	+	1	0	0	4660
O95831-1#59	0	1	1	O95831-1	421	422	+	1	O95831-1	0	613	O95831-2	0	326	+	9	O95831-1#59	0	1	O95831-2	134	135	+	1	0	0	4661
O95831-1#59	0	1	1	O95831-1	421	422	+	1	O95831-1	0	613	O95831-1	0	613	+	8	O95831-1#59	0	1	O95831-1	421	422	+	1	0	0	4662
O95831-1#60	0	1	1	O95831-1	421	422	+	1	O95831-1	352	613	O95831-5	0	261	+	12	O95831-1#60	0	1	O95831-5	69	70	+	1	0	0	4663
O95831-1#60	0	1	1	O95831-1	421	422	+	1	O95831-1	0	613	O95831-3	0	609	+	10	O95831-1#60	0	1	O95831-3	417	418	+	1	0	0	4664
O95831-1#60	0	1	1	O95831-1	421	422	+	1	O95831-1	0	613	O95831-2	0	326	+	9	O95831-1#60	0	1	O95831-2	134	135	+	1	0	0	4665
O95831-1#60	0	1	1	O95831-1	421	422	+	1	O95831-1	0	613	O95831-1	0	613	+	8	O95831-1#60	0	1	O95831-1	421	422	+	1	0	0	4666
O95831-1#61	0	1	1	O95831-1	429	430	+	1	O95831-1	352	613	O95831-5	0	261	+	12	O95831-1#61	0	1	O95831-5	77	78	+	1	0	0	4667
O95831-1#61	0	1	1	O95831-1	429	430	+	1	O95831-1	0	613	O95831-3	0	609	+	10	O95831-1#61	0	1	O95831-3	425	426	+	1	0	0	4668
O95831-1#61	0	1	1	O95831-1	429	430	+	1	O95831-1	0	613	O95831-2	0	326	+	9	O95831-1#61	0	1	O95831-2	142	143	+	1	0	0	4669
O95831-1#61	0	1	1	O95831-1	429	430	+	1	O95831-1	0	613	O95831-1	0	613	+	8	O95831-1#61	0	1	O95831-1	429	430	+	1	0	0	4670
O95831-1#62	0	1	1	O95831-1	450	451	+	1	O95831-1	352	613	O95831-5	0	261	+	12	O95831-1#62	0	1	O95831-5	98	99	+	1	0	0	4671
O95831-1#62	0	1	1	O95831-1	450	451	+	1	O95831-1	0	613	O95831-3	0	609	+	10	O95831-1#62	0	1	O95831-3	446	447	+	1	0	0	4672
O95831-1#62	0	1	1	O95831-1	450	451	+	1	O95831-1	0	613	O95831-2	0	326	+	9	O95831-1#62	0	1	O95831-2	163	164	+	1	0	0	4673
O95831-1#62	0	1	1	O95831-1	450	451	+	1	O95831-1	0	613	O95831-1	0	613	+	8	O95831-1#62	0	1	O95831-1	450	451	+	1	0	0	4674
O95831-1#63	0	1	1	O95831-1	471	472	+	1	O95831-1	352	613	O95831-5	0	261	+	12	O95831-1#63	0	1	O95831-5	119	120	+	1	0	0	4675
O95831-1#63	0	1	1	O95831-1	471	472	+	1	O95831-1	0	613	O95831-3	0	609	+	10	O95831-1#63	0	1	O95831-3	467	468	+	1	0	0	4676
O95831-1#63	0	1	1	O95831-1	471	472	+	1	O95831-1	0	613	O95831-2	0	326	+	9	O95831-1#63	0	1	O95831-2	184	185	+	1	0	0	4677
O95831-1#63	0	1	1	O95831-1	471	472	+	1	O95831-1	0	613	O95831-1	0	613	+	8	O95831-1#63	0	1	O95831-1	471	472	+	1	0	0	4678
O95831-1#64	0	1	1	O95831-1	474	475	+	1	O95831-1	352	613	O95831-5	0	261	+	12	O95831-1#64	0	1	O95831-5	122	123	+	1	0	0	4679
O95831-1#64	0	1	1	O95831-1	474	475	+	1	O95831-1	0	613	O95831-3	0	609	+	10	O95831-1#64	0	1	O95831-3	470	471	+	1	0	0	4680
O95831-1#64	0	1	1	O95831-1	474	475	+	1	O95831-1	0	613	O95831-2	0	326	+	9	O95831-1#64	0	1	O95831-2	187	188	+	1	0	0	4681
O95831-1#64	0	1	1	O95831-1	474	475	+	1	O95831-1	0	613	O95831-1	0	613	+	8	O95831-1#64	0	1	O95831-1	474	475	+	1	0	0	4682
O95831-1#65	0	1	1	O95831-1	492	493	+	1	O95831-1	352	613	O95831-5	0	261	+	12	O95831-1#65	0	1	O95831-5	140	141	+	1	0	0	4683
O95831-1#65	0	1	1	O95831-1	492	493	+	1	O95831-1	0	613	O95831-3	0	609	+	10	O95831-1#65	0	1	O95831-3	488	489	+	1	0	0	4684
O95831-1#65	0	1	1	O95831-1	492	493	+	1	O95831-1	0	613	O95831-2	0	326	+	9	O95831-1#65	0	1	O95831-2	205	206	+	1	0	0	4685
O95831-1#65	0	1	1	O95831-1	492	493	+	1	O95831-1	0	613	O95831-1	0	613	+	8	O95831-1#65	0	1	O95831-1	492	493	+	1	0	0	4686
O95831-1#66	0	1	1	O95831-1	497	498	+	1	O95831-1	352	613	O95831-5	0	261	+	12	O95831-1#66	0	1	O95831-5	145	146	+	1	0	0	4687
O95831-1#66	0	1	1	O95831-1	497	498	+	1	O95831-1	0	613	O95831-3	0	609	+	10	O95831-1#66	0	1	O95831-3	493	494	+	1	0	0	4688
O95831-1#66	0	1	1	O95831-1	497	498	+	1	O95831-1	0	613	O95831-2	0	326	+	9	O95831-1#66	0	1	O95831-2	210	211	+	1	0	0	4689
O95831-1#66	0	1	1	O95831-1	497	498	+	1	O95831-1	0	613	O95831-1	0	613	+	8	O95831-1#66	0	1	O95831-1	497	498	+	1	0	0	4690
O95831-1#67	0	1	1	O95831-1	590	591	+	1	O95831-1	352	613	O95831-5	0	261	+	12	O95831-1#67	0	1	O95831-5	238	239	+	1	0	0	4691
O95831-1#67	0	1	1	O95831-1	590	591	+	1	O95831-1	0	613	O95831-3	0	609	+	10	O95831-1#67	0	1	O95831-3	586	587	+	1	0	0	4692
O95831-1#67	0	1	1	O95831-1	590	591	+	1	O95831-1	0	613	O95831-2	0	326	+	9	O95831-1#67	0	1	O95831-2	303	304	+	1	0	0	4693
O95831-1#67	0	1	1	O95831-1	590	591	+	1	O95831-1	0	613	O95831-1	0	613	+	8	O95831-1#67	0	1	O95831-1	590	591	+	1	0	0	4694
O95831-1#68	0	1	1	O95831-1	195	196	+	1	O95831-1	0	322	O95831-4	0	322	+	11	O95831-1#68	0	1	O95831-4	195	196	+	1	0	0	4695
O95831-1#68	0	1	1	O95831-1	195	196	+	1	O95831-1	0	613	O95831-3	0	609	+	10	O95831-1#68	0	1	O95831-3	191	192	+	1	0	0	4696
O95831-1#68	0	1	1	O95831-1	195	196	+	1	O95831-1	0	613	O95831-1	0	613	+	8	O95831-1#68	0	1	O95831-1	195	196	+	1	0	0	4697
O95831-1#69	0	18	18	O95831-1	412	430	+	18	O95831-1	352	613	O95831-5	0	261	+	12	O95831-1#69	0	18	O95831-5	60	78	+	18	0	0	4698
O95831-1#69	0	18	18	O95831-1	412	430	+	18	O95831-1	0	613	O95831-3	0	609	+	10	O95831-1#69	0	18	O95831-3	408	426	+	18	0	0	4699
O95831-1#69	0	18	18	O95831-1	412	430	+	18	O95831-1	0	613	O95831-2	0	326	+	9	O95831-1#69	0	18	O95831-2	125	143	+	18	0	0	4700
O95831-1#69	0	18	18	O95831-1	412	430	+	18	O95831-1	0	613	O95831-1	0	613	+	8	O95831-1#69	0	18	O95831-1	412	430	+	18	0	0	4701
O95831-1#70	0	3	3	O95831-1	442	445	+	3	O95831-1	352	613	O95831-5	0	261	+	12	O95831-1#70	0	3	O95831-5	90	93	+	3	0	0	4702
O95831-1#70	0	3	3	O95831-1	442	445	+	3	O95831-1	0	613	O95831-3	0	609	+	10	O95831-1#70	0	3	O95831-3	438	441	+	3	0	0	4703
O95831-1#70	0	3	3	O95831-1	442	445	+	3	O95831-1	0	613	O95831-2	0	326	+	9	O95831-1#70	0	3	O95831-2	155	158	+	3	0	0	4704
O95831-1#70	0	3	3	O95831-1	442	445	+	3	O95831-1	0	613	O95831-1	0	613	+	8	O95831-1#70	0	3	O95831-1	442	445	+	3	0	0	4705
O95831-1#71	0	1	1	O95831-1	453	454	+	1	O95831-1	352	613	O95831-5	0	261	+	12	O95831-1#71	0	1	O95831-5	101	102	+	1	0	0	4706
O95831-1#71	0	1	1	O95831-1	453	454	+	1	O95831-1	0	613	O95831-3	0	609	+	10	O95831-1#71	0	1	O95831-3	449	450	+	1	0	0	4707
O95831-1#71	0	1	1	O95831-1	453	454	+	1	O95831-1	0	613	O95831-2	0	326	+	9	O95831-1#71	0	1	O95831-2	166	167	+	1	0	0	4708
O95831-1#71	0	1	1	O95831-1	453	454	+	1	O95831-1	0	613	O95831-1	0	613	+	8	O95831-1#71	0	1	O95831-1	453	454	+	1	0	0	4709
O95831-1#72	0	1	1	O95831-1	476	477	+	1	O95831-1	352	613	O95831-5	0	261	+	12	O95831-1#72	0	1	O95831-5	124	125	+	1	0	0	4710
O95831-1#72	0	1	1	O95831-1	476	477	+	1	O95831-1	0	613	O95831-3	0	609	+	10	O95831-1#72	0	1	O95831-3	472	473	+	1	0	0	4711
O95831-1#72	0	1	1	O95831-1	476	477	+	1	O95831-1	0	613	O95831-2	0	326	+	9	O95831-1#72	0	1	O95831-2	189	190	+	1	0	0	4712
O95831-1#72	0	1	1	O95831-1	476	477	+	1	O95831-1	0	613	O95831-1	0	613	+	8	O95831-1#72	0	1	O95831-1	476	477	+	1	0	0	4713
O95831-1#73	0	1	1	O95831-1	479	480	+	1	O95831-1	352	613	O95831-5	0	261	+	12	O95831-1#73	0	1	O95831-5	127	128	+	1	0	0	4714
O95831-1#73	0	1	1	O95831-1	479	480	+	1	O95831-1	0	613	O95831-3	0	609	+	10	O95831-1#73	0	1	O95831-3	475	476	+	1	0	0	4715
O95831-1#73	0	1	1	O95831-1	479	480	+	1	O95831-1	0	613	O95831-2	0	326	+	9	O95831-1#73	0	1	O95831-2	192	193	+	1	0	0	4716
O95831-1#73	0	1	1	O95831-1	479	480	+	1	O95831-1	0	613	O95831-1	0	613	+	8	O95831-1#73	0	1	O95831-1	479	480	+	1	0	0	4717
O95831-1#74	0	1	1	O95831-1	484	485	+	1	O95831-1	352	613	O95831-5	0	261	+	12	O95831-1#74	0	1	O95831-5	132	133	+	1	0	0	4718
O95831-1#74	0	1	1	O95831-1	484	485	+	1	O95831-1	0	613	O95831-3	0	609	+	10	O95831-1#74	0	1	O95831-3	480	481	+	1	0	0	4719
O95831-1#74	0	1	1	O95831-1	484	485	+	1	O95831-1	0	613	O95831-2	0	326	+	9	O95831-1#74	0	1	O95831-2	197	198	+	1	0	0	4720
O95831-1#74	0	1	1	O95831-1	484	485	+	1	O95831-1	0	613	O95831-1	0	613	+	8	O95831-1#74	0	1	O95831-1	484	485	+	1	0	0	4721
O95831-1#75	0	1	1	O95831-1	528	529	+	1	O95831-1	352	613	O95831-5	0	261	+	12	O95831-1#75	0	1	O95831-5	176	177	+	1	0	0	4722
O95831-1#75	0	1	1	O95831-1	528	529	+	1	O95831-1	0	613	O95831-3	0	609	+	10	O95831-1#75	0	1	O95831-3	524	525	+	1	0	0	4723
O95831-1#75	0	1	1	O95831-1	528	529	+	1	O95831-1	0	613	O95831-2	0	326	+	9	O95831-1#75	0	1	O95831-2	241	242	+	1	0	0	4724
O95831-1#75	0	1	1	O95831-1	528	529	+	1	O95831-1	0	613	O95831-1	0	613	+	8	O95831-1#75	0	1	O95831-1	528	529	+	1	0	0	4725
O95831-1#76	0	1	1	O95831-1	530	531	+	1	O95831-1	352	613	O95831-5	0	261	+	12	O95831-1#76	0	1	O95831-5	178	179	+	1	0	0	4726
O95831-1#76	0	1	1	O95831-1	530	531	+	1	O95831-1	0	613	O95831-3	0	609	+	10	O95831-1#76	0	1	O95831-3	526	527	+	1	0	0	4727
O95831-1#76	0	1	1	O95831-1	530	531	+	1	O95831-1	0	613	O95831-2	0	326	+	9	O95831-1#76	0	1	O95831-2	243	244	+	1	0	0	4728
O95831-1#76	0	1	1	O95831-1	530	531	+	1	O95831-1	0	613	O95831-1	0	613	+	8	O95831-1#76	0	1	O95831-1	530	531	+	1	0	0	4729
O95831-1#77	0	1	1	O95831-1	532	533	+	1	O95831-1	352	613	O95831-5	0	261	+	12	O95831-1#77	0	1	O95831-5	180	181	+	1	0	0	4730
O95831-1#77	0	1	1	O95831-1	532	533	+	1	O95831-1	0	613	O95831-3	0	609	+	10	O95831-1#77	0	1	O95831-3	528	529	+	1	0	0	4731
O95831-1#77	0	1	1	O95831-1	532	533	+	1	O95831-1	0	613	O95831-2	0	326	+	9	O95831-1#77	0	1	O95831-2	245	246	+	1	0	0	4732
O95831-1#77	0	1	1	O95831-1	532	533	+	1	O95831-1	0	613	O95831-1	0	613	+	8	O95831-1#77	0	1	O95831-1	532	533	+	1	0	0	4733
O95831-1#78	0	1	1	O95831-1	534	535	+	1	O95831-1	352	613	O95831-5	0	261	+	12	O95831-1#78	0	1	O95831-5	182	183	+	1	0	0	4734
O95831-1#78	0	1	1	O95831-1	534	535	+	1	O95831-1	0	613	O95831-3	0	609	+	10	O95831-1#78	0	1	O95831-3	530	531	+	1	0	0	4735
O95831-1#78	0	1	1	O95831-1	534	535	+	1	O95831-1	0	613	O95831-2	0	326	+	9	O95831-1#78	0	1	O95831-2	247	248	+	1	0	0	4736
O95831-1#78	0	1	1	O95831-1	534	535	+	1	O95831-1	0	613	O95831-1	0	613	+	8	O95831-1#78	0	1	O95831-1	534	535	+	1	0	0	4737
O95831-1#79	0	9	9	O95831-1	129	138	+	9	O95831-1	0	322	O95831-4	0	322	+	11	O95831-1#79	0	9	O95831-4	129	138	+	9	0	0	4738
O95831-1#79	0	9	9	O95831-1	129	138	+	9	O95831-1	0	613	O95831-3	0	609	+	10	O95831-1#79	0	9	O95831-3	125	134	+	9	0	0	4739
O95831-1#79	0	9	9	O95831-1	129	138	+	9	O95831-1	0	613	O95831-1	0	613	+	8	O95831-1#79	0	9	O95831-1	129	138	+	9	0	0	4740
O95831-1#80	0	13	13	O95831-1	140	153	+	13	O95831-1	0	322	O95831-4	0	322	+	11	O95831-1#80	0	13	O95831-4	140	153	+	13	0	0	4741
O95831-1#80	0	13	13	O95831-1	140	153	+	13	O95831-1	0	613	O95831-3	0	609	+	10	O95831-1#80	0	13	O95831-3	136	149	+	13	0	0	4742
O95831-1#80	0	13	13	O95831-1	140	153	+	13	O95831-1	0	613	O95831-1	0	613	+	8	O95831-1#80	0	13	O95831-1	140	153	+	13	0	0	4743
O95831-1#81	0	5	5	O95831-1	157	162	+	5	O95831-1	0	322	O95831-4	0	322	+	11	O95831-1#81	0	5	O95831-4	157	162	+	5	0	0	4744
O95831-1#81	0	5	5	O95831-1	157	162	+	5	O95831-1	0	613	O95831-3	0	609	+	10	O95831-1#81	0	5	O95831-3	153	158	+	5	0	0	4745
O95831-1#81	0	5	5	O95831-1	157	162	+	5	O95831-1	0	613	O95831-1	0	613	+	8	O95831-1#81	0	5	O95831-1	157	162	+	5	0	0	4746
O95831-1#82	0	4	4	O95831-1	163	167	+	4	O95831-1	0	322	O95831-4	0	322	+	11	O95831-1#82	0	4	O95831-4	163	167	+	4	0	0	4747
O95831-1#82	0	4	4	O95831-1	163	167	+	4	O95831-1	0	613	O95831-3	0	609	+	10	O95831-1#82	0	4	O95831-3	159	163	+	4	0	0	4748
O95831-1#82	0	4	4	O95831-1	163	167	+	4	O95831-1	0	613	O95831-1	0	613	+	8	O95831-1#82	0	4	O95831-1	163	167	+	4	0	0	4749
O95831-1#83	0	4	4	O95831-1	172	176	+	4	O95831-1	0	322	O95831-4	0	322	+	11	O95831-1#83	0	4	O95831-4	172	176	+	4	0	0	4750
O95831-1#83	0	4	4	O95831-1	172	176	+	4	O95831-1	0	613	O95831-3	0	609	+	10	O95831-1#83	0	4	O95831-3	168	172	+	4	0	0	4751
O95831-1#83	0	4	4	O95831-1	172	176	+	4	O95831-1	0	613	O95831-1	0	613	+	8	O95831-1#83	0	4	O95831-1	172	176	+	4	0	0	4752
O95831-1#84	0	3	3	O95831-1	177	180	+	3	O95831-1	0	322	O95831-4	0	322	+	11	O95831-1#84	0	3	O95831-4	177	180	+	3	0	0	4753
O95831-1#84	0	3	3	O95831-1	177	180	+	3	O95831-1	0	613	O95831-3	0	609	+	10	O95831-1#84	0	3	O95831-3	173	176	+	3	0	0	4754
O95831-1#84	0	3	3	O95831-1	177	180	+	3	O95831-1	0	613	O95831-1	0	613	+	8	O95831-1#84	0	3	O95831-1	177	180	+	3	0	0	4755
O95831-1#85	0	4	4	O95831-1	186	190	+	4	O95831-1	0	322	O95831-4	0	322	+	11	O95831-1#85	0	4	O95831-4	186	190	+	4	0	0	4756
O95831-1#85	0	4	4	O95831-1	186	190	+	4	O95831-1	0	613	O95831-3	0	609	+	10	O95831-1#85	0	4	O95831-3	182	186	+	4	0	0	4757
O95831-1#85	0	4	4	O95831-1	186	190	+	4	O95831-1	0	613	O95831-1	0	613	+	8	O95831-1#85	0	4	O95831-1	186	190	+	4	0	0	4758
O95831-1#86	0	3	3	O95831-1	191	194	+	3	O95831-1	0	322	O95831-4	0	322	+	11	O95831-1#86	0	3	O95831-4	191	194	+	3	0	0	4759
O95831-1#86	0	3	3	O95831-1	191	194	+	3	O95831-1	0	613	O95831-3	0	609	+	10	O95831-1#86	0	3	O95831-3	187	190	+	3	0	0	4760
O95831-1#86	0	3	3	O95831-1	191	194	+	3	O95831-1	0	613	O95831-1	0	613	+	8	O95831-1#86	0	3	O95831-1	191	194	+	3	0	0	4761
O95831-1#87	0	7	7	O95831-1	199	206	+	7	O95831-1	0	322	O95831-4	0	322	+	11	O95831-1#87	0	7	O95831-4	199	206	+	7	0	0	4762
O95831-1#87	0	7	7	O95831-1	199	206	+	7	O95831-1	0	613	O95831-3	0	609	+	10	O95831-1#87	0	7	O95831-3	195	202	+	7	0	0	4763
O95831-1#87	0	7	7	O95831-1	199	206	+	7	O95831-1	0	613	O95831-1	0	613	+	8	O95831-1#87	0	7	O95831-1	199	206	+	7	0	0	4764
O95831-1#88	0	3	3	O95831-1	207	210	+	3	O95831-1	0	322	O95831-4	0	322	+	11	O95831-1#88	0	3	O95831-4	207	210	+	3	0	0	4765
O95831-1#88	0	3	3	O95831-1	207	210	+	3	O95831-1	0	613	O95831-3	0	609	+	10	O95831-1#88	0	3	O95831-3	203	206	+	3	0	0	4766
O95831-1#88	0	3	3	O95831-1	207	210	+	3	O95831-1	0	613	O95831-1	0	613	+	8	O95831-1#88	0	3	O95831-1	207	210	+	3	0	0	4767
O95831-1#89	0	6	6	O95831-1	213	219	+	6	O95831-1	0	322	O95831-4	0	322	+	11	O95831-1#89	0	6	O95831-4	213	219	+	6	0	0	4768
O95831-1#89	0	6	6	O95831-1	213	219	+	6	O95831-1	0	613	O95831-3	0	609	+	10	O95831-1#89	0	6	O95831-3	209	215	+	6	0	0	4769
O95831-1#89	0	6	6	O95831-1	213	219	+	6	O95831-1	0	613	O95831-1	0	613	+	8	O95831-1#89	0	6	O95831-1	213	219	+	6	0	0	4770
O95831-1#90	0	5	5	O95831-1	223	228	+	5	O95831-1	0	322	O95831-4	0	322	+	11	O95831-1#90	0	5	O95831-4	223	228	+	5	0	0	4771
O95831-1#90	0	5	5	O95831-1	223	228	+	5	O95831-1	0	613	O95831-3	0	609	+	10	O95831-1#90	0	5	O95831-3	219	224	+	5	0	0	4772
O95831-1#90	0	5	5	O95831-1	223	228	+	5	O95831-1	0	613	O95831-1	0	613	+	8	O95831-1#90	0	5	O95831-1	223	228	+	5	0	0	4773
O95831-1#91	0	5	5	O95831-1	232	237	+	5	O95831-1	0	322	O95831-4	0	322	+	11	O95831-1#91	0	5	O95831-4	232	237	+	5	0	0	4774
O95831-1#91	0	5	5	O95831-1	232	237	+	5	O95831-1	0	613	O95831-3	0	609	+	10	O95831-1#91	0	5	O95831-3	228	233	+	5	0	0	4775
O95831-1#91	0	5	5	O95831-1	232	237	+	5	O95831-1	0	613	O95831-1	0	613	+	8	O95831-1#91	0	5	O95831-1	232	237	+	5	0	0	4776
O95831-1#92	0	4	4	O95831-1	237	241	+	4	O95831-1	0	322	O95831-4	0	322	+	11	O95831-1#92	0	4	O95831-4	237	241	+	4	0	0	4777
O95831-1#92	0	4	4	O95831-1	237	241	+	4	O95831-1	0	613	O95831-3	0	609	+	10	O95831-1#92	0	4	O95831-3	233	237	+	4	0	0	4778
O95831-1#92	0	4	4	O95831-1	237	241	+	4	O95831-1	0	613	O95831-1	0	613	+	8	O95831-1#92	0	4	O95831-1	237	241	+	4	0	0	4779
O95831-1#93	0	4	4	O95831-1	241	245	+	4	O95831-1	0	322	O95831-4	0	322	+	11	O95831-1#93	0	4	O95831-4	241	245	+	4	0	0	4780
O95831-1#93	0	4	4	O95831-1	241	245	+	4	O95831-1	0	613	O95831-3	0	609	+	10	O95831-1#93	0	4	O95831-3	237	241	+	4	0	0	4781
O95831-1#93	0	4	4	O95831-1	241	245	+	4	O95831-1	0	613	O95831-1	0	613	+	8	O95831-1#93	0	4	O95831-1	241	245	+	4	0	0	4782
O95831-1#94	0	9	9	O95831-1	249	258	+	9	O95831-1	0	322	O95831-4	0	322	+	11	O95831-1#94	0	9	O95831-4	249	258	+	9	0	0	4783
O95831-1#94	0	9	9	O95831-1	249	258	+	9	O95831-1	0	613	O95831-3	0	609	+	10	O95831-1#94	0	9	O95831-3	245	254	+	9	0	0	4784
O95831-1#94	0	9	9	O95831-1	249	258	+	9	O95831-1	0	613	O95831-1	0	613	+	8	O95831-1#94	0	9	O95831-1	249	258	+	9	0	0	4785
O95831-1#95	0	3	3	O95831-1	261	264	+	3	O95831-1	0	322	O95831-4	0	322	+	11	O95831-1#95	0	3	O95831-4	261	264	+	3	0	0	4786
O95831-1#95	0	3	3	O95831-1	261	264	+	3	O95831-1	0	613	O95831-3	0	609	+	10	O95831-1#95	0	3	O95831-3	257	260	+	3	0	0	4787
O95831-1#95	0	3	3	O95831-1	261	264	+	3	O95831-1	0	613	O95831-1	0	613	+	8	O95831-1#95	0	3	O95831-1	261	264	+	3	0	0	4788
O95831-1#96	0	4	4	O95831-1	267	271	+	4	O95831-1	0	322	O95831-4	0	322	+	11	O95831-1#96	0	4	O95831-4	267	271	+	4	0	0	4789
O95831-1#96	0	4	4	O95831-1	267	271	+	4	O95831-1	0	613	O95831-3	0	609	+	10	O95831-1#96	0	4	O95831-3	263	267	+	4	0	0	4790
O95831-1#96	0	4	4	O95831-1	267	271	+	4	O95831-1	0	613	O95831-1	0	613	+	8	O95831-1#96	0	4	O95831-1	267	271	+	4	0	0	4791
O95831-1#97	0	5	5	O95831-1	274	279	+	5	O95831-1	0	322	O95831-4	0	322	+	11	O95831-1#97	0	5	O95831-4	274	279	+	5	0	0	4792
O95831-1#97	0	5	5	O95831-1	274	279	+	5	O95831-1	0	613	O95831-3	0	609	+	10	O95831-1#97	0	5	O95831-3	270	275	+	5	0	0	4793
O95831-1#97	0	5	5	O95831-1	274	279	+	5	O95831-1	0	613	O95831-1	0	613	+	8	O95831-1#97	0	5	O95831-1	274	279	+	5	0	0	4794
O95831-1#98	0	3	3	O95831-1	280	283	+	3	O95831-1	0	322	O95831-4	0	322	+	11	O95831-1#98	0	3	O95831-4	280	283	+	3	0	0	4795
O95831-1#98	0	3	3	O95831-1	280	283	+	3	O95831-1	0	613	O95831-3	0	609	+	10	O95831-1#98	0	3	O95831-3	276	279	+	3	0	0	4796
O95831-1#98	0	3	3	O95831-1	280	283	+	3	O95831-1	0	613	O95831-1	0	613	+	8	O95831-1#98	0	3	O95831-1	280	283	+	3	0	0	4797
O95831-1#99	0	13	13	O95831-1	286	299	+	13	O95831-1	0	322	O95831-4	0	322	+	11	O95831-1#99	0	13	O95831-4	286	299	+	13	0	0	4798
O95831-1#99	0	13	13	O95831-1	286	299	+	13	O95831-1	0	613	O95831-3	0	609	+	10	O95831-1#99	0	13	O95831-3	282	295	+	13	0	0	4799
O95831-1#99	0	13	13	O95831-1	286	299	+	13	O95831-1	0	613	O95831-1	0	613	+	8	O95831-1#99	0	13	O95831-1	286	299	+	13	0	0	4800
O95831-1#100	0	6	6	O95831-1	300	306	+	6	O95831-1	0	322	O95831-4	0	322	+	11	O95831-1#100	0	6	O95831-4	300	306	+	6	0	0	4801
O95831-1#100	0	6	6	O95831-1	300	306	+	6	O95831-1	0	613	O95831-3	0	609	+	10	O95831-1#100	0	6	O95831-3	296	302	+	6	0	0	4802
O95831-1#100	0	6	6	O95831-1	300	306	+	6	O95831-1	0	613	O95831-1	0	613	+	8	O95831-1#100	0	6	O95831-1	300	306	+	6	0	0	4803
O95831-1#101	0	17	17	O95831-1	309	326	+	17	O95831-1	0	322	O95831-4	0	322	+	11	O95831-1#101	0	13	O95831-4	309	322	+	13	0	4	4804
O95831-1#101	0	17	17	O95831-1	309	326	+	17	O95831-1	0	613	O95831-3	0	609	+	10	O95831-1#101	0	17	O95831-3	305	322	+	17	0	0	4805
O95831-1#101	0	17	17	O95831-1	309	326	+	17	O95831-1	0	613	O95831-2	0	326	+	9	O95831-1#101	13	17	O95831-2	35	39	+	4	13	0	4806
O95831-1#101	0	17	17	O95831-1	309	326	+	17	O95831-1	0	613	O95831-1	0	613	+	8	O95831-1#101	0	17	O95831-1	309	326	+	17	0	0	4807
O95831-1#102	0	5	5	O95831-1	328	333	+	5	O95831-1	0	613	O95831-3	0	609	+	10	O95831-1#102	0	5	O95831-3	324	329	+	5	0	0	4808
O95831-1#102	0	5	5	O95831-1	328	333	+	5	O95831-1	0	613	O95831-2	0	326	+	9	O95831-1#102	0	5	O95831-2	41	46	+	5	0	0	4809
O95831-1#102	0	5	5	O95831-1	328	333	+	5	O95831-1	0	613	O95831-1	0	613	+	8	O95831-1#102	0	5	O95831-1	328	333	+	5	0	0	4810
O95831-1#103	0	4	4	O95831-1	334	338	+	4	O95831-1	0	613	O95831-3	0	609	+	10	O95831-1#103	0	4	O95831-3	330	334	+	4	0	0	4811
O95831-1#103	0	4	4	O95831-1	334	338	+	4	O95831-1	0	613	O95831-2	0	326	+	9	O95831-1#103	0	4	O95831-2	47	51	+	4	0	0	4812
O95831-1#103	0	4	4	O95831-1	334	338	+	4	O95831-1	0	613	O95831-1	0	613	+	8	O95831-1#103	0	4	O95831-1	334	338	+	4	0	0	4813
O95831-1#104	0	5	5	O95831-1	338	343	+	5	O95831-1	0	613	O95831-3	0	609	+	10	O95831-1#104	0	5	O95831-3	334	339	+	5	0	0	4814
O95831-1#104	0	5	5	O95831-1	338	343	+	5	O95831-1	0	613	O95831-2	0	326	+	9	O95831-1#104	0	5	O95831-2	51	56	+	5	0	0	4815
O95831-1#104	0	5	5	O95831-1	338	343	+	5	O95831-1	0	613	O95831-1	0	613	+	8	O95831-1#104	0	5	O95831-1	338	343	+	5	0	0	4816
O95831-1#105	0	13	13	O95831-1	345	358	+	13	O95831-1	352	613	O95831-5	0	261	+	12	O95831-1#105	7	13	O95831-5	0	6	+	6	7	0	4817
O95831-1#105	0	13	13	O95831-1	345	358	+	13	O95831-1	0	613	O95831-3	0	609	+	10	O95831-1#105	0	13	O95831-3	341	354	+	13	0	0	4818
O95831-1#105	0	13	13	O95831-1	345	358	+	13	O95831-1	0	613	O95831-2	0	326	+	9	O95831-1#105	0	13	O95831-2	58	71	+	13	0	0	4819
O95831-1#105	0	13	13	O95831-1	345	358	+	13	O95831-1	0	613	O95831-1	0	613	+	8	O95831-1#105	0	13	O95831-1	345	358	+	13	0	0	4820
O95831-1#106	0	3	3	O95831-1	361	364	+	3	O95831-1	352	613	O95831-5	0	261	+	12	O95831-1#106	0	3	O95831-5	9	12	+	3	0	0	4821
O95831-1#106	0	3	3	O95831-1	361	364	+	3	O95831-1	0	613	O95831-3	0	609	+	10	O95831-1#106	0	3	O95831-3	357	360	+	3	0	0	4822
O95831-1#106	0	3	3	O95831-1	361	364	+	3	O95831-1	0	613	O95831-2	0	326	+	9	O95831-1#106	0	3	O95831-2	74	77	+	3	0	0	4823
O95831-1#106	0	3	3	O95831-1	361	364	+	3	O95831-1	0	613	O95831-1	0	613	+	8	O95831-1#106	0	3	O95831-1	361	364	+	3	0	0	4824
O95831-1#107	0	7	7	O95831-1	368	375	+	7	O95831-1	352	613	O95831-5	0	261	+	12	O95831-1#107	0	7	O95831-5	16	23	+	7	0	0	4825
O95831-1#107	0	7	7	O95831-1	368	375	+	7	O95831-1	0	613	O95831-3	0	609	+	10	O95831-1#107	0	7	O95831-3	364	371	+	7	0	0	4826
O95831-1#107	0	7	7	O95831-1	368	375	+	7	O95831-1	0	613	O95831-2	0	326	+	9	O95831-1#107	0	7	O95831-2	81	88	+	7	0	0	4827
O95831-1#107	0	7	7	O95831-1	368	375	+	7	O95831-1	0	613	O95831-1	0	613	+	8	O95831-1#107	0	7	O95831-1	368	375	+	7	0	0	4828
O95831-1#108	0	6	6	O95831-1	377	383	+	6	O95831-1	352	613	O95831-5	0	261	+	12	O95831-1#108	0	6	O95831-5	25	31	+	6	0	0	4829
O95831-1#108	0	6	6	O95831-1	377	383	+	6	O95831-1	0	613	O95831-3	0	609	+	10	O95831-1#108	0	6	O95831-3	373	379	+	6	0	0	4830
O95831-1#108	0	6	6	O95831-1	377	383	+	6	O95831-1	0	613	O95831-2	0	326	+	9	O95831-1#108	0	6	O95831-2	90	96	+	6	0	0	4831
O95831-1#108	0	6	6	O95831-1	377	383	+	6	O95831-1	0	613	O95831-1	0	613	+	8	O95831-1#108	0	6	O95831-1	377	383	+	6	0	0	4832
O95831-1#109	0	9	9	O95831-1	387	396	+	9	O95831-1	352	613	O95831-5	0	261	+	12	O95831-1#109	0	9	O95831-5	35	44	+	9	0	0	4833
O95831-1#109	0	9	9	O95831-1	387	396	+	9	O95831-1	0	613	O95831-3	0	609	+	10	O95831-1#109	0	9	O95831-3	383	392	+	9	0	0	4834
O95831-1#109	0	9	9	O95831-1	387	396	+	9	O95831-1	0	613	O95831-2	0	326	+	9	O95831-1#109	0	9	O95831-2	100	109	+	9	0	0	4835
O95831-1#109	0	9	9	O95831-1	387	396	+	9	O95831-1	0	613	O95831-1	0	613	+	8	O95831-1#109	0	9	O95831-1	387	396	+	9	0	0	4836
O95831-1#110	0	3	3	O95831-1	399	402	+	3	O95831-1	352	613	O95831-5	0	261	+	12	O95831-1#110	0	3	O95831-5	47	50	+	3	0	0	4837
O95831-1#110	0	3	3	O95831-1	399	402	+	3	O95831-1	0	613	O95831-3	0	609	+	10	O95831-1#110	0	3	O95831-3	395	398	+	3	0	0	4838
O95831-1#110	0	3	3	O95831-1	399	402	+	3	O95831-1	0	613	O95831-2	0	326	+	9	O95831-1#110	0	3	O95831-2	112	115	+	3	0	0	4839
O95831-1#110	0	3	3	O95831-1	399	402	+	3	O95831-1	0	613	O95831-1	0	613	+	8	O95831-1#110	0	3	O95831-1	399	402	+	3	0	0	4840
O95831-1#111	0	4	4	O95831-1	406	410	+	4	O95831-1	352	613	O95831-5	0	261	+	12	O95831-1#111	0	4	O95831-5	54	58	+	4	0	0	4841
O95831-1#111	0	4	4	O95831-1	406	410	+	4	O95831-1	0	613	O95831-3	0	609	+	10	O95831-1#111	0	4	O95831-3	402	406	+	4	0	0	4842
O95831-1#111	0	4	4	O95831-1	406	410	+	4	O95831-1	0	613	O95831-2	0	326	+	9	O95831-1#111	0	4	O95831-2	119	123	+	4	0	0	4843
O95831-1#111	0	4	4	O95831-1	406	410	+	4	O95831-1	0	613	O95831-1	0	613	+	8	O95831-1#111	0	4	O95831-1	406	410	+	4	0	0	4844
O95831-1#112	0	3	3	O95831-1	415	418	+	3	O95831-1	352	613	O95831-5	0	261	+	12	O95831-1#112	0	3	O95831-5	63	66	+	3	0	0	4845
O95831-1#112	0	3	3	O95831-1	415	418	+	3	O95831-1	0	613	O95831-3	0	609	+	10	O95831-1#112	0	3	O95831-3	411	414	+	3	0	0	4846
O95831-1#112	0	3	3	O95831-1	415	418	+	3	O95831-1	0	613	O95831-2	0	326	+	9	O95831-1#112	0	3	O95831-2	128	131	+	3	0	0	4847
O95831-1#112	0	3	3	O95831-1	415	418	+	3	O95831-1	0	613	O95831-1	0	613	+	8	O95831-1#112	0	3	O95831-1	415	418	+	3	0	0	4848
O95831-1#113	0	3	3	O95831-1	419	422	+	3	O95831-1	352	613	O95831-5	0	261	+	12	O95831-1#113	0	3	O95831-5	67	70	+	3	0	0	4849
O95831-1#113	0	3	3	O95831-1	419	422	+	3	O95831-1	0	613	O95831-3	0	609	+	10	O95831-1#113	0	3	O95831-3	415	418	+	3	0	0	4850
O95831-1#113	0	3	3	O95831-1	419	422	+	3	O95831-1	0	613	O95831-2	0	326	+	9	O95831-1#113	0	3	O95831-2	132	135	+	3	0	0	4851
O95831-1#113	0	3	3	O95831-1	419	422	+	3	O95831-1	0	613	O95831-1	0	613	+	8	O95831-1#113	0	3	O95831-1	419	422	+	3	0	0	4852
O95831-1#114	0	4	4	O95831-1	426	430	+	4	O95831-1	352	613	O95831-5	0	261	+	12	O95831-1#114	0	4	O95831-5	74	78	+	4	0	0	4853
O95831-1#114	0	4	4	O95831-1	426	430	+	4	O95831-1	0	613	O95831-3	0	609	+	10	O95831-1#114	0	4	O95831-3	422	426	+	4	0	0	4854
O95831-1#114	0	4	4	O95831-1	426	430	+	4	O95831-1	0	613	O95831-2	0	326	+	9	O95831-1#114	0	4	O95831-2	139	143	+	4	0	0	4855
O95831-1#114	0	4	4	O95831-1	426	430	+	4	O95831-1	0	613	O95831-1	0	613	+	8	O95831-1#114	0	4	O95831-1	426	430	+	4	0	0	4856
O95831-1#115	0	3	3	O95831-1	432	435	+	3	O95831-1	352	613	O95831-5	0	261	+	12	O95831-1#115	0	3	O95831-5	80	83	+	3	0	0	4857
O95831-1#115	0	3	3	O95831-1	432	435	+	3	O95831-1	0	613	O95831-3	0	609	+	10	O95831-1#115	0	3	O95831-3	428	431	+	3	0	0	4858
O95831-1#115	0	3	3	O95831-1	432	435	+	3	O95831-1	0	613	O95831-2	0	326	+	9	O95831-1#115	0	3	O95831-2	145	148	+	3	0	0	4859
O95831-1#115	0	3	3	O95831-1	432	435	+	3	O95831-1	0	613	O95831-1	0	613	+	8	O95831-1#115	0	3	O95831-1	432	435	+	3	0	0	4860
O95831-1#116	0	3	3	O95831-1	436	439	+	3	O95831-1	352	613	O95831-5	0	261	+	12	O95831-1#116	0	3	O95831-5	84	87	+	3	0	0	4861
O95831-1#116	0	3	3	O95831-1	436	439	+	3	O95831-1	0	613	O95831-3	0	609	+	10	O95831-1#116	0	3	O95831-3	432	435	+	3	0	0	4862
O95831-1#116	0	3	3	O95831-1	436	439	+	3	O95831-1	0	613	O95831-2	0	326	+	9	O95831-1#116	0	3	O95831-2	149	152	+	3	0	0	4863
O95831-1#116	0	3	3	O95831-1	436	439	+	3	O95831-1	0	613	O95831-1	0	613	+	8	O95831-1#116	0	3	O95831-1	436	439	+	3	0	0	4864
O95831-1#117	0	5	5	O95831-1	439	444	+	5	O95831-1	352	613	O95831-5	0	261	+	12	O95831-1#117	0	5	O95831-5	87	92	+	5	0	0	4865
O95831-1#117	0	5	5	O95831-1	439	444	+	5	O95831-1	0	613	O95831-3	0	609	+	10	O95831-1#117	0	5	O95831-3	435	440	+	5	0	0	4866
O95831-1#117	0	5	5	O95831-1	439	444	+	5	O95831-1	0	613	O95831-2	0	326	+	9	O95831-1#117	0	5	O95831-2	152	157	+	5	0	0	4867
O95831-1#117	0	5	5	O95831-1	439	444	+	5	O95831-1	0	613	O95831-1	0	613	+	8	O95831-1#117	0	5	O95831-1	439	444	+	5	0	0	4868
O95831-1#118	0	3	3	O95831-1	444	447	+	3	O95831-1	352	613	O95831-5	0	261	+	12	O95831-1#118	0	3	O95831-5	92	95	+	3	0	0	4869
O95831-1#118	0	3	3	O95831-1	444	447	+	3	O95831-1	0	613	O95831-3	0	609	+	10	O95831-1#118	0	3	O95831-3	440	443	+	3	0	0	4870
O95831-1#118	0	3	3	O95831-1	444	447	+	3	O95831-1	0	613	O95831-2	0	326	+	9	O95831-1#118	0	3	O95831-2	157	160	+	3	0	0	4871
O95831-1#118	0	3	3	O95831-1	444	447	+	3	O95831-1	0	613	O95831-1	0	613	+	8	O95831-1#118	0	3	O95831-1	444	447	+	3	0	0	4872
O95831-1#119	0	3	3	O95831-1	447	450	+	3	O95831-1	352	613	O95831-5	0	261	+	12	O95831-1#119	0	3	O95831-5	95	98	+	3	0	0	4873
O95831-1#119	0	3	3	O95831-1	447	450	+	3	O95831-1	0	613	O95831-3	0	609	+	10	O95831-1#119	0	3	O95831-3	443	446	+	3	0	0	4874
O95831-1#119	0	3	3	O95831-1	447	450	+	3	O95831-1	0	613	O95831-2	0	326	+	9	O95831-1#119	0	3	O95831-2	160	163	+	3	0	0	4875
O95831-1#119	0	3	3	O95831-1	447	450	+	3	O95831-1	0	613	O95831-1	0	613	+	8	O95831-1#119	0	3	O95831-1	447	450	+	3	0	0	4876
O95831-1#120	0	14	14	O95831-1	454	468	+	14	O95831-1	352	613	O95831-5	0	261	+	12	O95831-1#120	0	14	O95831-5	102	116	+	14	0	0	4877
O95831-1#120	0	14	14	O95831-1	454	468	+	14	O95831-1	0	613	O95831-3	0	609	+	10	O95831-1#120	0	14	O95831-3	450	464	+	14	0	0	4878
O95831-1#120	0	14	14	O95831-1	454	468	+	14	O95831-1	0	613	O95831-2	0	326	+	9	O95831-1#120	0	14	O95831-2	167	181	+	14	0	0	4879
O95831-1#120	0	14	14	O95831-1	454	468	+	14	O95831-1	0	613	O95831-1	0	613	+	8	O95831-1#120	0	14	O95831-1	454	468	+	14	0	0	4880
O95831-1#121	0	3	3	O95831-1	468	471	+	3	O95831-1	352	613	O95831-5	0	261	+	12	O95831-1#121	0	3	O95831-5	116	119	+	3	0	0	4881
O95831-1#121	0	3	3	O95831-1	468	471	+	3	O95831-1	0	613	O95831-3	0	609	+	10	O95831-1#121	0	3	O95831-3	464	467	+	3	0	0	4882
O95831-1#121	0	3	3	O95831-1	468	471	+	3	O95831-1	0	613	O95831-2	0	326	+	9	O95831-1#121	0	3	O95831-2	181	184	+	3	0	0	4883
O95831-1#121	0	3	3	O95831-1	468	471	+	3	O95831-1	0	613	O95831-1	0	613	+	8	O95831-1#121	0	3	O95831-1	468	471	+	3	0	0	4884
O95831-1#122	0	7	7	O95831-1	480	487	+	7	O95831-1	352	613	O95831-5	0	261	+	12	O95831-1#122	0	7	O95831-5	128	135	+	7	0	0	4885
O95831-1#122	0	7	7	O95831-1	480	487	+	7	O95831-1	0	613	O95831-3	0	609	+	10	O95831-1#122	0	7	O95831-3	476	483	+	7	0	0	4886
O95831-1#122	0	7	7	O95831-1	480	487	+	7	O95831-1	0	613	O95831-2	0	326	+	9	O95831-1#122	0	7	O95831-2	193	200	+	7	0	0	4887
O95831-1#122	0	7	7	O95831-1	480	487	+	7	O95831-1	0	613	O95831-1	0	613	+	8	O95831-1#122	0	7	O95831-1	480	487	+	7	0	0	4888
O95831-1#123	0	6	6	O95831-1	490	496	+	6	O95831-1	352	613	O95831-5	0	261	+	12	O95831-1#123	0	6	O95831-5	138	144	+	6	0	0	4889
O95831-1#123	0	6	6	O95831-1	490	496	+	6	O95831-1	0	613	O95831-3	0	609	+	10	O95831-1#123	0	6	O95831-3	486	492	+	6	0	0	4890
O95831-1#123	0	6	6	O95831-1	490	496	+	6	O95831-1	0	613	O95831-2	0	326	+	9	O95831-1#123	0	6	O95831-2	203	209	+	6	0	0	4891
O95831-1#123	0	6	6	O95831-1	490	496	+	6	O95831-1	0	613	O95831-1	0	613	+	8	O95831-1#123	0	6	O95831-1	490	496	+	6	0	0	4892
O95831-1#124	0	6	6	O95831-1	503	509	+	6	O95831-1	352	613	O95831-5	0	261	+	12	O95831-1#124	0	6	O95831-5	151	157	+	6	0	0	4893
O95831-1#124	0	6	6	O95831-1	503	509	+	6	O95831-1	0	613	O95831-3	0	609	+	10	O95831-1#124	0	6	O95831-3	499	505	+	6	0	0	4894
O95831-1#124	0	6	6	O95831-1	503	509	+	6	O95831-1	0	613	O95831-2	0	326	+	9	O95831-1#124	0	6	O95831-2	216	222	+	6	0	0	4895
O95831-1#124	0	6	6	O95831-1	503	509	+	6	O95831-1	0	613	O95831-1	0	613	+	8	O95831-1#124	0	6	O95831-1	503	509	+	6	0	0	4896
O95831-1#125	0	3	3	O95831-1	512	515	+	3	O95831-1	352	613	O95831-5	0	261	+	12	O95831-1#125	0	3	O95831-5	160	163	+	3	0	0	4897
O95831-1#125	0	3	3	O95831-1	512	515	+	3	O95831-1	0	613	O95831-3	0	609	+	10	O95831-1#125	0	3	O95831-3	508	511	+	3	0	0	4898
O95831-1#125	0	3	3	O95831-1	512	515	+	3	O95831-1	0	613	O95831-2	0	326	+	9	O95831-1#125	0	3	O95831-2	225	228	+	3	0	0	4899
O95831-1#125	0	3	3	O95831-1	512	515	+	3	O95831-1	0	613	O95831-1	0	613	+	8	O95831-1#125	0	3	O95831-1	512	515	+	3	0	0	4900
O95831-1#126	0	8	8	O95831-1	516	524	+	8	O95831-1	352	613	O95831-5	0	261	+	12	O95831-1#126	0	8	O95831-5	164	172	+	8	0	0	4901
O95831-1#126	0	8	8	O95831-1	516	524	+	8	O95831-1	0	613	O95831-3	0	609	+	10	O95831-1#126	0	8	O95831-3	512	520	+	8	0	0	4902
O95831-1#126	0	8	8	O95831-1	516	524	+	8	O95831-1	0	613	O95831-2	0	326	+	9	O95831-1#126	0	8	O95831-2	229	237	+	8	0	0	4903
O95831-1#126	0	8	8	O95831-1	516	524	+	8	O95831-1	0	613	O95831-1	0	613	+	8	O95831-1#126	0	8	O95831-1	516	524	+	8	0	0	4904
O95831-1#127	0	5	5	O95831-1	528	533	+	5	O95831-1	352	613	O95831-5	0	261	+	12	O95831-1#127	0	5	O95831-5	176	181	+	5	0	0	4905
O95831-1#127	0	5	5	O95831-1	528	533	+	5	O95831-1	0	613	O95831-3	0	609	+	10	O95831-1#127	0	5	O95831-3	524	529	+	5	0	0	4906
O95831-1#127	0	5	5	O95831-1	528	533	+	5	O95831-1	0	613	O95831-2	0	326	+	9	O95831-1#127	0	5	O95831-2	241	246	+	5	0	0	4907
O95831-1#127	0	5	5	O95831-1	528	533	+	5	O95831-1	0	613	O95831-1	0	613	+	8	O95831-1#127	0	5	O95831-1	528	533	+	5	0	0	4908
O95831-1#128	0	5	5	O95831-1	537	542	+	5	O95831-1	352	613	O95831-5	0	261	+	12	O95831-1#128	0	5	O95831-5	185	190	+	5	0	0	4909
O95831-1#128	0	5	5	O95831-1	537	542	+	5	O95831-1	0	613	O95831-3	0	609	+	10	O95831-1#128	0	5	O95831-3	533	538	+	5	0	0	4910
O95831-1#128	0	5	5	O95831-1	537	542	+	5	O95831-1	0	613	O95831-2	0	326	+	9	O95831-1#128	0	5	O95831-2	250	255	+	5	0	0	4911
O95831-1#128	0	5	5	O95831-1	537	542	+	5	O95831-1	0	613	O95831-1	0	613	+	8	O95831-1#128	0	5	O95831-1	537	542	+	5	0	0	4912
O95831-1#129	0	8	8	O95831-1	561	569	+	8	O95831-1	352	613	O95831-5	0	261	+	12	O95831-1#129	0	8	O95831-5	209	217	+	8	0	0	4913
O95831-1#129	0	8	8	O95831-1	561	569	+	8	O95831-1	0	613	O95831-3	0	609	+	10	O95831-1#129	0	8	O95831-3	557	565	+	8	0	0	4914
O95831-1#129	0	8	8	O95831-1	561	569	+	8	O95831-1	0	613	O95831-2	0	326	+	9	O95831-1#129	0	8	O95831-2	274	282	+	8	0	0	4915
O95831-1#129	0	8	8	O95831-1	561	569	+	8	O95831-1	0	613	O95831-1	0	613	+	8	O95831-1#129	0	8	O95831-1	561	569	+	8	0	0	4916
O95831-1#130	0	9	9	O95831-1	571	580	+	9	O95831-1	352	613	O95831-5	0	261	+	12	O95831-1#130	0	9	O95831-5	219	228	+	9	0	0	4917
O95831-1#130	0	9	9	O95831-1	571	580	+	9	O95831-1	0	613	O95831-3	0	609	+	10	O95831-1#130	0	9	O95831-3	567	576	+	9	0	0	4918
O95831-1#130	0	9	9	O95831-1	571	580	+	9	O95831-1	0	613	O95831-2	0	326	+	9	O95831-1#130	0	9	O95831-2	284	293	+	9	0	0	4919
O95831-1#130	0	9	9	O95831-1	571	580	+	9	O95831-1	0	613	O95831-1	0	613	+	8	O95831-1#130	0	9	O95831-1	571	580	+	9	0	0	4920
O95831-1#131	0	10	10	O95831-1	584	594	+	10	O95831-1	352	613	O95831-5	0	261	+	12	O95831-1#131	0	10	O95831-5	232	242	+	10	0	0	4921
O95831-1#131	0	10	10	O95831-1	584	594	+	10	O95831-1	0	613	O95831-3	0	609	+	10	O95831-1#131	0	10	O95831-3	580	590	+	10	0	0	4922
O95831-1#131	0	10	10	O95831-1	584	594	+	10	O95831-1	0	613	O95831-2	0	326	+	9	O95831-1#131	0	10	O95831-2	297	307	+	10	0	0	4923
O95831-1#131	0	10	10	O95831-1	584	594	+	10	O95831-1	0	613	O95831-1	0	613	+	8	O95831-1#131	0	10	O95831-1	584	594	+	10	0	0	4924
O95831-1#132	0	5	5	O95831-1	600	605	+	5	O95831-1	352	613	O95831-5	0	261	+	12	O95831-1#132	0	5	O95831-5	248	253	+	5	0	0	4925
O95831-1#132	0	5	5	O95831-1	600	605	+	5	O95831-1	0	613	O95831-3	0	609	+	10	O95831-1#132	0	5	O95831-3	596	601	+	5	0	0	4926
O95831-1#132	0	5	5	O95831-1	600	605	+	5	O95831-1	0	613	O95831-2	0	326	+	9	O95831-1#132	0	5	O95831-2	313	318	+	5	0	0	4927
O95831-1#132	0	5	5	O95831-1	600	605	+	5	O95831-1	0	613	O95831-1	0	613	+	8	O95831-1#132	0	5	O95831-1	600	605	+	5	0	0	4928
O95831-1#133	0	3	3	O95831-1	605	608	+	3	O95831-1	352	613	O95831-5	0	261	+	12	O95831-1#133	0	3	O95831-5	253	256	+	3	0	0	4929
O95831-1#133	0	3	3	O95831-1	605	608	+	3	O95831-1	0	613	O95831-3	0	609	+	10	O95831-1#133	0	3	O95831-3	601	604	+	3	0	0	4930
O95831-1#133	0	3	3	O95831-1	605	608	+	3	O95831-1	0	613	O95831-2	0	326	+	9	O95831-1#133	0	3	O95831-2	318	321	+	3	0	0	4931
O95831-1#133	0	3	3	O95831-1	605	608	+	3	O95831-1	0	613	O95831-1	0	613	+	8	O95831-1#133	0	3	O95831-1	605	608	+	3	0	0	4932
